,Curated Name and Num,Hospital type (HCRIS + care compare),S2_1_C1_21,Lon,Lat,D_4_IRF_C13_51,D3_IPF_C2_42,D_4_IPF_C11_75,S4_HHA1_C2_34,S4_HHA1_C4_35,A_C2_23,S3_2_C4_22,D_4_HOS_C12_52,A8_C2_30,S4_HHA2_C1_36,D_5_HOS_C2_71,D3_SNF_C3_71,B_1_C21_106,A_C2_191,D1_IPF_C1_52,S3_2_C4_6,S3_2_C2_19,A_C6_70,S3_1_C8_26,S3_2_C2_6,D_4_IRF_C11_53,S2_1_C2_24,D_4_IPF_C11_93,D_4_IRF_C13_70,B_1_C0_71,B_1_C0_53,S10_C1_6,D_4_HOS_C13_62,D3_SNF_C3_70,B_1_C0_51,A_C1_30,A_C2_110,C_1_C6_202,A_C2_46,D_4_HOS_C2_90,S2_1_C1_145,S5_C1_2,B_1_C26_190,A_C1_116,S5_C2_10,C_1_C5_51,C_1_C7_69,D_5_HOS_C5_91,D_5_HOS_C7_58,S3_2_C6_4,A_C1_192,C_1_C5_9920,D3_HOS_C3_76,C_1_C5_72,E_B_HOS_C1_4,B_1_C21_44,D_4_HOS_C13_74,A_C6_33,A_C1_22,D_4_SNF_C11_56,S3_1_C7_2,S4_HHA2_C4_35,C_1_C6_65,D_4_HOS_C12_63,S4_HHA3_C2_38,D3_HOS_C2_40,D_4_HOS_C11_70,C_1_C6_60,B_1_C21_112,B_2_C26_30,D3_IPF_C3_98,D3_IPF_C3_200,B_1_C0_74,S2_1_C2_1808,D_5_HOS_C7_51,B_1_C0_9940,A_C1_93,S2_1_C1_26,S3_2_C2_4,D_5_HOS_C4_70,D_4_IRF_C11_57,D_4_IPF_C13_73,A7_1_C2_6,S4_HHA2_C4_38,D_4_HOS_C2_97,B_1_C21_100,B_1_C26_75,S4_HHA2_C2_35,B_1_C26_58,C_1_C5_33,A_C1_16,D_4_HOS_C11_58,A_C1_191,S3_2_C3_2201,S3_2_C5_41,S2_1_C2_38,D3_SNF_C2_63,D_1_HOS_C6_32,D_3_HOS_C9_41,D_4_IRF_C13_57,D_5_HOS_C4_51,B_1_C0_33,A_C1_59,D_4_HOS_C2_60,D3_HOS_C2_55,S3_2_C4_15,S3_2_C2_1,D_4_HOS_C3_70,C_1_C5_63,A_C2_58,D_4_HOS_C13_53,S2_1_C5_24,S5_C2_2,A_C1_11,D_5_HOS_C6_90,D_5_HOS_C5_65,D_4_IPF_C11_200,A_C6_68,S2_1_C1_36,D3_IRF_C3_57,S4_HHA1_C4_33,A_C6_30,C_1_C7_57,A_C2_12,D1_HOS_C1_54,S3_2_C4_19,E_B_HOS_C1_6,C_1_C6_88,D_5_HOS_C4_50,D_5_HOS_C5_52,A_C2_40,D_4_HOS_C11_63,D_5_HOS_C3_51,D_5_HOS_C5_93,S3_1_C7_17,A_C1_17,D_5_HOS_C7_53,D_4_HOS_C11_72,A_C1_9201,A_C2_9920,A_C6_97,A_C2_43,B_1_C21_33,S3_2_C4_36,D_5_HOS_C6_57,D3_HOS_C3_60,S5_C2_9,D_4_HOS_C2_53,D3_IRF_C3_76,A_C6_43,S3_2_C5_14,D_4_HOS_C11_54,S2_1_C2_126,C_1_C6_107,B_1_C21_66,S2_1_C2_115,D_4_SNF_C13_73,B_1_C0_45,D3_SNF_C2_52,B_2_C26_75,S4_HHA2_C3_35,S4_HHA2_C1_33,D_5_HOS_C7_59,S2_1_C2_143,D_5_HOS_C2_200,D_4_IPF_C2_200,S5_C1_8,D_3_HOS_C9_34,A_C1_68,D3_IPF_C3_96,S3_1_C2_12,D_3_HOS_C5_200,D3_HOS_C3_64,S3_2_C4_29,D_4_IRF_C2_200,C_1_C7_91,D3_SNF_C2_64,A8_C2_23,A_C6_59,S3_2_C5_26,S3_2_C6_9,C_1_C6_9920,S3_2_C2_24,S2_1_C1_105,D_5_HOS_C7_93,S3_1_C2_14,S3_2_C6_26,B_1_C26_9201,A_C6_113,C_1_C7_56,D_4_IPF_C13_68,A_C6_53,D3_IPF_C3_65,B_2_C26_70,D_4_IRF_C13_200,D_4_IPF_C13_64,A_C1_67,S3_2_C6_3,A7_1_C3_3,B_1_C26_107,D3_HOS_C2_64,S2_1_C2_5,S5_C4_2,A8_C2_29,D3_IRF_C2_51,D_5_HOS_C2_66,D_5_HOS_C6_62,STATE,B_2_C26_9920,A_C6_89,B_1_C22_116,D_5_HOS_C3_73,B_1_C0_63,D4_KIDNEY_C1_69,D_4_HOS_C3_9201,B_2_C26_4201,B_1_C22_191,C_1_C6_33,D3_HOS_C3_63,E_B_HOS_C1_44,D4_LIVER_C1_69,S3_1_C7_6,B_1_C0_56,C_1_C5_53,C_1_C5_55,D_5_HOS_C4_91,D1_IPF_C1_37,D_5_HOS_C5_72,E_B_HOS_C101_3,E_B_HOS_C1_18,D_4_HOS_C12_70,S3_1_C9_20,S10_C1_30,B_2_C26_6250,C_1_C5_68,D_5_HOS_C2_97,S3_2_C4_41,D_4_IRF_C13_64,D_4_SNF_C11_60,A_C2_22,D_4_HOS_C10_97,S2_1_C1_2,D_4_IRF_C11_73,S3_1_C11_26,B_1_C21_71,E_B_HOS_C1_28,B_1_C0_2,S4_HHA3_C5_37,D3_HOS_C3_56,D3_SNF_C3_67,B_1_C22_59,A_C6_72,D4_HEART_C1_69,D3_SNF_C2_70,B_1_C0_97,A_C6_6,D_5_HOS_C3_75,D_5_HOS_C6_91,S3_1_C7_26,D3_IRF_C3_69,B_1_C0_1,A7_1_C3_7,B_2_C26_108,D3_HOS_C2_72,D_4_HOS_C4_89,S3_2_C5_9,C_1_C6_67,D_4_HOS_C13_200,D_4_HOS_C11_71,S3_2_C6_41,B_1_C22_43,D3_IRF_C2_98,D3_HOS_C2_70,A_C2_14,C_1_C7_51,A7_1_C2_1,D3_IRF_C2_9201,C_1_C5_9910,D_4_HOS_C12_53,D3_IRF_C2_61,D_4_HOS_C4_59,B_2_C26_62,D_1_HOS_C6_35,B_2_C26_44,B_2_C26_46,B_1_C0_6250,S2_1_C1_27,E_B_HOS_C101_2,D_5_HOS_C5_66,D_5_HOS_C5_75,D_4_IPF_C13_66,A_C6_112,B_1_C21_52,C_1_C7_94,S3_1_C11_25,S3_2_C6_28,D3_SNF_C2_34,A_C2_55,D_4_HOS_C12_50,B_1_C22_65,S2_1_C1_38,A_C1_107,A_C2_117,S2_1_C2_1608,S2_1_C1_47,S3_2_C5_39,D_5_HOS_C6_96,S3_1_C3_14,A7_1_C5_5,S2_1_C4_24,S3_2_C4_2550,B_1_C21_190,S3_3_C6_6,D_4_SNF_C11_51,A_C1_35,D3_IPF_C2_41,D_4_HOS_C12_55,A_C2_8,D_5_HOS_C6_50,D3_SNF_C2_51,S3_2_C2_9,D3_IRF_C3_62,D3_IPF_C3_55,S3_1_C2_17,D3_SNF_C2_66,D_4_HOS_C11_9201,B_1_C26_95,A8_C2_2,B_2_C26_191,D3_SNF_C3_72,S2_1_C2_1501,S2_1_C2_10,S3_1_C15_18,S3_2_C2_1402,B_1_C0_44,A_C1_44,D_4_HOS_C11_90,D_3_HOS_C9_44,A7_1_C7_8,S3_2_C4_33,A_C2_7,D_5_HOS_C4_63,C_1_C7_75,A_C6_44,C_1_C5_4201,D_4_HOS_C3_89,B_1_C26_109,S10_C2_23,D_4_HOS_C12_76,B_1_C0_105,D_4_IRF_C11_91,C_1_C5_107,A_C1_108,B_1_C21_54,D_4_IRF_C13_65,D_4_SNF_C11_63,S3_1_C2_1801,C_1_C6_30,S2_1_C2_1001,D3_IRF_C2_90,D_4_IPF_C11_69,D_4_HOS_C3_71,S3_1_C9_18,E_B_HOS_C1_7,S3_3_C4_7,D3_IRF_C3_60,D_4_IPF_C13_75,D3_SNF_C2_54,C_1_C7_117,D_4_HOS_C2_91,D_5_HOS_C6_70,B_2_C26_9910,D3_IPF_C3_70,D_4_HOS_C4_57,D_4_HOS_C12_200,D_4_IPF_C11_51,A_C6_9910,D_5_HOS_C4_73,D_5_HOS_C5_97,S3_2_C4_17,S3_2_C6_12,D3_SNF_C3_9201,S10_C1_20,S3_1_C7_24,D_5_HOS_C2_50,S4_HHA3_C3_36,S3_2_C6_33,C_1_C6_58,D_1_HOS_C4_31,S3_2_C6_1,S3_2_C4_9,B_1_C0_190,D3_SNF_C3_91,D_4_HOS_C13_65,D3_HOS_C3_91,D3_IPF_C3_51,D3_HOS_C3_59,E_B_HOS_C101_5,S3_1_C7_7,B_1_C0_58,B_1_C0_194,D3_IRF_C2_40,S2_1_C1_48,S3_1_C6_24,B_1_C22_75,S10_C1_26,D_4_HOS_C13_90,D_5_HOS_C5_98,D_4_HOS_C11_93,B_1_C0_17,S4_HHA2_C2_37,D3_SNF_C3_69,D_4_SNF_C11_200,D_5_HOS_C2_94,D_5_HOS_C3_52,D_4_HOS_C3_72,S3_2_C2_1401,A7_1_C2_5,A_C2_192,D1_SNF_C1_74,S10_C3_22,S3_2_C6_2,B_1_C21_56,D_4_HOS_C1_200,A_C1_6250,B_1_C21_115,D_4_IPF_C11_70,A8_C2_21,B_1_C22_51,B_1_C22_72,S10_C3_21,C_1_C6_91,D_3_HOS_C2_200,A_C6_194,B_1_C0_192,D_5_HOS_C3_58,D_4_HOS_C4_200,A_C1_14,C_1_C7_93,S3_1_C12_17,B_1_C26_53,C_1_C7_64,S4_HHA1_C5_36,S5_C1_11,A_C2_99,A_C6_18,D3_SNF_C2_96,S3_2_C6_37,C_1_C6_45,PRVDR_NUM,C_1_C6_71,A_C2_3,D_4_HOS_C11_51,D3_HOS_C2_66,D3_IPF_C3_50,C_1_C6_9910,D_5_HOS_C3_50,D_5_HOS_C7_68,D_4_IRF_C11_69,B_1_C0_88,C_1_C5_202,D_4_IRF_C13_52,S3_3_C4_5,S2_1_C2_1809,A_C1_8,D_5_HOS_C2_62,S3_2_C5_35,D3_HOS_C3_200,A_C6_108,D3_HOS_C3_61,D3_SNF_C3_51,D_1_HOS_C7_200,D_4_IRF_C11_68,B_1_C26_30,D_5_HOS_C6_200,D3_HOS_C2_96,S3_1_C5_1,S3_2_C5_38,C_1_C5_66,B_2_C26_117,A8_C2_3,C_1_C5_4501,S3_2_C6_30,C_1_C7_95,D_5_HOS_C4_9201,S2_1_C1_24,S3_1_C10_1801,B_1_C26_117,D1_IRF_C1_49,B_1_C0_16,D3_SNF_C2_72,A_C1_95,S10_C1_11,D_4_HOS_C13_51,S4_HHA2_C2_33,A_C1_110,D_4_HOS_C11_66,D3_SNF_C2_58,B_2_C26_95,B_2_C26_63,D3_IRF_C3_55,S3_1_C7_1801,S3_1_C8_12,D1_HOS_C1_56,B_2_C26_192,B_2_C26_52,D_4_HOS_C11_60,D3_SNF_C2_31,B_1_C0_98,B_2_C26_115,S3_2_C4_30,S4_HHA2_C5_37,B_1_C22_60,D_1_HOS_C6_30,D3_IPF_C3_91,D_5_HOS_C3_62,A_C2_62,B_1_C22_9201,B_1_C22_45,D3_IPF_C2_52,D_5_HOS_C4_64,C_1_C7_59,B_1_C21_21,B_1_C0_4,A_C6_10,S2_1_C1_127,S3_1_C8_22,A_C2_106,B_2_C26_101,B_1_C21_50,D_5_HOS_C7_63,S3_2_C4_1601,C_1_C7_106,A8_C2_31,D_5_HOS_C4_90,D_5_HOS_C7_96,D_4_IPF_C11_9201,D_5_HOS_C4_200,B_1_C22_52,S3_1_C2_32,B_1_C0_100,D3_IPF_C2_200,S2_1_C1_143,A_C1_64,D3_IRF_C2_91,A_C6_75,S3_1_C6_5,B_1_C0_9910,A_C1_63,S10_C3_23,S3_2_C4_5,D_5_HOS_C5_58,S3_2_C4_10,D_4_HOS_C3_63,S2_1_C1_115,S5_C4_1,D_3_HOS_C9_33,B_1_C0_22,C_1_C6_44,D_5_HOS_C3_95,E_B_HOS_C1_20,B_1_C0_111,S5_C1_14,B_1_C0_115,A7_1_C1_6,A7_1_C1_7,D3_HOS_C2_53,D_4_HOS_C12_60,B_1_C22_54,S4_HHA1_C5_37,A_C1_62,D_4_HOS_C2_71,A_C6_22,S3_2_C4_4,C_1_C6_117,S3_1_C7_10,B_1_C26_116,D_5_HOS_C5_6250,A_C1_69,D_4_IRF_C13_90,B_1_C26_41,D_5_HOS_C5_51,B_2_C26_72,B_1_C26_4201,D_5_HOS_C7_64,D3_HOS_C2_9201,S3_2_C2_25,D3_HOS_C2_6250,S4_HHA2_C5_33,S2_1_C2_7,D_5_HOS_C5_60,S3_2_C4_23,S4_HHA3_C3_38,B_2_C26_33,C_1_C5_57,D_4_IPF_C13_53,D3_SNF_C2_98,A_C6_35,E_B_HOS_C1_39,A_C6_99,S4_HHA2_C4_34,D3_HOS_C2_35,C_1_C5_64,B_1_C0_59,D_4_HOS_C3_74,B_1_C26_89,C_1_C7_9920,D_4_HOS_C13_71,D_4_HOS_C12_73,D_5_HOS_C3_59,S3_1_C13_17,E_B_HOS_C1_15,D_4_HOS_C10_52,D_4_HOS_C11_74,D1_IPF_C1_53,D3_IRF_C3_200,D_4_SNF_C11_9201,D3_SNF_C2_60,A_C6_11,D_4_HOS_C12_66,D_5_HOS_C3_54,B_1_C26_34,D_4_HOS_C13_70,D_4_HOS_C2_9201,C_1_C5_108,A7_1_C3_5,S3_1_C3_17,D_4_HOS_C11_59,S3_3_C6_3,B_1_C21_94,S3_2_C6_13,S2_1_C2_1509,S3_2_C4_43,B_1_C22_99,C_1_C2_67,B_1_C26_4501,S5_C5_2,B_2_C0_202,D_5_HOS_C7_69,D3_SNF_C3_64,C_1_C6_70,D3_IPF_C3_64,D_4_HOS_C3_65,B_1_C21_42,S2_1_C2_16,A_C6_93,A8_C2_1,B_1_C21_93,A7_1_C2_2,E_A_HOS_C1_72,B_1_C0_35,S3_1_C7_16,D_4_IPF_C11_65,D_4_SNF_C11_55,S4_HHA3_C2_33,D1_HOS_C1_41,B_1_C22_106,A_C6_13,S3_2_C6_43,B_1_C26_101,S4_HHA2_C2_34,B_1_C26_44,C_1_C6_41,C_1_C7_58,S4_HHA3_C2_34,A_C2_76,D_4_HOS_C3_60,S3_2_C6_1402,C_1_C5_201,E_B_HOS_C1_41,B_1_C0_55,B_1_C22_112,D3_IPF_C2_9201,S5_C1_6,S2_1_C1_1,D_4_HOS_C10_91,C_1_C7_97,D3_SNF_C3_200,D3_IPF_C3_72,D_4_SNF_C11_67,D3_IRF_C3_56,D_5_HOS_C7_62,D3_IPF_C2_34,B_1_C26_94,D_4_HOS_C11_67,A7_3_C10_1,C_1_C6_110,C_1_C5_75,A_C6_42,A_C2_16,A_C2_17,A_C1_45,A8_C2_18,D_5_HOS_C3_72,D_4_HOS_C2_69,S3_2_C2_28,B_2_C26_51,A_C1_9930,S3_2_C4_11,S4_HHA1_C4_34,D_4_HOS_C13_68,B_1_C26_191,S3_1_C10_19,B_1_C21_64,A_C2_31,B_2_C26_74,D_5_HOS_C2_98,D_4_IPF_C11_64,B_1_C26_68,D3_IRF_C3_73,B_2_C26_193,B_1_C0_4201,D4_LUNG_C1_69,D_5_HOS_C7_72,D_5_HOS_C7_66,S3_3_C5_2,D_4_IPF_C11_55,D1_HOS_C5_44,S3_2_C4_42,S3_3_C2_1,B_2_C26_91,D3_HOS_C2_61,S3_1_C2_24,A7_3_C10_2,A7_1_C1_1,D_4_HOS_C3_56,D3_HOS_C2_62,B_1_C21_41,D_4_HOS_C12_72,A7_1_C5_3,D_5_HOS_C4_96,S3_1_C3_1,S3_2_C4_2552,S3_2_C2_23,D_4_IRF_C11_76,S3_2_C4_8,D_5_HOS_C6_9201,A8_C2_11,S4_HHA1_C3_35,A_C1_58,D_5_HOS_C6_64,S2_1_C1_134,A_C2_71,D_5_HOS_C4_60,E_B_HOS_C1_37,B_1_C22_192,A_C1_32,S3_2_C3_14,D_4_HOS_C4_55,D3_IRF_C2_69,A7_1_C1_10,S5_C4_6,D3_SNF_C2_76,A_C1_52,B_1_C0_32,S3_1_C12_16,S4_HHA1_C3_38,C_1_C7_9201,B_1_C0_200,A7_1_C1_2,B_1_C21_53,D3_HOS_C3_74,D_4_IRF_C13_54,D3_SNF_C2_73,B_1_C26_192,A_C6_114,B_1_C22_70,B_1_C0_31,A_C6_67,D_5_HOS_C7_65,S3_2_C4_39,B_2_C26_96,S3_2_C6_40,B_1_C0_9930,S5_C1_12,C_1_C6_74,S3_3_C4_1,C_1_C7_6250,S2_1_C1_141,S3_2_C4_40,D_4_HOS_C13_50,A7_1_C5_7,S3_3_C2_4,C_1_C6_54,A_C2_9,B_1_C22_88,S4_HHA1_C1_38,D_1_HOS_C7_31,D_4_HOS_C3_98,A7_3_C7_1,C_1_C7_76,E_B_HOS_C101_8,A_C6_88,A7_1_C2_7,D_4_SNF_C11_70,A_C2_11,A_C6_73,B_1_C0_99,A7_3_C6_3,B_2_C26_60,C_1_C6_35,S3_2_C5_37,C_1_C7_90,D_4_HOS_C12_57,C_1_C2_65,D_4_HOS_C4_76,B_1_C21_89,D_4_HOS_C2_68,D3_SNF_C3_68,B_1_C26_9920,D1_IRF_C1_52,A_C1_109,D_4_HOS_C13_91,D3_SNF_C2_55,S3_2_C5_40,D3_HOS_C3_98,A7_1_C5_8,D3_HOS_C2_50,A7_1_C7_2,B_1_C26_73,S3_1_C6_7,S3_2_C6_6,D3_HOS_C2_57,S2_1_C1_140,A_C6_90,D3_HOS_C2_33,D_4_IPF_C11_90,D3_SNF_C2_53,A8_C2_19,D_1_HOS_C4_33,C_1_C6_52,D3_IPF_C2_40,D3_IPF_C3_76,A_C2_15,C_1_C6_106,D_5_HOS_C3_57,D_5_HOS_C5_73,B_2_C26_40,S3_2_C6_16,D3_IPF_C2_35,S3_3_C2_3,S2_1_C2_1524,S2_1_C2_128,D_4_IPF_C13_9201,E_A_HOS_C1_7094,D_4_HOS_C2_63,A_C1_114,B_1_C0_21,S3_2_C4_21,D_4_IRF_C6_200,S3_2_C2_43,S3_1_C13_1,D_4_HOS_C2_76,D3_IPF_C3_69,A8_C2_6,A_C6_9,E_B_HOS_C1_4001,A_C1_6,D_4_IPF_C13_52,D_4_IRF_C11_63,D_4_HOS_C2_93,B_1_C0_193,B_2_C26_99,S10_C1_10,D_4_IPF_C4_200,D_4_HOS_C1_53,S3_1_C6_26,D3_HOS_C3_94,B_1_C22_109,D_5_HOS_C6_54,A8_C2_16,D_4_HOS_C2_56,A_C2_56,S2_1_C2_1519,C_1_C6_94,A_C6_5,D_5_HOS_C4_93,S3_1_C10_14,D_4_IPF_C11_54,S3_1_C8_15,S4_HHA2_C3_36,D_4_HOS_C2_72,A7_3_C9_3,S3_2_C2_34,A_C1_60,D_4_IRF_C13_68,RPT_REC_NUM,A_C2_116,D_4_SNF_C11_76,D_4_HOS_C3_59,D3_HOS_C3_67,D_5_HOS_C7_71,B_1_C26_91,S3_2_C2_2550,D_4_HOS_C10_93,C_1_C5_111,D_4_HOS_C2_88,D_4_HOS_C3_64,D3_IPF_C2_96,D3_SNF_C3_93,A_C6_105,B_2_C26_89,D3_HOS_C2_56,D_4_HOS_C11_73,D_3_HOS_C3_200,B_1_C0_95,D3_IPF_C3_52,S3_2_C2_18,D_4_HOS_C2_65,D3_IPF_C2_67,S3_1_C13_14,B_2_C26_93,D_5_HOS_C3_200,C_1_C5_95,S4_HHA1_C2_37,D_5_HOS_C6_6250,D_4_HOS_C10_54,D_4_IPF_C11_52,A_C2_101,D_5_HOS_C2_60,D_5_HOS_C4_69,D_3_HOS_C9_31,S10_C1_22,S3_1_C5_14,D3_HOS_C3_50,D_5_HOS_C5_71,E_B_HOS_C1_42,S3_2_C2_35,S2_1_C2_140,D_4_HOS_C4_68,S3_2_C5_12,C_1_C6_31,A8_C2_7,D_4_HOS_C11_200,B_1_C22_67,D_4_IRF_C13_55,E_B_HOS_C1_43,B_2_C26_105,D_5_HOS_C6_63,S3_1_C6_16,D3_IPF_C2_56,D_4_SNF_C11_58,D3_IPF_C2_65,A8_C2_12,D_4_HOS_C10_65,C_1_C6_55,D3_IPF_C3_73,D_4_IRF_C13_74,B_2_C26_9940,D_5_HOS_C4_71,D_4_IPF_C13_63,A7_3_C11_1,D_4_HOS_C10_90,S2_1_C1_37,S3_1_C4_9,A_C1_105,D_1_HOS_C4_200,D_5_HOS_C6_75,A_C1_33,D_4_HOS_C13_54,D3_IPF_C2_60,D_4_IRF_C11_50,B_1_C0_94,S3_1_C2_19,D3_SNF_C3_98,A_C2_2,C_1_C5_59,D_3_HOS_C9_40,D_4_IRF_C11_9201,D1_HOS_C1_63,D_4_HOS_C13_9201,S2_1_C2_1807,D1_HOS_C1_37,S2_1_C2_18,B_1_C0_9201,D3_HOS_C2_32,A_C6_55,A7_1_C3_6,D3_SNF_C2_69,S3_3_C6_1,A_C6_100,D3_IRF_C2_60,D_5_HOS_C5_62,S3_3_C6_4,A7_1_C2_4,D_4_HOS_C2_74,B_1_C26_69,C_1_C5_116,D_5_HOS_C7_90,D3_SNF_C2_71,D_5_HOS_C3_64,S3_1_C4_1,D_5_HOS_C7_75,D_4_SNF_C11_90,S2_1_C2_1510,A_C2_90,A_C1_9910,A_C1_88,A_C1_46,B_1_C21_105,B_1_C22_57,D_1_HOS_C7_35,D_4_HOS_C11_57,D_5_HOS_C5_74,B_1_C21_194,E_B_HOS_C1_35,A_C1_101,D3_HOS_C2_58,B_1_C0_91,S4_HHA1_C4_37,B_1_C21_59,D3_SNF_C2_56,D_5_HOS_C6_98,D_4_HOS_C3_68,S2_1_C2_9,D_4_HOS_C4_66,D3_IPF_C2_32,S4_HHA2_C1_35,A7_1_C1_4,S3_1_C6_10,S10_C1_27,S2_1_C1_86,S3_1_C6_32,D_4_HOS_C4_64,D_5_HOS_C6_53,S3_2_C6_38,S3_1_C7_20,C_1_C5_31,C_1_C5_70,B_1_C21_58,D_5_HOS_C2_58,D3_IRF_C3_68,D_5_HOS_C5_200,A_C6_57,S3_1_C9_22,B_1_C0_117,C_1_C6_108,D_4_HOS_C10_51,S4_HHA1_C5_35,B_1_C21_32,D_4_HOS_C13_63,D_4_HOS_C11_94,S4_HHA3_C3_34,A_C6_52,D_5_HOS_C5_63,D3_IRF_C2_73,D_5_HOS_C2_57,B_1_C21_51,D_4_IRF_C11_67,C_1_C7_9910,D_5_HOS_C4_74,C_1_C7_68,D_5_HOS_C6_65,D_5_HOS_C3_66,B_1_C0_62,D3_SNF_C2_30,S3_1_C13_16,D_5_HOS_C3_61,TRNSMTL_NUM,B_1_C22_40,A_C6_9201,S3_1_C3_18,S3_2_C4_3,B_1_C26_45,A7_1_C1_3,D_4_IPF_C13_56,D3_IRF_C2_50,S2_1_C2_1,B_1_C0_50,S3_2_C5_6,D3_HOS_C2_93,S4_HHA2_C4_37,D3_SNF_C2_74,D_4_IRF_C11_90,D_4_HOS_C10_6250,D_4_HOS_C12_67,A_C1_40,C_1_C6_9940,S4_HHA1_C4_38,D_5_HOS_C7_70,A_C6_60,S3_1_C8_6,D3_IPF_C2_57,B_1_C0_23,S2_1_C2_1802,S3_2_C3_2552,D3_IRF_C2_71,D3_IPF_C3_66,A_C6_91,B_1_C0_109,D3_IPF_C2_71,S3_1_C9_21,B_1_C26_115,C_1_C2_68,D_4_HOS_C3_6250,S2_1_C3_3,A_C1_75,S2_1_C2_1504,E_A_HOS_C1_7099,D3_IRF_C2_35,S3_1_C8_10,B_1_C0_20,S4_HHA3_C4_38,S4_HHA1_C3_33,S2_1_C2_1515,S5_C4_3,S2_1_C1_56,D_5_HOS_C6_94,S3_1_C8_25,B_1_C26_71,D3_IRF_C2_94,A_C2_94,D3_IPF_C2_70,D_1_HOS_C6_33,D3_SNF_C2_91,E_B_HOS_C1_40,A7_1_C7_7,B_1_C22_89,S5_C1_3,C_1_C7_89,A_C2_66,B_1_C21_76,S3_2_C6_36,S3_1_C7_18,S3_1_C6_29,D3_SNF_C3_75,S3_2_C6_31,D1_IRF_C1_51,B_1_C0_12,D_4_IPF_C11_59,C_1_C5_32,D3_SNF_C3_55,D_5_HOS_C4_98,D_5_HOS_C3_67,B_1_C0_76,D_1_HOS_C6_200,D_4_IPF_C11_56,S10_C1_9,B_1_C22_74,A_C6_40,S3_1_C9_24,A_C6_54,A_C1_10,D1_IPF_C1_51,D_3_HOS_C9_32,D_4_HOS_C11_65,B_1_C26_74,E_A_HOS_C1_59,D_4_HOS_C4_75,A_C2_91,S3_2_C4_7,A_C6_193,C_1_C5_115,B_1_C26_62,S2_1_C2_132,D_4_HOS_C2_62,D_4_HOS_C3_69,D3_IRF_C2_41,D_5_HOS_C7_200,D_5_HOS_C3_68,D_4_IPF_C13_72,D1_HOS_C1_49,D_4_HOS_C10_9201,D3_IRF_C2_53,A_C2_97,D_4_HOS_C3_55,S3_1_C5_11,D_5_HOS_C7_50,D_4_HOS_C4_70,C_1_C5_52,D_4_HOS_C4_53,S3_1_C3_1801,S3_2_C5_2,S3_1_C3_9,S3_1_C7_8,S5_C3_2,D_4_HOS_C3_66,B_2_C26_68,S3_1_C8_1,B_1_C22_111,E_B_HOS_C1_36,B_1_C21_57,B_1_C0_75,A_C6_50,B_2_C26_110,S3_1_C6_15,B_1_C26_99,D_4_HOS_C2_200,C_1_C7_9930,C_1_C6_99,D1_IPF_C1_41,S2_1_C2_129,C_1_C5_41,A_C2_13,S3_3_C5_6,D3_IRF_C3_65,S4_HHA1_C2_35,S3_1_C5_13,S3_1_C15_14,S3_1_C7_32,D3_IPF_C3_54,D1_HOS_C1_58,D_1_HOS_C7_34,S3_1_C7_12,S3_1_C8_19,B_2_C26_66,B_1_C22_107,S4_HHA1_C1_36,D1_HOS_C1_51,S4_HHA2_C5_38,S10_C1_15,B_1_C0_34,S5_C2_1,D_4_IRF_C11_55,A7_3_C15_2,A_C6_110,S4_HHA1_C1_35,S2_1_C1_106,B_1_C26_31,B_1_C26_60,B_1_C0_46,A7_1_C1_5,A_C6_4,D_5_HOS_C2_93,C_1_C7_100,A_C6_16,D_5_HOS_C5_53,D3_SNF_C2_67,D_4_HOS_C10_55,B_2_C26_90,C_1_C5_96,D1_HOS_C5_43,A_C1_193,D_1_HOS_C6_31,S3_2_C2_2,A8_C2_27,S2_1_C2_1606,B_1_C22_76,C_1_C6_90,A_C2_115,C_1_C6_4501,A_C6_94,A_C6_200,D3_IRF_C3_90,S10_C1_16,D_4_HOS_C13_56,D_5_HOS_C5_54,D_4_HOS_C13_72,S10_C1_31,B_1_C26_112,C_1_C5_61,D_5_HOS_C5_56,A7_1_C5_4,D3_IPF_C2_74,A_C6_20,C_1_C5_200,D4_ISLET_C1_69,D3_IPF_C2_73,D_4_HOS_C3_73,S2_1_C2_142,B_2_C26_31,S2_1_C1_108,S3_2_C5_32,A_C2_20,D_4_IPF_C13_60,D3_HOS_C3_57,D3_HOS_C2_41,D3_IPF_C2_93,A_C1_7,MSA,D3_HOS_C3_68,S3_2_C5_33,D_5_HOS_C7_73,A_C6_76,D3_IRF_C3_70,A7_3_C9_1,B_1_C22_32,D_4_SNF_C11_69,D_5_HOS_C2_56,S3_2_C3_25,S3_1_C3_7,D_4_IPF_C11_71,A_C2_60,S3_2_C2_38,A_C6_69,B_2_C26_53,D_4_SNF_C11_57,A_C2_57,D_4_HOS_C10_75,D_4_HOS_C13_76,A_C6_6250,C_1_C6_57,D3_SNF_C2_35,A_C1_55,D_5_HOS_C5_76,S3_2_C3_1401,D_4_IPF_C13_51,D3_HOS_C3_71,D3_IPF_C3_60,S3_2_C5_28,D3_HOS_C3_54,B_1_C26_110,B_1_C21_191,S3_2_C4_24,B_1_C26_6250,S3_2_C4_2553,S4_HHA3_C1_35,D3_HOS_C3_73,D3_IRF_C3_64,S2_1_C2_130,D_4_SNF_C11_50,D_4_HOS_C12_97,D_4_IRF_C13_56,B_2_C26_35,S2_1_C2_1508,A7_3_C5_2,D3_IPF_C2_68,D1_HOS_C1_53,A_C1_117,S2_1_C2_1511,S3_2_C4_1402,A_C6_117,B_1_C26_70,A_C2_88,D_4_HOS_C3_94,D3_HOS_C2_51,D_5_HOS_C3_60,S4_HHA3_C4_37,B_1_C26_54,A_C6_15,D3_IRF_C2_75,S2_1_C2_1513,S2_1_C2_1601,D3_IPF_C2_59,A_C2_19,A_C6_111,D3_SNF_C2_62,S10_C1_18,D_4_HOS_C3_67,A_C1_56,B_1_C21_68,D_3_HOS_C9_35,S3_1_C8_20,D_4_HOS_C10_98,S3_1_C14_17,A_C6_64,A7_1_C7_10,B_1_C0_9,D_4_IRF_C11_51,B_1_C22_66,A_C6_46,D_4_IPF_C13_69,E_B_HOS_C1_1,D_5_HOS_C4_67,D_5_HOS_C7_67,A7_3_C15_1,S3_2_C4_34,S3_1_C4_8,A8_C2_26,D3_HOS_C2_63,B_1_C26_202,S10_C1_14,S3_1_C10_21,D_4_HOS_C10_64,B_2_C26_9930,C_1_C7_115,B_1_C22_62,S4_HHA1_C3_34,D3_IRF_C3_63,S10_C2_20,E_B_HOS_C1_12,S3_2_C5_30,D_4_IPF_C11_62,D3_HOS_C3_51,S2_1_C2_2,B_1_C21_67,D_1_HOS_C4_35,D3_IPF_C3_63,D_3_HOS_C9_30,S4_HHA1_C1_33,C_1_C5_9940,D1_HOS_C1_55,D3_IRF_C2_93,D_5_HOS_C2_59,D_4_IPF_C3_200,A_C2_32,A_C2_4501,S3_1_C14_16,D3_IPF_C3_67,S10_C1_23,E_B_HOS_C1_21,B_1_C26_194,A_C6_98,S3_1_C5_9,C_1_C6_43,B_2_C26_100,D3_IPF_C3_57,C_1_C7_107,D3_HOS_C3_70,E_B_HOS_C1_19,D_4_HOS_C13_97,D_5_HOS_C7_94,S3_1_C2_11,S3_1_C9_27,A_C1_54,B_1_C21_107,S5_C1_9,S3_1_C2_16,S3_1_C11_22,D_5_HOS_C5_70,S5_C3_6,D_4_HOS_C4_69,A_C1_50,D_4_HOS_C13_55,A_C6_8,D_1_HOS_C4_43,D_1_HOS_C7_41,D_4_HOS_C11_55,D_5_HOS_C3_94,S2_1_C2_3601,S3_2_C4_12,A_C6_4201,B_1_C22_35,D_4_IRF_C11_74,D3_IRF_C2_65,S3_2_C4_31,B_1_C0_14,D_4_IRF_C13_66,D3_IPF_C2_55,A_C2_59,D3_SNF_C3_59,D_5_HOS_C7_9201,D_5_HOS_C2_9201,A8_C2_8,B_1_C0_52,S3_2_C6_39,D_4_HOS_C3_75,D3_IRF_C2_64,D3_SNF_C3_94,A_C2_6,A7_3_C10_3,S2_1_C2_8,S3_1_C5_12,S4_HHA2_C4_33,D_4_HOS_C10_73,D3_SNF_C2_94,B_1_C21_46,S3_1_C10_22,D_4_HOS_C12_59,D3_HOS_C3_9201,S3_1_C14_14,D_5_HOS_C3_90,A8_C2_5,C_1_C5_88,S10_C2_22,D_5_HOS_C7_91,B_1_C22_69,B_1_C22_94,D3_HOS_C2_75,C_1_C6_63,B_1_C21_70,S3_1_C11_24,C_1_C5_98,S3_2_C4_13,S3_1_C2_10,B_1_C26_56,D3_HOS_C2_91,S2_1_C3_11801,D_4_IPF_C11_91,D_4_IPF_C6_200,B_1_C0_89,C_1_C5_99,D_4_HOS_C10_53,A7_1_C5_2,S3_1_C3_24,D_4_SNF_C11_64,S3_2_C5_3,D_4_HOS_C3_53,D_4_IPF_C11_60,A8_C2_28,C_1_C5_9930,D3_IRF_C2_54,D3_IRF_C2_55,D3_IRF_C3_58,S3_2_C4_20,B_1_C21_35,D_5_HOS_C6_66,B_1_C0_18,A7_3_C7_3,D_4_IRF_C13_71,S3_1_C15_17,A_C2_51,S3_1_C3_11,S3_1_C3_2001,D_4_IPF_C13_57,D3_IPF_C2_91,S5_C3_1,B_1_C0_191,D_3_HOS_C6_200,D3_IPF_C2_50,B_1_C0_7,D3_IPF_C2_90,D3_SNF_C2_90,B_1_C0_73,S3_1_C9_19,A7_1_C6_7,D_4_HOS_C1_76,D3_SNF_C2_9201,B_1_C22_95,D1_HOS_C1_26,S3_1_C8_7,D1_HOS_C1_62,S2_1_C3_24,B_1_C22_46,S3_1_C8_24,D_4_IRF_C13_72,D3_IRF_C2_31,A_C1_4201,D_5_HOS_C3_6250,S3_1_C3_32,D3_IRF_C2_67,S2_1_C2_1201,D1_HOS_C1_52,B_2_C26_69,D_1_HOS_C7_40,S2_1_C2_1804,S3_1_C6_2,A_C2_45,S3_1_C7_19,B_1_C22_93,D1_IPF_C1_49,D3_HOS_C3_72,A8_C2_13,D3_IPF_C2_69,D_5_HOS_C2_54,D_4_HOS_C2_98,D_5_HOS_C6_58,D_4_IRF_C11_93,CENSUS,S3_1_C15_21,A_C1_57,D_1_HOS_C4_32,D_4_IRF_C13_53,C_1_C5_30,B_1_C0_65,D_1_HOS_C7_32,C_1_C3_202,D3_SNF_C3_74,D3_HOS_C2_74,D_4_IRF_C11_58,D_3_HOS_C8_200,S3_2_C4_2201,B_1_C26_40,D_4_HOS_C1_50,E_B_HOS_C1_33,B_1_C0_60,S4_HHA2_C3_34,D_5_HOS_C6_55,S5_C2_6,D_5_HOS_C5_68,A_C2_64,B_1_C26_96,C_1_C6_59,D_5_HOS_C7_60,C_1_C7_109,S4_HHA3_C2_35,B_1_C0_96,S3_1_C6_22,B_2_C26_71,D3_HOS_C2_54,S4_HHA3_C1_34,S3_2_C5_13,S3_2_C6_35,D_4_HOS_C10_56,D_4_IRF_C11_59,A_C2_93,D_4_HOS_C10_70,B_1_C22_41,D_5_HOS_C4_58,S3_2_C4_25,S3_2_C4_35,C_1_C5_44,S3_2_C2_27,C_1_C7_88,B_1_C0_66,B_1_C26_93,S3_1_C10_18,A_C6_190,A_C6_56,B_1_C22_31,B_1_C0_64,A7_1_C2_10,A_C1_18,B_1_C26_201,D_4_IPF_C13_50,S3_1_C4_10,B_1_C26_100,B_1_C21_9201,D_5_HOS_C7_57,E_B_HOS_C1_11,A_C2_70,D_4_HOS_C12_75,S3_1_C2_18,D_1_HOS_C6_40,S3_1_C5_16,S3_2_C3_2550,A7_1_C3_2,S2_1_C1_4,D_4_IPF_C11_53,S3_1_C6_25,S3_2_C5_34,B_1_C21_31,D3_IPF_C2_66,S4_HHA3_C2_37,B_2_C26_65,D1_IPF_C1_27,FI_NUM,A7_1_C5_6,S2_1_C2_1202,D_5_HOS_C6_68,D3_HOS_C2_90,B_1_C26_88,D_4_HOS_C13_75,A_C2_67,B_1_C0_112,D3_IRF_C3_74,S5_C2_21,D3_IPF_C3_9201,D_4_IRF_C11_70,D1_SNF_C1_85,A_C1_76,D_4_HOS_C13_64,D_4_IPF_C13_55,S2_1_C1_85,S3_3_C6_5,B_1_C0_43,D_4_HOS_C10_71,E_B_HOS_C1_5,C_1_C5_35,B_1_C26_59,C_1_C6_76,A_C2_52,D3_IRF_C2_63,D_5_HOS_C3_96,A_C2_200,B_2_C26_190,A_C6_62,B_2_C26_98,C_1_C5_58,B_1_C0_42,B_1_C26_106,S4_HHA1_C5_38,A_C2_53,UTIL_CODE,S3_2_C6_27,D_4_HOS_C12_58,D_4_HOS_C3_93,D_4_SNF_C11_52,B_1_C0_110,B_2_C26_55,C_1_C6_93,C_1_C6_64,D_5_HOS_C7_54,S3_1_C2_9,D_5_HOS_C4_68,S3_1_C5_20,S2_1_C2_1506,D_4_IPF_C13_59,C_1_C5_100,D_4_HOS_C10_50,S3_1_C5_19,D_4_IRF_C13_91,D3_SNF_C3_58,C_1_C7_9940,A_C1_98,D_5_HOS_C3_76,A_C6_1,D_5_HOS_C2_65,A_C2_4,A8_C2_20,D_5_HOS_C6_93,D_4_HOS_C12_71,B_1_C26_65,B_1_C21_55,D3_HOS_C3_69,C_1_C5_56,D3_SNF_C3_56,D_1_HOS_C4_40,E_B_HOS_C1_38,S4_HHA2_C3_38,C_1_C5_67,S10_C1_21,C_1_C5_110,D_5_HOS_C6_69,A_C2_33,D_4_IPF_C11_66,E_B_HOS_C1_25,B_1_C0_57,D_4_HOS_C4_65,S3_2_C2_2552,D_4_SNF_C11_54,S3_1_C5_8,B_1_C26_51,B_1_C26_90,S3_2_C4_1602,S4_HHA1_C1_34,S3_1_C3_10,B_1_C26_67,S5_C1_21,D_5_HOS_C7_6250,D_4_IRF_C13_62,D_4_HOS_C12_96,D_1_HOS_C4_30,C_1_C7_72,A_C2_50,D_4_HOS_C3_96,A_C1_90,S3_3_C5_7,D_5_HOS_C4_54,S3_2_C2_26,S3_1_C3_8,S3_2_C2_5,S4_HHA1_C3_36,S3_1_C8_2001,A_C1_12,D3_HOS_C3_90,B_1_C26_57,S3_2_C4_32,C_1_C5_109,C_1_C5_62,C_1_C7_63,D_4_HOS_C2_52,C_1_C7_108,B_2_C26_97,D_4_HOS_C3_90,D3_IPF_C3_56,D3_IRF_C2_72,B_1_C26_33,D_5_HOS_C4_62,S3_2_C5_1,S3_3_C4_4,D3_IPF_C2_76,B_1_C22_64,A_C1_194,C_1_C6_4201,A8_C2_10,C_1_C5_60,C_1_C5_90,A_C1_74,A_C2_73,D3_IPF_C3_94,A_C2_98,S3_1_C7_1,C_1_C7_52,D3_SNF_C3_52,S2_1_C2_1502,B_1_C21_65,A_C2_30,D_5_HOS_C3_91,B_1_C22_63,A8_C2_15,D_5_HOS_C7_52,B_1_C22_58,D_5_HOS_C7_56,A_C2_61,D_5_HOS_C2_51,S3_2_C2_13,D_4_HOS_C4_52,S3_1_C8_5,D3_IRF_C3_96,D3_HOS_C3_58,A_C6_9930,E_B_HOS_C1_24,D_4_HOS_C11_52,A_C6_41,D_4_HOS_C2_70,B_1_C22_71,D_5_HOS_C2_70,A8_C2_17,B_2_C26_41,D3_SNF_C3_65,D3_SNF_C3_73,D_4_HOS_C4_90,S2_1_C2_1503,S2_1_C2_1604,S5_C5_1,A_C1_70,S3_1_C2_1,D_4_IRF_C13_63,D_5_HOS_C3_74,A_C6_66,S5_C6_4,S3_1_C15_1,D_4_HOS_C3_58,D_4_SNF_C11_75,S10_C1_17,A_C2_9940,S3_2_C2_20,D_5_HOS_C4_75,S3_1_C11_21,A7_1_C5_10,D3_IPF_C2_64,D_4_HOS_C13_59,D_4_HOS_C4_51,S3_1_C10_27,S3_2_C2_2553,D3_IPF_C2_62,B_1_C21_73,S3_3_C6_2,D_5_HOS_C6_59,B_1_C0_69,S5_C2_5,D3_IRF_C2_62,S2_1_C2_1517,A_C2_105,A_C2_69,S10_C3_20,A7_3_C9_2,D_5_HOS_C6_95,E_B_HOS_C1_27,S2_1_C2_4,A_C6_191,D3_HOS_C3_96,S3_1_C7_13,D3_IRF_C3_53,S3_2_C2_37,D_5_HOS_C3_70,E_B_HOS_C1_23,S3_2_C3_23,D_4_HOS_C12_54,D3_IRF_C3_91,E_B_HOS_C101_4,D_5_HOS_C6_72,D_4_IPF_C11_72,B_2_C26_4501,D_5_HOS_C2_74,D3_IRF_C3_54,S10_C1_13,E_B_HOS_C1_3998,C_1_C7_73,S2_1_C2_36,C_1_C5_50,B_1_C22_98,B_1_C21_69,D3_SNF_C2_75,S2_1_C2_1401,C_1_C5_105,A8_C2_14,A_C2_21,A_C2_34,C_1_C6_9930,S3_1_C8_16,S3_1_C2_21,A_C2_89,D_1_HOS_C4_42,A_C1_94,A_C6_4501,B_1_C26_35,D3_HOS_C3_6250,S3_1_C6_12,A_C6_32,S4_HHA3_C5_36,B_1_C0_101,S3_1_C13_18,D_1_HOS_C4_4201,S3_2_C6_29,A_C6_14,D_5_HOS_C2_90,C_1_C5_54,S3_1_C3_12,D3_SNF_C2_65,D_5_HOS_C2_91,D_4_IRF_C11_56,D3_IRF_C3_72,D_4_HOS_C2_94,D_5_HOS_C4_6250,D3_IPF_C2_63,D_4_HOS_C11_91,D3_IRF_C2_52,C_1_C6_53,S3_1_C8_18,D3_IPF_C2_31,S3_2_C5_36,B_1_C26_111,S3_1_C5_7,B_1_C21_74,S4_HHA3_C5_38,S3_1_C2_20,A_C2_4201,D3_SNF_C3_66,D_5_HOS_C4_52,S3_2_C6_15,A_C6_192,A7_1_C1_8,D_5_HOS_C5_64,B_1_C26_9940,A_C2_75,D4_INTESTINE_C1_69,B_1_C26_32,S3_2_C3_2551,A_C2_74,S3_1_C8_13,S3_2_C2_3,C_1_C7_111,S3_2_C4_1,S4_HHA2_C5_35,A_C6_23,C_1_C6_66,D_4_IPF_C11_73,S10_C1_1,D_5_HOS_C6_73,D_4_IRF_C13_59,C_1_C6_98,S2_1_C1_128,D_4_HOS_C2_75,A7_3_C15_3,D_4_HOS_C12_65,B_2_C26_73,D1_HOS_C1_48,A_C2_9910,S10_C1_19,S2_1_C1_35,B_1_C26_98,S2_1_C2_3801,D_4_SNF_C11_66,S3_1_C8_8,S4_HHA1_C2_33,A_C1_89,D3_IPF_C3_68,C_1_C5_89,C_1_C7_66,D_4_HOS_C2_55,D_5_HOS_C5_96,B_1_C21_40,C_1_C7_50,D_4_IPF_C13_71,S2_1_C2_1801,A_C6_107,B_2_C26_50,S4_HHA3_C5_35,S4_HHA2_C4_36,D_5_HOS_C4_94,A_C2_194,B_1_C26_50,D_4_HOS_C13_73,D_4_IRF_C13_93,D3_HOS_C2_71,B_1_C22_55,D_4_HOS_C13_52,S2_1_C1_3801,A_C2_42,C_1_C6_89,B_1_C0_90,C_1_C5_76,D_5_HOS_C2_52,S3_1_C10_20,S3_1_C11_20,S3_1_C6_1,D3_HOS_C2_60,S3_1_C10_25,D3_HOS_C2_76,A_C6_21,C_1_C6_100,D_4_IRF_C11_200,S3_1_C3_20,D1_IRF_C1_41,B_1_C22_73,D_4_HOS_C10_62,D3_HOS_C2_97,D_5_HOS_C3_65,B_1_C21_193,D_4_HOS_C10_63,C_1_C6_9201,B_1_C21_101,S2_1_C3_2,A_C1_21,D3_SNF_C3_53,D3_IRF_C2_76,S2_1_C2_127,D3_IRF_C3_71,S3_1_C2_7,D_4_HOS_C12_69,S2_1_C1_93,D_5_HOS_C2_76,D1_IRF_C1_50,D_5_HOS_C2_53,S2_1_C2_1520,S3_1_C7_25,D_5_HOS_C2_96,A_C2_6250,B_1_C0_108,S3_2_C4_14,D_5_HOS_C3_93,S2_1_C2_1521,D1_IRF_C1_48,B_1_C0_54,S3_3_C4_6,A8_C2_50,B_1_C26_66,D3_SNF_C3_63,B_1_C0_40,E_B_HOS_C1_14,C_1_C5_45,D3_IRF_C2_57,D_5_HOS_C2_72,D_4_HOS_C12_51,B_1_C22_34,A7_1_C3_10,D3_HOS_C2_69,D_5_HOS_C5_59,S3_1_C5_10,C_1_C5_9201,D_4_IPF_C13_93,S2_1_C1_129,A8_C2_4,S4_HHA1_C2_38,S3_2_C3_22,S3_2_C6_7,D_5_HOS_C2_67,A_C2_114,A7_1_C3_1,C_1_C6_46,S2_1_C6_24,D_5_HOS_C5_69,B_1_C22_33,S3_1_C4_12,S4_HHA3_C5_34,D_5_HOS_C3_71,B_1_C22_44,B_1_C22_100,D_4_HOS_C2_50,S3_1_C8_11,S3_2_C2_14,A_C1_65,D3_IPF_C2_94,A7_1_C7_1,D_4_IRF_C13_76,A_C2_18,A_C2_111,C_1_C7_98,D_4_SNF_C13_200,D_4_HOS_C10_66,D_1_HOS_C7_33,D3_IRF_C2_74,S2_1_C1_142,C_1_C7_101,D_5_HOS_C5_57,D3_HOS_C2_52,D_4_HOS_C6_200,C_1_C7_53,D_4_HOS_C4_72,D1_IRF_C1_27,S3_1_C7_9,S2_1_C2_1522,S3_2_C2_32,D3_HOS_C3_62,REGION,B_2_C26_9201,A_C6_3,D3_IRF_C2_68,E_B_HOS_C1_10,A_C2_68,C_1_C6_97,D3_SNF_C2_50,C_1_C6_101,D_4_HOS_C4_73,S10_C1_2701,A_C2_108,S3_2_C2_21,A8_C2_33,D_4_HOS_C10_60,D_4_HOS_C4_54,D_4_IPF_C13_70,S3_1_C10_26,D3_SNF_C2_40,A_C1_99,D_5_HOS_C5_9201,S3_2_C5_11,D_4_IRF_C11_71,S3_2_C2_41,S4_HHA3_C1_33,S3_1_C6_11,A_C1_72,D_4_SNF_C11_91,D_5_HOS_C3_56,S2_1_C2_1516,D_5_HOS_C3_63,A_C2_95,D4_PANCREAS_C1_69,A_C1_91,B_1_C22_190,B_2_C26_32,B_1_C26_61,D_5_HOS_C6_67,C_1_C5_43,S3_2_C2_12,S2_1_C2_14,A7_1_C2_3,D_4_HOS_C10_96,A_C2_96,A_C2_107,E_B_HOS_C1_3,S3_2_C2_11,B_1_C21_34,D_4_IRF_C13_60,S4_HHA2_C1_38,A_C1_190,S3_2_C5_31,D_5_HOS_C4_76,S3_2_C4_26,B_1_C0_116,D3_IRF_C2_96,D_4_HOS_C11_53,S3_2_C5_8,S3_3_C2_5,D_4_HOS_C3_88,A_C6_12,D_4_HOS_C4_50,S3_1_C8_9,D3_IPF_C3_75,D_4_HOS_C11_69,S3_2_C2_22,B_1_C26_42,B_1_C22_30,S2_1_C2_11801,D_5_HOS_C2_75,D3_SNF_C2_57,B_1_C22_91,B_1_C21_117,C_1_C6_6250,D_4_HOS_C4_67,C_1_C7_112,D_5_HOS_C2_73,C_1_C5_6250,E_B_HOS_C1_13,D3_IPF_C3_93,S3_2_C2_15,A_C1_19,D_5_HOS_C5_67,E_A_HOS_C1_7093,D_4_HOS_C2_66,D_4_IPF_C11_57,S3_2_C5_16,D3_SNF_C2_68,S3_2_C5_10,D_5_HOS_C6_51,D3_SNF_C3_90,D_5_HOS_C7_76,S2_1_C2_1607,S4_HHA1_C5_34,D_4_HOS_C2_58,S3_1_C12_1,S3_1_C12_14,B_1_C22_108,D_4_HOS_C2_57,A7_3_C11_3,A7_1_C3_4,D_4_HOS_C12_6250,S10_C1_12,D_5_HOS_C4_66,S3_2_C6_1401,D_4_IPF_C13_58,S3_2_C4_28,C_1_C6_96,E_B_HOS_C1_2,B_2_C26_112,D_5_HOS_C6_56,S4_HHA2_C3_33,B_1_C26_52,D_4_HOS_C2_67,S3_1_C8_32,D_5_HOS_C3_98,B_1_C0_13,S2_1_C2_1514,D_4_SNF_C11_73,D3_IPF_C3_53,C_1_C6_105,S5_C1_5,A_C2_5,D_4_HOS_C13_58,S3_2_C4_16,B_1_C22_115,D3_HOS_C3_66,S3_2_C6_5,S10_C1_2,D_5_HOS_C3_97,D3_HOS_C3_65,A_C1_34,D_4_HOS_C12_94,D_5_HOS_C2_69,D3_IPF_C2_75,C_1_C6_73,S3_3_C4_3,E_B_HOS_C1_9,D_4_HOS_C2_73,D_4_HOS_C11_62,D_4_HOS_C10_72,S3_1_C9_14,C_1_C6_109,A_C2_72,D_4_IRF_C13_73,E_B_HOS_C1_29,D3_IRF_C3_51,S3_1_C2_8,B_2_C26_202,S3_2_C2_30,B_2_C26_58,D3_HOS_C2_34,D3_IRF_C2_34,D3_SNF_C3_60,S3_1_C10_24,S3_2_C4_2,A_C1_9940,D_5_HOS_C4_55,S2_1_C2_1507,S2_1_C2_13,B_1_C0_41,S5_C1_10,S2_1_C1_3,A_C2_41,S4_HHA3_C4_33,C_1_C5_93,D_4_IRF_C11_72,FY_END_DT,B_1_C21_98,C_1_C6_34,A7_1_C7_3,D3_IRF_C2_32,S5_C2_8,B_1_C26_193,D3_IRF_C3_59,S3_1_C3_16,D_4_HOS_C11_50,D_4_IPF_C13_91,A_C6_116,C_1_C5_112,A_C6_7,D3_IPF_C2_33,A_C1_71,S5_C1_1,D3_HOS_C2_42,D_4_HOS_C12_68,E_B_HOS_C1_8,D3_IRF_C2_56,B_1_C26_97,D3_HOS_C2_65,S3_2_C5_5,S3_3_C5_3,A_C6_106,S3_2_C4_27,C_1_C7_55,D_4_HOS_C4_71,B_1_C21_75,D_4_HOS_C13_98,D_4_IRF_C13_50,D_5_HOS_C6_74,S3_3_C2_6,D3_IRF_C2_59,A_C6_45,D_4_IRF_C13_69,C_1_C6_115,A_C6_63,D_1_HOS_C4_41,A8_C2_24,S4_HHA1_C4_36,D_4_HOS_C4_91,D3_IPF_C2_72,A_C6_96,D3_HOS_C2_73,D3_SNF_C2_59,C_1_C7_54,S3_1_C2_27,D_5_HOS_C7_74,C_1_C6_50,C_1_C7_65,D_4_HOS_C2_64,C_1_C6_32,D1_IRF_C1_53,D3_IPF_C3_59,A_C6_58,C_1_C7_202,D3_IRF_C3_50,C_1_C5_46,S4_HHA2_C5_36,D_4_HOS_C12_93,D_4_IRF_C3_200,B_1_C0_15,B_2_C26_45,D_5_HOS_C4_72,B_1_C21_45,D_4_SNF_C11_53,A_C1_9,S3_2_C2_7,D_5_HOS_C4_59,S5_C1_7,A_C2_113,A_C6_74,S4_HHA3_C4_35,A_C1_66,E_B_HOS_C1_30,D3_IRF_C3_93,A_C2_190,D_4_HOS_C11_75,D_5_HOS_C6_71,B_2_C26_43,B_1_C22_194,D3_HOS_C3_55,B_1_C0_68,D_4_SNF_C11_93,S3_1_C7_2001,S3_1_C10_2001,D_5_HOS_C2_63,A7_3_C5_1,B_1_C21_88,C_1_C7_60,D_4_HOS_C4_88,D3_IPF_C2_98,C_1_C5_73,D_5_HOS_C5_90,D3_IPF_C2_53,RPT_STUS_CD,C_1_C6_68,B_1_C21_99,A_C6_19,D3_SNF_C3_57,A_C1_97,B_2_C26_200,S3_2_C6_14,C_1_C6_69,A7_3_C11_2,B_1_C0_11,S2_1_C2_1518,D3_IRF_C3_98,S4_HHA2_C2_38,S3_2_C4_37,S3_1_C15_16,B_1_C0_19,D3_SNF_C2_202,D1_HOS_C1_50,B_1_C26_76,D_4_HOS_C12_62,S3_2_C2_33,S4_HHA3_C4_36,D_4_HOS_C11_56,C_1_C7_110,A_C1_4,D_4_IRF_C11_64,D3_HOS_C3_53,D3_IRF_C2_70,S3_2_C4_18,S3_1_C6_9,D_4_IPF_C11_76,D3_IRF_C2_200,A_C1_51,D_4_IRF_C11_54,A_C2_65,D_1_HOS_C6_41,A_C1_100,S2_1_C2_1602,B_1_C26_108,A_C1_96,D3_IPF_C2_54,D3_IRF_C3_94,C_1_C5_65,C_1_C7_116,A_C1_106,FY_BGN_DT,S3_2_C6_42,D_5_HOS_C6_76,D3_HOS_C2_67,S2_1_C1_144,S10_C2_21,D_4_IPF_C13_67,S3_3_C4_2,S3_1_C7_11,B_1_C21_90,D3_HOS_C3_52,D3_SNF_C3_96,B_1_C21_30,C_1_C5_117,E_B_HOS_C1_17,D_4_HOS_C4_60,E_B_HOS_C1_16,B_1_C21_43,D_4_HOS_C4_74,D_4_HOS_C1_73,B_2_C26_106,D_4_HOS_C2_54,D_4_IPF_C11_63,D3_IRF_C3_61,D_4_HOS_C3_200,S3_3_C5_1,D3_IPF_C3_62,D_4_IPF_C1_200,D3_IRF_C3_66,S3_2_C5_42,A_C2_54,A_C2_10,B_2_C26_194,D_4_HOS_C10_76,A_C6_95,C_1_C5_40,S2_1_C2_1603,A_C2_109,A7_1_C7_6,B_1_C0_67,D3_SNF_C3_76,C_1_C5_34,A_C2_9930,D_4_SNF_C11_65,D_5_HOS_C4_56,E_B_HOS_C101_7,C_1_C5_71,S3_2_C6_10,S4_HHA3_C1_38,D_4_HOS_C10_68,A7_1_C7_5,D3_SNF_C3_50,A7_1_C3_8,S3_1_C8_1801,B_1_C0_30,B_2_C26_56,D_5_HOS_C2_55,B_2_C26_76,D_5_HOS_C6_60,S2_1_C1_126,D_5_HOS_C6_52,S3_1_C3_19,S3_1_C11_27,S3_2_C5_27,S3_2_C5_43,S3_2_C2_2201,S3_1_C8_14,E_B_HOS_C101_6,S3_1_C6_14,A_C1_53,S2_1_C2_1402,D_4_HOS_C12_98,D_5_HOS_C7_98,S2_1_C2_17,D1_HOS_C1_27,D3_SNF_C2_32,S2_1_C1_131,S2_1_C2_1512,C_1_C6_112,B_1_C0_10,S2_1_C3_143,S2_1_C2_1523,D_4_IPF_C13_74,E_B_HOS_C1_22,D_4_IRF_C11_52,D_5_HOS_C6_61,A_C6_34,C_1_C7_74,D1_HOS_C5_46,D3_IRF_C3_67,C_1_C7_105,C_1_C5_101,D_4_IRF_C11_65,A7_3_C5_3,D_4_HOS_C11_98,B_1_C21_192,S2_1_C1_132,D1_SNF_C1_84,B_1_C0_106,D3_HOS_C3_93,A_C1_20,A_C2_44,D_4_HOS_C3_50,D_5_HOS_C7_55,D3_HOS_C3_97,B_1_C21_108,S4_HHA1_C5_33,S2_1_C4_2,D_5_HOS_C4_57,B_1_C21_60,D_5_HOS_C3_9201,D3_SNF_C3_54,D_4_HOS_C4_56,B_1_C0_93,A7_1_C7_4,B_1_C21_62,C_1_C6_56,B_1_C21_116,D_4_HOS_C11_68,B_2_C26_88,S3_2_C5_7,D3_IRF_C2_58,A8_C2_22,S3_1_C14_18,S3_1_C8_17,S3_1_C4_7,A7_3_C6_2,D_4_IPF_C13_62,D_4_SNF_C11_68,S2_1_C1_11801,A8_C2_9,B_1_C22_53,D_4_HOS_C10_57,A_C6_61,A7_3_C6_1,S3_2_C2_40,B_1_C21_63,S3_2_C4_1401,S3_2_C2_16,B_2_C26_67,D3_HOS_C2_30,S3_1_C6_19,D_4_IPF_C11_68,A_C2_35,B_1_C0_61,D_4_IPF_C11_50,D_4_HOS_C12_90,D3_HOS_C2_43,D_4_HOS_C2_59,C_1_C6_51,A_C6_31,S5_C4_4,S3_2_C2_2551,D_5_HOS_C3_69,A_C1_42,D_4_HOS_C3_91,E_B_HOS_C1_32,D_1_HOS_C6_34,B_2_C26_64,S3_2_C5_15,B_1_C26_63,B_1_C21_109,D_4_HOS_C3_52,D_4_SNF_C11_59,D_4_HOS_C3_62,A_C6_65,D_5_HOS_C6_97,D_5_HOS_C2_6250,D_4_IRF_C13_58,E_B_HOS_C1_34,D_4_SNF_C11_72,C_1_C6_42,S3_2_C4_2551,D_4_HOS_C10_58,A_C6_71,S5_C6_2,D_4_IPF_C11_67,D1_SNF_C1_37,E_B_HOS_C1_31,A_C2_100,D_4_HOS_C10_69,D1_HOS_C1_57,S3_3_C2_2,D_3_HOS_C9_200,D3_SNF_C3_62,S4_HHA3_C3_33,D3_HOS_C2_98,S3_2_C6_11,S3_1_C2_2001,S3_1_C6_8,B_1_C26_55,A7_3_C7_2,D1_IPF_C1_50,D3_IRF_C2_66,A_C1_43,C_1_C7_99,B_1_C22_117,S5_C3_3,D_4_HOS_C13_66,B_1_C22_193,D_4_SNF_C11_71,D_4_HOS_C11_76,C_1_C5_42,B_1_C0_72,A_C1_200,S2_1_C1_22,D_4_HOS_C2_51,S5_C2_7,D1_HOS_C5_45,D3_IRF_C2_33,S3_2_C2_29,C_1_C5_69,B_1_C0_6,S3_2_C2_39,A_C1_111,S5_C6_1,D_5_HOS_C2_64,C_1_C6_95,B_1_C0_5,A_C1_13,D_4_HOS_C12_9201,B_1_C26_200,D3_HOS_C3_75,D_4_HOS_C1_91,D_5_HOS_C5_50,D3_IPF_C2_51,D_5_HOS_C4_65,D_4_HOS_C4_58,B_1_C21_72,A_C6_101,C_1_C8_202,D3_HOS_C2_31,D_4_IPF_C13_76,S5_C1_15,C_1_C7_67,D3_IRF_C3_75,S3_2_C5_4,B_1_C22_90,A_C1_112,C_1_C7_61,S3_1_C7_15,A_C2_112,D_4_IRF_C4_200,D1_IPF_C1_48,D_4_HOS_C4_93,D3_IPF_C2_58,S3_1_C4_14,D_4_SNF_C11_74,B_2_C26_42,B_1_C0_70,C_1_C5_91,S3_1_C9_26,C_1_C5_74,B_2_C26_109,ST_CTY_CD,S2_1_C7_3,C_1_C7_71,D3_IPF_C3_71,B_1_C21_95,S3_1_C7_22,S4_HHA3_C1_36,D1_IRF_C1_37,B_1_C22_56,S4_HHA2_C5_34,S3_2_C2_36,B_2_C26_107,D_1_HOS_C4_34,C_1_C5_94,B_2_C26_201,D_4_HOS_C3_51,D_5_HOS_C4_53,S3_1_C11_19,D_4_IPF_C11_74,D_4_IRF_C11_66,S4_HHA3_C3_35,S3_1_C6_17,A7_1_C4_7,B_1_C0_4501,D_4_IRF_C11_62,FI_CREAT_DT,A_C6_9920,B_1_C0_9920,S2_1_C1_5,D_1_HOS_C7_30,S2_1_C2_12,S3_2_C6_32,A7_1_C2_8,B_1_C0_8,D_4_IPF_C11_58,D3_IPF_C3_58,S2_1_C2_1805,S3_2_C2_8,B_1_C26_72,D_4_HOS_C3_97,C_1_C6_62,B_2_C26_94,S4_HHA3_C5_33,D_4_HOS_C13_67,A_C1_115,S3_1_C11_14,B_1_C0_107,D3_IRF_C3_9201,A_C6_109,D_4_HOS_C12_56,A_C2_193,S3_2_C3_1402,D_4_HOS_C10_67,C_1_C2_66,B_2_C26_34,S3_1_C7_5,B_1_C22_105,S3_2_C6_8,C_1_C6_111,D_4_HOS_C13_69,S4_HHA3_C4_34,S2_1_C2_1806,S3_3_C5_4,S2_1_C2_1505,S4_HHA2_C1_34,B_1_C26_9910,S3_2_C2_31,D_4_IRF_C11_75,D3_SNF_C2_93,A_C1_9920,C_1_C6_72,A_C1_15,A_C2_1,C_1_C6_116,S2_1_C2_15,D_4_HOS_C13_57,D_4_HOS_C13_93,S3_1_C5_17,S3_2_C2_10,B_1_C26_43,A_C1_4501,D_5_HOS_C5_55,A_C6_2,A7_1_C5_1,A_C1_5,D_4_IPF_C13_65,D3_SNF_C2_41,B_1_C22_42,C_1_C7_70,B_1_C22_50,B_2_C26_57,S3_1_C4_11,B_1_C26_105,A_C2_63,B_1_C26_46,E_B_HOS_C1_26,D_4_HOS_C3_54,D_4_IRF_C11_98,D_4_IPF_C13_90,A_C1_73,B_2_C26_111,S3_1_C14_1,A_C1_31,S3_1_C13_2,D_4_IRF_C13_75,D_4_HOS_C3_76,C_1_C6_61,C_1_C6_75,B_1_C22_101,S3_1_C8_28,B_1_C26_9930,D_4_HOS_C10_59,C_1_C7_96,D3_IPF_C3_74,B_1_C21_91,D_4_SNF_C11_62,S3_2_C6_34,A8_C2_25,S2_1_C1_125,D3_HOS_C2_68,A_C6_115,B_2_C26_116,C_1_C5_97,A_C1_41,C_1_C6_40,S3_2_C2_42,D_4_HOS_C12_74,D_4_IPF_C13_200,D_5_HOS_C3_55,D_4_HOS_C11_64,D_4_HOS_C13_60,D_4_HOS_C12_91,B_2_C26_59,A_C6_51,D_4_IRF_C11_60,D_5_HOS_C2_68,S3_2_C2_17,S2_1_C2_1605,S2_1_C2_1803,D_4_IPF_C13_54,D3_IPF_C3_90,S3_2_C3_24,S2_1_C1_3601,B_1_C22_68,D3_HOS_C2_59,A_C6_9940,D3_IRF_C3_52,S3_2_C5_29,S2_1_C1_116,S5_C2_3,B_1_C26_64,S3_1_C8_21,S3_2_C3_2553,S3_2_C4_38,S3_3_C6_7,A_C1_23,D_4_HOS_C12_64,S3_1_C7_14,S10_C1_3,S2_1_C4_3,B_2_C26_54,B_1_C22_110,D_5_HOS_C3_53,S2_1_C1_60,S3_1_C3_21,C_1_C5_106,S5_C1_13,A_C6_17,C_1_C7_62,D_4_HOS_C3_57,D3_HOS_C2_94,FFY,Hospital Type (Care Compare),Name and Num
,Curated Name and Num,Hospital type (HCRIS + care compare),Type of Control of Hospital (See Table I),Lon,Lat,Recovery Room,Subprovider I,ASC (Non Distinct Part),With Outliers:  Other Charges,PEP Episodes:  Total Charges:,Paramedical Education,Physician Part A,Delivery Room and Labor Room,Adj for Occupational therapy in excess of li,W/Out Outliers:  Number of Episodes,Medical Supplies Charged to Patients,Medical Supplies Charged to Patients,Heart Acquisition,Research,Total Program Excludable Costs,Non-Physician Part B,Excluded Areas,Electroencephalography,RHC/FQHC Combined,Non-Physician Part B,Anesthesiology,In State Medicaid eligible days,Other Outpatient Services,Electroencephalography,Medical Supplies Charged to Patients,Anesthesiology,Medicaid charges,Whole Blood & Packed Red Blood Cells,Electroencephalography,Recovery Room,Adults and Pediatrics,Intestinal Acquisition,Total,OLTC,Clinic,"If this Hospital is claiming cost for renal services on Worksheet A, are they inpatient services only? (Y/N)",Number of Times per week Patient receives Dialysis,"Gift, Flower, Coffee Shop, Canteen",Hospice,"Percentage of patients re-using
dialyzers",Recovery Room,Electrocardiology,Emergency,MRI,Physician-Part A,Physicians' Private Office,OPT,Other Ancillary,Impl. Dev. Charged to Patients,Outlier payments,SNF,Renal Dialysis,Burn Intensive Care Unit,Interns & Res Other Program Costs,Radioisotope,HMO,PEP Episodes:  Total Charges:,Respiratory Therapy,"Blood Storing, Processing, Trans",With Outliers:  Non Routine Med Sup Chgs,Subprovider-IPF,Electroencephalography,Laboratory,Other Organ Acquisition,Adults & Pediatrics,Other Reimbursable,TOTAL,Renal Dialysis,Renal 9 Provider Number,Recovery Room,OSP,Other Outpatient Services,Urban/Rural Indicator at beginning,Physician-Part A,Electroencephalography,CT Scan,Drugs Charged to Patients,Movable Equipment,PEP:  Total Non Routine Med Supply Chgs,Durable Medical Equipment Sold,Int & Res (non approved teaching program,ASC (Non Distinct Part),With Outliers:  Total Charges,MRI,Burn Intensive Care Unit,Medical Records and Medical Rec. Library,MRI,Research,Physician Part A Teaching,Medical Records & Med Records Library,MDH status ending date (MM/DD/YY),"Blood Storing, Processing, Trans",Coronary Intensive Care Unit,Subprovider-IRF,CT Scan,Recovery Room,Burn Intensive Care Unit,Cardiac Catheterization,Laboratory,Radiology-Therapeutic,Home Office:  Physician Part A,Total Salaries,Electroencephalography,"Blood Storing, Processing, Trans",MRI,Anesthesiology,Medicaid HMO Days,"Number of Times per week
 Patient receives Dialysis",Cafeteria,Clinic,Respiratory Therapy,Total,Speech Pathology,Beginning Date of SCH status,CT Scan,PEP Episodes:  Total Visits,Adults and Pediatrics,CT Scan,Maintenance of Personnel,Program Discharges,Excluded Areas,Line 2 times line 5,RHC,Operating Room,Delivery Room and Labor Room,Subprovider-IPF,"Blood Storing, Processing, Trans",Recovery Room,Other Outpatient Services,IRF,Social Service,Anesthesiology,Impl. Dev. Charged to Patients,Observation Beds (Distinct Unit),OPT,Durable Medical Equipment Sold,Nursery,Burn Intensive Care Unit,Cafeteria,CT Scan,Laboratory,Average times dialyzers re-used,Anesthesiology,Other Ancillary,Nursery,Home Office Salaries & Wage Related Csts,Radiology-Diagnostic,Medicare Certified Kidney TC term date,Liver Acquisition,Physical Therapy,"If Line 32, Col 1 is yes, enter the method used: (A, B, or E only)",Drugs Charged to Patients,NF,Delivery Room and Labor Room,ASC (Non Distinct Part),Total Charges:  LUPA Episodes,Without Outliers:  Total Visits,Cardiac Catheterization,State,Total,Total Nursing School,Utilization,Surgical Intensive Care Unit,Speech Pathology,Durable Medical Equipment Rented,Other Special Care,Total Costs,Intravenous Therapy,Admin & Gen Under Contract,Total Nursing School,Emergency,Intravenous Therapy,Adj for Respiratory therapy costs in excess,Cardiac Catheterization,Employee Benefits,SNF,OPT,Wage Related Costs RHC/FQHC,Does the hospital qualify as RPCH/CAH? (Y/N),Other Outpatient Services,Total Hospital,Employee Benefits,Observation Beds (Distinct Unit),Interest Expense,Radioisotope,Speech Pathology,Anesthesiology,Respiratory Therapy,Electroencephalography,Total,Intravenous Therapy,Occupational Therapy,Non-Physician Anesthetist Part B,Buildings and Fixtures,Liver Acquisition,Intravenous Therapy,IRF Provider Number,"Number of Times per week
 Patient receives Dialysis",Physicians' Assistant,Recovery Room,Physical Therapy,Whole Blood & Packed Red Blood Cells,SSA State Code,OPT,FQHC,Hospice,Drugs Charged to Patients,"Blood Storing, Processing, Trans",Organ Procurement,Observation Beds (Distinct Unit),Subprovider II,Research,Burn Intensive Care Unit,"Blood Storing, Processing, Trans",Protested amounts,Organ Procurement,Hospital Adlts & Ped Swing Bed NF,Radioisotope,Anesthesiology,Radiology-Therapeutic,Emergency,net of Swing Bed and Private Room Diff,Impl. Dev. Charged to Patients,OPPS payments,Total customary charges,Electroencephalography,NF,Cost of Uncompensated Care,Blood Clotting Factors for Hemoph.,Speech Pathology,Durable Medical Equipment Sold,Medical Records & Med Records Library,Intravenous Therapy,Laboratory,Interns & Res Other Program Costs,Durable Medical Equipment Sold,Hospital City,Drugs Charged to Patients,RHC/FQHC Combined,Medical Supplies Charged to Patients,interns and residents,New Capital Equipment,Total Number of Outlier Episodes,Radioisotope,Occupational Therapy,Cardiac Catheterization,Impl. Dev. Charged to Patients,Organ Procurement,Electroencephalography,Durable Medical Equipment Sold,Maintenance and Repairs,ASC (Non Distinct Part),Emergency,RHC/FQHC Combined,Electrocardiology,New Capital Buildings and Fixtures,Donations,Lung  Acquisition,Impl. Dev. Charged to Patients,FQHC,SNF,Occupational Therapy,Total,Medical Supplies Charged to Patients,Medical Records & Med Records Library,Nursery,Other Reimbursable,Electroencephalography,Central Services and Supply,Recovery Room,Land,Observation Beds (Distinct Unit),CORF,Anesthesiology,PBP Clinical Lab Services Program Only,Cardiac Catheterization,Whole Blood & Packed Red Blood Cells,Other Special Care Unit,SNF,OLTC,Blood Clotting Factors for Hemoph.,Urban (1) or Rural (2),Medical and Other Services reimbursed by OPPS,Physical Therapy,ASC (Non Distinct Part),Physical Therapy,Other Organ Acquisition,Delivery Room and Labor Room,Home Program Dialysis,Outpatient Rehab Provider,Administrative and General under Contract,Surgical Intensive Care Unit,Radiology-Therapeutic,Operating Room,Respiratory Therapy,MDH status beginning date (MM/DD/YY),Liver Acquisition,Other Special Purpose,FQHC 9 Provider Number,"Is this a New Hospital under
42 CFR 412.300 PPS capital
(Y/N)",Central Services and Supply,Durable Medical Equipment Rented,Total Hospital,Fixed Equipment,Out of State Medicaid eligible days,Interns & Residents,"Gift, Flower, Coffee Shop, Canteen",Total,Recovery Room,Other Special Care Unit,Subprovider-IRF,Radiology-Therapeutic,Laundry and Linen Service,Operating Room,Recovery Room,SNF,Whole Blood & Packed Red Blood Cells,Radiology-Therapeutic,IRF,Physical Therapy,Observation Beds (Distinct Unit),Ambulance Services,Investment Income-New Movable Equip,Research,Impl. Dev. Charged to Patients,RHC 2 Provider Number,NF Provider Number,Total discharges,Related  Salaries,SNF,SNF,Clinic,SNF,Subtotal,Housekeeping under contract,Operation of Plant,"Blood Storing, Processing, Trans",ASC (Non Distinct Part),SNF,Subprovider II,FQHC,Pancreas Acquisition,Cost of charity care (patients covered by public program + patients w/ coverage accepted by provider),Other Ancillary,Kidney Acquisition,Emergency,Liver Acquisition,Lung  Acquisition,Radiology-Diagnostic,Respiratory Therapy,"Blood Storing, Processing, Trans",Subprovider 2,Adults & Pediatrics,ICF Provider Number,Clinic,Electrocardiology,Medical Supplies Charged to Patients,Total Subprovider I Interns & Residents,"Sum of lines 3,4 divided by line 6",Total Overhead Costs,Laboratory,ASC (Non Distinct Part),Radiology-Diagnostic,Other Special Purpose,Emergency,Electroencephalography,CORF,Electroencephalography,CT Scan,Total,Recovery Room,CORF,Drugs Charged to Patients,Durable Medical Equipment Sold,Wage Related Costs Core,Management and Administrative Services,Observation Beds (Distinct Unit),Charity care charges and uninsured discounts for the entire facility,Hospice,Operating Room,LUPA Episodes:  Total Number of Episodes,Housekeeping under Contract,MRI,Intensive Care Unit,Total Salaries,SNF,"Gift, Flower, Coffee Shop, Canteen",Emergency,Respiratory Therapy,Emergency,Recovery Room,Cardiac Catheterization,Payment to cost ratio,Total Adults & Peds,MRI,Other Nonreimbursable,Subprovider-IRF,Does the hospital elect a fully prospective payment method for capital costs? (Y/N),Hospice,ASC (Non Distinct Part),Total Bad Debt expense,Clinic,Other Reimbursable,Other Outpatient Services,Social Service,With Outliers:  Number of Episodes,Electrocardiology,Total,Home Program Dialysis,Delivery Room and Labor Room,Impl. Dev. Charged to Patients,Home Office Salaries,Fixed Equipment,Physicians' Private Office,Total Program General Inp. Rtn Service,Payments received from patients for amounts previously written off as charity care,Non-Physician Anesthetist Part A,Radioisotope,Total,Blood Clotting Factors for Hemoph.,ASC (Distinct Part),Electroencephalography,"Income from imposition of interest, finance",Recovery Room,Impl. Dev. Charged to Patients,Cost of patients approved for charity care and uninsured discounts,Emergency,Total Allied Health Cost,Other Nonreimbursable,Physicians' Private Office,MRI,Total Other Medical Education,Central Services and Supply,Other Outpatient Services,Title V discharges,Anesthesiology,Intravenous Therapy,Total Number of Episodes,"Number of patients on transplant 
list",CMHC,Other General Service,Durable Medical Equipment Rented,Maintenance of Personnel,NF,Hospital Provider Number,Medical Supplies Charged to Patients,Other Capital,Recovery Room,Physical Therapy,Operating Room,CORF,Operating Room,Speech Pathology,Electrocardiology,RHC,Total,Delivery Room and Labor Room,Subtotal Wage Related Csts,Renal 10 Provider Number,Laundry and Linen Service,Whole Blood & Packed Red Blood Cells,Dietary under Contract,TOTAL,Lung  Acquisition,PBP Clinical Lab Services Program Only,Recovery Room,Total,Speech Pathology,Adults and Pediatrics,Total,Durable Medical Equipment Rented,Hospital Adults & Pediatrics,Nursing Administration,Physical Therapy,Other Special Purpose,Investment Income-Other,ICF,Operation of Plant,Ambulance Services,Observation Beds (Distinct Unit),In State Medicaid paid days,Total Subprovider II Interns & Residents,Other Special Purpose,Total Program Inpatient Costs,Medical Records and Medical Rec. Library,Impl. Dev. Charged to Patients,Ambulance Services,Stand-alone CHIP cost,Recovery Room,With Outliers:  Total Visits,Intestinal Acquisition,Physical Therapy,MRI,Ambulance Services,"Blood Storing, Processing, Trans",Radiology-Therapeutic,Subprovider 2,Other Special Care,Target Amount,Physicians' Private Office,Delivery Room and Labor Room,Laboratory,Intensive Care Unit,Other Reimbursable,ASC (Distinct Part),Operation of Plant,Total Number of Outlier Episodes,Laboratory,Adults & Pediatrics,Emergency,Whole Blood & Packed Red Blood Cells,Whole Blood & Packed Red Blood Cells,Observation Beds (Distinct Unit),NF,Delivery Room and Labor Room,Intravenous Therapy,Cardiac Catheterization,Interns & Res Salary and Fringe Benefits,Employee Benefits,Dietary,"Medicare certified heart
transplant center cert date",HHA,Heart Acquisition,HHA,Operating Room,"Blood Storing, Processing, Trans",Teaching Physician Salaries,Heart Acquisition,Adj for Speech therapy in excess of lim,Clinic,Durable Medical Equipment Rented,Observation Beds (Distinct Unit),Total,Delivery Room and Labor Room,Labor and Delivery,Int & Res (non approved teaching program,TOTAL,City,Intravenous Therapy,Emergency,ASC (Non Distinct Part),Hospital Adults & Ped Swing Bed SNF,CORF,"Blood Storing, Processing, Trans",Cost of charity care,Physician-Part B,MRI,Excluded Area Salaries,"Blood Storing, Processing, Trans",Is this hospital an All-Inclusive rate provider? (Y/N),"Number of patients in program at 
end of cost reporting period",Burn Intensive Care Unit,Interns & Res Other Program Costs,SNF,Ambulance Services,Excess of reasonable cost over reasonable charges,Islet Acquisition,"Epoietin amount form worksheet A
for home dialysis program",ASC (Distinct Part),Movable Equipment,Begin Balance,Anesthesiology,Laboratory,Radiology-Diagnostic,Total Number of Outlier Episodes,Whole Blood & Packed Red Blood Cells,Medical Supplies Charged to Patients,Interns & Res Other Program Costs,Physician-Part A,Other Special Purpose,Burn Intensive Care Unit,Hospice,Blood Clotting Factors for Hemoph.,Electrocardiology,Clinic,Subprovider-IRF,Recovery Room,Impl. Dev. Charged to Patients,Subprovider II,Intravenous Therapy,Observation Beds (Distinct Unit),Interns & Residents,Blood Clotting Factors for Hemoph.,Total Visits,Swing Bed SNF Provider Number,Laboratory,Physician Part B,LUPA:  Total Non Routine Med Sup Chgs,Burn Intensive Care Unit,CT Scan,Anesthesiology,Other Reimbursable,Other Special Care Unit,Other adjustments,CMHC,PEP Episodes:  Other Charges,Other Special Care Unit,Intravenous Therapy,Cardiac Catheterization,Renal Dialysis,FQHC,OPT,Medical Supplies Charged to Patients,Drugs Charged to Patients,Cardiac Catheterization,Title XVIII discharges,Aggregate amount collected from patients,Delivery Room and Labor Room,Renal Dialysis,"Anesthetist, and Medical Education Costs",TOTAL,Observation Beds (Distinct Unit),Laboratory,Cafeteria,Physical Therapy,Radiology-Diagnostic,Surgical Intensive Care Unit,Electroencephalography,Observation Beds (Distinct Unit),Lung  Acquisition,Fixed Equipment,IRF,Cardiac Catheterization,Subtotal Salaries,Home Program Dialysis,Contract Labor:  Physician Part A,RHC 10 Provider Number,Other General Service,CMHC,Occupational Therapy,ICF,"Number of days in year dialysis 
furnished",Total Directly Assigned New Cap Rel Csts,Electrocardiology,Intravenous Therapy,Electroencephalography,Intravenous Therapy,Respiratory Therapy,Subprovider I,FQHC 1 Provider Number,Other Outpatient Services,Investment Income-New Bldgs & Fixtures,Other Outpatient Services,Land Improvements,IPPS Interim payment,Other Special Care Unit,IPF,Respiratory Therapy,Radiology-Therapeutic,With Outliers:  Total Visits,Total Program General Inpatient Routine,Heart Acquisition,Nursing Administration,Other General Service,HHA,With Outliers:  Other Charges,SNF,Subprovider-IRF,MRI,With Outliers:  Other Charges,Other Ancillary,Laboratory,Related Salaries,Less Observation Beds,Interim payments,Radiology-Therapeutic,Other Organ Acquisition,Observation Beds (Distinct Unit),Number of stations,Hospital Street Address,Emergency,Durable Medical Equipment Sold,TOTAL,Impl. Dev. Charged to Patients,Occupational Therapy,Radioisotope,Whole Blood & Packed Red Blood Cells,Surgical Intensive Care Unit,Home Program Dialysis,Occupational Therapy,New Cap Related Csts Bldg & Fixtures,Intestinal Acquisition,ASC (Non Distinct Part),Subprovider I,Medical Records and Medical Rec. Library,Social Service,NF,Sale of medical records and abstracts,Impl. Dev. Charged to Patients,Electrocardiology,Administrative & General under contract,Recovery Room,OOT,Contract Labor,PEP Episodes:  Other Charges,Speech Pathology,Research,SNF,Intravenous Therapy,Intensive Care Unit,Renal Dialysis,Other Reimbursable,Intravenous Therapy,Speech Pathology,Drugs Charged to Patients,Nonpaid Workers,Subprovider II,Organ Procurement,Impl. Dev. Charged to Patients,Physical Therapy,Excluded Area Salaries,Radiology-Therapeutic,Coronary Care Unit Program Cost,Social Service,Net Salaries,Emergency,PBP Clinical Lab Services Program Only,Hospice,New Cap Related Csts Movable Equipment,Land,Radioisotope,Whole Blood & Packed Red Blood Cells,Subprovider-IRF,Impl. Dev. Charged to Patients,Buildings and Fixtures,Durable Medical Equipment Rented,Hospital Adults & Pediatrics,Interns & Residents,Physician Part B,Other Ancillary,Home Office Personnel,Observation Beds (Distinct Unit),"Sale of scrap, waste, etc.",Total Charges:  LUPA Episodes,MRI,Intravenous Therapy,"If an Organ Procurement Organization, enter the OPO number",Medical Supplies Charged to Patients,Laboratory,Subtotal,Physicians' Private Office,Coronary Care Unit,Home Office Salaries & Wage Related Csts,Radiology-Therapeutic,Electrocardiology,Total,Number of stations,Other Ancillary,Delivery Room and Labor Room,Coronary Care Unit,Title V discharges,LUPA:  Total Non Routine Med Sup Chgs,Observation Beds (Distinct Unit),Total,Land Improvements,Anesthesiology,Renal Dialysis,Radiology-Diagnostic,Drugs Charged to Patients,Physicians' Private Office,Utilization Review SNF,Electroencephalography,Intensive Care Unit,Occupational Therapy,Respiratory Therapy,Central Services and Supply,Durable Medical Equipment Rented,Pharmacy,OOT,"Number of patients transplanted 
during fiscal year",Renal Dialysis,Net Salaries,Blood Clotting Factors for Hemoph.,Home Office Name,Pharmacy,Operating Room,Disp. And Retirement,Subtotal Other Wages and Related Csts,Radiology-Diagnostic,Housekeeping,RHC,Without Outliers:  Non Routine Med Sup Chgs,Intensive Care Unit,Other Reimbursable,New Cap Related Csts Bldg & Fixtures,Other Ancillary,Transitional corridor payment,RHC,Purchase,Electroencephalography,Cafeteria,Drugs Charged to Patients,CMHC,Total,Laboratory,Other Special Care Unit,Maintenance of Personnel,Clinic,CT Scan,Respiratory Therapy,Other Ancillary,FQHC,Speech Pathology,Speech Pathology,OPT,Total Program Excludable Costs,Pancreas Acquisition,Emergency,Radiology-Therapeutic,Pharmacy,Other Reimbursable,Subtotal,Operating Room,Land Improvements,Drugs Charged to Patients,Total Adults & Peds,Non-Physician Part B,CT Scan,"Are there any related organization or how office costs as defined in HCFA Pub. 15-I, chapter 10? (Y/N)",Clinic,Burn Intensive Care Unit,Clinic,Anesthesiology,Nursing School,Burn Intensive Care Unit,Delivery Room and Labor Room,Subprovider-IPF,Other Ancillary,Pharmacy,Heart Acquisition,CT Scan,Drugs Charged to Patients,Subprovider-IPF,Teaching Physician Salaries,Other Special Care Unit,Subtotal Salaries,RHC 25 Provider Number,Medicare Certified Liver TC term date,Observation Beds (Distinct Unit),HRR adjustment amount ,"Blood Storing, Processing, Trans",Utilization Review SNF,Interns & Res Salary and Fringe Benefits,Non-Physician Anesthetist Part B,Total Outpatient Program Pass Thru Cost,Other General Service,Title XVIII discharges,Other Ancillary,Electrocardiology,Rental of Provider space by suppliers,Housekeeping,Sequestration adjustment,Maintenance and Repairs,Delivery Room and Labor Room,"Blood Storing, Processing, Trans",Other Outpatient Services,Nonpaid Workers,CMHC,Stand-alone CHIP Charges (Gross Revenue),Total Other Medical Education,Anesthesiology,RHC/FQHC Combined,Home Program Dialysis,Pancreas Acquisition,Radiology-Diagnostic,Sale of medical and surgical supplies to,Radioisotope,Radioisotope,RHC 20 Provider Number,Home Program Dialysis,Administrative and General,Other Outpatient Services,Total Hospital Interns & Residents,Radiology-Diagnostic,CAH Visits,LUPA Episodes:  Total Number of Episodes,Impl. Dev. Charged to Patients,Total,Dietary,Laboratory,Speech Pathology,Report Record Number,Hospice,Other Ancillary,Cardiac Catheterization,Occupational Therapy,Medical Supplies Charged to Patients,Emergency,Interns & Residents,Other Outpatient Services,Islet Acquisition,RHC,Intravenous Therapy,Durable Medical Equipment Rented,Other Outpatient Services,Kidney Acquisition,FQHC,Radioisotope,Drugs Charged to Patients,Total Other Medical Education Cost,Ambulance Services,Delivery Room and Labor Room,Wage Related Costs Other,Respiratory Therapy,Occupational Therapy,Title XVIII discharges,Other Outpatient Services,Total,Ambulance Services,With Outliers:  Number of Episodes,Blood Clotting Factors for Hemoph.,Radiology-Diagnostic,Delivery Room and Labor Room,HHA,Laboratory,Electrocardiology,Intensive Care Unit,Payments received from patients for amounts previously written off as charity care,Total Hospital,Operating Room,Medical Supplies Charged to Patients,Tentative settlement,Dietary under contract,FI/Contractor's Name,Speech Pathology,Management and Administrative Services,Intensive Care Unit,Telephone Services,Total,Occupational Therapy,Radiology-Therapeutic,Balance due provider/program,Kidney Acquisition,"Blood Storing, Processing, Trans",IPF,Radioisotope,MRI,Respiratory Therapy,Related Organization Transactions,Respiratory Therapy,Radiology-Therapeutic,Drugs Charged to Patients,Renal Dialysis,OSP,Medical Supplies Charged to Patients,"Blood Storing, Processing, Trans",New Cap Related Csts Bldg & Fixtures,Clinic,Number of periods hospital was in MDH status,Coronary Care Unit,Kidney Acquisition,Total,ASC (Non Distinct Part),Burn Intensive Care Unit,Radiology-Diagnostic,Laboratory,Operating Room,Home Program Dialysis,SNF,Other Reimbursable,New Capital Equipment,Cardiac Catheterization,Subprovider-IPF,Observation Beds (Distinct Unit),Allowable Inpatient Cost Plus Incentive Pt,Observation Beds (Distinct Unit),Renal 8 Provider Number,net of Swing Bed and Private Room Diff,Renal 1 Provider Number,Observation Beds (Distinct Unit),Coronary Care Unit,Radiology-Therapeutic,Movable Equipment,Electrocardiology,Net Salaries,Int & Res (non approved teaching program,Laboratory,Whole Blood & Packed Red Blood Cells,Subtotal Other Wages and Related Csts,Building Improvements,Renal Dialysis,Electrocardiology,Hospice,Clinic,Medical Supplies Charged to Patients,Intravenous Therapy,Hospital Adults & Pediatrics,ASC (Non Distinct Part),Clinic,RHC 11 Provider Number,Clinic,CORF,RHC,OLTC,Kidney Acquisition,CT Scan,Other Special Care Unit,CT Scan,Renal Dialysis,Other Nonreimbursable,Adjusted reimburseable bad debts,HHA,MRI,Emergency,PEP:  Total Number of Outlier Episodes,Cardiac Catheterization,Radioisotope,Other Reimbursable,Speech Pathology,SNF Provider Number,Physical Therapy,Coronary Care Unit,Without Outliers:  Total Charges,Building Improvements,Burn Intensive Care Unit,Medicare reimbursable bad debts for the entire hospital complex,Have you established a new subprovider excluded unit under 42 CFR 413.40(f)(1)(I)?(Y/N),Labor and Delivery Days Title 18,Intravenous Therapy,Anesthesiology,Nursing Administration,NF,Intensive Care Unit,Electroencephalography,MRI,MRI,Speech Pathology,Total,CT Scan,HHA,Other Special Purpose,Lung  Acquisition,Recovery Room,Total Charges,Coronary Care Unit,"Blood Storing, Processing, Trans",Home Program Dialysis,LUPA Episodes:  Other Charges,Delivery Room and Labor Room,"Blood Storing, Processing, Trans",Drugs Charged to Patients,CT Scan,Recovery Room,Occupational Therapy,CORF,Renal Dialysis,Speech Pathology,Respiratory Therapy,Physical Therapy,Whole Blood & Packed Red Blood Cells,Adults and Pediatrics,Title XVIII discharges,PBP Clinical Lab Services Program Only,NOT IN THIS FILE,Subprovider-IPF,Observation Beds (Distinct Unit),Subprovider 1,Non-Physician Anesthetist Part B,NF,Buildings and Fixtures,Radioisotope,Operating Room,Hospital PO Box,Operating Room,Non-Physician Part B,Other Outpatient Services,PEP:  Total Number of Outlier Episodes,Renal Dialysis,Clinic,Blood Clotting Factors for Hemoph.,Occupational Therapy,Subprovider-IPF,OSP,PEP:  Total Non Routine Med Supply Chgs,Electroencephalography,Laboratory,Hospital Adlts & Ped Swing Bed NF,CT Scan,Paramedical Education,Renal 3 Provider Number,Interns & Residents,Medical Supplies Charged to Patients,Physical Therapy,Emergency,Pancreas Acquisition,Medical Supplies Charged to Patients,OLTC,ASC (Distinct Part),Speech Pathology,Blood Clotting Factors for Hemoph.,Provider's actual MSA or CBSA,ASC (Non Distinct Part),RHC 5 Provider Number,HAC reduction adjustment amount,Other Special Care Unit,Burn Intensive Care Unit,Nursing School,PEP:  Total Non Routine Med Supply Chgs,LUPA Episodes:  Total Visits,RHC 16 Provider Number,"Average patient dialysis time 
including setup","Is this a teaching hospital or
affiliated with a teaching hospital? (Y/N)",Home Program Dialysis,Outpatient Rehab Provider,Medical Supplies Charged to Patients,Home Program Dialysis,Home Program Dialysis,Electroencephalography,Burn Intensive Care Unit,Emergency,Subtotal,Assets,FQHC,"Average patient dialysis time 
including setup",FQHC,Physical Therapy,Other Ancillary,Cafeteria,Subprovider 1,Ambulance Trips,ASC (Non Distinct Part),Laundry and Linen Service,Pass Through Cost for  Program Ancillary,Maintenance of Personnel,Cardiac Catheterization,Coronary Care Unit,Radiology-Therapeutic,Other Reimbursable,Occupational Therapy,Other Ancillary,Total,Radioisotope,Net Revenue from stand-alone SCHIP,Renal Dialysis,Subprovider-IPF,Hospice,Radiology-Diagnostic,Dietary,Pass Through Cost for  Program Ancillary,Coronary Care Unit,Respiratory Therapy,Renal Dialysis,IPPS Payment amount (unadjusted),ASC (Non Distinct Part),Emergency,Interns & Residents,Nonpaid Workers,ASC (Distinct Part),Whole Blood & Packed Red Blood Cells,Medicare Certified Islet TC term date,Whole Blood & Packed Red Blood Cells,Electrocardiology,Subprovider-IRF,Total,Speech Pathology,Impl. Dev. Charged to Patients,Total Program Inpatient Costs,Observation Beds (Distinct Unit),Anesthesiology,Durable Medical Equipment Sold,Radiology-Therapeutic,Surgical Intensive Care Unit,Operating Room,Electroencephalography,Delivery Room and Labor Room,Anesthesiology,Subprovider 2,Non-Physician Anesthetist Part A,Coronary Care Unit,Intensive Care Unit,"Number of Times per week 
Patient receives Dialysis",Physical Therapy,Speech Pathology,Hospital Adults & Pediatrics,Islet Acquisition,Allowable bad debts for dual eligibles beneficiaries,CT Scan,ASC (Non Distinct Part),Operating Room,Intestinal Acquisition,RPCH/CAH Visits,CMHC,Total Nursing School,OOT,CMHC,Total Program General Inpatient Routine,Medicare Certified Lung TC term date,Subprovider-IRF,Nursing Administration,Total,Respiratory Therapy,With Outliers:  Total Charges,Nursery,Total discharges,Labor and Delivery Days -  Title XIX,Radiology-Diagnostic,Bonus Payment,Surgical Intensive Care Unit,Other Special Care,SNF,Physical Therapy,Liver Acquisition,W/Out Outliers:  Number of Episodes,Pass Through Cost for  Program Ancillary,Total Non Routine Medical  Supply Charges,Total costs for patients covered by a state or local government program,Surgical Intensive Care Unit,"Number of patients in program at 
end of cost reporting period",Radiology-Therapeutic,New Cap Related Csts Movable Equipment,Intestinal Acquisition,Without Outliers:  Total Charges,"If this facility qualifies as a RPCH/CAH, has it elected the all inclusive payment for outpatient service? (Y/N)",Intensive Care Unit,Laboratory,OLTC,Fixed Equipment,Employee Benefits,Other Outpatient Services,Int & Res (non approved teaching program,Medical Records and Medical Rec. Library,Anesthesiology,Occupational Therapy,Radiology-Therapeutic,Clinic,Durable Medical Equipment Rented,Intensive Care Unit Program Cost,Nonpaid Workers,Intensive Care Unit,Non-Physician Anesthetist Part A,Depreciation-New Movable Equipment,FQHC 7 Provider Number,Other Ancillary,Clinic,ASC (Distinct Part),ICF,Home Program Dialysis,Total Salaries,Clinic,State or local govt (not Medicaid or CHIP) -- Costs minus net revenue (0 min),Radioisotope,Radiology-Diagnostic,Impl. Dev. Charged to Patients,Total unreimbursed and uncompensated care,Other Organ Acquisition,PBP Clinical Lab Services Program Only,Radioisotope,Building Improvements,Renal Dialysis,Nursing School,Subtotal,Organ Procurement,Drugs Charged to Patients,Drugs Charged to Patients,Home Office PO Box,Intensive Care Unit,Is this a rural hospital qualifying for an exception to the certified registered nurse anesthetist the CRNA fee schedule? (Y/N),Housekeeping,Nursing School,Laboratory,CT Scan,Subprovider-IRF,Other Outpatient Services,Operation of Plant,Geographic MSA,Speech Pathology,Housekeeping under Contract,Drugs Charged to Patients,Other Ancillary,Electroencephalography,New Cap Related Csts Bldg & Fixtures,Coronary Care Unit,Electrocardiology,Radioisotope,Interns & Residents,Total Hospital,Medical Supplies Charged to Patients,Laboratory,Nursing Administration,Electrocardiology,Anesthesiology,CT Scan,CT Scan,ASC (Non Distinct Part),Other Ancillary,Blood Clotting Factors for Hemoph.,CT Scan,Other Special Care Unit,Radiology-Therapeutic,Other Ancillary,Home Office Salaries,Recovery Room,Medical Supplies Charged to Patients,Laboratory,Administrative and General under Contract,Radiology-Diagnostic,Intestinal Acquisition,Research,Wage Related Costs RHC/FQHC,Blood Clotting Factors for Hemoph.,Interns & Residents,Without Outliers:  Total Charges,Drugs Charged to Patients,Intravenous Therapy,Medicare Certified Pancreas TC term date,Operating Room,Durable Medical Equipment Sold,Radioisotope,Other Special Care Unit,RHC 9 Provider Number,New Cap Related Csts Movable Equipment,Speech Pathology,"Anesthetist, and Medical Education Costs",Other Special Purpose,RHC 12 Provider Number,Related Salaries,Other Special Purpose,Electroencephalography,RHC,Home Program Dialysis,Recovery Room,Laboratory,PEP:  Total Number of Outlier Episodes,Radiology-Diagnostic,Pharmacy,ASC (Non Distinct Part),RHC 14 Provider Number,FQHC 2 Provider Number,Cardiac Catheterization,Nonphysician Anesthetists,Islet Acquisition,Whole Blood & Packed Red Blood Cells,Government grants or appropriations or transfers for support of hospital operations,Occupational Therapy,Radioisotope,Speech Pathology,Other Special Care Unit,NF,Other Reimbursable,Title XIX discharges,Intravenous Therapy,Total,Housekeeping,Recovery Room,Physical Therapy,OLTC,Electrocardiology,Medical and Other Services,Occupational Therapy,Occupational Therapy,New Cap Related Csts Bldg & Fixtures,Dietary,Intensive Care Unit,Depreciation-New Bldgs & Fixtures,"Blood Storing, Processing, Trans",Total,Total charges to state or local government programs for indigent care (not Medicaid or CHIP),OLTC,Intravenous Therapy,OOT,ASC (Distinct Part),Whole Blood & Packed Red Blood Cells,LUPA Episodes:  Other Charges,"Blood Storing, Processing, Trans",Charity care charges and uninsured discounts for the entire facility,Ancillary service charges,Operation of Plant,Whole Blood & Packed Red Blood Cells,Recovery Room,Hospital State,Occupational Therapy,Other Special Care Unit,"Blood Storing, Processing, Trans",Adults & Pediatrics,Without Outliers:  Total Visits,OSP,Target Amount per Discharge,Other Outpatient Services,Cardiac Catheterization,Total Allied Health,Coronary Care Unit,ICF,Title XIX discharges,Occupational Therapy,Cost of charity care (uninsured patients + patients w/ coverage not accepted by provider),Lesser of cost or charges,Other Nonreimbursable,Other Reimbursable,Coronary Care Unit,Nursery,Int & Res (non approved teaching program,CT Scan,Liver Acquisition,Electroencephalography,Excess of customary charges,Durable Medical Equipment Sold,Home Program Dialysis,Surgical Intensive Care Unit,Total Facility FTEs,Radiology-Diagnostic,Liver Acquisition,Average times dialyzers re-used,IPF,HHA,Electroencephalography,Number of stations,Electrocardiology,Operating Room,Radiology-Therapeutic,Laundry and Linen Service,Nursery,Subprovider-IRF,Radiology-Therapeutic,Home Program Dialysis,Ending Date of SCH status,Management and Administrative Services,Subprovider II,Other Special Care Unit,Renal Dialysis,Respiratory Therapy,Laundry and Linen Service,Central Services and Supply,Physical Therapy,Radiology-Therapeutic,Cardiac Catheterization,Cardiac Catheterization,Observation Beds (Distinct Unit),Observation Beds (Distinct Unit),Television and Radio Service,Delivery Room and Labor Room,Central Services and Supply,ASC (Non Distinct Part),Intravenous Therapy,Home Program Dialysis,Maintenance and Repairs,Total,Swing Bed NF Provider Number,Other Special Care,PEP Episodes:  Total Visits,Drugs Charged to Patients,Home Program Dialysis,OLTC,HHA,Cardiac Catheterization,Observation Beds (Distinct Unit),Title XIX discharges,Clinic,Refunds and Rebates of Expenses,RHC,Payments received from patients for amounts previously written off as charity care,Emergency,Electrocardiology,Home Program Dialysis,ASC (Non Distinct Part),"Blood Storing, Processing, Trans",Electroencephalography,Hospice,Other Reimbursable,Contract Labor:  Physician Part A,Burn Intensive Care Unit,Radioisotope,Emergency,Self Insurance,Emergency,Total Outpatient Program Pass Thru Cost,FQHC,CMHC,Anesthesiology,Land Improvements,Hospice,Intravenous Therapy,Non-Physician Anesthetist Part B,Anesthesiology,Laboratory,Non-physician Anesthetist,OOT,Radiology-Diagnostic,Radiology-Therapeutic,MRI,Non-Physician Anesthetist Part A,Other Special Care Unit,Physical Therapy,Other General Service,Total,Medical Supplies Charged to Patients,Total discharges,Recovery Room,Surgical Intensive Care Unit,ICF,CT Scan,Emergency,"Number of patients in program at 
end of cost reporting period",Research,Total Patient Days,Operating Room,Operation of Plant,Clinic,Clinic,Drugs Charged to Patients,SNF,Ending Balance,Other Ancillary,Observation Beds (Distinct Unit),Ambulance Services,Total Swing Bed Cost,Total Adults & Pediatrics,Relief Payment,Out of State Medicaid paid days,OLTC,Hospice,Impl. Dev. Charged to Patients,Intensive Care Unit,Subprovider II,Blood Clotting Factors for Hemoph.,Labor and Delivery,Occupational Therapy,HHA 2 Provider Number,Total Program Excludable Costs,Electrocardiology,Subprovider-IPF,Renal 5 Provider Number,HMO,NF,SNF,Other Outpatient Services,Total Program Inpatient Costs,Impl. Dev. Charged to Patients,Laundry and Linen Service,Electrocardiology,Radiology-Diagnostic,Other Reimbursable,MRI,Other Outpatient Services,Census Division Code,Total discharges,CT Scan,Coronary Intensive Care Unit,Anesthesiology,Adults & Pediatrics,Respiratory Therapy,Coronary Intensive Care Unit,Total Costs,Renal Dialysis,Renal Dialysis,MRI,Total Inpatient Program Days,Physician Part A Teaching,Subprovider-IPF,Operating Room,Component rate ESRD,Laboratory,LUPA Episodes:  Other Charges,Radiology-Therapeutic,Number of stations,Speech Pathology,Intravenous Therapy,Durable Medical Equipment Rented,Cardiac Catheterization,Laboratory,Pancreas Acquisition,With Outliers:  Total Charges,Durable Medical Equipment Rented,HHA,Medical Supplies Charged to Patients,Radiology-Diagnostic,Without Outliers:  Other Charges,Contract Labor:  Physician Part A,Dietary under Contract,Radioisotope,Cardiac Catheterization,Other Outpatient Services,Electroencephalography,Subprovider-IRF,MRI,Interns & Residents,Dietary under contract,SNF,Administrative and General,RHC,Physical Therapy,Other Outpatient Services,Total Subprovider I Interns & Residents,"Gift, Flower, Coffee Shop, Canteen",Radioisotope,Intensive Care Unit,Intravenous Therapy,Total,Other General Service,Negative Cost Centers,Operating Room,Burn Intensive Care Unit,Int & Res (non approved teaching program,Observation Beds (Distinct Unit),CT Scan,Total cost,Electroencephalography,ASC (Non Distinct Part),Subprovider 1,Subprovider-IPF,IPF,Interns & Residents,Land Improvements,IPF Provider Number,Anesthesiology,CMHC,Dietary,Intensive Care Unit,Physical Therapy,With Outliers:  Number of Episodes,Respiratory Therapy,net of Swing Bed Cost,Fiscal Intermediary Number,Movable Equipment,HHA 3 Provider Number,Speech Pathology,Clinic,RHC,ASC (Non Distinct Part),Occupational Therapy,Other Organ Acquisition,Renal Dialysis,Initial Physician Payment Method (Y/N),Observation Beds (Distinct Unit),Electroencephalography,Utilization Review - Physician Compen,Other Ancillary,Intravenous Therapy,Radiology-Therapeutic,Is this a New Hospital under 42 CFR 413.40(f)(1)(I) (TEFRA)? (Y/N),Subtotal Wage Related Csts,Nursery,Medical Supplies Charged to Patients,Payment to cost ratio,Other Special Care Unit,Cardiac Catheterization,Other Ancillary,Delivery Room and Labor Room,"Blood Storing, Processing, Trans",Durable Medical Equipment Rented,Total Salaries,"Gift, Flower, Coffee Shop, Canteen",Whole Blood & Packed Red Blood Cells,Other Reimbursable,MRI,Subprovider I,Heart Acquisition,Total Non Routine Medical  Supply Charges,Anesthesiology,Utilization Code (L/N/F),Administrative and General,MRI,Other Outpatient Services,Delivery Room and Labor Room,Intestinal Acquisition,Radiology-Therapeutic,Other Outpatient Services,Intravenous Therapy,Radiology-Diagnostic,Coronary Care Unit,Speech Pathology,NF,RHC 7 Provider Number,Cardiac Catheterization,Int & Res (non approved teaching program,Operating Room,SNF,Emergency,MRI,OSP,Other Reimbursable,Other Ancillary,New Capital Buildings and Fixtures,Respiratory Therapy,Employee Benefits,Vending Machines,Other Outpatient Services,Medical Supplies Charged to Patients,Respiratory Therapy,Radiology-Therapeutic,Electrocardiology,Radioisotope,Radioisotope,Subprovider-IPF,MSP-LCC reconciliation amount,LUPA:  Total Non Routine Med Sup Chgs,Occupational Therapy,Cost of patients approved for charity care and uninsured discounts,Intestinal Acquisition,Electrocardiology,Burn Intensive Care Unit,Physical Therapy,Deductibles and coinsurance,CT Scan,Respiratory Therapy,Interns & Residents,Radiology-Diagnostic,Intensive Care Unit,Recovery Room,Clinic,Teaching Physician Salaries,Without Outliers:  Other Charges,Burn Intensive Care Unit,Occupational Therapy,MCP Physician Payment Method (Y/N),Blood Clotting Factors for Hemoph.,Whole Blood & Packed Red Blood Cells,Durable Medical Equipment Rented,Adults & Pediatrics,Impl. Dev. Charged to Patients,Operating Room,Durable Medical Equipment Rented,Clinic,Total Overhead Costs,Radiology-Diagnostic,Employee Benefits,Intensive Care Unit,Physician-Part B,LUPA Episodes:  Total Number of Episodes,ICF,Maintenance of Personnel,Clinic,CT Scan,Housekeeping,Pancreas Acquisition,Whole Blood & Packed Red Blood Cells,"Blood Storing, Processing, Trans",Delivery Room and Labor Room,Lung  Acquisition,Durable Medical Equipment Sold,Clinic,Radioisotope,Impl. Dev. Charged to Patients,Burn Intensive Care Unit,Whole Blood & Packed Red Blood Cells,Total Salaries,Subtotal Other Wages and Related Csts,Other Ancillary,Intravenous Therapy,Other Nonreimbursable,Subprovider II,Provider-based physician adjustment,Laboratory,Clinic,Renal Dialysis,Drugs Charged to Patients,Home Program Dialysis,Other Reimbursable,Hospital Adults & Pediatrics,Delivery Room and Labor Room,Delivery Room and Labor Room,RHC 3 Provider Number,Respiratory Therapy,Adults and Pediatrics,Emergency,"Blood Storing, Processing, Trans",Rental of quarters to employee and oths,Delivery Room and Labor Room,MRI,Radioisotope,PBP Clinical Lab Services Program Only,Recovery Room,Contract Labor: Pysician Part A,Delivery Room and Labor Room,Hospital Adlts & Ped Swing Bed SNF,Durable Medical Equipment Rented,MRI,OOT,Total prospective payment,Delivery Room and Labor Room,Subprovider-IRF,Electroencephalography,Medical Supplies Charged to Patients,Electroencephalography,Sale of drugs to other than patients,Subprovider-IRF,Respiratory Therapy,Drugs Charged to Patients,Clinic,RHC 4 Provider Number,FQHC 5 Provider Number,"Number of patients in program at 
end of cost reporting period",Electroencephalography,Hospital Adults & Pediatrics,"Blood Storing, Processing, Trans",Renal Dialysis,Physical Therapy,CAPD exchanges per day,Total discharges,MRI,ASC (Non Distinct Part),Private grants or donations or endowment income restricted to funding charity care,OSP,Non-Physician Anesthetist Part A,ASC (Non Distinct Part),OLTC,Total,Intravenous Therapy,Cardiac Catheterization,Recovery Room,Total Facility FTEs,Interns & Residents,Whole Blood & Packed Red Blood Cells,Drugs Charged to Patients,Excluded Area Salaries,Cardiac Catheterization,Electrocardiology,"Number of days in year dialysis 
furnished",Whole Blood & Packed Red Blood Cells,RHC 18 Provider Number,Kidney Acquisition,Electrocardiology,Charity care charges and uninsured discounts for the entire facility,New Cap Related Csts Movable Equipment,Ambulance Services,Subtotal,IPF Provider Number,Research,Durable Medical Equipment Rented,Nursery,Anesthesiology,Maintenance of Personnel,Electroencephalography,Cost of physicians svcs in a teaching hospita,Physician Part B,Radiology-Diagnostic,Emergency,Outlier payments,Impl. Dev. Charged to Patients,Impl. Dev. Charged to Patients,ICF,Renal Dialysis,Radiology-Diagnostic,Net revenue from state/local govt indigent care (not Medicaid or CHIP),Partial or full credits from manufacturers,Drugs Charged to Patients,Ending Date of SCH status,Operating Room,Other Reimbursable,Electrocardiology,ASC (Non Distinct Part),Hospice 2 Provider Number,Kidney Acquisition,Cafeteria employees and guests,Interns & Res Salary and Fringe Benefits,Surgical Intensive Care Unit,OOT,IPF,OLTC,FQHC,Subprovider I,Home Program Dialysis,ICF,Other Special Care Unit,Blood Clotting Factors for Hemoph.,Other Special Care,Coronary Care Unit,Total Number of Episodes,HHA,Title XVIII discharges,Subprovider II,Admin & Gen Under Contract,Central Services and Supply,Clinic,Radiology-Diagnostic,Other Special Care,Respiratory Therapy,Emergency,Radioisotope,Impl. Dev. Charged to Patients,Home Program Dialysis,Blood Clotting Factors for Hemoph.,"Blood Storing, Processing, Trans",Emergency,Delivery Room and Labor Room,Anesthesiology,Subprovider 1,Intensive Care Unit,Cafeteria,Islet Acquisition,Total Hospital,Renal Dialysis,Total Non Routine Medical  Supply Charges,NF,Subprovider II,Physical Therapy,Delivery Room and Labor Room,Home Office:  Physician Part A,Physicians' Private Office,Subtotal,Intravenous Therapy,OSP,ASC (Non Distinct Part),Organ Procurement,Coronary Care Unit,Interns & Residents,Renal Dialysis,Nursery,Non-Physician Anesthetist Part B,Islet Acquisition,Total Salaries,Total Charges,Paramedical Education,Physical Therapy,Drugs Charged to Patients,Cost To Charge Ratio,Drugs Charged to Patients,Cardiac Catheterization,Other Reimbursable,"Medical certified liver 
transplant center cert date",ASC (Non Distinct Part),Total,Respiratory Therapy,Drugs Charged to Patients,Program Inpatient Ancillary Service Cost,CORF,Total unreimbursed cost for Medicaid and CHIP and state and local indigent care programs,"If (SCH), enter the # of periods.",Other Reimbursable,MDH status ending date (MM/DD/YY),Physical Therapy,Intensive Care Unit,With Outliers:  Total Visits,FQHC,Speech Pathology,FQHC,Physical Therapy,Radiology-Therapeutic,Durable Medical Equipment Rented,Subprovider-IPF,Operating Room,Medical Supplies Charged to Patients,Renal 2 Provider Number,Liver Acquisition,Operating Room,Total Charges,PEP Episodes:  Total Number of Episodes,Home Program Dialysis,Other Nonreimbursable,Operating Room,Drugs Charged to Patients,Other Outpatient Services,Medical Supplies Charged to Patients,Radiology-Therapeutic,Delivery Room and Labor Room,MDH status beginning date  (MM/DD/YY),Subprovider I,FQHC,Clinic,Other Ancillary,Delivery Room and Labor Room,NF,NF,Hospital Adults & Pediatrics,Laboratory,Outpatient Rehab Provider,Other Ancillary,Interns & Res Salary and Fringe Benefits,Int & Res (non approved teaching program,Total,NF,Total Program General Inpatient Routine,Drugs Charged to Patients,Whole Blood & Packed Red Blood Cells,Durable Medical Equipment Sold,Respiratory Therapy,Nonpaid Workers,"Blood Storing, Processing, Trans",Observation Beds (Distinct Unit),HHA,Hospital Zip Code,Interns & Res Salary and Fringe Benefits,Anesthesiology,Other Ancillary,Medicare Certified Heart TC term date,Medical Supplies Charged to Patients,Total,Electrocardiology,Does the facility operate an ICF/MR facility for purposes of Title XIX? (Y/N),Other Ancillary,Pass through Cost for Program Inpatient,Anesthesiology,RHC 21 Provider Number,Outpatient Rehab Provider,Durable Medical Equipment Rented,Blood Clotting Factors for Hemoph.,Lung  Acquisition,Home Office Salaries & Wage Related Csts,Other Outpatient Services,RHC 22 Provider Number,Program Inpatient Ancillary Service Cost,Radiology-Diagnostic,Total,Total,Physical Therapy,"Blood Storing, Processing, Trans",Subprovider-IPF,Total reasonable charges,NF,CT Scan,Impl. Dev. Charged to Patients,Recovery Room,Surgical Intensive Care Unit,Total,Electrocardiology,Cardiac Catheterization,Burn Intensive Care Unit,Observation Beds (Distinct Unit),Other Outpatient Services,"Medical certified lung
transplant center cert date","Trade, Quantity, and Time Discounts",With Outliers:  Non Routine Med Sup Chgs,Physician Part A,Interns & Residents,Occupational Therapy,Utilization Review SNF,Land,OLTC,Other Medicaid Days,Electrocardiology,Burn Intensive Care Unit,Other Special Care,Total Other Charges,Medical Supplies Charged to Patients,SNF,Int & Res (non approved teaching program,Operating Room,Surgical Intensive Care Unit,Home Office Salaries & Wage Related Csts,Respiratory Therapy,Home Program Dialysis,Land,Other Ancillary,Other General Service,Islet Acquisition,Other Reimbursable,Total,Physical Therapy,Burn Intensive Care Unit,Renal Dialysis,Home Office Street,HHA,CT Scan,Delivery Room and Labor Room,Total Outpatient Program Pass Thru Cost,Anesthesiology,Impl. Dev. Charged to Patients,net of Swing Bed Cost,Coronary Care Unit,RHC 23 Provider Number,Housekeeping,Whole Blood & Packed Red Blood Cells,CMS Region Code,Observation Beds (Distinct Unit),Other Capital,Speech Pathology,Organ acquisition,Speech Pathology,Durable Medical Equipment Sold,Operating Room,HHA,Drugs Charged to Patients,Medicare allowable bad debts for the entire hospital complex,Lung  Acquisition,Non-Physician Anesthetist Part B,Other Adjustments (Summed),Laboratory,Radiology-Diagnostic,Electroencephalography,RHC/FQHC Combined,Subprovider-IPF,CMHC,Observation Beds (Distinct Unit),Contract Labor,Medical Supplies Charged to Patients,Medical Records & Med Records Library,Without Outliers:  Total Visits,Surgical Intensive Care Unit,Impl. Dev. Charged to Patients,Emergency,Radioisotope,RHC 17 Provider Number,"Blood Storing, Processing, Trans",Ambulance Services,Organ Procurement,Emergency,"Gift, Flower, Coffee Shop, Canteen",Coronary Care Unit,PBP Clinical Lab Services Program Only,Occupational Therapy,Nursery,Management and Administrative Services,Hospice 1 Provider Number,Buildings and Fixtures,Durable Medical Equipment Rented,Durable Medical Equipment Rented,Liver Acquisition,OPPS payments,Contract Labor,Surgical Intensive Care Unit,Laboratory,Without Outliers:  Non Routine Med Sup Chgs,"Gift, Flower, Coffee Shop, Canteen",Laundry and Linen Service,Other Ancillary,Employee Benefits,Hospice,Durable Medical Equipment Rented,Anesthesiology,Home Office Personnel,Subtotal Wage Related Csts,RHC,Maintenance of Personnel,Operating Room,Coronary Care Unit,ASC (Non Distinct Part),Electrocardiology,Physician Part A,Subprovider I,Adults and Pediatrics,Paid Losses,ASC (Non Distinct Part),CT Scan,Emergency,Other Special Purpose,Blood Clotting Factors for Hemoph.,Occupational Therapy,Other Organ Acquisition,Drugs Charged to Patients,Blood Clotting Factors for Hemoph.,Organ acquisition charges,Other Outpatient Services,Home Office:  Physician Part A,Nonphysician Anesthetists,Occupational Therapy,HVBP payment adjustment amount,Physical Therapy,CT Scan,Teaching Physician Salaries,Speech Pathology,Excluded Area Salaries,Recovery Room,Clinic,Other Ancillary,FQHC 8 Provider Number,Total Other Charges,MRI,Title V discharges,Title V discharges,Lung  Acquisition,CT Scan,Total,Building Improvements,Blood Clotting Factors for Hemoph.,Stand-alone CHIP -- Costs minus net revenue (0 min),Physical Therapy,Home Office Salaries,MRI,Administrative & General under contract,Durable Medical Equipment Rented,Medical and Other Services reimbursed by OPPS,Other Organ Acquisition,Radioisotope,LUPA Episodes:  Total Visits,Delivery Room and Labor Room,Occupational Therapy,Labor and Delivery Days -  Title XIX,Other Reimbursable,Nursing Administration,RHC 15 Provider Number,Drugs Charged to Patients,Anesthesiology,Kidney Acquisition,"Number of days in year dialysis 
furnished",Administrative and General,MRI,Teaching Physician Salaries,ASC (Distinct Part),Physical Therapy,Physician-Part B,Net Revenue from Medicaid,Durable Medical Equipment Sold,Respiratory Therapy,Surgical Intensive Care Unit,Home Program Dialysis,Electrocardiology,ASC (Non Distinct Part),Drugs Charged to Patients,Subtotal Salaries,Ancillary service other pass through costs,Drugs Charged to Patients,Whole Blood & Packed Red Blood Cells,Impl. Dev. Charged to Patients,Total Hospital Interns & Residents,Pancreas Acquisition,Impl. Dev. Charged to Patients,Drugs Charged to Patients,ESRD DME costs,Recovery Room,Intensive Care Unit,Total,Operation of Plant,MRI,Surgical Intensive Care Unit,Surgical Intensive Care Unit,Laboratory,Hospice,Non-Physician Anesthetist Part A,OSP,Radiology-Therapeutic,RHC 8 Provider Number,ASC 1 Provider Number,Subprovider-IRF,"Percentage of patients re-using
dialyzers",Hospital Name,Subprovider-IRF,PEP Episodes:  Total Visits,Other Outpatient Services,Impl. Dev. Charged to Patients,Fiscal Year End Date,Other Reimbursable,Surgical Intensive Care Unit,Buildings and Fixtures,Coronary Care Unit,Utilization,Nonpaid Workers,Cardiac Catheterization,IPF,Operating Room,Emergency,Hospice,Other Organ Acquisition,Operation of Plant,Burn Intensive Care Unit,Medical Supplies Charged to Patients,"Number of patients in program at 
end of cost reporting period",Subprovider I,Speech Pathology,Transitional corridor payment,Radioisotope,Durable Medical Equipment Sold,Respiratory Therapy,Physician-Part B,Subtotal Salaries,Heart Acquisition,Administrative and General,Radiology-Therapeutic,Medical Supplies Charged to Patients,ASC (Non Distinct Part),Other Reimbursable,Operating Room,Renal Dialysis,Total,Cardiac Catheterization,NF,Electrocardiology,ASC (Distinct Part),"Blood Storing, Processing, Trans",Subprovider-IRF,Adj for Physical therapy costs in excess,PEP Episodes:  Total Number of Episodes,Emergency,Impl. Dev. Charged to Patients,Durable Medical Equipment Rented,Drugs Charged to Patients,Cardiac Catheterization,Radiology-Diagnostic,Total Facility,Renal Dialysis,Operating Room,Respiratory Therapy,Intravenous Therapy,Coronary Care Unit,"Anesthetist, and Medical Education Costs",Cardiac Catheterization,MRI,Total,Operating Room,OLTC,Total Number of Episodes,Other Outpatient Services,Total Allied Health,Pharmacy,NF,Impl. Dev. Charged to Patients,NF,Anesthesiology,Housekeeping,Interns & Residents,Cardiac Catheterization,"Treatment capacity per day per
station",Interest Expense,Renal Dialysis,PEP Episodes:  Total Charges:,Physical Therapy,Subtotal,Other Outpatient Services,"Gift, Flower, Coffee Shop, Canteen",ASC (Non Distinct Part),Medical Supplies Charged to Patients,Nursery,Other Nonreimbursable,Radiology-Therapeutic,Speech Pathology,Other Outpatient Services,ICF,ICF,"Blood Storing, Processing, Trans",New Cap Related Csts Bldg & Fixtures,RHC,Laboratory,RHC,Other Reimbursable,Drugs Charged to Patients,Clinic,Anesthesiology,Report Status Code,Speech Pathology,CMHC,Nonphysician Anesthetists,CT Scan,Durable Medical Equipment Sold,Cross Foot Adjustments,Home Office Salaries & Wage Related Csts,Electrocardiology,New Cap Related Csts Movable Equipment,Cafeteria,RHC 19 Provider Number,Other Reimbursable,With Outliers:  Non Routine Med Sup Chgs,Maintenance of Personnel,Total discharges,Nonphysician Anesthetists,TOTAL,Pass through Cost for Program Inpatient Routine,Other Ancillary,Whole Blood & Packed Red Blood Cells,Housekeeping under contract,PEP Episodes:  Total Number of Episodes,Radioisotope,Intestinal Acquisition,Employee Benefits,Intravenous Therapy,Anesthesiology,Electroencephalography,Wage Related Costs Other,Coronary Care Unit,Other Ancillary,TOTAL,Recovery Room,Radiology-Diagnostic,Respiratory Therapy,Subprovider-IRF,Int & Res (non approved teaching program,FQHC 3 Provider Number,Lung  Acquisition,Durable Medical Equipment Rented,Radiology-Diagnostic,Home Program Dialysis,Respiratory Therapy,Hospice,Heart Acquisition,Fiscal Year Begin Date,Social Service,Other Ancillary,Occupational Therapy,Are provider based physicians' costs included in Worksheet A? (Y/N),Cost of patients approved for charity care and uninsured discounts,Occupational Therapy,Excluded Area Salaries,Surgical Intensive Care Unit,Clinic,Delivery Room and Labor Room,Durable Medical Equipment Rented,Adults and Pediatrics,Other Special Purpose,Ratio of line 15 to line 16,Laboratory,Amounts expected under 42 CFR,Nursery,Renal Dialysis,Drugs Charged to Patients,Heart Acquisition,Radiology-Diagnostic,"Blood Storing, Processing, Trans",PBP Clinical Lab Services Program Only,Total Allied Health,Net Salaries,Whole Blood & Packed Red Blood Cells,Total Nonphysician Anesthetist Cost,Physical Therapy,Social Service,Radiology-Diagnostic,Dietary,Other Nonreimbursable,Other Ancillary,Ambulance Services,Subprovider-IPF,FQHC 4 Provider Number,Pancreas Acquisition,Movable Equipment,Occupational Therapy,Other Ancillary,Surgical Intensive Care Unit,OOT,Respiratory Therapy,Radioisotope,"Sum of lines 3,4 divided by line 6",Medical Supplies Charged to Patients,Excluded Area Salaries,Without Outliers:  Non Routine Med Sup Chgs,Speech Pathology,Fixed Equipment,Operating Room,Subtotal,Subprovider 2,Adults and Pediatrics,Radioisotope,Radiology-Therapeutic,Other Ancillary,Laboratory,"Medicare certified kidney 
transplant center cert date",Delivery Room and Labor Room,SNF,Total Facility FTEs,Administrative and General,Other General Service,Physician Part A,Total Hospital,Line 2 times line 5,Total Hospital,Anesthesiology,Hospice 3 Provider Number,Other Reimbursable,Other Reimbursable,CMHC 1 Provider Number,net of Swing Bed Cost,Coronary Care Unit,certification date,RHC 13 Provider Number,Other Organ Acquisition,Dietary,Zip Code,RHC 24 Provider Number,Renal Dialysis,Interns and residents,Delivery Room and Labor Room,PBP Clinical Lab Services Program Only,Surgical Intensive Care Unit,Renal Dialysis,Surgical Intensive Care Unit Program Cost,Occupational Therapy,Kidney Acquisition,HHA,Respiratory Therapy,Total,Other Reimbursable,Physicians' Private Office,certification date,Program Ancillary Services,Heart Acquisition,Other Outpatient Services,Nursing School,SNF,Operating Room,Radiology-Therapeutic,Durable Medical Equipment Sold,Lung  Acquisition,Total Visits,Hospital County,CT Scan,Laboratory,Observation Beds (Distinct Unit),Radiology-Diagnostic,Radioisotope,Other Outpatient Services,Building Improvements,Whole Blood & Packed Red Blood Cells,Radioisotope,Hospice,Speech Pathology,RHC,Interns & Residents,MRI,Interest expense on Medicare Overpaymts,Title XIX discharges,IRF,Total Hospital,New Cap Related Csts Movable Equipment,Whole Blood & Packed Red Blood Cells,Speech Pathology,Premiums,Parking Lot,Anesthesiology,CT Scan,PBP Clinical Lab Services Program Only,New Cap Related Csts Bldg & Fixtures,Pharmacy,"Blood Storing, Processing, Trans",Home Office Salaries,Teaching Physician Salaries,Occupational Therapy,Adults and Pediatrics,SNF,Speech Pathology,Other Special Care Unit,PBP Clinical Lab Services Program Only,Operating Room,Clinic,Nursery,Cardiac Catheterization,Recovery Room,Intensive Care Unit,CAPD exchanges per day,Interns & Residents,Electrocardiology,Subprovider I,Emergency,Subtotal,Surgical Intensive Care Unit,Intravenous Therapy,Home Office:  Physician Part A,"Blood Storing, Processing, Trans",Pancreas Acquisition,Delivery Room and Labor Room,Cardiac Catheterization,Whole Blood & Packed Red Blood Cells,Respiratory Therapy,Durable Medical Equipment Sold,Blood Clotting Factors for Hemoph.,MRI,Allowable bad debts,Impl. Dev. Charged to Patients,Subprovider I,Interns & Residents,MRI,Medical Supplies Charged to Patients,"Number of Times per week
 Patient receives Dialysis",Occupational Therapy,net of Swing Bed and Private Room Diff,Primary payer payments,Int & Res (non approved teaching program,Electrocardiology,Operating Cost and Target Amount,Excluded Area Salaries,Total,Whole Blood & Packed Red Blood Cells,LUPA Episodes:  Total Visits,Other Reimbursable,Contract Labor,ICF,Intensive Care Unit,Radiology-Therapeutic,New Cap Related Csts Movable Equipment,Pass through Cost for Program Inpatient,Physical Therapy,Nursery,CMHC,Other Special Purpose,"Average patient dialysis time 
including setup",Physical Therapy,Nonpaid Workers,Medical Supplies Charged to Patients,Other Ancillary,Subprovider I,Impl. Dev. Charged to Patients,Total Salaries,"Does the facility qualify and is it receiving payments for 
disproportionate share? (Y/N)",Recovery Room,"Treatment capacity per day per
station",Burn Intensive Care Unit Program Cost,Burn Intensive Care Unit,Maintenance and Repairs,Electrocardiology,Maintenance and Repairs,Central Services and Supply,Islet Acquisition,"Number of patients in program at 
end of cost reporting period",Intravenous Therapy,Ambulance Services,Administrative and General,Nursing Administration,Observation Beds (Distinct Unit),Cross Foot Adjustments,ASC (Non Distinct Part),Emergency,Operating Room,Recovery Room,Respiratory Therapy,MRI,Impl. Dev. Charged to Patients,HHA,Total Charges,Intensive Care Unit,Other Ancillary,Number of EPO units furnished for Line 13,Occupational Therapy,ASC (Non Distinct Part),Physician-Part A,Clinic,Other Organ Acquisition,PBP Clinical Lab Services Program Only,RPCH/CAH Visits,Other Organ Acquisition,Total Other Medical Education,Program Inpatient Ancillary Service Cost,Other Outpatient Services,MRI,Total Hospital,Renal Dialysis,Subprovider I,Electroencephalography,Emergency,RHC/FQHC Combined,Renal Dialysis,Pancreas Acquisition,SSA State County Code,Hospital Title 18 Payment System (P/T/O),Medical Supplies Charged to Patients,Medical Supplies Charged to Patients,Ambulance Services,HHA,W/Out Outliers:  Number of Episodes,net of Swing Bed and Private Room Diff,Radioisotope,Total Other Charges,Cafeteria,Liver Acquisition,Surgical Intensive Care Unit,Home Program Dialysis,Negative Cost Centers,Recovery Room,Anesthesiology,SNF,Renal Dialysis,Physical Therapy,Total Charges:  LUPA Episodes,IRF,Total,ICF,Whole Blood & Packed Red Blood Cells,Fiscal Intermediary/MAC Create Date,OPT,OPT,IRF Provider Number,Adults & Pediatrics,HHA 1 Provider Number,Housekeeping,Subtotal,Laundry and Linen Service,MRI,MRI,Renal 6 Provider Number,Home Office Personnel,Impl. Dev. Charged to Patients,Durable Medical Equipment Sold,Whole Blood & Packed Red Blood Cells,Home Program Dialysis,Total Visits,Occupational Therapy,ASC (Distinct Part),Total Hospital Interns & Residents,Liver Acquisition,Observation Beds (Distinct Unit),Pancreas Acquisition,Radioisotope,Nonpaid Workers,Related Salaries,Occupational Therapy,Physical Therapy,Surgical Intensive Care Unit,Hospital Adlts & Ped Swing Bed SNF,Kidney Acquisition,Home Office Personnel,Islet Acquisition,Electrocardiology,PEP Episodes:  Other Charges,Renal 7 Provider Number,Subtotal Other Wages and Related Csts,RHC 6 Provider Number,Without Outliers:  Other Charges,CORF,Laundry and Linen Service,ASC (Non Distinct Part),Other Outpatient Services,OPT,Impl. Dev. Charged to Patients,Pharmacy,New Capital Buildings and Fixtures,Hospice,RHC 1 Provider Number,CT Scan,Other Outpatient Services,IRF,Excluded Area Salaries,Nursery,ICF,Radiology-Therapeutic,New Capital Equipment,Land,Administrative and General,Respiratory Therapy,Subprovider-IRF,Subprovider I,Electroencephalography,Operating Room,CT Scan,Surgical Intensive Care Unit,Kidney Acquisition,"Blood Storing, Processing, Trans",OLTC,Deductibles and coinsurance related to line 24,Radiology-Diagnostic,Other Reimbursable,Clinic,Drugs Charged to Patients,Islet Acquisition,Title XIX discharges,Intensive Care Unit,Title XVIII discharges,ASC (Non Distinct Part),Other Ancillary,PBP Clinical Lab Services Program Only,ASC (Non Distinct Part),HHA,Medicaid Observation Days,OOT,Cardiac Catheterization,Durable Medical Equipment Rented,Renal Dialysis,Emergency,Whole Blood & Packed Red Blood Cells,Dietary,Utilization Review-physicians compens,"Does this facility operate 
transplant center? (Y/N)",Speech Pathology,ASC (Distinct Part),Hospice,Durable Medical Equipment Sold,Subprovider-IRF,Subprovider-IPF,Social Service,Renal Dialysis,Total,Radiology-Therapeutic,Intravenous Therapy,Laboratory,Emergency,Cardiac Catheterization,Recovery Room,Laboratory,Speech Pathology,Wage Related Costs Core,FQHC 6 Provider Number,Renal 4 Provider Number,Radiology-Diagnostic,Clinic,Wage Related Costs RHC/FQHC,Beginning Date of SCH status,Speech Pathology,Cardiac Catheterization,OSP,Delivery Room and Labor Room,Admin & Gen Under Contract,Is this hospital classified as a referral center? (Y/N),"Average patient dialysis time 
including setup",Intravenous Therapy,OLTC,Interns & Residents,Nursing Administration,Total Overhead Costs,Paramedical Education,Intravenous Therapy,Total Hospital,Received DSH or supplemental payments from Medicaid? (Y/N),Hospital Type,Radiology-Diagnostic,Intestinal Acquisition,Anesthesiology,or allied health costs?,OLTC,Heart Acquisition,"Net costs of Epoietin furnished to
all maintenance dialysis patients
by the provider",Social Service,Whole Blood & Packed Red Blood Cells,CT Scan,Home Program Dialysis,FFY,Hospital Type (Care Compare),Name and Num
,Curated Name and Num,Hospital type (HCRIS + care compare),,Lon,Lat,APPORTIONMENT OF INPATIENT/OUTPATIENT ANCILLARY SERVICE OTHER PASS THROUGH COSTS,INPATIENT ANCILLARY SERVICE COST APPORTIONMENT,APPORTIONMENT OF INPATIENT/OUTPATIENT ANCILLARY SERVICE OTHER PASS THROUGH COSTS,HHA STATISTICAL DATA,HHA STATISTICAL DATA,TRIAL BALANCE OF EXPENSE ACCOUNTS,HOSPITAL WAGE INDEX DATA,APPORTIONMENT OF INPATIENT/OUTPATIENT ANCILLARY SERVICE OTHER PASS THROUGH COSTS,ADJUSTMENTS,HHA STATISTICAL DATA,APPORTIONMENT OF MEDICAL AND OTHER HEALTH SERVICES,INPATIENT ANCILLARY SERVICE COST APPORTIONMENT,COST ALLOCATION,TRIAL BALANCE OF EXPENSE ACCOUNTS,COMPUTATION OF INPATIENT OPERATING COSTS,HOSPITAL WAGE INDEX DATA,HOSPITAL WAGE INDEX DATA,TRIAL BALANCE OF EXPENSE ACCOUNTS,Total Inpatient Days/Outpatient Visits,HOSPITAL WAGE INDEX DATA,APPORTIONMENT OF INPATIENT/OUTPATIENT ANCILLARY SERVICE OTHER PASS THROUGH COSTS,,APPORTIONMENT OF INPATIENT/OUTPATIENT ANCILLARY SERVICE OTHER PASS THROUGH COSTS,APPORTIONMENT OF INPATIENT/OUTPATIENT ANCILLARY SERVICE OTHER PASS THROUGH COSTS,COST ALLOCATION,COST ALLOCATION,S-10 DATA,APPORTIONMENT OF INPATIENT/OUTPATIENT ANCILLARY SERVICE OTHER PASS THROUGH COSTS,INPATIENT ANCILLARY SERVICE COST APPORTIONMENT,COST ALLOCATION,TRIAL BALANCE OF EXPENSE ACCOUNTS,TRIAL BALANCE OF EXPENSE ACCOUNTS,COMPUTATION OF RATIO OF COST TO CHARGES,TRIAL BALANCE OF EXPENSE ACCOUNTS,APPORTIONMENT OF INPATIENT/OUTPATIENT ANCILLARY SERVICE OTHER PASS THROUGH COSTS,,RENAL STATISTICAL DATA,COST ALLOCATION,TRIAL BALANCE OF EXPENSE ACCOUNTS,RENAL STATISTICAL DATA,COMPUTATION OF RATIO OF COST TO CHARGES,COMPUTATION OF RATIO OF COST TO CHARGES,APPORTIONMENT OF MEDICAL AND OTHER HEALTH SERVICES,APPORTIONMENT OF MEDICAL AND OTHER HEALTH SERVICES,HOSPITAL WAGE INDEX DATA,TRIAL BALANCE OF EXPENSE ACCOUNTS,COMPUTATION OF RATIO OF COST TO CHARGES,INPATIENT ANCILLARY SERVICE COST APPORTIONMENT,COMPUTATION OF RATIO OF COST TO CHARGES,CALCULATION OF REIMBURSEMENT SETTLEMENT,COST ALLOCATION,APPORTIONMENT OF INPATIENT/OUTPATIENT ANCILLARY SERVICE OTHER PASS THROUGH COSTS,TRIAL BALANCE OF EXPENSE ACCOUNTS,TRIAL BALANCE OF EXPENSE ACCOUNTS,APPORTIONMENT OF INPATIENT/OUTPATIENT ANCILLARY SERVICE OTHER PASS THROUGH COSTS,Medicaid Inpatient Days/Outpatient Visits,HHA STATISTICAL DATA,COMPUTATION OF RATIO OF COST TO CHARGES,APPORTIONMENT OF INPATIENT/OUTPATIENT ANCILLARY SERVICE OTHER PASS THROUGH COSTS,HHA STATISTICAL DATA,INPATIENT ANCILLARY SERVICE COST APPORTIONMENT,APPORTIONMENT OF INPATIENT/OUTPATIENT ANCILLARY SERVICE OTHER PASS THROUGH COSTS,COMPUTATION OF RATIO OF COST TO CHARGES,COST ALLOCATION,ALLOCATION OF NEW CAPITAL COSTS,INPATIENT ANCILLARY SERVICE COST APPORTIONMENT,INPATIENT ANCILLARY SERVICE COST APPORTIONMENT,COST ALLOCATION,,APPORTIONMENT OF MEDICAL AND OTHER HEALTH SERVICES,COST ALLOCATION,TRIAL BALANCE OF EXPENSE ACCOUNTS,,HOSPITAL WAGE INDEX DATA,APPORTIONMENT OF MEDICAL AND OTHER HEALTH SERVICES,APPORTIONMENT OF INPATIENT/OUTPATIENT ANCILLARY SERVICE OTHER PASS THROUGH COSTS,APPORTIONMENT OF INPATIENT/OUTPATIENT ANCILLARY SERVICE OTHER PASS THROUGH COSTS,ANALYSIS OF CHANGES IN NEW CAPITAL BALANCES,HHA STATISTICAL DATA,APPORTIONMENT OF INPATIENT/OUTPATIENT ANCILLARY SERVICE OTHER PASS THROUGH COSTS,COST ALLOCATION,COST ALLOCATION,HHA STATISTICAL DATA,COST ALLOCATION,COMPUTATION OF RATIO OF COST TO CHARGES,TRIAL BALANCE OF EXPENSE ACCOUNTS,APPORTIONMENT OF INPATIENT/OUTPATIENT ANCILLARY SERVICE OTHER PASS THROUGH COSTS,TRIAL BALANCE OF EXPENSE ACCOUNTS,HOSPITAL WAGE INDEX DATA,HOSPITAL WAGE INDEX DATA,,INPATIENT ANCILLARY SERVICE COST APPORTIONMENT,APPORTIONMENT OF INPATIENT ROUTINE SERVICE CAPITAL COSTS,APPORTIONMENT OF INPATIENT ROUTINE SERVICE OTHER PASS THROUGH COSTS,APPORTIONMENT OF INPATIENT/OUTPATIENT ANCILLARY SERVICE OTHER PASS THROUGH COSTS,APPORTIONMENT OF MEDICAL AND OTHER HEALTH SERVICES,COST ALLOCATION,TRIAL BALANCE OF EXPENSE ACCOUNTS,APPORTIONMENT OF INPATIENT/OUTPATIENT ANCILLARY SERVICE OTHER PASS THROUGH COSTS,INPATIENT ANCILLARY SERVICE COST APPORTIONMENT,HOSPITAL WAGE INDEX DATA,HOSPITAL WAGE INDEX DATA,APPORTIONMENT OF INPATIENT/OUTPATIENT ANCILLARY SERVICE OTHER PASS THROUGH COSTS,COMPUTATION OF RATIO OF COST TO CHARGES,TRIAL BALANCE OF EXPENSE ACCOUNTS,APPORTIONMENT OF INPATIENT/OUTPATIENT ANCILLARY SERVICE OTHER PASS THROUGH COSTS,,RENAL STATISTICAL DATA,TRIAL BALANCE OF EXPENSE ACCOUNTS,APPORTIONMENT OF MEDICAL AND OTHER HEALTH SERVICES,APPORTIONMENT OF MEDICAL AND OTHER HEALTH SERVICES,APPORTIONMENT OF INPATIENT/OUTPATIENT ANCILLARY SERVICE OTHER PASS THROUGH COSTS,TRIAL BALANCE OF EXPENSE ACCOUNTS,,INPATIENT ANCILLARY SERVICE COST APPORTIONMENT,HHA STATISTICAL DATA,TRIAL BALANCE OF EXPENSE ACCOUNTS,COMPUTATION OF RATIO OF COST TO CHARGES,TRIAL BALANCE OF EXPENSE ACCOUNTS,COMPUTATION OF INPATIENT OPERATING COSTS,HOSPITAL WAGE INDEX DATA,CALCULATION OF REIMBURSEMENT SETTLEMENT,COMPUTATION OF RATIO OF COST TO CHARGES,APPORTIONMENT OF MEDICAL AND OTHER HEALTH SERVICES,APPORTIONMENT OF MEDICAL AND OTHER HEALTH SERVICES,TRIAL BALANCE OF EXPENSE ACCOUNTS,APPORTIONMENT OF INPATIENT/OUTPATIENT ANCILLARY SERVICE OTHER PASS THROUGH COSTS,APPORTIONMENT OF MEDICAL AND OTHER HEALTH SERVICES,APPORTIONMENT OF MEDICAL AND OTHER HEALTH SERVICES,Medicaid Inpatient Days/Outpatient Visits,TRIAL BALANCE OF EXPENSE ACCOUNTS,APPORTIONMENT OF MEDICAL AND OTHER HEALTH SERVICES,APPORTIONMENT OF INPATIENT/OUTPATIENT ANCILLARY SERVICE OTHER PASS THROUGH COSTS,TRIAL BALANCE OF EXPENSE ACCOUNTS,TRIAL BALANCE OF EXPENSE ACCOUNTS,TRIAL BALANCE OF EXPENSE ACCOUNTS,TRIAL BALANCE OF EXPENSE ACCOUNTS,COST ALLOCATION,HOSPITAL WAGE INDEX DATA,APPORTIONMENT OF MEDICAL AND OTHER HEALTH SERVICES,INPATIENT ANCILLARY SERVICE COST APPORTIONMENT,RENAL STATISTICAL DATA,APPORTIONMENT OF INPATIENT/OUTPATIENT ANCILLARY SERVICE OTHER PASS THROUGH COSTS,INPATIENT ANCILLARY SERVICE COST APPORTIONMENT,TRIAL BALANCE OF EXPENSE ACCOUNTS,HOSPITAL WAGE INDEX DATA,APPORTIONMENT OF INPATIENT/OUTPATIENT ANCILLARY SERVICE OTHER PASS THROUGH COSTS,,COMPUTATION OF RATIO OF COST TO CHARGES,COST ALLOCATION,,APPORTIONMENT OF INPATIENT/OUTPATIENT ANCILLARY SERVICE OTHER PASS THROUGH COSTS,COST ALLOCATION,INPATIENT ANCILLARY SERVICE COST APPORTIONMENT,ALLOCATION OF NEW CAPITAL COSTS,HHA STATISTICAL DATA,HHA STATISTICAL DATA,APPORTIONMENT OF MEDICAL AND OTHER HEALTH SERVICES,,APPORTIONMENT OF MEDICAL AND OTHER HEALTH SERVICES,APPORTIONMENT OF INPATIENT/OUTPATIENT ANCILLARY SERVICE OTHER PASS THROUGH COSTS,RENAL STATISTICAL DATA,APPORTIONMENT OF INPATIENT ROUTINE SERVICE OTHER PASS THROUGH COSTS,TRIAL BALANCE OF EXPENSE ACCOUNTS,INPATIENT ANCILLARY SERVICE COST APPORTIONMENT,NUMBER OF BEDS,APPORTIONMENT OF INPATIENT ROUTINE SERVICE OTHER PASS THROUGH COSTS,INPATIENT ANCILLARY SERVICE COST APPORTIONMENT,HOSPITAL WAGE INDEX DATA,APPORTIONMENT OF INPATIENT/OUTPATIENT ANCILLARY SERVICE OTHER PASS THROUGH COSTS,COMPUTATION OF RATIO OF COST TO CHARGES,INPATIENT ANCILLARY SERVICE COST APPORTIONMENT,ADJUSTMENTS,TRIAL BALANCE OF EXPENSE ACCOUNTS,HOSPITAL WAGE INDEX DATA,HOSPITAL WAGE INDEX DATA,COMPUTATION OF RATIO OF COST TO CHARGES,HOSPITAL WAGE INDEX DATA,,APPORTIONMENT OF MEDICAL AND OTHER HEALTH SERVICES,NUMBER OF BEDS,HOSPITAL WAGE INDEX DATA,COST ALLOCATION,TRIAL BALANCE OF EXPENSE ACCOUNTS,COMPUTATION OF RATIO OF COST TO CHARGES,APPORTIONMENT OF INPATIENT/OUTPATIENT ANCILLARY SERVICE OTHER PASS THROUGH COSTS,TRIAL BALANCE OF EXPENSE ACCOUNTS,INPATIENT ANCILLARY SERVICE COST APPORTIONMENT,ALLOCATION OF NEW CAPITAL COSTS,APPORTIONMENT OF INPATIENT/OUTPATIENT ANCILLARY SERVICE OTHER PASS THROUGH COSTS,APPORTIONMENT OF INPATIENT/OUTPATIENT ANCILLARY SERVICE OTHER PASS THROUGH COSTS,TRIAL BALANCE OF EXPENSE ACCOUNTS,HOSPITAL WAGE INDEX DATA,ANALYSIS OF CHANGES IN NEW CAPITAL BALANCES,COST ALLOCATION,INPATIENT ANCILLARY SERVICE COST APPORTIONMENT,,RENAL STATISTICAL DATA,ADJUSTMENTS,INPATIENT ANCILLARY SERVICE COST APPORTIONMENT,APPORTIONMENT OF MEDICAL AND OTHER HEALTH SERVICES,APPORTIONMENT OF MEDICAL AND OTHER HEALTH SERVICES,HOSPITAL IDENTIFICATION INFORMATION,ALLOCATION OF NEW CAPITAL COSTS,TRIAL BALANCE OF EXPENSE ACCOUNTS,COST ALLOCATION,APPORTIONMENT OF MEDICAL AND OTHER HEALTH SERVICES,COST ALLOCATION,,APPORTIONMENT OF INPATIENT/OUTPATIENT ANCILLARY SERVICE OTHER PASS THROUGH COSTS,ALLOCATION OF NEW CAPITAL COSTS,COST ALLOCATION,COMPUTATION OF RATIO OF COST TO CHARGES,INPATIENT ANCILLARY SERVICE COST APPORTIONMENT,CALCULATION OF REIMBURSEMENT SETTLEMENT,,Medicaid Inpatient Days/Outpatient Visits,COST ALLOCATION,COMPUTATION OF RATIO OF COST TO CHARGES,COMPUTATION OF RATIO OF COST TO CHARGES,APPORTIONMENT OF MEDICAL AND OTHER HEALTH SERVICES,COMPUTATION OF INPATIENT OPERATING COSTS,APPORTIONMENT OF MEDICAL AND OTHER HEALTH SERVICES,CALCULATION OF REIMBURSEMENT SETTLEMENT,CALCULATION OF REIMBURSEMENT SETTLEMENT,APPORTIONMENT OF INPATIENT/OUTPATIENT ANCILLARY SERVICE OTHER PASS THROUGH COSTS,Total Inpatient Days/Outpatient Visits,S-10 DATA,ALLOCATION OF NEW CAPITAL COSTS,COMPUTATION OF RATIO OF COST TO CHARGES,APPORTIONMENT OF MEDICAL AND OTHER HEALTH SERVICES,HOSPITAL WAGE INDEX DATA,APPORTIONMENT OF INPATIENT/OUTPATIENT ANCILLARY SERVICE OTHER PASS THROUGH COSTS,APPORTIONMENT OF INPATIENT/OUTPATIENT ANCILLARY SERVICE OTHER PASS THROUGH COSTS,TRIAL BALANCE OF EXPENSE ACCOUNTS,APPORTIONMENT OF INPATIENT/OUTPATIENT ANCILLARY SERVICE OTHER PASS THROUGH COSTS,,APPORTIONMENT OF INPATIENT/OUTPATIENT ANCILLARY SERVICE OTHER PASS THROUGH COSTS,Total Inpatient Days/Outpatient Visits,COST ALLOCATION,CALCULATION OF REIMBURSEMENT SETTLEMENT,COST ALLOCATION,HHA STATISTICAL DATA,INPATIENT ANCILLARY SERVICE COST APPORTIONMENT,INPATIENT ANCILLARY SERVICE COST APPORTIONMENT,COST ALLOCATION,TRIAL BALANCE OF EXPENSE ACCOUNTS,,INPATIENT ANCILLARY SERVICE COST APPORTIONMENT,COST ALLOCATION,TRIAL BALANCE OF EXPENSE ACCOUNTS,APPORTIONMENT OF MEDICAL AND OTHER HEALTH SERVICES,APPORTIONMENT OF MEDICAL AND OTHER HEALTH SERVICES,Medicaid Inpatient Days/Outpatient Visits,INPATIENT ANCILLARY SERVICE COST APPORTIONMENT,COST ALLOCATION,ANALYSIS OF CHANGES IN NEW CAPITAL BALANCES,ALLOCATION OF NEW CAPITAL COSTS,INPATIENT ANCILLARY SERVICE COST APPORTIONMENT,APPORTIONMENT OF INPATIENT/OUTPATIENT ANCILLARY SERVICE OTHER PASS THROUGH COSTS,HOSPITAL WAGE INDEX DATA,COMPUTATION OF RATIO OF COST TO CHARGES,APPORTIONMENT OF INPATIENT/OUTPATIENT ANCILLARY SERVICE OTHER PASS THROUGH COSTS,APPORTIONMENT OF INPATIENT/OUTPATIENT ANCILLARY SERVICE OTHER PASS THROUGH COSTS,HOSPITAL WAGE INDEX DATA,COST ALLOCATION,INPATIENT ANCILLARY SERVICE COST APPORTIONMENT,INPATIENT ANCILLARY SERVICE COST APPORTIONMENT,TRIAL BALANCE OF EXPENSE ACCOUNTS,COMPUTATION OF RATIO OF COST TO CHARGES,ANALYSIS OF CHANGES IN NEW CAPITAL BALANCES,INPATIENT ANCILLARY SERVICE COST APPORTIONMENT,COMPUTATION OF RATIO OF COST TO CHARGES,APPORTIONMENT OF INPATIENT/OUTPATIENT ANCILLARY SERVICE OTHER PASS THROUGH COSTS,INPATIENT ANCILLARY SERVICE COST APPORTIONMENT,APPORTIONMENT OF INPATIENT/OUTPATIENT ANCILLARY SERVICE OTHER PASS THROUGH COSTS,ALLOCATION OF NEW CAPITAL COSTS,APPORTIONMENT OF INPATIENT ROUTINE SERVICE CAPITAL COSTS,ALLOCATION OF NEW CAPITAL COSTS,ALLOCATION OF NEW CAPITAL COSTS,COST ALLOCATION,,CALCULATION OF REIMBURSEMENT SETTLEMENT,APPORTIONMENT OF MEDICAL AND OTHER HEALTH SERVICES,APPORTIONMENT OF MEDICAL AND OTHER HEALTH SERVICES,APPORTIONMENT OF INPATIENT/OUTPATIENT ANCILLARY SERVICE OTHER PASS THROUGH COSTS,TRIAL BALANCE OF EXPENSE ACCOUNTS,COST ALLOCATION,COMPUTATION OF RATIO OF COST TO CHARGES,Total Inpatient Days/Outpatient Visits,HOSPITAL WAGE INDEX DATA,INPATIENT ANCILLARY SERVICE COST APPORTIONMENT,TRIAL BALANCE OF EXPENSE ACCOUNTS,APPORTIONMENT OF INPATIENT/OUTPATIENT ANCILLARY SERVICE OTHER PASS THROUGH COSTS,COST ALLOCATION,,TRIAL BALANCE OF EXPENSE ACCOUNTS,TRIAL BALANCE OF EXPENSE ACCOUNTS,,,HOSPITAL WAGE INDEX DATA,APPORTIONMENT OF MEDICAL AND OTHER HEALTH SERVICES,BED DAYS AVAILABLE,ANALYSIS OF CHANGES IN NEW CAPITAL BALANCES,,HOSPITAL WAGE INDEX DATA,COST ALLOCATION,HOSPITAL WAGE INDEX DATA,APPORTIONMENT OF INPATIENT/OUTPATIENT ANCILLARY SERVICE OTHER PASS THROUGH COSTS,TRIAL BALANCE OF EXPENSE ACCOUNTS,INPATIENT ANCILLARY SERVICE COST APPORTIONMENT,APPORTIONMENT OF INPATIENT/OUTPATIENT ANCILLARY SERVICE OTHER PASS THROUGH COSTS,TRIAL BALANCE OF EXPENSE ACCOUNTS,APPORTIONMENT OF MEDICAL AND OTHER HEALTH SERVICES,INPATIENT ANCILLARY SERVICE COST APPORTIONMENT,HOSPITAL WAGE INDEX DATA,INPATIENT ANCILLARY SERVICE COST APPORTIONMENT,INPATIENT ANCILLARY SERVICE COST APPORTIONMENT,NUMBER OF BEDS,INPATIENT ANCILLARY SERVICE COST APPORTIONMENT,APPORTIONMENT OF INPATIENT/OUTPATIENT ANCILLARY SERVICE OTHER PASS THROUGH COSTS,COST ALLOCATION,ADJUSTMENTS,ALLOCATION OF NEW CAPITAL COSTS,INPATIENT ANCILLARY SERVICE COST APPORTIONMENT,,,Total Inpatient Days/Outpatient Visits,HOSPITAL WAGE INDEX DATA,COST ALLOCATION,TRIAL BALANCE OF EXPENSE ACCOUNTS,APPORTIONMENT OF INPATIENT/OUTPATIENT ANCILLARY SERVICE OTHER PASS THROUGH COSTS,APPORTIONMENT OF INPATIENT ROUTINE SERVICE OTHER PASS THROUGH COSTS,ANALYSIS OF CHANGES IN NEW CAPITAL BALANCES,HOSPITAL WAGE INDEX DATA,TRIAL BALANCE OF EXPENSE ACCOUNTS,APPORTIONMENT OF MEDICAL AND OTHER HEALTH SERVICES,COMPUTATION OF RATIO OF COST TO CHARGES,TRIAL BALANCE OF EXPENSE ACCOUNTS,COMPUTATION OF RATIO OF COST TO CHARGES,APPORTIONMENT OF INPATIENT/OUTPATIENT ANCILLARY SERVICE OTHER PASS THROUGH COSTS,COST ALLOCATION,S-10 DATA,APPORTIONMENT OF INPATIENT/OUTPATIENT ANCILLARY SERVICE OTHER PASS THROUGH COSTS,COST ALLOCATION,APPORTIONMENT OF INPATIENT/OUTPATIENT ANCILLARY SERVICE OTHER PASS THROUGH COSTS,COMPUTATION OF RATIO OF COST TO CHARGES,TRIAL BALANCE OF EXPENSE ACCOUNTS,COST ALLOCATION,APPORTIONMENT OF INPATIENT/OUTPATIENT ANCILLARY SERVICE OTHER PASS THROUGH COSTS,APPORTIONMENT OF INPATIENT/OUTPATIENT ANCILLARY SERVICE OTHER PASS THROUGH COSTS,NUMBER OF BEDS,COMPUTATION OF RATIO OF COST TO CHARGES,,INPATIENT ANCILLARY SERVICE COST APPORTIONMENT,APPORTIONMENT OF INPATIENT/OUTPATIENT ANCILLARY SERVICE OTHER PASS THROUGH COSTS,APPORTIONMENT OF INPATIENT/OUTPATIENT ANCILLARY SERVICE OTHER PASS THROUGH COSTS,Total Inpatient Days/Outpatient Visits,CALCULATION OF REIMBURSEMENT SETTLEMENT,HOSPITAL WAGE INDEX DATA,INPATIENT ANCILLARY SERVICE COST APPORTIONMENT,APPORTIONMENT OF INPATIENT/OUTPATIENT ANCILLARY SERVICE OTHER PASS THROUGH COSTS,INPATIENT ANCILLARY SERVICE COST APPORTIONMENT,COMPUTATION OF RATIO OF COST TO CHARGES,APPORTIONMENT OF INPATIENT/OUTPATIENT ANCILLARY SERVICE OTHER PASS THROUGH COSTS,APPORTIONMENT OF MEDICAL AND OTHER HEALTH SERVICES,ALLOCATION OF NEW CAPITAL COSTS,INPATIENT ANCILLARY SERVICE COST APPORTIONMENT,APPORTIONMENT OF INPATIENT/OUTPATIENT ANCILLARY SERVICE OTHER PASS THROUGH COSTS,APPORTIONMENT OF INPATIENT/OUTPATIENT ANCILLARY SERVICE OTHER PASS THROUGH COSTS,APPORTIONMENT OF INPATIENT/OUTPATIENT ANCILLARY SERVICE OTHER PASS THROUGH COSTS,TRIAL BALANCE OF EXPENSE ACCOUNTS,APPORTIONMENT OF MEDICAL AND OTHER HEALTH SERVICES,APPORTIONMENT OF MEDICAL AND OTHER HEALTH SERVICES,HOSPITAL WAGE INDEX DATA,HOSPITAL WAGE INDEX DATA,INPATIENT ANCILLARY SERVICE COST APPORTIONMENT,S-10 DATA,Medicaid Inpatient Days/Outpatient Visits,APPORTIONMENT OF MEDICAL AND OTHER HEALTH SERVICES,HHA STATISTICAL DATA,HOSPITAL WAGE INDEX DATA,COMPUTATION OF RATIO OF COST TO CHARGES,APPORTIONMENT OF INPATIENT ROUTINE SERVICE CAPITAL COSTS,HOSPITAL WAGE INDEX DATA,HOSPITAL WAGE INDEX DATA,COST ALLOCATION,INPATIENT ANCILLARY SERVICE COST APPORTIONMENT,APPORTIONMENT OF INPATIENT/OUTPATIENT ANCILLARY SERVICE OTHER PASS THROUGH COSTS,INPATIENT ANCILLARY SERVICE COST APPORTIONMENT,INPATIENT ANCILLARY SERVICE COST APPORTIONMENT,INPATIENT ANCILLARY SERVICE COST APPORTIONMENT,CALCULATION OF REIMBURSEMENT SETTLEMENT,Medicaid Inpatient Days/Outpatient Visits,COST ALLOCATION,COST ALLOCATION,INPATIENT ANCILLARY SERVICE COST APPORTIONMENT,,Medicare Inpatient Days/Outpatient Visits,COST ALLOCATION,S-10 DATA,APPORTIONMENT OF INPATIENT/OUTPATIENT ANCILLARY SERVICE OTHER PASS THROUGH COSTS,APPORTIONMENT OF MEDICAL AND OTHER HEALTH SERVICES,APPORTIONMENT OF INPATIENT/OUTPATIENT ANCILLARY SERVICE OTHER PASS THROUGH COSTS,COST ALLOCATION,HHA STATISTICAL DATA,INPATIENT ANCILLARY SERVICE COST APPORTIONMENT,APPORTIONMENT OF INPATIENT/OUTPATIENT ANCILLARY SERVICE OTHER PASS THROUGH COSTS,APPORTIONMENT OF MEDICAL AND OTHER HEALTH SERVICES,APPORTIONMENT OF MEDICAL AND OTHER HEALTH SERVICES,APPORTIONMENT OF INPATIENT/OUTPATIENT ANCILLARY SERVICE OTHER PASS THROUGH COSTS,HOSPITAL WAGE INDEX DATA,ANALYSIS OF CHANGES IN NEW CAPITAL BALANCES,TRIAL BALANCE OF EXPENSE ACCOUNTS,COMPUTATION OF INPATIENT OPERATING COSTS,S-10 DATA,HOSPITAL WAGE INDEX DATA,COST ALLOCATION,APPORTIONMENT OF INPATIENT/OUTPATIENT ANCILLARY SERVICE OTHER PASS THROUGH COSTS,TRIAL BALANCE OF EXPENSE ACCOUNTS,COST ALLOCATION,APPORTIONMENT OF INPATIENT/OUTPATIENT ANCILLARY SERVICE OTHER PASS THROUGH COSTS,ADJUSTMENTS,COST ALLOCATION,COST ALLOCATION,S-10 DATA,COMPUTATION OF RATIO OF COST TO CHARGES,APPORTIONMENT OF INPATIENT ROUTINE SERVICE OTHER PASS THROUGH COSTS,TRIAL BALANCE OF EXPENSE ACCOUNTS,COST ALLOCATION,APPORTIONMENT OF MEDICAL AND OTHER HEALTH SERVICES,APPORTIONMENT OF INPATIENT/OUTPATIENT ANCILLARY SERVICE OTHER PASS THROUGH COSTS,TRIAL BALANCE OF EXPENSE ACCOUNTS,COMPUTATION OF RATIO OF COST TO CHARGES,Total Inpatient Days/Outpatient Visits,COST ALLOCATION,COMPUTATION OF RATIO OF COST TO CHARGES,HHA STATISTICAL DATA,RENAL STATISTICAL DATA,TRIAL BALANCE OF EXPENSE ACCOUNTS,TRIAL BALANCE OF EXPENSE ACCOUNTS,INPATIENT ANCILLARY SERVICE COST APPORTIONMENT,HOSPITAL WAGE INDEX DATA,COMPUTATION OF RATIO OF COST TO CHARGES,HOSPITAL IDENTIFICATION INFORMATION,COMPUTATION OF RATIO OF COST TO CHARGES,TRIAL BALANCE OF EXPENSE ACCOUNTS,APPORTIONMENT OF INPATIENT/OUTPATIENT ANCILLARY SERVICE OTHER PASS THROUGH COSTS,INPATIENT ANCILLARY SERVICE COST APPORTIONMENT,INPATIENT ANCILLARY SERVICE COST APPORTIONMENT,COMPUTATION OF RATIO OF COST TO CHARGES,APPORTIONMENT OF MEDICAL AND OTHER HEALTH SERVICES,APPORTIONMENT OF MEDICAL AND OTHER HEALTH SERVICES,APPORTIONMENT OF INPATIENT/OUTPATIENT ANCILLARY SERVICE OTHER PASS THROUGH COSTS,COST ALLOCATION,COMPUTATION OF RATIO OF COST TO CHARGES,APPORTIONMENT OF INPATIENT/OUTPATIENT ANCILLARY SERVICE OTHER PASS THROUGH COSTS,HOSPITAL WAGE INDEX DATA,,TRIAL BALANCE OF EXPENSE ACCOUNTS,APPORTIONMENT OF MEDICAL AND OTHER HEALTH SERVICES,HOSPITAL WAGE INDEX DATA,INPATIENT ANCILLARY SERVICE COST APPORTIONMENT,TRIAL BALANCE OF EXPENSE ACCOUNTS,INPATIENT ANCILLARY SERVICE COST APPORTIONMENT,INPATIENT ANCILLARY SERVICE COST APPORTIONMENT,APPORTIONMENT OF INPATIENT ROUTINE SERVICE CAPITAL COSTS,APPORTIONMENT OF INPATIENT/OUTPATIENT ANCILLARY SERVICE OTHER PASS THROUGH COSTS,COST ALLOCATION,APPORTIONMENT OF MEDICAL AND OTHER HEALTH SERVICES,INPATIENT ANCILLARY SERVICE COST APPORTIONMENT,BED DAYS AVAILABLE,HOSPITAL WAGE INDEX DATA,COMPUTATION OF RATIO OF COST TO CHARGES,ALLOCATION OF NEW CAPITAL COSTS,ADJUSTMENTS,COMPUTATION OF RATIO OF COST TO CHARGES,HOSPITAL WAGE INDEX DATA,COMPUTATION OF RATIO OF COST TO CHARGES,APPORTIONMENT OF MEDICAL AND OTHER HEALTH SERVICES,,Total Inpatient Days/Outpatient Visits,COST ALLOCATION,COMPUTATION OF INPATIENT OPERATING COSTS,COST ALLOCATION,INPATIENT ANCILLARY SERVICE COST APPORTIONMENT,TRIAL BALANCE OF EXPENSE ACCOUNTS,S-10 DATA,APPORTIONMENT OF INPATIENT/OUTPATIENT ANCILLARY SERVICE OTHER PASS THROUGH COSTS,HHA STATISTICAL DATA,TRIAL BALANCE OF EXPENSE ACCOUNTS,APPORTIONMENT OF INPATIENT/OUTPATIENT ANCILLARY SERVICE OTHER PASS THROUGH COSTS,INPATIENT ANCILLARY SERVICE COST APPORTIONMENT,ALLOCATION OF NEW CAPITAL COSTS,ALLOCATION OF NEW CAPITAL COSTS,INPATIENT ANCILLARY SERVICE COST APPORTIONMENT,Medicaid Inpatient Days/Outpatient Visits,Total Inpatient Days/Outpatient Visits,COMPUTATION OF INPATIENT OPERATING COSTS,ALLOCATION OF NEW CAPITAL COSTS,ALLOCATION OF NEW CAPITAL COSTS,APPORTIONMENT OF INPATIENT/OUTPATIENT ANCILLARY SERVICE OTHER PASS THROUGH COSTS,INPATIENT ANCILLARY SERVICE COST APPORTIONMENT,COST ALLOCATION,ALLOCATION OF NEW CAPITAL COSTS,HOSPITAL WAGE INDEX DATA,HHA STATISTICAL DATA,COST ALLOCATION,APPORTIONMENT OF INPATIENT ROUTINE SERVICE CAPITAL COSTS,INPATIENT ANCILLARY SERVICE COST APPORTIONMENT,APPORTIONMENT OF MEDICAL AND OTHER HEALTH SERVICES,TRIAL BALANCE OF EXPENSE ACCOUNTS,COST ALLOCATION,COST ALLOCATION,INPATIENT ANCILLARY SERVICE COST APPORTIONMENT,APPORTIONMENT OF MEDICAL AND OTHER HEALTH SERVICES,COMPUTATION OF RATIO OF COST TO CHARGES,COST ALLOCATION,COST ALLOCATION,TRIAL BALANCE OF EXPENSE ACCOUNTS,,Total Inpatient Days/Outpatient Visits,TRIAL BALANCE OF EXPENSE ACCOUNTS,ALLOCATION OF NEW CAPITAL COSTS,COST ALLOCATION,APPORTIONMENT OF MEDICAL AND OTHER HEALTH SERVICES,HOSPITAL WAGE INDEX DATA,COMPUTATION OF RATIO OF COST TO CHARGES,ADJUSTMENTS,APPORTIONMENT OF MEDICAL AND OTHER HEALTH SERVICES,APPORTIONMENT OF MEDICAL AND OTHER HEALTH SERVICES,APPORTIONMENT OF INPATIENT/OUTPATIENT ANCILLARY SERVICE OTHER PASS THROUGH COSTS,APPORTIONMENT OF MEDICAL AND OTHER HEALTH SERVICES,COST ALLOCATION,NUMBER OF BEDS,COST ALLOCATION,INPATIENT ANCILLARY SERVICE COST APPORTIONMENT,,TRIAL BALANCE OF EXPENSE ACCOUNTS,INPATIENT ANCILLARY SERVICE COST APPORTIONMENT,TRIAL BALANCE OF EXPENSE ACCOUNTS,Medicare Inpatient Days/Outpatient Visits,COST ALLOCATION,TRIAL BALANCE OF EXPENSE ACCOUNTS,S-10 DATA,HOSPITAL WAGE INDEX DATA,APPORTIONMENT OF MEDICAL AND OTHER HEALTH SERVICES,HOSPITAL WAGE INDEX DATA,APPORTIONMENT OF INPATIENT/OUTPATIENT ANCILLARY SERVICE OTHER PASS THROUGH COSTS,,RENAL STATISTICAL DATA,APPORTIONMENT OF INPATIENT ROUTINE SERVICE OTHER PASS THROUGH COSTS,COST ALLOCATION,COMPUTATION OF RATIO OF COST TO CHARGES,APPORTIONMENT OF MEDICAL AND OTHER HEALTH SERVICES,CALCULATION OF REIMBURSEMENT SETTLEMENT,COST ALLOCATION,RENAL STATISTICAL DATA,COST ALLOCATION,ANALYSIS OF CHANGES IN NEW CAPITAL BALANCES,ANALYSIS OF CHANGES IN NEW CAPITAL BALANCES,INPATIENT ANCILLARY SERVICE COST APPORTIONMENT,APPORTIONMENT OF INPATIENT/OUTPATIENT ANCILLARY SERVICE OTHER PASS THROUGH COSTS,COST ALLOCATION,HHA STATISTICAL DATA,TRIAL BALANCE OF EXPENSE ACCOUNTS,APPORTIONMENT OF INPATIENT/OUTPATIENT ANCILLARY SERVICE OTHER PASS THROUGH COSTS,TRIAL BALANCE OF EXPENSE ACCOUNTS,HOSPITAL WAGE INDEX DATA,COMPUTATION OF RATIO OF COST TO CHARGES,Medicaid Inpatient Days/Outpatient Visits,COST ALLOCATION,APPORTIONMENT OF MEDICAL AND OTHER HEALTH SERVICES,TRIAL BALANCE OF EXPENSE ACCOUNTS,APPORTIONMENT OF INPATIENT/OUTPATIENT ANCILLARY SERVICE OTHER PASS THROUGH COSTS,COST ALLOCATION,APPORTIONMENT OF MEDICAL AND OTHER HEALTH SERVICES,ALLOCATION OF NEW CAPITAL COSTS,COST ALLOCATION,APPORTIONMENT OF MEDICAL AND OTHER HEALTH SERVICES,INPATIENT ANCILLARY SERVICE COST APPORTIONMENT,HOSPITAL WAGE INDEX DATA,INPATIENT ANCILLARY SERVICE COST APPORTIONMENT,HHA STATISTICAL DATA,,APPORTIONMENT OF MEDICAL AND OTHER HEALTH SERVICES,HOSPITAL WAGE INDEX DATA,HHA STATISTICAL DATA,ALLOCATION OF NEW CAPITAL COSTS,COMPUTATION OF RATIO OF COST TO CHARGES,APPORTIONMENT OF INPATIENT/OUTPATIENT ANCILLARY SERVICE OTHER PASS THROUGH COSTS,INPATIENT ANCILLARY SERVICE COST APPORTIONMENT,TRIAL BALANCE OF EXPENSE ACCOUNTS,CALCULATION OF REIMBURSEMENT SETTLEMENT,TRIAL BALANCE OF EXPENSE ACCOUNTS,HHA STATISTICAL DATA,INPATIENT ANCILLARY SERVICE COST APPORTIONMENT,COMPUTATION OF RATIO OF COST TO CHARGES,COST ALLOCATION,APPORTIONMENT OF INPATIENT/OUTPATIENT ANCILLARY SERVICE OTHER PASS THROUGH COSTS,COST ALLOCATION,COMPUTATION OF RATIO OF COST TO CHARGES,APPORTIONMENT OF INPATIENT/OUTPATIENT ANCILLARY SERVICE OTHER PASS THROUGH COSTS,APPORTIONMENT OF INPATIENT/OUTPATIENT ANCILLARY SERVICE OTHER PASS THROUGH COSTS,APPORTIONMENT OF MEDICAL AND OTHER HEALTH SERVICES,Total Inpatient Days/Outpatient Visits,CALCULATION OF REIMBURSEMENT SETTLEMENT,APPORTIONMENT OF INPATIENT/OUTPATIENT ANCILLARY SERVICE OTHER PASS THROUGH COSTS,APPORTIONMENT OF INPATIENT/OUTPATIENT ANCILLARY SERVICE OTHER PASS THROUGH COSTS,COMPUTATION OF INPATIENT OPERATING COSTS,INPATIENT ANCILLARY SERVICE COST APPORTIONMENT,APPORTIONMENT OF INPATIENT/OUTPATIENT ANCILLARY SERVICE OTHER PASS THROUGH COSTS,INPATIENT ANCILLARY SERVICE COST APPORTIONMENT,TRIAL BALANCE OF EXPENSE ACCOUNTS,APPORTIONMENT OF INPATIENT/OUTPATIENT ANCILLARY SERVICE OTHER PASS THROUGH COSTS,APPORTIONMENT OF MEDICAL AND OTHER HEALTH SERVICES,COST ALLOCATION,APPORTIONMENT OF INPATIENT/OUTPATIENT ANCILLARY SERVICE OTHER PASS THROUGH COSTS,APPORTIONMENT OF INPATIENT/OUTPATIENT ANCILLARY SERVICE OTHER PASS THROUGH COSTS,COMPUTATION OF RATIO OF COST TO CHARGES,ANALYSIS OF CHANGES IN NEW CAPITAL BALANCES,BED DAYS AVAILABLE,APPORTIONMENT OF INPATIENT/OUTPATIENT ANCILLARY SERVICE OTHER PASS THROUGH COSTS,HOSPITAL WAGE INDEX DATA,COST ALLOCATION,HOSPITAL WAGE INDEX DATA,,HOSPITAL WAGE INDEX DATA,COST ALLOCATION,COMPUTATION OF RATIO OF COST TO CHARGES,COST ALLOCATION,RENAL STATISTICAL DATA,ALLOCATION OF NEW CAPITAL COSTS,APPORTIONMENT OF MEDICAL AND OTHER HEALTH SERVICES,INPATIENT ANCILLARY SERVICE COST APPORTIONMENT,COMPUTATION OF RATIO OF COST TO CHARGES,INPATIENT ANCILLARY SERVICE COST APPORTIONMENT,APPORTIONMENT OF INPATIENT/OUTPATIENT ANCILLARY SERVICE OTHER PASS THROUGH COSTS,COST ALLOCATION,,TRIAL BALANCE OF EXPENSE ACCOUNTS,ADJUSTMENTS,COST ALLOCATION,ANALYSIS OF CHANGES IN NEW CAPITAL BALANCES,CALCULATION OF REIMBURSEMENT SETTLEMENT (PPS),COST ALLOCATION,Medicaid Inpatient Days/Outpatient Visits,APPORTIONMENT OF INPATIENT/OUTPATIENT ANCILLARY SERVICE OTHER PASS THROUGH COSTS,APPORTIONMENT OF INPATIENT/OUTPATIENT ANCILLARY SERVICE OTHER PASS THROUGH COSTS,HHA STATISTICAL DATA,COMPUTATION OF INPATIENT OPERATING COSTS,COST ALLOCATION,TRIAL BALANCE OF EXPENSE ACCOUNTS,HOSPITAL WAGE INDEX DATA,COST ALLOCATION,HHA STATISTICAL DATA,COST ALLOCATION,COMPUTATION OF RATIO OF COST TO CHARGES,COMPUTATION OF RATIO OF COST TO CHARGES,HHA STATISTICAL DATA,TRIAL BALANCE OF EXPENSE ACCOUNTS,APPORTIONMENT OF INPATIENT/OUTPATIENT ANCILLARY SERVICE OTHER PASS THROUGH COSTS,HOSPITAL WAGE INDEX DATA,COMPUTATION OF RATIO OF COST TO CHARGES,CALCULATION OF REIMBURSEMENT SETTLEMENT,COST ALLOCATION,COST ALLOCATION,INPATIENT ANCILLARY SERVICE COST APPORTIONMENT,RENAL STATISTICAL DATA,,APPORTIONMENT OF INPATIENT/OUTPATIENT ANCILLARY SERVICE OTHER PASS THROUGH COSTS,COMPUTATION OF RATIO OF COST TO CHARGES,INPATIENT ANCILLARY SERVICE COST APPORTIONMENT,INPATIENT ANCILLARY SERVICE COST APPORTIONMENT,APPORTIONMENT OF INPATIENT/OUTPATIENT ANCILLARY SERVICE OTHER PASS THROUGH COSTS,INPATIENT ANCILLARY SERVICE COST APPORTIONMENT,APPORTIONMENT OF MEDICAL AND OTHER HEALTH SERVICES,INPATIENT ANCILLARY SERVICE COST APPORTIONMENT,COST ALLOCATION,APPORTIONMENT OF INPATIENT/OUTPATIENT ANCILLARY SERVICE OTHER PASS THROUGH COSTS,RECONCILIATION OF CAPITAL COST CENTERS,COMPUTATION OF RATIO OF COST TO CHARGES,COMPUTATION OF RATIO OF COST TO CHARGES,TRIAL BALANCE OF EXPENSE ACCOUNTS,TRIAL BALANCE OF EXPENSE ACCOUNTS,TRIAL BALANCE OF EXPENSE ACCOUNTS,TRIAL BALANCE OF EXPENSE ACCOUNTS,ADJUSTMENTS,APPORTIONMENT OF MEDICAL AND OTHER HEALTH SERVICES,APPORTIONMENT OF INPATIENT/OUTPATIENT ANCILLARY SERVICE OTHER PASS THROUGH COSTS,HOSPITAL WAGE INDEX DATA,ALLOCATION OF NEW CAPITAL COSTS,TRIAL BALANCE OF EXPENSE ACCOUNTS,HOSPITAL WAGE INDEX DATA,HHA STATISTICAL DATA,APPORTIONMENT OF INPATIENT/OUTPATIENT ANCILLARY SERVICE OTHER PASS THROUGH COSTS,COST ALLOCATION,Total Inpatient Days/Outpatient Visits,COST ALLOCATION,TRIAL BALANCE OF EXPENSE ACCOUNTS,ALLOCATION OF NEW CAPITAL COSTS,APPORTIONMENT OF MEDICAL AND OTHER HEALTH SERVICES,APPORTIONMENT OF INPATIENT/OUTPATIENT ANCILLARY SERVICE OTHER PASS THROUGH COSTS,COST ALLOCATION,INPATIENT ANCILLARY SERVICE COST APPORTIONMENT,ALLOCATION OF NEW CAPITAL COSTS,COST ALLOCATION,,APPORTIONMENT OF MEDICAL AND OTHER HEALTH SERVICES,APPORTIONMENT OF MEDICAL AND OTHER HEALTH SERVICES,HOSPITAL WAGE INDEX DATA,APPORTIONMENT OF INPATIENT/OUTPATIENT ANCILLARY SERVICE OTHER PASS THROUGH COSTS,COMPUTATION OF INPATIENT OPERATING COSTS,HOSPITAL WAGE INDEX DATA,HOSPITAL WAGE INDEX DATA,ALLOCATION OF NEW CAPITAL COSTS,INPATIENT ANCILLARY SERVICE COST APPORTIONMENT,NUMBER OF BEDS,RECONCILIATION OF CAPITAL COST CENTERS,ANALYSIS OF CHANGES IN NEW CAPITAL BALANCES,APPORTIONMENT OF INPATIENT/OUTPATIENT ANCILLARY SERVICE OTHER PASS THROUGH COSTS,INPATIENT ANCILLARY SERVICE COST APPORTIONMENT,COST ALLOCATION,APPORTIONMENT OF INPATIENT/OUTPATIENT ANCILLARY SERVICE OTHER PASS THROUGH COSTS,ANALYSIS OF CHANGES IN NEW CAPITAL BALANCES,APPORTIONMENT OF MEDICAL AND OTHER HEALTH SERVICES,BED DAYS AVAILABLE,HOSPITAL WAGE INDEX DATA,HOSPITAL WAGE INDEX DATA,APPORTIONMENT OF INPATIENT/OUTPATIENT ANCILLARY SERVICE OTHER PASS THROUGH COSTS,HOSPITAL WAGE INDEX DATA,APPORTIONMENT OF MEDICAL AND OTHER HEALTH SERVICES,ADJUSTMENTS,HHA STATISTICAL DATA,TRIAL BALANCE OF EXPENSE ACCOUNTS,APPORTIONMENT OF MEDICAL AND OTHER HEALTH SERVICES,,TRIAL BALANCE OF EXPENSE ACCOUNTS,APPORTIONMENT OF MEDICAL AND OTHER HEALTH SERVICES,CALCULATION OF REIMBURSEMENT SETTLEMENT,COST ALLOCATION,TRIAL BALANCE OF EXPENSE ACCOUNTS,HOSPITAL WAGE INDEX DATA,APPORTIONMENT OF INPATIENT/OUTPATIENT ANCILLARY SERVICE OTHER PASS THROUGH COSTS,INPATIENT ANCILLARY SERVICE COST APPORTIONMENT,ANALYSIS OF CHANGES IN NEW CAPITAL BALANCES,RENAL STATISTICAL DATA,INPATIENT ANCILLARY SERVICE COST APPORTIONMENT,TRIAL BALANCE OF EXPENSE ACCOUNTS,COST ALLOCATION,Total Inpatient Days/Outpatient Visits,HHA STATISTICAL DATA,COMPUTATION OF RATIO OF COST TO CHARGES,COST ALLOCATION,ANALYSIS OF CHANGES IN NEW CAPITAL BALANCES,COST ALLOCATION,INPATIENT ANCILLARY SERVICE COST APPORTIONMENT,APPORTIONMENT OF INPATIENT/OUTPATIENT ANCILLARY SERVICE OTHER PASS THROUGH COSTS,INPATIENT ANCILLARY SERVICE COST APPORTIONMENT,COST ALLOCATION,TRIAL BALANCE OF EXPENSE ACCOUNTS,COST ALLOCATION,COST ALLOCATION,TRIAL BALANCE OF EXPENSE ACCOUNTS,APPORTIONMENT OF MEDICAL AND OTHER HEALTH SERVICES,HOSPITAL WAGE INDEX DATA,ALLOCATION OF NEW CAPITAL COSTS,HOSPITAL WAGE INDEX DATA,COST ALLOCATION,RENAL STATISTICAL DATA,COMPUTATION OF RATIO OF COST TO CHARGES,HOSPITAL WAGE INDEX DATA,COMPUTATION OF RATIO OF COST TO CHARGES,,HOSPITAL WAGE INDEX DATA,APPORTIONMENT OF INPATIENT/OUTPATIENT ANCILLARY SERVICE OTHER PASS THROUGH COSTS,ANALYSIS OF CHANGES IN NEW CAPITAL BALANCES,HOSPITAL WAGE INDEX DATA,COMPUTATION OF RATIO OF COST TO CHARGES,TRIAL BALANCE OF EXPENSE ACCOUNTS,COST ALLOCATION,HHA STATISTICAL DATA,APPORTIONMENT OF INPATIENT ROUTINE SERVICE CAPITAL COSTS,APPORTIONMENT OF INPATIENT/OUTPATIENT ANCILLARY SERVICE OTHER PASS THROUGH COSTS,RECONCILIATION OF CAPITAL COST CENTERS,COMPUTATION OF RATIO OF COST TO CHARGES,CALCULATION OF REIMBURSEMENT SETTLEMENT,TRIAL BALANCE OF EXPENSE ACCOUNTS,ANALYSIS OF CHANGES IN NEW CAPITAL BALANCES,APPORTIONMENT OF INPATIENT/OUTPATIENT ANCILLARY SERVICE OTHER PASS THROUGH COSTS,TRIAL BALANCE OF EXPENSE ACCOUNTS,TRIAL BALANCE OF EXPENSE ACCOUNTS,COST ALLOCATION,RECONCILIATION OF CAPITAL COST CENTERS,ALLOCATION OF NEW CAPITAL COSTS,COMPUTATION OF RATIO OF COST TO CHARGES,HOSPITAL WAGE INDEX DATA,COMPUTATION OF RATIO OF COST TO CHARGES,APPORTIONMENT OF INPATIENT/OUTPATIENT ANCILLARY SERVICE OTHER PASS THROUGH COSTS,COMPUTATION OF RATIO OF COST TO CHARGES,APPORTIONMENT OF INPATIENT/OUTPATIENT ANCILLARY SERVICE OTHER PASS THROUGH COSTS,COST ALLOCATION,APPORTIONMENT OF INPATIENT/OUTPATIENT ANCILLARY SERVICE OTHER PASS THROUGH COSTS,INPATIENT ANCILLARY SERVICE COST APPORTIONMENT,COST ALLOCATION,COMPUTATION OF INPATIENT OPERATING COSTS,TRIAL BALANCE OF EXPENSE ACCOUNTS,APPORTIONMENT OF INPATIENT/OUTPATIENT ANCILLARY SERVICE OTHER PASS THROUGH COSTS,INPATIENT ANCILLARY SERVICE COST APPORTIONMENT,HOSPITAL WAGE INDEX DATA,INPATIENT ANCILLARY SERVICE COST APPORTIONMENT,ANALYSIS OF CHANGES IN NEW CAPITAL BALANCES,INPATIENT ANCILLARY SERVICE COST APPORTIONMENT,ANALYSIS OF CHANGES IN NEW CAPITAL BALANCES,COST ALLOCATION,Medicare Inpatient Days/Outpatient Visits,HOSPITAL WAGE INDEX DATA,INPATIENT ANCILLARY SERVICE COST APPORTIONMENT,,TRIAL BALANCE OF EXPENSE ACCOUNTS,INPATIENT ANCILLARY SERVICE COST APPORTIONMENT,APPORTIONMENT OF INPATIENT/OUTPATIENT ANCILLARY SERVICE OTHER PASS THROUGH COSTS,INPATIENT ANCILLARY SERVICE COST APPORTIONMENT,ADJUSTMENTS,APPORTIONMENT OF INPATIENT ROUTINE SERVICE CAPITAL COSTS,COMPUTATION OF RATIO OF COST TO CHARGES,INPATIENT ANCILLARY SERVICE COST APPORTIONMENT,INPATIENT ANCILLARY SERVICE COST APPORTIONMENT,TRIAL BALANCE OF EXPENSE ACCOUNTS,COMPUTATION OF RATIO OF COST TO CHARGES,APPORTIONMENT OF MEDICAL AND OTHER HEALTH SERVICES,APPORTIONMENT OF MEDICAL AND OTHER HEALTH SERVICES,ALLOCATION OF NEW CAPITAL COSTS,HOSPITAL WAGE INDEX DATA,INPATIENT ANCILLARY SERVICE COST APPORTIONMENT,HOSPITAL WAGE INDEX DATA,,,APPORTIONMENT OF INPATIENT/OUTPATIENT ANCILLARY SERVICE OTHER PASS THROUGH COSTS,CALCULATION OF REIMBURSEMENT SETTLEMENT (PPS),APPORTIONMENT OF INPATIENT/OUTPATIENT ANCILLARY SERVICE OTHER PASS THROUGH COSTS,TRIAL BALANCE OF EXPENSE ACCOUNTS,COST ALLOCATION,HOSPITAL WAGE INDEX DATA,APPORTIONMENT OF INPATIENT/OUTPATIENT ANCILLARY SERVICE OTHER PASS THROUGH COSTS,HOSPITAL WAGE INDEX DATA,Total Inpatient Days/Outpatient Visits,APPORTIONMENT OF INPATIENT/OUTPATIENT ANCILLARY SERVICE OTHER PASS THROUGH COSTS,INPATIENT ANCILLARY SERVICE COST APPORTIONMENT,ADJUSTMENTS,TRIAL BALANCE OF EXPENSE ACCOUNTS,CALCULATION OF REIMBURSEMENT SETTLEMENT,TRIAL BALANCE OF EXPENSE ACCOUNTS,APPORTIONMENT OF INPATIENT/OUTPATIENT ANCILLARY SERVICE OTHER PASS THROUGH COSTS,APPORTIONMENT OF INPATIENT/OUTPATIENT ANCILLARY SERVICE OTHER PASS THROUGH COSTS,APPORTIONMENT OF INPATIENT/OUTPATIENT ANCILLARY SERVICE OTHER PASS THROUGH COSTS,COST ALLOCATION,ALLOCATION OF NEW CAPITAL COSTS,S-10 DATA,APPORTIONMENT OF INPATIENT/OUTPATIENT ANCILLARY SERVICE OTHER PASS THROUGH COSTS,APPORTIONMENT OF INPATIENT/OUTPATIENT ANCILLARY SERVICE OTHER PASS THROUGH COSTS,Medicare Inpatient Days/Outpatient Visits,INPATIENT ANCILLARY SERVICE COST APPORTIONMENT,COST ALLOCATION,APPORTIONMENT OF MEDICAL AND OTHER HEALTH SERVICES,ADJUSTMENTS,APPORTIONMENT OF INPATIENT/OUTPATIENT ANCILLARY SERVICE OTHER PASS THROUGH COSTS,TRIAL BALANCE OF EXPENSE ACCOUNTS,,COMPUTATION OF RATIO OF COST TO CHARGES,TRIAL BALANCE OF EXPENSE ACCOUNTS,APPORTIONMENT OF MEDICAL AND OTHER HEALTH SERVICES,Total Inpatient Days/Outpatient Visits,APPORTIONMENT OF INPATIENT/OUTPATIENT ANCILLARY SERVICE OTHER PASS THROUGH COSTS,Total Inpatient Days/Outpatient Visits,HHA STATISTICAL DATA,APPORTIONMENT OF INPATIENT/OUTPATIENT ANCILLARY SERVICE OTHER PASS THROUGH COSTS,RECONCILIATION OF CAPITAL COST CENTERS,HOSPITAL WAGE INDEX DATA,TRIAL BALANCE OF EXPENSE ACCOUNTS,APPORTIONMENT OF INPATIENT/OUTPATIENT ANCILLARY SERVICE OTHER PASS THROUGH COSTS,HOSPITAL IDENTIFICATION INFORMATION,TRIAL BALANCE OF EXPENSE ACCOUNTS,APPORTIONMENT OF INPATIENT/OUTPATIENT ANCILLARY SERVICE OTHER PASS THROUGH COSTS,APPORTIONMENT OF INPATIENT/OUTPATIENT ANCILLARY SERVICE OTHER PASS THROUGH COSTS,INPATIENT ANCILLARY SERVICE COST APPORTIONMENT,APPORTIONMENT OF MEDICAL AND OTHER HEALTH SERVICES,COST ALLOCATION,HOSPITAL WAGE INDEX DATA,APPORTIONMENT OF INPATIENT/OUTPATIENT ANCILLARY SERVICE OTHER PASS THROUGH COSTS,COMPUTATION OF RATIO OF COST TO CHARGES,APPORTIONMENT OF INPATIENT/OUTPATIENT ANCILLARY SERVICE OTHER PASS THROUGH COSTS,APPORTIONMENT OF INPATIENT/OUTPATIENT ANCILLARY SERVICE OTHER PASS THROUGH COSTS,INPATIENT ANCILLARY SERVICE COST APPORTIONMENT,INPATIENT ANCILLARY SERVICE COST APPORTIONMENT,TRIAL BALANCE OF EXPENSE ACCOUNTS,ALLOCATION OF NEW CAPITAL COSTS,INPATIENT ANCILLARY SERVICE COST APPORTIONMENT,APPORTIONMENT OF INPATIENT/OUTPATIENT ANCILLARY SERVICE OTHER PASS THROUGH COSTS,APPORTIONMENT OF INPATIENT ROUTINE SERVICE OTHER PASS THROUGH COSTS,COST ALLOCATION,INPATIENT ANCILLARY SERVICE COST APPORTIONMENT,HOSPITAL WAGE INDEX DATA,APPORTIONMENT OF INPATIENT/OUTPATIENT ANCILLARY SERVICE OTHER PASS THROUGH COSTS,INPATIENT ANCILLARY SERVICE COST APPORTIONMENT,Total Inpatient Days/Outpatient Visits,ALLOCATION OF NEW CAPITAL COSTS,APPORTIONMENT OF MEDICAL AND OTHER HEALTH SERVICES,COMPUTATION OF RATIO OF COST TO CHARGES,HHA STATISTICAL DATA,APPORTIONMENT OF MEDICAL AND OTHER HEALTH SERVICES,APPORTIONMENT OF INPATIENT/OUTPATIENT ANCILLARY SERVICE OTHER PASS THROUGH COSTS,APPORTIONMENT OF INPATIENT/OUTPATIENT ANCILLARY SERVICE OTHER PASS THROUGH COSTS,TRIAL BALANCE OF EXPENSE ACCOUNTS,APPORTIONMENT OF MEDICAL AND OTHER HEALTH SERVICES,APPORTIONMENT OF MEDICAL AND OTHER HEALTH SERVICES,APPORTIONMENT OF INPATIENT ROUTINE SERVICE OTHER PASS THROUGH COSTS,S-10 DATA,BED DAYS AVAILABLE,INPATIENT ANCILLARY SERVICE COST APPORTIONMENT,APPORTIONMENT OF MEDICAL AND OTHER HEALTH SERVICES,CALCULATION OF REIMBURSEMENT SETTLEMENT,HOSPITAL WAGE INDEX DATA,,APPORTIONMENT OF INPATIENT/OUTPATIENT ANCILLARY SERVICE OTHER PASS THROUGH COSTS,HOSPITAL WAGE INDEX DATA,COMPUTATION OF RATIO OF COST TO CHARGES,ADJUSTMENTS,APPORTIONMENT OF INPATIENT/OUTPATIENT ANCILLARY SERVICE OTHER PASS THROUGH COSTS,COST ALLOCATION,APPORTIONMENT OF INPATIENT/OUTPATIENT ANCILLARY SERVICE OTHER PASS THROUGH COSTS,CALCULATION OF REIMBURSEMENT SETTLEMENT,ALLOCATION OF NEW CAPITAL COSTS,APPORTIONMENT OF MEDICAL AND OTHER HEALTH SERVICES,Medicare Inpatient Days/Outpatient Visits,INPATIENT ANCILLARY SERVICE COST APPORTIONMENT,APPORTIONMENT OF INPATIENT/OUTPATIENT ANCILLARY SERVICE OTHER PASS THROUGH COSTS,INPATIENT ANCILLARY SERVICE COST APPORTIONMENT,ADJUSTMENTS,APPORTIONMENT OF INPATIENT/OUTPATIENT ANCILLARY SERVICE OTHER PASS THROUGH COSTS,COMPUTATION OF RATIO OF COST TO CHARGES,INPATIENT ANCILLARY SERVICE COST APPORTIONMENT,APPORTIONMENT OF INPATIENT/OUTPATIENT ANCILLARY SERVICE OTHER PASS THROUGH COSTS,ALLOCATION OF NEW CAPITAL COSTS,APPORTIONMENT OF MEDICAL AND OTHER HEALTH SERVICES,APPORTIONMENT OF INPATIENT/OUTPATIENT ANCILLARY SERVICE OTHER PASS THROUGH COSTS,RECONCILIATION OF CAPITAL COST CENTERS,APPORTIONMENT OF INPATIENT/OUTPATIENT ANCILLARY SERVICE OTHER PASS THROUGH COSTS,,BED DAYS AVAILABLE,TRIAL BALANCE OF EXPENSE ACCOUNTS,APPORTIONMENT OF INPATIENT ROUTINE SERVICE CAPITAL COSTS,APPORTIONMENT OF MEDICAL AND OTHER HEALTH SERVICES,TRIAL BALANCE OF EXPENSE ACCOUNTS,APPORTIONMENT OF INPATIENT/OUTPATIENT ANCILLARY SERVICE OTHER PASS THROUGH COSTS,INPATIENT ANCILLARY SERVICE COST APPORTIONMENT,APPORTIONMENT OF INPATIENT/OUTPATIENT ANCILLARY SERVICE OTHER PASS THROUGH COSTS,COST ALLOCATION,NUMBER OF BEDS,INPATIENT ANCILLARY SERVICE COST APPORTIONMENT,TRIAL BALANCE OF EXPENSE ACCOUNTS,COMPUTATION OF RATIO OF COST TO CHARGES,APPORTIONMENT OF INPATIENT ROUTINE SERVICE OTHER PASS THROUGH COSTS,APPORTIONMENT OF INPATIENT/OUTPATIENT ANCILLARY SERVICE OTHER PASS THROUGH COSTS,COMPUTATION OF INPATIENT OPERATING COSTS,APPORTIONMENT OF INPATIENT/OUTPATIENT ANCILLARY SERVICE OTHER PASS THROUGH COSTS,,COMPUTATION OF INPATIENT OPERATING COSTS,,COST ALLOCATION,INPATIENT ANCILLARY SERVICE COST APPORTIONMENT,TRIAL BALANCE OF EXPENSE ACCOUNTS,ANALYSIS OF CHANGES IN NEW CAPITAL BALANCES,INPATIENT ANCILLARY SERVICE COST APPORTIONMENT,HOSPITAL WAGE INDEX DATA,TRIAL BALANCE OF EXPENSE ACCOUNTS,INPATIENT ANCILLARY SERVICE COST APPORTIONMENT,APPORTIONMENT OF MEDICAL AND OTHER HEALTH SERVICES,HOSPITAL WAGE INDEX DATA,ANALYSIS OF CHANGES IN NEW CAPITAL BALANCES,APPORTIONMENT OF INPATIENT/OUTPATIENT ANCILLARY SERVICE OTHER PASS THROUGH COSTS,COST ALLOCATION,COMPUTATION OF RATIO OF COST TO CHARGES,APPORTIONMENT OF MEDICAL AND OTHER HEALTH SERVICES,INPATIENT ANCILLARY SERVICE COST APPORTIONMENT,APPORTIONMENT OF MEDICAL AND OTHER HEALTH SERVICES,BED DAYS AVAILABLE,APPORTIONMENT OF MEDICAL AND OTHER HEALTH SERVICES,APPORTIONMENT OF INPATIENT/OUTPATIENT ANCILLARY SERVICE OTHER PASS THROUGH COSTS,,TRIAL BALANCE OF EXPENSE ACCOUNTS,TRIAL BALANCE OF EXPENSE ACCOUNTS,TRIAL BALANCE OF EXPENSE ACCOUNTS,TRIAL BALANCE OF EXPENSE ACCOUNTS,COST ALLOCATION,COST ALLOCATION,APPORTIONMENT OF INPATIENT ROUTINE SERVICE CAPITAL COSTS,APPORTIONMENT OF INPATIENT/OUTPATIENT ANCILLARY SERVICE OTHER PASS THROUGH COSTS,APPORTIONMENT OF MEDICAL AND OTHER HEALTH SERVICES,COST ALLOCATION,CALCULATION OF REIMBURSEMENT SETTLEMENT,TRIAL BALANCE OF EXPENSE ACCOUNTS,INPATIENT ANCILLARY SERVICE COST APPORTIONMENT,COST ALLOCATION,HHA STATISTICAL DATA,COST ALLOCATION,INPATIENT ANCILLARY SERVICE COST APPORTIONMENT,APPORTIONMENT OF MEDICAL AND OTHER HEALTH SERVICES,APPORTIONMENT OF INPATIENT/OUTPATIENT ANCILLARY SERVICE OTHER PASS THROUGH COSTS,,APPORTIONMENT OF INPATIENT/OUTPATIENT ANCILLARY SERVICE OTHER PASS THROUGH COSTS,INPATIENT ANCILLARY SERVICE COST APPORTIONMENT,HHA STATISTICAL DATA,ANALYSIS OF CHANGES IN NEW CAPITAL BALANCES,Medicare Inpatient Days/Outpatient Visits,S-10 DATA,,Medicare Inpatient Days/Outpatient Visits,APPORTIONMENT OF INPATIENT/OUTPATIENT ANCILLARY SERVICE OTHER PASS THROUGH COSTS,APPORTIONMENT OF MEDICAL AND OTHER HEALTH SERVICES,HOSPITAL WAGE INDEX DATA,Medicaid Inpatient Days/Outpatient Visits,COMPUTATION OF RATIO OF COST TO CHARGES,COMPUTATION OF RATIO OF COST TO CHARGES,COST ALLOCATION,APPORTIONMENT OF MEDICAL AND OTHER HEALTH SERVICES,INPATIENT ANCILLARY SERVICE COST APPORTIONMENT,APPORTIONMENT OF MEDICAL AND OTHER HEALTH SERVICES,TRIAL BALANCE OF EXPENSE ACCOUNTS,Total Inpatient Days/Outpatient Visits,COST ALLOCATION,COMPUTATION OF RATIO OF COST TO CHARGES,APPORTIONMENT OF INPATIENT/OUTPATIENT ANCILLARY SERVICE OTHER PASS THROUGH COSTS,HHA STATISTICAL DATA,COST ALLOCATION,APPORTIONMENT OF INPATIENT/OUTPATIENT ANCILLARY SERVICE OTHER PASS THROUGH COSTS,APPORTIONMENT OF INPATIENT/OUTPATIENT ANCILLARY SERVICE OTHER PASS THROUGH COSTS,HHA STATISTICAL DATA,TRIAL BALANCE OF EXPENSE ACCOUNTS,APPORTIONMENT OF MEDICAL AND OTHER HEALTH SERVICES,INPATIENT ANCILLARY SERVICE COST APPORTIONMENT,APPORTIONMENT OF MEDICAL AND OTHER HEALTH SERVICES,COST ALLOCATION,APPORTIONMENT OF INPATIENT/OUTPATIENT ANCILLARY SERVICE OTHER PASS THROUGH COSTS,COMPUTATION OF RATIO OF COST TO CHARGES,APPORTIONMENT OF MEDICAL AND OTHER HEALTH SERVICES,COMPUTATION OF RATIO OF COST TO CHARGES,APPORTIONMENT OF MEDICAL AND OTHER HEALTH SERVICES,APPORTIONMENT OF MEDICAL AND OTHER HEALTH SERVICES,COST ALLOCATION,INPATIENT ANCILLARY SERVICE COST APPORTIONMENT,Total Inpatient Days/Outpatient Visits,APPORTIONMENT OF MEDICAL AND OTHER HEALTH SERVICES,HOSPITAL IDENTIFICATION INFORMATION,COST ALLOCATION,TRIAL BALANCE OF EXPENSE ACCOUNTS,BED DAYS AVAILABLE,HOSPITAL WAGE INDEX DATA,COST ALLOCATION,ANALYSIS OF CHANGES IN NEW CAPITAL BALANCES,APPORTIONMENT OF INPATIENT/OUTPATIENT ANCILLARY SERVICE OTHER PASS THROUGH COSTS,INPATIENT ANCILLARY SERVICE COST APPORTIONMENT,,COST ALLOCATION,HOSPITAL WAGE INDEX DATA,INPATIENT ANCILLARY SERVICE COST APPORTIONMENT,HHA STATISTICAL DATA,INPATIENT ANCILLARY SERVICE COST APPORTIONMENT,APPORTIONMENT OF INPATIENT/OUTPATIENT ANCILLARY SERVICE OTHER PASS THROUGH COSTS,APPORTIONMENT OF INPATIENT/OUTPATIENT ANCILLARY SERVICE OTHER PASS THROUGH COSTS,APPORTIONMENT OF INPATIENT/OUTPATIENT ANCILLARY SERVICE OTHER PASS THROUGH COSTS,TRIAL BALANCE OF EXPENSE ACCOUNTS,COMPUTATION OF RATIO OF COST TO CHARGES,HHA STATISTICAL DATA,APPORTIONMENT OF MEDICAL AND OTHER HEALTH SERVICES,TRIAL BALANCE OF EXPENSE ACCOUNTS,Total Inpatient Days/Outpatient Visits,INPATIENT ANCILLARY SERVICE COST APPORTIONMENT,COST ALLOCATION,,HOSPITAL WAGE INDEX DATA,INPATIENT ANCILLARY SERVICE COST APPORTIONMENT,INPATIENT ANCILLARY SERVICE COST APPORTIONMENT,TRIAL BALANCE OF EXPENSE ACCOUNTS,COST ALLOCATION,INPATIENT ANCILLARY SERVICE COST APPORTIONMENT,Total Inpatient Days/Outpatient Visits,COST ALLOCATION,COMPUTATION OF RATIO OF COST TO CHARGES,APPORTIONMENT OF INPATIENT/OUTPATIENT ANCILLARY SERVICE OTHER PASS THROUGH COSTS,,TRIAL BALANCE OF EXPENSE ACCOUNTS,,CALCULATION OF REIMBURSEMENT SETTLEMENT (PPS),INPATIENT ANCILLARY SERVICE COST APPORTIONMENT,Total Inpatient Days/Outpatient Visits,COST ALLOCATION,HHA STATISTICAL DATA,HHA STATISTICAL DATA,,RENAL STATISTICAL DATA,,APPORTIONMENT OF MEDICAL AND OTHER HEALTH SERVICES,Total Inpatient Days/Outpatient Visits,COST ALLOCATION,INPATIENT ANCILLARY SERVICE COST APPORTIONMENT,TRIAL BALANCE OF EXPENSE ACCOUNTS,INPATIENT ANCILLARY SERVICE COST APPORTIONMENT,APPORTIONMENT OF INPATIENT ROUTINE SERVICE CAPITAL COSTS,INPATIENT ANCILLARY SERVICE COST APPORTIONMENT,CALCULATION OF REIMBURSEMENT SETTLEMENT,ANALYSIS OF CHANGES IN NEW CAPITAL BALANCES,COST ALLOCATION,RENAL STATISTICAL DATA,COMPUTATION OF RATIO OF COST TO CHARGES,TRIAL BALANCE OF EXPENSE ACCOUNTS,COST ALLOCATION,HOSPITAL WAGE INDEX DATA,Medicaid Inpatient Days/Outpatient Visits,Medicare Inpatient Days/Outpatient Visits,INPATIENT ANCILLARY SERVICE COST APPORTIONMENT,HOSPITAL WAGE INDEX DATA,COMPUTATION OF INPATIENT OPERATING COSTS,COST ALLOCATION,APPORTIONMENT OF INPATIENT/OUTPATIENT ANCILLARY SERVICE OTHER PASS THROUGH COSTS,COMPUTATION OF RATIO OF COST TO CHARGES,INPATIENT ANCILLARY SERVICE COST APPORTIONMENT,APPORTIONMENT OF MEDICAL AND OTHER HEALTH SERVICES,APPORTIONMENT OF MEDICAL AND OTHER HEALTH SERVICES,COST ALLOCATION,APPORTIONMENT OF INPATIENT ROUTINE SERVICE CAPITAL COSTS,APPORTIONMENT OF INPATIENT/OUTPATIENT ANCILLARY SERVICE OTHER PASS THROUGH COSTS,S-10 DATA,COST ALLOCATION,TRIAL BALANCE OF EXPENSE ACCOUNTS,Total Inpatient Days/Outpatient Visits,TRIAL BALANCE OF EXPENSE ACCOUNTS,TRIAL BALANCE OF EXPENSE ACCOUNTS,COMPUTATION OF INPATIENT OPERATING COSTS,APPORTIONMENT OF INPATIENT ROUTINE SERVICE OTHER PASS THROUGH COSTS,APPORTIONMENT OF INPATIENT/OUTPATIENT ANCILLARY SERVICE OTHER PASS THROUGH COSTS,COST ALLOCATION,CALCULATION OF REIMBURSEMENT SETTLEMENT (PPS),APPORTIONMENT OF INPATIENT/OUTPATIENT ANCILLARY SERVICE OTHER PASS THROUGH COSTS,TRIAL BALANCE OF EXPENSE ACCOUNTS,HOSPITAL WAGE INDEX DATA,TRIAL BALANCE OF EXPENSE ACCOUNTS,COMPUTATION OF RATIO OF COST TO CHARGES,COST ALLOCATION,,APPORTIONMENT OF INPATIENT/OUTPATIENT ANCILLARY SERVICE OTHER PASS THROUGH COSTS,APPORTIONMENT OF INPATIENT/OUTPATIENT ANCILLARY SERVICE OTHER PASS THROUGH COSTS,INPATIENT ANCILLARY SERVICE COST APPORTIONMENT,APPORTIONMENT OF MEDICAL AND OTHER HEALTH SERVICES,APPORTIONMENT OF MEDICAL AND OTHER HEALTH SERVICES,APPORTIONMENT OF INPATIENT/OUTPATIENT ANCILLARY SERVICE OTHER PASS THROUGH COSTS,COMPUTATION OF INPATIENT OPERATING COSTS,APPORTIONMENT OF INPATIENT/OUTPATIENT ANCILLARY SERVICE OTHER PASS THROUGH COSTS,INPATIENT ANCILLARY SERVICE COST APPORTIONMENT,TRIAL BALANCE OF EXPENSE ACCOUNTS,APPORTIONMENT OF INPATIENT/OUTPATIENT ANCILLARY SERVICE OTHER PASS THROUGH COSTS,BED DAYS AVAILABLE,APPORTIONMENT OF MEDICAL AND OTHER HEALTH SERVICES,APPORTIONMENT OF INPATIENT/OUTPATIENT ANCILLARY SERVICE OTHER PASS THROUGH COSTS,COMPUTATION OF RATIO OF COST TO CHARGES,APPORTIONMENT OF INPATIENT/OUTPATIENT ANCILLARY SERVICE OTHER PASS THROUGH COSTS,BED DAYS AVAILABLE,HOSPITAL WAGE INDEX DATA,BED DAYS AVAILABLE,Medicaid Inpatient Days/Outpatient Visits,RENAL STATISTICAL DATA,APPORTIONMENT OF INPATIENT/OUTPATIENT ANCILLARY SERVICE OTHER PASS THROUGH COSTS,ALLOCATION OF NEW CAPITAL COSTS,Total Inpatient Days/Outpatient Visits,COST ALLOCATION,CALCULATION OF REIMBURSEMENT SETTLEMENT,COST ALLOCATION,COST ALLOCATION,TRIAL BALANCE OF EXPENSE ACCOUNTS,ALLOCATION OF NEW CAPITAL COSTS,Medicare Inpatient Days/Outpatient Visits,COST ALLOCATION,APPORTIONMENT OF INPATIENT/OUTPATIENT ANCILLARY SERVICE OTHER PASS THROUGH COSTS,COMPUTATION OF RATIO OF COST TO CHARGES,COMPUTATION OF RATIO OF COST TO CHARGES,COMPUTATION OF INPATIENT OPERATING COSTS,,COMPUTATION OF RATIO OF COST TO CHARGES,TRIAL BALANCE OF EXPENSE ACCOUNTS,HOSPITAL WAGE INDEX DATA,INPATIENT ANCILLARY SERVICE COST APPORTIONMENT,HHA STATISTICAL DATA,BED DAYS AVAILABLE,Total Inpatient Days/Outpatient Visits,Medicaid Inpatient Days/Outpatient Visits,INPATIENT ANCILLARY SERVICE COST APPORTIONMENT,COMPUTATION OF INPATIENT OPERATING COSTS,APPORTIONMENT OF INPATIENT ROUTINE SERVICE CAPITAL COSTS,Medicaid Inpatient Days/Outpatient Visits,Total Inpatient Days/Outpatient Visits,ALLOCATION OF NEW CAPITAL COSTS,COST ALLOCATION,HHA STATISTICAL DATA,COMPUTATION OF INPATIENT OPERATING COSTS,HHA STATISTICAL DATA,S-10 DATA,COST ALLOCATION,RENAL STATISTICAL DATA,APPORTIONMENT OF INPATIENT/OUTPATIENT ANCILLARY SERVICE OTHER PASS THROUGH COSTS,RECONCILIATION OF CAPITAL COST CENTERS,TRIAL BALANCE OF EXPENSE ACCOUNTS,HHA STATISTICAL DATA,,COST ALLOCATION,COST ALLOCATION,COST ALLOCATION,ANALYSIS OF CHANGES IN NEW CAPITAL BALANCES,TRIAL BALANCE OF EXPENSE ACCOUNTS,APPORTIONMENT OF MEDICAL AND OTHER HEALTH SERVICES,COMPUTATION OF RATIO OF COST TO CHARGES,TRIAL BALANCE OF EXPENSE ACCOUNTS,APPORTIONMENT OF MEDICAL AND OTHER HEALTH SERVICES,INPATIENT ANCILLARY SERVICE COST APPORTIONMENT,APPORTIONMENT OF INPATIENT/OUTPATIENT ANCILLARY SERVICE OTHER PASS THROUGH COSTS,ALLOCATION OF NEW CAPITAL COSTS,COMPUTATION OF RATIO OF COST TO CHARGES,COMPUTATION OF INPATIENT OPERATING COSTS,TRIAL BALANCE OF EXPENSE ACCOUNTS,APPORTIONMENT OF INPATIENT ROUTINE SERVICE CAPITAL COSTS,HOSPITAL WAGE INDEX DATA,ADJUSTMENTS,,COST ALLOCATION,COMPUTATION OF RATIO OF COST TO CHARGES,TRIAL BALANCE OF EXPENSE ACCOUNTS,COMPUTATION OF RATIO OF COST TO CHARGES,TRIAL BALANCE OF EXPENSE ACCOUNTS,TRIAL BALANCE OF EXPENSE ACCOUNTS,INPATIENT ANCILLARY SERVICE COST APPORTIONMENT,S-10 DATA,APPORTIONMENT OF INPATIENT/OUTPATIENT ANCILLARY SERVICE OTHER PASS THROUGH COSTS,APPORTIONMENT OF MEDICAL AND OTHER HEALTH SERVICES,APPORTIONMENT OF INPATIENT/OUTPATIENT ANCILLARY SERVICE OTHER PASS THROUGH COSTS,S-10 DATA,COST ALLOCATION,COMPUTATION OF RATIO OF COST TO CHARGES,APPORTIONMENT OF MEDICAL AND OTHER HEALTH SERVICES,ANALYSIS OF CHANGES IN NEW CAPITAL BALANCES,INPATIENT ANCILLARY SERVICE COST APPORTIONMENT,TRIAL BALANCE OF EXPENSE ACCOUNTS,COMPUTATION OF RATIO OF COST TO CHARGES,,INPATIENT ANCILLARY SERVICE COST APPORTIONMENT,APPORTIONMENT OF INPATIENT/OUTPATIENT ANCILLARY SERVICE OTHER PASS THROUGH COSTS,,ALLOCATION OF NEW CAPITAL COSTS,,HOSPITAL WAGE INDEX DATA,TRIAL BALANCE OF EXPENSE ACCOUNTS,APPORTIONMENT OF INPATIENT/OUTPATIENT ANCILLARY SERVICE OTHER PASS THROUGH COSTS,INPATIENT ANCILLARY SERVICE COST APPORTIONMENT,INPATIENT ANCILLARY SERVICE COST APPORTIONMENT,INPATIENT ANCILLARY SERVICE COST APPORTIONMENT,TRIAL BALANCE OF EXPENSE ACCOUNTS,HOSPITAL IDENTIFICATION INFORMATION,INPATIENT ANCILLARY SERVICE COST APPORTIONMENT,HOSPITAL WAGE INDEX DATA,APPORTIONMENT OF MEDICAL AND OTHER HEALTH SERVICES,TRIAL BALANCE OF EXPENSE ACCOUNTS,INPATIENT ANCILLARY SERVICE COST APPORTIONMENT,RECONCILIATION OF CAPITAL COST CENTERS,COST ALLOCATION,APPORTIONMENT OF INPATIENT/OUTPATIENT ANCILLARY SERVICE OTHER PASS THROUGH COSTS,APPORTIONMENT OF MEDICAL AND OTHER HEALTH SERVICES,HOSPITAL WAGE INDEX DATA,BED DAYS AVAILABLE,APPORTIONMENT OF INPATIENT/OUTPATIENT ANCILLARY SERVICE OTHER PASS THROUGH COSTS,TRIAL BALANCE OF EXPENSE ACCOUNTS,HOSPITAL WAGE INDEX DATA,TRIAL BALANCE OF EXPENSE ACCOUNTS,ALLOCATION OF NEW CAPITAL COSTS,APPORTIONMENT OF INPATIENT/OUTPATIENT ANCILLARY SERVICE OTHER PASS THROUGH COSTS,TRIAL BALANCE OF EXPENSE ACCOUNTS,APPORTIONMENT OF INPATIENT/OUTPATIENT ANCILLARY SERVICE OTHER PASS THROUGH COSTS,APPORTIONMENT OF INPATIENT/OUTPATIENT ANCILLARY SERVICE OTHER PASS THROUGH COSTS,TRIAL BALANCE OF EXPENSE ACCOUNTS,COMPUTATION OF RATIO OF COST TO CHARGES,INPATIENT ANCILLARY SERVICE COST APPORTIONMENT,TRIAL BALANCE OF EXPENSE ACCOUNTS,APPORTIONMENT OF MEDICAL AND OTHER HEALTH SERVICES,HOSPITAL WAGE INDEX DATA,APPORTIONMENT OF INPATIENT/OUTPATIENT ANCILLARY SERVICE OTHER PASS THROUGH COSTS,INPATIENT ANCILLARY SERVICE COST APPORTIONMENT,INPATIENT ANCILLARY SERVICE COST APPORTIONMENT,HOSPITAL WAGE INDEX DATA,INPATIENT ANCILLARY SERVICE COST APPORTIONMENT,COST ALLOCATION,COST ALLOCATION,HOSPITAL WAGE INDEX DATA,COST ALLOCATION,HOSPITAL WAGE INDEX DATA,HHA STATISTICAL DATA,INPATIENT ANCILLARY SERVICE COST APPORTIONMENT,INPATIENT ANCILLARY SERVICE COST APPORTIONMENT,,APPORTIONMENT OF INPATIENT/OUTPATIENT ANCILLARY SERVICE OTHER PASS THROUGH COSTS,APPORTIONMENT OF INPATIENT/OUTPATIENT ANCILLARY SERVICE OTHER PASS THROUGH COSTS,APPORTIONMENT OF INPATIENT/OUTPATIENT ANCILLARY SERVICE OTHER PASS THROUGH COSTS,ALLOCATION OF NEW CAPITAL COSTS,,RECONCILIATION OF CAPITAL COST CENTERS,INPATIENT ANCILLARY SERVICE COST APPORTIONMENT,COMPUTATION OF INPATIENT OPERATING COSTS,TRIAL BALANCE OF EXPENSE ACCOUNTS,,HOSPITAL WAGE INDEX DATA,TRIAL BALANCE OF EXPENSE ACCOUNTS,COST ALLOCATION,TRIAL BALANCE OF EXPENSE ACCOUNTS,APPORTIONMENT OF INPATIENT/OUTPATIENT ANCILLARY SERVICE OTHER PASS THROUGH COSTS,INPATIENT ANCILLARY SERVICE COST APPORTIONMENT,APPORTIONMENT OF MEDICAL AND OTHER HEALTH SERVICES,HHA STATISTICAL DATA,COST ALLOCATION,TRIAL BALANCE OF EXPENSE ACCOUNTS,INPATIENT ANCILLARY SERVICE COST APPORTIONMENT,,,INPATIENT ANCILLARY SERVICE COST APPORTIONMENT,TRIAL BALANCE OF EXPENSE ACCOUNTS,TRIAL BALANCE OF EXPENSE ACCOUNTS,INPATIENT ANCILLARY SERVICE COST APPORTIONMENT,S-10 DATA,APPORTIONMENT OF INPATIENT/OUTPATIENT ANCILLARY SERVICE OTHER PASS THROUGH COSTS,TRIAL BALANCE OF EXPENSE ACCOUNTS,COST ALLOCATION,APPORTIONMENT OF INPATIENT ROUTINE SERVICE OTHER PASS THROUGH COSTS,Total Inpatient Days/Outpatient Visits,APPORTIONMENT OF INPATIENT/OUTPATIENT ANCILLARY SERVICE OTHER PASS THROUGH COSTS,Total Inpatient Days/Outpatient Visits,TRIAL BALANCE OF EXPENSE ACCOUNTS,ANALYSIS OF CHANGES IN NEW CAPITAL BALANCES,COST ALLOCATION,APPORTIONMENT OF INPATIENT/OUTPATIENT ANCILLARY SERVICE OTHER PASS THROUGH COSTS,COST ALLOCATION,TRIAL BALANCE OF EXPENSE ACCOUNTS,APPORTIONMENT OF INPATIENT/OUTPATIENT ANCILLARY SERVICE OTHER PASS THROUGH COSTS,CALCULATION OF REIMBURSEMENT SETTLEMENT,APPORTIONMENT OF MEDICAL AND OTHER HEALTH SERVICES,APPORTIONMENT OF MEDICAL AND OTHER HEALTH SERVICES,RECONCILIATION OF CAPITAL COST CENTERS,HOSPITAL WAGE INDEX DATA,BED DAYS AVAILABLE,ADJUSTMENTS,INPATIENT ANCILLARY SERVICE COST APPORTIONMENT,COST ALLOCATION,S-10 DATA,Total Inpatient Days/Outpatient Visits,APPORTIONMENT OF INPATIENT/OUTPATIENT ANCILLARY SERVICE OTHER PASS THROUGH COSTS,ALLOCATION OF NEW CAPITAL COSTS,COMPUTATION OF RATIO OF COST TO CHARGES,COST ALLOCATION,HHA STATISTICAL DATA,INPATIENT ANCILLARY SERVICE COST APPORTIONMENT,S-10 DATA,CALCULATION OF REIMBURSEMENT SETTLEMENT,HOSPITAL WAGE INDEX DATA,APPORTIONMENT OF INPATIENT/OUTPATIENT ANCILLARY SERVICE OTHER PASS THROUGH COSTS,INPATIENT ANCILLARY SERVICE COST APPORTIONMENT,,COST ALLOCATION,APPORTIONMENT OF INPATIENT ROUTINE SERVICE CAPITAL COSTS,INPATIENT ANCILLARY SERVICE COST APPORTIONMENT,APPORTIONMENT OF INPATIENT ROUTINE SERVICE OTHER PASS THROUGH COSTS,HHA STATISTICAL DATA,COMPUTATION OF RATIO OF COST TO CHARGES,COMPUTATION OF INPATIENT OPERATING COSTS,INPATIENT ANCILLARY SERVICE COST APPORTIONMENT,APPORTIONMENT OF MEDICAL AND OTHER HEALTH SERVICES,APPORTIONMENT OF INPATIENT/OUTPATIENT ANCILLARY SERVICE OTHER PASS THROUGH COSTS,TRIAL BALANCE OF EXPENSE ACCOUNTS,TRIAL BALANCE OF EXPENSE ACCOUNTS,Total Inpatient Days/Outpatient Visits,INPATIENT ANCILLARY SERVICE COST APPORTIONMENT,S-10 DATA,CALCULATION OF REIMBURSEMENT SETTLEMENT,COST ALLOCATION,TRIAL BALANCE OF EXPENSE ACCOUNTS,BED DAYS AVAILABLE,COMPUTATION OF RATIO OF COST TO CHARGES,ALLOCATION OF NEW CAPITAL COSTS,INPATIENT ANCILLARY SERVICE COST APPORTIONMENT,COMPUTATION OF RATIO OF COST TO CHARGES,INPATIENT ANCILLARY SERVICE COST APPORTIONMENT,CALCULATION OF REIMBURSEMENT SETTLEMENT,APPORTIONMENT OF INPATIENT/OUTPATIENT ANCILLARY SERVICE OTHER PASS THROUGH COSTS,APPORTIONMENT OF MEDICAL AND OTHER HEALTH SERVICES,NUMBER OF BEDS,Total Inpatient Days/Outpatient Visits,TRIAL BALANCE OF EXPENSE ACCOUNTS,COST ALLOCATION,RENAL STATISTICAL DATA,NUMBER OF BEDS,Total Inpatient Days/Outpatient Visits,APPORTIONMENT OF MEDICAL AND OTHER HEALTH SERVICES,RENAL STATISTICAL DATA,APPORTIONMENT OF INPATIENT/OUTPATIENT ANCILLARY SERVICE OTHER PASS THROUGH COSTS,TRIAL BALANCE OF EXPENSE ACCOUNTS,APPORTIONMENT OF INPATIENT/OUTPATIENT ANCILLARY SERVICE OTHER PASS THROUGH COSTS,TRIAL BALANCE OF EXPENSE ACCOUNTS,APPORTIONMENT OF INPATIENT ROUTINE SERVICE CAPITAL COSTS,APPORTIONMENT OF INPATIENT ROUTINE SERVICE CAPITAL COSTS,APPORTIONMENT OF INPATIENT/OUTPATIENT ANCILLARY SERVICE OTHER PASS THROUGH COSTS,APPORTIONMENT OF MEDICAL AND OTHER HEALTH SERVICES,,HOSPITAL WAGE INDEX DATA,TRIAL BALANCE OF EXPENSE ACCOUNTS,COST ALLOCATION,APPORTIONMENT OF INPATIENT/OUTPATIENT ANCILLARY SERVICE OTHER PASS THROUGH COSTS,INPATIENT ANCILLARY SERVICE COST APPORTIONMENT,HOSPITAL WAGE INDEX DATA,COST ALLOCATION,APPORTIONMENT OF INPATIENT/OUTPATIENT ANCILLARY SERVICE OTHER PASS THROUGH COSTS,INPATIENT ANCILLARY SERVICE COST APPORTIONMENT,TRIAL BALANCE OF EXPENSE ACCOUNTS,INPATIENT ANCILLARY SERVICE COST APPORTIONMENT,APPORTIONMENT OF MEDICAL AND OTHER HEALTH SERVICES,APPORTIONMENT OF MEDICAL AND OTHER HEALTH SERVICES,ADJUSTMENTS,COST ALLOCATION,HOSPITAL WAGE INDEX DATA,APPORTIONMENT OF INPATIENT/OUTPATIENT ANCILLARY SERVICE OTHER PASS THROUGH COSTS,INPATIENT ANCILLARY SERVICE COST APPORTIONMENT,INPATIENT ANCILLARY SERVICE COST APPORTIONMENT,TRIAL BALANCE OF EXPENSE ACCOUNTS,RECONCILIATION OF CAPITAL COST CENTERS,,BED DAYS AVAILABLE,HHA STATISTICAL DATA,APPORTIONMENT OF INPATIENT/OUTPATIENT ANCILLARY SERVICE OTHER PASS THROUGH COSTS,INPATIENT ANCILLARY SERVICE COST APPORTIONMENT,COST ALLOCATION,Total Inpatient Days/Outpatient Visits,APPORTIONMENT OF INPATIENT/OUTPATIENT ANCILLARY SERVICE OTHER PASS THROUGH COSTS,INPATIENT ANCILLARY SERVICE COST APPORTIONMENT,Total Inpatient Days/Outpatient Visits,APPORTIONMENT OF MEDICAL AND OTHER HEALTH SERVICES,ADJUSTMENTS,COMPUTATION OF RATIO OF COST TO CHARGES,S-10 DATA,APPORTIONMENT OF MEDICAL AND OTHER HEALTH SERVICES,COST ALLOCATION,COST ALLOCATION,INPATIENT ANCILLARY SERVICE COST APPORTIONMENT,COMPUTATION OF RATIO OF COST TO CHARGES,COST ALLOCATION,Total Inpatient Days/Outpatient Visits,COMPUTATION OF RATIO OF COST TO CHARGES,HOSPITAL WAGE INDEX DATA,NUMBER OF BEDS,COST ALLOCATION,INPATIENT ANCILLARY SERVICE COST APPORTIONMENT,,APPORTIONMENT OF INPATIENT/OUTPATIENT ANCILLARY SERVICE OTHER PASS THROUGH COSTS,APPORTIONMENT OF INPATIENT/OUTPATIENT ANCILLARY SERVICE OTHER PASS THROUGH COSTS,COST ALLOCATION,COMPUTATION OF RATIO OF COST TO CHARGES,APPORTIONMENT OF INPATIENT/OUTPATIENT ANCILLARY SERVICE OTHER PASS THROUGH COSTS,ANALYSIS OF CHANGES IN NEW CAPITAL BALANCES,BED DAYS AVAILABLE,APPORTIONMENT OF INPATIENT/OUTPATIENT ANCILLARY SERVICE OTHER PASS THROUGH COSTS,HOSPITAL WAGE INDEX DATA,APPORTIONMENT OF INPATIENT/OUTPATIENT ANCILLARY SERVICE OTHER PASS THROUGH COSTS,APPORTIONMENT OF INPATIENT/OUTPATIENT ANCILLARY SERVICE OTHER PASS THROUGH COSTS,ADJUSTMENTS,COMPUTATION OF RATIO OF COST TO CHARGES,INPATIENT ANCILLARY SERVICE COST APPORTIONMENT,INPATIENT ANCILLARY SERVICE COST APPORTIONMENT,INPATIENT ANCILLARY SERVICE COST APPORTIONMENT,HOSPITAL WAGE INDEX DATA,COST ALLOCATION,APPORTIONMENT OF MEDICAL AND OTHER HEALTH SERVICES,COST ALLOCATION,RECONCILIATION OF CAPITAL COST CENTERS,APPORTIONMENT OF INPATIENT/OUTPATIENT ANCILLARY SERVICE OTHER PASS THROUGH COSTS,Total Inpatient Days/Outpatient Visits,TRIAL BALANCE OF EXPENSE ACCOUNTS,BED DAYS AVAILABLE,BED DAYS AVAILABLE,APPORTIONMENT OF INPATIENT/OUTPATIENT ANCILLARY SERVICE OTHER PASS THROUGH COSTS,INPATIENT ANCILLARY SERVICE COST APPORTIONMENT,RENAL STATISTICAL DATA,COST ALLOCATION,APPORTIONMENT OF INPATIENT ROUTINE SERVICE OTHER PASS THROUGH COSTS,INPATIENT ANCILLARY SERVICE COST APPORTIONMENT,COST ALLOCATION,INPATIENT ANCILLARY SERVICE COST APPORTIONMENT,INPATIENT ANCILLARY SERVICE COST APPORTIONMENT,COST ALLOCATION,Total Inpatient Days/Outpatient Visits,ANALYSIS OF CHANGES IN NEW CAPITAL BALANCES,APPORTIONMENT OF INPATIENT/OUTPATIENT ANCILLARY SERVICE OTHER PASS THROUGH COSTS,INPATIENT ANCILLARY SERVICE COST APPORTIONMENT,COST ALLOCATION,COMPUTATION OF INPATIENT OPERATING COSTS,Total Inpatient Days/Outpatient Visits,COMPUTATION OF INPATIENT OPERATING COSTS,,COST ALLOCATION,Total Inpatient Days/Outpatient Visits,APPORTIONMENT OF INPATIENT/OUTPATIENT ANCILLARY SERVICE OTHER PASS THROUGH COSTS,INPATIENT ANCILLARY SERVICE COST APPORTIONMENT,TRIAL BALANCE OF EXPENSE ACCOUNTS,APPORTIONMENT OF MEDICAL AND OTHER HEALTH SERVICES,BED DAYS AVAILABLE,INPATIENT ANCILLARY SERVICE COST APPORTIONMENT,,COMPUTATION OF INPATIENT OPERATING COSTS,ALLOCATION OF NEW CAPITAL COSTS,APPORTIONMENT OF INPATIENT ROUTINE SERVICE CAPITAL COSTS,,Medicare Inpatient Days/Outpatient Visits,TRIAL BALANCE OF EXPENSE ACCOUNTS,Medicaid Inpatient Days/Outpatient Visits,COST ALLOCATION,COMPUTATION OF INPATIENT OPERATING COSTS,INPATIENT ANCILLARY SERVICE COST APPORTIONMENT,ADJUSTMENTS,INPATIENT ANCILLARY SERVICE COST APPORTIONMENT,APPORTIONMENT OF MEDICAL AND OTHER HEALTH SERVICES,APPORTIONMENT OF INPATIENT/OUTPATIENT ANCILLARY SERVICE OTHER PASS THROUGH COSTS,APPORTIONMENT OF MEDICAL AND OTHER HEALTH SERVICES,APPORTIONMENT OF INPATIENT/OUTPATIENT ANCILLARY SERVICE OTHER PASS THROUGH COSTS,HOSPITAL IDENTIFICATION INFORMATION,Total Inpatient Days/Outpatient Visits,TRIAL BALANCE OF EXPENSE ACCOUNTS,APPORTIONMENT OF INPATIENT ROUTINE SERVICE CAPITAL COSTS,APPORTIONMENT OF INPATIENT/OUTPATIENT ANCILLARY SERVICE OTHER PASS THROUGH COSTS,COMPUTATION OF RATIO OF COST TO CHARGES,COST ALLOCATION,APPORTIONMENT OF INPATIENT ROUTINE SERVICE CAPITAL COSTS,COMPUTATION OF RATIO OF COST TO CHARGES,INPATIENT ANCILLARY SERVICE COST APPORTIONMENT,INPATIENT ANCILLARY SERVICE COST APPORTIONMENT,APPORTIONMENT OF INPATIENT/OUTPATIENT ANCILLARY SERVICE OTHER PASS THROUGH COSTS,APPORTIONMENT OF INPATIENT ROUTINE SERVICE OTHER PASS THROUGH COSTS,HOSPITAL WAGE INDEX DATA,COST ALLOCATION,APPORTIONMENT OF INPATIENT/OUTPATIENT ANCILLARY SERVICE OTHER PASS THROUGH COSTS,CALCULATION OF REIMBURSEMENT SETTLEMENT,COST ALLOCATION,HHA STATISTICAL DATA,APPORTIONMENT OF MEDICAL AND OTHER HEALTH SERVICES,RENAL STATISTICAL DATA,APPORTIONMENT OF MEDICAL AND OTHER HEALTH SERVICES,TRIAL BALANCE OF EXPENSE ACCOUNTS,COST ALLOCATION,COMPUTATION OF RATIO OF COST TO CHARGES,APPORTIONMENT OF MEDICAL AND OTHER HEALTH SERVICES,COMPUTATION OF RATIO OF COST TO CHARGES,HHA STATISTICAL DATA,COST ALLOCATION,Medicare Inpatient Days/Outpatient Visits,ALLOCATION OF NEW CAPITAL COSTS,INPATIENT ANCILLARY SERVICE COST APPORTIONMENT,HHA STATISTICAL DATA,HOSPITAL WAGE INDEX DATA,HOSPITAL WAGE INDEX DATA,APPORTIONMENT OF INPATIENT/OUTPATIENT ANCILLARY SERVICE OTHER PASS THROUGH COSTS,APPORTIONMENT OF INPATIENT/OUTPATIENT ANCILLARY SERVICE OTHER PASS THROUGH COSTS,TRIAL BALANCE OF EXPENSE ACCOUNTS,APPORTIONMENT OF INPATIENT/OUTPATIENT ANCILLARY SERVICE OTHER PASS THROUGH COSTS,COST ALLOCATION,APPORTIONMENT OF MEDICAL AND OTHER HEALTH SERVICES,HOSPITAL WAGE INDEX DATA,HOSPITAL WAGE INDEX DATA,COMPUTATION OF RATIO OF COST TO CHARGES,HOSPITAL WAGE INDEX DATA,COMPUTATION OF RATIO OF COST TO CHARGES,COST ALLOCATION,COST ALLOCATION,Total Inpatient Days/Outpatient Visits,TRIAL BALANCE OF EXPENSE ACCOUNTS,TRIAL BALANCE OF EXPENSE ACCOUNTS,COST ALLOCATION,COST ALLOCATION,ANALYSIS OF CHANGES IN NEW CAPITAL BALANCES,TRIAL BALANCE OF EXPENSE ACCOUNTS,COST ALLOCATION,APPORTIONMENT OF INPATIENT/OUTPATIENT ANCILLARY SERVICE OTHER PASS THROUGH COSTS,BED DAYS AVAILABLE,COST ALLOCATION,COST ALLOCATION,APPORTIONMENT OF MEDICAL AND OTHER HEALTH SERVICES,CALCULATION OF REIMBURSEMENT SETTLEMENT,TRIAL BALANCE OF EXPENSE ACCOUNTS,APPORTIONMENT OF INPATIENT/OUTPATIENT ANCILLARY SERVICE OTHER PASS THROUGH COSTS,NUMBER OF BEDS,APPORTIONMENT OF INPATIENT ROUTINE SERVICE CAPITAL COSTS,BED DAYS AVAILABLE,HOSPITAL WAGE INDEX DATA,ANALYSIS OF CHANGES IN NEW CAPITAL BALANCES,,APPORTIONMENT OF INPATIENT/OUTPATIENT ANCILLARY SERVICE OTHER PASS THROUGH COSTS,Medicare Inpatient Days/Outpatient Visits,HOSPITAL WAGE INDEX DATA,COST ALLOCATION,INPATIENT ANCILLARY SERVICE COST APPORTIONMENT,HHA STATISTICAL DATA,ALLOCATION OF NEW CAPITAL COSTS,COMPUTATION OF INPATIENT OPERATING COSTS,HOSPITAL IDENTIFICATION INFORMATION,ANALYSIS OF CHANGES IN NEW CAPITAL BALANCES,,APPORTIONMENT OF MEDICAL AND OTHER HEALTH SERVICES,INPATIENT ANCILLARY SERVICE COST APPORTIONMENT,COST ALLOCATION,APPORTIONMENT OF INPATIENT/OUTPATIENT ANCILLARY SERVICE OTHER PASS THROUGH COSTS,TRIAL BALANCE OF EXPENSE ACCOUNTS,COST ALLOCATION,INPATIENT ANCILLARY SERVICE COST APPORTIONMENT,RENAL STATISTICAL DATA,INPATIENT ANCILLARY SERVICE COST APPORTIONMENT,APPORTIONMENT OF INPATIENT/OUTPATIENT ANCILLARY SERVICE OTHER PASS THROUGH COSTS,COMPUTATION OF INPATIENT OPERATING COSTS,TRIAL BALANCE OF EXPENSE ACCOUNTS,APPORTIONMENT OF INPATIENT/OUTPATIENT ANCILLARY SERVICE OTHER PASS THROUGH COSTS,APPORTIONMENT OF INPATIENT/OUTPATIENT ANCILLARY SERVICE OTHER PASS THROUGH COSTS,,HOSPITAL WAGE INDEX DATA,COST ALLOCATION,APPORTIONMENT OF INPATIENT/OUTPATIENT ANCILLARY SERVICE OTHER PASS THROUGH COSTS,CALCULATION OF REIMBURSEMENT SETTLEMENT,COMPUTATION OF RATIO OF COST TO CHARGES,COST ALLOCATION,COMPUTATION OF RATIO OF COST TO CHARGES,TRIAL BALANCE OF EXPENSE ACCOUNTS,INPATIENT ANCILLARY SERVICE COST APPORTIONMENT,APPORTIONMENT OF MEDICAL AND OTHER HEALTH SERVICES,TRIAL BALANCE OF EXPENSE ACCOUNTS,ALLOCATION OF NEW CAPITAL COSTS,TRIAL BALANCE OF EXPENSE ACCOUNTS,ALLOCATION OF NEW CAPITAL COSTS,COMPUTATION OF RATIO OF COST TO CHARGES,COST ALLOCATION,COST ALLOCATION,HHA STATISTICAL DATA,TRIAL BALANCE OF EXPENSE ACCOUNTS,HOSPITAL IDENTIFICATION INFORMATION,HOSPITAL WAGE INDEX DATA,APPORTIONMENT OF INPATIENT/OUTPATIENT ANCILLARY SERVICE OTHER PASS THROUGH COSTS,APPORTIONMENT OF INPATIENT/OUTPATIENT ANCILLARY SERVICE OTHER PASS THROUGH COSTS,APPORTIONMENT OF INPATIENT/OUTPATIENT ANCILLARY SERVICE OTHER PASS THROUGH COSTS,COST ALLOCATION,ALLOCATION OF NEW CAPITAL COSTS,COMPUTATION OF RATIO OF COST TO CHARGES,COMPUTATION OF RATIO OF COST TO CHARGES,APPORTIONMENT OF MEDICAL AND OTHER HEALTH SERVICES,NUMBER OF BEDS,APPORTIONMENT OF MEDICAL AND OTHER HEALTH SERVICES,BED DAYS AVAILABLE,,APPORTIONMENT OF INPATIENT/OUTPATIENT ANCILLARY SERVICE OTHER PASS THROUGH COSTS,COMPUTATION OF RATIO OF COST TO CHARGES,APPORTIONMENT OF INPATIENT/OUTPATIENT ANCILLARY SERVICE OTHER PASS THROUGH COSTS,BED DAYS AVAILABLE,APPORTIONMENT OF INPATIENT/OUTPATIENT ANCILLARY SERVICE OTHER PASS THROUGH COSTS,INPATIENT ANCILLARY SERVICE COST APPORTIONMENT,COMPUTATION OF RATIO OF COST TO CHARGES,TRIAL BALANCE OF EXPENSE ACCOUNTS,APPORTIONMENT OF MEDICAL AND OTHER HEALTH SERVICES,TRIAL BALANCE OF EXPENSE ACCOUNTS,APPORTIONMENT OF MEDICAL AND OTHER HEALTH SERVICES,TRIAL BALANCE OF EXPENSE ACCOUNTS,ADJUSTMENTS,APPORTIONMENT OF MEDICAL AND OTHER HEALTH SERVICES,APPORTIONMENT OF INPATIENT/OUTPATIENT ANCILLARY SERVICE OTHER PASS THROUGH COSTS,COST ALLOCATION,COST ALLOCATION,INPATIENT ANCILLARY SERVICE COST APPORTIONMENT,COMPUTATION OF RATIO OF COST TO CHARGES,INPATIENT ANCILLARY SERVICE COST APPORTIONMENT,APPORTIONMENT OF INPATIENT ROUTINE SERVICE CAPITAL COSTS,CALCULATION OF REIMBURSEMENT SETTLEMENT,HHA STATISTICAL DATA,COMPUTATION OF RATIO OF COST TO CHARGES,S-10 DATA,COMPUTATION OF RATIO OF COST TO CHARGES,APPORTIONMENT OF MEDICAL AND OTHER HEALTH SERVICES,TRIAL BALANCE OF EXPENSE ACCOUNTS,APPORTIONMENT OF INPATIENT/OUTPATIENT ANCILLARY SERVICE OTHER PASS THROUGH COSTS,CALCULATION OF REIMBURSEMENT SETTLEMENT,COST ALLOCATION,APPORTIONMENT OF INPATIENT/OUTPATIENT ANCILLARY SERVICE OTHER PASS THROUGH COSTS,HOSPITAL WAGE INDEX DATA,APPORTIONMENT OF INPATIENT/OUTPATIENT ANCILLARY SERVICE OTHER PASS THROUGH COSTS,BED DAYS AVAILABLE,COST ALLOCATION,COST ALLOCATION,HOSPITAL WAGE INDEX DATA,HHA STATISTICAL DATA,BED DAYS AVAILABLE,COST ALLOCATION,RENAL STATISTICAL DATA,APPORTIONMENT OF MEDICAL AND OTHER HEALTH SERVICES,APPORTIONMENT OF INPATIENT/OUTPATIENT ANCILLARY SERVICE OTHER PASS THROUGH COSTS,APPORTIONMENT OF INPATIENT/OUTPATIENT ANCILLARY SERVICE OTHER PASS THROUGH COSTS,APPORTIONMENT OF INPATIENT ROUTINE SERVICE CAPITAL COSTS,COMPUTATION OF RATIO OF COST TO CHARGES,TRIAL BALANCE OF EXPENSE ACCOUNTS,APPORTIONMENT OF INPATIENT/OUTPATIENT ANCILLARY SERVICE OTHER PASS THROUGH COSTS,TRIAL BALANCE OF EXPENSE ACCOUNTS,HOSPITAL WAGE INDEX DATA,APPORTIONMENT OF MEDICAL AND OTHER HEALTH SERVICES,HOSPITAL WAGE INDEX DATA,BED DAYS AVAILABLE,HOSPITAL WAGE INDEX DATA,HHA STATISTICAL DATA,Total Inpatient Days/Outpatient Visits,TRIAL BALANCE OF EXPENSE ACCOUNTS,INPATIENT ANCILLARY SERVICE COST APPORTIONMENT,COST ALLOCATION,HOSPITAL WAGE INDEX DATA,COMPUTATION OF RATIO OF COST TO CHARGES,COMPUTATION OF RATIO OF COST TO CHARGES,COMPUTATION OF RATIO OF COST TO CHARGES,APPORTIONMENT OF INPATIENT/OUTPATIENT ANCILLARY SERVICE OTHER PASS THROUGH COSTS,COMPUTATION OF RATIO OF COST TO CHARGES,ALLOCATION OF NEW CAPITAL COSTS,APPORTIONMENT OF INPATIENT/OUTPATIENT ANCILLARY SERVICE OTHER PASS THROUGH COSTS,INPATIENT ANCILLARY SERVICE COST APPORTIONMENT,INPATIENT ANCILLARY SERVICE COST APPORTIONMENT,COST ALLOCATION,APPORTIONMENT OF MEDICAL AND OTHER HEALTH SERVICES,HOSPITAL WAGE INDEX DATA,HOSPITAL WAGE INDEX DATA,INPATIENT ANCILLARY SERVICE COST APPORTIONMENT,COST ALLOCATION,TRIAL BALANCE OF EXPENSE ACCOUNTS,COMPUTATION OF RATIO OF COST TO CHARGES,ADJUSTMENTS,COMPUTATION OF RATIO OF COST TO CHARGES,COMPUTATION OF RATIO OF COST TO CHARGES,TRIAL BALANCE OF EXPENSE ACCOUNTS,TRIAL BALANCE OF EXPENSE ACCOUNTS,INPATIENT ANCILLARY SERVICE COST APPORTIONMENT,TRIAL BALANCE OF EXPENSE ACCOUNTS,Medicaid Inpatient Days/Outpatient Visits,COMPUTATION OF RATIO OF COST TO CHARGES,INPATIENT ANCILLARY SERVICE COST APPORTIONMENT,,COST ALLOCATION,TRIAL BALANCE OF EXPENSE ACCOUNTS,APPORTIONMENT OF MEDICAL AND OTHER HEALTH SERVICES,COST ALLOCATION,ADJUSTMENTS,APPORTIONMENT OF MEDICAL AND OTHER HEALTH SERVICES,COST ALLOCATION,APPORTIONMENT OF MEDICAL AND OTHER HEALTH SERVICES,TRIAL BALANCE OF EXPENSE ACCOUNTS,APPORTIONMENT OF MEDICAL AND OTHER HEALTH SERVICES,HOSPITAL WAGE INDEX DATA,APPORTIONMENT OF INPATIENT/OUTPATIENT ANCILLARY SERVICE OTHER PASS THROUGH COSTS,Total Inpatient Days/Outpatient Visits,INPATIENT ANCILLARY SERVICE COST APPORTIONMENT,INPATIENT ANCILLARY SERVICE COST APPORTIONMENT,TRIAL BALANCE OF EXPENSE ACCOUNTS,CALCULATION OF REIMBURSEMENT SETTLEMENT,APPORTIONMENT OF INPATIENT/OUTPATIENT ANCILLARY SERVICE OTHER PASS THROUGH COSTS,TRIAL BALANCE OF EXPENSE ACCOUNTS,APPORTIONMENT OF INPATIENT/OUTPATIENT ANCILLARY SERVICE OTHER PASS THROUGH COSTS,COST ALLOCATION,APPORTIONMENT OF MEDICAL AND OTHER HEALTH SERVICES,ADJUSTMENTS,ALLOCATION OF NEW CAPITAL COSTS,INPATIENT ANCILLARY SERVICE COST APPORTIONMENT,INPATIENT ANCILLARY SERVICE COST APPORTIONMENT,APPORTIONMENT OF INPATIENT/OUTPATIENT ANCILLARY SERVICE OTHER PASS THROUGH COSTS,,,RENAL STATISTICAL DATA,TRIAL BALANCE OF EXPENSE ACCOUNTS,NUMBER OF BEDS,APPORTIONMENT OF INPATIENT/OUTPATIENT ANCILLARY SERVICE OTHER PASS THROUGH COSTS,APPORTIONMENT OF MEDICAL AND OTHER HEALTH SERVICES,TRIAL BALANCE OF EXPENSE ACCOUNTS,RENAL STATISTICAL DATA,Total Inpatient Days/Outpatient Visits,APPORTIONMENT OF INPATIENT/OUTPATIENT ANCILLARY SERVICE OTHER PASS THROUGH COSTS,APPORTIONMENT OF INPATIENT/OUTPATIENT ANCILLARY SERVICE OTHER PASS THROUGH COSTS,S-10 DATA,TRIAL BALANCE OF EXPENSE ACCOUNTS,HOSPITAL WAGE INDEX DATA,APPORTIONMENT OF MEDICAL AND OTHER HEALTH SERVICES,Total Inpatient Days/Outpatient Visits,ANALYSIS OF CHANGES IN NEW CAPITAL BALANCES,INPATIENT ANCILLARY SERVICE COST APPORTIONMENT,APPORTIONMENT OF INPATIENT/OUTPATIENT ANCILLARY SERVICE OTHER PASS THROUGH COSTS,APPORTIONMENT OF INPATIENT/OUTPATIENT ANCILLARY SERVICE OTHER PASS THROUGH COSTS,Total Inpatient Days/Outpatient Visits,HOSPITAL WAGE INDEX DATA,INPATIENT ANCILLARY SERVICE COST APPORTIONMENT,COST ALLOCATION,HOSPITAL WAGE INDEX DATA,APPORTIONMENT OF MEDICAL AND OTHER HEALTH SERVICES,COST ALLOCATION,RENAL STATISTICAL DATA,INPATIENT ANCILLARY SERVICE COST APPORTIONMENT,,TRIAL BALANCE OF EXPENSE ACCOUNTS,TRIAL BALANCE OF EXPENSE ACCOUNTS,S-10 DATA,RECONCILIATION OF CAPITAL COST CENTERS,APPORTIONMENT OF MEDICAL AND OTHER HEALTH SERVICES,CALCULATION OF REIMBURSEMENT SETTLEMENT,,TRIAL BALANCE OF EXPENSE ACCOUNTS,INPATIENT ANCILLARY SERVICE COST APPORTIONMENT,Medicaid Inpatient Days/Outpatient Visits,INPATIENT ANCILLARY SERVICE COST APPORTIONMENT,HOSPITAL WAGE INDEX DATA,APPORTIONMENT OF MEDICAL AND OTHER HEALTH SERVICES,CALCULATION OF REIMBURSEMENT SETTLEMENT,HOSPITAL WAGE INDEX DATA,APPORTIONMENT OF INPATIENT/OUTPATIENT ANCILLARY SERVICE OTHER PASS THROUGH COSTS,INPATIENT ANCILLARY SERVICE COST APPORTIONMENT,CALCULATION OF REIMBURSEMENT SETTLEMENT,APPORTIONMENT OF MEDICAL AND OTHER HEALTH SERVICES,APPORTIONMENT OF INPATIENT/OUTPATIENT ANCILLARY SERVICE OTHER PASS THROUGH COSTS,ALLOCATION OF NEW CAPITAL COSTS,APPORTIONMENT OF MEDICAL AND OTHER HEALTH SERVICES,INPATIENT ANCILLARY SERVICE COST APPORTIONMENT,S-10 DATA,CALCULATION OF REIMBURSEMENT SETTLEMENT,COMPUTATION OF RATIO OF COST TO CHARGES,,COMPUTATION OF RATIO OF COST TO CHARGES,COST ALLOCATION,COST ALLOCATION,INPATIENT ANCILLARY SERVICE COST APPORTIONMENT,,COMPUTATION OF RATIO OF COST TO CHARGES,ADJUSTMENTS,TRIAL BALANCE OF EXPENSE ACCOUNTS,TRIAL BALANCE OF EXPENSE ACCOUNTS,COMPUTATION OF RATIO OF COST TO CHARGES,Total Inpatient Days/Outpatient Visits,NUMBER OF BEDS,TRIAL BALANCE OF EXPENSE ACCOUNTS,APPORTIONMENT OF INPATIENT ROUTINE SERVICE CAPITAL COSTS,TRIAL BALANCE OF EXPENSE ACCOUNTS,TRIAL BALANCE OF EXPENSE ACCOUNTS,COST ALLOCATION,INPATIENT ANCILLARY SERVICE COST APPORTIONMENT,Medicare Inpatient Days/Outpatient Visits,TRIAL BALANCE OF EXPENSE ACCOUNTS,HHA STATISTICAL DATA,COST ALLOCATION,Total Inpatient Days/Outpatient Visits,APPORTIONMENT OF INPATIENT ROUTINE SERVICE CAPITAL COSTS,HOSPITAL WAGE INDEX DATA,TRIAL BALANCE OF EXPENSE ACCOUNTS,APPORTIONMENT OF MEDICAL AND OTHER HEALTH SERVICES,COMPUTATION OF RATIO OF COST TO CHARGES,BED DAYS AVAILABLE,INPATIENT ANCILLARY SERVICE COST APPORTIONMENT,APPORTIONMENT OF MEDICAL AND OTHER HEALTH SERVICES,APPORTIONMENT OF INPATIENT/OUTPATIENT ANCILLARY SERVICE OTHER PASS THROUGH COSTS,INPATIENT ANCILLARY SERVICE COST APPORTIONMENT,APPORTIONMENT OF INPATIENT/OUTPATIENT ANCILLARY SERVICE OTHER PASS THROUGH COSTS,APPORTIONMENT OF MEDICAL AND OTHER HEALTH SERVICES,INPATIENT ANCILLARY SERVICE COST APPORTIONMENT,APPORTIONMENT OF INPATIENT/OUTPATIENT ANCILLARY SERVICE OTHER PASS THROUGH COSTS,INPATIENT ANCILLARY SERVICE COST APPORTIONMENT,COMPUTATION OF RATIO OF COST TO CHARGES,Total Inpatient Days/Outpatient Visits,INPATIENT ANCILLARY SERVICE COST APPORTIONMENT,HOSPITAL WAGE INDEX DATA,COST ALLOCATION,BED DAYS AVAILABLE,COST ALLOCATION,HHA STATISTICAL DATA,NUMBER OF BEDS,TRIAL BALANCE OF EXPENSE ACCOUNTS,INPATIENT ANCILLARY SERVICE COST APPORTIONMENT,APPORTIONMENT OF MEDICAL AND OTHER HEALTH SERVICES,HOSPITAL WAGE INDEX DATA,TRIAL BALANCE OF EXPENSE ACCOUNTS,ANALYSIS OF CHANGES IN NEW CAPITAL BALANCES,APPORTIONMENT OF MEDICAL AND OTHER HEALTH SERVICES,COST ALLOCATION,TRIAL BALANCE OF EXPENSE ACCOUNTS,,COST ALLOCATION,HOSPITAL WAGE INDEX DATA,TRIAL BALANCE OF EXPENSE ACCOUNTS,Total Inpatient Days/Outpatient Visits,HOSPITAL WAGE INDEX DATA,COMPUTATION OF RATIO OF COST TO CHARGES,HOSPITAL WAGE INDEX DATA,HHA STATISTICAL DATA,TRIAL BALANCE OF EXPENSE ACCOUNTS,COMPUTATION OF RATIO OF COST TO CHARGES,APPORTIONMENT OF INPATIENT/OUTPATIENT ANCILLARY SERVICE OTHER PASS THROUGH COSTS,S-10 DATA,APPORTIONMENT OF MEDICAL AND OTHER HEALTH SERVICES,APPORTIONMENT OF INPATIENT/OUTPATIENT ANCILLARY SERVICE OTHER PASS THROUGH COSTS,COMPUTATION OF RATIO OF COST TO CHARGES,,APPORTIONMENT OF INPATIENT/OUTPATIENT ANCILLARY SERVICE OTHER PASS THROUGH COSTS,RECONCILIATION OF CAPITAL COST CENTERS,APPORTIONMENT OF INPATIENT/OUTPATIENT ANCILLARY SERVICE OTHER PASS THROUGH COSTS,ALLOCATION OF NEW CAPITAL COSTS,COMPUTATION OF INPATIENT OPERATING COSTS,TRIAL BALANCE OF EXPENSE ACCOUNTS,S-10 DATA,,COST ALLOCATION,,APPORTIONMENT OF INPATIENT/OUTPATIENT ANCILLARY SERVICE OTHER PASS THROUGH COSTS,Total Inpatient Days/Outpatient Visits,HHA STATISTICAL DATA,TRIAL BALANCE OF EXPENSE ACCOUNTS,INPATIENT ANCILLARY SERVICE COST APPORTIONMENT,COMPUTATION OF RATIO OF COST TO CHARGES,COMPUTATION OF RATIO OF COST TO CHARGES,APPORTIONMENT OF INPATIENT/OUTPATIENT ANCILLARY SERVICE OTHER PASS THROUGH COSTS,APPORTIONMENT OF MEDICAL AND OTHER HEALTH SERVICES,COST ALLOCATION,COMPUTATION OF RATIO OF COST TO CHARGES,APPORTIONMENT OF INPATIENT/OUTPATIENT ANCILLARY SERVICE OTHER PASS THROUGH COSTS,,TRIAL BALANCE OF EXPENSE ACCOUNTS,ALLOCATION OF NEW CAPITAL COSTS,HHA STATISTICAL DATA,HHA STATISTICAL DATA,APPORTIONMENT OF MEDICAL AND OTHER HEALTH SERVICES,TRIAL BALANCE OF EXPENSE ACCOUNTS,COST ALLOCATION,APPORTIONMENT OF INPATIENT/OUTPATIENT ANCILLARY SERVICE OTHER PASS THROUGH COSTS,APPORTIONMENT OF INPATIENT/OUTPATIENT ANCILLARY SERVICE OTHER PASS THROUGH COSTS,INPATIENT ANCILLARY SERVICE COST APPORTIONMENT,COST ALLOCATION,APPORTIONMENT OF INPATIENT/OUTPATIENT ANCILLARY SERVICE OTHER PASS THROUGH COSTS,,TRIAL BALANCE OF EXPENSE ACCOUNTS,COMPUTATION OF RATIO OF COST TO CHARGES,COST ALLOCATION,COMPUTATION OF RATIO OF COST TO CHARGES,APPORTIONMENT OF MEDICAL AND OTHER HEALTH SERVICES,Total Inpatient Days/Outpatient Visits,Total Inpatient Days/Outpatient Visits,Medicare Inpatient Days/Outpatient Visits,INPATIENT ANCILLARY SERVICE COST APPORTIONMENT,Total Inpatient Days/Outpatient Visits,INPATIENT ANCILLARY SERVICE COST APPORTIONMENT,TRIAL BALANCE OF EXPENSE ACCOUNTS,COMPUTATION OF RATIO OF COST TO CHARGES,APPORTIONMENT OF INPATIENT/OUTPATIENT ANCILLARY SERVICE OTHER PASS THROUGH COSTS,BED DAYS AVAILABLE,COMPUTATION OF INPATIENT OPERATING COSTS,COST ALLOCATION,APPORTIONMENT OF INPATIENT/OUTPATIENT ANCILLARY SERVICE OTHER PASS THROUGH COSTS,INPATIENT ANCILLARY SERVICE COST APPORTIONMENT,APPORTIONMENT OF MEDICAL AND OTHER HEALTH SERVICES,COST ALLOCATION,APPORTIONMENT OF INPATIENT/OUTPATIENT ANCILLARY SERVICE OTHER PASS THROUGH COSTS,COMPUTATION OF RATIO OF COST TO CHARGES,COST ALLOCATION,,TRIAL BALANCE OF EXPENSE ACCOUNTS,INPATIENT ANCILLARY SERVICE COST APPORTIONMENT,INPATIENT ANCILLARY SERVICE COST APPORTIONMENT,,INPATIENT ANCILLARY SERVICE COST APPORTIONMENT,NUMBER OF BEDS,APPORTIONMENT OF INPATIENT/OUTPATIENT ANCILLARY SERVICE OTHER PASS THROUGH COSTS,,APPORTIONMENT OF MEDICAL AND OTHER HEALTH SERVICES,COMPUTATION OF INPATIENT OPERATING COSTS,APPORTIONMENT OF MEDICAL AND OTHER HEALTH SERVICES,,Medicaid Inpatient Days/Outpatient Visits,APPORTIONMENT OF MEDICAL AND OTHER HEALTH SERVICES,TRIAL BALANCE OF EXPENSE ACCOUNTS,COST ALLOCATION,HOSPITAL WAGE INDEX DATA,APPORTIONMENT OF MEDICAL AND OTHER HEALTH SERVICES,,COMPUTATION OF INPATIENT OPERATING COSTS,COST ALLOCATION,HOSPITAL WAGE INDEX DATA,ADJUSTMENTS,COST ALLOCATION,INPATIENT ANCILLARY SERVICE COST APPORTIONMENT,COST ALLOCATION,CALCULATION OF REIMBURSEMENT SETTLEMENT,COMPUTATION OF RATIO OF COST TO CHARGES,INPATIENT ANCILLARY SERVICE COST APPORTIONMENT,APPORTIONMENT OF MEDICAL AND OTHER HEALTH SERVICES,APPORTIONMENT OF INPATIENT/OUTPATIENT ANCILLARY SERVICE OTHER PASS THROUGH COSTS,COST ALLOCATION,ANALYSIS OF CHANGES IN NEW CAPITAL BALANCES,INPATIENT ANCILLARY SERVICE COST APPORTIONMENT,APPORTIONMENT OF MEDICAL AND OTHER HEALTH SERVICES,BED DAYS AVAILABLE,COMPUTATION OF RATIO OF COST TO CHARGES,APPORTIONMENT OF INPATIENT/OUTPATIENT ANCILLARY SERVICE OTHER PASS THROUGH COSTS,,ADJUSTMENTS,HHA STATISTICAL DATA,HOSPITAL WAGE INDEX DATA,HOSPITAL WAGE INDEX DATA,APPORTIONMENT OF MEDICAL AND OTHER HEALTH SERVICES,TRIAL BALANCE OF EXPENSE ACCOUNTS,ANALYSIS OF CHANGES IN NEW CAPITAL BALANCES,COMPUTATION OF RATIO OF COST TO CHARGES,,APPORTIONMENT OF MEDICAL AND OTHER HEALTH SERVICES,COST ALLOCATION,BED DAYS AVAILABLE,HHA STATISTICAL DATA,APPORTIONMENT OF MEDICAL AND OTHER HEALTH SERVICES,COST ALLOCATION,COST ALLOCATION,APPORTIONMENT OF INPATIENT/OUTPATIENT ANCILLARY SERVICE OTHER PASS THROUGH COSTS,Total Inpatient Days/Outpatient Visits,HOSPITAL WAGE INDEX DATA,TRIAL BALANCE OF EXPENSE ACCOUNTS,INPATIENT ANCILLARY SERVICE COST APPORTIONMENT,ANALYSIS OF CHANGES IN NEW CAPITAL BALANCES,APPORTIONMENT OF INPATIENT/OUTPATIENT ANCILLARY SERVICE OTHER PASS THROUGH COSTS,TRIAL BALANCE OF EXPENSE ACCOUNTS,TRIAL BALANCE OF EXPENSE ACCOUNTS,COMPUTATION OF RATIO OF COST TO CHARGES,APPORTIONMENT OF INPATIENT/OUTPATIENT ANCILLARY SERVICE OTHER PASS THROUGH COSTS,APPORTIONMENT OF INPATIENT/OUTPATIENT ANCILLARY SERVICE OTHER PASS THROUGH COSTS,APPORTIONMENT OF INPATIENT ROUTINE SERVICE CAPITAL COSTS,INPATIENT ANCILLARY SERVICE COST APPORTIONMENT,,COMPUTATION OF RATIO OF COST TO CHARGES,APPORTIONMENT OF MEDICAL AND OTHER HEALTH SERVICES,INPATIENT ANCILLARY SERVICE COST APPORTIONMENT,APPORTIONMENT OF INPATIENT/OUTPATIENT ANCILLARY SERVICE OTHER PASS THROUGH COSTS,COMPUTATION OF RATIO OF COST TO CHARGES,APPORTIONMENT OF INPATIENT/OUTPATIENT ANCILLARY SERVICE OTHER PASS THROUGH COSTS,COMPUTATION OF INPATIENT OPERATING COSTS,Medicaid Inpatient Days/Outpatient Visits,,HOSPITAL WAGE INDEX DATA,INPATIENT ANCILLARY SERVICE COST APPORTIONMENT,HOSPITAL IDENTIFICATION INFORMATION,ALLOCATION OF NEW CAPITAL COSTS,TRIAL BALANCE OF EXPENSE ACCOUNTS,INPATIENT ANCILLARY SERVICE COST APPORTIONMENT,CALCULATION OF REIMBURSEMENT SETTLEMENT,TRIAL BALANCE OF EXPENSE ACCOUNTS,COMPUTATION OF RATIO OF COST TO CHARGES,INPATIENT ANCILLARY SERVICE COST APPORTIONMENT,COMPUTATION OF RATIO OF COST TO CHARGES,APPORTIONMENT OF INPATIENT/OUTPATIENT ANCILLARY SERVICE OTHER PASS THROUGH COSTS,S-10 DATA,TRIAL BALANCE OF EXPENSE ACCOUNTS,HOSPITAL WAGE INDEX DATA,ADJUSTMENTS,APPORTIONMENT OF INPATIENT/OUTPATIENT ANCILLARY SERVICE OTHER PASS THROUGH COSTS,APPORTIONMENT OF INPATIENT/OUTPATIENT ANCILLARY SERVICE OTHER PASS THROUGH COSTS,APPORTIONMENT OF INPATIENT/OUTPATIENT ANCILLARY SERVICE OTHER PASS THROUGH COSTS,Total Inpatient Days/Outpatient Visits,INPATIENT ANCILLARY SERVICE COST APPORTIONMENT,TRIAL BALANCE OF EXPENSE ACCOUNTS,APPORTIONMENT OF MEDICAL AND OTHER HEALTH SERVICES,HOSPITAL WAGE INDEX DATA,APPORTIONMENT OF INPATIENT/OUTPATIENT ANCILLARY SERVICE OTHER PASS THROUGH COSTS,HOSPITAL WAGE INDEX DATA,HHA STATISTICAL DATA,Medicare Inpatient Days/Outpatient Visits,TRIAL BALANCE OF EXPENSE ACCOUNTS,APPORTIONMENT OF INPATIENT/OUTPATIENT ANCILLARY SERVICE OTHER PASS THROUGH COSTS,APPORTIONMENT OF MEDICAL AND OTHER HEALTH SERVICES,,APPORTIONMENT OF MEDICAL AND OTHER HEALTH SERVICES,TRIAL BALANCE OF EXPENSE ACCOUNTS,,TRIAL BALANCE OF EXPENSE ACCOUNTS,COST ALLOCATION,ALLOCATION OF NEW CAPITAL COSTS,COST ALLOCATION,APPORTIONMENT OF MEDICAL AND OTHER HEALTH SERVICES,COMPUTATION OF RATIO OF COST TO CHARGES,HOSPITAL WAGE INDEX DATA,,ANALYSIS OF CHANGES IN NEW CAPITAL BALANCES,APPORTIONMENT OF INPATIENT/OUTPATIENT ANCILLARY SERVICE OTHER PASS THROUGH COSTS,TRIAL BALANCE OF EXPENSE ACCOUNTS,TRIAL BALANCE OF EXPENSE ACCOUNTS,CALCULATION OF REIMBURSEMENT SETTLEMENT,HOSPITAL WAGE INDEX DATA,COST ALLOCATION,APPORTIONMENT OF INPATIENT/OUTPATIENT ANCILLARY SERVICE OTHER PASS THROUGH COSTS,HHA STATISTICAL DATA,TRIAL BALANCE OF EXPENSE ACCOUNTS,HOSPITAL WAGE INDEX DATA,APPORTIONMENT OF MEDICAL AND OTHER HEALTH SERVICES,HOSPITAL WAGE INDEX DATA,COST ALLOCATION,INPATIENT ANCILLARY SERVICE COST APPORTIONMENT,APPORTIONMENT OF INPATIENT/OUTPATIENT ANCILLARY SERVICE OTHER PASS THROUGH COSTS,HOSPITAL WAGE INDEX DATA,HOSPITAL WAGE INDEX DATA,APPORTIONMENT OF INPATIENT/OUTPATIENT ANCILLARY SERVICE OTHER PASS THROUGH COSTS,TRIAL BALANCE OF EXPENSE ACCOUNTS,APPORTIONMENT OF INPATIENT/OUTPATIENT ANCILLARY SERVICE OTHER PASS THROUGH COSTS,Total Inpatient Days/Outpatient Visits,INPATIENT ANCILLARY SERVICE COST APPORTIONMENT,APPORTIONMENT OF INPATIENT/OUTPATIENT ANCILLARY SERVICE OTHER PASS THROUGH COSTS,HOSPITAL WAGE INDEX DATA,COST ALLOCATION,COST ALLOCATION,,APPORTIONMENT OF MEDICAL AND OTHER HEALTH SERVICES,INPATIENT ANCILLARY SERVICE COST APPORTIONMENT,COST ALLOCATION,COST ALLOCATION,COMPUTATION OF RATIO OF COST TO CHARGES,APPORTIONMENT OF INPATIENT/OUTPATIENT ANCILLARY SERVICE OTHER PASS THROUGH COSTS,COMPUTATION OF RATIO OF COST TO CHARGES,APPORTIONMENT OF MEDICAL AND OTHER HEALTH SERVICES,COMPUTATION OF RATIO OF COST TO CHARGES,CALCULATION OF REIMBURSEMENT SETTLEMENT,INPATIENT ANCILLARY SERVICE COST APPORTIONMENT,HOSPITAL WAGE INDEX DATA,TRIAL BALANCE OF EXPENSE ACCOUNTS,APPORTIONMENT OF MEDICAL AND OTHER HEALTH SERVICES,CALCULATION OF REIMBURSEMENT SETTLEMENT (PPS),APPORTIONMENT OF INPATIENT/OUTPATIENT ANCILLARY SERVICE OTHER PASS THROUGH COSTS,APPORTIONMENT OF INPATIENT/OUTPATIENT ANCILLARY SERVICE OTHER PASS THROUGH COSTS,HOSPITAL WAGE INDEX DATA,INPATIENT ANCILLARY SERVICE COST APPORTIONMENT,HOSPITAL WAGE INDEX DATA,APPORTIONMENT OF MEDICAL AND OTHER HEALTH SERVICES,INPATIENT ANCILLARY SERVICE COST APPORTIONMENT,APPORTIONMENT OF MEDICAL AND OTHER HEALTH SERVICES,,HHA STATISTICAL DATA,APPORTIONMENT OF INPATIENT/OUTPATIENT ANCILLARY SERVICE OTHER PASS THROUGH COSTS,Total Inpatient Days/Outpatient Visits,Total Inpatient Days/Outpatient Visits,COST ALLOCATION,APPORTIONMENT OF INPATIENT/OUTPATIENT ANCILLARY SERVICE OTHER PASS THROUGH COSTS,RECONCILIATION OF CAPITAL COST CENTERS,ANALYSIS OF CHANGES IN NEW CAPITAL BALANCES,APPORTIONMENT OF INPATIENT/OUTPATIENT ANCILLARY SERVICE OTHER PASS THROUGH COSTS,S-10 DATA,APPORTIONMENT OF MEDICAL AND OTHER HEALTH SERVICES,HOSPITAL WAGE INDEX DATA,APPORTIONMENT OF INPATIENT/OUTPATIENT ANCILLARY SERVICE OTHER PASS THROUGH COSTS,HOSPITAL WAGE INDEX DATA,COMPUTATION OF RATIO OF COST TO CHARGES,CALCULATION OF REIMBURSEMENT SETTLEMENT,ALLOCATION OF NEW CAPITAL COSTS,APPORTIONMENT OF MEDICAL AND OTHER HEALTH SERVICES,HHA STATISTICAL DATA,COST ALLOCATION,APPORTIONMENT OF INPATIENT/OUTPATIENT ANCILLARY SERVICE OTHER PASS THROUGH COSTS,Total Inpatient Days/Outpatient Visits,APPORTIONMENT OF MEDICAL AND OTHER HEALTH SERVICES,COST ALLOCATION,,APPORTIONMENT OF INPATIENT/OUTPATIENT ANCILLARY SERVICE OTHER PASS THROUGH COSTS,INPATIENT ANCILLARY SERVICE COST APPORTIONMENT,COMPUTATION OF RATIO OF COST TO CHARGES,RENAL STATISTICAL DATA,TRIAL BALANCE OF EXPENSE ACCOUNTS,APPORTIONMENT OF INPATIENT/OUTPATIENT ANCILLARY SERVICE OTHER PASS THROUGH COSTS,HOSPITAL WAGE INDEX DATA,COST ALLOCATION,INPATIENT ANCILLARY SERVICE COST APPORTIONMENT,HOSPITAL WAGE INDEX DATA,S-10 DATA,APPORTIONMENT OF MEDICAL AND OTHER HEALTH SERVICES,INPATIENT ANCILLARY SERVICE COST APPORTIONMENT,TRIAL BALANCE OF EXPENSE ACCOUNTS,APPORTIONMENT OF INPATIENT/OUTPATIENT ANCILLARY SERVICE OTHER PASS THROUGH COSTS,APPORTIONMENT OF MEDICAL AND OTHER HEALTH SERVICES,INPATIENT ANCILLARY SERVICE COST APPORTIONMENT,COMPUTATION OF RATIO OF COST TO CHARGES,HOSPITAL WAGE INDEX DATA,CALCULATION OF REIMBURSEMENT SETTLEMENT,APPORTIONMENT OF INPATIENT/OUTPATIENT ANCILLARY SERVICE OTHER PASS THROUGH COSTS,APPORTIONMENT OF INPATIENT/OUTPATIENT ANCILLARY SERVICE OTHER PASS THROUGH COSTS,APPORTIONMENT OF INPATIENT/OUTPATIENT ANCILLARY SERVICE OTHER PASS THROUGH COSTS,Total Inpatient Days/Outpatient Visits,COMPUTATION OF RATIO OF COST TO CHARGES,TRIAL BALANCE OF EXPENSE ACCOUNTS,APPORTIONMENT OF INPATIENT/OUTPATIENT ANCILLARY SERVICE OTHER PASS THROUGH COSTS,CALCULATION OF REIMBURSEMENT SETTLEMENT,INPATIENT ANCILLARY SERVICE COST APPORTIONMENT,NUMBER OF BEDS,ALLOCATION OF NEW CAPITAL COSTS,HOSPITAL WAGE INDEX DATA,ALLOCATION OF NEW CAPITAL COSTS,INPATIENT ANCILLARY SERVICE COST APPORTIONMENT,INPATIENT ANCILLARY SERVICE COST APPORTIONMENT,INPATIENT ANCILLARY SERVICE COST APPORTIONMENT,Total Inpatient Days/Outpatient Visits,HOSPITAL WAGE INDEX DATA,TRIAL BALANCE OF EXPENSE ACCOUNTS,APPORTIONMENT OF MEDICAL AND OTHER HEALTH SERVICES,,,COST ALLOCATION,RENAL STATISTICAL DATA,,TRIAL BALANCE OF EXPENSE ACCOUNTS,HHA STATISTICAL DATA,COMPUTATION OF RATIO OF COST TO CHARGES,APPORTIONMENT OF INPATIENT/OUTPATIENT ANCILLARY SERVICE OTHER PASS THROUGH COSTS,HOSPITAL IDENTIFICATION INFORMATION,COST ALLOCATION,COMPUTATION OF RATIO OF COST TO CHARGES,ANALYSIS OF CHANGES IN NEW CAPITAL BALANCES,INPATIENT ANCILLARY SERVICE COST APPORTIONMENT,RENAL STATISTICAL DATA,COST ALLOCATION,INPATIENT ANCILLARY SERVICE COST APPORTIONMENT,BED DAYS AVAILABLE,APPORTIONMENT OF INPATIENT/OUTPATIENT ANCILLARY SERVICE OTHER PASS THROUGH COSTS,APPORTIONMENT OF INPATIENT/OUTPATIENT ANCILLARY SERVICE OTHER PASS THROUGH COSTS,TRIAL BALANCE OF EXPENSE ACCOUNTS,COMPUTATION OF RATIO OF COST TO CHARGES,TRIAL BALANCE OF EXPENSE ACCOUNTS,INPATIENT ANCILLARY SERVICE COST APPORTIONMENT,TRIAL BALANCE OF EXPENSE ACCOUNTS,RENAL STATISTICAL DATA,INPATIENT ANCILLARY SERVICE COST APPORTIONMENT,APPORTIONMENT OF INPATIENT/OUTPATIENT ANCILLARY SERVICE OTHER PASS THROUGH COSTS,CALCULATION OF REIMBURSEMENT SETTLEMENT,INPATIENT ANCILLARY SERVICE COST APPORTIONMENT,COST ALLOCATION,INPATIENT ANCILLARY SERVICE COST APPORTIONMENT,HOSPITAL WAGE INDEX DATA,HOSPITAL WAGE INDEX DATA,TRIAL BALANCE OF EXPENSE ACCOUNTS,HOSPITAL WAGE INDEX DATA,COMPUTATION OF RATIO OF COST TO CHARGES,APPORTIONMENT OF INPATIENT/OUTPATIENT ANCILLARY SERVICE OTHER PASS THROUGH COSTS,COST ALLOCATION,APPORTIONMENT OF INPATIENT/OUTPATIENT ANCILLARY SERVICE OTHER PASS THROUGH COSTS,APPORTIONMENT OF INPATIENT/OUTPATIENT ANCILLARY SERVICE OTHER PASS THROUGH COSTS,APPORTIONMENT OF MEDICAL AND OTHER HEALTH SERVICES,HOSPITAL WAGE INDEX DATA,INPATIENT ANCILLARY SERVICE COST APPORTIONMENT,TRIAL BALANCE OF EXPENSE ACCOUNTS,APPORTIONMENT OF INPATIENT/OUTPATIENT ANCILLARY SERVICE OTHER PASS THROUGH COSTS,COMPUTATION OF RATIO OF COST TO CHARGES,TRIAL BALANCE OF EXPENSE ACCOUNTS,APPORTIONMENT OF INPATIENT ROUTINE SERVICE CAPITAL COSTS,ADJUSTMENTS,HHA STATISTICAL DATA,APPORTIONMENT OF INPATIENT/OUTPATIENT ANCILLARY SERVICE OTHER PASS THROUGH COSTS,INPATIENT ANCILLARY SERVICE COST APPORTIONMENT,TRIAL BALANCE OF EXPENSE ACCOUNTS,INPATIENT ANCILLARY SERVICE COST APPORTIONMENT,INPATIENT ANCILLARY SERVICE COST APPORTIONMENT,COMPUTATION OF RATIO OF COST TO CHARGES,NUMBER OF BEDS,APPORTIONMENT OF MEDICAL AND OTHER HEALTH SERVICES,COMPUTATION OF RATIO OF COST TO CHARGES,COMPUTATION OF RATIO OF COST TO CHARGES,APPORTIONMENT OF INPATIENT/OUTPATIENT ANCILLARY SERVICE OTHER PASS THROUGH COSTS,COMPUTATION OF RATIO OF COST TO CHARGES,COMPUTATION OF INPATIENT OPERATING COSTS,INPATIENT ANCILLARY SERVICE COST APPORTIONMENT,TRIAL BALANCE OF EXPENSE ACCOUNTS,COMPUTATION OF RATIO OF COST TO CHARGES,INPATIENT ANCILLARY SERVICE COST APPORTIONMENT,COMPUTATION OF RATIO OF COST TO CHARGES,HHA STATISTICAL DATA,APPORTIONMENT OF INPATIENT/OUTPATIENT ANCILLARY SERVICE OTHER PASS THROUGH COSTS,APPORTIONMENT OF INPATIENT/OUTPATIENT ANCILLARY SERVICE OTHER PASS THROUGH COSTS,COST ALLOCATION,ALLOCATION OF NEW CAPITAL COSTS,APPORTIONMENT OF MEDICAL AND OTHER HEALTH SERVICES,COST ALLOCATION,APPORTIONMENT OF INPATIENT/OUTPATIENT ANCILLARY SERVICE OTHER PASS THROUGH COSTS,TRIAL BALANCE OF EXPENSE ACCOUNTS,HOSPITAL WAGE INDEX DATA,APPORTIONMENT OF MEDICAL AND OTHER HEALTH SERVICES,RENAL STATISTICAL DATA,TRIAL BALANCE OF EXPENSE ACCOUNTS,TRIAL BALANCE OF EXPENSE ACCOUNTS,HHA STATISTICAL DATA,TRIAL BALANCE OF EXPENSE ACCOUNTS,CALCULATION OF REIMBURSEMENT SETTLEMENT,INPATIENT ANCILLARY SERVICE COST APPORTIONMENT,TRIAL BALANCE OF EXPENSE ACCOUNTS,APPORTIONMENT OF INPATIENT/OUTPATIENT ANCILLARY SERVICE OTHER PASS THROUGH COSTS,APPORTIONMENT OF MEDICAL AND OTHER HEALTH SERVICES,ALLOCATION OF NEW CAPITAL COSTS,COST ALLOCATION,INPATIENT ANCILLARY SERVICE COST APPORTIONMENT,COST ALLOCATION,APPORTIONMENT OF INPATIENT/OUTPATIENT ANCILLARY SERVICE OTHER PASS THROUGH COSTS,Medicaid Inpatient Days/Outpatient Visits,Total Inpatient Days/Outpatient Visits,APPORTIONMENT OF MEDICAL AND OTHER HEALTH SERVICES,RECONCILIATION OF CAPITAL COST CENTERS,COST ALLOCATION,COMPUTATION OF RATIO OF COST TO CHARGES,APPORTIONMENT OF INPATIENT/OUTPATIENT ANCILLARY SERVICE OTHER PASS THROUGH COSTS,INPATIENT ANCILLARY SERVICE COST APPORTIONMENT,COMPUTATION OF RATIO OF COST TO CHARGES,APPORTIONMENT OF MEDICAL AND OTHER HEALTH SERVICES,INPATIENT ANCILLARY SERVICE COST APPORTIONMENT,HOSPITAL IDENTIFICATION INFORMATION,COMPUTATION OF RATIO OF COST TO CHARGES,COST ALLOCATION,TRIAL BALANCE OF EXPENSE ACCOUNTS,INPATIENT ANCILLARY SERVICE COST APPORTIONMENT,TRIAL BALANCE OF EXPENSE ACCOUNTS,ALLOCATION OF NEW CAPITAL COSTS,HOSPITAL WAGE INDEX DATA,COMPUTATION OF RATIO OF COST TO CHARGES,RECONCILIATION OF CAPITAL COST CENTERS,COST ALLOCATION,,INPATIENT ANCILLARY SERVICE COST APPORTIONMENT,HHA STATISTICAL DATA,HOSPITAL WAGE INDEX DATA,Total Inpatient Days/Outpatient Visits,COST ALLOCATION,INPATIENT ANCILLARY SERVICE COST APPORTIONMENT,COMPUTATION OF INPATIENT OPERATING COSTS,COST ALLOCATION,APPORTIONMENT OF INPATIENT/OUTPATIENT ANCILLARY SERVICE OTHER PASS THROUGH COSTS,HOSPITAL WAGE INDEX DATA,HHA STATISTICAL DATA,APPORTIONMENT OF INPATIENT/OUTPATIENT ANCILLARY SERVICE OTHER PASS THROUGH COSTS,COMPUTATION OF RATIO OF COST TO CHARGES,TRIAL BALANCE OF EXPENSE ACCOUNTS,APPORTIONMENT OF INPATIENT/OUTPATIENT ANCILLARY SERVICE OTHER PASS THROUGH COSTS,INPATIENT ANCILLARY SERVICE COST APPORTIONMENT,INPATIENT ANCILLARY SERVICE COST APPORTIONMENT,HOSPITAL WAGE INDEX DATA,Medicare Inpatient Days/Outpatient Visits,APPORTIONMENT OF INPATIENT/OUTPATIENT ANCILLARY SERVICE OTHER PASS THROUGH COSTS,INPATIENT ANCILLARY SERVICE COST APPORTIONMENT,TRIAL BALANCE OF EXPENSE ACCOUNTS,APPORTIONMENT OF INPATIENT/OUTPATIENT ANCILLARY SERVICE OTHER PASS THROUGH COSTS,TRIAL BALANCE OF EXPENSE ACCOUNTS,APPORTIONMENT OF INPATIENT ROUTINE SERVICE CAPITAL COSTS,TRIAL BALANCE OF EXPENSE ACCOUNTS,,COST ALLOCATION,TRIAL BALANCE OF EXPENSE ACCOUNTS,INPATIENT ANCILLARY SERVICE COST APPORTIONMENT,INPATIENT ANCILLARY SERVICE COST APPORTIONMENT,COMPUTATION OF RATIO OF COST TO CHARGES,COMPUTATION OF RATIO OF COST TO CHARGES,TRIAL BALANCE OF EXPENSE ACCOUNTS,HOSPITAL IDENTIFICATION INFORMATION,HOSPITAL WAGE INDEX DATA,APPORTIONMENT OF MEDICAL AND OTHER HEALTH SERVICES,INPATIENT ANCILLARY SERVICE COST APPORTIONMENT,,S-10 DATA,APPORTIONMENT OF INPATIENT/OUTPATIENT ANCILLARY SERVICE OTHER PASS THROUGH COSTS,HOSPITAL WAGE INDEX DATA,Medicaid Inpatient Days/Outpatient Visits,COST ALLOCATION,INPATIENT ANCILLARY SERVICE COST APPORTIONMENT,INPATIENT ANCILLARY SERVICE COST APPORTIONMENT,COST ALLOCATION,COMPUTATION OF RATIO OF COST TO CHARGES,CALCULATION OF REIMBURSEMENT SETTLEMENT,APPORTIONMENT OF INPATIENT/OUTPATIENT ANCILLARY SERVICE OTHER PASS THROUGH COSTS,CALCULATION OF REIMBURSEMENT SETTLEMENT,COST ALLOCATION,APPORTIONMENT OF INPATIENT/OUTPATIENT ANCILLARY SERVICE OTHER PASS THROUGH COSTS,APPORTIONMENT OF INPATIENT/OUTPATIENT ANCILLARY SERVICE OTHER PASS THROUGH COSTS,ALLOCATION OF NEW CAPITAL COSTS,APPORTIONMENT OF INPATIENT/OUTPATIENT ANCILLARY SERVICE OTHER PASS THROUGH COSTS,APPORTIONMENT OF INPATIENT/OUTPATIENT ANCILLARY SERVICE OTHER PASS THROUGH COSTS,INPATIENT ANCILLARY SERVICE COST APPORTIONMENT,APPORTIONMENT OF INPATIENT/OUTPATIENT ANCILLARY SERVICE OTHER PASS THROUGH COSTS,HOSPITAL WAGE INDEX DATA,INPATIENT ANCILLARY SERVICE COST APPORTIONMENT,APPORTIONMENT OF INPATIENT/OUTPATIENT ANCILLARY SERVICE OTHER PASS THROUGH COSTS,INPATIENT ANCILLARY SERVICE COST APPORTIONMENT,HOSPITAL WAGE INDEX DATA,TRIAL BALANCE OF EXPENSE ACCOUNTS,TRIAL BALANCE OF EXPENSE ACCOUNTS,ALLOCATION OF NEW CAPITAL COSTS,APPORTIONMENT OF INPATIENT/OUTPATIENT ANCILLARY SERVICE OTHER PASS THROUGH COSTS,TRIAL BALANCE OF EXPENSE ACCOUNTS,COMPUTATION OF RATIO OF COST TO CHARGES,,TRIAL BALANCE OF EXPENSE ACCOUNTS,ANALYSIS OF CHANGES IN NEW CAPITAL BALANCES,COST ALLOCATION,INPATIENT ANCILLARY SERVICE COST APPORTIONMENT,COMPUTATION OF RATIO OF COST TO CHARGES,TRIAL BALANCE OF EXPENSE ACCOUNTS,APPORTIONMENT OF INPATIENT/OUTPATIENT ANCILLARY SERVICE OTHER PASS THROUGH COSTS,APPORTIONMENT OF MEDICAL AND OTHER HEALTH SERVICES,CALCULATION OF REIMBURSEMENT SETTLEMENT,COMPUTATION OF RATIO OF COST TO CHARGES,HOSPITAL WAGE INDEX DATA,HHA STATISTICAL DATA,APPORTIONMENT OF INPATIENT/OUTPATIENT ANCILLARY SERVICE OTHER PASS THROUGH COSTS,ANALYSIS OF CHANGES IN NEW CAPITAL BALANCES,INPATIENT ANCILLARY SERVICE COST APPORTIONMENT,ANALYSIS OF CHANGES IN NEW CAPITAL BALANCES,Total Inpatient Days/Outpatient Visits,COST ALLOCATION,ALLOCATION OF NEW CAPITAL COSTS,APPORTIONMENT OF MEDICAL AND OTHER HEALTH SERVICES,ALLOCATION OF NEW CAPITAL COSTS,APPORTIONMENT OF MEDICAL AND OTHER HEALTH SERVICES,,APPORTIONMENT OF MEDICAL AND OTHER HEALTH SERVICES,BED DAYS AVAILABLE,Total Inpatient Days/Outpatient Visits,HOSPITAL WAGE INDEX DATA,HOSPITAL WAGE INDEX DATA,HOSPITAL WAGE INDEX DATA,Total Inpatient Days/Outpatient Visits,CALCULATION OF REIMBURSEMENT SETTLEMENT,Medicare Inpatient Days/Outpatient Visits,TRIAL BALANCE OF EXPENSE ACCOUNTS,,APPORTIONMENT OF INPATIENT/OUTPATIENT ANCILLARY SERVICE OTHER PASS THROUGH COSTS,APPORTIONMENT OF MEDICAL AND OTHER HEALTH SERVICES,,COMPUTATION OF INPATIENT OPERATING COSTS,INPATIENT ANCILLARY SERVICE COST APPORTIONMENT,,,COMPUTATION OF RATIO OF COST TO CHARGES,COST ALLOCATION,,,APPORTIONMENT OF INPATIENT/OUTPATIENT ANCILLARY SERVICE OTHER PASS THROUGH COSTS,CALCULATION OF REIMBURSEMENT SETTLEMENT,APPORTIONMENT OF INPATIENT/OUTPATIENT ANCILLARY SERVICE OTHER PASS THROUGH COSTS,APPORTIONMENT OF MEDICAL AND OTHER HEALTH SERVICES,TRIAL BALANCE OF EXPENSE ACCOUNTS,COMPUTATION OF RATIO OF COST TO CHARGES,COMPUTATION OF INPATIENT OPERATING COSTS,INPATIENT ANCILLARY SERVICE COST APPORTIONMENT,COMPUTATION OF RATIO OF COST TO CHARGES,COMPUTATION OF RATIO OF COST TO CHARGES,APPORTIONMENT OF INPATIENT/OUTPATIENT ANCILLARY SERVICE OTHER PASS THROUGH COSTS,RECONCILIATION OF CAPITAL COST CENTERS,APPORTIONMENT OF INPATIENT/OUTPATIENT ANCILLARY SERVICE OTHER PASS THROUGH COSTS,COST ALLOCATION,,COMPUTATION OF INPATIENT OPERATING COSTS,COST ALLOCATION,INPATIENT ANCILLARY SERVICE COST APPORTIONMENT,TRIAL BALANCE OF EXPENSE ACCOUNTS,TRIAL BALANCE OF EXPENSE ACCOUNTS,APPORTIONMENT OF INPATIENT/OUTPATIENT ANCILLARY SERVICE OTHER PASS THROUGH COSTS,APPORTIONMENT OF MEDICAL AND OTHER HEALTH SERVICES,INPATIENT ANCILLARY SERVICE COST APPORTIONMENT,COST ALLOCATION,HHA STATISTICAL DATA,,APPORTIONMENT OF MEDICAL AND OTHER HEALTH SERVICES,COST ALLOCATION,APPORTIONMENT OF MEDICAL AND OTHER HEALTH SERVICES,INPATIENT ANCILLARY SERVICE COST APPORTIONMENT,APPORTIONMENT OF INPATIENT/OUTPATIENT ANCILLARY SERVICE OTHER PASS THROUGH COSTS,COST ALLOCATION,ANALYSIS OF CHANGES IN NEW CAPITAL BALANCES,COST ALLOCATION,COMPUTATION OF RATIO OF COST TO CHARGES,COST ALLOCATION,APPORTIONMENT OF INPATIENT/OUTPATIENT ANCILLARY SERVICE OTHER PASS THROUGH COSTS,ALLOCATION OF NEW CAPITAL COSTS,HOSPITAL WAGE INDEX DATA,INPATIENT ANCILLARY SERVICE COST APPORTIONMENT,ADJUSTMENTS,Total Inpatient Days/Outpatient Visits,Total Inpatient Days/Outpatient Visits,BED DAYS AVAILABLE,RECONCILIATION OF CAPITAL COST CENTERS,APPORTIONMENT OF INPATIENT/OUTPATIENT ANCILLARY SERVICE OTHER PASS THROUGH COSTS,APPORTIONMENT OF INPATIENT/OUTPATIENT ANCILLARY SERVICE OTHER PASS THROUGH COSTS,,ADJUSTMENTS,COST ALLOCATION,APPORTIONMENT OF INPATIENT/OUTPATIENT ANCILLARY SERVICE OTHER PASS THROUGH COSTS,TRIAL BALANCE OF EXPENSE ACCOUNTS,RECONCILIATION OF CAPITAL COST CENTERS,HOSPITAL WAGE INDEX DATA,COST ALLOCATION,HOSPITAL WAGE INDEX DATA,HOSPITAL WAGE INDEX DATA,ALLOCATION OF NEW CAPITAL COSTS,INPATIENT ANCILLARY SERVICE COST APPORTIONMENT,Medicare Inpatient Days/Outpatient Visits,APPORTIONMENT OF INPATIENT/OUTPATIENT ANCILLARY SERVICE OTHER PASS THROUGH COSTS,TRIAL BALANCE OF EXPENSE ACCOUNTS,COST ALLOCATION,APPORTIONMENT OF INPATIENT/OUTPATIENT ANCILLARY SERVICE OTHER PASS THROUGH COSTS,APPORTIONMENT OF INPATIENT/OUTPATIENT ANCILLARY SERVICE OTHER PASS THROUGH COSTS,INPATIENT ANCILLARY SERVICE COST APPORTIONMENT,APPORTIONMENT OF INPATIENT/OUTPATIENT ANCILLARY SERVICE OTHER PASS THROUGH COSTS,COMPUTATION OF RATIO OF COST TO CHARGES,TRIAL BALANCE OF EXPENSE ACCOUNTS,RENAL STATISTICAL DATA,HOSPITAL WAGE INDEX DATA,APPORTIONMENT OF MEDICAL AND OTHER HEALTH SERVICES,TRIAL BALANCE OF EXPENSE ACCOUNTS,APPORTIONMENT OF INPATIENT/OUTPATIENT ANCILLARY SERVICE OTHER PASS THROUGH COSTS,CALCULATION OF REIMBURSEMENT SETTLEMENT,APPORTIONMENT OF INPATIENT ROUTINE SERVICE CAPITAL COSTS,ALLOCATION OF NEW CAPITAL COSTS,HOSPITAL WAGE INDEX DATA,COST ALLOCATION,COST ALLOCATION,APPORTIONMENT OF INPATIENT/OUTPATIENT ANCILLARY SERVICE OTHER PASS THROUGH COSTS,APPORTIONMENT OF INPATIENT/OUTPATIENT ANCILLARY SERVICE OTHER PASS THROUGH COSTS,APPORTIONMENT OF INPATIENT/OUTPATIENT ANCILLARY SERVICE OTHER PASS THROUGH COSTS,TRIAL BALANCE OF EXPENSE ACCOUNTS,APPORTIONMENT OF MEDICAL AND OTHER HEALTH SERVICES,APPORTIONMENT OF MEDICAL AND OTHER HEALTH SERVICES,APPORTIONMENT OF INPATIENT/OUTPATIENT ANCILLARY SERVICE OTHER PASS THROUGH COSTS,CALCULATION OF REIMBURSEMENT SETTLEMENT,APPORTIONMENT OF INPATIENT/OUTPATIENT ANCILLARY SERVICE OTHER PASS THROUGH COSTS,COMPUTATION OF RATIO OF COST TO CHARGES,HOSPITAL WAGE INDEX DATA,APPORTIONMENT OF INPATIENT/OUTPATIENT ANCILLARY SERVICE OTHER PASS THROUGH COSTS,TRIAL BALANCE OF EXPENSE ACCOUNTS,RENAL STATISTICAL DATA,APPORTIONMENT OF INPATIENT/OUTPATIENT ANCILLARY SERVICE OTHER PASS THROUGH COSTS,COMPUTATION OF INPATIENT OPERATING COSTS,CALCULATION OF REIMBURSEMENT SETTLEMENT,TRIAL BALANCE OF EXPENSE ACCOUNTS,APPORTIONMENT OF INPATIENT/OUTPATIENT ANCILLARY SERVICE OTHER PASS THROUGH COSTS,COMPUTATION OF INPATIENT OPERATING COSTS,HOSPITAL WAGE INDEX DATA,APPORTIONMENT OF INPATIENT ROUTINE SERVICE OTHER PASS THROUGH COSTS,INPATIENT ANCILLARY SERVICE COST APPORTIONMENT,HHA STATISTICAL DATA,INPATIENT ANCILLARY SERVICE COST APPORTIONMENT,HOSPITAL WAGE INDEX DATA,NUMBER OF BEDS,Medicare Inpatient Days/Outpatient Visits,COST ALLOCATION,RECONCILIATION OF CAPITAL COST CENTERS,COMPUTATION OF INPATIENT OPERATING COSTS,INPATIENT ANCILLARY SERVICE COST APPORTIONMENT,TRIAL BALANCE OF EXPENSE ACCOUNTS,COMPUTATION OF RATIO OF COST TO CHARGES,COST ALLOCATION,RENAL STATISTICAL DATA,APPORTIONMENT OF INPATIENT/OUTPATIENT ANCILLARY SERVICE OTHER PASS THROUGH COSTS,COST ALLOCATION,APPORTIONMENT OF INPATIENT/OUTPATIENT ANCILLARY SERVICE OTHER PASS THROUGH COSTS,APPORTIONMENT OF INPATIENT/OUTPATIENT ANCILLARY SERVICE OTHER PASS THROUGH COSTS,COMPUTATION OF RATIO OF COST TO CHARGES,COST ALLOCATION,TRIAL BALANCE OF EXPENSE ACCOUNTS,,APPORTIONMENT OF INPATIENT/OUTPATIENT ANCILLARY SERVICE OTHER PASS THROUGH COSTS,RENAL STATISTICAL DATA,COMPUTATION OF INPATIENT OPERATING COSTS,INPATIENT ANCILLARY SERVICE COST APPORTIONMENT,HOSPITAL WAGE INDEX DATA,COMPUTATION OF RATIO OF COST TO CHARGES,COST ALLOCATION,HOSPITAL WAGE INDEX DATA,TRIAL BALANCE OF EXPENSE ACCOUNTS,RENAL STATISTICAL DATA,APPORTIONMENT OF MEDICAL AND OTHER HEALTH SERVICES,COMPUTATION OF RATIO OF COST TO CHARGES,COST ALLOCATION,TRIAL BALANCE OF EXPENSE ACCOUNTS,APPORTIONMENT OF INPATIENT/OUTPATIENT ANCILLARY SERVICE OTHER PASS THROUGH COSTS,COST ALLOCATION,INPATIENT ANCILLARY SERVICE COST APPORTIONMENT,APPORTIONMENT OF INPATIENT/OUTPATIENT ANCILLARY SERVICE OTHER PASS THROUGH COSTS,APPORTIONMENT OF MEDICAL AND OTHER HEALTH SERVICES,INPATIENT ANCILLARY SERVICE COST APPORTIONMENT,APPORTIONMENT OF MEDICAL AND OTHER HEALTH SERVICES,APPORTIONMENT OF INPATIENT/OUTPATIENT ANCILLARY SERVICE OTHER PASS THROUGH COSTS,COST ALLOCATION,TRIAL BALANCE OF EXPENSE ACCOUNTS,COMPUTATION OF RATIO OF COST TO CHARGES,INPATIENT ANCILLARY SERVICE COST APPORTIONMENT,APPORTIONMENT OF INPATIENT/OUTPATIENT ANCILLARY SERVICE OTHER PASS THROUGH COSTS,RENAL STATISTICAL DATA,COMPUTATION OF RATIO OF COST TO CHARGES,INPATIENT ANCILLARY SERVICE COST APPORTIONMENT,HOSPITAL WAGE INDEX DATA,COST ALLOCATION,TRIAL BALANCE OF EXPENSE ACCOUNTS,COMPUTATION OF RATIO OF COST TO CHARGES,Medicaid Inpatient Days/Outpatient Visits,TRIAL BALANCE OF EXPENSE ACCOUNTS,APPORTIONMENT OF INPATIENT/OUTPATIENT ANCILLARY SERVICE OTHER PASS THROUGH COSTS,COMPUTATION OF INPATIENT OPERATING COSTS,APPORTIONMENT OF INPATIENT/OUTPATIENT ANCILLARY SERVICE OTHER PASS THROUGH COSTS,INPATIENT ANCILLARY SERVICE COST APPORTIONMENT,BED DAYS AVAILABLE,APPORTIONMENT OF INPATIENT/OUTPATIENT ANCILLARY SERVICE OTHER PASS THROUGH COSTS,ALLOCATION OF NEW CAPITAL COSTS,COST ALLOCATION,COMPUTATION OF RATIO OF COST TO CHARGES,Total Inpatient Days/Outpatient Visits,COMPUTATION OF RATIO OF COST TO CHARGES,ALLOCATION OF NEW CAPITAL COSTS,HOSPITAL IDENTIFICATION INFORMATION,,COMPUTATION OF RATIO OF COST TO CHARGES,INPATIENT ANCILLARY SERVICE COST APPORTIONMENT,COST ALLOCATION,Medicaid Inpatient Days/Outpatient Visits,HHA STATISTICAL DATA,COMPUTATION OF INPATIENT OPERATING COSTS,COST ALLOCATION,HHA STATISTICAL DATA,HOSPITAL WAGE INDEX DATA,ALLOCATION OF NEW CAPITAL COSTS,APPORTIONMENT OF INPATIENT ROUTINE SERVICE CAPITAL COSTS,COMPUTATION OF RATIO OF COST TO CHARGES,ALLOCATION OF NEW CAPITAL COSTS,APPORTIONMENT OF INPATIENT/OUTPATIENT ANCILLARY SERVICE OTHER PASS THROUGH COSTS,APPORTIONMENT OF MEDICAL AND OTHER HEALTH SERVICES,Total Inpatient Days/Outpatient Visits,APPORTIONMENT OF INPATIENT/OUTPATIENT ANCILLARY SERVICE OTHER PASS THROUGH COSTS,APPORTIONMENT OF INPATIENT/OUTPATIENT ANCILLARY SERVICE OTHER PASS THROUGH COSTS,HHA STATISTICAL DATA,Medicare Inpatient Days/Outpatient Visits,ANALYSIS OF CHANGES IN NEW CAPITAL BALANCES,COST ALLOCATION,APPORTIONMENT OF INPATIENT/OUTPATIENT ANCILLARY SERVICE OTHER PASS THROUGH COSTS,HOSPITAL IDENTIFICATION INFORMATION,TRIAL BALANCE OF EXPENSE ACCOUNTS,COST ALLOCATION,,APPORTIONMENT OF INPATIENT ROUTINE SERVICE CAPITAL COSTS,,HOSPITAL WAGE INDEX DATA,ANALYSIS OF CHANGES IN NEW CAPITAL BALANCES,COST ALLOCATION,APPORTIONMENT OF INPATIENT/OUTPATIENT ANCILLARY SERVICE OTHER PASS THROUGH COSTS,INPATIENT ANCILLARY SERVICE COST APPORTIONMENT,,HOSPITAL WAGE INDEX DATA,COST ALLOCATION,APPORTIONMENT OF INPATIENT/OUTPATIENT ANCILLARY SERVICE OTHER PASS THROUGH COSTS,COMPUTATION OF RATIO OF COST TO CHARGES,ALLOCATION OF NEW CAPITAL COSTS,HHA STATISTICAL DATA,APPORTIONMENT OF INPATIENT/OUTPATIENT ANCILLARY SERVICE OTHER PASS THROUGH COSTS,TRIAL BALANCE OF EXPENSE ACCOUNTS,Total Inpatient Days/Outpatient Visits,COST ALLOCATION,INPATIENT ANCILLARY SERVICE COST APPORTIONMENT,TRIAL BALANCE OF EXPENSE ACCOUNTS,APPORTIONMENT OF INPATIENT/OUTPATIENT ANCILLARY SERVICE OTHER PASS THROUGH COSTS,TRIAL BALANCE OF EXPENSE ACCOUNTS,HOSPITAL WAGE INDEX DATA,APPORTIONMENT OF INPATIENT/OUTPATIENT ANCILLARY SERVICE OTHER PASS THROUGH COSTS,COMPUTATION OF RATIO OF COST TO CHARGES,ALLOCATION OF NEW CAPITAL COSTS,Medicaid Inpatient Days/Outpatient Visits,COST ALLOCATION,HOSPITAL WAGE INDEX DATA,COMPUTATION OF RATIO OF COST TO CHARGES,APPORTIONMENT OF INPATIENT/OUTPATIENT ANCILLARY SERVICE OTHER PASS THROUGH COSTS,HHA STATISTICAL DATA,,HOSPITAL WAGE INDEX DATA,,HHA STATISTICAL DATA,COST ALLOCATION,HOSPITAL WAGE INDEX DATA,APPORTIONMENT OF INPATIENT/OUTPATIENT ANCILLARY SERVICE OTHER PASS THROUGH COSTS,INPATIENT ANCILLARY SERVICE COST APPORTIONMENT,TRIAL BALANCE OF EXPENSE ACCOUNTS,COMPUTATION OF RATIO OF COST TO CHARGES,TRIAL BALANCE OF EXPENSE ACCOUNTS,TRIAL BALANCE OF EXPENSE ACCOUNTS,COMPUTATION OF RATIO OF COST TO CHARGES,,APPORTIONMENT OF INPATIENT/OUTPATIENT ANCILLARY SERVICE OTHER PASS THROUGH COSTS,APPORTIONMENT OF INPATIENT/OUTPATIENT ANCILLARY SERVICE OTHER PASS THROUGH COSTS,BED DAYS AVAILABLE,HOSPITAL WAGE INDEX DATA,COST ALLOCATION,TRIAL BALANCE OF EXPENSE ACCOUNTS,APPORTIONMENT OF MEDICAL AND OTHER HEALTH SERVICES,TRIAL BALANCE OF EXPENSE ACCOUNTS,ANALYSIS OF CHANGES IN NEW CAPITAL BALANCES,TRIAL BALANCE OF EXPENSE ACCOUNTS,APPORTIONMENT OF INPATIENT/OUTPATIENT ANCILLARY SERVICE OTHER PASS THROUGH COSTS,INPATIENT ANCILLARY SERVICE COST APPORTIONMENT,COST ALLOCATION,COMPUTATION OF RATIO OF COST TO CHARGES,COST ALLOCATION,ALLOCATION OF NEW CAPITAL COSTS,BED DAYS AVAILABLE,COST ALLOCATION,TRIAL BALANCE OF EXPENSE ACCOUNTS,COST ALLOCATION,CALCULATION OF REIMBURSEMENT SETTLEMENT,APPORTIONMENT OF INPATIENT/OUTPATIENT ANCILLARY SERVICE OTHER PASS THROUGH COSTS,APPORTIONMENT OF INPATIENT/OUTPATIENT ANCILLARY SERVICE OTHER PASS THROUGH COSTS,APPORTIONMENT OF INPATIENT/OUTPATIENT ANCILLARY SERVICE OTHER PASS THROUGH COSTS,TRIAL BALANCE OF EXPENSE ACCOUNTS,ALLOCATION OF NEW CAPITAL COSTS,Total Inpatient Days/Outpatient Visits,TRIAL BALANCE OF EXPENSE ACCOUNTS,Total Inpatient Days/Outpatient Visits,APPORTIONMENT OF INPATIENT/OUTPATIENT ANCILLARY SERVICE OTHER PASS THROUGH COSTS,APPORTIONMENT OF INPATIENT/OUTPATIENT ANCILLARY SERVICE OTHER PASS THROUGH COSTS,COMPUTATION OF RATIO OF COST TO CHARGES,COMPUTATION OF RATIO OF COST TO CHARGES,COST ALLOCATION,Total Inpatient Days/Outpatient Visits,COST ALLOCATION,APPORTIONMENT OF INPATIENT/OUTPATIENT ANCILLARY SERVICE OTHER PASS THROUGH COSTS,COMPUTATION OF RATIO OF COST TO CHARGES,INPATIENT ANCILLARY SERVICE COST APPORTIONMENT,COST ALLOCATION,APPORTIONMENT OF INPATIENT/OUTPATIENT ANCILLARY SERVICE OTHER PASS THROUGH COSTS,HOSPITAL WAGE INDEX DATA,ADJUSTMENTS,,INPATIENT ANCILLARY SERVICE COST APPORTIONMENT,TRIAL BALANCE OF EXPENSE ACCOUNTS,ALLOCATION OF NEW CAPITAL COSTS,COMPUTATION OF RATIO OF COST TO CHARGES,TRIAL BALANCE OF EXPENSE ACCOUNTS,COMPUTATION OF RATIO OF COST TO CHARGES,HOSPITAL WAGE INDEX DATA,APPORTIONMENT OF INPATIENT/OUTPATIENT ANCILLARY SERVICE OTHER PASS THROUGH COSTS,APPORTIONMENT OF INPATIENT/OUTPATIENT ANCILLARY SERVICE OTHER PASS THROUGH COSTS,APPORTIONMENT OF MEDICAL AND OTHER HEALTH SERVICES,APPORTIONMENT OF INPATIENT/OUTPATIENT ANCILLARY SERVICE OTHER PASS THROUGH COSTS,APPORTIONMENT OF INPATIENT/OUTPATIENT ANCILLARY SERVICE OTHER PASS THROUGH COSTS,APPORTIONMENT OF INPATIENT/OUTPATIENT ANCILLARY SERVICE OTHER PASS THROUGH COSTS,ALLOCATION OF NEW CAPITAL COSTS,TRIAL BALANCE OF EXPENSE ACCOUNTS,APPORTIONMENT OF INPATIENT/OUTPATIENT ANCILLARY SERVICE OTHER PASS THROUGH COSTS,APPORTIONMENT OF MEDICAL AND OTHER HEALTH SERVICES,HOSPITAL WAGE INDEX DATA,,,APPORTIONMENT OF INPATIENT/OUTPATIENT ANCILLARY SERVICE OTHER PASS THROUGH COSTS,INPATIENT ANCILLARY SERVICE COST APPORTIONMENT,HOSPITAL WAGE INDEX DATA,,COST ALLOCATION,INPATIENT ANCILLARY SERVICE COST APPORTIONMENT,TRIAL BALANCE OF EXPENSE ACCOUNTS,INPATIENT ANCILLARY SERVICE COST APPORTIONMENT,HOSPITAL WAGE INDEX DATA,,RENAL STATISTICAL DATA,COST ALLOCATION,Total Inpatient Days/Outpatient Visits,HOSPITAL WAGE INDEX DATA,HOSPITAL WAGE INDEX DATA,HOSPITAL WAGE INDEX DATA,TRIAL BALANCE OF EXPENSE ACCOUNTS,APPORTIONMENT OF INPATIENT/OUTPATIENT ANCILLARY SERVICE OTHER PASS THROUGH COSTS,Medicaid Inpatient Days/Outpatient Visits,S-10 DATA,,ALLOCATION OF NEW CAPITAL COSTS,COST ALLOCATION,APPORTIONMENT OF MEDICAL AND OTHER HEALTH SERVICES,,BED DAYS AVAILABLE,COMPUTATION OF RATIO OF COST TO CHARGES,RENAL STATISTICAL DATA,TRIAL BALANCE OF EXPENSE ACCOUNTS,COMPUTATION OF RATIO OF COST TO CHARGES,APPORTIONMENT OF INPATIENT/OUTPATIENT ANCILLARY SERVICE OTHER PASS THROUGH COSTS,INPATIENT ANCILLARY SERVICE COST APPORTIONMENT,FFY,Hospital Type (Care Compare),Name and Num
,Curated Name and Num,Hospital type (HCRIS + care compare),Type of Control of Hospital (See Table I) (S2_1_C1_21),Lon,Lat,Recovery Room (D_4_IRF_C13_51),Subprovider I (D3_IPF_C2_42),ASC (Non Distinct Part) (D_4_IPF_C11_75),"HHA I, With Outliers:  Other Charges (S4_HHA1_C2_34)","HHA I, PEP Episodes:  Total Charges: (S4_HHA1_C4_35)",Paramedical Education (A_C2_23),"ADJUSTED SALARIES, Physician Part A (S3_2_C4_22)",Delivery Room and Labor Room (D_4_HOS_C12_52),Adj for Occupational therapy in excess of li (A8_C2_30),"HHA II, W/Out Outliers:  Number of Episodes (S4_HHA2_C1_36)","PPS REIMBURSED SERVICES -  CHARGES, Medical Supplies Charged to Patients (D_5_HOS_C2_71)",Medical Supplies Charged to Patients (D3_SNF_C3_71),Heart Acquisition (B_1_C21_106),Research (A_C2_191),Total Program Excludable Costs (D1_IPF_C1_52),"ADJUSTED SALARIES, Non-Physician Part B (S3_2_C4_6)","AMOUNT REPORTED, Excluded Areas (S3_2_C2_19)",Electroencephalography (A_C6_70),RHC/FQHC Combined (S3_1_C8_26),"AMOUNT REPORTED, Non-Physician Part B (S3_2_C2_6)",Anesthesiology (D_4_IRF_C11_53),In State Medicaid eligible days (S2_1_C2_24),Other Outpatient Services (D_4_IPF_C11_93),Electroencephalography (D_4_IRF_C13_70),"Net Expense for Cost Allocation, Medical Supplies Charged to Patients (B_1_C0_71)","Net Expense for Cost Allocation, Anesthesiology (B_1_C0_53)",Medicaid charges (S10_C1_6),Whole Blood & Packed Red Blood Cells (D_4_HOS_C13_62),Electroencephalography (D3_SNF_C3_70),"Net Expense for Cost Allocation, Recovery Room (B_1_C0_51)",Adults and Pediatrics (A_C1_30),Intestinal Acquisition (A_C2_110),Total (C_1_C6_202),OLTC (A_C2_46),Clinic (D_4_HOS_C2_90),"If this Hospital is claiming cost for renal services on Worksheet A, are they inpatient services only? (Y/N) (S2_1_C1_145)",Number of Times per week Patient receives Dialysis (S5_C1_2),"Gift, Flower, Coffee Shop, Canteen (B_1_C26_190)",Hospice (A_C1_116),"Percentage of patients re-using
dialyzers (S5_C2_10)",Recovery Room (C_1_C5_51),Electrocardiology (C_1_C7_69),"PPS SERVICES COST, Emergency (D_5_HOS_C5_91)","COST SERVICES NOT SUBJECT TO DEDUCTIBLES AND COINSURANCE - COST, MRI (D_5_HOS_C7_58)","AVERAGE HOURLY WAGE, Physician-Part A (S3_2_C6_4)",Physicians' Private Office (A_C1_192),OPT (C_1_C5_9920),Other Ancillary (D3_HOS_C3_76),Impl. Dev. Charged to Patients (C_1_C5_72),Outlier payments (E_B_HOS_C1_4),"Allocation of Interns & Residents Salary and Fringes, SNF (B_1_C21_44)",Renal Dialysis (D_4_HOS_C13_74),Burn Intensive Care Unit (A_C6_33),Interns & Res Other Program Costs (A_C1_22),Radioisotope (D_4_SNF_C11_56),HMO (S3_1_C7_2),"HHA II, PEP Episodes:  Total Charges: (S4_HHA2_C4_35)",Respiratory Therapy (C_1_C6_65),"Blood Storing, Processing, Trans (D_4_HOS_C12_63)","HHA III, With Outliers:  Non Routine Med Sup Chgs (S4_HHA3_C2_38)",Subprovider-IPF (D3_HOS_C2_40),Electroencephalography (D_4_HOS_C11_70),"Total Inpatient Charges, Laboratory (C_1_C6_60)",Other Organ Acquisition (B_1_C21_112),"TOTAL CAPITAL COSTS AFTER COST ALLOCATION, Adults & Pediatrics (B_2_C26_30)",Other Reimbursable (D3_IPF_C3_98),TOTAL (D3_IPF_C3_200),"Net Expense for Cost Allocation, Renal Dialysis (B_1_C0_74)",Renal 9 Provider Number (S2_1_C2_1808),"COST SERVICES NOT SUBJECT TO DEDUCTIBLES AND COINSURANCE - COST, Recovery Room (D_5_HOS_C7_51)","Net Expense for Cost Allocation, OSP (B_1_C0_9940)",Other Outpatient Services (A_C1_93),Urban/Rural Indicator at beginning (S2_1_C1_26),"AMOUNT REPORTED, Physician-Part A (S3_2_C2_4)","COST REIMBURSED SERVICES NOT SUBJECT TO DEDUCTIBLES AND COINSURANCE - CHARGES, Electroencephalography (D_5_HOS_C4_70)",CT Scan (D_4_IRF_C11_57),Drugs Charged to Patients (D_4_IPF_C13_73),"Purchases, Movable Equipment (A7_1_C2_6)","HHA II, PEP:  Total Non Routine Med Supply Chgs (S4_HHA2_C4_38)",Durable Medical Equipment Sold (D_4_HOS_C2_97),Int & Res (non approved teaching program (B_1_C21_100),ASC (Non Distinct Part) (B_1_C26_75),"HHA II, With Outliers:  Total Charges (S4_HHA2_C2_35)",MRI (B_1_C26_58),Burn Intensive Care Unit (C_1_C5_33),Medical Records and Medical Rec. Library (A_C1_16),MRI (D_4_HOS_C11_58),Research (A_C1_191),"AMOUNT REPORTED, Physician Part A Teaching (S3_2_C3_2201)","PAID HOURS RELATED TO SALARIES, Medical Records & Med Records Library (S3_2_C5_41)",MDH status ending date (MM/DD/YY) (S2_1_C2_38),"Blood Storing, Processing, Trans (D3_SNF_C2_63)",Coronary Intensive Care Unit (D_1_HOS_C6_32),Subprovider-IRF (D_3_HOS_C9_41),CT Scan (D_4_IRF_C13_57),"COST REIMBURSED SERVICES NOT SUBJECT TO DEDUCTIBLES AND COINSURANCE - CHARGES, Recovery Room (D_5_HOS_C4_51)","Net Expense for Cost Allocation, Burn Intensive Care Unit (B_1_C0_33)",Cardiac Catheterization (A_C1_59),Laboratory (D_4_HOS_C2_60),Radiology-Therapeutic (D3_HOS_C2_55),"ADJUSTED SALARIES, Home Office:  Physician Part A (S3_2_C4_15)","AMOUNT REPORTED, Total Salaries (S3_2_C2_1)",Electroencephalography (D_4_HOS_C3_70),"Blood Storing, Processing, Trans (C_1_C5_63)",MRI (A_C2_58),Anesthesiology (D_4_HOS_C13_53),Medicaid HMO Days (S2_1_C5_24),"Number of Times per week
 Patient receives Dialysis (S5_C2_2)",Cafeteria (A_C1_11),"COST SERVICES SUBJECT TO DEDUCTIBLES AND COINSURANCE - COST, Clinic (D_5_HOS_C6_90)","PPS SERVICES COST, Respiratory Therapy (D_5_HOS_C5_65)",Total (D_4_IPF_C11_200),Speech Pathology (A_C6_68),Beginning Date of SCH status (S2_1_C1_36),CT Scan (D3_IRF_C3_57),"HHA I, PEP Episodes:  Total Visits (S4_HHA1_C4_33)",Adults and Pediatrics (A_C6_30),"Total Outpatient Charges, CT Scan (C_1_C7_57)",Maintenance of Personnel (A_C2_12),Program Discharges (D1_HOS_C1_54),"ADJUSTED SALARIES, Excluded Areas (S3_2_C4_19)",Line 2 times line 5 (E_B_HOS_C1_6),RHC (C_1_C6_88),"COST REIMBURSED SERVICES NOT SUBJECT TO DEDUCTIBLES AND COINSURANCE - CHARGES, Operating Room (D_5_HOS_C4_50)","PPS SERVICES COST, Delivery Room and Labor Room (D_5_HOS_C5_52)",Subprovider-IPF (A_C2_40),"Blood Storing, Processing, Trans (D_4_HOS_C11_63)","COST REIMBURSED SERVICES SUBJECT TO DEDUCTIBLES  AND COINSURANCE - CHARGES, Recovery Room (D_5_HOS_C3_51)","PPS SERVICES COST, Other Outpatient Services (D_5_HOS_C5_93)",IRF (S3_1_C7_17),Social Service (A_C1_17),"COST SERVICES NOT SUBJECT TO DEDUCTIBLES AND COINSURANCE - COST, Anesthesiology (D_5_HOS_C7_53)",Impl. Dev. Charged to Patients (D_4_HOS_C11_72),Observation Beds (Distinct Unit) (A_C1_9201),OPT (A_C2_9920),Durable Medical Equipment Sold (A_C6_97),Nursery (A_C2_43),"Allocation of Interns & Residents Salary and Fringes, Burn Intensive Care Unit (B_1_C21_33)","ADJUSTED SALARIES, Cafeteria (S3_2_C4_36)","COST SERVICES SUBJECT TO DEDUCTIBLES AND COINSURANCE - COST, CT Scan (D_5_HOS_C6_57)",Laboratory (D3_HOS_C3_60),Average times dialyzers re-used (S5_C2_9),Anesthesiology (D_4_HOS_C2_53),Other Ancillary (D3_IRF_C3_76),Nursery (A_C6_43),"PAID HOURS RELATED TO SALARIES, Home Office Salaries & Wage Related Csts (S3_2_C5_14)",Radiology-Diagnostic (D_4_HOS_C11_54),Medicare Certified Kidney TC term date (S2_1_C2_126),Liver Acquisition (C_1_C6_107),"Allocation of Interns & Residents Salary and Fringes, Physical Therapy (B_1_C21_66)","If Line 32, Col 1 is yes, enter the method used: (A, B, or E only) (S2_1_C2_115)",Drugs Charged to Patients (D_4_SNF_C13_73),"Net Expense for Cost Allocation, NF (B_1_C0_45)",Delivery Room and Labor Room (D3_SNF_C2_52),ASC (Non Distinct Part) (B_2_C26_75),"HHA II, Total Charges:  LUPA Episodes (S4_HHA2_C3_35)","HHA II, Without Outliers:  Total Visits (S4_HHA2_C1_33)","COST SERVICES NOT SUBJECT TO DEDUCTIBLES AND COINSURANCE - COST, Cardiac Catheterization (D_5_HOS_C7_59)",State (S2_1_C2_143),"PPS REIMBURSED SERVICES -  CHARGES, Total (D_5_HOS_C2_200)",Total Nursing School (D_4_IPF_C2_200),Utilization (S5_C1_8),Surgical Intensive Care Unit (D_3_HOS_C9_34),Speech Pathology (A_C1_68),Durable Medical Equipment Rented (D3_IPF_C3_96),Other Special Care (S3_1_C2_12),Total Costs (D_3_HOS_C5_200),Intravenous Therapy (D3_HOS_C3_64),"ADJUSTED SALARIES, Admin & Gen Under Contract (S3_2_C4_29)",Total Nursing School (D_4_IRF_C2_200),Emergency (C_1_C7_91),Intravenous Therapy (D3_SNF_C2_64),Adj for Respiratory therapy costs in excess (A8_C2_23),Cardiac Catheterization (A_C6_59),"PAID HOURS RELATED TO SALARIES, Employee Benefits (S3_2_C5_26)","AVERAGE HOURLY WAGE, SNF (S3_2_C6_9)",OPT (C_1_C6_9920),"AMOUNT REPORTED, Wage Related Costs RHC/FQHC (S3_2_C2_24)",Does the hospital qualify as RPCH/CAH? (Y/N) (S2_1_C1_105),"COST SERVICES NOT SUBJECT TO DEDUCTIBLES AND COINSURANCE - COST, Other Outpatient Services (D_5_HOS_C7_93)",Total Hospital (S3_1_C2_14),"AVERAGE HOURLY WAGE, Employee Benefits (S3_2_C6_26)",Observation Beds (Distinct Unit) (B_1_C26_9201),Interest Expense (A_C6_113),"Total Outpatient Charges, Radioisotope (C_1_C7_56)",Speech Pathology (D_4_IPF_C13_68),Anesthesiology (A_C6_53),Respiratory Therapy (D3_IPF_C3_65),Electroencephalography (B_2_C26_70),Total (D_4_IRF_C13_200),Intravenous Therapy (D_4_IPF_C13_64),Occupational Therapy (A_C1_67),"AVERAGE HOURLY WAGE, Non-Physician Anesthetist Part B (S3_2_C6_3)","Donations, Buildings and Fixtures (A7_1_C3_3)",Liver Acquisition (B_1_C26_107),Intravenous Therapy (D3_HOS_C2_64),IRF Provider Number (S2_1_C2_5),"Number of Times per week
 Patient receives Dialysis (S5_C4_2)",Physicians' Assistant (A8_C2_29),Recovery Room (D3_IRF_C2_51),"PPS REIMBURSED SERVICES -  CHARGES, Physical Therapy (D_5_HOS_C2_66)","COST SERVICES SUBJECT TO DEDUCTIBLES AND COINSURANCE - COST, Whole Blood & Packed Red Blood Cells (D_5_HOS_C6_62)",SSA State Code (STATE),OPT (B_2_C26_9920),FQHC (A_C6_89),Hospice (B_1_C22_116),"COST REIMBURSED SERVICES SUBJECT TO DEDUCTIBLES  AND COINSURANCE - CHARGES, Drugs Charged to Patients (D_5_HOS_C3_73)","Net Expense for Cost Allocation, Blood Storing, Processing, Trans (B_1_C0_63)",Organ Procurement (D4_KIDNEY_C1_69),Observation Beds (Distinct Unit) (D_4_HOS_C3_9201),"TOTAL CAPITAL COSTS AFTER COST ALLOCATION, Subprovider II (B_2_C26_4201)",Research (B_1_C22_191),"Total Inpatient Charges, Burn Intensive Care Unit (C_1_C6_33)","Blood Storing, Processing, Trans (D3_HOS_C3_63)",Protested amounts (E_B_HOS_C1_44),Organ Procurement (D4_LIVER_C1_69),Hospital Adlts & Ped Swing Bed NF (S3_1_C7_6),"Net Expense for Cost Allocation, Radioisotope (B_1_C0_56)",Anesthesiology (C_1_C5_53),Radiology-Therapeutic (C_1_C5_55),"COST REIMBURSED SERVICES NOT SUBJECT TO DEDUCTIBLES AND COINSURANCE - CHARGES, Emergency (D_5_HOS_C4_91)","General Inpatient Routine Service Cost, net of Swing Bed and Private Room Diff (D1_IPF_C1_37)","PPS SERVICES COST, Impl. Dev. Charged to Patients (D_5_HOS_C5_72)",OPPS payments (E_B_HOS_C101_3),Total customary charges (E_B_HOS_C1_18),Electroencephalography (D_4_HOS_C12_70),NF (S3_1_C9_20),Cost of Uncompensated Care (S10_C1_30),"TOTAL CAPITAL COSTS AFTER COST ALLOCATION, Blood Clotting Factors for Hemoph. (B_2_C26_6250)",Speech Pathology (C_1_C5_68),"PPS REIMBURSED SERVICES -  CHARGES, Durable Medical Equipment Sold (D_5_HOS_C2_97)","ADJUSTED SALARIES, Medical Records & Med Records Library (S3_2_C4_41)",Intravenous Therapy (D_4_IRF_C13_64),Laboratory (D_4_SNF_C11_60),Interns & Res Other Program Costs (A_C2_22),Durable Medical Equipment Sold (D_4_HOS_C10_97),Hospital City (S2_1_C1_2),Drugs Charged to Patients (D_4_IRF_C11_73),RHC/FQHC Combined (S3_1_C11_26),"Allocation of Interns & Residents Salary and Fringes, Medical Supplies Charged to Patients (B_1_C21_71)",interns and residents (E_B_HOS_C1_28),"Net Expense for Cost Allocation, New Capital Equipment (B_1_C0_2)","HHA III, Total Number of Outlier Episodes (S4_HHA3_C5_37)",Radioisotope (D3_HOS_C3_56),Occupational Therapy (D3_SNF_C3_67),"Allocation of Interns & Residents Program Costs, Cardiac Catheterization (B_1_C22_59)",Impl. Dev. Charged to Patients (A_C6_72),Organ Procurement (D4_HEART_C1_69),Electroencephalography (D3_SNF_C2_70),"Net Expense for Cost Allocation, Durable Medical Equipment Sold (B_1_C0_97)",Maintenance and Repairs (A_C6_6),"COST REIMBURSED SERVICES SUBJECT TO DEDUCTIBLES  AND COINSURANCE - CHARGES, ASC (Non Distinct Part) (D_5_HOS_C3_75)","COST SERVICES SUBJECT TO DEDUCTIBLES AND COINSURANCE - COST, Emergency (D_5_HOS_C6_91)",RHC/FQHC Combined (S3_1_C7_26),Electrocardiology (D3_IRF_C3_69),"Net Expense for Cost Allocation, New Capital Buildings and Fixtures (B_1_C0_1)","Fully Depreciated Assets, Donations (A7_1_C3_7)",Lung  Acquisition (B_2_C26_108),Impl. Dev. Charged to Patients (D3_HOS_C2_72),FQHC (D_4_HOS_C4_89),"PAID HOURS RELATED TO SALARIES, SNF (S3_2_C5_9)",Occupational Therapy (C_1_C6_67),Total (D_4_HOS_C13_200),Medical Supplies Charged to Patients (D_4_HOS_C11_71),"AVERAGE HOURLY WAGE, Medical Records & Med Records Library (S3_2_C6_41)","Allocation of Interns & Residents Program Costs, Nursery (B_1_C22_43)",Other Reimbursable (D3_IRF_C2_98),Electroencephalography (D3_HOS_C2_70),Central Services and Supply (A_C2_14),"Total Outpatient Charges, Recovery Room (C_1_C7_51)","Purchases, Land (A7_1_C2_1)",Observation Beds (Distinct Unit) (D3_IRF_C2_9201),CORF (C_1_C5_9910),Anesthesiology (D_4_HOS_C12_53),PBP Clinical Lab Services Program Only (D3_IRF_C2_61),Cardiac Catheterization (D_4_HOS_C4_59),"TOTAL CAPITAL COSTS AFTER COST ALLOCATION, Whole Blood & Packed Red Blood Cells (B_2_C26_62)",Other Special Care Unit (D_1_HOS_C6_35),"TOTAL CAPITAL COSTS AFTER COST ALLOCATION, SNF (B_2_C26_44)","TOTAL CAPITAL COSTS AFTER COST ALLOCATION, OLTC (B_2_C26_46)","Net Expense for Cost Allocation, Blood Clotting Factors for Hemoph. (B_1_C0_6250)",Urban (1) or Rural (2) (S2_1_C1_27),Medical and Other Services reimbursed by OPPS (E_B_HOS_C101_2),"PPS SERVICES COST, Physical Therapy (D_5_HOS_C5_66)","PPS SERVICES COST, ASC (Non Distinct Part) (D_5_HOS_C5_75)",Physical Therapy (D_4_IPF_C13_66),Other Organ Acquisition (A_C6_112),"Allocation of Interns & Residents Salary and Fringes, Delivery Room and Labor Room (B_1_C21_52)",Home Program Dialysis (C_1_C7_94),Outpatient Rehab Provider (S3_1_C11_25),"AVERAGE HOURLY WAGE, Administrative and General under Contract (S3_2_C6_28)",Surgical Intensive Care Unit (D3_SNF_C2_34),Radiology-Therapeutic (A_C2_55),Operating Room (D_4_HOS_C12_50),"Allocation of Interns & Residents Program Costs, Respiratory Therapy (B_1_C22_65)",MDH status beginning date (MM/DD/YY) (S2_1_C1_38),Liver Acquisition (A_C1_107),Other Special Purpose (A_C2_117),FQHC 9 Provider Number (S2_1_C2_1608),"Is this a New Hospital under
42 CFR 412.300 PPS capital
(Y/N) (S2_1_C1_47)","PAID HOURS RELATED TO SALARIES, Central Services and Supply (S3_2_C5_39)","COST SERVICES SUBJECT TO DEDUCTIBLES AND COINSURANCE - COST, Durable Medical Equipment Rented (D_5_HOS_C6_96)",Total Hospital (S3_1_C3_14),"Disposals and Retirements, Fixed Equipment (A7_1_C5_5)",Out of State Medicaid eligible days (S2_1_C4_24),"ADJUSTED SALARIES, Interns & Residents (S3_2_C4_2550)","Gift, Flower, Coffee Shop, Canteen (B_1_C21_190)","AVERAGE HOURLY WAGE, Total (S3_3_C6_6)",Recovery Room (D_4_SNF_C11_51),Other Special Care Unit (A_C1_35),Subprovider-IRF (D3_IPF_C2_41),Radiology-Therapeutic (D_4_HOS_C12_55),Laundry and Linen Service (A_C2_8),"COST SERVICES SUBJECT TO DEDUCTIBLES AND COINSURANCE - COST, Operating Room (D_5_HOS_C6_50)",Recovery Room (D3_SNF_C2_51),"AMOUNT REPORTED, SNF (S3_2_C2_9)",Whole Blood & Packed Red Blood Cells (D3_IRF_C3_62),Radiology-Therapeutic (D3_IPF_C3_55),IRF (S3_1_C2_17),Physical Therapy (D3_SNF_C2_66),Observation Beds (Distinct Unit) (D_4_HOS_C11_9201),Ambulance Services (B_1_C26_95),Investment Income-New Movable Equip (A8_C2_2),Research (B_2_C26_191),Impl. Dev. Charged to Patients (D3_SNF_C3_72),RHC 2 Provider Number (S2_1_C2_1501),NF Provider Number (S2_1_C2_10),Total discharges (S3_1_C15_18),"AMOUNT REPORTED, Related  Salaries (S3_2_C2_1402)","Net Expense for Cost Allocation, SNF (B_1_C0_44)",SNF (A_C1_44),Clinic (D_4_HOS_C11_90),SNF (D_3_HOS_C9_44),"Fully Depreciated Assets, Subtotal (A7_1_C7_8)","ADJUSTED SALARIES, Housekeeping under contract (S3_2_C4_33)",Operation of Plant (A_C2_7),"COST REIMBURSED SERVICES NOT SUBJECT TO DEDUCTIBLES AND COINSURANCE - CHARGES, Blood Storing, Processing, Trans (D_5_HOS_C4_63)",ASC (Non Distinct Part) (C_1_C7_75),SNF (A_C6_44),Subprovider II (C_1_C5_4201),FQHC (D_4_HOS_C3_89),Pancreas Acquisition (B_1_C26_109),Cost of charity care (patients covered by public program + patients w/ coverage accepted by provider) (S10_C2_23),Other Ancillary (D_4_HOS_C12_76),"Net Expense for Cost Allocation, Kidney Acquisition (B_1_C0_105)",Emergency (D_4_IRF_C11_91),Liver Acquisition (C_1_C5_107),Lung  Acquisition (A_C1_108),"Allocation of Interns & Residents Salary and Fringes, Radiology-Diagnostic (B_1_C21_54)",Respiratory Therapy (D_4_IRF_C13_65),"Blood Storing, Processing, Trans (D_4_SNF_C11_63)",Subprovider 2 (S3_1_C2_1801),"Total Inpatient Charges, Adults & Pediatrics (C_1_C6_30)",ICF Provider Number (S2_1_C2_1001),Clinic (D3_IRF_C2_90),Electrocardiology (D_4_IPF_C11_69),Medical Supplies Charged to Patients (D_4_HOS_C3_71),Total Subprovider I Interns & Residents (S3_1_C9_18),"Sum of lines 3,4 divided by line 6 (E_B_HOS_C1_7)","ADJUSTED SALARIES, Total Overhead Costs (S3_3_C4_7)",Laboratory (D3_IRF_C3_60),ASC (Non Distinct Part) (D_4_IPF_C13_75),Radiology-Diagnostic (D3_SNF_C2_54),Other Special Purpose (C_1_C7_117),Emergency (D_4_HOS_C2_91),"COST SERVICES SUBJECT TO DEDUCTIBLES AND COINSURANCE - COST, Electroencephalography (D_5_HOS_C6_70)",CORF (B_2_C26_9910),Electroencephalography (D3_IPF_C3_70),CT Scan (D_4_HOS_C4_57),Total (D_4_HOS_C12_200),Recovery Room (D_4_IPF_C11_51),CORF (A_C6_9910),"COST REIMBURSED SERVICES NOT SUBJECT TO DEDUCTIBLES AND COINSURANCE - CHARGES, Drugs Charged to Patients (D_5_HOS_C4_73)","PPS SERVICES COST, Durable Medical Equipment Sold (D_5_HOS_C5_97)","ADJUSTED SALARIES, Wage Related Costs Core (S3_2_C4_17)","AVERAGE HOURLY WAGE, Management and Administrative Services (S3_2_C6_12)",Observation Beds (Distinct Unit) (D3_SNF_C3_9201),Charity care charges and uninsured discounts for the entire facility (S10_C1_20),Hospice (S3_1_C7_24),"PPS REIMBURSED SERVICES -  CHARGES, Operating Room (D_5_HOS_C2_50)","HHA III, LUPA Episodes:  Total Number of Episodes (S4_HHA3_C3_36)","AVERAGE HOURLY WAGE, Housekeeping under Contract (S3_2_C6_33)","Total Inpatient Charges, MRI (C_1_C6_58)",Intensive Care Unit (D_1_HOS_C4_31),"AVERAGE HOURLY WAGE, Total Salaries (S3_2_C6_1)","ADJUSTED SALARIES, SNF (S3_2_C4_9)","Net Expense for Cost Allocation, Gift, Flower, Coffee Shop, Canteen (B_1_C0_190)",Emergency (D3_SNF_C3_91),Respiratory Therapy (D_4_HOS_C13_65),Emergency (D3_HOS_C3_91),Recovery Room (D3_IPF_C3_51),Cardiac Catheterization (D3_HOS_C3_59),Payment to cost ratio (E_B_HOS_C101_5),Total Adults & Peds (S3_1_C7_7),"Net Expense for Cost Allocation, MRI (B_1_C0_58)","Net Expense for Cost Allocation, Other Nonreimbursable (B_1_C0_194)",Subprovider-IRF (D3_IRF_C2_40),Does the hospital elect a fully prospective payment method for capital costs? (Y/N) (S2_1_C1_48),Hospice (S3_1_C6_24),ASC (Non Distinct Part) (B_1_C22_75),Total Bad Debt expense (S10_C1_26),Clinic (D_4_HOS_C13_90),"PPS SERVICES COST, Other Reimbursable (D_5_HOS_C5_98)",Other Outpatient Services (D_4_HOS_C11_93),"Net Expense for Cost Allocation, Social Service (B_1_C0_17)","HHA II, With Outliers:  Number of Episodes (S4_HHA2_C2_37)",Electrocardiology (D3_SNF_C3_69),Total (D_4_SNF_C11_200),"PPS REIMBURSED SERVICES -  CHARGES, Home Program Dialysis (D_5_HOS_C2_94)","COST REIMBURSED SERVICES SUBJECT TO DEDUCTIBLES  AND COINSURANCE - CHARGES, Delivery Room and Labor Room (D_5_HOS_C3_52)",Impl. Dev. Charged to Patients (D_4_HOS_C3_72),"AMOUNT REPORTED, Home Office Salaries (S3_2_C2_1401)","Purchases, Fixed Equipment (A7_1_C2_5)",Physicians' Private Office (A_C2_192),Total Program General Inp. Rtn Service (D1_SNF_C1_74),Payments received from patients for amounts previously written off as charity care (S10_C3_22),"AVERAGE HOURLY WAGE, Non-Physician Anesthetist Part A (S3_2_C6_2)","Allocation of Interns & Residents Salary and Fringes, Radioisotope (B_1_C21_56)",Total (D_4_HOS_C1_200),Blood Clotting Factors for Hemoph. (A_C1_6250),ASC (Distinct Part) (B_1_C21_115),Electroencephalography (D_4_IPF_C11_70),"Income from imposition of interest, finance (A8_C2_21)","Allocation of Interns & Residents Program Costs, Recovery Room (B_1_C22_51)","Allocation of Interns & Residents Program Costs, Impl. Dev. Charged to Patients (B_1_C22_72)",Cost of patients approved for charity care and uninsured discounts (S10_C3_21),Emergency (C_1_C6_91),Total Allied Health Cost (D_3_HOS_C2_200),Other Nonreimbursable (A_C6_194),"Net Expense for Cost Allocation, Physicians' Private Office (B_1_C0_192)","COST REIMBURSED SERVICES SUBJECT TO DEDUCTIBLES  AND COINSURANCE - CHARGES, MRI (D_5_HOS_C3_58)",Total Other Medical Education (D_4_HOS_C4_200),Central Services and Supply (A_C1_14),Other Outpatient Services (C_1_C7_93),Title V discharges (S3_1_C12_17),Anesthesiology (B_1_C26_53),Intravenous Therapy (C_1_C7_64),"HHA I, Total Number of Episodes (S4_HHA1_C5_36)","Number of patients on transplant 
list (S5_C1_11)",CMHC (A_C2_99),Other General Service (A_C6_18),Durable Medical Equipment Rented (D3_SNF_C2_96),"AVERAGE HOURLY WAGE, Maintenance of Personnel (S3_2_C6_37)","Total Inpatient Charges, NF (C_1_C6_45)",Hospital Provider Number (PRVDR_NUM),Medical Supplies Charged to Patients (C_1_C6_71),Other Capital (A_C2_3),Recovery Room (D_4_HOS_C11_51),Physical Therapy (D3_HOS_C2_66),Operating Room (D3_IPF_C3_50),CORF (C_1_C6_9910),"COST REIMBURSED SERVICES SUBJECT TO DEDUCTIBLES  AND COINSURANCE - CHARGES, Operating Room (D_5_HOS_C3_50)","COST SERVICES NOT SUBJECT TO DEDUCTIBLES AND COINSURANCE - COST, Speech Pathology (D_5_HOS_C7_68)",Electrocardiology (D_4_IRF_C11_69),"Net Expense for Cost Allocation, RHC (B_1_C0_88)",Total (C_1_C5_202),Delivery Room and Labor Room (D_4_IRF_C13_52),"ADJUSTED SALARIES, Subtotal Wage Related Csts (S3_3_C4_5)",Renal 10 Provider Number (S2_1_C2_1809),Laundry and Linen Service (A_C1_8),"PPS REIMBURSED SERVICES -  CHARGES, Whole Blood & Packed Red Blood Cells (D_5_HOS_C2_62)","PAID HOURS RELATED TO SALARIES, Dietary under Contract (S3_2_C5_35)",TOTAL (D3_HOS_C3_200),Lung  Acquisition (A_C6_108),PBP Clinical Lab Services Program Only (D3_HOS_C3_61),Recovery Room (D3_SNF_C3_51),Total (D_1_HOS_C7_200),Speech Pathology (D_4_IRF_C11_68),Adults and Pediatrics (B_1_C26_30),"COST SERVICES SUBJECT TO DEDUCTIBLES AND COINSURANCE - COST, Total (D_5_HOS_C6_200)",Durable Medical Equipment Rented (D3_HOS_C2_96),Hospital Adults & Pediatrics (S3_1_C5_1),"PAID HOURS RELATED TO SALARIES, Nursing Administration (S3_2_C5_38)",Physical Therapy (C_1_C5_66),Other Special Purpose (B_2_C26_117),Investment Income-Other (A8_C2_3),ICF (C_1_C5_4501),"AVERAGE HOURLY WAGE, Operation of Plant (S3_2_C6_30)",Ambulance Services (C_1_C7_95),"COST REIMBURSED SERVICES NOT SUBJECT TO DEDUCTIBLES AND COINSURANCE - CHARGES, Observation Beds (Distinct Unit) (D_5_HOS_C4_9201)",In State Medicaid paid days (S2_1_C1_24),Total Subprovider II Interns & Residents (S3_1_C10_1801),Other Special Purpose (B_1_C26_117),Total Program Inpatient Costs (D1_IRF_C1_49),"Net Expense for Cost Allocation, Medical Records and Medical Rec. Library (B_1_C0_16)",Impl. Dev. Charged to Patients (D3_SNF_C2_72),Ambulance Services (A_C1_95),Stand-alone CHIP cost (S10_C1_11),Recovery Room (D_4_HOS_C13_51),"HHA II, With Outliers:  Total Visits (S4_HHA2_C2_33)",Intestinal Acquisition (A_C1_110),Physical Therapy (D_4_HOS_C11_66),MRI (D3_SNF_C2_58),Ambulance Services (B_2_C26_95),"Blood Storing, Processing, Trans (B_2_C26_63)",Radiology-Therapeutic (D3_IRF_C3_55),Subprovider 2 (S3_1_C7_1801),Other Special Care (S3_1_C8_12),Target Amount (D1_HOS_C1_56),Physicians' Private Office (B_2_C26_192),"TOTAL CAPITAL COSTS AFTER COST ALLOCATION, Delivery Room and Labor Room (B_2_C26_52)",Laboratory (D_4_HOS_C11_60),Intensive Care Unit (D3_SNF_C2_31),"Net Expense for Cost Allocation, Other Reimbursable (B_1_C0_98)",ASC (Distinct Part) (B_2_C26_115),"ADJUSTED SALARIES, Operation of Plant (S3_2_C4_30)","HHA II, Total Number of Outlier Episodes (S4_HHA2_C5_37)","Allocation of Interns & Residents Program Costs, Laboratory (B_1_C22_60)",Adults & Pediatrics (D_1_HOS_C6_30),Emergency (D3_IPF_C3_91),"COST REIMBURSED SERVICES SUBJECT TO DEDUCTIBLES  AND COINSURANCE - CHARGES, Whole Blood & Packed Red Blood Cells (D_5_HOS_C3_62)",Whole Blood & Packed Red Blood Cells (A_C2_62),Observation Beds (Distinct Unit) (B_1_C22_9201),"Allocation of Interns & Residents Program Costs, NF (B_1_C22_45)",Delivery Room and Labor Room (D3_IPF_C2_52),"COST REIMBURSED SERVICES NOT SUBJECT TO DEDUCTIBLES AND COINSURANCE - CHARGES, Intravenous Therapy (D_5_HOS_C4_64)","Total Outpatient Charges, Cardiac Catheterization (C_1_C7_59)","Allocation of Interns & Residents Salary and Fringes, Interns & Res Salary and Fringe Benefits (B_1_C21_21)","Net Expense for Cost Allocation, Employee Benefits (B_1_C0_4)",Dietary (A_C6_10),"Medicare certified heart
transplant center cert date (S2_1_C1_127)",HHA (S3_1_C8_22),Heart Acquisition (A_C2_106),HHA (B_2_C26_101),"Allocation of Interns & Residents Salary and Fringes, Operating Room (B_1_C21_50)","COST SERVICES NOT SUBJECT TO DEDUCTIBLES AND COINSURANCE - COST, Blood Storing, Processing, Trans (D_5_HOS_C7_63)","ADJUSTED SALARIES, Teaching Physician Salaries (S3_2_C4_1601)",Heart Acquisition (C_1_C7_106),Adj for Speech therapy in excess of lim (A8_C2_31),"COST REIMBURSED SERVICES NOT SUBJECT TO DEDUCTIBLES AND COINSURANCE - CHARGES, Clinic (D_5_HOS_C4_90)","COST SERVICES NOT SUBJECT TO DEDUCTIBLES AND COINSURANCE - COST, Durable Medical Equipment Rented (D_5_HOS_C7_96)",Observation Beds (Distinct Unit) (D_4_IPF_C11_9201),"COST REIMBURSED SERVICES NOT SUBJECT TO DEDUCTIBLES AND COINSURANCE - CHARGES, Total (D_5_HOS_C4_200)","Allocation of Interns & Residents Program Costs, Delivery Room and Labor Room (B_1_C22_52)",Labor and Delivery (S3_1_C2_32),"Net Expense for Cost Allocation, Int & Res (non approved teaching program (B_1_C0_100)",TOTAL (D3_IPF_C2_200),City (S2_1_C1_143),Intravenous Therapy (A_C1_64),Emergency (D3_IRF_C2_91),ASC (Non Distinct Part) (A_C6_75),Hospital Adults & Ped Swing Bed SNF (S3_1_C6_5),"Net Expense for Cost Allocation, CORF (B_1_C0_9910)","Blood Storing, Processing, Trans (A_C1_63)",Cost of charity care (S10_C3_23),"ADJUSTED SALARIES, Physician-Part B (S3_2_C4_5)","PPS SERVICES COST, MRI (D_5_HOS_C5_58)","ADJUSTED SALARIES, Excluded Area Salaries (S3_2_C4_10)","Blood Storing, Processing, Trans (D_4_HOS_C3_63)",Is this hospital an All-Inclusive rate provider? (Y/N) (S2_1_C1_115),"Number of patients in program at 
end of cost reporting period (S5_C4_1)",Burn Intensive Care Unit (D_3_HOS_C9_33),"Net Expense for Cost Allocation, Interns & Res Other Program Costs (B_1_C0_22)","Total Inpatient Charges, SNF (C_1_C6_44)","COST REIMBURSED SERVICES SUBJECT TO DEDUCTIBLES  AND COINSURANCE - CHARGES, Ambulance Services (D_5_HOS_C3_95)",Excess of reasonable cost over reasonable charges (E_B_HOS_C1_20),"Net Expense for Cost Allocation, Islet Acquisition (B_1_C0_111)","Epoietin amount form worksheet A
for home dialysis program (S5_C1_14)","Net Expense for Cost Allocation, ASC (Distinct Part) (B_1_C0_115)","Beginning Balances, Movable Equipment (A7_1_C1_6)","Fully Depreciated Assets, Begin Balance (A7_1_C1_7)",Anesthesiology (D3_HOS_C2_53),Laboratory (D_4_HOS_C12_60),"Allocation of Interns & Residents Program Costs, Radiology-Diagnostic (B_1_C22_54)","HHA I, Total Number of Outlier Episodes (S4_HHA1_C5_37)",Whole Blood & Packed Red Blood Cells (A_C1_62),Medical Supplies Charged to Patients (D_4_HOS_C2_71),Interns & Res Other Program Costs (A_C6_22),"ADJUSTED SALARIES, Physician-Part A (S3_2_C4_4)",Other Special Purpose (C_1_C6_117),Burn Intensive Care Unit (S3_1_C7_10),Hospice (B_1_C26_116),"PPS SERVICES COST, Blood Clotting Factors for Hemoph. (D_5_HOS_C5_6250)",Electrocardiology (A_C1_69),Clinic (D_4_IRF_C13_90),Subprovider-IRF (B_1_C26_41),"PPS SERVICES COST, Recovery Room (D_5_HOS_C5_51)",Impl. Dev. Charged to Patients (B_2_C26_72),Subprovider II (B_1_C26_4201),"COST SERVICES NOT SUBJECT TO DEDUCTIBLES AND COINSURANCE - COST, Intravenous Therapy (D_5_HOS_C7_64)",Observation Beds (Distinct Unit) (D3_HOS_C2_9201),"AMOUNT REPORTED, Interns & Residents (S3_2_C2_25)",Blood Clotting Factors for Hemoph. (D3_HOS_C2_6250),"HHA II, Total Visits (S4_HHA2_C5_33)",Swing Bed SNF Provider Number (S2_1_C2_7),"PPS SERVICES COST, Laboratory (D_5_HOS_C5_60)","ADJUSTED SALARIES, Physician Part B (S3_2_C4_23)","HHA III, LUPA:  Total Non Routine Med Sup Chgs (S4_HHA3_C3_38)","TOTAL CAPITAL COSTS AFTER COST ALLOCATION, Burn Intensive Care Unit (B_2_C26_33)",CT Scan (C_1_C5_57),Anesthesiology (D_4_IPF_C13_53),Other Reimbursable (D3_SNF_C2_98),Other Special Care Unit (A_C6_35),Other adjustments (E_B_HOS_C1_39),CMHC (A_C6_99),"HHA II, PEP Episodes:  Other Charges (S4_HHA2_C4_34)",Other Special Care Unit (D3_HOS_C2_35),Intravenous Therapy (C_1_C5_64),"Net Expense for Cost Allocation, Cardiac Catheterization (B_1_C0_59)",Renal Dialysis (D_4_HOS_C3_74),FQHC (B_1_C26_89),OPT (C_1_C7_9920),Medical Supplies Charged to Patients (D_4_HOS_C13_71),Drugs Charged to Patients (D_4_HOS_C12_73),"COST REIMBURSED SERVICES SUBJECT TO DEDUCTIBLES  AND COINSURANCE - CHARGES, Cardiac Catheterization (D_5_HOS_C3_59)",Title XVIII discharges (S3_1_C13_17),Aggregate amount collected from patients (E_B_HOS_C1_15),Delivery Room and Labor Room (D_4_HOS_C10_52),Renal Dialysis (D_4_HOS_C11_74),"Total Program Inpatient Operating Cost excluding Capital Related, Nonphysician, Anesthetist, and Medical Education Costs (D1_IPF_C1_53)",TOTAL (D3_IRF_C3_200),Observation Beds (Distinct Unit) (D_4_SNF_C11_9201),Laboratory (D3_SNF_C2_60),Cafeteria (A_C6_11),Physical Therapy (D_4_HOS_C12_66),"COST REIMBURSED SERVICES SUBJECT TO DEDUCTIBLES  AND COINSURANCE - CHARGES, Radiology-Diagnostic (D_5_HOS_C3_54)",Surgical Intensive Care Unit (B_1_C26_34),Electroencephalography (D_4_HOS_C13_70),Observation Beds (Distinct Unit) (D_4_HOS_C2_9201),Lung  Acquisition (C_1_C5_108),"Donations, Fixed Equipment (A7_1_C3_5)",IRF (S3_1_C3_17),Cardiac Catheterization (D_4_HOS_C11_59),"AVERAGE HOURLY WAGE, Subtotal Salaries (S3_3_C6_3)",Home Program Dialysis (B_1_C21_94),"AVERAGE HOURLY WAGE, Contract Labor:  Physician Part A (S3_2_C6_13)",RHC 10 Provider Number (S2_1_C2_1509),"ADJUSTED SALARIES, Other General Service (S3_2_C4_43)",CMHC (B_1_C22_99),Occupational Therapy (C_1_C2_67),ICF (B_1_C26_4501),"Number of days in year dialysis 
furnished (S5_C5_2)","TOTAL CAPITAL COSTS AFTER COST ALLOCATION, Total Directly Assigned New Cap Rel Csts (B_2_C0_202)","COST SERVICES NOT SUBJECT TO DEDUCTIBLES AND COINSURANCE - COST, Electrocardiology (D_5_HOS_C7_69)",Intravenous Therapy (D3_SNF_C3_64),Electroencephalography (C_1_C6_70),Intravenous Therapy (D3_IPF_C3_64),Respiratory Therapy (D_4_HOS_C3_65),"Allocation of Interns & Residents Salary and Fringes, Subprovider I (B_1_C21_42)",FQHC 1 Provider Number (S2_1_C2_16),Other Outpatient Services (A_C6_93),Investment Income-New Bldgs & Fixtures (A8_C2_1),Other Outpatient Services (B_1_C21_93),"Purchases, Land Improvements (A7_1_C2_2)",IPPS Interim payment (E_A_HOS_C1_72),"Net Expense for Cost Allocation, Other Special Care Unit (B_1_C0_35)",IPF (S3_1_C7_16),Respiratory Therapy (D_4_IPF_C11_65),Radiology-Therapeutic (D_4_SNF_C11_55),"HHA III, With Outliers:  Total Visits (S4_HHA3_C2_33)",Total Program General Inpatient Routine (D1_HOS_C1_41),Heart Acquisition (B_1_C22_106),Nursing Administration (A_C6_13),"AVERAGE HOURLY WAGE, Other General Service (S3_2_C6_43)",HHA (B_1_C26_101),"HHA II, With Outliers:  Other Charges (S4_HHA2_C2_34)",SNF (B_1_C26_44),"Total Inpatient Charges, Subprovider-IRF (C_1_C6_41)","Total Outpatient Charges, MRI (C_1_C7_58)","HHA III, With Outliers:  Other Charges (S4_HHA3_C2_34)",Other Ancillary (A_C2_76),Laboratory (D_4_HOS_C3_60),"AVERAGE HOURLY WAGE, Related Salaries (S3_2_C6_1402)",Less Observation Beds (C_1_C5_201),Interim payments (E_B_HOS_C1_41),"Net Expense for Cost Allocation, Radiology-Therapeutic (B_1_C0_55)",Other Organ Acquisition (B_1_C22_112),Observation Beds (Distinct Unit) (D3_IPF_C2_9201),Number of stations (S5_C1_6),Hospital Street Address (S2_1_C1_1),Emergency (D_4_HOS_C10_91),Durable Medical Equipment Sold (C_1_C7_97),TOTAL (D3_SNF_C3_200),Impl. Dev. Charged to Patients (D3_IPF_C3_72),Occupational Therapy (D_4_SNF_C11_67),Radioisotope (D3_IRF_C3_56),"COST SERVICES NOT SUBJECT TO DEDUCTIBLES AND COINSURANCE - COST, Whole Blood & Packed Red Blood Cells (D_5_HOS_C7_62)",Surgical Intensive Care Unit (D3_IPF_C2_34),Home Program Dialysis (B_1_C26_94),Occupational Therapy (D_4_HOS_C11_67),"Lease, New Cap Related Csts Bldg & Fixtures (A7_3_C10_1)",Intestinal Acquisition (C_1_C6_110),ASC (Non Distinct Part) (C_1_C5_75),Subprovider I (A_C6_42),Medical Records and Medical Rec. Library (A_C2_16),Social Service (A_C2_17),NF (A_C1_45),Sale of medical records and abstracts (A8_C2_18),"COST REIMBURSED SERVICES SUBJECT TO DEDUCTIBLES  AND COINSURANCE - CHARGES, Impl. Dev. Charged to Patients (D_5_HOS_C3_72)",Electrocardiology (D_4_HOS_C2_69),"AMOUNT REPORTED, Administrative & General under contract (S3_2_C2_28)","TOTAL CAPITAL COSTS AFTER COST ALLOCATION, Recovery Room (B_2_C26_51)",OOT (A_C1_9930),"ADJUSTED SALARIES, Contract Labor (S3_2_C4_11)","HHA I, PEP Episodes:  Other Charges (S4_HHA1_C4_34)",Speech Pathology (D_4_HOS_C13_68),Research (B_1_C26_191),SNF (S3_1_C10_19),"Allocation of Interns & Residents Salary and Fringes, Intravenous Therapy (B_1_C21_64)",Intensive Care Unit (A_C2_31),Renal Dialysis (B_2_C26_74),"PPS REIMBURSED SERVICES -  CHARGES, Other Reimbursable (D_5_HOS_C2_98)",Intravenous Therapy (D_4_IPF_C11_64),Speech Pathology (B_1_C26_68),Drugs Charged to Patients (D3_IRF_C3_73),Nonpaid Workers (B_2_C26_193),"Net Expense for Cost Allocation, Subprovider II (B_1_C0_4201)",Organ Procurement (D4_LUNG_C1_69),"COST SERVICES NOT SUBJECT TO DEDUCTIBLES AND COINSURANCE - COST, Impl. Dev. Charged to Patients (D_5_HOS_C7_72)","COST SERVICES NOT SUBJECT TO DEDUCTIBLES AND COINSURANCE - COST, Physical Therapy (D_5_HOS_C7_66)","PAID HOURS RELATED TO SALARIES, Excluded Area Salaries (S3_3_C5_2)",Radiology-Therapeutic (D_4_IPF_C11_55),Coronary Care Unit Program Cost (D1_HOS_C5_44),"ADJUSTED SALARIES, Social Service (S3_2_C4_42)","AMOUNT REPORTED, Net Salaries (S3_3_C2_1)",Emergency (B_2_C26_91),PBP Clinical Lab Services Program Only (D3_HOS_C2_61),Hospice (S3_1_C2_24),"Lease, New Cap Related Csts Movable Equipment (A7_3_C10_2)","Beginning Balances, Land (A7_1_C1_1)",Radioisotope (D_4_HOS_C3_56),Whole Blood & Packed Red Blood Cells (D3_HOS_C2_62),"Allocation of Interns & Residents Salary and Fringes, Subprovider-IRF (B_1_C21_41)",Impl. Dev. Charged to Patients (D_4_HOS_C12_72),"Disposals and Retirements, Buildings and Fixtures (A7_1_C5_3)","COST REIMBURSED SERVICES NOT SUBJECT TO DEDUCTIBLES AND COINSURANCE - CHARGES, Durable Medical Equipment Rented (D_5_HOS_C4_96)",Hospital Adults & Pediatrics (S3_1_C3_1),"ADJUSTED SALARIES, Interns & Residents (S3_2_C4_2552)","AMOUNT REPORTED, Physician Part B (S3_2_C2_23)",Other Ancillary (D_4_IRF_C11_76),"ADJUSTED SALARIES, Home Office Personnel (S3_2_C4_8)","COST SERVICES SUBJECT TO DEDUCTIBLES AND COINSURANCE - COST, Observation Beds (Distinct Unit) (D_5_HOS_C6_9201)","Sale of scrap, waste, etc. (A8_C2_11)","HHA I, Total Charges:  LUPA Episodes (S4_HHA1_C3_35)",MRI (A_C1_58),"COST SERVICES SUBJECT TO DEDUCTIBLES AND COINSURANCE - COST, Intravenous Therapy (D_5_HOS_C6_64)","If an Organ Procurement Organization, enter the OPO number (S2_1_C1_134)",Medical Supplies Charged to Patients (A_C2_71),"COST REIMBURSED SERVICES NOT SUBJECT TO DEDUCTIBLES AND COINSURANCE - CHARGES, Laboratory (D_5_HOS_C4_60)",Subtotal (E_B_HOS_C1_37),Physicians' Private Office (B_1_C22_192),Coronary Care Unit (A_C1_32),"AMOUNT REPORTED, Home Office Salaries & Wage Related Csts (S3_2_C3_14)",Radiology-Therapeutic (D_4_HOS_C4_55),Electrocardiology (D3_IRF_C2_69),"Beginning Balances, Total (A7_1_C1_10)",Number of stations (S5_C4_6),Other Ancillary (D3_SNF_C2_76),Delivery Room and Labor Room (A_C1_52),"Net Expense for Cost Allocation, Coronary Care Unit (B_1_C0_32)",Title V discharges (S3_1_C12_16),"HHA I, LUPA:  Total Non Routine Med Sup Chgs (S4_HHA1_C3_38)",Observation Beds (Distinct Unit) (C_1_C7_9201),"Net Expense for Cost Allocation, Total (B_1_C0_200)","Beginning Balances, Land Improvements (A7_1_C1_2)","Allocation of Interns & Residents Salary and Fringes, Anesthesiology (B_1_C21_53)",Renal Dialysis (D3_HOS_C3_74),Radiology-Diagnostic (D_4_IRF_C13_54),Drugs Charged to Patients (D3_SNF_C2_73),Physicians' Private Office (B_1_C26_192),Utilization Review SNF (A_C6_114),"Allocation of Interns & Residents Program Costs, Electroencephalography (B_1_C22_70)","Net Expense for Cost Allocation, Intensive Care Unit (B_1_C0_31)",Occupational Therapy (A_C6_67),"COST SERVICES NOT SUBJECT TO DEDUCTIBLES AND COINSURANCE - COST, Respiratory Therapy (D_5_HOS_C7_65)","ADJUSTED SALARIES, Central Services and Supply (S3_2_C4_39)",Durable Medical Equipment Rented (B_2_C26_96),"AVERAGE HOURLY WAGE, Pharmacy (S3_2_C6_40)","Net Expense for Cost Allocation, OOT (B_1_C0_9930)","Number of patients transplanted 
during fiscal year (S5_C1_12)",Renal Dialysis (C_1_C6_74),"ADJUSTED SALARIES, Net Salaries (S3_3_C4_1)","Total Outpatient Charges, Blood Clotting Factors for Hemoph. (C_1_C7_6250)",Home Office Name (S2_1_C1_141),"ADJUSTED SALARIES, Pharmacy (S3_2_C4_40)",Operating Room (D_4_HOS_C13_50),"Fully Depreciated Assets, Disp. And Retirement (A7_1_C5_7)","AMOUNT REPORTED, Subtotal Other Wages and Related Csts (S3_3_C2_4)","Total Inpatient Charges, Radiology-Diagnostic (C_1_C6_54)",Housekeeping (A_C2_9),RHC (B_1_C22_88),"HHA I, Without Outliers:  Non Routine Med Sup Chgs (S4_HHA1_C1_38)",Intensive Care Unit (D_1_HOS_C7_31),Other Reimbursable (D_4_HOS_C3_98),"Other Capital Related Costs, New Cap Related Csts Bldg & Fixtures (A7_3_C7_1)",Other Ancillary (C_1_C7_76),Transitional corridor payment (E_B_HOS_C101_8),RHC (A_C6_88),"Fully Depreciated Assets, Purchase (A7_1_C2_7)",Electroencephalography (D_4_SNF_C11_70),Cafeteria (A_C2_11),Drugs Charged to Patients (A_C6_73),"Net Expense for Cost Allocation, CMHC (B_1_C0_99)","Taxes, Total (A7_3_C6_3)","TOTAL CAPITAL COSTS AFTER COST ALLOCATION, Laboratory (B_2_C26_60)","Total Inpatient Charges, Other Special Care Unit (C_1_C6_35)","PAID HOURS RELATED TO SALARIES, Maintenance of Personnel (S3_2_C5_37)",Clinic (C_1_C7_90),CT Scan (D_4_HOS_C12_57),Respiratory Therapy (C_1_C2_65),Other Ancillary (D_4_HOS_C4_76),FQHC (B_1_C21_89),Speech Pathology (D_4_HOS_C2_68),Speech Pathology (D3_SNF_C3_68),OPT (B_1_C26_9920),Total Program Excludable Costs (D1_IRF_C1_52),Pancreas Acquisition (A_C1_109),Emergency (D_4_HOS_C13_91),Radiology-Therapeutic (D3_SNF_C2_55),"PAID HOURS RELATED TO SALARIES, Pharmacy (S3_2_C5_40)",Other Reimbursable (D3_HOS_C3_98),"Disposals and Retirements, Subtotal (A7_1_C5_8)",Operating Room (D3_HOS_C2_50),"Disposals and Retirements, Land Improvements (A7_1_C7_2)",Drugs Charged to Patients (B_1_C26_73),Total Adults & Peds (S3_1_C6_7),"AVERAGE HOURLY WAGE, Non-Physician Part B (S3_2_C6_6)",CT Scan (D3_HOS_C2_57),"Are there any related organization or how office costs as defined in HCFA Pub. 15-I, chapter 10? (Y/N) (S2_1_C1_140)",Clinic (A_C6_90),Burn Intensive Care Unit (D3_HOS_C2_33),Clinic (D_4_IPF_C11_90),Anesthesiology (D3_SNF_C2_53),Nursing School (A8_C2_19),Burn Intensive Care Unit (D_1_HOS_C4_33),"Total Inpatient Charges, Delivery Room and Labor Room (C_1_C6_52)",Subprovider-IPF (D3_IPF_C2_40),Other Ancillary (D3_IPF_C3_76),Pharmacy (A_C2_15),Heart Acquisition (C_1_C6_106),"COST REIMBURSED SERVICES SUBJECT TO DEDUCTIBLES  AND COINSURANCE - CHARGES, CT Scan (D_5_HOS_C3_57)","PPS SERVICES COST, Drugs Charged to Patients (D_5_HOS_C5_73)","TOTAL CAPITAL COSTS AFTER COST ALLOCATION, Subprovider-IPF (B_2_C26_40)","AVERAGE HOURLY WAGE, Teaching Physician Salaries (S3_2_C6_16)",Other Special Care Unit (D3_IPF_C2_35),"AMOUNT REPORTED, Subtotal Salaries (S3_3_C2_3)",RHC 25 Provider Number (S2_1_C2_1524),Medicare Certified Liver TC term date (S2_1_C2_128),Observation Beds (Distinct Unit) (D_4_IPF_C13_9201),HRR adjustment amount  (E_A_HOS_C1_7094),"Blood Storing, Processing, Trans (D_4_HOS_C2_63)",Utilization Review SNF (A_C1_114),"Net Expense for Cost Allocation, Interns & Res Salary and Fringe Benefits (B_1_C0_21)","ADJUSTED SALARIES, Non-Physician Anesthetist Part B (S3_2_C4_21)",Total Outpatient Program Pass Thru Cost (D_4_IRF_C6_200),"AMOUNT REPORTED, Other General Service (S3_2_C2_43)",Title XVIII discharges (S3_1_C13_1),Other Ancillary (D_4_HOS_C2_76),Electrocardiology (D3_IPF_C3_69),Rental of Provider space by suppliers (A8_C2_6),Housekeeping (A_C6_9),Sequestration adjustment (E_B_HOS_C1_4001),Maintenance and Repairs (A_C1_6),Delivery Room and Labor Room (D_4_IPF_C13_52),"Blood Storing, Processing, Trans (D_4_IRF_C11_63)",Other Outpatient Services (D_4_HOS_C2_93),"Net Expense for Cost Allocation, Nonpaid Workers (B_1_C0_193)",CMHC (B_2_C26_99),Stand-alone CHIP Charges (Gross Revenue) (S10_C1_10),Total Other Medical Education (D_4_IPF_C4_200),Anesthesiology (D_4_HOS_C1_53),RHC/FQHC Combined (S3_1_C6_26),Home Program Dialysis (D3_HOS_C3_94),Pancreas Acquisition (B_1_C22_109),"COST SERVICES SUBJECT TO DEDUCTIBLES AND COINSURANCE - COST, Radiology-Diagnostic (D_5_HOS_C6_54)",Sale of medical and surgical supplies to (A8_C2_16),Radioisotope (D_4_HOS_C2_56),Radioisotope (A_C2_56),RHC 20 Provider Number (S2_1_C2_1519),Home Program Dialysis (C_1_C6_94),Administrative and General (A_C6_5),"COST REIMBURSED SERVICES NOT SUBJECT TO DEDUCTIBLES AND COINSURANCE - CHARGES, Other Outpatient Services (D_5_HOS_C4_93)",Total Hospital Interns & Residents (S3_1_C10_14),Radiology-Diagnostic (D_4_IPF_C11_54),CAH Visits (S3_1_C8_15),"HHA II, LUPA Episodes:  Total Number of Episodes (S4_HHA2_C3_36)",Impl. Dev. Charged to Patients (D_4_HOS_C2_72),"Depreciation, Total (A7_3_C9_3)","AMOUNT REPORTED, Dietary (S3_2_C2_34)",Laboratory (A_C1_60),Speech Pathology (D_4_IRF_C13_68),Report Record Number (RPT_REC_NUM),Hospice (A_C2_116),Other Ancillary (D_4_SNF_C11_76),Cardiac Catheterization (D_4_HOS_C3_59),Occupational Therapy (D3_HOS_C3_67),"COST SERVICES NOT SUBJECT TO DEDUCTIBLES AND COINSURANCE - COST, Medical Supplies Charged to Patients (D_5_HOS_C7_71)",Emergency (B_1_C26_91),"AMOUNT REPORTED, Interns & Residents (S3_2_C2_2550)",Other Outpatient Services (D_4_HOS_C10_93),Islet Acquisition (C_1_C5_111),RHC (D_4_HOS_C2_88),Intravenous Therapy (D_4_HOS_C3_64),Durable Medical Equipment Rented (D3_IPF_C2_96),Other Outpatient Services (D3_SNF_C3_93),Kidney Acquisition (A_C6_105),FQHC (B_2_C26_89),Radioisotope (D3_HOS_C2_56),Drugs Charged to Patients (D_4_HOS_C11_73),Total Other Medical Education Cost (D_3_HOS_C3_200),"Net Expense for Cost Allocation, Ambulance Services (B_1_C0_95)",Delivery Room and Labor Room (D3_IPF_C3_52),"AMOUNT REPORTED, Wage Related Costs Other (S3_2_C2_18)",Respiratory Therapy (D_4_HOS_C2_65),Occupational Therapy (D3_IPF_C2_67),Title XVIII discharges (S3_1_C13_14),Other Outpatient Services (B_2_C26_93),"COST REIMBURSED SERVICES SUBJECT TO DEDUCTIBLES  AND COINSURANCE - CHARGES, Total (D_5_HOS_C3_200)",Ambulance Services (C_1_C5_95),"HHA I, With Outliers:  Number of Episodes (S4_HHA1_C2_37)","COST SERVICES SUBJECT TO DEDUCTIBLES AND COINSURANCE - COST, Blood Clotting Factors for Hemoph. (D_5_HOS_C6_6250)",Radiology-Diagnostic (D_4_HOS_C10_54),Delivery Room and Labor Room (D_4_IPF_C11_52),HHA (A_C2_101),"PPS REIMBURSED SERVICES -  CHARGES, Laboratory (D_5_HOS_C2_60)","COST REIMBURSED SERVICES NOT SUBJECT TO DEDUCTIBLES AND COINSURANCE - CHARGES, Electrocardiology (D_5_HOS_C4_69)",Intensive Care Unit (D_3_HOS_C9_31),Payments received from patients for amounts previously written off as charity care (S10_C1_22),Total Hospital (S3_1_C5_14),Operating Room (D3_HOS_C3_50),"PPS SERVICES COST, Medical Supplies Charged to Patients (D_5_HOS_C5_71)",Tentative settlement (E_B_HOS_C1_42),"AMOUNT REPORTED, Dietary under contract (S3_2_C2_35)",FI/Contractor's Name (S2_1_C2_140),Speech Pathology (D_4_HOS_C4_68),"PAID HOURS RELATED TO SALARIES, Management and Administrative Services (S3_2_C5_12)","Total Inpatient Charges, Intensive Care Unit (C_1_C6_31)",Telephone Services (A8_C2_7),Total (D_4_HOS_C11_200),"Allocation of Interns & Residents Program Costs, Occupational Therapy (B_1_C22_67)",Radiology-Therapeutic (D_4_IRF_C13_55),Balance due provider/program (E_B_HOS_C1_43),Kidney Acquisition (B_2_C26_105),"COST SERVICES SUBJECT TO DEDUCTIBLES AND COINSURANCE - COST, Blood Storing, Processing, Trans (D_5_HOS_C6_63)",IPF (S3_1_C6_16),Radioisotope (D3_IPF_C2_56),MRI (D_4_SNF_C11_58),Respiratory Therapy (D3_IPF_C2_65),Related Organization Transactions (A8_C2_12),Respiratory Therapy (D_4_HOS_C10_65),"Total Inpatient Charges, Radiology-Therapeutic (C_1_C6_55)",Drugs Charged to Patients (D3_IPF_C3_73),Renal Dialysis (D_4_IRF_C13_74),OSP (B_2_C26_9940),"COST REIMBURSED SERVICES NOT SUBJECT TO DEDUCTIBLES AND COINSURANCE - CHARGES, Medical Supplies Charged to Patients (D_5_HOS_C4_71)","Blood Storing, Processing, Trans (D_4_IPF_C13_63)","Interest, New Cap Related Csts Bldg & Fixtures (A7_3_C11_1)",Clinic (D_4_HOS_C10_90),Number of periods hospital was in MDH status (S2_1_C1_37),Coronary Care Unit (S3_1_C4_9),Kidney Acquisition (A_C1_105),Total (D_1_HOS_C4_200),"COST SERVICES SUBJECT TO DEDUCTIBLES AND COINSURANCE - COST, ASC (Non Distinct Part) (D_5_HOS_C6_75)",Burn Intensive Care Unit (A_C1_33),Radiology-Diagnostic (D_4_HOS_C13_54),Laboratory (D3_IPF_C2_60),Operating Room (D_4_IRF_C11_50),"Net Expense for Cost Allocation, Home Program Dialysis (B_1_C0_94)",SNF (S3_1_C2_19),Other Reimbursable (D3_SNF_C3_98),New Capital Equipment (A_C2_2),Cardiac Catheterization (C_1_C5_59),Subprovider-IPF (D_3_HOS_C9_40),Observation Beds (Distinct Unit) (D_4_IRF_C11_9201),Allowable Inpatient Cost Plus Incentive Pt (D1_HOS_C1_63),Observation Beds (Distinct Unit) (D_4_HOS_C13_9201),Renal 8 Provider Number (S2_1_C2_1807),"General Inpatient Routine Service Cost, net of Swing Bed and Private Room Diff (D1_HOS_C1_37)",Renal 1 Provider Number (S2_1_C2_18),"Net Expense for Cost Allocation, Observation Beds (Distinct Unit) (B_1_C0_9201)",Coronary Care Unit (D3_HOS_C2_32),Radiology-Therapeutic (A_C6_55),"Donations, Movable Equipment (A7_1_C3_6)",Electrocardiology (D3_SNF_C2_69),"AVERAGE HOURLY WAGE, Net Salaries (S3_3_C6_1)",Int & Res (non approved teaching program (A_C6_100),Laboratory (D3_IRF_C2_60),"PPS SERVICES COST, Whole Blood & Packed Red Blood Cells (D_5_HOS_C5_62)","AVERAGE HOURLY WAGE, Subtotal Other Wages and Related Csts (S3_3_C6_4)","Purchases, Building Improvements (A7_1_C2_4)",Renal Dialysis (D_4_HOS_C2_74),Electrocardiology (B_1_C26_69),Hospice (C_1_C5_116),"COST SERVICES NOT SUBJECT TO DEDUCTIBLES AND COINSURANCE - COST, Clinic (D_5_HOS_C7_90)",Medical Supplies Charged to Patients (D3_SNF_C2_71),"COST REIMBURSED SERVICES SUBJECT TO DEDUCTIBLES  AND COINSURANCE - CHARGES, Intravenous Therapy (D_5_HOS_C3_64)",Hospital Adults & Pediatrics (S3_1_C4_1),"COST SERVICES NOT SUBJECT TO DEDUCTIBLES AND COINSURANCE - COST, ASC (Non Distinct Part) (D_5_HOS_C7_75)",Clinic (D_4_SNF_C11_90),RHC 11 Provider Number (S2_1_C2_1510),Clinic (A_C2_90),CORF (A_C1_9910),RHC (A_C1_88),OLTC (A_C1_46),Kidney Acquisition (B_1_C21_105),"Allocation of Interns & Residents Program Costs, CT Scan (B_1_C22_57)",Other Special Care Unit (D_1_HOS_C7_35),CT Scan (D_4_HOS_C11_57),"PPS SERVICES COST, Renal Dialysis (D_5_HOS_C5_74)",Other Nonreimbursable (B_1_C21_194),Adjusted reimburseable bad debts (E_B_HOS_C1_35),HHA (A_C1_101),MRI (D3_HOS_C2_58),"Net Expense for Cost Allocation, Emergency (B_1_C0_91)","HHA I, PEP:  Total Number of Outlier Episodes (S4_HHA1_C4_37)","Allocation of Interns & Residents Salary and Fringes, Cardiac Catheterization (B_1_C21_59)",Radioisotope (D3_SNF_C2_56),"COST SERVICES SUBJECT TO DEDUCTIBLES AND COINSURANCE - COST, Other Reimbursable (D_5_HOS_C6_98)",Speech Pathology (D_4_HOS_C3_68),SNF Provider Number (S2_1_C2_9),Physical Therapy (D_4_HOS_C4_66),Coronary Care Unit (D3_IPF_C2_32),"HHA II, Without Outliers:  Total Charges (S4_HHA2_C1_35)","Beginning Balances, Building Improvements (A7_1_C1_4)",Burn Intensive Care Unit (S3_1_C6_10),Medicare reimbursable bad debts for the entire hospital complex (S10_C1_27),Have you established a new subprovider excluded unit under 42 CFR 413.40(f)(1)(I)?(Y/N) (S2_1_C1_86),Labor and Delivery Days Title 18 (S3_1_C6_32),Intravenous Therapy (D_4_HOS_C4_64),"COST SERVICES SUBJECT TO DEDUCTIBLES AND COINSURANCE - COST, Anesthesiology (D_5_HOS_C6_53)","AVERAGE HOURLY WAGE, Nursing Administration (S3_2_C6_38)",NF (S3_1_C7_20),Intensive Care Unit (C_1_C5_31),Electroencephalography (C_1_C5_70),"Allocation of Interns & Residents Salary and Fringes, MRI (B_1_C21_58)","PPS REIMBURSED SERVICES -  CHARGES, MRI (D_5_HOS_C2_58)",Speech Pathology (D3_IRF_C3_68),"PPS SERVICES COST, Total (D_5_HOS_C5_200)",CT Scan (A_C6_57),HHA (S3_1_C9_22),"Net Expense for Cost Allocation, Other Special Purpose (B_1_C0_117)",Lung  Acquisition (C_1_C6_108),Recovery Room (D_4_HOS_C10_51),"HHA I, Total Charges (S4_HHA1_C5_35)","Allocation of Interns & Residents Salary and Fringes, Coronary Care Unit (B_1_C21_32)","Blood Storing, Processing, Trans (D_4_HOS_C13_63)",Home Program Dialysis (D_4_HOS_C11_94),"HHA III, LUPA Episodes:  Other Charges (S4_HHA3_C3_34)",Delivery Room and Labor Room (A_C6_52),"PPS SERVICES COST, Blood Storing, Processing, Trans (D_5_HOS_C5_63)",Drugs Charged to Patients (D3_IRF_C2_73),"PPS REIMBURSED SERVICES -  CHARGES, CT Scan (D_5_HOS_C2_57)","Allocation of Interns & Residents Salary and Fringes, Recovery Room (B_1_C21_51)",Occupational Therapy (D_4_IRF_C11_67),CORF (C_1_C7_9910),"COST REIMBURSED SERVICES NOT SUBJECT TO DEDUCTIBLES AND COINSURANCE - CHARGES, Renal Dialysis (D_5_HOS_C4_74)",Speech Pathology (C_1_C7_68),"COST SERVICES SUBJECT TO DEDUCTIBLES AND COINSURANCE - COST, Respiratory Therapy (D_5_HOS_C6_65)","COST REIMBURSED SERVICES SUBJECT TO DEDUCTIBLES  AND COINSURANCE - CHARGES, Physical Therapy (D_5_HOS_C3_66)","Net Expense for Cost Allocation, Whole Blood & Packed Red Blood Cells (B_1_C0_62)",Adults and Pediatrics (D3_SNF_C2_30),Title XVIII discharges (S3_1_C13_16),"COST REIMBURSED SERVICES SUBJECT TO DEDUCTIBLES  AND COINSURANCE - CHARGES, PBP Clinical Lab Services Program Only (D_5_HOS_C3_61)",NOT IN THIS FILE (TRNSMTL_NUM),"Allocation of Interns & Residents Program Costs, Subprovider-IPF (B_1_C22_40)",Observation Beds (Distinct Unit) (A_C6_9201),Subprovider 1 (S3_1_C3_18),"ADJUSTED SALARIES, Non-Physician Anesthetist Part B (S3_2_C4_3)",NF (B_1_C26_45),"Beginning Balances, Buildings and Fixtures (A7_1_C1_3)",Radioisotope (D_4_IPF_C13_56),Operating Room (D3_IRF_C2_50),Hospital PO Box (S2_1_C2_1),"Net Expense for Cost Allocation, Operating Room (B_1_C0_50)","PAID HOURS RELATED TO SALARIES, Non-Physician Part B (S3_2_C5_6)",Other Outpatient Services (D3_HOS_C2_93),"HHA II, PEP:  Total Number of Outlier Episodes (S4_HHA2_C4_37)",Renal Dialysis (D3_SNF_C2_74),Clinic (D_4_IRF_C11_90),Blood Clotting Factors for Hemoph. (D_4_HOS_C10_6250),Occupational Therapy (D_4_HOS_C12_67),Subprovider-IPF (A_C1_40),OSP (C_1_C6_9940),"HHA I, PEP:  Total Non Routine Med Supply Chgs (S4_HHA1_C4_38)","COST SERVICES NOT SUBJECT TO DEDUCTIBLES AND COINSURANCE - COST, Electroencephalography (D_5_HOS_C7_70)",Laboratory (A_C6_60),Hospital Adlts & Ped Swing Bed NF (S3_1_C8_6),CT Scan (D3_IPF_C2_57),"Net Expense for Cost Allocation, Paramedical Education (B_1_C0_23)",Renal 3 Provider Number (S2_1_C2_1802),"AMOUNT REPORTED, Interns & Residents (S3_2_C3_2552)",Medical Supplies Charged to Patients (D3_IRF_C2_71),Physical Therapy (D3_IPF_C3_66),Emergency (A_C6_91),"Net Expense for Cost Allocation, Pancreas Acquisition (B_1_C0_109)",Medical Supplies Charged to Patients (D3_IPF_C2_71),OLTC (S3_1_C9_21),ASC (Distinct Part) (B_1_C26_115),Speech Pathology (C_1_C2_68),Blood Clotting Factors for Hemoph. (D_4_HOS_C3_6250),Provider's actual MSA or CBSA (S2_1_C3_3),ASC (Non Distinct Part) (A_C1_75),RHC 5 Provider Number (S2_1_C2_1504),HAC reduction adjustment amount (E_A_HOS_C1_7099),Other Special Care Unit (D3_IRF_C2_35),Burn Intensive Care Unit (S3_1_C8_10),"Net Expense for Cost Allocation, Nursing School (B_1_C0_20)","HHA III, PEP:  Total Non Routine Med Supply Chgs (S4_HHA3_C4_38)","HHA I, LUPA Episodes:  Total Visits (S4_HHA1_C3_33)",RHC 16 Provider Number (S2_1_C2_1515),"Average patient dialysis time 
including setup (S5_C4_3)","Is this a teaching hospital or
affiliated with a teaching hospital? (Y/N) (S2_1_C1_56)","COST SERVICES SUBJECT TO DEDUCTIBLES AND COINSURANCE - COST, Home Program Dialysis (D_5_HOS_C6_94)",Outpatient Rehab Provider (S3_1_C8_25),Medical Supplies Charged to Patients (B_1_C26_71),Home Program Dialysis (D3_IRF_C2_94),Home Program Dialysis (A_C2_94),Electroencephalography (D3_IPF_C2_70),Burn Intensive Care Unit (D_1_HOS_C6_33),Emergency (D3_SNF_C2_91),Subtotal (E_B_HOS_C1_40),"Fully Depreciated Assets, Assets (A7_1_C7_7)",FQHC (B_1_C22_89),"Average patient dialysis time 
including setup (S5_C1_3)",FQHC (C_1_C7_89),Physical Therapy (A_C2_66),Other Ancillary (B_1_C21_76),"AVERAGE HOURLY WAGE, Cafeteria (S3_2_C6_36)",Subprovider 1 (S3_1_C7_18),Ambulance Trips (S3_1_C6_29),ASC (Non Distinct Part) (D3_SNF_C3_75),"AVERAGE HOURLY WAGE, Laundry and Linen Service (S3_2_C6_31)",Pass Through Cost for  Program Ancillary (D1_IRF_C1_51),"Net Expense for Cost Allocation, Maintenance of Personnel (B_1_C0_12)",Cardiac Catheterization (D_4_IPF_C11_59),Coronary Care Unit (C_1_C5_32),Radiology-Therapeutic (D3_SNF_C3_55),"COST REIMBURSED SERVICES NOT SUBJECT TO DEDUCTIBLES AND COINSURANCE - CHARGES, Other Reimbursable (D_5_HOS_C4_98)","COST REIMBURSED SERVICES SUBJECT TO DEDUCTIBLES  AND COINSURANCE - CHARGES, Occupational Therapy (D_5_HOS_C3_67)","Net Expense for Cost Allocation, Other Ancillary (B_1_C0_76)",Total (D_1_HOS_C6_200),Radioisotope (D_4_IPF_C11_56),Net Revenue from stand-alone SCHIP (S10_C1_9),Renal Dialysis (B_1_C22_74),Subprovider-IPF (A_C6_40),Hospice (S3_1_C9_24),Radiology-Diagnostic (A_C6_54),Dietary (A_C1_10),Pass Through Cost for  Program Ancillary (D1_IPF_C1_51),Coronary Care Unit (D_3_HOS_C9_32),Respiratory Therapy (D_4_HOS_C11_65),Renal Dialysis (B_1_C26_74),IPPS Payment amount (unadjusted) (E_A_HOS_C1_59),ASC (Non Distinct Part) (D_4_HOS_C4_75),Emergency (A_C2_91),"ADJUSTED SALARIES, Interns & Residents (S3_2_C4_7)",Nonpaid Workers (A_C6_193),ASC (Distinct Part) (C_1_C5_115),Whole Blood & Packed Red Blood Cells (B_1_C26_62),Medicare Certified Islet TC term date (S2_1_C2_132),Whole Blood & Packed Red Blood Cells (D_4_HOS_C2_62),Electrocardiology (D_4_HOS_C3_69),Subprovider-IRF (D3_IRF_C2_41),"COST SERVICES NOT SUBJECT TO DEDUCTIBLES AND COINSURANCE - COST, Total (D_5_HOS_C7_200)","COST REIMBURSED SERVICES SUBJECT TO DEDUCTIBLES  AND COINSURANCE - CHARGES, Speech Pathology (D_5_HOS_C3_68)",Impl. Dev. Charged to Patients (D_4_IPF_C13_72),Total Program Inpatient Costs (D1_HOS_C1_49),Observation Beds (Distinct Unit) (D_4_HOS_C10_9201),Anesthesiology (D3_IRF_C2_53),Durable Medical Equipment Sold (A_C2_97),Radiology-Therapeutic (D_4_HOS_C3_55),Surgical Intensive Care Unit (S3_1_C5_11),"COST SERVICES NOT SUBJECT TO DEDUCTIBLES AND COINSURANCE - COST, Operating Room (D_5_HOS_C7_50)",Electroencephalography (D_4_HOS_C4_70),Delivery Room and Labor Room (C_1_C5_52),Anesthesiology (D_4_HOS_C4_53),Subprovider 2 (S3_1_C3_1801),"PAID HOURS RELATED TO SALARIES, Non-Physician Anesthetist Part A (S3_2_C5_2)",Coronary Care Unit (S3_1_C3_9),Intensive Care Unit (S3_1_C7_8),"Number of Times per week 
Patient receives Dialysis (S5_C3_2)",Physical Therapy (D_4_HOS_C3_66),Speech Pathology (B_2_C26_68),Hospital Adults & Pediatrics (S3_1_C8_1),Islet Acquisition (B_1_C22_111),Allowable bad debts for dual eligibles beneficiaries (E_B_HOS_C1_36),"Allocation of Interns & Residents Salary and Fringes, CT Scan (B_1_C21_57)","Net Expense for Cost Allocation, ASC (Non Distinct Part) (B_1_C0_75)",Operating Room (A_C6_50),Intestinal Acquisition (B_2_C26_110),RPCH/CAH Visits (S3_1_C6_15),CMHC (B_1_C26_99),Total Nursing School (D_4_HOS_C2_200),OOT (C_1_C7_9930),CMHC (C_1_C6_99),Total Program General Inpatient Routine (D1_IPF_C1_41),Medicare Certified Lung TC term date (S2_1_C2_129),Subprovider-IRF (C_1_C5_41),Nursing Administration (A_C2_13),"PAID HOURS RELATED TO SALARIES, Total (S3_3_C5_6)",Respiratory Therapy (D3_IRF_C3_65),"HHA I, With Outliers:  Total Charges (S4_HHA1_C2_35)",Nursery (S3_1_C5_13),Total discharges (S3_1_C15_14),Labor and Delivery Days -  Title XIX (S3_1_C7_32),Radiology-Diagnostic (D3_IPF_C3_54),Bonus Payment (D1_HOS_C1_58),Surgical Intensive Care Unit (D_1_HOS_C7_34),Other Special Care (S3_1_C7_12),SNF (S3_1_C8_19),Physical Therapy (B_2_C26_66),Liver Acquisition (B_1_C22_107),"HHA I, W/Out Outliers:  Number of Episodes (S4_HHA1_C1_36)",Pass Through Cost for  Program Ancillary (D1_HOS_C1_51),"HHA II, Total Non Routine Medical  Supply Charges (S4_HHA2_C5_38)",Total costs for patients covered by a state or local government program (S10_C1_15),"Net Expense for Cost Allocation, Surgical Intensive Care Unit (B_1_C0_34)","Number of patients in program at 
end of cost reporting period (S5_C2_1)",Radiology-Therapeutic (D_4_IRF_C11_55),"Total, New Cap Related Csts Movable Equipment (A7_3_C15_2)",Intestinal Acquisition (A_C6_110),"HHA I, Without Outliers:  Total Charges (S4_HHA1_C1_35)","If this facility qualifies as a RPCH/CAH, has it elected the all inclusive payment for outpatient service? (Y/N) (S2_1_C1_106)",Intensive Care Unit (B_1_C26_31),Laboratory (B_1_C26_60),"Net Expense for Cost Allocation, OLTC (B_1_C0_46)","Beginning Balances, Fixed Equipment (A7_1_C1_5)",Employee Benefits (A_C6_4),"PPS REIMBURSED SERVICES -  CHARGES, Other Outpatient Services (D_5_HOS_C2_93)",Int & Res (non approved teaching program (C_1_C7_100),Medical Records and Medical Rec. Library (A_C6_16),"PPS SERVICES COST, Anesthesiology (D_5_HOS_C5_53)",Occupational Therapy (D3_SNF_C2_67),Radiology-Therapeutic (D_4_HOS_C10_55),Clinic (B_2_C26_90),Durable Medical Equipment Rented (C_1_C5_96),Intensive Care Unit Program Cost (D1_HOS_C5_43),Nonpaid Workers (A_C1_193),Intensive Care Unit (D_1_HOS_C6_31),"AMOUNT REPORTED, Non-Physician Anesthetist Part A (S3_2_C2_2)",Depreciation-New Movable Equipment (A8_C2_27),FQHC 7 Provider Number (S2_1_C2_1606),Other Ancillary (B_1_C22_76),Clinic (C_1_C6_90),ASC (Distinct Part) (A_C2_115),"Total Inpatient Charges, ICF (C_1_C6_4501)",Home Program Dialysis (A_C6_94),Total Salaries (A_C6_200),Clinic (D3_IRF_C3_90),State or local govt (not Medicaid or CHIP) -- Costs minus net revenue (0 min) (S10_C1_16),Radioisotope (D_4_HOS_C13_56),"PPS SERVICES COST, Radiology-Diagnostic (D_5_HOS_C5_54)",Impl. Dev. Charged to Patients (D_4_HOS_C13_72),Total unreimbursed and uncompensated care (S10_C1_31),Other Organ Acquisition (B_1_C26_112),PBP Clinical Lab Services Program Only (C_1_C5_61),"PPS SERVICES COST, Radioisotope (D_5_HOS_C5_56)","Disposals and Retirements, Building Improvements (A7_1_C5_4)",Renal Dialysis (D3_IPF_C2_74),Nursing School (A_C6_20),Subtotal (C_1_C5_200),Organ Procurement (D4_ISLET_C1_69),Drugs Charged to Patients (D3_IPF_C2_73),Drugs Charged to Patients (D_4_HOS_C3_73),Home Office PO Box (S2_1_C2_142),"TOTAL CAPITAL COSTS AFTER COST ALLOCATION, Intensive Care Unit (B_2_C26_31)",Is this a rural hospital qualifying for an exception to the certified registered nurse anesthetist the CRNA fee schedule? (Y/N) (S2_1_C1_108),"PAID HOURS RELATED TO SALARIES, Housekeeping (S3_2_C5_32)",Nursing School (A_C2_20),Laboratory (D_4_IPF_C13_60),CT Scan (D3_HOS_C3_57),Subprovider-IRF (D3_HOS_C2_41),Other Outpatient Services (D3_IPF_C2_93),Operation of Plant (A_C1_7),Geographic MSA (MSA),Speech Pathology (D3_HOS_C3_68),"PAID HOURS RELATED TO SALARIES, Housekeeping under Contract (S3_2_C5_33)","COST SERVICES NOT SUBJECT TO DEDUCTIBLES AND COINSURANCE - COST, Drugs Charged to Patients (D_5_HOS_C7_73)",Other Ancillary (A_C6_76),Electroencephalography (D3_IRF_C3_70),"Depreciation, New Cap Related Csts Bldg & Fixtures (A7_3_C9_1)","Allocation of Interns & Residents Program Costs, Coronary Care Unit (B_1_C22_32)",Electrocardiology (D_4_SNF_C11_69),"PPS REIMBURSED SERVICES -  CHARGES, Radioisotope (D_5_HOS_C2_56)","AMOUNT REPORTED, Interns & Residents (S3_2_C3_25)",Total Hospital (S3_1_C3_7),Medical Supplies Charged to Patients (D_4_IPF_C11_71),Laboratory (A_C2_60),"AMOUNT REPORTED, Nursing Administration (S3_2_C2_38)",Electrocardiology (A_C6_69),"TOTAL CAPITAL COSTS AFTER COST ALLOCATION, Anesthesiology (B_2_C26_53)",CT Scan (D_4_SNF_C11_57),CT Scan (A_C2_57),ASC (Non Distinct Part) (D_4_HOS_C10_75),Other Ancillary (D_4_HOS_C13_76),Blood Clotting Factors for Hemoph. (A_C6_6250),"Total Inpatient Charges, CT Scan (C_1_C6_57)",Other Special Care Unit (D3_SNF_C2_35),Radiology-Therapeutic (A_C1_55),"PPS SERVICES COST, Other Ancillary (D_5_HOS_C5_76)","AMOUNT REPORTED, Home Office Salaries (S3_2_C3_1401)",Recovery Room (D_4_IPF_C13_51),Medical Supplies Charged to Patients (D3_HOS_C3_71),Laboratory (D3_IPF_C3_60),"PAID HOURS RELATED TO SALARIES, Administrative and General under Contract (S3_2_C5_28)",Radiology-Diagnostic (D3_HOS_C3_54),Intestinal Acquisition (B_1_C26_110),Research (B_1_C21_191),"ADJUSTED SALARIES, Wage Related Costs RHC/FQHC (S3_2_C4_24)",Blood Clotting Factors for Hemoph. (B_1_C26_6250),"ADJUSTED SALARIES, Interns & Residents (S3_2_C4_2553)","HHA III, Without Outliers:  Total Charges (S4_HHA3_C1_35)",Drugs Charged to Patients (D3_HOS_C3_73),Intravenous Therapy (D3_IRF_C3_64),Medicare Certified Pancreas TC term date (S2_1_C2_130),Operating Room (D_4_SNF_C11_50),Durable Medical Equipment Sold (D_4_HOS_C12_97),Radioisotope (D_4_IRF_C13_56),"TOTAL CAPITAL COSTS AFTER COST ALLOCATION, Other Special Care Unit (B_2_C26_35)",RHC 9 Provider Number (S2_1_C2_1508),"Insurance, New Cap Related Csts Movable Equipment (A7_3_C5_2)",Speech Pathology (D3_IPF_C2_68),"Total Program Inpatient Operating Cost excluding Capital Related, Nonphysician, Anesthetist, and Medical Education Costs (D1_HOS_C1_53)",Other Special Purpose (A_C1_117),RHC 12 Provider Number (S2_1_C2_1511),"ADJUSTED SALARIES, Related Salaries (S3_2_C4_1402)",Other Special Purpose (A_C6_117),Electroencephalography (B_1_C26_70),RHC (A_C2_88),Home Program Dialysis (D_4_HOS_C3_94),Recovery Room (D3_HOS_C2_51),"COST REIMBURSED SERVICES SUBJECT TO DEDUCTIBLES  AND COINSURANCE - CHARGES, Laboratory (D_5_HOS_C3_60)","HHA III, PEP:  Total Number of Outlier Episodes (S4_HHA3_C4_37)",Radiology-Diagnostic (B_1_C26_54),Pharmacy (A_C6_15),ASC (Non Distinct Part) (D3_IRF_C2_75),RHC 14 Provider Number (S2_1_C2_1513),FQHC 2 Provider Number (S2_1_C2_1601),Cardiac Catheterization (D3_IPF_C2_59),Nonphysician Anesthetists (A_C2_19),Islet Acquisition (A_C6_111),Whole Blood & Packed Red Blood Cells (D3_SNF_C2_62),Government grants or appropriations or transfers for support of hospital operations (S10_C1_18),Occupational Therapy (D_4_HOS_C3_67),Radioisotope (A_C1_56),"Allocation of Interns & Residents Salary and Fringes, Speech Pathology (B_1_C21_68)",Other Special Care Unit (D_3_HOS_C9_35),NF (S3_1_C8_20),Other Reimbursable (D_4_HOS_C10_98),Title XIX discharges (S3_1_C14_17),Intravenous Therapy (A_C6_64),"Fully Depreciated Assets, Total (A7_1_C7_10)","Net Expense for Cost Allocation, Housekeeping (B_1_C0_9)",Recovery Room (D_4_IRF_C11_51),"Allocation of Interns & Residents Program Costs, Physical Therapy (B_1_C22_66)",OLTC (A_C6_46),Electrocardiology (D_4_IPF_C13_69),Medical and Other Services (E_B_HOS_C1_1),"COST REIMBURSED SERVICES NOT SUBJECT TO DEDUCTIBLES AND COINSURANCE - CHARGES, Occupational Therapy (D_5_HOS_C4_67)","COST SERVICES NOT SUBJECT TO DEDUCTIBLES AND COINSURANCE - COST, Occupational Therapy (D_5_HOS_C7_67)","Total, New Cap Related Csts Bldg & Fixtures (A7_3_C15_1)","ADJUSTED SALARIES, Dietary (S3_2_C4_34)",Intensive Care Unit (S3_1_C4_8),Depreciation-New Bldgs & Fixtures (A8_C2_26),"Blood Storing, Processing, Trans (D3_HOS_C2_63)",Total (B_1_C26_202),Total charges to state or local government programs for indigent care (not Medicaid or CHIP) (S10_C1_14),OLTC (S3_1_C10_21),Intravenous Therapy (D_4_HOS_C10_64),OOT (B_2_C26_9930),ASC (Distinct Part) (C_1_C7_115),"Allocation of Interns & Residents Program Costs, Whole Blood & Packed Red Blood Cells (B_1_C22_62)","HHA I, LUPA Episodes:  Other Charges (S4_HHA1_C3_34)","Blood Storing, Processing, Trans (D3_IRF_C3_63)",Charity care charges and uninsured discounts for the entire facility (S10_C2_20),Ancillary service charges (E_B_HOS_C1_12),"PAID HOURS RELATED TO SALARIES, Operation of Plant (S3_2_C5_30)",Whole Blood & Packed Red Blood Cells (D_4_IPF_C11_62),Recovery Room (D3_HOS_C3_51),Hospital State (S2_1_C2_2),"Allocation of Interns & Residents Salary and Fringes, Occupational Therapy (B_1_C21_67)",Other Special Care Unit (D_1_HOS_C4_35),"Blood Storing, Processing, Trans (D3_IPF_C3_63)",Adults & Pediatrics (D_3_HOS_C9_30),"HHA I, Without Outliers:  Total Visits (S4_HHA1_C1_33)",OSP (C_1_C5_9940),Target Amount per Discharge (D1_HOS_C1_55),Other Outpatient Services (D3_IRF_C2_93),"PPS REIMBURSED SERVICES -  CHARGES, Cardiac Catheterization (D_5_HOS_C2_59)",Total Allied Health (D_4_IPF_C3_200),Coronary Care Unit (A_C2_32),ICF (A_C2_4501),Title XIX discharges (S3_1_C14_16),Occupational Therapy (D3_IPF_C3_67),Cost of charity care (uninsured patients + patients w/ coverage not accepted by provider) (S10_C1_23),Lesser of cost or charges (E_B_HOS_C1_21),Other Nonreimbursable (B_1_C26_194),Other Reimbursable (A_C6_98),Coronary Care Unit (S3_1_C5_9),"Total Inpatient Charges, Nursery (C_1_C6_43)",Int & Res (non approved teaching program (B_2_C26_100),CT Scan (D3_IPF_C3_57),Liver Acquisition (C_1_C7_107),Electroencephalography (D3_HOS_C3_70),Excess of customary charges (E_B_HOS_C1_19),Durable Medical Equipment Sold (D_4_HOS_C13_97),"COST SERVICES NOT SUBJECT TO DEDUCTIBLES AND COINSURANCE - COST, Home Program Dialysis (D_5_HOS_C7_94)",Surgical Intensive Care Unit (S3_1_C2_11),Total Facility FTEs (S3_1_C9_27),Radiology-Diagnostic (A_C1_54),Liver Acquisition (B_1_C21_107),Average times dialyzers re-used (S5_C1_9),IPF (S3_1_C2_16),HHA (S3_1_C11_22),"PPS SERVICES COST, Electroencephalography (D_5_HOS_C5_70)",Number of stations (S5_C3_6),Electrocardiology (D_4_HOS_C4_69),Operating Room (A_C1_50),Radiology-Therapeutic (D_4_HOS_C13_55),Laundry and Linen Service (A_C6_8),Nursery (D_1_HOS_C4_43),Subprovider-IRF (D_1_HOS_C7_41),Radiology-Therapeutic (D_4_HOS_C11_55),"COST REIMBURSED SERVICES SUBJECT TO DEDUCTIBLES  AND COINSURANCE - CHARGES, Home Program Dialysis (D_5_HOS_C3_94)",Ending Date of SCH status (S2_1_C2_3601),"ADJUSTED SALARIES, Management and Administrative Services (S3_2_C4_12)",Subprovider II (A_C6_4201),"Allocation of Interns & Residents Program Costs, Other Special Care Unit (B_1_C22_35)",Renal Dialysis (D_4_IRF_C11_74),Respiratory Therapy (D3_IRF_C2_65),"ADJUSTED SALARIES, Laundry and Linen Service (S3_2_C4_31)","Net Expense for Cost Allocation, Central Services and Supply (B_1_C0_14)",Physical Therapy (D_4_IRF_C13_66),Radiology-Therapeutic (D3_IPF_C2_55),Cardiac Catheterization (A_C2_59),Cardiac Catheterization (D3_SNF_C3_59),"COST SERVICES NOT SUBJECT TO DEDUCTIBLES AND COINSURANCE - COST, Observation Beds (Distinct Unit) (D_5_HOS_C7_9201)","PPS REIMBURSED SERVICES -  CHARGES, Observation Beds (Distinct Unit) (D_5_HOS_C2_9201)",Television and Radio Service (A8_C2_8),"Net Expense for Cost Allocation, Delivery Room and Labor Room (B_1_C0_52)","AVERAGE HOURLY WAGE, Central Services and Supply (S3_2_C6_39)",ASC (Non Distinct Part) (D_4_HOS_C3_75),Intravenous Therapy (D3_IRF_C2_64),Home Program Dialysis (D3_SNF_C3_94),Maintenance and Repairs (A_C2_6),"Lease, Total (A7_3_C10_3)",Swing Bed NF Provider Number (S2_1_C2_8),Other Special Care (S3_1_C5_12),"HHA II, PEP Episodes:  Total Visits (S4_HHA2_C4_33)",Drugs Charged to Patients (D_4_HOS_C10_73),Home Program Dialysis (D3_SNF_C2_94),"Allocation of Interns & Residents Salary and Fringes, OLTC (B_1_C21_46)",HHA (S3_1_C10_22),Cardiac Catheterization (D_4_HOS_C12_59),Observation Beds (Distinct Unit) (D3_HOS_C3_9201),Title XIX discharges (S3_1_C14_14),"COST REIMBURSED SERVICES SUBJECT TO DEDUCTIBLES  AND COINSURANCE - CHARGES, Clinic (D_5_HOS_C3_90)",Refunds and Rebates of Expenses (A8_C2_5),RHC (C_1_C5_88),Payments received from patients for amounts previously written off as charity care (S10_C2_22),"COST SERVICES NOT SUBJECT TO DEDUCTIBLES AND COINSURANCE - COST, Emergency (D_5_HOS_C7_91)","Allocation of Interns & Residents Program Costs, Electrocardiology (B_1_C22_69)",Home Program Dialysis (B_1_C22_94),ASC (Non Distinct Part) (D3_HOS_C2_75),"Blood Storing, Processing, Trans (C_1_C6_63)","Allocation of Interns & Residents Salary and Fringes, Electroencephalography (B_1_C21_70)",Hospice (S3_1_C11_24),Other Reimbursable (C_1_C5_98),"ADJUSTED SALARIES, Contract Labor:  Physician Part A (S3_2_C4_13)",Burn Intensive Care Unit (S3_1_C2_10),Radioisotope (B_1_C26_56),Emergency (D3_HOS_C2_91),Self Insurance (S2_1_C3_11801),Emergency (D_4_IPF_C11_91),Total Outpatient Program Pass Thru Cost (D_4_IPF_C6_200),"Net Expense for Cost Allocation, FQHC (B_1_C0_89)",CMHC (C_1_C5_99),Anesthesiology (D_4_HOS_C10_53),"Disposals and Retirements, Land Improvements (A7_1_C5_2)",Hospice (S3_1_C3_24),Intravenous Therapy (D_4_SNF_C11_64),"PAID HOURS RELATED TO SALARIES, Non-Physician Anesthetist Part B (S3_2_C5_3)",Anesthesiology (D_4_HOS_C3_53),Laboratory (D_4_IPF_C11_60),Non-physician Anesthetist (A8_C2_28),OOT (C_1_C5_9930),Radiology-Diagnostic (D3_IRF_C2_54),Radiology-Therapeutic (D3_IRF_C2_55),MRI (D3_IRF_C3_58),"ADJUSTED SALARIES, Non-Physician Anesthetist Part A (S3_2_C4_20)","Allocation of Interns & Residents Salary and Fringes, Other Special Care Unit (B_1_C21_35)","COST SERVICES SUBJECT TO DEDUCTIBLES AND COINSURANCE - COST, Physical Therapy (D_5_HOS_C6_66)","Net Expense for Cost Allocation, Other General Service (B_1_C0_18)","Other Capital Related Costs, Total (A7_3_C7_3)",Medical Supplies Charged to Patients (D_4_IRF_C13_71),Total discharges (S3_1_C15_17),Recovery Room (A_C2_51),Surgical Intensive Care Unit (S3_1_C3_11),ICF (S3_1_C3_2001),CT Scan (D_4_IPF_C13_57),Emergency (D3_IPF_C2_91),"Number of patients in program at 
end of cost reporting period (S5_C3_1)","Net Expense for Cost Allocation, Research (B_1_C0_191)",Total Patient Days (D_3_HOS_C6_200),Operating Room (D3_IPF_C2_50),"Net Expense for Cost Allocation, Operation of Plant (B_1_C0_7)",Clinic (D3_IPF_C2_90),Clinic (D3_SNF_C2_90),"Net Expense for Cost Allocation, Drugs Charged to Patients (B_1_C0_73)",SNF (S3_1_C9_19),"Fully Depreciated Assets, Ending Balance (A7_1_C6_7)",Other Ancillary (D_4_HOS_C1_76),Observation Beds (Distinct Unit) (D3_SNF_C2_9201),Ambulance Services (B_1_C22_95),Total Swing Bed Cost (D1_HOS_C1_26),Total Adults & Pediatrics (S3_1_C8_7),Relief Payment (D1_HOS_C1_62),Out of State Medicaid paid days (S2_1_C3_24),"Allocation of Interns & Residents Program Costs, OLTC (B_1_C22_46)",Hospice (S3_1_C8_24),Impl. Dev. Charged to Patients (D_4_IRF_C13_72),Intensive Care Unit (D3_IRF_C2_31),Subprovider II (A_C1_4201),"COST REIMBURSED SERVICES SUBJECT TO DEDUCTIBLES  AND COINSURANCE - CHARGES, Blood Clotting Factors for Hemoph. (D_5_HOS_C3_6250)",Labor and Delivery (S3_1_C3_32),Occupational Therapy (D3_IRF_C2_67),HHA 2 Provider Number (S2_1_C2_1201),Total Program Excludable Costs (D1_HOS_C1_52),Electrocardiology (B_2_C26_69),Subprovider-IPF (D_1_HOS_C7_40),Renal 5 Provider Number (S2_1_C2_1804),HMO (S3_1_C6_2),NF (A_C2_45),SNF (S3_1_C7_19),Other Outpatient Services (B_1_C22_93),Total Program Inpatient Costs (D1_IPF_C1_49),Impl. Dev. Charged to Patients (D3_HOS_C3_72),Laundry and Linen Service (A8_C2_13),Electrocardiology (D3_IPF_C2_69),"PPS REIMBURSED SERVICES -  CHARGES, Radiology-Diagnostic (D_5_HOS_C2_54)",Other Reimbursable (D_4_HOS_C2_98),"COST SERVICES SUBJECT TO DEDUCTIBLES AND COINSURANCE - COST, MRI (D_5_HOS_C6_58)",Other Outpatient Services (D_4_IRF_C11_93),Census Division Code (CENSUS),Total discharges (S3_1_C15_21),CT Scan (A_C1_57),Coronary Intensive Care Unit (D_1_HOS_C4_32),Anesthesiology (D_4_IRF_C13_53),Adults & Pediatrics (C_1_C5_30),"Net Expense for Cost Allocation, Respiratory Therapy (B_1_C0_65)",Coronary Intensive Care Unit (D_1_HOS_C7_32),Total Costs (C_1_C3_202),Renal Dialysis (D3_SNF_C3_74),Renal Dialysis (D3_HOS_C2_74),MRI (D_4_IRF_C11_58),Total Inpatient Program Days (D_3_HOS_C8_200),"ADJUSTED SALARIES, Physician Part A Teaching (S3_2_C4_2201)",Subprovider-IPF (B_1_C26_40),Operating Room (D_4_HOS_C1_50),Component rate ESRD (E_B_HOS_C1_33),"Net Expense for Cost Allocation, Laboratory (B_1_C0_60)","HHA II, LUPA Episodes:  Other Charges (S4_HHA2_C3_34)","COST SERVICES SUBJECT TO DEDUCTIBLES AND COINSURANCE - COST, Radiology-Therapeutic (D_5_HOS_C6_55)",Number of stations (S5_C2_6),"PPS SERVICES COST, Speech Pathology (D_5_HOS_C5_68)",Intravenous Therapy (A_C2_64),Durable Medical Equipment Rented (B_1_C26_96),"Total Inpatient Charges, Cardiac Catheterization (C_1_C6_59)","COST SERVICES NOT SUBJECT TO DEDUCTIBLES AND COINSURANCE - COST, Laboratory (D_5_HOS_C7_60)",Pancreas Acquisition (C_1_C7_109),"HHA III, With Outliers:  Total Charges (S4_HHA3_C2_35)","Net Expense for Cost Allocation, Durable Medical Equipment Rented (B_1_C0_96)",HHA (S3_1_C6_22),Medical Supplies Charged to Patients (B_2_C26_71),Radiology-Diagnostic (D3_HOS_C2_54),"HHA III, Without Outliers:  Other Charges (S4_HHA3_C1_34)","PAID HOURS RELATED TO SALARIES, Contract Labor:  Physician Part A (S3_2_C5_13)","AVERAGE HOURLY WAGE, Dietary under Contract (S3_2_C6_35)",Radioisotope (D_4_HOS_C10_56),Cardiac Catheterization (D_4_IRF_C11_59),Other Outpatient Services (A_C2_93),Electroencephalography (D_4_HOS_C10_70),"Allocation of Interns & Residents Program Costs, Subprovider-IRF (B_1_C22_41)","COST REIMBURSED SERVICES NOT SUBJECT TO DEDUCTIBLES AND COINSURANCE - CHARGES, MRI (D_5_HOS_C4_58)","ADJUSTED SALARIES, Interns & Residents (S3_2_C4_25)","ADJUSTED SALARIES, Dietary under contract (S3_2_C4_35)",SNF (C_1_C5_44),"AMOUNT REPORTED, Administrative and General (S3_2_C2_27)",RHC (C_1_C7_88),"Net Expense for Cost Allocation, Physical Therapy (B_1_C0_66)",Other Outpatient Services (B_1_C26_93),Total Subprovider I Interns & Residents (S3_1_C10_18),"Gift, Flower, Coffee Shop, Canteen (A_C6_190)",Radioisotope (A_C6_56),"Allocation of Interns & Residents Program Costs, Intensive Care Unit (B_1_C22_31)","Net Expense for Cost Allocation, Intravenous Therapy (B_1_C0_64)","Purchases, Total (A7_1_C2_10)",Other General Service (A_C1_18),Negative Cost Centers (B_1_C26_201),Operating Room (D_4_IPF_C13_50),Burn Intensive Care Unit (S3_1_C4_10),Int & Res (non approved teaching program (B_1_C26_100),Observation Beds (Distinct Unit) (B_1_C21_9201),"COST SERVICES NOT SUBJECT TO DEDUCTIBLES AND COINSURANCE - COST, CT Scan (D_5_HOS_C7_57)",Total cost (E_B_HOS_C1_11),Electroencephalography (A_C2_70),ASC (Non Distinct Part) (D_4_HOS_C12_75),Subprovider 1 (S3_1_C2_18),Subprovider-IPF (D_1_HOS_C6_40),IPF (S3_1_C5_16),"AMOUNT REPORTED, Interns & Residents (S3_2_C3_2550)","Donations, Land Improvements (A7_1_C3_2)",IPF Provider Number (S2_1_C1_4),Anesthesiology (D_4_IPF_C11_53),CMHC (S3_1_C6_25),"PAID HOURS RELATED TO SALARIES, Dietary (S3_2_C5_34)","Allocation of Interns & Residents Salary and Fringes, Intensive Care Unit (B_1_C21_31)",Physical Therapy (D3_IPF_C2_66),"HHA III, With Outliers:  Number of Episodes (S4_HHA3_C2_37)",Respiratory Therapy (B_2_C26_65),"General Inpatient Routine Service Cost, net of Swing Bed Cost (D1_IPF_C1_27)",Fiscal Intermediary Number (FI_NUM),"Disposals and Retirements, Movable Equipment (A7_1_C5_6)",HHA 3 Provider Number (S2_1_C2_1202),"COST SERVICES SUBJECT TO DEDUCTIBLES AND COINSURANCE - COST, Speech Pathology (D_5_HOS_C6_68)",Clinic (D3_HOS_C2_90),RHC (B_1_C26_88),ASC (Non Distinct Part) (D_4_HOS_C13_75),Occupational Therapy (A_C2_67),"Net Expense for Cost Allocation, Other Organ Acquisition (B_1_C0_112)",Renal Dialysis (D3_IRF_C3_74),Initial Physician Payment Method (Y/N) (S5_C2_21),Observation Beds (Distinct Unit) (D3_IPF_C3_9201),Electroencephalography (D_4_IRF_C11_70),Utilization Review - Physician Compen (D1_SNF_C1_85),Other Ancillary (A_C1_76),Intravenous Therapy (D_4_HOS_C13_64),Radiology-Therapeutic (D_4_IPF_C13_55),Is this a New Hospital under 42 CFR 413.40(f)(1)(I) (TEFRA)? (Y/N) (S2_1_C1_85),"AVERAGE HOURLY WAGE, Subtotal Wage Related Csts (S3_3_C6_5)","Net Expense for Cost Allocation, Nursery (B_1_C0_43)",Medical Supplies Charged to Patients (D_4_HOS_C10_71),Payment to cost ratio (E_B_HOS_C1_5),Other Special Care Unit (C_1_C5_35),Cardiac Catheterization (B_1_C26_59),Other Ancillary (C_1_C6_76),Delivery Room and Labor Room (A_C2_52),"Blood Storing, Processing, Trans (D3_IRF_C2_63)","COST REIMBURSED SERVICES SUBJECT TO DEDUCTIBLES  AND COINSURANCE - CHARGES, Durable Medical Equipment Rented (D_5_HOS_C3_96)",Total Salaries (A_C2_200),"Gift, Flower, Coffee Shop, Canteen (B_2_C26_190)",Whole Blood & Packed Red Blood Cells (A_C6_62),Other Reimbursable (B_2_C26_98),MRI (C_1_C5_58),"Net Expense for Cost Allocation, Subprovider I (B_1_C0_42)",Heart Acquisition (B_1_C26_106),"HHA I, Total Non Routine Medical  Supply Charges (S4_HHA1_C5_38)",Anesthesiology (A_C2_53),Utilization Code (L/N/F) (UTIL_CODE),"AVERAGE HOURLY WAGE, Administrative and General (S3_2_C6_27)",MRI (D_4_HOS_C12_58),Other Outpatient Services (D_4_HOS_C3_93),Delivery Room and Labor Room (D_4_SNF_C11_52),"Net Expense for Cost Allocation, Intestinal Acquisition (B_1_C0_110)","TOTAL CAPITAL COSTS AFTER COST ALLOCATION, Radiology-Therapeutic (B_2_C26_55)",Other Outpatient Services (C_1_C6_93),Intravenous Therapy (C_1_C6_64),"COST SERVICES NOT SUBJECT TO DEDUCTIBLES AND COINSURANCE - COST, Radiology-Diagnostic (D_5_HOS_C7_54)",Coronary Care Unit (S3_1_C2_9),"COST REIMBURSED SERVICES NOT SUBJECT TO DEDUCTIBLES AND COINSURANCE - CHARGES, Speech Pathology (D_5_HOS_C4_68)",NF (S3_1_C5_20),RHC 7 Provider Number (S2_1_C2_1506),Cardiac Catheterization (D_4_IPF_C13_59),Int & Res (non approved teaching program (C_1_C5_100),Operating Room (D_4_HOS_C10_50),SNF (S3_1_C5_19),Emergency (D_4_IRF_C13_91),MRI (D3_SNF_C3_58),OSP (C_1_C7_9940),Other Reimbursable (A_C1_98),"COST REIMBURSED SERVICES SUBJECT TO DEDUCTIBLES  AND COINSURANCE - CHARGES, Other Ancillary (D_5_HOS_C3_76)",New Capital Buildings and Fixtures (A_C6_1),"PPS REIMBURSED SERVICES -  CHARGES, Respiratory Therapy (D_5_HOS_C2_65)",Employee Benefits (A_C2_4),Vending Machines (A8_C2_20),"COST SERVICES SUBJECT TO DEDUCTIBLES AND COINSURANCE - COST, Other Outpatient Services (D_5_HOS_C6_93)",Medical Supplies Charged to Patients (D_4_HOS_C12_71),Respiratory Therapy (B_1_C26_65),"Allocation of Interns & Residents Salary and Fringes, Radiology-Therapeutic (B_1_C21_55)",Electrocardiology (D3_HOS_C3_69),Radioisotope (C_1_C5_56),Radioisotope (D3_SNF_C3_56),Subprovider-IPF (D_1_HOS_C4_40),MSP-LCC reconciliation amount (E_B_HOS_C1_38),"HHA II, LUPA:  Total Non Routine Med Sup Chgs (S4_HHA2_C3_38)",Occupational Therapy (C_1_C5_67),Cost of patients approved for charity care and uninsured discounts (S10_C1_21),Intestinal Acquisition (C_1_C5_110),"COST SERVICES SUBJECT TO DEDUCTIBLES AND COINSURANCE - COST, Electrocardiology (D_5_HOS_C6_69)",Burn Intensive Care Unit (A_C2_33),Physical Therapy (D_4_IPF_C11_66),Deductibles and coinsurance (E_B_HOS_C1_25),"Net Expense for Cost Allocation, CT Scan (B_1_C0_57)",Respiratory Therapy (D_4_HOS_C4_65),"AMOUNT REPORTED, Interns & Residents (S3_2_C2_2552)",Radiology-Diagnostic (D_4_SNF_C11_54),Intensive Care Unit (S3_1_C5_8),Recovery Room (B_1_C26_51),Clinic (B_1_C26_90),"ADJUSTED SALARIES, Teaching Physician Salaries (S3_2_C4_1602)","HHA I, Without Outliers:  Other Charges (S4_HHA1_C1_34)",Burn Intensive Care Unit (S3_1_C3_10),Occupational Therapy (B_1_C26_67),MCP Physician Payment Method (Y/N) (S5_C1_21),"COST SERVICES NOT SUBJECT TO DEDUCTIBLES AND COINSURANCE - COST, Blood Clotting Factors for Hemoph. (D_5_HOS_C7_6250)",Whole Blood & Packed Red Blood Cells (D_4_IRF_C13_62),Durable Medical Equipment Rented (D_4_HOS_C12_96),Adults & Pediatrics (D_1_HOS_C4_30),Impl. Dev. Charged to Patients (C_1_C7_72),Operating Room (A_C2_50),Durable Medical Equipment Rented (D_4_HOS_C3_96),Clinic (A_C1_90),"PAID HOURS RELATED TO SALARIES, Total Overhead Costs (S3_3_C5_7)","COST REIMBURSED SERVICES NOT SUBJECT TO DEDUCTIBLES AND COINSURANCE - CHARGES, Radiology-Diagnostic (D_5_HOS_C4_54)","AMOUNT REPORTED, Employee Benefits (S3_2_C2_26)",Intensive Care Unit (S3_1_C3_8),"AMOUNT REPORTED, Physician-Part B (S3_2_C2_5)","HHA I, LUPA Episodes:  Total Number of Episodes (S4_HHA1_C3_36)",ICF (S3_1_C8_2001),Maintenance of Personnel (A_C1_12),Clinic (D3_HOS_C3_90),CT Scan (B_1_C26_57),"ADJUSTED SALARIES, Housekeeping (S3_2_C4_32)",Pancreas Acquisition (C_1_C5_109),Whole Blood & Packed Red Blood Cells (C_1_C5_62),"Blood Storing, Processing, Trans (C_1_C7_63)",Delivery Room and Labor Room (D_4_HOS_C2_52),Lung  Acquisition (C_1_C7_108),Durable Medical Equipment Sold (B_2_C26_97),Clinic (D_4_HOS_C3_90),Radioisotope (D3_IPF_C3_56),Impl. Dev. Charged to Patients (D3_IRF_C2_72),Burn Intensive Care Unit (B_1_C26_33),"COST REIMBURSED SERVICES NOT SUBJECT TO DEDUCTIBLES AND COINSURANCE - CHARGES, Whole Blood & Packed Red Blood Cells (D_5_HOS_C4_62)","PAID HOURS RELATED TO SALARIES, Total Salaries (S3_2_C5_1)","ADJUSTED SALARIES, Subtotal Other Wages and Related Csts (S3_3_C4_4)",Other Ancillary (D3_IPF_C2_76),"Allocation of Interns & Residents Program Costs, Intravenous Therapy (B_1_C22_64)",Other Nonreimbursable (A_C1_194),"Total Inpatient Charges, Subprovider II (C_1_C6_4201)",Provider-based physician adjustment (A8_C2_10),Laboratory (C_1_C5_60),Clinic (C_1_C5_90),Renal Dialysis (A_C1_74),Drugs Charged to Patients (A_C2_73),Home Program Dialysis (D3_IPF_C3_94),Other Reimbursable (A_C2_98),Hospital Adults & Pediatrics (S3_1_C7_1),"Total Outpatient Charges, Delivery Room and Labor Room (C_1_C7_52)",Delivery Room and Labor Room (D3_SNF_C3_52),RHC 3 Provider Number (S2_1_C2_1502),"Allocation of Interns & Residents Salary and Fringes, Respiratory Therapy (B_1_C21_65)",Adults and Pediatrics (A_C2_30),"COST REIMBURSED SERVICES SUBJECT TO DEDUCTIBLES  AND COINSURANCE - CHARGES, Emergency (D_5_HOS_C3_91)","Allocation of Interns & Residents Program Costs, Blood Storing, Processing, Trans (B_1_C22_63)",Rental of quarters to employee and oths (A8_C2_15),"COST SERVICES NOT SUBJECT TO DEDUCTIBLES AND COINSURANCE - COST, Delivery Room and Labor Room (D_5_HOS_C7_52)","Allocation of Interns & Residents Program Costs, MRI (B_1_C22_58)","COST SERVICES NOT SUBJECT TO DEDUCTIBLES AND COINSURANCE - COST, Radioisotope (D_5_HOS_C7_56)",PBP Clinical Lab Services Program Only (A_C2_61),"PPS REIMBURSED SERVICES -  CHARGES, Recovery Room (D_5_HOS_C2_51)","AMOUNT REPORTED, Contract Labor: Pysician Part A (S3_2_C2_13)",Delivery Room and Labor Room (D_4_HOS_C4_52),Hospital Adlts & Ped Swing Bed SNF (S3_1_C8_5),Durable Medical Equipment Rented (D3_IRF_C3_96),MRI (D3_HOS_C3_58),OOT (A_C6_9930),Total prospective payment (E_B_HOS_C1_24),Delivery Room and Labor Room (D_4_HOS_C11_52),Subprovider-IRF (A_C6_41),Electroencephalography (D_4_HOS_C2_70),"Allocation of Interns & Residents Program Costs, Medical Supplies Charged to Patients (B_1_C22_71)","PPS REIMBURSED SERVICES -  CHARGES, Electroencephalography (D_5_HOS_C2_70)",Sale of drugs to other than patients (A8_C2_17),"TOTAL CAPITAL COSTS AFTER COST ALLOCATION, Subprovider-IRF (B_2_C26_41)",Respiratory Therapy (D3_SNF_C3_65),Drugs Charged to Patients (D3_SNF_C3_73),Clinic (D_4_HOS_C4_90),RHC 4 Provider Number (S2_1_C2_1503),FQHC 5 Provider Number (S2_1_C2_1604),"Number of patients in program at 
end of cost reporting period (S5_C5_1)",Electroencephalography (A_C1_70),Hospital Adults & Pediatrics (S3_1_C2_1),"Blood Storing, Processing, Trans (D_4_IRF_C13_63)","COST REIMBURSED SERVICES SUBJECT TO DEDUCTIBLES  AND COINSURANCE - CHARGES, Renal Dialysis (D_5_HOS_C3_74)",Physical Therapy (A_C6_66),CAPD exchanges per day (S5_C6_4),Total discharges (S3_1_C15_1),MRI (D_4_HOS_C3_58),ASC (Non Distinct Part) (D_4_SNF_C11_75),Private grants or donations or endowment income restricted to funding charity care (S10_C1_17),OSP (A_C2_9940),"AMOUNT REPORTED, Non-Physician Anesthetist Part A (S3_2_C2_20)","COST REIMBURSED SERVICES NOT SUBJECT TO DEDUCTIBLES AND COINSURANCE - CHARGES, ASC (Non Distinct Part) (D_5_HOS_C4_75)",OLTC (S3_1_C11_21),"Disposals and Retirements, Total (A7_1_C5_10)",Intravenous Therapy (D3_IPF_C2_64),Cardiac Catheterization (D_4_HOS_C13_59),Recovery Room (D_4_HOS_C4_51),Total Facility FTEs (S3_1_C10_27),"AMOUNT REPORTED, Interns & Residents (S3_2_C2_2553)",Whole Blood & Packed Red Blood Cells (D3_IPF_C2_62),Drugs Charged to Patients (B_1_C21_73),"AVERAGE HOURLY WAGE, Excluded Area Salaries (S3_3_C6_2)","COST SERVICES SUBJECT TO DEDUCTIBLES AND COINSURANCE - COST, Cardiac Catheterization (D_5_HOS_C6_59)","Net Expense for Cost Allocation, Electrocardiology (B_1_C0_69)","Number of days in year dialysis 
furnished (S5_C2_5)",Whole Blood & Packed Red Blood Cells (D3_IRF_C2_62),RHC 18 Provider Number (S2_1_C2_1517),Kidney Acquisition (A_C2_105),Electrocardiology (A_C2_69),Charity care charges and uninsured discounts for the entire facility (S10_C3_20),"Depreciation, New Cap Related Csts Movable Equipment (A7_3_C9_2)","COST SERVICES SUBJECT TO DEDUCTIBLES AND COINSURANCE - COST, Ambulance Services (D_5_HOS_C6_95)",Subtotal (E_B_HOS_C1_27),IPF Provider Number (S2_1_C2_4),Research (A_C6_191),Durable Medical Equipment Rented (D3_HOS_C3_96),Nursery (S3_1_C7_13),Anesthesiology (D3_IRF_C3_53),"AMOUNT REPORTED, Maintenance of Personnel (S3_2_C2_37)","COST REIMBURSED SERVICES SUBJECT TO DEDUCTIBLES  AND COINSURANCE - CHARGES, Electroencephalography (D_5_HOS_C3_70)",Cost of physicians svcs in a teaching hospita (E_B_HOS_C1_23),"AMOUNT REPORTED, Physician Part B (S3_2_C3_23)",Radiology-Diagnostic (D_4_HOS_C12_54),Emergency (D3_IRF_C3_91),Outlier payments (E_B_HOS_C101_4),"COST SERVICES SUBJECT TO DEDUCTIBLES AND COINSURANCE - COST, Impl. Dev. Charged to Patients (D_5_HOS_C6_72)",Impl. Dev. Charged to Patients (D_4_IPF_C11_72),"TOTAL CAPITAL COSTS AFTER COST ALLOCATION, ICF (B_2_C26_4501)","PPS REIMBURSED SERVICES -  CHARGES, Renal Dialysis (D_5_HOS_C2_74)",Radiology-Diagnostic (D3_IRF_C3_54),Net revenue from state/local govt indigent care (not Medicaid or CHIP) (S10_C1_13),Partial or full credits from manufacturers (E_B_HOS_C1_3998),Drugs Charged to Patients (C_1_C7_73),Ending Date of SCH status (S2_1_C2_36),Operating Room (C_1_C5_50),Other Reimbursable (B_1_C22_98),"Allocation of Interns & Residents Salary and Fringes, Electrocardiology (B_1_C21_69)",ASC (Non Distinct Part) (D3_SNF_C2_75),Hospice 2 Provider Number (S2_1_C2_1401),Kidney Acquisition (C_1_C5_105),Cafeteria employees and guests (A8_C2_14),Interns & Res Salary and Fringe Benefits (A_C2_21),Surgical Intensive Care Unit (A_C2_34),OOT (C_1_C6_9930),IPF (S3_1_C8_16),OLTC (S3_1_C2_21),FQHC (A_C2_89),Subprovider I (D_1_HOS_C4_42),Home Program Dialysis (A_C1_94),ICF (A_C6_4501),Other Special Care Unit (B_1_C26_35),Blood Clotting Factors for Hemoph. (D3_HOS_C3_6250),Other Special Care (S3_1_C6_12),Coronary Care Unit (A_C6_32),"HHA III, Total Number of Episodes (S4_HHA3_C5_36)","Net Expense for Cost Allocation, HHA (B_1_C0_101)",Title XVIII discharges (S3_1_C13_18),Subprovider II (D_1_HOS_C4_4201),"AVERAGE HOURLY WAGE, Admin & Gen Under Contract (S3_2_C6_29)",Central Services and Supply (A_C6_14),"PPS REIMBURSED SERVICES -  CHARGES, Clinic (D_5_HOS_C2_90)",Radiology-Diagnostic (C_1_C5_54),Other Special Care (S3_1_C3_12),Respiratory Therapy (D3_SNF_C2_65),"PPS REIMBURSED SERVICES -  CHARGES, Emergency (D_5_HOS_C2_91)",Radioisotope (D_4_IRF_C11_56),Impl. Dev. Charged to Patients (D3_IRF_C3_72),Home Program Dialysis (D_4_HOS_C2_94),"COST REIMBURSED SERVICES NOT SUBJECT TO DEDUCTIBLES AND COINSURANCE - CHARGES, Blood Clotting Factors for Hemoph. (D_5_HOS_C4_6250)","Blood Storing, Processing, Trans (D3_IPF_C2_63)",Emergency (D_4_HOS_C11_91),Delivery Room and Labor Room (D3_IRF_C2_52),"Total Inpatient Charges, Anesthesiology (C_1_C6_53)",Subprovider 1 (S3_1_C8_18),Intensive Care Unit (D3_IPF_C2_31),"PAID HOURS RELATED TO SALARIES, Cafeteria (S3_2_C5_36)",Islet Acquisition (B_1_C26_111),Total Hospital (S3_1_C5_7),Renal Dialysis (B_1_C21_74),"HHA III, Total Non Routine Medical  Supply Charges (S4_HHA3_C5_38)",NF (S3_1_C2_20),Subprovider II (A_C2_4201),Physical Therapy (D3_SNF_C3_66),"COST REIMBURSED SERVICES NOT SUBJECT TO DEDUCTIBLES AND COINSURANCE - CHARGES, Delivery Room and Labor Room (D_5_HOS_C4_52)","AVERAGE HOURLY WAGE, Home Office:  Physician Part A (S3_2_C6_15)",Physicians' Private Office (A_C6_192),"Beginning Balances, Subtotal (A7_1_C1_8)","PPS SERVICES COST, Intravenous Therapy (D_5_HOS_C5_64)",OSP (B_1_C26_9940),ASC (Non Distinct Part) (A_C2_75),Organ Procurement (D4_INTESTINE_C1_69),Coronary Care Unit (B_1_C26_32),"AMOUNT REPORTED, Interns & Residents (S3_2_C3_2551)",Renal Dialysis (A_C2_74),Nursery (S3_1_C8_13),"AMOUNT REPORTED, Non-Physician Anesthetist Part B (S3_2_C2_3)",Islet Acquisition (C_1_C7_111),"ADJUSTED SALARIES, Total Salaries (S3_2_C4_1)","HHA II, Total Charges (S4_HHA2_C5_35)",Paramedical Education (A_C6_23),Physical Therapy (C_1_C6_66),Drugs Charged to Patients (D_4_IPF_C11_73),Cost To Charge Ratio (S10_C1_1),"COST SERVICES SUBJECT TO DEDUCTIBLES AND COINSURANCE - COST, Drugs Charged to Patients (D_5_HOS_C6_73)",Cardiac Catheterization (D_4_IRF_C13_59),Other Reimbursable (C_1_C6_98),"Medical certified liver 
transplant center cert date (S2_1_C1_128)",ASC (Non Distinct Part) (D_4_HOS_C2_75),"Total, Total (A7_3_C15_3)",Respiratory Therapy (D_4_HOS_C12_65),Drugs Charged to Patients (B_2_C26_73),Program Inpatient Ancillary Service Cost (D1_HOS_C1_48),CORF (A_C2_9910),Total unreimbursed cost for Medicaid and CHIP and state and local indigent care programs (S10_C1_19),"If (SCH), enter the # of periods. (S2_1_C1_35)",Other Reimbursable (B_1_C26_98),MDH status ending date (MM/DD/YY) (S2_1_C2_3801),Physical Therapy (D_4_SNF_C11_66),Intensive Care Unit (S3_1_C8_8),"HHA I, With Outliers:  Total Visits (S4_HHA1_C2_33)",FQHC (A_C1_89),Speech Pathology (D3_IPF_C3_68),FQHC (C_1_C5_89),Physical Therapy (C_1_C7_66),Radiology-Therapeutic (D_4_HOS_C2_55),"PPS SERVICES COST, Durable Medical Equipment Rented (D_5_HOS_C5_96)","Allocation of Interns & Residents Salary and Fringes, Subprovider-IPF (B_1_C21_40)","Total Outpatient Charges, Operating Room (C_1_C7_50)",Medical Supplies Charged to Patients (D_4_IPF_C13_71),Renal 2 Provider Number (S2_1_C2_1801),Liver Acquisition (A_C6_107),"TOTAL CAPITAL COSTS AFTER COST ALLOCATION, Operating Room (B_2_C26_50)","HHA III, Total Charges (S4_HHA3_C5_35)","HHA II, PEP Episodes:  Total Number of Episodes (S4_HHA2_C4_36)","COST REIMBURSED SERVICES NOT SUBJECT TO DEDUCTIBLES AND COINSURANCE - CHARGES, Home Program Dialysis (D_5_HOS_C4_94)",Other Nonreimbursable (A_C2_194),Operating Room (B_1_C26_50),Drugs Charged to Patients (D_4_HOS_C13_73),Other Outpatient Services (D_4_IRF_C13_93),Medical Supplies Charged to Patients (D3_HOS_C2_71),"Allocation of Interns & Residents Program Costs, Radiology-Therapeutic (B_1_C22_55)",Delivery Room and Labor Room (D_4_HOS_C13_52),MDH status beginning date  (MM/DD/YY) (S2_1_C1_3801),Subprovider I (A_C2_42),FQHC (C_1_C6_89),"Net Expense for Cost Allocation, Clinic (B_1_C0_90)",Other Ancillary (C_1_C5_76),"PPS REIMBURSED SERVICES -  CHARGES, Delivery Room and Labor Room (D_5_HOS_C2_52)",NF (S3_1_C10_20),NF (S3_1_C11_20),Hospital Adults & Pediatrics (S3_1_C6_1),Laboratory (D3_HOS_C2_60),Outpatient Rehab Provider (S3_1_C10_25),Other Ancillary (D3_HOS_C2_76),Interns & Res Salary and Fringe Benefits (A_C6_21),Int & Res (non approved teaching program (C_1_C6_100),Total (D_4_IRF_C11_200),NF (S3_1_C3_20),Total Program General Inpatient Routine (D1_IRF_C1_41),Drugs Charged to Patients (B_1_C22_73),Whole Blood & Packed Red Blood Cells (D_4_HOS_C10_62),Durable Medical Equipment Sold (D3_HOS_C2_97),"COST REIMBURSED SERVICES SUBJECT TO DEDUCTIBLES  AND COINSURANCE - CHARGES, Respiratory Therapy (D_5_HOS_C3_65)",Nonpaid Workers (B_1_C21_193),"Blood Storing, Processing, Trans (D_4_HOS_C10_63)",Observation Beds (Distinct Unit) (C_1_C6_9201),HHA (B_1_C21_101),Hospital Zip Code (S2_1_C3_2),Interns & Res Salary and Fringe Benefits (A_C1_21),Anesthesiology (D3_SNF_C3_53),Other Ancillary (D3_IRF_C2_76),Medicare Certified Heart TC term date (S2_1_C2_127),Medical Supplies Charged to Patients (D3_IRF_C3_71),Total (S3_1_C2_7),Electrocardiology (D_4_HOS_C12_69),Does the facility operate an ICF/MR facility for purposes of Title XIX? (Y/N) (S2_1_C1_93),"PPS REIMBURSED SERVICES -  CHARGES, Other Ancillary (D_5_HOS_C2_76)",Pass through Cost for Program Inpatient (D1_IRF_C1_50),"PPS REIMBURSED SERVICES -  CHARGES, Anesthesiology (D_5_HOS_C2_53)",RHC 21 Provider Number (S2_1_C2_1520),Outpatient Rehab Provider (S3_1_C7_25),"PPS REIMBURSED SERVICES -  CHARGES, Durable Medical Equipment Rented (D_5_HOS_C2_96)",Blood Clotting Factors for Hemoph. (A_C2_6250),"Net Expense for Cost Allocation, Lung  Acquisition (B_1_C0_108)","ADJUSTED SALARIES, Home Office Salaries & Wage Related Csts (S3_2_C4_14)","COST REIMBURSED SERVICES SUBJECT TO DEDUCTIBLES  AND COINSURANCE - CHARGES, Other Outpatient Services (D_5_HOS_C3_93)",RHC 22 Provider Number (S2_1_C2_1521),Program Inpatient Ancillary Service Cost (D1_IRF_C1_48),"Net Expense for Cost Allocation, Radiology-Diagnostic (B_1_C0_54)","ADJUSTED SALARIES, Total (S3_3_C4_6)",Total (A8_C2_50),Physical Therapy (B_1_C26_66),"Blood Storing, Processing, Trans (D3_SNF_C3_63)","Net Expense for Cost Allocation, Subprovider-IPF (B_1_C0_40)",Total reasonable charges (E_B_HOS_C1_14),NF (C_1_C5_45),CT Scan (D3_IRF_C2_57),"PPS REIMBURSED SERVICES -  CHARGES, Impl. Dev. Charged to Patients (D_5_HOS_C2_72)",Recovery Room (D_4_HOS_C12_51),"Allocation of Interns & Residents Program Costs, Surgical Intensive Care Unit (B_1_C22_34)","Donations, Total (A7_1_C3_10)",Electrocardiology (D3_HOS_C2_69),"PPS SERVICES COST, Cardiac Catheterization (D_5_HOS_C5_59)",Burn Intensive Care Unit (S3_1_C5_10),Observation Beds (Distinct Unit) (C_1_C5_9201),Other Outpatient Services (D_4_IPF_C13_93),"Medical certified lung
transplant center cert date (S2_1_C1_129)","Trade, Quantity, and Time Discounts (A8_C2_4)","HHA I, With Outliers:  Non Routine Med Sup Chgs (S4_HHA1_C2_38)","AMOUNT REPORTED, Physician Part A (S3_2_C3_22)","AVERAGE HOURLY WAGE, Interns & Residents (S3_2_C6_7)","PPS REIMBURSED SERVICES -  CHARGES, Occupational Therapy (D_5_HOS_C2_67)",Utilization Review SNF (A_C2_114),"Donations, Land (A7_1_C3_1)","Total Inpatient Charges, OLTC (C_1_C6_46)",Other Medicaid Days (S2_1_C6_24),"PPS SERVICES COST, Electrocardiology (D_5_HOS_C5_69)","Allocation of Interns & Residents Program Costs, Burn Intensive Care Unit (B_1_C22_33)",Other Special Care (S3_1_C4_12),"HHA III, Total Other Charges (S4_HHA3_C5_34)","COST REIMBURSED SERVICES SUBJECT TO DEDUCTIBLES  AND COINSURANCE - CHARGES, Medical Supplies Charged to Patients (D_5_HOS_C3_71)","Allocation of Interns & Residents Program Costs, SNF (B_1_C22_44)",Int & Res (non approved teaching program (B_1_C22_100),Operating Room (D_4_HOS_C2_50),Surgical Intensive Care Unit (S3_1_C8_11),"AMOUNT REPORTED, Home Office Salaries & Wage Related Csts (S3_2_C2_14)",Respiratory Therapy (A_C1_65),Home Program Dialysis (D3_IPF_C2_94),"Disposals and Retirements, Land (A7_1_C7_1)",Other Ancillary (D_4_IRF_C13_76),Other General Service (A_C2_18),Islet Acquisition (A_C2_111),Other Reimbursable (C_1_C7_98),Total (D_4_SNF_C13_200),Physical Therapy (D_4_HOS_C10_66),Burn Intensive Care Unit (D_1_HOS_C7_33),Renal Dialysis (D3_IRF_C2_74),Home Office Street (S2_1_C1_142),HHA (C_1_C7_101),"PPS SERVICES COST, CT Scan (D_5_HOS_C5_57)",Delivery Room and Labor Room (D3_HOS_C2_52),Total Outpatient Program Pass Thru Cost (D_4_HOS_C6_200),"Total Outpatient Charges, Anesthesiology (C_1_C7_53)",Impl. Dev. Charged to Patients (D_4_HOS_C4_72),"General Inpatient Routine Service Cost, net of Swing Bed Cost (D1_IRF_C1_27)",Coronary Care Unit (S3_1_C7_9),RHC 23 Provider Number (S2_1_C2_1522),"AMOUNT REPORTED, Housekeeping (S3_2_C2_32)",Whole Blood & Packed Red Blood Cells (D3_HOS_C3_62),CMS Region Code (REGION),Observation Beds (Distinct Unit) (B_2_C26_9201),Other Capital (A_C6_3),Speech Pathology (D3_IRF_C2_68),Organ acquisition (E_B_HOS_C1_10),Speech Pathology (A_C2_68),Durable Medical Equipment Sold (C_1_C6_97),Operating Room (D3_SNF_C2_50),HHA (C_1_C6_101),Drugs Charged to Patients (D_4_HOS_C4_73),Medicare allowable bad debts for the entire hospital complex (S10_C1_2701),Lung  Acquisition (A_C2_108),"AMOUNT REPORTED, Non-Physician Anesthetist Part B (S3_2_C2_21)",Other Adjustments (Summed) (A8_C2_33),Laboratory (D_4_HOS_C10_60),Radiology-Diagnostic (D_4_HOS_C4_54),Electroencephalography (D_4_IPF_C13_70),RHC/FQHC Combined (S3_1_C10_26),Subprovider-IPF (D3_SNF_C2_40),CMHC (A_C1_99),"PPS SERVICES COST, Observation Beds (Distinct Unit) (D_5_HOS_C5_9201)","PAID HOURS RELATED TO SALARIES, Contract Labor (S3_2_C5_11)",Medical Supplies Charged to Patients (D_4_IRF_C11_71),"AMOUNT REPORTED, Medical Records & Med Records Library (S3_2_C2_41)","HHA III, Without Outliers:  Total Visits (S4_HHA3_C1_33)",Surgical Intensive Care Unit (S3_1_C6_11),Impl. Dev. Charged to Patients (A_C1_72),Emergency (D_4_SNF_C11_91),"COST REIMBURSED SERVICES SUBJECT TO DEDUCTIBLES  AND COINSURANCE - CHARGES, Radioisotope (D_5_HOS_C3_56)",RHC 17 Provider Number (S2_1_C2_1516),"COST REIMBURSED SERVICES SUBJECT TO DEDUCTIBLES  AND COINSURANCE - CHARGES, Blood Storing, Processing, Trans (D_5_HOS_C3_63)",Ambulance Services (A_C2_95),Organ Procurement (D4_PANCREAS_C1_69),Emergency (A_C1_91),"Gift, Flower, Coffee Shop, Canteen (B_1_C22_190)","TOTAL CAPITAL COSTS AFTER COST ALLOCATION, Coronary Care Unit (B_2_C26_32)",PBP Clinical Lab Services Program Only (B_1_C26_61),"COST SERVICES SUBJECT TO DEDUCTIBLES AND COINSURANCE - COST, Occupational Therapy (D_5_HOS_C6_67)",Nursery (C_1_C5_43),"AMOUNT REPORTED, Management and Administrative Services (S3_2_C2_12)",Hospice 1 Provider Number (S2_1_C2_14),"Purchases, Buildings and Fixtures (A7_1_C2_3)",Durable Medical Equipment Rented (D_4_HOS_C10_96),Durable Medical Equipment Rented (A_C2_96),Liver Acquisition (A_C2_107),OPPS payments (E_B_HOS_C1_3),"AMOUNT REPORTED, Contract Labor (S3_2_C2_11)","Allocation of Interns & Residents Salary and Fringes, Surgical Intensive Care Unit (B_1_C21_34)",Laboratory (D_4_IRF_C13_60),"HHA II, Without Outliers:  Non Routine Med Sup Chgs (S4_HHA2_C1_38)","Gift, Flower, Coffee Shop, Canteen (A_C1_190)","PAID HOURS RELATED TO SALARIES, Laundry and Linen Service (S3_2_C5_31)","COST REIMBURSED SERVICES NOT SUBJECT TO DEDUCTIBLES AND COINSURANCE - CHARGES, Other Ancillary (D_5_HOS_C4_76)","ADJUSTED SALARIES, Employee Benefits (S3_2_C4_26)","Net Expense for Cost Allocation, Hospice (B_1_C0_116)",Durable Medical Equipment Rented (D3_IRF_C2_96),Anesthesiology (D_4_HOS_C11_53),"PAID HOURS RELATED TO SALARIES, Home Office Personnel (S3_2_C5_8)","AMOUNT REPORTED, Subtotal Wage Related Csts (S3_3_C2_5)",RHC (D_4_HOS_C3_88),Maintenance of Personnel (A_C6_12),Operating Room (D_4_HOS_C4_50),Coronary Care Unit (S3_1_C8_9),ASC (Non Distinct Part) (D3_IPF_C3_75),Electrocardiology (D_4_HOS_C11_69),"AMOUNT REPORTED, Physician Part A (S3_2_C2_22)",Subprovider I (B_1_C26_42),"Allocation of Interns & Residents Program Costs, Adults and Pediatrics (B_1_C22_30)",Paid Losses (S2_1_C2_11801),"PPS REIMBURSED SERVICES -  CHARGES, ASC (Non Distinct Part) (D_5_HOS_C2_75)",CT Scan (D3_SNF_C2_57),Emergency (B_1_C22_91),Other Special Purpose (B_1_C21_117),"Total Inpatient Charges, Blood Clotting Factors for Hemoph. (C_1_C6_6250)",Occupational Therapy (D_4_HOS_C4_67),Other Organ Acquisition (C_1_C7_112),"PPS REIMBURSED SERVICES -  CHARGES, Drugs Charged to Patients (D_5_HOS_C2_73)",Blood Clotting Factors for Hemoph. (C_1_C5_6250),Organ acquisition charges (E_B_HOS_C1_13),Other Outpatient Services (D3_IPF_C3_93),"AMOUNT REPORTED, Home Office:  Physician Part A (S3_2_C2_15)",Nonphysician Anesthetists (A_C1_19),"PPS SERVICES COST, Occupational Therapy (D_5_HOS_C5_67)",HVBP payment adjustment amount (E_A_HOS_C1_7093),Physical Therapy (D_4_HOS_C2_66),CT Scan (D_4_IPF_C11_57),"PAID HOURS RELATED TO SALARIES, Teaching Physician Salaries (S3_2_C5_16)",Speech Pathology (D3_SNF_C2_68),"PAID HOURS RELATED TO SALARIES, Excluded Area Salaries (S3_2_C5_10)","COST SERVICES SUBJECT TO DEDUCTIBLES AND COINSURANCE - COST, Recovery Room (D_5_HOS_C6_51)",Clinic (D3_SNF_C3_90),"COST SERVICES NOT SUBJECT TO DEDUCTIBLES AND COINSURANCE - COST, Other Ancillary (D_5_HOS_C7_76)",FQHC 8 Provider Number (S2_1_C2_1607),"HHA I, Total Other Charges (S4_HHA1_C5_34)",MRI (D_4_HOS_C2_58),Title V discharges (S3_1_C12_1),Title V discharges (S3_1_C12_14),Lung  Acquisition (B_1_C22_108),CT Scan (D_4_HOS_C2_57),"Interest, Total (A7_3_C11_3)","Donations, Building Improvements (A7_1_C3_4)",Blood Clotting Factors for Hemoph. (D_4_HOS_C12_6250),Stand-alone CHIP -- Costs minus net revenue (0 min) (S10_C1_12),"COST REIMBURSED SERVICES NOT SUBJECT TO DEDUCTIBLES AND COINSURANCE - CHARGES, Physical Therapy (D_5_HOS_C4_66)","AVERAGE HOURLY WAGE, Home Office Salaries (S3_2_C6_1401)",MRI (D_4_IPF_C13_58),"ADJUSTED SALARIES, Administrative & General under contract (S3_2_C4_28)",Durable Medical Equipment Rented (C_1_C6_96),Medical and Other Services reimbursed by OPPS (E_B_HOS_C1_2),Other Organ Acquisition (B_2_C26_112),"COST SERVICES SUBJECT TO DEDUCTIBLES AND COINSURANCE - COST, Radioisotope (D_5_HOS_C6_56)","HHA II, LUPA Episodes:  Total Visits (S4_HHA2_C3_33)",Delivery Room and Labor Room (B_1_C26_52),Occupational Therapy (D_4_HOS_C2_67),Labor and Delivery Days -  Title XIX (S3_1_C8_32),"COST REIMBURSED SERVICES SUBJECT TO DEDUCTIBLES  AND COINSURANCE - CHARGES, Other Reimbursable (D_5_HOS_C3_98)","Net Expense for Cost Allocation, Nursing Administration (B_1_C0_13)",RHC 15 Provider Number (S2_1_C2_1514),Drugs Charged to Patients (D_4_SNF_C11_73),Anesthesiology (D3_IPF_C3_53),Kidney Acquisition (C_1_C6_105),"Number of days in year dialysis 
furnished (S5_C1_5)",Administrative and General (A_C2_5),MRI (D_4_HOS_C13_58),"ADJUSTED SALARIES, Teaching Physician Salaries (S3_2_C4_16)",ASC (Distinct Part) (B_1_C22_115),Physical Therapy (D3_HOS_C3_66),"AVERAGE HOURLY WAGE, Physician-Part B (S3_2_C6_5)",Net Revenue from Medicaid (S10_C1_2),"COST REIMBURSED SERVICES SUBJECT TO DEDUCTIBLES  AND COINSURANCE - CHARGES, Durable Medical Equipment Sold (D_5_HOS_C3_97)",Respiratory Therapy (D3_HOS_C3_65),Surgical Intensive Care Unit (A_C1_34),Home Program Dialysis (D_4_HOS_C12_94),"PPS REIMBURSED SERVICES -  CHARGES, Electrocardiology (D_5_HOS_C2_69)",ASC (Non Distinct Part) (D3_IPF_C2_75),Drugs Charged to Patients (C_1_C6_73),"ADJUSTED SALARIES, Subtotal Salaries (S3_3_C4_3)",Ancillary service other pass through costs (E_B_HOS_C1_9),Drugs Charged to Patients (D_4_HOS_C2_73),Whole Blood & Packed Red Blood Cells (D_4_HOS_C11_62),Impl. Dev. Charged to Patients (D_4_HOS_C10_72),Total Hospital Interns & Residents (S3_1_C9_14),Pancreas Acquisition (C_1_C6_109),Impl. Dev. Charged to Patients (A_C2_72),Drugs Charged to Patients (D_4_IRF_C13_73),ESRD DME costs (E_B_HOS_C1_29),Recovery Room (D3_IRF_C3_51),Intensive Care Unit (S3_1_C2_8),Total (B_2_C26_202),"AMOUNT REPORTED, Operation of Plant (S3_2_C2_30)","TOTAL CAPITAL COSTS AFTER COST ALLOCATION, MRI (B_2_C26_58)",Surgical Intensive Care Unit (D3_HOS_C2_34),Surgical Intensive Care Unit (D3_IRF_C2_34),Laboratory (D3_SNF_C3_60),Hospice (S3_1_C10_24),"ADJUSTED SALARIES, Non-Physician Anesthetist Part A (S3_2_C4_2)",OSP (A_C1_9940),"COST REIMBURSED SERVICES NOT SUBJECT TO DEDUCTIBLES AND COINSURANCE - CHARGES, Radiology-Therapeutic (D_5_HOS_C4_55)",RHC 8 Provider Number (S2_1_C2_1507),ASC 1 Provider Number (S2_1_C2_13),"Net Expense for Cost Allocation, Subprovider-IRF (B_1_C0_41)","Percentage of patients re-using
dialyzers (S5_C1_10)",Hospital Name (S2_1_C1_3),Subprovider-IRF (A_C2_41),"HHA III, PEP Episodes:  Total Visits (S4_HHA3_C4_33)",Other Outpatient Services (C_1_C5_93),Impl. Dev. Charged to Patients (D_4_IRF_C11_72),Fiscal Year End Date (FY_END_DT),Other Reimbursable (B_1_C21_98),"Total Inpatient Charges, Surgical Intensive Care Unit (C_1_C6_34)","Disposals and Retirements, Buildings and Fixtures (A7_1_C7_3)",Coronary Care Unit (D3_IRF_C2_32),Utilization (S5_C2_8),Nonpaid Workers (B_1_C26_193),Cardiac Catheterization (D3_IRF_C3_59),IPF (S3_1_C3_16),Operating Room (D_4_HOS_C11_50),Emergency (D_4_IPF_C13_91),Hospice (A_C6_116),Other Organ Acquisition (C_1_C5_112),Operation of Plant (A_C6_7),Burn Intensive Care Unit (D3_IPF_C2_33),Medical Supplies Charged to Patients (A_C1_71),"Number of patients in program at 
end of cost reporting period (S5_C1_1)",Subprovider I (D3_HOS_C2_42),Speech Pathology (D_4_HOS_C12_68),Transitional corridor payment (E_B_HOS_C1_8),Radioisotope (D3_IRF_C2_56),Durable Medical Equipment Sold (B_1_C26_97),Respiratory Therapy (D3_HOS_C2_65),"PAID HOURS RELATED TO SALARIES, Physician-Part B (S3_2_C5_5)","PAID HOURS RELATED TO SALARIES, Subtotal Salaries (S3_3_C5_3)",Heart Acquisition (A_C6_106),"ADJUSTED SALARIES, Administrative and General (S3_2_C4_27)","Total Outpatient Charges, Radiology-Therapeutic (C_1_C7_55)",Medical Supplies Charged to Patients (D_4_HOS_C4_71),ASC (Non Distinct Part) (B_1_C21_75),Other Reimbursable (D_4_HOS_C13_98),Operating Room (D_4_IRF_C13_50),"COST SERVICES SUBJECT TO DEDUCTIBLES AND COINSURANCE - COST, Renal Dialysis (D_5_HOS_C6_74)","AMOUNT REPORTED, Total (S3_3_C2_6)",Cardiac Catheterization (D3_IRF_C2_59),NF (A_C6_45),Electrocardiology (D_4_IRF_C13_69),ASC (Distinct Part) (C_1_C6_115),"Blood Storing, Processing, Trans (A_C6_63)",Subprovider-IRF (D_1_HOS_C4_41),Adj for Physical therapy costs in excess (A8_C2_24),"HHA I, PEP Episodes:  Total Number of Episodes (S4_HHA1_C4_36)",Emergency (D_4_HOS_C4_91),Impl. Dev. Charged to Patients (D3_IPF_C2_72),Durable Medical Equipment Rented (A_C6_96),Drugs Charged to Patients (D3_HOS_C2_73),Cardiac Catheterization (D3_SNF_C2_59),"Total Outpatient Charges, Radiology-Diagnostic (C_1_C7_54)",Total Facility (S3_1_C2_27),"COST SERVICES NOT SUBJECT TO DEDUCTIBLES AND COINSURANCE - COST, Renal Dialysis (D_5_HOS_C7_74)","Total Inpatient Charges, Operating Room (C_1_C6_50)",Respiratory Therapy (C_1_C7_65),Intravenous Therapy (D_4_HOS_C2_64),"Total Inpatient Charges, Coronary Care Unit (C_1_C6_32)","Total Program Inpatient Operating Cost excluding Capital Related, Nonphysician, Anesthetist, and Medical Education Costs (D1_IRF_C1_53)",Cardiac Catheterization (D3_IPF_C3_59),MRI (A_C6_58),Total (C_1_C7_202),Operating Room (D3_IRF_C3_50),OLTC (C_1_C5_46),"HHA II, Total Number of Episodes (S4_HHA2_C5_36)",Other Outpatient Services (D_4_HOS_C12_93),Total Allied Health (D_4_IRF_C3_200),"Net Expense for Cost Allocation, Pharmacy (B_1_C0_15)","TOTAL CAPITAL COSTS AFTER COST ALLOCATION, NF (B_2_C26_45)","COST REIMBURSED SERVICES NOT SUBJECT TO DEDUCTIBLES AND COINSURANCE - CHARGES, Impl. Dev. Charged to Patients (D_5_HOS_C4_72)","Allocation of Interns & Residents Salary and Fringes, NF (B_1_C21_45)",Anesthesiology (D_4_SNF_C11_53),Housekeeping (A_C1_9),"AMOUNT REPORTED, Interns & Residents (S3_2_C2_7)","COST REIMBURSED SERVICES NOT SUBJECT TO DEDUCTIBLES AND COINSURANCE - CHARGES, Cardiac Catheterization (D_5_HOS_C4_59)","Treatment capacity per day per
station (S5_C1_7)",Interest Expense (A_C2_113),Renal Dialysis (A_C6_74),"HHA III, PEP Episodes:  Total Charges: (S4_HHA3_C4_35)",Physical Therapy (A_C1_66),Subtotal (E_B_HOS_C1_30),Other Outpatient Services (D3_IRF_C3_93),"Gift, Flower, Coffee Shop, Canteen (A_C2_190)",ASC (Non Distinct Part) (D_4_HOS_C11_75),"COST SERVICES SUBJECT TO DEDUCTIBLES AND COINSURANCE - COST, Medical Supplies Charged to Patients (D_5_HOS_C6_71)","TOTAL CAPITAL COSTS AFTER COST ALLOCATION, Nursery (B_2_C26_43)",Other Nonreimbursable (B_1_C22_194),Radiology-Therapeutic (D3_HOS_C3_55),"Net Expense for Cost Allocation, Speech Pathology (B_1_C0_68)",Other Outpatient Services (D_4_SNF_C11_93),ICF (S3_1_C7_2001),ICF (S3_1_C10_2001),"PPS REIMBURSED SERVICES -  CHARGES, Blood Storing, Processing, Trans (D_5_HOS_C2_63)","Insurance, New Cap Related Csts Bldg & Fixtures (A7_3_C5_1)",RHC (B_1_C21_88),"Total Outpatient Charges, Laboratory (C_1_C7_60)",RHC (D_4_HOS_C4_88),Other Reimbursable (D3_IPF_C2_98),Drugs Charged to Patients (C_1_C5_73),"PPS SERVICES COST, Clinic (D_5_HOS_C5_90)",Anesthesiology (D3_IPF_C2_53),Report Status Code (RPT_STUS_CD),Speech Pathology (C_1_C6_68),CMHC (B_1_C21_99),Nonphysician Anesthetists (A_C6_19),CT Scan (D3_SNF_C3_57),Durable Medical Equipment Sold (A_C1_97),Cross Foot Adjustments (B_2_C26_200),"AVERAGE HOURLY WAGE, Home Office Salaries & Wage Related Csts (S3_2_C6_14)",Electrocardiology (C_1_C6_69),"Interest, New Cap Related Csts Movable Equipment (A7_3_C11_2)","Net Expense for Cost Allocation, Cafeteria (B_1_C0_11)",RHC 19 Provider Number (S2_1_C2_1518),Other Reimbursable (D3_IRF_C3_98),"HHA II, With Outliers:  Non Routine Med Sup Chgs (S4_HHA2_C2_38)","ADJUSTED SALARIES, Maintenance of Personnel (S3_2_C4_37)",Total discharges (S3_1_C15_16),"Net Expense for Cost Allocation, Nonphysician Anesthetists (B_1_C0_19)",TOTAL (D3_SNF_C2_202),Pass through Cost for Program Inpatient Routine (D1_HOS_C1_50),Other Ancillary (B_1_C26_76),Whole Blood & Packed Red Blood Cells (D_4_HOS_C12_62),"AMOUNT REPORTED, Housekeeping under contract (S3_2_C2_33)","HHA III, PEP Episodes:  Total Number of Episodes (S4_HHA3_C4_36)",Radioisotope (D_4_HOS_C11_56),Intestinal Acquisition (C_1_C7_110),Employee Benefits (A_C1_4),Intravenous Therapy (D_4_IRF_C11_64),Anesthesiology (D3_HOS_C3_53),Electroencephalography (D3_IRF_C2_70),"ADJUSTED SALARIES, Wage Related Costs Other (S3_2_C4_18)",Coronary Care Unit (S3_1_C6_9),Other Ancillary (D_4_IPF_C11_76),TOTAL (D3_IRF_C2_200),Recovery Room (A_C1_51),Radiology-Diagnostic (D_4_IRF_C11_54),Respiratory Therapy (A_C2_65),Subprovider-IRF (D_1_HOS_C6_41),Int & Res (non approved teaching program (A_C1_100),FQHC 3 Provider Number (S2_1_C2_1602),Lung  Acquisition (B_1_C26_108),Durable Medical Equipment Rented (A_C1_96),Radiology-Diagnostic (D3_IPF_C2_54),Home Program Dialysis (D3_IRF_C3_94),Respiratory Therapy (C_1_C5_65),Hospice (C_1_C7_116),Heart Acquisition (A_C1_106),Fiscal Year Begin Date (FY_BGN_DT),"AVERAGE HOURLY WAGE, Social Service (S3_2_C6_42)","COST SERVICES SUBJECT TO DEDUCTIBLES AND COINSURANCE - COST, Other Ancillary (D_5_HOS_C6_76)",Occupational Therapy (D3_HOS_C2_67),Are provider based physicians' costs included in Worksheet A? (Y/N) (S2_1_C1_144),Cost of patients approved for charity care and uninsured discounts (S10_C2_21),Occupational Therapy (D_4_IPF_C13_67),"ADJUSTED SALARIES, Excluded Area Salaries (S3_3_C4_2)",Surgical Intensive Care Unit (S3_1_C7_11),Clinic (B_1_C21_90),Delivery Room and Labor Room (D3_HOS_C3_52),Durable Medical Equipment Rented (D3_SNF_C3_96),"Allocation of Interns & Residents Salary and Fringes, Adults and Pediatrics (B_1_C21_30)",Other Special Purpose (C_1_C5_117),Ratio of line 15 to line 16 (E_B_HOS_C1_17),Laboratory (D_4_HOS_C4_60),Amounts expected under 42 CFR (E_B_HOS_C1_16),"Allocation of Interns & Residents Salary and Fringes, Nursery (B_1_C21_43)",Renal Dialysis (D_4_HOS_C4_74),Drugs Charged to Patients (D_4_HOS_C1_73),Heart Acquisition (B_2_C26_106),Radiology-Diagnostic (D_4_HOS_C2_54),"Blood Storing, Processing, Trans (D_4_IPF_C11_63)",PBP Clinical Lab Services Program Only (D3_IRF_C3_61),Total Allied Health (D_4_HOS_C3_200),"PAID HOURS RELATED TO SALARIES, Net Salaries (S3_3_C5_1)",Whole Blood & Packed Red Blood Cells (D3_IPF_C3_62),Total Nonphysician Anesthetist Cost (D_4_IPF_C1_200),Physical Therapy (D3_IRF_C3_66),"PAID HOURS RELATED TO SALARIES, Social Service (S3_2_C5_42)",Radiology-Diagnostic (A_C2_54),Dietary (A_C2_10),Other Nonreimbursable (B_2_C26_194),Other Ancillary (D_4_HOS_C10_76),Ambulance Services (A_C6_95),Subprovider-IPF (C_1_C5_40),FQHC 4 Provider Number (S2_1_C2_1603),Pancreas Acquisition (A_C2_109),"Disposals and Retirements, Movable Equipment (A7_1_C7_6)","Net Expense for Cost Allocation, Occupational Therapy (B_1_C0_67)",Other Ancillary (D3_SNF_C3_76),Surgical Intensive Care Unit (C_1_C5_34),OOT (A_C2_9930),Respiratory Therapy (D_4_SNF_C11_65),"COST REIMBURSED SERVICES NOT SUBJECT TO DEDUCTIBLES AND COINSURANCE - CHARGES, Radioisotope (D_5_HOS_C4_56)","Sum of lines 3,4 divided by line 6 (E_B_HOS_C101_7)",Medical Supplies Charged to Patients (C_1_C5_71),"AVERAGE HOURLY WAGE, Excluded Area Salaries (S3_2_C6_10)","HHA III, Without Outliers:  Non Routine Med Sup Chgs (S4_HHA3_C1_38)",Speech Pathology (D_4_HOS_C10_68),"Disposals and Retirements, Fixed Equipment (A7_1_C7_5)",Operating Room (D3_SNF_C3_50),"Donations, Subtotal (A7_1_C3_8)",Subprovider 2 (S3_1_C8_1801),"Net Expense for Cost Allocation, Adults and Pediatrics (B_1_C0_30)","TOTAL CAPITAL COSTS AFTER COST ALLOCATION, Radioisotope (B_2_C26_56)","PPS REIMBURSED SERVICES -  CHARGES, Radiology-Therapeutic (D_5_HOS_C2_55)",Other Ancillary (B_2_C26_76),"COST SERVICES SUBJECT TO DEDUCTIBLES AND COINSURANCE - COST, Laboratory (D_5_HOS_C6_60)","Medicare certified kidney 
transplant center cert date (S2_1_C1_126)","COST SERVICES SUBJECT TO DEDUCTIBLES AND COINSURANCE - COST, Delivery Room and Labor Room (D_5_HOS_C6_52)",SNF (S3_1_C3_19),Total Facility FTEs (S3_1_C11_27),"PAID HOURS RELATED TO SALARIES, Administrative and General (S3_2_C5_27)","PAID HOURS RELATED TO SALARIES, Other General Service (S3_2_C5_43)","AMOUNT REPORTED, Physician Part A (S3_2_C2_2201)",Total Hospital (S3_1_C8_14),Line 2 times line 5 (E_B_HOS_C101_6),Total Hospital (S3_1_C6_14),Anesthesiology (A_C1_53),Hospice 3 Provider Number (S2_1_C2_1402),Other Reimbursable (D_4_HOS_C12_98),"COST SERVICES NOT SUBJECT TO DEDUCTIBLES AND COINSURANCE - COST, Other Reimbursable (D_5_HOS_C7_98)",CMHC 1 Provider Number (S2_1_C2_17),"General Inpatient Routine Service Cost, net of Swing Bed Cost (D1_HOS_C1_27)",Coronary Care Unit (D3_SNF_C2_32),certification date (S2_1_C1_131),RHC 13 Provider Number (S2_1_C2_1512),Other Organ Acquisition (C_1_C6_112),"Net Expense for Cost Allocation, Dietary (B_1_C0_10)",Zip Code (S2_1_C3_143),RHC 24 Provider Number (S2_1_C2_1523),Renal Dialysis (D_4_IPF_C13_74),Interns and residents (E_B_HOS_C1_22),Delivery Room and Labor Room (D_4_IRF_C11_52),"COST SERVICES SUBJECT TO DEDUCTIBLES AND COINSURANCE - COST, PBP Clinical Lab Services Program Only (D_5_HOS_C6_61)",Surgical Intensive Care Unit (A_C6_34),Renal Dialysis (C_1_C7_74),Surgical Intensive Care Unit Program Cost (D1_HOS_C5_46),Occupational Therapy (D3_IRF_C3_67),Kidney Acquisition (C_1_C7_105),HHA (C_1_C5_101),Respiratory Therapy (D_4_IRF_C11_65),"Insurance, Total (A7_3_C5_3)",Other Reimbursable (D_4_HOS_C11_98),Physicians' Private Office (B_1_C21_192),certification date (S2_1_C1_132),Program Ancillary Services (D1_SNF_C1_84),"Net Expense for Cost Allocation, Heart Acquisition (B_1_C0_106)",Other Outpatient Services (D3_HOS_C3_93),Nursing School (A_C1_20),SNF (A_C2_44),Operating Room (D_4_HOS_C3_50),"COST SERVICES NOT SUBJECT TO DEDUCTIBLES AND COINSURANCE - COST, Radiology-Therapeutic (D_5_HOS_C7_55)",Durable Medical Equipment Sold (D3_HOS_C3_97),Lung  Acquisition (B_1_C21_108),"HHA I, Total Visits (S4_HHA1_C5_33)",Hospital County (S2_1_C4_2),"COST REIMBURSED SERVICES NOT SUBJECT TO DEDUCTIBLES AND COINSURANCE - CHARGES, CT Scan (D_5_HOS_C4_57)","Allocation of Interns & Residents Salary and Fringes, Laboratory (B_1_C21_60)","COST REIMBURSED SERVICES SUBJECT TO DEDUCTIBLES  AND COINSURANCE - CHARGES, Observation Beds (Distinct Unit) (D_5_HOS_C3_9201)",Radiology-Diagnostic (D3_SNF_C3_54),Radioisotope (D_4_HOS_C4_56),"Net Expense for Cost Allocation, Other Outpatient Services (B_1_C0_93)","Disposals and Retirements, Building Improvements (A7_1_C7_4)","Allocation of Interns & Residents Salary and Fringes, Whole Blood & Packed Red Blood Cells (B_1_C21_62)","Total Inpatient Charges, Radioisotope (C_1_C6_56)",Hospice (B_1_C21_116),Speech Pathology (D_4_HOS_C11_68),RHC (B_2_C26_88),"PAID HOURS RELATED TO SALARIES, Interns & Residents (S3_2_C5_7)",MRI (D3_IRF_C2_58),Interest expense on Medicare Overpaymts (A8_C2_22),Title XIX discharges (S3_1_C14_18),IRF (S3_1_C8_17),Total Hospital (S3_1_C4_7),"Taxes, New Cap Related Csts Movable Equipment (A7_3_C6_2)",Whole Blood & Packed Red Blood Cells (D_4_IPF_C13_62),Speech Pathology (D_4_SNF_C11_68),Premiums (S2_1_C1_11801),Parking Lot (A8_C2_9),"Allocation of Interns & Residents Program Costs, Anesthesiology (B_1_C22_53)",CT Scan (D_4_HOS_C10_57),PBP Clinical Lab Services Program Only (A_C6_61),"Taxes, New Cap Related Csts Bldg & Fixtures (A7_3_C6_1)","AMOUNT REPORTED, Pharmacy (S3_2_C2_40)","Allocation of Interns & Residents Salary and Fringes, Blood Storing, Processing, Trans (B_1_C21_63)","ADJUSTED SALARIES, Home Office Salaries (S3_2_C4_1401)","AMOUNT REPORTED, Teaching Physician Salaries (S3_2_C2_16)",Occupational Therapy (B_2_C26_67),Adults and Pediatrics (D3_HOS_C2_30),SNF (S3_1_C6_19),Speech Pathology (D_4_IPF_C11_68),Other Special Care Unit (A_C2_35),"Net Expense for Cost Allocation, PBP Clinical Lab Services Program Only (B_1_C0_61)",Operating Room (D_4_IPF_C11_50),Clinic (D_4_HOS_C12_90),Nursery (D3_HOS_C2_43),Cardiac Catheterization (D_4_HOS_C2_59),"Total Inpatient Charges, Recovery Room (C_1_C6_51)",Intensive Care Unit (A_C6_31),CAPD exchanges per day (S5_C4_4),"AMOUNT REPORTED, Interns & Residents (S3_2_C2_2551)","COST REIMBURSED SERVICES SUBJECT TO DEDUCTIBLES  AND COINSURANCE - CHARGES, Electrocardiology (D_5_HOS_C3_69)",Subprovider I (A_C1_42),Emergency (D_4_HOS_C3_91),Subtotal (E_B_HOS_C1_32),Surgical Intensive Care Unit (D_1_HOS_C6_34),Intravenous Therapy (B_2_C26_64),"PAID HOURS RELATED TO SALARIES, Home Office:  Physician Part A (S3_2_C5_15)","Blood Storing, Processing, Trans (B_1_C26_63)",Pancreas Acquisition (B_1_C21_109),Delivery Room and Labor Room (D_4_HOS_C3_52),Cardiac Catheterization (D_4_SNF_C11_59),Whole Blood & Packed Red Blood Cells (D_4_HOS_C3_62),Respiratory Therapy (A_C6_65),"COST SERVICES SUBJECT TO DEDUCTIBLES AND COINSURANCE - COST, Durable Medical Equipment Sold (D_5_HOS_C6_97)","PPS REIMBURSED SERVICES -  CHARGES, Blood Clotting Factors for Hemoph. (D_5_HOS_C2_6250)",MRI (D_4_IRF_C13_58),Allowable bad debts (E_B_HOS_C1_34),Impl. Dev. Charged to Patients (D_4_SNF_C11_72),"Total Inpatient Charges, Subprovider I (C_1_C6_42)","ADJUSTED SALARIES, Interns & Residents (S3_2_C4_2551)",MRI (D_4_HOS_C10_58),Medical Supplies Charged to Patients (A_C6_71),"Number of Times per week
 Patient receives Dialysis (S5_C6_2)",Occupational Therapy (D_4_IPF_C11_67),"General Inpatient Routine Service Cost, net of Swing Bed and Private Room Diff (D1_SNF_C1_37)",Primary payer payments (E_B_HOS_C1_31),Int & Res (non approved teaching program (A_C2_100),Electrocardiology (D_4_HOS_C10_69),"Difference between Adjusted Inpatient, Operating Cost and Target Amount (D1_HOS_C1_57)","AMOUNT REPORTED, Excluded Area Salaries (S3_3_C2_2)",Total (D_3_HOS_C9_200),Whole Blood & Packed Red Blood Cells (D3_SNF_C3_62),"HHA III, LUPA Episodes:  Total Visits (S4_HHA3_C3_33)",Other Reimbursable (D3_HOS_C2_98),"AVERAGE HOURLY WAGE, Contract Labor (S3_2_C6_11)",ICF (S3_1_C2_2001),Intensive Care Unit (S3_1_C6_8),Radiology-Therapeutic (B_1_C26_55),"Other Capital Related Costs, New Cap Related Csts Movable Equipment (A7_3_C7_2)",Pass through Cost for Program Inpatient (D1_IPF_C1_50),Physical Therapy (D3_IRF_C2_66),Nursery (A_C1_43),CMHC (C_1_C7_99),Other Special Purpose (B_1_C22_117),"Average patient dialysis time 
including setup (S5_C3_3)",Physical Therapy (D_4_HOS_C13_66),Nonpaid Workers (B_1_C22_193),Medical Supplies Charged to Patients (D_4_SNF_C11_71),Other Ancillary (D_4_HOS_C11_76),Subprovider I (C_1_C5_42),"Net Expense for Cost Allocation, Impl. Dev. Charged to Patients (B_1_C0_72)",Total Salaries (A_C1_200),"Does the facility qualify and is it receiving payments for 
disproportionate share? (Y/N) (S2_1_C1_22)",Recovery Room (D_4_HOS_C2_51),"Treatment capacity per day per
station (S5_C2_7)",Burn Intensive Care Unit Program Cost (D1_HOS_C5_45),Burn Intensive Care Unit (D3_IRF_C2_33),"AMOUNT REPORTED, Maintenance and Repairs (S3_2_C2_29)",Electrocardiology (C_1_C5_69),"Net Expense for Cost Allocation, Maintenance and Repairs (B_1_C0_6)","AMOUNT REPORTED, Central Services and Supply (S3_2_C2_39)",Islet Acquisition (A_C1_111),"Number of patients in program at 
end of cost reporting period (S5_C6_1)","PPS REIMBURSED SERVICES -  CHARGES, Intravenous Therapy (D_5_HOS_C2_64)",Ambulance Services (C_1_C6_95),"Net Expense for Cost Allocation, Administrative and General (B_1_C0_5)",Nursing Administration (A_C1_13),Observation Beds (Distinct Unit) (D_4_HOS_C12_9201),Cross Foot Adjustments (B_1_C26_200),ASC (Non Distinct Part) (D3_HOS_C3_75),Emergency (D_4_HOS_C1_91),"PPS SERVICES COST, Operating Room (D_5_HOS_C5_50)",Recovery Room (D3_IPF_C2_51),"COST REIMBURSED SERVICES NOT SUBJECT TO DEDUCTIBLES AND COINSURANCE - CHARGES, Respiratory Therapy (D_5_HOS_C4_65)",MRI (D_4_HOS_C4_58),"Allocation of Interns & Residents Salary and Fringes, Impl. Dev. Charged to Patients (B_1_C21_72)",HHA (A_C6_101),Total Charges (C_1_C8_202),Intensive Care Unit (D3_HOS_C2_31),Other Ancillary (D_4_IPF_C13_76),Number of EPO units furnished for Line 13 (S5_C1_15),Occupational Therapy (C_1_C7_67),ASC (Non Distinct Part) (D3_IRF_C3_75),"PAID HOURS RELATED TO SALARIES, Physician-Part A (S3_2_C5_4)",Clinic (B_1_C22_90),Other Organ Acquisition (A_C1_112),"Total Outpatient Charges, PBP Clinical Lab Services Program Only (C_1_C7_61)",RPCH/CAH Visits (S3_1_C7_15),Other Organ Acquisition (A_C2_112),Total Other Medical Education (D_4_IRF_C4_200),Program Inpatient Ancillary Service Cost (D1_IPF_C1_48),Other Outpatient Services (D_4_HOS_C4_93),MRI (D3_IPF_C2_58),Total Hospital (S3_1_C4_14),Renal Dialysis (D_4_SNF_C11_74),"TOTAL CAPITAL COSTS AFTER COST ALLOCATION, Subprovider I (B_2_C26_42)","Net Expense for Cost Allocation, Electroencephalography (B_1_C0_70)",Emergency (C_1_C5_91),RHC/FQHC Combined (S3_1_C9_26),Renal Dialysis (C_1_C5_74),Pancreas Acquisition (B_2_C26_109),SSA State County Code (ST_CTY_CD),Hospital Title 18 Payment System (P/T/O) (S2_1_C7_3),Medical Supplies Charged to Patients (C_1_C7_71),Medical Supplies Charged to Patients (D3_IPF_C3_71),Ambulance Services (B_1_C21_95),HHA (S3_1_C7_22),"HHA III, W/Out Outliers:  Number of Episodes (S4_HHA3_C1_36)","General Inpatient Routine Service Cost, net of Swing Bed and Private Room Diff (D1_IRF_C1_37)","Allocation of Interns & Residents Program Costs, Radioisotope (B_1_C22_56)","HHA II, Total Other Charges (S4_HHA2_C5_34)","AMOUNT REPORTED, Cafeteria (S3_2_C2_36)",Liver Acquisition (B_2_C26_107),Surgical Intensive Care Unit (D_1_HOS_C4_34),Home Program Dialysis (C_1_C5_94),Negative Cost Centers (B_2_C26_201),Recovery Room (D_4_HOS_C3_51),"COST REIMBURSED SERVICES NOT SUBJECT TO DEDUCTIBLES AND COINSURANCE - CHARGES, Anesthesiology (D_5_HOS_C4_53)",SNF (S3_1_C11_19),Renal Dialysis (D_4_IPF_C11_74),Physical Therapy (D_4_IRF_C11_66),"HHA III, Total Charges:  LUPA Episodes (S4_HHA3_C3_35)",IRF (S3_1_C6_17),"Fully Depreciated Assets, Total (A7_1_C4_7)","Net Expense for Cost Allocation, ICF (B_1_C0_4501)",Whole Blood & Packed Red Blood Cells (D_4_IRF_C11_62),Fiscal Intermediary/MAC Create Date (FI_CREAT_DT),OPT (A_C6_9920),"Net Expense for Cost Allocation, OPT (B_1_C0_9920)",IRF Provider Number (S2_1_C1_5),Adults & Pediatrics (D_1_HOS_C7_30),HHA 1 Provider Number (S2_1_C2_12),"AVERAGE HOURLY WAGE, Housekeeping (S3_2_C6_32)","Purchases, Subtotal (A7_1_C2_8)","Net Expense for Cost Allocation, Laundry and Linen Service (B_1_C0_8)",MRI (D_4_IPF_C11_58),MRI (D3_IPF_C3_58),Renal 6 Provider Number (S2_1_C2_1805),"AMOUNT REPORTED, Home Office Personnel (S3_2_C2_8)",Impl. Dev. Charged to Patients (B_1_C26_72),Durable Medical Equipment Sold (D_4_HOS_C3_97),"Total Inpatient Charges, Whole Blood & Packed Red Blood Cells (C_1_C6_62)",Home Program Dialysis (B_2_C26_94),"HHA III, Total Visits (S4_HHA3_C5_33)",Occupational Therapy (D_4_HOS_C13_67),ASC (Distinct Part) (A_C1_115),Total Hospital Interns & Residents (S3_1_C11_14),"Net Expense for Cost Allocation, Liver Acquisition (B_1_C0_107)",Observation Beds (Distinct Unit) (D3_IRF_C3_9201),Pancreas Acquisition (A_C6_109),Radioisotope (D_4_HOS_C12_56),Nonpaid Workers (A_C2_193),"AMOUNT REPORTED, Related Salaries (S3_2_C3_1402)",Occupational Therapy (D_4_HOS_C10_67),Physical Therapy (C_1_C2_66),"TOTAL CAPITAL COSTS AFTER COST ALLOCATION, Surgical Intensive Care Unit (B_2_C26_34)",Hospital Adlts & Ped Swing Bed SNF (S3_1_C7_5),Kidney Acquisition (B_1_C22_105),"AVERAGE HOURLY WAGE, Home Office Personnel (S3_2_C6_8)",Islet Acquisition (C_1_C6_111),Electrocardiology (D_4_HOS_C13_69),"HHA III, PEP Episodes:  Other Charges (S4_HHA3_C4_34)",Renal 7 Provider Number (S2_1_C2_1806),"PAID HOURS RELATED TO SALARIES, Subtotal Other Wages and Related Csts (S3_3_C5_4)",RHC 6 Provider Number (S2_1_C2_1505),"HHA II, Without Outliers:  Other Charges (S4_HHA2_C1_34)",CORF (B_1_C26_9910),"AMOUNT REPORTED, Laundry and Linen Service (S3_2_C2_31)",ASC (Non Distinct Part) (D_4_IRF_C11_75),Other Outpatient Services (D3_SNF_C2_93),OPT (A_C1_9920),Impl. Dev. Charged to Patients (C_1_C6_72),Pharmacy (A_C1_15),New Capital Buildings and Fixtures (A_C2_1),Hospice (C_1_C6_116),RHC 1 Provider Number (S2_1_C2_15),CT Scan (D_4_HOS_C13_57),Other Outpatient Services (D_4_HOS_C13_93),IRF (S3_1_C5_17),"AMOUNT REPORTED, Excluded Area Salaries (S3_2_C2_10)",Nursery (B_1_C26_43),ICF (A_C1_4501),"PPS SERVICES COST, Radiology-Therapeutic (D_5_HOS_C5_55)",New Capital Equipment (A_C6_2),"Disposals and Retirements, Land (A7_1_C5_1)",Administrative and General (A_C1_5),Respiratory Therapy (D_4_IPF_C13_65),Subprovider-IRF (D3_SNF_C2_41),"Allocation of Interns & Residents Program Costs, Subprovider I (B_1_C22_42)",Electroencephalography (C_1_C7_70),"Allocation of Interns & Residents Program Costs, Operating Room (B_1_C22_50)","TOTAL CAPITAL COSTS AFTER COST ALLOCATION, CT Scan (B_2_C26_57)",Surgical Intensive Care Unit (S3_1_C4_11),Kidney Acquisition (B_1_C26_105),"Blood Storing, Processing, Trans (A_C2_63)",OLTC (B_1_C26_46),Deductibles and coinsurance related to line 24 (E_B_HOS_C1_26),Radiology-Diagnostic (D_4_HOS_C3_54),Other Reimbursable (D_4_IRF_C11_98),Clinic (D_4_IPF_C13_90),Drugs Charged to Patients (A_C1_73),Islet Acquisition (B_2_C26_111),Title XIX discharges (S3_1_C14_1),Intensive Care Unit (A_C1_31),Title XVIII discharges (S3_1_C13_2),ASC (Non Distinct Part) (D_4_IRF_C13_75),Other Ancillary (D_4_HOS_C3_76),"Total Inpatient Charges, PBP Clinical Lab Services Program Only (C_1_C6_61)",ASC (Non Distinct Part) (C_1_C6_75),HHA (B_1_C22_101),Medicaid Observation Days (S3_1_C8_28),OOT (B_1_C26_9930),Cardiac Catheterization (D_4_HOS_C10_59),Durable Medical Equipment Rented (C_1_C7_96),Renal Dialysis (D3_IPF_C3_74),Emergency (B_1_C21_91),Whole Blood & Packed Red Blood Cells (D_4_SNF_C11_62),"AVERAGE HOURLY WAGE, Dietary (S3_2_C6_34)",Utilization Review-physicians compens (A8_C2_25),"Does this facility operate 
transplant center? (Y/N) (S2_1_C1_125)",Speech Pathology (D3_HOS_C2_68),ASC (Distinct Part) (A_C6_115),Hospice (B_2_C26_116),Durable Medical Equipment Sold (C_1_C5_97),Subprovider-IRF (A_C1_41),"Total Inpatient Charges, Subprovider-IPF (C_1_C6_40)","AMOUNT REPORTED, Social Service (S3_2_C2_42)",Renal Dialysis (D_4_HOS_C12_74),Total (D_4_IPF_C13_200),"COST REIMBURSED SERVICES SUBJECT TO DEDUCTIBLES  AND COINSURANCE - CHARGES, Radiology-Therapeutic (D_5_HOS_C3_55)",Intravenous Therapy (D_4_HOS_C11_64),Laboratory (D_4_HOS_C13_60),Emergency (D_4_HOS_C12_91),"TOTAL CAPITAL COSTS AFTER COST ALLOCATION, Cardiac Catheterization (B_2_C26_59)",Recovery Room (A_C6_51),Laboratory (D_4_IRF_C11_60),"PPS REIMBURSED SERVICES -  CHARGES, Speech Pathology (D_5_HOS_C2_68)","AMOUNT REPORTED, Wage Related Costs Core (S3_2_C2_17)",FQHC 6 Provider Number (S2_1_C2_1605),Renal 4 Provider Number (S2_1_C2_1803),Radiology-Diagnostic (D_4_IPF_C13_54),Clinic (D3_IPF_C3_90),"AMOUNT REPORTED, Wage Related Costs RHC/FQHC (S3_2_C3_24)",Beginning Date of SCH status (S2_1_C1_3601),"Allocation of Interns & Residents Program Costs, Speech Pathology (B_1_C22_68)",Cardiac Catheterization (D3_HOS_C2_59),OSP (A_C6_9940),Delivery Room and Labor Room (D3_IRF_C3_52),"PAID HOURS RELATED TO SALARIES, Admin & Gen Under Contract (S3_2_C5_29)",Is this hospital classified as a referral center? (Y/N) (S2_1_C1_116),"Average patient dialysis time 
including setup (S5_C2_3)",Intravenous Therapy (B_1_C26_64),OLTC (S3_1_C8_21),"AMOUNT REPORTED, Interns & Residents (S3_2_C3_2553)","ADJUSTED SALARIES, Nursing Administration (S3_2_C4_38)","AVERAGE HOURLY WAGE, Total Overhead Costs (S3_3_C6_7)",Paramedical Education (A_C1_23),Intravenous Therapy (D_4_HOS_C12_64),Total Hospital (S3_1_C7_14),Received DSH or supplemental payments from Medicaid? (Y/N) (S10_C1_3),Hospital Type (S2_1_C4_3),"TOTAL CAPITAL COSTS AFTER COST ALLOCATION, Radiology-Diagnostic (B_2_C26_54)",Intestinal Acquisition (B_1_C22_110),"COST REIMBURSED SERVICES SUBJECT TO DEDUCTIBLES  AND COINSURANCE - CHARGES, Anesthesiology (D_5_HOS_C3_53)",or allied health costs? (S2_1_C1_60),OLTC (S3_1_C3_21),Heart Acquisition (C_1_C5_106),"Net costs of Epoietin furnished to
all maintenance dialysis patients
by the provider (S5_C1_13)",Social Service (A_C6_17),"Total Outpatient Charges, Whole Blood & Packed Red Blood Cells (C_1_C7_62)",CT Scan (D_4_HOS_C3_57),Home Program Dialysis (D3_HOS_C2_94),FFY,Hospital Type (Care Compare),Name and Num
4558,NORTH SHORE UNIVERSITY HOSPITAL (330106),General Short Term (Acute Care Hospitals),Voluntary Nonprofit-Other,-73.703029,40.779269,,,,,789115.0,,25746940.0,,,,,,,1424512.0,342358.0,,16885882.0,,,,,11665.0,,,,,438287278.0,,7075.0,8158621.0,103017016.0,,3084726268.0,,,N,3.0,219101.0,,,14904791.0,57181526.0,2491859.0,,218.28,,,24194.0,88159340.0,,,,,5326722.0,,24367.0,,18068673.0,137055.0,,,,221322786.0,,26114745.0,,363388.0,10875767.0,,,,2983980.0,1.0,24034164.0,,,,40127910.0,,,,21414145.0,,7220776.0,,6017303.0,,2394426.0,,211782.0,,,2267.0,,,,,,,3431146.0,,801550870.0,,15715083.0,1420678.0,,12514.0,,1692420.0,,5039.0,,,,,4039.0,-1340337.0,68290856.0,,,16885882.0,36388142.0,,,,61583.0,,,,,2657381.0,,,,,,75388.0,,1692420.0,,14689514.0,,,,,,,,,225344.0,,,,,1436140.0,,,,,205214743.0,,,,928478.0,,51.0,873884.0,,848482.0,,122358538.0,,,,165358.0,27.57,,,N,,777.0,39.66,,-500347.0,44647060.0,,,4570.0,108046.0,,,,,,,,,7.0,,,76291.0,,33,,,,,11109370.0,2276228.0,,,144828.0,,3161938.0,,,,4397983.0,,6065866.0,,12053738.0,5215038.0,,,86789.0,,25882104.0,,1732933.0,,6017303.0,,,1542109.0,,MANHASSET,,,,3488470.0,42510726.0,,355865.0,,,,,9951.0,,,,,,,43612717.0,,,68056104.0,,471941.0,,3521.0,,28.41,,,1061919.0,2520899.0,19073964.0,,,,,,,,,2454049.0,,,1.0,,45279.0,11875682.0,,,363054.0,4180437.0,,219.68,,566359.0,13304723.0,,,,,,N,150596.0,,285267.0,1145144.0,84.0,,,52.99,,7217327.0,,10298790.0,1732787.0,,,13011538.0,,,,5970913.0,,27908206.0,-2806478.0,405429.0,6699.0,,,,,13423669.0,13011538.0,,,,,24079576.0,,101362777.0,-120340.0,,,,2210740.0,920410.0,2165649.0,,,,2153284.0,,,,1291366580.0,,,,,,,145044020.0,,,221007.0,,,,,1773.0,,205214743.0,,,,,159701540.0,,,70270817.0,,13304723.0,,,34907210.0,6913.0,46.15,13011538.0,,,,6491441.0,20457.0,,,10245.0,3282290.0,18942839.0,,N,,2896575.0,28282592.0,3521.0,,,2679828.0,,,,,,,,20165157.0,,17857989.0,1599040.0,,663512.0,,,,,,,,20455108.0,88568766.0,873884.0,,,,,2891554.0,2346583.0,,,,,60.0,,-326300453.0,,,,330106,,,,7562163.0,15206.0,,,,,,1082804569.0,,185448480.0,,2374809.0,,,121150750.0,,,,13895219.0,,267113593.0,,,,129943.0,13208504.0,,,,25.95,131660348.0,,13878.0,,,,11748974.0,18485.0,16565042.0,12321999.0,,,,,,2577321.0,482205.0,,,11120.0,,2127440.0,1321793.0,,,16760946.0,,10905815.0,,2639102.0,95190.0,80950.0,,,,,,,,36029944.0,164713385.0,-35182.0,,259845.0,,1307422.0,5333133.0,,,,,,,,,466671.0,,,1655197.0,,,,-99722.0,,,2742271.0,18856068.0,119282407.0,872245.0,67296087.0,,N,,,35104886.0,49127226.0,,,,116308.0,,137545919.0,,,13182809.0,2767839.0,,,,-5156912.0,24034164.0,,,,,13796284.0,,,,1617492.0,,,,3597032.0,,,,1458681.0,47108902.0,,,7361155.0,,,,,,,,,,,,,,6759299.0,,,,22872.0,,3792915.0,,,2192490.0,-4033228.0,76291.0,,14646902.0,,,,,,,39.67,,,,,,,,,,,,3548576.0,,,,,-2334051.0,-10146424.0,,29842.0,283850743.0,7974888.0,4038.0,,,,109674110.0,,-34.0,,48552917.0,,35634830.0,,64523098.0,,304000.0,,,,35877070.0,2611588.0,,,36.0,300 COMMUNITY DRIVE,37762013.0,,5096393.0,,,,,,443259.0,,10436292.0,,21414145.0,,5748097.0,22447.0,,,,,4457707.0,679047.0,,1629359.0,,,15671819.0,428.0,,873186.0,592844.0,,,1732933.0,,,,,,,2032195.0,,9381911.0,2657381.0,633930786.0,2340794.0,,,9627244.0,4631276.0,,,,14389765.0,9412833.0,,225427.0,,47108902.0,,,,,737320.0,1876060.0,,,,,35980818.0,,7731219.0,,,,655545899.0,,,7622799.0,8296557.0,,,,1215011756.0,2175913.0,,245285.0,,1167750.0,4943951.0,,112645.0,6941241.0,,,3543092.0,,44.1,,19.0,5941763.0,633844456.0,,,8098449.0,,,1629359.0,98282590.0,2479271.0,,,324642.0,,,3956390.0,,,,,907528.0,-51226.0,,,3492447.0,105928719.0,,35707028.0,18458297.0,,,,,48779.0,,,,,,183658.0,,26636246.0,63977879.0,,55269185.0,95190.0,,22319285.0,Y,-380710.0,,,,,,30733342.0,15462162.0,,970987.0,,,6054209.0,1020261.0,,,561358643.0,,,,,,,22579727.0,,,,16826.0,,13207.0,,,,848482.0,,,,,,48630897.0,,,,,,,,,3357251.0,,,-39778217.0,,8096.1,,,,,64804673.0,8648170.0,15523733.0,,533354,,,,,,36259314.0,,,,,,,,30394.0,,2084578.0,,,15873176.0,,,,,16826.0,70055.0,,27908206.0,,,20587708.0,,8967732.0,13182809.0,,,1159751.0,,18781154.0,,,,,,,64342384.0,,,,,103329.0,78506.0,,4875.0,819.0,,7030.0,,7269809.0,5290971.0,42810.0,,,,,10032742.0,,,,779835.0,380421.0,,,,610780.0,,681279.0,249.0,,43759612.0,,,,,,,267113593.0,333550,,21406094.0,,,,39.65,,,,68.65,,,35285715.0,,,,,,,,,2133806.0,,,,,321841.0,,,634.0,,196169.0,23834865.0,11068270.0,18421408.0,,,,,,335702,,,,8456506.0,,553129.0,,,,,62.41,,14928819.0,2646743.0,162748.0,12010924.0,,47569720.0,,,,,14116258.0,28070405.0,838779.0,,,,,30199.0,,18458297.0,,,,,1787.0,,,,,287.0,,C,28981.0,,,,,429829687.0,,,,58588902.0,,,,,,,,4805258.0,,,,-28536600.0,,97680.0,823318.0,,,,41374.0,-337422.0,,,,,,,35004,7433831.0,,,,,,,3711.0,,,Y,,,,,,2493.0,,,35980399.0,,,4.3,,847962.0,,22.71,,13403.0,,23.78,,,,16322136.0,,,,1056665.0,154786.0,,21152510.0,39164.0,-60324.0,,-260876.0,8648170.0,23094.0,,,16305574.0,298843783.0,,2681262.0,22933645.0,,,,,,,,,,,253966556.0,,,,,,,,16120219.0,,,,5475.0,447.0,,,69551.0,231838.0,,,250382.0,10922576.0,-1069004.0,,,,,,,3771885.0,,,457941.0,13977717.0,,5032535.0,,50039.0,,34460.0,,485630.0,2704.0,80925.0,410718.0,,,6796334.0,,,6064526.0,,,42510726.0,,21511435.0,,14928819.0,60993698.0,,72906598.0,-6966226.0,,,,,,3431146.0,2391925.0,,5793023.0,,2691.0,,,,,,,,,-445757910.0,,,,7149584.0,,25882104.0,,,942751.0,168.0,,,1082804569.0,,47796.0,,,1235111.0,N,508111.0,,,1297643.0,,,10905815.0,5380,,,,,,32038933.0,1078169.0,,5522433.0,,225427.0,,51937030.0,8109694.0,-1177154.0,,,1612626.0,,,,58319545.0,,2045229.0,475932.0,,,,100752.0,20292.0,6084535.0,,112672.0,,,,,21960058.0,,,,,,994405.0,,,,234465029.0,,,,,2646743.0,,,14116258.0,,,51558026.0,,,,,,,,,522077.0,,1043732.0,,,,,,,,14456245.0,,289658.0,,,,,,43612717.0,8648170.0,,,14350331.0,1130173170.0,,,,,,,,,10458795.0,,420323.0,,3924898.0,NY,,11120.0,,358866.0,110439.0,,,,,15889.0,569456.0,,210.0,,16645328.0,,26533730.0,,,49699556.0,,5679.0,,755051.0,,,,40.0,328.34,17785281.0,,,46.0,,61709.0,,,30842820.0,,,13173.0,,,,,,,498854.0,,,2374809.0,6082243.0,,,,,,,,8875969.0,23.53,,,,2873360.0,20063536.0,,,,24517585.0,,,312.9,,,2117.0,,,,439289.0,,2751747.0,,,58436412.0,87634.0,,22636758.0,,,8172783.0,37762013.0,,,15889.0,,,,212029.0,,,,,,,,,,,,388092.0,,11019154.0,,,,477496.0,14600.0,,,470902.0,,11788643.0,380421.0,51798.0,32804886.0,,,37033541.0,,,,,,,231838.0,,,,,,,,,,,,19501527.0,4158997.0,319264.0,,40271.0,,11135.0,,4135273.0,24664417.0,,85484.0,24897441.0,,,,2.0,,2271185.0,3944.0,,267113593.0,7233101.0,813853.0,1082804569.0,,548442.0,,154786.0,,12053738.0,,,38907996.0,,,,,,,,,,,,,,20587708.0,,,,2084578.0,,144016.0,1061919.0,,,3597032.0,,35634830.0,70879973.0,,8140230.0,2384118.0,,,,3137957.0,,104690749.0,267053244.0,,,,,,,,260128.0,56213055.0,,4875.0,,,,NSUH PSYCHIATRIC EXEMPT UNIT,,,292762.0,2441222.0,69712.0,,618050.0,12053738.0,13201,15866072.0,,,,,,,,,,,,,554705.0,,,N,33.5,3848626.0,,0.765,16171942.0,,146858.0,1253170.0,,,859218796.0,91559.0,,693501.0,7220776.0,,,,,F,51.8,12010924.0,,,,929753.0,184527.0,,,15.0,,,,,,63977879.0,,,,,5388553.0,,-12590154.0,7752.0,165120974.0,-30114.0,,,11789637.0,25038.0,8282217.0,8172783.0,,15579.0,419.0,,,17805079.0,,,,,,3883811.0,,,,,14904791.0,19249921.0,,,,,X,,,,231838.0,42995681.0,73640609.0,,5780182.0,7217227.0,,6558637.0,21150.0,119282407.0,,,,,7361155.0,11976974.0,,,12885997.0,,,,15889.0,140.0,,,,17369138.0,1629359.0,,,5792626.0,,-163567334.0,60993698.0,19249921.0,8290183.0,40252083.0,,11372393.0,10245.0,4865765.0,,,,8321918.0,,,,,209198.0,,,,,,,,803789.0,,42078496.0,,,,,86789.0,-51226.0,,120.0,1045937.0,,,,,1412445.0,617.0,,,,,50039.0,,,,,,,,26636246.0,,,,8902.8,,,,39.52,,16580302.0,,,,1317738.0,26805950.0,80729612.0,32765740.0,,32309866.0,33S106,,,334.0,,,,,,24897441.0,,,,,,1418.0,,,,7028814.0,,101282312.0,,2140765.0,,,3002876.0,-4033228.0,5078.0,919897.0,,15579.0,,,,,,16171942.0,,,,,32300361.0,,,33.3,,3746134.0,51558026.0,18615.0,184.0,14495641.0,,,,,,,,,,,74517.0,,,625955.0,,,,3543731.0,,,,655545899.0,,,5466236.0,,16322136.0,,2523572.0,13173.0,,,801550870.0,,,21951214.0,,0.253378,,,,,,86123443.0,7752.0,1757333.0,121150750.0,,,,22636758.0,,,6913.0,26035.0,,,,304111.0,,,463206.0,122407565.0,,,,7932389.0,,,,11945395.0,101282312.0,,,,32185.0,,,,,7268862.0,2121736.0,,,,95190.0,90914806.0,,46789.0,-357196.0,,,,,,,,,,14350331.0,,,10030,22847315.0,,,,,617.0,10705717.0,N,920410.0,,,,,,,,,,,,26423354.0,740614670.0,-445757910.0,13208504.0,,4806517.0,,,,14389765.0,,547131.0,,38398132.0,,,,,,,,,35.37,,,,,104.0,2300802.0,,,,,,,,16929.0,,5857912.0,,,,109766462.0,,,,7562163.0,,,,,1073165.0,22872.0,15889.0,,,,53.0,,11976974.0,,2.0,,,,,99487.0,,,,,,,,-263163603.0,90914806.0,,,,,,,23736.0,,6017303.0,,9208.0,,,,,,5246195.0,,16078953.0,,1415908.0,,,8167019.0,,,44367840.0,,,,42074975.0,1629359.0,425649.0,,,,99849.0,,6558637.0,,,,,185448480.0,,,,3944.0,,,25746940.0,,575706.0,,56213055.0,,4312679.0,,,,,6759299.0,,,,,,,,,,,83635.0,1560254.0,,,,,,,,,,,12946170.0,,,,,,,4457707.0,,47566199.0,,,,16120219.0,,2370.0,,8567601.0,,,,,314.0,137642726.0,,,,4488136.0,199.2,96552917.0,,4725688.0,5147043.0,,10705717.0,,54677203.0,553536831.0,3521.0,,,68056104.0,325.1,,,,,,54.0,86123443.0,10905815.0,1165904.0,86962259.0,,368621.0,,,,,,,,,NORTH SHORE UNIVERSITY HOSPITAL,,,2384118.0,,2011-12-31,,165898946.0,,,,,,16790.0,,,,,-1959963.0,,,192.0,,,,,,7269809.0,598796.0,13953981.0,,69155087.0,46153515.0,,2253436.0,,,,748436482.0,,,,,,,,,,,,24517585.0,,115516768.0,1072.0,,222610311.0,68044.0,,42776116.0,,,,1188743633.0,,,,,,9053313.0,,,,,11976974.0,22847315.0,,3.0,13446517.0,-1731521.0,,7292268.0,35798336.0,,,,,352109.0,,404570.0,1027965.0,,,,137055.0,,,150536678.0,,,55269185.0,2396876.0,,5,2969439.0,,,,,2363189.0,,100678585.0,2913428.0,1702826.0,,,,,1151.0,,9664415.0,12705193.0,2121736.0,,,,,,6558637.0,,,,,2267.0,,,7681125.0,,1375189.0,,,,,,109445.0,,11789637.0,,,2011-01-01 00:00:00,38.89,,,Y,2650029.0,,80307625.0,95.0,2466262.0,10357.0,,9201530.0,,,,,,,,,,,,15889.0,15986176.0,,,,68330.0,13639904.0,7373995.0,699912.0,46789.0,-5746854.0,12053738.0,,,,,,14646902.0,,,,,,43.13,,,,,,,108947697.0,587783.0,10298790.0,274815.0,,04/04/2008,,90885.0,,1335156.0,3531067.0,,283917.0,,109356.0,,,,,,267113593.0,,,,,12850795.0,,,,,,,,30516448.0,,,,48552917.0,,,,,,5096393.0,,,,532471.0,,,,,144224.0,NASSAU,,2053131.0,,75431.0,,793945.0,,,3227456.0,,,,648455.0,,,,,,,,,,-1959503.0,,22319285.0,,,8233946.0,,,,,501984245.0,40555.0,,757561.0,,,3746134.0,,,34532450.0,-199701.0,,,,,,35784649.0,9208.0,,,15715083.0,,,,,,,,,280242.0,,,,11068270.0,,7.0,,35634830.0,13687.0,,38398132.0,,72572143.0,358866.0,,,,68.65,,2691.0,6065866.0,,319264.0,,3773238.0,,,4.3,,,,,,72804265.0,801550870.0,Y,,,,,848482.0,35285715.0,3721842.0,2891554.0,,35.0,,,168020962.0,8109694.0,,,,,3905695.0,73576.0,,,,-502236.0,4273469901.0,25419737.0,,42613.0,,,110108.0,3170140.0,,,,,,363388.0,,27682.0,,,,1635607.0,36259314.0,,16305574.0,,33400,P,,,,32158.0,,,852880.0,,1692420.0,,16929.0,443259.0,,,,,,,,,,,,2014-04-25 00:00:00,,,,10722202.0,337148,23.57,104690749.0,4107596.0,,2010.0,,,88159340.0,,,21319.0,,,,,,,,5522433.0,,,,,892762.0,,,,,,,,23736.0,,,,2374809.0,,,,200260628.0,8233946.0,47217092.0,,,,,,59560605.0,8167019.0,,1214341.0,-4162314.0,,70879973.0,,,,173855.0,6855229.0,807557.0,,3002876.0,8367099.0,,9768630.0,,,,,,2117.0,5226989.0,,,,,,,,,,,,3355116.0,,29.54,,Y,,,,,,50927436.0,2657381.0,1418.0,,,,,14495641.0,,,,,159701540.0,,,,,,,,,,,25483.0,N,,,,,8109694.0,20.1,,,13878.0,Y,General Short Term,8032857.0,,,Y,,,402692.0,,,,,2011,Acute Care Hospitals,NORTH SHORE UNIVERSITY HOSPITAL (330106)
9862,NORTH SHORE UNIVERSITY HOSPITAL (330106),General Short Term (Acute Care Hospitals),Voluntary Nonprofit-Other,-73.703029,40.779269,,,,,693690.0,,7588999.0,,,,,,,955101.0,295795.0,,25167515.0,-27462.0,,,,10662.0,,,,,542022789.0,,4857.0,8871853.0,95529789.0,,3341117301.0,,,N,3.0,614939.0,,,16733524.0,71963672.0,3312467.0,,215.72,,,55703.0,81928933.0,,,,,7773814.0,,33198.0,,59357030.0,994114.0,,,,259261315.0,,23824670.0,,382716.0,9275994.0,,,,3102463.0,1.0,24538651.0,,,,31994973.0,,,,23183113.0,,9177186.0,,6465767.0,,2335072.0,,220241.0,,,1689.0,,,,,,,2436866.0,,864011752.0,,16289686.0,1781508.0,,22156.0,,1375867.0,160.0,28778.0,,,,,3567.0,-1173799.0,124303032.0,,,25167515.0,,,,,73829.0,,,673775.0,,3153624.0,,,393109.0,,,3947.0,,1375867.0,,12186120.0,,,,,,,,,53063.0,,,,,1480770.0,,,,,255165452.0,,,,946552.0,,51.0,235372.0,,1081011.0,,139319459.0,,,,182094.0,28.25,,,N,,781.0,48.62,1258780.0,-1500176.0,21051021.0,,,33313.0,141804.0,,,,,,,,,7.0,,,,,33,,,,11578.0,11352863.0,2978336.0,,,181247.0,,5460265.0,,,,4849112.0,,6281200.0,,12397661.0,4064322.0,,858213.0,1143682.0,,31961417.0,,1882741.0,,6465767.0,,,1708356.0,,MANHASSET,,,,3908545.0,47083028.0,,914835.0,,,,,13482.0,,,,76.0,,,41479731.0,,,59789357.0,,488935.0,,198.0,,29.36,,,1214997.0,2371344.0,35294463.0,990000.0,,,,,,,,2444238.0,,,1.0,,,5228615.0,,,397969.0,4697869.0,,265.53,,435253.0,31275120.0,,,,,,N,177884.0,,285666.0,813562.0,202.0,,,59.46,,7118408.0,,12534767.0,1749194.0,,,13812208.0,,,,8235840.0,,33493612.0,-2696989.0,429221.0,2073.0,,,,,14219849.0,13812208.0,10.0,,,,21351547.0,,88425735.0,-203896.0,,,,12915106.0,1563235.0,2365876.0,,,,2162298.0,,,,1374903844.0,,,,,,,177137910.0,,,250098.0,,,,,1012.0,,255165452.0,,,24687.0,,179880601.0,,,62200319.0,,31275120.0,,,36743901.0,5851.0,47.63,13812208.0,,757.0,,5130527.0,42486.0,,,8592.0,4336373.0,16571549.0,,N,,2998809.0,23604861.0,198.0,,,3170951.0,,947.0,,,,,,340186.0,,19664307.0,1881618.0,,703078.0,,,,,,,,28503180.0,90078479.0,235372.0,,,,,3258933.0,11277345.0,,,,9043.0,60.0,,-341209885.0,,,,330106,,,,10476424.0,23074.0,,,,,,1138466652.0,,187469600.0,,2517882.0,,,112529263.0,,,,12426413.0,,257889268.0,312394.0,,,151996.0,15684575.0,,,,25.59,139695430.0,,11116.0,,,,12471934.0,5574.0,18524211.0,24504580.0,,,,,,2855560.0,468433.0,,,10174.0,,2593569.0,1304087.0,,,20424437.0,,10878401.0,,3311872.0,87496.0,61176.0,,,,,,,,38602976.0,180689512.0,-95916.0,,248999.0,,1490096.0,5518501.0,,,,,,,,24687.0,494309.0,,,1986354.0,,,,-70158.0,,,3065677.0,26621562.0,207667365.0,1290781.0,68260458.0,,N,,,35087828.0,52739719.0,,,,214142.0,,148884957.0,,,21395299.0,2685747.0,490.0,,,-7351979.0,24538651.0,,,,,13669526.0,,,1693362.0,1511015.0,,,,5678848.0,,,,4145769.0,38968997.0,,,9202769.0,,,,,,,,,,,,,,6202872.0,,,,20393.0,,3520235.0,,,2946990.0,-2499004.0,,,32558685.0,,,,,,,44.05,,,,,,,,,,,,3851972.0,,,,,-2403833.0,-9572942.0,1313297.0,318060.0,261336857.0,7719769.0,3723.0,,,,100630025.0,,,,46463254.0,,38683593.0,,103792964.0,,163112.0,,,,36949916.0,2614680.0,,,36.0,300 COMMUNITY DRIVE,30198576.0,,5146751.0,,,,,,208912.0,,5944825.0,,23183113.0,,6021392.0,17327.0,,,821118.0,,9166018.0,755193.0,,1417931.0,,,16970994.0,450.71,,962862.0,540047.0,,,1882741.0,,,,,,,2146338.0,,3701629.0,3153624.0,617899408.0,2247070.0,,,9293443.0,5206276.0,,,,10929562.0,39105015.0,,227106.0,,38968997.0,,,,,735745.0,2554865.0,,,,,36972522.0,,3191096.0,,,,728667218.0,,,8043997.0,3459563.0,,4986.0,9893891.0,1276503239.0,2300710.0,,68375.0,,1109998.0,5570871.0,,,9525272.0,,,4416539.0,,48.51,,19.0,3968900.0,617666368.0,,,8842122.0,,,1417931.0,81878813.0,2429534.0,,118008.0,350767.0,,,4047328.0,,,11907863.0,,106600.0,-2470286.0,,,3365501.0,106281337.0,,39993604.0,35382422.0,,,,,146699.0,,,,,,182282.0,,52758869.0,61786515.0,,56262673.0,87496.0,,33779181.0,Y,-402818.0,,,,,,31178302.0,14751790.0,,864416.0,,,3649925.0,983714.0,,,544142349.0,,,,-425853.0,,,23862112.0,,,,15560.0,,5463.0,,,,1081011.0,,,,,,104870564.0,,,,,,,,,3669745.0,,,-25542997.0,,8432.93,,,,,72866366.0,9646527.0,16301315.0,,545904,,,,,,38973075.0,,,,,,,,30394.0,,3070122.0,,,19244589.0,,,,,15560.0,81092.0,833526.0,33493612.0,490.0,,26937767.0,,7462000.0,21395299.0,,,827582.0,,20008945.0,,,,,,,112188442.0,,10.0,,,23797.0,83560.0,,4267.0,5888.0,,160332.0,,29223765.0,6023688.0,16684.0,,,,,8227517.0,201806.0,,,699495.0,373125.0,,,,694052.0,,664410.0,249.0,,47278649.0,,,,,,,257889268.0,333550,404599.0,16666480.0,,,4304.0,43.18,,,,58.6,,,36143181.0,,,,,,,,,1911180.0,,,,,296585.0,,,6142.0,,135203.0,22916063.0,11943573.0,19153412.0,,,,,,335702,,,,,,752251.0,,,,,53.21,,20298748.0,2840938.0,145922.0,19766631.0,,54681594.0,,,,,11601915.0,27421185.0,888797.0,,,,,425259.0,,35382422.0,,,,,8068.0,,,,,249.0,,C,41817.0,,,,,557045220.0,,,,65494378.0,,,,,,,,4713644.0,,2083.0,,-28896450.0,,114409.0,148657.0,,,,57585.0,-605332.0,,,,,,,35004,7745523.0,,,,,,,3764.0,,,Y,,,,,,2808.0,,4455.0,36973713.0,,,4.3,,1123484.0,,22.45,,15603.0,,24.33,,,,8501267.0,,,,922802.0,147092.0,,46243379.0,32430.0,,,-260919.0,9646527.0,23390.0,,,14531086.0,278915942.0,,2429883.0,23905562.0,,,,,,,,14526.0,,,242023120.0,,,,,,,,17250525.0,,,,5490.0,215.0,,,90008.0,224230.0,,,238781.0,11675259.0,-1170237.0,,,,,,,3433314.0,,,482522.0,12183518.0,,5164035.0,,47887.0,,36376.0,,778165.0,1769.0,84408.0,456095.0,,7384.0,6470758.0,,313526.0,16457289.0,,,47083028.0,,20827715.0,,20298748.0,62545754.0,,15230055.0,-6552116.0,3015424.0,,,,,2436866.0,2354735.0,,7266098.0,,2303.0,,,,,213802.0,,,,-453627887.0,,223698.0,,8359255.0,,32357697.0,,,1731677.0,,,,1138466652.0,,28353.0,,,1368899.0,N,588804.0,,,1461693.0,,,10878401.0,5380,360091.0,,14526.0,,,35457710.0,1103957.0,,5811388.0,233040.0,227106.0,,50896080.0,8087120.0,-1309829.0,,,1783926.0,971429.0,,,88367507.0,,2179427.0,709498.0,,,,97372.0,34520.0,7615872.0,,145922.0,,,,,14058228.0,,,,,,918570.0,,,102.0,224549099.0,,,,,2840938.0,,,11601915.0,,,60431671.0,,,,,,,,,4213.0,,1179367.0,,,,,,,,15468704.0,,65908.0,,,326920.0,,,41479731.0,9646527.0,,,12764280.0,1187120984.0,1341774.0,,,,,,,,59782774.0,,425050.0,,2427155.0,NY,,10174.0,50.0,91871.0,108029.0,,,,,1297.0,270241.0,,218.0,,13706456.0,326920.0,25497528.0,,,53612420.0,,4951.0,,437669.0,531293.0,,,40.0,333.5,20340628.0,,,46.0,,411979.0,,,34050289.0,,,13830.0,,,,,,,461356.0,,,2517882.0,6857839.0,,,,,,1489250.0,,9428615.0,24.83,,,,2925746.0,15238268.0,,,,23891283.0,,,286.83,,,1970.0,382.0,,,1054036.0,,2570408.0,,971429.0,34575263.0,,,27594731.0,,,9075381.0,30198576.0,17343436.0,,1297.0,,,,240587.0,,,,,,,,,,,,371438.0,,19088563.0,,,,460326.0,14640.0,,,360085.0,,12793355.0,373125.0,71251.0,30819756.0,,,36679574.0,,11907863.0,,,,,224230.0,,,,,,,,,,,,17474021.0,3943442.0,272405.0,,40777.0,,10433.0,1631220.0,3816030.0,22233569.0,,80098.0,33354645.0,,,,2.0,,2640704.0,3879.0,,257889268.0,7334445.0,486010.0,1138466652.0,,160234.0,,147092.0,8344171.0,12397661.0,,,38287393.0,,,,,,,,,,,,142269.0,,26937767.0,,,,3070122.0,,207571.0,1214997.0,,,5911888.0,,38683593.0,91656893.0,,9515051.0,2721012.0,,,,3064717.0,,94654971.0,285450960.0,,,,,,,326920.0,309598.0,20539975.0,,4267.0,,,,NSUH PSYCHIATRIC EXEMPT UNIT,,,380263.0,2467407.0,123168.0,,599566.0,12397661.0,13001,12599705.0,,,201806.0,,,,,,,,,,556546.0,,,N,35.0,4170426.0,,,16199046.0,,340250.0,1384618.0,,,866119374.0,237338.0,,777157.0,9177186.0,,,181549.0,,F,57.78,19766631.0,,,,884120.0,,,,15.0,,,,,,61786515.0,,,,,5678288.0,,-17424220.0,138510.0,178387635.0,-33256.0,,,12546248.0,13266.0,7734371.0,9075381.0,,15408.0,-1191.0,,,14534038.0,,,,,164224.0,4424630.0,,,,,16733524.0,20573201.0,,,,,X,,,,224230.0,34452824.0,32734193.0,,6121257.0,4187559.0,,8853993.0,19764.0,207667365.0,1393.0,,,85201.0,9202769.0,13039170.0,,,3504604.0,,,,1297.0,1755.0,,,,18139965.0,1417931.0,,,5078078.0,,-173385919.0,62545754.0,20573201.0,8074165.0,41064503.0,,14746149.0,8592.0,4798651.0,,,,7097461.0,448.0,,,,181247.0,,,8094348.0,,,,,779927.0,,43135048.0,,,,,1143682.0,-2438837.0,,,653151.0,,,,,1472899.0,621.0,,,,,47887.0,,,,,,,,52758869.0,,,,9235.5,,,,38.24,,16682708.0,,,,1467011.0,4323011.0,121983093.0,37408656.0,,32958087.0,33S106,,,353.0,,,,,,33354645.0,,,305345.0,,,14394.0,,89828.0,,19663309.0,,114239834.0,,2069438.0,,,3281623.0,-2499004.0,,2081711.0,,15408.0,,,,,,16199046.0,,,-1774.0,,29941195.0,,,35.1,,4620723.0,60431671.0,18666.0,,19497370.0,,,,,117.0,,,,,,61278.0,,,504094.0,,,,3850535.0,,,,728667218.0,,,3999894.0,,8501267.0,,2510345.0,13830.0,,,864011752.0,,,33271429.0,,0.233665,6813.0,,,,,88562759.0,138510.0,1744849.0,112529263.0,,396280.0,,27594731.0,,,5851.0,26909.0,,90.0,,276016.0,,,650016.0,133303902.0,,,,8459247.0,,,,10393226.0,114239834.0,,,,16477.0,,,,,7498773.0,1991368.0,,,,87496.0,90842013.0,,122731.0,-43450.0,,,,,,,,,,12764280.0,,,10030,23672522.0,,,,,621.0,17401721.0,N,1563235.0,,,,,,,,,,,,29640669.0,724481233.0,-453627887.0,15684575.0,,4787473.0,858213.0,,,10929562.0,8094348.0,560217.0,,40552204.0,,,1258780.0,,,,56472.0,,36.74,,,,,178.0,3347960.0,,,,,,,,15345.0,,6089574.0,,,,116490858.0,,55583667.0,,10476424.0,,,,78991391.0,1531068.0,20393.0,1297.0,,,,81.0,,13039170.0,,2.0,218970.0,,,,139997.0,,,,,,,,-261812924.0,90842013.0,,,,,,189474.0,24195.0,,6465767.0,,8429.0,,,,,,6150652.0,,17328861.0,,1116186.0,,,9147798.0,,,49103889.0,,,,43134850.0,1417931.0,451031.0,,,,103505.0,,8853993.0,,,,,187469600.0,,,,3879.0,52.0,,7588999.0,,600804.0,1185180.0,20539975.0,,4069812.0,,,,,6202872.0,,,,,,,-91216.0,,,,166857.0,1657403.0,,,,,,,,,,,11303280.0,,,,,,,9166018.0,,54681396.0,,,,17250525.0,,1799.0,,8569642.0,,,,,314.0,121423840.0,,,,4898084.0,67.28,102692366.0,,6071880.0,14375578.0,,17401721.0,204.0,75952325.0,535593702.0,198.0,,,59789357.0,330.9,,66626168.0,,,,54.0,88562759.0,10878401.0,953767.0,63154394.0,,413592.0,,,,,,,,,NORTH SHORE UNIVERSITY HOSPITAL,,,2721012.0,,2012-12-31,,161576331.0,,,,,,16836.0,,,,,-1188016.0,,,192.0,,,,,,29223765.0,3086494.0,12159323.0,,89613869.0,47931123.0,,2414344.0,,,,733029880.0,,,,,,,,266.0,,,,23891283.0,,158751032.0,1076.0,,219462016.0,1027797.0,,42640085.0,,,,1531101447.0,,,,3015424.0,,9706267.0,,,,,13039170.0,23672522.0,,3.0,12803456.0,-2527144.0,,8391567.0,36866632.0,,,,,360649.0,,283690.0,1086549.0,,,,994114.0,,,164934683.0,,,56262673.0,2294106.0,,5,2133379.0,,,,,2394664.0,,113847107.0,3075763.0,2097670.0,,,,,1168.0,,12737598.0,11003263.0,1991368.0,,,,,,8853993.0,,,,,1689.0,,,8411527.0,,1244871.0,,,,,,122847.0,,12546248.0,,,2012-01-01 00:00:00,32.19,,,Y,13969142.0,,82072666.0,106.0,2812313.0,9778.0,,9339000.0,,,,,,,,,,,,1297.0,14305661.0,,,,97976.0,10676788.0,7421448.0,1913903.0,122731.0,-5244445.0,12397661.0,,,,,,32558685.0,,,,,,41.19,,409571.0,,,,,99984581.0,587768.0,12534767.0,263840.0,,04/04/2008,,91134.0,,1550871.0,,8344171.0,273309.0,,99917.0,,,,,,257889268.0,,,,,13857852.0,,,,,,,,30083917.0,,,,46463254.0,,,,,,5146751.0,,,,611537.0,,,,,142269.0,NASSAU,,2666391.0,,74140.0,,906201.0,,,9405362.0,,,,650604.0,,,,,,,,,34537743.0,-1188016.0,,33779181.0,,,8977610.0,,,,,528475110.0,42908.0,,601361.0,,,4620723.0,,,44692587.0,-210756.0,,,,,,36837319.0,8429.0,,,16289686.0,,,,,,,,,193147.0,,,,11943573.0,,7.0,,38683593.0,29313.0,,40552204.0,,73757059.0,91871.0,,,,58.6,,2303.0,6281200.0,,272405.0,,4166479.0,,,4.3,,,,,,66626168.0,864011752.0,Y,,,,,1081011.0,36143181.0,4006757.0,3258933.0,,,,,186696618.0,8087120.0,1489250.0,,247285.0,,10128135.0,203086.0,,,,,4872218748.0,43850439.0,,4655.0,,,113750.0,3493118.0,,,,,,382716.0,,19554.0,,,,1681008.0,38973075.0,,14531086.0,,33400,P,,,,18546.0,,,873280.0,,1375867.0,,15345.0,208912.0,,,,,,,,,11907863.0,,,2014-12-15 00:00:00,,,,9296450.0,337148,22.15,94654971.0,4267076.0,,1277.0,,,81928933.0,,,29129.0,,,,,,,,5811388.0,,,,,1416675.0,,,,,,,,24195.0,,,,2517882.0,,,,185865987.0,8977610.0,51233692.0,,,,,,59944851.0,9147798.0,,1459247.0,-3271384.0,,91656893.0,,,,4034650.0,6854420.0,789653.0,,3281623.0,8287186.0,,10339657.0,,,,,,1970.0,7323411.0,,,,,2646202.0,,,,,,,3276610.0,,25.37,,Y,409571.0,,,,,54059507.0,3153624.0,14394.0,,,,,19497370.0,,,,,179880601.0,,,,,,,,,,,30795.0,N,,,,,8087120.0,42.3,,,11116.0,Y,General Short Term,10083889.0,,,Y,,,640440.0,,,,,2012,Acute Care Hospitals,NORTH SHORE UNIVERSITY HOSPITAL (330106)
17079,NORTH SHORE UNIVERSITY HOSPITAL (330106),General Short Term (Acute Care Hospitals),Voluntary Nonprofit-Other,-73.703029,40.779269,,,,,630611.0,,6873419.0,1388.0,,,,,,527954.0,342992.0,,24098373.0,-102588.0,,,,11875.0,,,,,640470216.0,,5521.0,8935860.0,91696734.0,,3544932145.0,,,N,3.0,611043.0,,,16876084.0,103934381.0,3658035.0,,234.1,,,17438.0,90039089.0,265217.0,,,,,,35587.0,,77592452.0,1507773.0,,,,227983050.0,,23307667.0,,355960.0,7914262.0,,,,3049306.0,1.0,30294665.0,,,,26070758.0,,,,23952916.0,,10846314.0,,6521737.0,,2297486.0,,225954.0,,,1794.0,,,,,,,2202658.0,,928843331.0,,16616788.0,2022267.0,,23602.0,,1378031.0,95.0,36108.0,,,,,3320.0,-1158134.0,167221978.0,,,24098373.0,,,,748.0,55418.0,,,610499.0,,3218129.0,,,472412.0,,,1012.0,,1403712.0,,10852251.0,,,,,,,,,48642.0,,,,,1660535.0,,,,,306641167.0,,,,993169.0,,51.0,334403.0,,1287077.0,,143370707.0,,,,206238.0,26.73,,,N,,729.0,48.21,1408478.0,-1494588.0,22370138.0,,,27071.0,191400.0,,,,,,,,,7.0,,,,,33,,,,8219.0,11532977.0,2824331.0,,,171788.0,,5147800.0,,,,4974979.0,,6425317.0,,12354375.0,5481654.0,,841201.0,40633.0,,24122497.0,,2023035.0,,6876879.0,,,2252117.0,,MANHASSET,,,,4181365.0,52621934.0,,907109.0,,,,,16483.0,,,,42.0,,,38660179.0,,,66423015.0,,516117.0,,118.0,,30.43,,,2582409.0,3027387.0,36752246.0,,,,,,,,,2419308.0,,,1.0,,,5610814.0,,,364811.0,5116580.0,,225.49,,440883.0,35012257.0,,,,,,N,186074.0,,270052.0,652557.0,110.0,,,53.61,,7178089.0,,9973917.0,1532817.0,,,13622124.0,,,,9418915.0,,35747504.0,-3211803.0,516507.0,3895.0,,,,,14204093.0,13622124.0,4.0,,,,22989983.0,,102770377.0,-206872.0,,,,1690714.0,2714954.0,2218974.0,,,,1982142.0,,,,1336706837.0,,,,,,,190511254.0,,,205201.0,,,,,3041.0,,306641167.0,,,27594.0,,194447893.0,,,85894675.0,,35012257.0,,,34823426.0,5165.0,48.57,13794411.0,,207.0,,5060714.0,40782.0,,,7763.0,4643260.0,15004611.0,,N,,2842320.0,21984929.0,118.0,,,3252972.0,,13198.0,,,,,,1007313.0,,19996714.0,1397412.0,,656660.0,,,,,,,,20871131.0,93642823.0,334403.0,,,,,3246536.0,13383434.0,,,,8444.0,60.0,,-389898107.0,,,,330106,,,,11292418.0,29423.0,,,,,,1159441822.0,,201321312.0,,2399207.0,,,110949351.0,,,,12222856.0,,256154872.0,304409.0,,,124317.0,15188719.0,,,,27.52,151573099.0,,10034.0,,,,11990572.0,10350.0,20485709.0,1560397.0,,,,,,3412233.0,495278.0,,,9531.0,,3252147.0,1277289.0,,,22237671.0,,10727407.0,,3139045.0,80316.0,67597.0,,,,,,,,35471819.0,126138402.0,-65532.0,,232104.0,,1763539.0,5070877.0,,,,,,,,27594.0,468514.0,6.0,,2016320.0,,,,-105935.0,,,2989325.0,19473719.0,166575586.0,1632039.0,73129705.0,,N,,,33259953.0,55474897.0,,,,,,172025135.0,11907863.0,,25189480.0,2545593.0,643.0,,,-12590188.0,30294665.0,,,,,12384786.0,,-1188033.0,1834063.0,1802791.0,,,319900.0,5810038.0,,,,4063849.0,38546138.0,,,11487279.0,,,,,,,,,,,,,,6568022.0,,,,43028.0,,4097118.0,,,2264003.0,-2419238.0,,,36391958.0,,,,,,,40.7,,179.37,,,,,,,,,,9039606.0,,,,,-2215814.0,-11266735.0,1203877.0,140740.0,254799866.0,7872760.0,3260.0,,,,97424914.0,,,,42504249.0,,37647833.0,,129761687.0,,163246.0,,,,39887439.0,2653821.0,,,34.0,300 COMMUNITY DRIVE,29996172.0,,4741316.0,747.0,,,,,1716560.0,,4963390.0,,23952916.0,,5113693.0,23436.0,,,791754.0,,13626711.0,808325.0,,1256830.0,,,20331723.0,459.3,,1060245.0,490384.0,,,2023035.0,,,,,,,2053659.0,,4148553.0,3229536.0,717162805.0,2242388.0,,,9632673.0,6196276.0,,,,14566005.0,23505146.0,,211869.0,,38546138.0,,,,,712871.0,2620993.0,,,,,41168414.0,,3257013.0,,,,844186315.0,,,8812445.0,3593982.0,,10743.0,14724242.0,1292848031.0,2378183.0,,247983.0,,792368.0,6470312.0,,,9127680.0,,,3382613.0,,48.11,,11.0,7364680.0,722795722.0,,,9103722.0,,,1318534.0,76254503.0,2635621.0,,227400.0,386823.0,,,4419591.0,,,7237931.0,,68624.0,-307932.0,,,3145429.0,121953322.0,,54974348.0,48957919.0,,,,,255502.0,,,,,,189214.0,,44774868.0,66720173.0,,56948056.0,80316.0,,41306915.0,Y,-1543070.0,,,,,,29820756.0,22051475.0,,871867.0,,,3552926.0,972528.0,,,641864402.0,,,,-1642571.0,,,23241155.0,,,,14894.0,,7815.0,,,621652.0,1287077.0,,,,,,7136635.0,,,,,,,,,3647093.0,,,-9656031.0,,9079.4,,,,,76355315.0,9589696.0,15543906.0,,572883,,,,,,39987132.0,,,,,,,,-224805.0,,2965718.0,,,21529402.0,,,,,14894.0,85008.0,813607.0,35747504.0,621.0,,26055754.0,,5783683.0,25189480.0,,,997522.0,,18390882.0,,521349.0,,,,,118117448.0,,4.0,,,138597.0,87119.0,,4931.0,4917.0,,181439.0,,40139770.0,6314212.0,12558.0,,,,,8145242.0,83230.0,,,915022.0,356810.0,,,,570601.0,,2340875.0,249.0,,53488908.0,,,,,,,256154872.0,333550,389143.0,18835321.0,,,100845.0,40.89,,,,70.78,,,36767855.0,,,,,,,,,2403309.0,,,,,281109.0,,,514808.0,,490075.0,22249179.0,10614456.0,19380851.0,22.0,,,,,335702,,,,,,723263.0,,,,,66.11,,19856786.0,3041872.0,133764.0,24765017.0,,58430858.0,,,,,12968646.0,26451759.0,814745.0,,,,,532885.0,,48957919.0,,,,,2580.0,,,,,256.0,,G,54315.0,-102022.0,,,,643305248.0,,,,61470652.0,,,,,,,,4522173.0,,5866.0,,-28689514.0,,150267.0,223907.0,,,,44188.0,-1393319.0,,,,,,,35004,8019598.0,,,,,,,4155.0,,,Y,,,,,,9080.0,,1224.0,41169037.0,,,4.5,,1141192.0,,23.01,,15408.0,,24.04,,,,8782738.0,,,,904831.0,141441.0,,1525606.0,42122.0,,,-179034.0,9589696.0,21491.0,,,13520862.0,280951422.0,,2262652.0,23802377.0,,,,,,,,14927.0,,,239932318.0,319900.0,,,,,,,18015622.0,,,,5475.0,699.0,,,110825.0,211171.0,,617303.0,218887.0,11866443.0,-1150975.0,,,,,,,4084150.0,,,643975.0,15641277.37,,5918421.0,,47283.0,,30422.0,,854392.0,623.0,82317.0,469589.0,,6871.0,6375392.0,,174777.0,18242393.0,,,52621934.0,,19189856.0,,19856786.0,60662342.0,,14756679.0,-4808012.0,3534717.0,,,,,2202658.0,2422717.0,,7894668.0,,2317.0,,,,,175754.0,,,,-491292140.0,,,,10708072.0,,41777930.0,,,1882744.0,,,,1159441822.0,,23215.0,,,1356733.0,N,529868.0,,,1733197.0,,,10461551.0,5380,839756.0,,14927.0,,,35174531.0,1046348.0,,6155473.0,,211869.0,,48710658.0,7860722.0,-1179496.0,,,1319428.0,1539530.0,,,106552410.0,,2212938.0,1073395.0,,,,81110.0,60430.37,7551487.0,,133764.0,,,,,11653541.0,,,,,,936474.0,,,2808.0,222813691.0,,,,,3041872.0,,,12968646.0,13114.0,,67700234.0,,,,,,,,,658.0,,1327886.0,,,,,,,,15401391.0,,62469.0,,,319336.0,,,38660179.0,10055950.0,,,14565467.0,1209926194.0,799360.0,,,,,,,,9561594.0,,389744.0,,2548858.0,NY,,9531.0,2.0,126899.0,100989.0,,,,,1466.0,327211.0,,200.0,,17783005.0,319336.0,24259327.0,,,55500221.0,,6305.0,,864903.0,521865.0,,,40.0,332.9,22461765.0,,,46.0,,13609.0,,,32951489.0,,,14322.0,,,,,,,437280.0,,,2430251.0,6410000.0,,,,,,2391200.0,,10483370.0,18.18,,,,3215728.0,14596063.0,,,,21543011.0,,,237.9,,29886.0,1941.0,270.0,,,399890.0,,2451891.0,,1539530.0,41796849.0,,,29719001.0,61704.0,,9370629.0,29996172.0,26248207.0,,1466.0,,,,694906.0,,,,,,,,,,,,340491.0,,54224387.0,,,,450017.0,14600.0,,,400667.0,,15537509.0,356810.0,106743.0,33644029.0,,,37770371.0,,19145794.0,,,,,211171.0,,,,,,,,,1901.0,,,17118627.0,3849444.0,321501.0,,39895.0,,9802.0,1546097.0,4440110.0,24997106.0,,120572.0,41453448.0,,,,2.0,,2690466.0,3798.0,,256154872.0,6748837.0,510644.0,1159441822.0,,536004.0,,141441.0,8233775.0,12354375.0,,,35580945.0,,,,,,,,,,,,139534.0,,26055754.0,,344.0,,2965718.0,,387796.0,2582409.0,,,5810038.0,,37647833.0,96178008.0,,9457744.0,2875898.0,,,,2920403.0,,150472018.0,351097129.0,,,,,,,319336.0,368351.0,25035536.0,,4931.0,,,,NSUH PSYCHIATRIC EXEMPT UNIT,,,346743.0,2273990.0,114123.0,,539382.0,12354375.0,10001,19922259.0,,,83230.0,,,,,,,,,,559053.0,,,N,31.66,4269532.0,,,16900025.0,,182287.0,1670925.0,,,855296840.0,224529.0,,1000728.0,10846314.0,,,379459.0,,F,58.73,24765017.0,,,,840374.0,,,,15.0,,,,,,66720173.0,,,,,5626285.0,,-18987706.0,242009.0,119067697.0,-38874.0,,,11842013.0,12160.0,8335824.0,9370629.0,,14916.0,-623.0,,,18780527.0,,,,,158351.0,4009894.0,,,,,16876084.0,21201939.0,,,,,X,,,,211171.0,41075222.0,29372406.0,,6800855.0,4198411.37,,9943430.0,19493.0,166575586.0,1315.0,,,29587.0,11487279.0,12765770.0,,,5219560.0,,,,1466.0,1504.0,,,,19245818.0,1318534.0,,,5580425.0,,-206108619.0,60662342.0,21201939.0,7770955.0,39973129.0,,16537752.0,7763.0,3599426.0,,,,7768737.0,250.0,,,,171788.0,,,9331754.0,61704.0,,,,699503.0,,47330544.0,,-1188033.0,,,40633.0,-307932.0,,,428626.0,,,,,1620891.0,576.0,,,,,47283.0,,,,,,,,44216026.0,,,,9837.6,,,,42.33,,15763640.0,,,,1301046.0,4487815.0,95456269.0,41180784.0,,36517123.0,33S106,,,320.0,,,,,,41453448.0,,,297962.0,,,1112732.0,,226370.0,,25850788.0,,110553859.0,,1909179.0,,,3060611.0,-2419238.0,,2421717.0,,14916.0,,,,,,16900025.0,,,,,28315214.0,,,34.44,,3291373.0,67700234.0,18615.0,,21682124.0,,,,,6.0,,,,,,61010.0,,,462094.0,,,,3646966.0,,,,850569384.0,,,3952780.0,,8782738.0,,2836883.0,14322.0,,,934733685.0,,,39011671.0,,0.218646,4446.0,,,,,91282113.0,242009.0,1814602.0,110949351.0,,17655433.0,,29719001.0,,,5165.0,31070.0,,2160.0,,215822.0,,,595858.0,154275173.0,,,,9057032.0,,,,9245948.0,110553859.0,,,,15617.0,,,,,8113526.0,1819416.0,1388.0,,,80316.0,80587548.0,,44105.0,-561222.0,,,,,,,,,,14565467.0,351890.0,,10030,23544940.0,,,,,576.0,23113436.0,N,2714954.0,,,,,,,,,,,,34324882.0,838511452.0,-491292140.0,15188719.0,,4601537.0,841201.0,,,14566005.0,9331754.0,530983.0,,68682256.0,,,1408478.0,,,,135450.0,,35.9,,,,,,2714223.0,,,,,,,,15590.0,,5596250.0,,,,149602309.0,,61927791.0,,11292418.0,,,,75137010.0,2054225.0,43028.0,1466.0,,,,68.0,,12690768.0,,2.0,220967.0,,,,137707.0,,,,,,,,-266750906.0,80587548.0,,,,,,223395.0,18284.0,,6521737.0,,8360.0,,,,,,6389243.0,,18499998.0,,1081054.0,,,9433562.0,,,116244149.0,,,,47065209.0,1256830.0,413453.0,,,,101093.0,,9943430.0,,,,,201321312.0,,,,3798.0,5.0,,6873419.0,,782585.0,775747.0,25035536.0,,3873050.0,,,,,6568022.0,,,,,,,-343592.0,,,,332103.0,1537542.0,,,,,,,,,,,13136788.0,,,34791.0,,,,13626711.0,,58430740.0,,,,18015622.0,,1901.0,,8862420.0,,,,,313.0,128290942.0,,,,4372379.0,210.74,100773031.0,,5988854.0,15773241.0,,23113436.0,22.0,79424774.0,635871606.0,118.0,,,66423015.0,331.43,,72224312.0,,,,47.0,91282113.0,10461551.0,826512.0,71372796.0,,321823.0,,,,,,,-1188033.0,,NORTH SHORE UNIVERSITY HOSPITAL,,,2875898.0,,2013-12-31,,205972929.0,,,,,,16790.0,,,,,,,,196.0,,,,,,40139770.0,790413.0,15622649.37,,97459751.0,39037325.0,,2213189.0,,,,844504248.0,,,,,,,,258.0,,1985.0,,21543011.0,,185882999.0,1024.0,,246802286.0,1777667.0,,44883624.0,,,,1757896992.0,,,,3534717.0,,9955576.0,,,,,12690768.0,23544940.0,,3.0,10974864.0,-2295850.0,,8316552.0,40698488.0,,,,,377507.0,,312068.0,1223486.0,,,,1507773.0,,,187400650.0,,,56948056.0,1168833.0,,5,2626975.0,,,,,2367204.0,,197880342.0,4991546.0,2046455.0,,,,,1109.0,,13141492.0,10743235.0,1819416.0,,,,,,9943430.0,,,,,1794.0,,,8485843.0,,1114656.0,,,,,,103708.0,,11842013.0,,,2013-01-01 00:00:00,39.95,,,Y,2090604.0,,86924116.0,561.0,2578000.0,23195.0,,8585227.0,,,,,,,,,,,,1466.0,17676308.37,,,,80849.0,11973607.0,7154573.0,2191330.0,44105.0,-5158835.0,12354375.0,,,,,,36391958.0,,,,,,47.56,,1091521.0,,,,,98968183.0,593063.0,9973917.0,175941.0,1864.0,04/04/2008,,90885.0,,1659502.0,,8233775.0,259577.0,,92787.0,,,,,,256154872.0,,,,,14151634.0,,,,,,,,21860043.0,,,4219369.0,42504249.0,,,,,,4741316.0,,,,616554.0,,,,,139534.0,NASSAU,,2444236.0,,65578.0,,1228977.0,,,8266342.0,,,,662981.0,,,,,,,,,18896076.0,-1188033.0,,41306915.0,,,9307616.0,,,,,507789512.0,43723.0,,680410.0,,,3291373.0,,,49113782.0,-212051.0,,,,,,40678339.0,8360.0,,,16616788.0,,,,,,,,,753961.0,,,,10614456.0,,7.0,,37647833.0,20149.0,,68682256.0,,75298403.0,126899.0,,,,68.74,,2317.0,6425317.0,,321501.0,,4268520.0,,,4.3,,,,,,72224312.0,928843331.0,Y,,,,,1287077.0,36767855.0,4502805.0,3246536.0,,59.0,,,210023549.0,7860722.0,2391200.0,,345030.0,,9650849.0,207498.0,,,,,5302829137.0,42167852.0,,,,,129410.0,3310833.0,,,,,,355960.0,,18669.0,,,,1800197.0,39987132.0,,13520862.0,,33400,P,,,,,,,843326.0,,1378031.0,,15590.0,1716560.0,,,,,,,,,7237931.0,,,2016-03-24 00:00:00,,,,8864477.0,337148,24.09,150700891.0,3963068.0,,1230.0,,,90039089.0,,,73861.0,,,,,,,,6155473.0,,,,,1593355.0,,,,,,,,18628.0,,,,2399207.0,,,,198179297.0,9307616.0,52030680.0,,,,,,61676279.0,9433562.0,,1413085.0,-3397237.0,,96178008.0,,,,42759.0,6512346.0,975681.0,,3060611.0,8514824.0,,10974406.0,,,,,,1941.0,8465873.0,6368.0,,,,4107816.0,,,,,,,3015773.0,,29.0,,Y,1091521.0,,,,,69014884.0,3218129.0,1112732.0,,,,,21682124.0,,,,,194447893.0,,,,,,,,,,,37375.0,N,,,,,8218445.0,45.38,,,10034.0,Y,General Short Term,10253334.0,,,Y,,,,,,,,2013,Acute Care Hospitals,NORTH SHORE UNIVERSITY HOSPITAL (330106)
26139,NORTH SHORE UNIVERSITY HOSPITAL (330106),General Short Term (Acute Care Hospitals),Voluntary Nonprofit-Other,-73.703029,40.779269,,,,,819905.0,13789.0,7464190.0,713.0,,,,,,241558.0,359022.0,,29465502.0,-119617.0,,,,5719.0,,,,,693084237.0,,112.0,10658017.0,94632786.0,,3806000694.0,,,N,3.0,655051.0,,,19557935.0,112228522.0,4173542.0,,233.23,,,3389.0,99909148.0,257626.0,,,,,,28997.0,,44319879.0,1909278.0,,,,236533038.0,,27073485.0,,285844.0,11703888.0,,,,3772465.0,1.0,34762119.0,,,,23837629.0,,,,15969485.0,,10768235.0,,5051798.0,,1999264.0,,179663.0,,,1417.0,,,,,,,1542970.0,,1009628358.0,,17868385.0,2348954.0,,22828.0,,1387839.0,,44834.0,29.0,,,,4184.0,-843611.0,210050240.0,,,29465502.0,,,,466.0,57228.0,,,752977.0,,3414765.0,,,508944.0,,,8372.0,,1387839.0,,11309799.0,,,,,,,,,49171.0,,,,,1747594.0,,,,,386102354.0,,,,946613.0,,51.0,215376.0,,1397452.0,,161942927.0,,,,240991.0,28.05,,,N,,768.0,43.21,1359811.0,-1179397.0,25626113.0,,,19557.0,226347.0,,,,,,,,,,,,,,33,,,,19894.0,12212883.0,3942067.0,,,227084.0,,6813890.0,,,,5704862.0,,2392044.0,,13686900.0,9234372.0,,718928.0,137724.0,,34294695.0,,2203487.0,,5051798.0,,,1887288.0,,MANHASSET,,,,5113688.0,60245192.0,,1170179.0,,,,,483.0,,,,,,,44066803.0,,,72435545.0,,513519.0,,20280.0,,28.12,,,4194917.0,2830243.0,42844238.0,,,,,,,,,2879030.0,,,1.0,,,340302.0,,,368784.0,7987131.0,,210.19,,367934.0,63084973.0,,,,,,N,143945.0,,269679.0,454369.0,191.0,,,59.77,,7862032.0,,702803.0,1398494.0,,,14405196.0,,13284.0,,9994001.0,,39418020.0,-2327941.0,803334.0,1919.0,,,,,14914217.0,14405196.0,,,,,20439491.0,,104839397.0,-116305.0,,,,18107553.0,2962391.0,3400687.0,,,,1991431.0,,,,1464500456.0,,,,,,,211262939.0,,,120670.0,,,,,3841.0,,386102354.0,,,212593.0,,187854708.0,,,65304737.0,,63084973.0,,,43961711.0,10115.0,50.17,14405196.0,10032.0,10363.0,,5519737.0,7276.0,,,8462.0,5151981.0,11604044.0,,N,,3736566.0,17454630.0,,,,3442387.0,,,2700.0,,,,,1198745.0,,20479972.0,3085196.0,,651518.0,,,,,,,,33575611.0,95413049.0,215376.0,,,,,3545228.0,15709166.0,,,,9179.0,60.0,,-486382599.0,,,,330106,,,,11693550.0,6742.0,,,,,,1175554792.0,,195318898.0,,2495063.0,,,115170835.0,,,,14455034.0,,253952942.0,179058.0,,,172464.0,16115370.0,,,,25.44,157022582.0,,11185.0,,,,10212745.0,5468.0,23461555.0,1475534.0,,,,,,4239573.0,685024.0,,,9863.0,,1479727.0,1564651.0,,,,,10383048.0,,4128803.0,84370.0,67951.0,,,,,,,,35944108.0,144216931.0,-114042.0,,251732.0,,2146963.0,5421119.0,,,,,,,,212593.0,619320.0,7.0,,1431621.0,,,,,,,3120912.0,30490415.0,234657526.0,1467807.0,77545542.0,,N,,,46073181.0,54121941.0,,,,,,183275524.0,19145794.0,,40261852.0,3344331.0,595.0,,,,34762119.0,,,,,13458994.0,,,3712712.0,2576029.0,,,105700.0,5964315.0,,,,7782477.0,62078780.0,,,10619167.0,,,,2468.0,,,,,,,,,,8411573.0,,,,37243.0,,3764239.0,,,1240386.0,-2614214.0,,,34933200.0,,,,,,,45.71,,,,,,,,,,,,13731448.0,,,,,-2977096.0,-8166219.0,1204693.0,237026.0,261894581.0,8768254.0,3589.0,,,,101912210.0,,-94168.0,,47420186.0,,38845383.0,,180443172.0,,59462.0,,,108713.0,49367776.0,417964.0,,,34.0,300 COMMUNITY DRIVE,32887880.0,,4873568.0,,,,,,2173869.0,,8498737.0,,15969485.0,,5160947.0,27622.0,,,485081.0,,12531387.0,1037911.0,,868713.0,,,23058105.0,457.65,,990883.0,887687.0,,,2203487.0,,,,,,,2326469.0,,3464168.0,3414765.0,727691649.0,2828386.0,,,9140774.0,6196276.0,,,,26306879.0,14614866.0,,213834.0,,62078780.0,,,,,733195.0,2803027.0,,,,,51740949.0,,3581342.0,,,,812466516.0,,,9923309.0,3926751.0,,15228.0,13917973.0,1321137298.0,1839076.0,,589104.0,,1119976.0,4232730.0,,,9758358.0,,,3545228.0,419582.0,46.92,,14.0,3193840.0,727341339.0,,,9698876.0,,,868713.0,82911015.0,3128823.0,,308758.0,596340.0,,,10861632.0,,,11842697.0,,33271.0,-456248.0,,,3796229.0,129465106.0,,46521468.0,58670611.0,,,,,280373.0,,,,,,206693.0,,30865316.0,76773794.0,,49225626.0,84370.0,,48261404.0,Y,-1681930.0,,,,,,30434401.0,22364055.0,,11492389.0,,,3636054.0,1181155.0,,,649069847.0,,,,-1461571.0,,,22780205.0,,,,14445.0,,5438.0,,-173.0,1034840.0,1397452.0,,,,,,7190257.0,,,,,,,,,4338474.0,,,-21328130.0,,9528.73,,,,,77488527.0,9510428.0,18787328.0,,685252,,,,,,43193272.0,,,,,,,,-254582.0,,3457650.0,67580.0,,22439989.0,,,,,14445.0,107115.0,506335.0,39418020.0,571.0,,20489050.0,,7051241.0,40261852.0,,19403.0,1018519.0,,20760478.0,,1210255.0,,,,,119722478.0,,67580.0,,,129135.0,143720.0,,4228.0,,,77646.0,,21769945.0,4870572.0,5186.0,,,,,9233616.0,55255.0,,,1093134.0,360713.0,,,,452514.0,,2184949.0,249.0,,60332651.0,,,,,,,253952942.0,333550,420674.0,17002357.0,,,,44.82,,,,67.27,,,36447089.0,,,,,,,,,2772676.0,,,,,371593.0,,,1062.0,,691150.0,23893348.0,14367876.0,21747902.0,24.0,,,,,335702,,,,,,998264.0,,,,,52.45,,20723709.0,3214478.0,135221.0,30588231.0,,71168744.0,,,,,14643056.0,28907140.0,823617.0,,,,,521309.0,,58670611.0,,,,,13993.0,,,,,228.0,,J,,-102023.0,,,,555521340.0,,,,67003162.0,,,,,,,,5462989.0,,8972.0,,-32453018.0,,104262.0,345340.0,,,,17503.0,-1378636.0,,,,,,,35004,4933184.0,,663930.0,,,,,3677.0,,,Y,,,,,756634.0,16532.0,,61744.0,51742006.0,,,4.5,,460821.0,,23.28,,16319.0,,25.19,,,,9253276.0,,,,560068.0,142735.0,,985936.0,36963.0,,,-379252.0,9510428.0,27843.0,15658.0,,20394338.0,287595095.0,,2530332.0,24066438.0,,,,,,,,91897.0,,,241265801.0,105700.0,,,,,,,20469063.0,,,,5475.0,657.0,,,134566.0,210149.0,,855228.0,221270.0,6984630.0,-2776298.0,,,,,,,3837417.0,,,703591.0,13913996.0,,5699000.0,,46931.0,492.0,18609.0,,671083.0,1005.0,81629.0,611844.0,,7491.0,7401590.0,,55782.0,18045134.0,,,60245192.0,,21655040.0,,20723709.0,69032362.0,,15165360.0,-6039210.0,4746630.0,,,,,1542970.0,2694266.0,5037488.0,7500693.0,,3661.0,,,,,267585.0,,,,-608112614.0,,,,11393927.0,,37957769.0,,,2350255.0,,,,1175663505.0,,11997.0,274598.0,,1647629.0,N,570995.0,,,1543014.0,,,10383048.0,5380,971455.0,,91897.0,-107427.0,,33034500.0,1383149.0,,6944541.0,,213834.0,,56067765.0,9045722.0,-1355593.0,,,1850897.0,3761117.0,,,122092089.0,,50030.0,336962.0,,,,60467.0,59620.0,5425068.0,,135221.0,,,,,12116488.0,,,,,,1041753.0,,,152.0,221175084.0,,,,,3214478.0,,,14643056.0,1360.0,,71887490.0,-16343733.0,,,,,,,,,,1366388.0,,,,,,,,15781934.0,,82576.0,,,270955.0,,,44066803.0,9510428.0,,,24955649.0,1222690137.0,271827.0,,,,,,,,20174230.0,718928.0,408207.0,,2850783.0,NY,,9863.0,1.0,48091.0,110146.0,,,,,317204.0,345409.0,,183.0,,12382862.0,270955.0,19189459.0,,,58645116.0,,3333.0,,974542.0,447973.0,,,40.0,327.82,24697016.0,,,46.0,,31995.0,,,37477801.0,,,14084.0,,,,,,,578033.0,,,2495063.0,6375306.0,,29327.0,,,,2224250.0,-70977.0,11599526.0,24.63,,,,3481927.0,17639511.0,,,,28030036.0,,,255.9,,9528.0,1673.0,,,,2066677.0,,3220465.0,,3761117.0,59549253.0,,,,,,12079585.0,32887880.0,11002696.0,,317204.0,,,,118272.0,,,,,,,,,,,,344198.0,,20326337.0,,,,426427.0,14600.0,,,404866.0,,17279411.0,360713.0,24932.0,29840905.0,39813.0,,25043419.0,,30988491.0,,,,,210149.0,,,,1151.0,,,,,2555.0,,,20090717.0,4440565.0,331179.0,,42851.0,,8995.0,2023113.0,4123261.0,25426687.0,,110138.0,47394386.0,,,,2.0,,2826753.0,3785.0,,253952942.0,7023531.0,474227.0,1175554792.0,,1011468.0,,142735.0,8330197.0,13686900.0,,,42395444.0,,,,1113.0,,5037488.0,,,,,3492498.0,147597.0,,20489050.0,,,,3457650.0,,289762.0,4194917.0,,,5964315.0,,38845383.0,119742052.0,,9861485.0,2978664.0,,,,3819142.0,,56516132.0,386678113.0,,,,,,,270955.0,333047.0,2337049.0,,4228.0,,,,NSUH PSYCHIATRIC EXEMPT UNIT,,,388142.0,2274166.0,44967.0,,529121.0,13686900.0,13001,15677809.0,,,55255.0,,,,,,,,,,428597.0,,,N,30.74,5555268.0,,,17642786.0,,62538.0,1676217.0,,,919621554.0,259013.0,,,10768235.0,,,486630.0,,F,57.25,30588231.0,42606.0,,,827734.0,,,,15.0,,,,,,76773794.0,,,,,,,-14790621.0,178004.0,139842983.0,,,,11442736.0,12293.0,7673126.0,12079585.0,,15080.0,-1057.0,,,13401381.0,,,,,97016.0,4677650.0,,,,,19557935.0,18863917.0,,,,,X,,,,210239.0,63133124.0,32301659.0,,5433476.0,4761879.0,,10413158.0,17155.0,234657526.0,1377.0,,,18334.0,10619167.0,12653284.0,,,5893068.0,,,,,,,,,20124825.0,868713.0,,,7012523.0,,-213709504.0,69032362.0,18863917.0,8697600.0,27639634.0,,,8462.0,884948.0,,,,7342052.0,,,,,227084.0,,,19070354.0,,,,,689457.0,,58080702.0,,,,,137724.0,-456248.0,,,484130.0,,,,,1728193.0,615.0,,,-165.0,5.0,46931.0,,,,,,,,30865316.0,,,,10310.92,,,,39.52,,16117905.0,,,,2182266.0,4122879.0,85478967.0,44454027.0,,45967452.0,33S106,,,290.0,,,,,,47394386.0,,,170276.0,,,1824.0,,62400.0,2468.0,26429154.0,,119006432.0,,1917674.0,,,4679025.0,-2614214.0,,2345550.0,,15080.0,,,,288896.0,,17642786.0,,,,,30936680.0,,,36.26,-165.0,2798408.0,71887490.0,18615.0,,24866932.0,,,,,4.0,,,,,,59615.0,,,467126.0,,,,3890075.0,,,,781143370.0,,,2051446.0,,9253276.0,,3939060.0,14084.0,,,1009628358.0,,,41068266.0,29.0,0.205213,8600.0,,,,,104311995.0,178004.0,1950558.0,115170835.0,,3663074.0,,,,,10115.0,29590.0,,104.0,,333815.0,,,,162427709.0,,,,10396888.0,,,,20446356.0,119006432.0,20280.0,,,20644.0,,,,,6498897.0,1302463.0,713.0,,,84370.0,80862881.0,,10223.0,-1286233.0,,,,,,,,,,24955649.0,1167250.0,,10030,23716128.0,,,,,615.0,42501328.0,N,2962391.0,,,,,,,,,,,,36310974.0,831578212.0,-608112614.0,16115370.0,,5520217.0,718928.0,,,26306879.0,19070354.0,701897.0,,68554293.0,,,1359811.0,,,,153672.0,,36.71,,,,,259.0,4849590.0,,,,,,,,15918.0,,5563930.0,,,,179760266.0,,,,11693550.0,,,,84142291.0,1875817.0,37243.0,317255.0,,,,50.0,,12653284.0,,2.0,239914.0,,,,406001.0,,,,,1535791.0,,,-379785877.0,80862881.0,,,,,,200498.0,12913.0,,5051798.0,,6023.0,,,,,,6408173.0,,20596206.0,,1266728.0,,,11487426.0,,,90812507.0,,2653955.0,,57802796.0,868713.0,417955.0,,,,99047.0,,10413158.0,,,,,195318898.0,,,,3785.0,1.0,,7464190.0,,728546.0,4701354.0,2337049.0,162.0,5078427.0,,,,,8411573.0,,,,,,,-262790.0,,,,408057.0,1812950.0,,,,,,,,,,,18260714.0,,,489598.0,,,,12531387.0,,71148464.0,,,,20469063.0,,2492.0,,9655145.0,,2700.0,,,313.0,121484786.0,,,,4551609.0,75.3,118726350.0,,5483261.0,15700183.0,,42501328.0,7.0,87448492.0,635390601.0,20280.0,,,72435545.0,327.82,,78748733.0,,,,47.0,104311995.0,10383048.0,845665.0,72260015.0,,165733.0,,,,,,,,,NORTH SHORE UNIVERSITY HOSPITAL,,,2978664.0,,2014-12-31,,198821041.0,,,,,,16790.0,,,,,-981634.0,,,242.0,,1620.0,,,,21769945.0,3116195.0,13901083.0,,119734891.0,410355.0,,2224994.0,,,,845257458.0,,,,,,,,311.0,,,,28030036.0,,242118785.0,1063.0,,277666873.0,1110675.0,,45701011.0,,,,1922458127.0,,,,4746630.0,,21179780.0,,,,,12653284.0,23716128.0,,3.0,11549508.0,-2303128.0,,9400829.0,51081140.0,,10032.0,,,504744.0,,698902.0,1352614.0,,,,1909278.0,,,199964509.0,,,49225626.0,1083461.0,,4,3192981.0,,,5.0,,3337575.0,,210209807.0,9027098.0,2042211.0,,,,,986.0,,12950947.0,12689127.0,1302463.0,,,,,,10413158.0,,,,,1417.0,,,10231590.0,,1459601.0,,,,,838543.0,63333.0,,11442736.0,,,2014-01-01 00:00:00,33.29,,,Y,20174230.0,,91950738.0,229.0,2593778.0,24341.0,,9207296.0,,,,,,,,,,,,317255.0,16227552.0,,,,102561.0,12413705.0,7676564.0,2256297.0,10223.0,-7249533.0,13686900.0,,,,,,34933200.0,,,,,,42.77,,1413865.0,,,,,100004277.0,819723.0,702803.0,116253.0,182.0,04/04/2008,,90885.0,,2091399.0,,8330197.0,263914.0,,95471.0,,,,,,253952942.0,,,,,13837635.0,,,,,,,-599.0,31822433.0,,,,47420186.0,,,,,,4873568.0,,,,625326.0,,,,,147597.0,NASSAU,,2458557.0,,40858.0,,1085131.0,,,10066656.0,,,,655636.0,,,,,,,,,27156030.0,-981634.0,,48261404.0,,,9845427.0,,,,,573469989.0,43036.0,,906222.0,,,2798408.0,,,57615012.0,-10102.0,,,,,,51049799.0,6023.0,,,17868385.0,,,,,,,,,1063307.0,,,,14367876.0,,7.0,,38845383.0,31341.0,,68554293.0,,78621802.0,83152.0,,,,67.27,,3661.0,2392044.0,,331179.0,,5546896.0,,,,,,,,,78748733.0,1009628358.0,Y,,,,,1397452.0,36447089.0,4875868.0,3545228.0,,69.0,,,218955769.0,9045722.0,2224250.0,,547664.0,,17058871.0,37375.0,,,,,5728458821.0,43922754.0,,,,,149048.0,4355887.0,,,,,,285844.0,,13756.0,,,,1867961.0,43193272.0,,20394338.0,,33400,P,,,,6964.0,,,1094133.0,,1387839.0,,15918.0,2173869.0,,,,,,,,,11842697.0,,,2021-01-11 00:00:00,,,,10864325.0,337148,22.16,127928604.0,3893557.0,,660.0,,,99909148.0,,,135245.0,,,,,,,,6944541.0,,,,,1773632.0,,,,,,,,12913.0,,,,2495063.0,,,,221487949.0,9845427.0,50294454.0,,,,,,64216606.0,11487426.0,,318341.0,-2393132.0,,119742052.0,,,,105274.0,9104009.0,919681.0,,4679025.0,9091971.0,,12287189.0,,,,,,1673.0,7650627.0,6627.0,,,,4832170.0,,90.0,,,13673433.0,,3024026.0,,24.5,,Y,1413865.0,,,,,82170971.0,3414765.0,1824.0,,,,,24866932.0,,,,1620.0,187854708.0,,,,55891.0,,,,,,,38537.0,N,,,,,9045722.0,44.37,166354.0,,10693.0,Y,General Short Term,11739059.0,,,Y,,,,,,,,2014,Acute Care Hospitals,NORTH SHORE UNIVERSITY HOSPITAL (330106)
31913,NORTH SHORE UNIVERSITY HOSPITAL (330106),General Short Term (Acute Care Hospitals),Voluntary Nonprofit-Other,-73.703029,40.779269,,,,,859350.0,27215.0,4732013.0,,,,,,,971975.0,461830.0,,33075110.0,-125040.0,,,,5919.0,,,,,871664538.0,,,10734469.0,103224641.0,,4255727832.0,,,N,3.0,756079.0,,,20487538.0,141167508.0,4759411.0,,243.96,,,9422.0,118752122.0,241939.0,,,,,,35214.0,,55083627.0,2064521.0,,,,299652518.0,,30992450.0,,323770.0,13051011.0,,,,3951382.0,1.0,37218783.0,,,,25713065.0,,,,16162992.0,,11713630.0,,3096136.0,,2819630.0,,111379.0,,,1323.0,,,,,,,1645402.0,,1081739256.0,,19019795.0,2202520.0,,28867.0,,1480333.0,,51318.0,143.0,,,,3839.0,-1125701.0,214006731.0,,,33075110.0,,,,,79209.0,,,,,3533058.0,,,490316.0,,,7237.0,,1480333.0,,12105009.0,,,,,,,,,51940.0,,,,,1532198.0,,,,,413655461.0,,92.0,,1054434.0,,51.0,293227.0,,1442009.0,,153319849.0,,,,208177.0,31.5,,,N,,766.0,52.61,1389778.0,-241377.0,28745391.0,,,28991.0,212374.0,,,,,,,,,,,,7597.0,,33,,,,22585.0,12778144.0,3480998.0,,,236396.0,,6342129.0,,,,6237135.0,,2417847.0,,15144081.0,10359655.0,,1137887.0,65665.0,,29528046.0,,2386841.0,,3096136.0,,,1708390.0,,MANHASSET,,,,5354061.0,56852347.0,,1084925.0,,,,,,,,,,,,54752673.0,,,80868326.0,,513258.0,,17633.0,,27.8,,,5643699.0,1607050.0,45360139.0,,,,,,,,,3163142.0,,,1.0,,2793.0,320833.0,,,389547.0,7478634.0,,215.05,,194410.0,69205939.0,,,,,,N,136650.0,,275898.0,3460820.0,207.0,,,63.41,,8055983.0,,606456.0,2890098.0,,,16165899.0,,,,12932613.0,,45389346.0,-11740723.0,867940.0,3682.0,,,,,16746731.0,16165899.0,,,,,21254334.0,,114724106.0,-109243.0,,,,16576084.0,3473181.0,4021724.0,,,,2116540.0,,,,1687555113.0,,,,,,,223955019.0,,,229283.0,,,,,678.0,,413655461.0,,,323631.0,,184336147.0,,,58495017.0,,69205939.0,,,41081061.0,10404.0,52.01,16165899.0,17918.0,,,5731418.0,17675.0,,,9162.0,5621827.0,13502895.0,,N,,3911278.0,12394612.0,,,,3561189.0,,1324.0,2524.0,,,,,1236557.0,,23572222.0,3648370.0,,701185.0,,,,,,,,30300382.0,94185146.0,293227.0,,,,,3482295.0,14761054.0,,,,10171.0,40.0,,-522834775.0,,,,330106,,,,11894003.0,17224.0,,,,,,1300757735.0,,189068160.0,,1255903.0,,,122369211.0,,,,16228258.0,,280252475.0,294219.0,,,227323.0,17596170.0,,,,25.6,165457000.0,,12348.0,,,,5523017.0,10231.0,25442898.0,1709626.0,,,,,,4032095.0,690807.0,,,9316.0,,1628282.0,1758681.0,,,,,10424261.0,,4319597.0,88710.0,77925.0,,,,,,,,38253546.0,162334365.0,-99005.0,,288989.0,,2165629.0,5778285.0,,,,,,,,323631.0,644716.0,6.0,,1870248.0,,,,-316.0,,,3270481.0,26652012.0,295630305.0,1592007.0,85503906.0,,N,,,47057076.0,54734385.0,,,,,,191435344.0,30988491.0,,41981823.0,3502957.0,767.0,,,,37218783.0,,,,,16469657.0,,,3898932.0,2803659.0,,,,6621080.0,,,,7690944.0,68774923.0,,,11692187.0,,,,625.0,,,,,,,,,,8772600.0,,,,24168.0,,4961680.0,,,2876972.0,-2813559.0,7597.0,3204.0,37540115.0,,,,,,,48.78,,,,,,,,,,,,17274260.0,,,,,-2985814.0,-7941086.0,1285506.0,162956.0,276735301.0,8805327.0,2332.0,,,,110049191.0,,-111513.0,,58723254.0,,43255295.0,,199133569.0,,31415.0,,,209653.0,54259172.0,266355.0,,,34.0,300 COMMUNITY DRIVE,29281670.0,,6115646.0,938.0,,,,,1710337.0,,10447877.0,,16162992.0,,2601897.0,28131.0,,,788237.0,,10006921.0,1060576.0,,1535845.0,,,26001639.0,447.86,,1238786.0,835948.0,,,2386841.0,,,,,,,2373742.0,,3541089.0,3533058.0,733791619.0,2869212.0,,,8841558.0,6196276.0,,,,28783375.0,12092811.0,,220053.0,,68774923.0,,,,,1056380.0,3419307.0,,,,,56335706.0,,3969770.0,,,,838117170.0,,,10236931.0,4369298.0,,21188.0,12270097.0,1472399238.0,1957829.0,,848087.0,,1255892.0,4585440.0,,,10960564.0,,,3482295.0,,48.05,,16.0,4033107.0,733506026.0,,,10304145.0,,,1535845.0,85168144.0,2941132.0,,278548.0,800091.0,,,9958433.0,,,6391626.0,,17462.0,-32120.0,,,4106804.0,124334213.0,,52630314.0,59575536.0,,,,,423730.0,,,,,,214444.0,,39157951.0,79920511.0,,49526406.0,88710.0,,46043561.0,Y,-1806628.0,,,,,,29972817.0,26578251.0,,12272824.0,,,3577808.0,1311257.0,,,644997817.0,,,,-906689.0,,,23392342.0,,,,14751.0,,4662.0,,,1126716.0,1442009.0,,,,,,8279701.0,,,,,,1281.0,,,4819763.0,,,-45120117.0,,9835.37,,,,,86301908.0,9857543.0,19597288.0,,685016,,,,,,48445181.0,,,,,,,,-227965.0,,3520267.0,59971.0,,25939533.0,,,,,14751.0,109943.0,814256.0,45389346.0,747.0,,22356651.0,,8909607.0,41981823.0,,7721.0,2002357.0,,22605596.0,,801438.0,,,,,126019735.0,-77752.0,60001.0,,,148462.0,143617.0,,4930.0,,,135164.0,,25276342.0,4980164.0,28983.0,,,,,133911.0,24271.0,,,1052233.0,378055.0,,,,649975.0,,2470919.0,249.0,,66999768.0,,,,,,,280252475.0,333550,391334.0,16689330.0,,,48528.0,47.86,,,,88.7,,,42538719.0,,,,,,,,,2722899.0,,,,,386830.0,,,7072.0,,937335.0,28487888.0,13109670.0,24442152.0,20.0,,,,,335702,,,,,,1434569.0,,,,,54.03,,23473043.0,3504352.0,142834.0,32647841.0,,79620468.0,,,,,14856664.0,36420770.0,869989.0,,,,,549132.0,,59575536.0,,,,,9775.0,,,,,253.0,,J,45281.0,-102022.0,,,,591629655.0,,,,76591472.0,,,,,,,,6062472.0,,9864.0,,-33930448.0,,136777.0,360834.0,,,,26993.0,-1379123.0,,,,,,,35004,4997880.0,,2756529.0,,,,,4622.0,,,Y,,,,,864384.0,3357.0,,,56335788.0,,,4.0,,443891.0,,23.64,,16181.0,,22.63,,,,10465334.0,,,,365313.0,150012.0,,1433615.0,35116.0,,,-574739.0,9857543.0,20250.0,21988.0,,21837916.0,301807571.0,,3221377.0,25156847.0,,,,,,,,131989.0,,,257912175.0,,,,,,,,21712355.0,,,,5475.0,866.0,,,91145.0,225741.0,,974831.0,233728.0,7100570.0,-2955254.0,,,,,,,5099740.0,,,1006610.0,12970245.0,,8058717.0,,48909.0,,27126.0,,592896.0,499.0,82743.0,679743.0,,8120.0,7260710.0,,56645.0,19166818.0,,,56852347.0,,26446323.0,,23473043.0,72351575.0,,15909575.0,-6860743.0,,,,,,1645402.0,2984748.0,,9518739.0,,4219.0,,,,,150570.0,,,,-704987439.0,,,,12846865.0,,38635313.0,,,2483948.0,,12401.0,,1300967388.0,,71064.0,244099.0,,1973051.0,N,576279.0,,,1611571.0,,,10424261.0,5380,918784.0,,131989.0,-130856.0,,38269390.0,1439866.0,,8059689.0,,220053.0,,57106589.0,12281765.0,-1953049.0,,,1870106.0,3849415.0,,,120044572.0,,71945.0,281269.0,,,,74494.0,46532.0,5949729.0,,142834.0,,,,,12168366.0,,,,,,1120092.0,,,2813.0,236476407.0,,,,,3504352.0,,,14856664.0,230.0,,84207496.0,-41667129.0,,,,,,,,,,1417372.0,,,,,,,,16133563.0,,85962.0,,,426208.0,,,54752673.0,9857543.0,,,23843933.0,1368002990.0,274330.0,,,,,,,,18222097.0,1137887.0,407163.0,,2907211.0,NY,,9316.0,1766.0,82500.0,118507.0,,,,,277364.0,399528.0,,174.0,,10075928.0,426208.0,35902097.0,,,63754264.0,,4787.0,,1140168.0,711679.0,,,40.0,331.82,28379663.0,,,,,13266.0,,,41611321.0,,,13805.0,,,,,,,601735.0,,,1255903.0,5089345.0,,,,,,1958950.0,,11763569.0,25.48,,,,3262078.0,19289435.0,,,,29836200.0,,,280.57,,,1772.0,,,,1646013.0,,3374014.0,,3849415.0,65459357.0,,,,,,11880703.0,29281670.0,25963566.0,,277364.0,,,,512003.0,,,,,,,,,,,,363577.0,,23155188.0,,,,373505.0,14600.0,,,398116.0,,18862608.0,378055.0,60893.0,30671032.0,680.0,,29582546.0,,37380117.0,,,,,225741.0,,,,1199.0,,,,,2190.0,,,21435768.0,4955046.0,441580.0,,47255.0,,7070.0,2127563.0,5423510.0,29105966.0,,125855.0,48159165.0,,,,2.0,,3351626.0,3910.0,,280252475.0,7093747.0,499737.0,1300757735.0,,1440551.0,,150012.0,5490353.0,15144081.0,,,42736573.0,,,,1720.0,,,,,,,,164169.0,,22356651.0,,,,3520267.0,,303807.0,5643699.0,,,6621080.0,,43255295.0,132645913.0,,10282880.0,3383558.0,,,,4018730.0,,55139293.0,404492091.0,,,,,,,426208.0,322791.0,2378764.0,,4930.0,,,,NSUH PSYCHIATRIC EXEMPT UNIT,,,388180.0,2428178.0,73413.0,,599718.0,15144081.0,13001,23092317.0,,,24271.0,,,,,,,,,,229129.0,,,N,29.92,5625144.0,,,18116183.0,,113955.0,1526638.0,,,1095647421.0,311895.0,,,11713630.0,,,500711.0,,F,61.97,32647841.0,33265.0,,,930101.0,,,,15.0,,,,,,79920511.0,,,,,,,-14787160.0,239264.0,158242802.0,,,,12083325.0,12985.0,8138530.0,11880703.0,,14640.0,-82.0,,,12078285.0,,,,,157647.0,5221732.0,,,,,20487538.0,18595052.0,,,,,X,,,,225910.0,74912674.0,38023191.0,,5421088.0,4712430.0,,10952306.0,17155.0,295630305.0,1765.0,,,6875.0,11692187.0,13192431.0,,,6047680.0,,,,,,,,,20798139.0,1535845.0,,,8328414.0,,-246474993.0,72351575.0,18595052.0,9083697.0,32446253.0,,,9162.0,426711.0,,,,7278407.0,,,,,236396.0,,,19924633.0,,,,,639267.0,,62023305.0,,,,,65665.0,-32120.0,,,512202.0,,,,,1897688.0,613.0,,,,5.0,48909.0,,,,,,,,39157951.0,,,,10638.51,,,,42.83,,18226290.0,,,,2911386.0,3887865.0,76717114.0,48032518.0,,50059439.0,33S106,,,206.0,,,,,,48159165.0,,,283701.0,,,12012.0,,60000.0,625.0,30300989.0,,136068520.0,,2038630.0,,,5584472.0,-2813559.0,,2643358.0,,14640.0,,,,264361.0,,18116183.0,,,,,37049516.0,,,36.45,,8248058.0,84207496.0,18615.0,,24315709.0,,,,,6639.0,,,,,,62611.0,,,493427.0,,,,4755076.0,,,,838117170.0,,,2103006.0,,10465334.0,,4801679.0,13805.0,,,1081739256.0,,,47458229.0,143.0,0.206484,9211.0,,,,,111605020.0,239264.0,1508352.0,122369211.0,,9107267.0,,,,,10404.0,37201.0,,1983.0,,398939.0,,,636261.0,175785049.0,,,,10507066.0,,,,46548852.0,136068520.0,17633.0,,,21490.0,,,,,5956844.0,972874.0,,,,88710.0,100724765.0,,47265.0,-1764505.0,,,,,,,,,,23843933.0,1167250.0,,10030,24871254.0,,,,,613.0,53172244.0,N,3473181.0,,,,,,,,,,,,42743140.0,822440226.0,-704987439.0,17596170.0,,6141681.0,1137887.0,,,28783375.0,19924633.0,730678.0,,77020716.0,,,1389778.0,,,,191111.0,,37.76,,,,,221.0,5782564.0,,,,,,,,17327.0,,5732814.0,,,,202444229.0,,,,11894003.0,,,,94358807.0,2085203.0,24168.0,277521.0,,,,244.0,,13192431.0,,2.0,278657.0,,,,408737.0,,,,,2207030.0,,,-434906472.0,100724765.0,,,,,,202608.0,17316.0,,3096136.0,,5739.0,,,,,,6169829.0,,22599898.0,,1476941.0,,,11953190.0,,,21635089.0,,,,61763733.0,1535845.0,441487.0,,,,55490.0,,10952306.0,,,,,189068160.0,,,,3910.0,,,4732013.0,,652412.0,1301736.0,2378764.0,,5329652.0,,,,,8772600.0,,,,,,,-268876.0,,,,600992.0,1860484.0,,,,,,,,,,,117224.0,,,276011.0,,,,10006921.0,,79602835.0,,,,21712355.0,,2274.0,,13176862.0,,2524.0,,,314.0,184809962.0,,,,4373199.0,63.41,150823454.0,,5421371.0,16525392.0,,53172244.0,,91135192.0,631836221.0,17633.0,,,80868326.0,331.82,,91440563.0,,,,47.0,111605020.0,10424261.0,730140.0,73711207.0,,327966.0,,,,,,,,,NORTH SHORE UNIVERSITY HOSPITAL,,,3383558.0,,2015-12-31,,220362246.0,,,,,,,,,,,-1000734.0,,,207.0,,2439.0,,,,25276342.0,4662058.0,12952929.0,,132645913.0,832613.0,,2363254.0,,,,835601822.0,,,,,,,,286.0,,2607.0,,29836200.0,,255679380.0,1015.0,,305276149.0,1253151.0,,49567968.0,,,,2043827672.0,,,,,,22565484.0,,,,,13192431.0,24871254.0,,3.0,7848817.0,-2516241.0,,9838989.0,55413500.0,,17918.0,,,513888.0,,684412.0,1463171.0,,,,2064521.0,,,211676699.0,,,49526406.0,3285893.0,,4,3375571.0,,,,,3430591.0,,254711683.0,-16687.0,2248102.0,,,,,1033.0,,17954511.0,14175058.0,972874.0,,,,,,10952306.0,,,,,1323.0,,,10360964.0,,1360933.0,,,,,,79634.0,,12083325.0,,,2015-01-01 00:00:00,35.96,,,Y,18222097.0,,101669805.0,1371.0,2765786.0,17262.0,,9167348.0,,,,,,,,,,,,277521.0,15326671.0,,,,98263.0,16227173.0,8338381.0,2757233.0,47265.0,-5853551.0,15144081.0,,,,,,37540115.0,,,,,,45.96,,1303145.0,,,,,108266432.0,791179.0,606456.0,73087.0,26.0,04/04/2008,,90885.0,,2140380.0,,5490353.0,280503.0,,99991.0,,,,,,280252475.0,,,,,14533053.0,,,,,,,-1932.0,33060547.0,,,,58723254.0,,,,,,6115646.0,,,,690075.0,,,,,164169.0,NASSAU,,2609967.0,,91666.0,,1253386.0,,,9804045.0,,,,666276.0,,,,,,,,,19446114.0,-1000734.0,,46043561.0,,,10447728.0,,,,,637946865.0,45091.0,,749344.0,,,8248058.0,,,59336811.0,-2002.0,,,,,,55398371.0,5739.0,,,19019795.0,,,,,,,,,1442054.0,,,,13109670.0,,7.0,,43255295.0,15129.0,,77020716.0,,88793802.0,112209.0,,,,88.7,,4219.0,2417847.0,,441580.0,,5617907.0,,,,,,,,,91440563.0,1081739256.0,Y,,,,,1442009.0,42538719.0,4609051.0,3482295.0,,69.0,,,272975732.0,12281765.0,1958950.0,,519186.0,,19574969.0,90325.0,,,,-112100.0,6299555504.0,50050074.0,,,,,152560.0,4577484.0,,,,,,323770.0,,20535.0,,,,1970651.0,48445181.0,,21837916.0,,33400,P,,,,,,,1160489.0,,1480333.0,,17327.0,1710337.0,,,,,,,,,6391626.0,,,2021-01-12 00:00:00,,,,12170125.0,337148,22.89,55139293.0,4146001.0,,1001.0,,,118752122.0,,,109231.0,,,,,,,,8059689.0,,,,,1790022.0,,,,,,,,17316.0,,,,1255903.0,,,,255029701.0,10447728.0,62516532.0,,,,,,72627903.0,11953190.0,,252258.0,-11762678.0,,132645913.0,,,,71833.0,9563288.0,967540.0,,5584472.0,9507663.0,,12232427.0,,,,,,1772.0,8612865.0,6927.0,,,,5113971.0,,169.0,,,,7301.0,3220258.0,,25.39,,Y,1303145.0,,,,,79035308.0,3533058.0,12012.0,,,,,24315709.0,,,,2439.0,184336147.0,,,,1243.0,,,,,,,39559.0,N,,,,,12281765.0,47.52,170007.0,,12348.0,Y,General Short Term,12405762.0,,,Y,,,,,,,,2015,Acute Care Hospitals,NORTH SHORE UNIVERSITY HOSPITAL (330106)
37798,NORTH SHORE UNIVERSITY HOSPITAL (330106),General Short Term (Acute Care Hospitals),Voluntary Nonprofit-Other,-73.703029,40.779269,,,,,1089385.0,16351.0,4631985.0,,,,,,,1074537.0,246520.0,,37810641.0,-134336.0,,,,6605.0,,,,,1630323444.0,,,10766891.0,109156494.0,,4651898260.0,,,N,3.0,738128.0,,,20909923.0,157830919.0,5176364.0,,243.7,,,3764.0,131978471.0,687010.0,,,,,,35186.0,,88211720.0,1546720.0,,,,352100172.0,,20504075.0,,257753.0,12230028.0,,,,4270459.0,1.0,38429600.0,,,,30676773.0,,,,16667088.0,,13310373.0,,1387358.0,,2882753.0,,46546.0,,,1332.0,,,,,,,887146.0,,1186948976.0,,23054378.0,2210535.0,,28491.0,,1676883.0,3.0,47601.0,71.0,,,,4746.0,-1171794.0,234262508.0,,,37810641.0,,,,,71328.0,,,,,3397470.0,,,470669.0,,,1104.0,,1676883.0,,13624557.0,,,,,,,,,58362.0,,,,,965222.0,,,,,438672841.0,,0.77,,894830.0,,51.0,409577.0,,1550505.0,,158889527.0,,,,221569.0,31.13,,,N,,756.0,53.9,1338395.0,,34721040.0,,,26164.0,140917.0,,,,,,,,,,,,42770.0,,33,,,,6319.0,15225111.0,4686335.0,,,,,7108472.0,,,,6450890.0,,2544044.0,556.0,14644737.0,11277354.0,,1114634.0,84968.0,,20336633.0,,2209003.0,,1387358.0,,,1733099.0,,MANHASSET,,,,5114967.0,36474220.0,,851050.0,,,,,,,,2.0,5.0,,,36593298.0,,,103848098.0,,525078.0,,20568.0,,29.81,,,6231969.0,2298229.0,40199224.0,,,,,,,,,1998523.0,,,1.0,,13174.0,405509.0,,,466899.0,8440716.0,,279.97,,229072.0,66343109.0,,,,,,N,130994.0,,283006.0,2537034.0,90.0,,,62.11,,8262786.0,,811014.0,2296872.0,,,16346764.0,,,,20618744.0,,48634361.0,-11681241.0,584399.0,5239.0,,,,,16960076.0,16346764.0,,,,,22152753.0,,110273605.0,-113171.0,,,,10278619.0,5657197.0,3784341.0,,,,2509582.0,,,,1813483030.0,,,,,,,222179415.0,,,187039.0,,,,,,,438672841.0,,,161992.0,,189701063.0,,,28477897.0,,66343109.0,,,43108125.0,10330.0,53.98,16346764.0,9812.0,28.0,,6810393.0,24541.0,,,8408.0,5988745.0,11571952.0,,N,,4686985.0,23082356.0,,,,3421200.0,,1175.0,2357.0,,,,,566182.0,,23494786.0,990805.0,,831664.0,,,,,,,,16437113.0,97039979.0,409577.0,,,,,3348612.0,11904520.0,,,,11784.0,40.0,,-608766209.0,,,,330106,,,,12277329.0,,,,,,,1396844406.0,,194333048.0,,1260297.0,,,144028481.0,,,,10509732.0,,294839697.0,334175.0,,,205709.0,18608023.0,,,,26.43,196426870.0,,11436.0,,,,5297387.0,14932.0,28567119.0,10694219.0,,,,,,2833190.0,467062.0,,,9695.0,,1083057.0,1127964.0,,,,,11336978.0,,5172683.0,91903.0,68275.0,,,,,,,,39744770.0,174528237.0,-79864.0,,326279.0,,1247612.0,6434451.0,,,,,278.0,,,162860.0,777116.0,7.0,,1671638.0,,,,-834.0,,,3695339.0,15446308.0,357852058.0,1983639.0,93680384.0,,N,,,48376160.0,59414497.0,,,,,,173669009.0,37380117.0,,45926777.0,4177002.0,942.0,,,,38429600.0,,,,,18777938.0,,,3810410.0,1654480.0,,,225750.0,7458813.0,,,,7106505.0,72587127.0,,,14030220.0,,,,,,,,,,,,,,10596735.0,,,,52517.0,,4217352.0,,,2785146.0,-3354551.0,42770.0,,42877691.0,,,,,,,48.03,,,,,,,,,,,,19653965.0,,,,,-3210270.0,-7803361.0,1532012.0,170237.0,304934689.0,9340574.0,2462.0,,,,115437520.0,,-245120.0,,72224592.0,,43756548.0,,228924366.0,,41643.0,,,,59713844.0,525624.0,,,34.0,300 COMMUNITY DRIVE,33073967.0,,7896187.0,,,,,,2166550.0,,13429361.0,,16667088.0,,3910029.0,23730.0,,,942970.0,,7376433.0,662940.0,,1109003.0,,,26901286.0,460.24,,1196812.0,459471.0,,,2209003.0,,,,,,,2577036.0,,4463172.0,3397470.0,774699736.0,1801202.0,,,8994129.0,6196276.0,,,,32142492.0,36330592.0,,227008.0,,72587127.0,,,,,1177325.0,3778210.0,,,,,59195023.0,,5414642.0,,,,815655501.0,,,10947306.0,6002739.0,,30306.0,12722500.0,1556914761.0,1336015.0,,1135002.0,,1214497.0,4216163.0,,,11188713.0,,,3348612.0,,46.03,,16.0,4852019.0,774087158.0,,,10339131.0,,,1109003.0,96884998.0,3702857.0,,390348.0,476027.0,,,9510429.0,,,8433182.0,,6880.0,-326617.0,,,2574659.0,137012768.0,,51714077.0,66202918.0,,,,,588689.0,,,,,,224602.0,,68799017.0,99339316.0,,70790394.0,91903.0,,51357091.0,Y,-2043007.0,,,,,,30981156.0,22403590.0,,1450039.0,,,5135824.0,823763.0,,,678002728.0,,,,-968081.0,,,23517143.0,,,,15315.0,,5392.0,,,1183902.0,1550505.0,,,,,,52461988.0,,,,,,,,,4916012.0,,,-28903056.0,,10314.56,,,,,46443534.0,10195054.0,17458652.0,,686853,,,,,,52699479.0,,,,,,,,-38160.0,,3439754.0,63002.0,,27281659.0,,,,,15315.0,65417.0,951774.0,48634361.0,904.0,,20111450.0,,9988952.0,45926777.0,,,637445.0,,31602320.0,,-1849796.0,,,,,137491745.0,-64731.0,63002.0,,,147173.0,72853.0,,4166.0,2032.0,,180507.0,,41361259.0,3101715.0,17828.0,,,,,-1.0,10769.0,,,847667.0,386815.0,,,,658073.0,,2684437.0,249.0,,57171344.0,,,,,,,294839697.0,333550,379349.0,18361577.0,,,10798.0,47.2,,,,84.8,,,42909646.0,,69.0,,,,5.0,,,1863251.0,,,,,461413.0,,,7595.0,,664325.0,34657548.0,13398564.0,26500057.0,38.0,,,,,335702,,,,,,823015.0,,,,,53.33,,24155124.0,3624432.0,175087.0,40541174.0,,80487915.0,,,,,15774007.0,41709744.0,1035932.0,,,,,424864.0,,66202918.0,,,,,4160.0,,,,,183.0,,J,,-102023.0,,,,584682609.0,,,,78431813.0,,,,,,,,5734808.0,,8617.0,,-41211654.0,,95796.0,435537.0,,,,22523.0,-1438793.0,,,,,,,35004,5243241.0,,3047303.0,,,,,5020.0,,,Y,,,,,950301.0,,,135.0,59195123.0,,,4.0,,363729.0,,23.26,,16161.0,,22.46,,,,12853415.0,,,,361581.0,151042.0,,1753438.0,38728.0,,,-537875.0,10195054.0,9933.0,27666.0,,21008175.0,332977215.0,,3342616.0,25831005.0,,,,,,,,78699.0,,,287028318.0,225750.0,,,,,,,23048358.0,,,,5490.0,487.0,,,51972.0,234730.0,,1008537.0,277221.0,7578750.0,-4144877.0,,,,,,,4206119.0,,,836870.0,13837860.83,,9521370.0,,50179.0,247.0,19286.0,,350393.0,820.0,82044.0,411348.0,,9517.0,5075325.0,,,22481828.0,,,36474220.0,,29921664.0,,24155124.0,70733647.0,,12391475.0,-7757125.0,,,,,,887146.0,1536839.0,,9517085.0,,4070.0,,,,,27902.0,,,,-796315804.0,,,,12106448.0,,49900986.0,,,1936253.0,,,,1396844406.0,,36785.0,283457.0,,1208169.0,N,607651.0,,,1954600.0,,,11336978.0,5380,638785.0,,78511.0,-81799.0,,18958402.0,1724228.0,,7825900.0,,227008.0,,63790462.0,10970111.0,-2912252.0,,,2030658.0,153684.0,,,134384268.0,,296552.0,423065.0,,,,69482.0,26346.83,4889633.0,,,,,,,15731474.0,,,,,,699479.0,,,217.0,272595730.0,,,,,3624432.0,,,15774007.0,2444.0,,86978736.0,-29393108.0,,,,,,,,,,1534878.0,,,,,,,,17377469.0,,97140.0,,,412874.0,,,36593298.0,10195054.0,,,25878443.0,1448296592.0,,,,,,,,,10631979.0,1114634.0,428954.0,,3266008.0,NY,,9695.0,,129583.0,129439.0,,,,,323250.0,642466.0,,125.0,,5167689.0,412874.0,19596609.0,,,66486370.0,,3646.0,,1142825.0,701760.0,,,40.0,336.5,31364006.0,,,46.0,,15582.0,,,45602163.0,,,14255.0,,,,,,,728547.0,,,1260297.0,5646841.0,,,,,,2077436.0,,12599375.0,25.56,,,,2842637.0,22423490.0,,,,32458717.0,,,349.63,,20620.0,1860.0,13.0,,,353360.0,114.0,4031293.0,,153684.0,76897282.0,,,,,,11096183.0,33073967.0,28690745.0,,323250.0,,,,264920.0,,,,,,,,,,,,437718.0,,30796491.0,,,,374664.0,14640.0,,,331569.0,,19062850.0,386815.0,,32272811.0,,,44439045.0,,45813299.0,,,,,234730.0,,,,1317.0,,,,,2562.0,,,14432588.0,3186102.0,236587.0,,48132.0,,8790.0,2549913.0,4463872.0,36435624.0,,113948.0,53664502.0,,,,2.0,,4080147.0,3836.0,,294839697.0,7278737.0,345867.0,1396844406.0,,1793834.0,,151042.0,5197096.0,14644737.0,,,40037460.0,,,,135.0,,,,,,,,182180.0,,20111450.0,,,,3439754.0,,262716.0,6231969.0,,,7458813.0,,43756548.0,133723206.0,,10520552.0,3606559.0,,,,3691304.0,,68208907.0,475127160.0,,,,,,,412874.0,218260.0,2697388.0,,4166.0,,,,NSUH PSYCHIATRIC EXEMPT UNIT,,,407843.0,2217770.0,73121.0,,411933.0,14644737.0,13001,29666471.0,,,10769.0,,,,,,,,,,148685.0,,,N,29.26,6197535.0,,,19342179.0,,47060.0,1652069.0,,,1166281589.0,235685.0,,,13310373.0,,,669042.0,,F,67.07,40541174.0,39793.0,,,600962.0,,,,15.0,,,,,,99339316.0,,,,,,,-31165296.0,328402.0,170342597.0,,,,13065229.0,14591.0,7801459.0,11096183.0,,14505.0,-100.0,,,5805134.0,,,,,188594.0,6110805.0,,,,,20909923.0,16616331.0,,,,,X,,,,234730.0,76953638.0,36974527.0,,5902398.0,4562243.83,,11942765.0,17202.0,357852058.0,1926.0,,,2662.0,14030220.0,13674612.0,,,7032259.0,,,,,503.0,,,,21989395.0,1109003.0,,,7217454.0,,-274521918.0,70733647.0,16616331.0,9635912.0,47487014.0,,,8408.0,3322617.0,,,,7927154.0,26.0,,,,291418.0,,,18403334.0,,,,,655578.0,,65681394.0,,,,,84968.0,-326617.0,,,588619.0,,,,,1967697.0,603.0,,,,5.0,50179.0,,,,,,34.0,,68799017.0,,,,11193.4,,,,42.7,,17586932.0,,,,2466290.0,1796896.0,39109876.0,27485132.0,,53430530.0,33S106,,,288.0,,,,,,53664502.0,,,330846.0,,,12003.0,,56927.0,,35947080.0,,141008578.0,,2422038.0,,,5320900.0,-3354551.0,,2933202.0,,14505.0,,,,268130.0,,19342179.0,,,-54369.0,,44611213.0,,,37.53,,2314216.0,86978736.0,18666.0,,25138477.0,,,,,,,,,,,72094.0,,,583624.0,,,,6350944.0,,,,815655501.0,,,2336343.0,,12853415.0,,4493901.0,14255.0,,,1186948976.0,,,60042104.0,71.0,0.203847,3063.0,,,,,73067518.0,328402.0,1275363.0,144028481.0,,29564353.0,,,,,10330.0,42975.0,,113.0,,370039.0,,,,145669786.0,,,,6858574.0,,,,33454848.0,141008578.0,20568.0,,,24285.0,,,,,5722363.0,968235.0,,,,91903.0,120910393.0,,16375.0,-2313862.0,,,,,,,,,,25878443.0,1930250.0,,10030,25218427.0,,,,,603.0,56315049.0,N,5657197.0,,,,,,,,,,,,43537361.0,859502061.0,-796315804.0,18608023.0,,5806136.0,1114634.0,,,32142492.0,18403334.0,874256.0,,80204656.0,,,1338395.0,,,,239771.0,,38.79,,,,,247.0,5756936.0,,,,,,,,17420.0,,5913759.0,,,,227075712.0,,,,12277329.0,,,,123549396.0,2519617.0,52517.0,323250.0,,,,215.0,,13674612.0,,2.0,182179.0,,,,421692.0,,,,,1266177.0,,,-497346465.0,120910393.0,,,,,,189755.0,13078.0,,1387358.0,,5518.0,,,,,,7301914.0,,24596234.0,,996050.0,,,13224712.0,,,28362533.0,,,,64973816.0,1109003.0,525261.0,,,,56105.0,,11942765.0,,,,,194333048.0,,,,3836.0,,,4631985.0,,635134.0,10115252.0,2697388.0,,6362642.0,,,,,10596735.0,,,,,,,-384799.0,,,,1131706.0,2051958.0,,,,,,,,,,,,,,8940781.0,,,,7376433.0,,80467347.0,,,,23048358.0,,2349.0,,11561861.0,,2357.0,,,315.0,199825569.0,,,,3781638.0,75.23,286740548.0,,5995232.0,19554952.0,,56315049.0,,110114487.0,664060010.0,20568.0,,,103848098.0,336.5,,99153803.0,,,,47.0,73067518.0,11336978.0,555641.0,76063427.0,,294067.0,,,,,,,,,NORTH SHORE UNIVERSITY HOSPITAL,,,3606559.0,,2016-12-31,,243158546.0,,,,,,16836.0,,,,,-1216920.0,,,195.0,,260.0,,,,41361259.0,4756661.0,13824782.83,,133723206.0,1251989.0,,2815984.0,,,,873444779.0,,,,,-2004188.0,,,341.0,,,,32458717.0,,305126796.0,1051.0,,297579862.0,1925896.0,,53938943.0,,,,2200520834.0,,,,,,11777685.0,,,,,13674612.0,25218427.0,,3.0,19484602.0,-3155131.0,,10156823.0,58545497.0,,9812.0,,,323618.0,,518395.0,1316522.0,,,,1546720.0,,,215085259.0,,,70790394.0,571975.0,,4,4242473.0,,,,,2014400.0,,269963685.0,1.0,1834561.0,,,,,812.0,,25962997.0,9357263.0,968235.0,,,,,,11942765.0,,,,,1332.0,,,10392227.0,,1364978.0,,,,,,61062.0,,13065229.0,,,2016-01-01 00:00:00,34.37,,,Y,10631979.0,,110027148.0,1218.0,904617.0,35286.0,,9571426.0,,,,,,,,,,,,323250.0,16401818.83,,,,98848.0,12964282.0,8132660.0,1332984.0,16375.0,-8587374.0,14644737.0,,,,,,42877691.0,,,,,,45.65,,1228012.0,,,,,114965643.0,524639.0,811014.0,44130.0,258.0,04/04/2008,,91134.0,,1993670.0,,5197096.0,290266.0,,102823.0,,,,,,294839697.0,,,,,14742501.0,,,,,,,-6326.0,28350746.0,,,,72224592.0,,,,,,7896187.0,,,,726483.0,,,,,182180.0,NASSAU,,3107796.0,,67426.0,,1322905.0,,,10127299.0,,,,665971.0,,,,,,,,,16569644.0,-1216920.0,,51357091.0,,,10572067.0,,,,,683363435.0,44053.0,,1077788.0,,,2314216.0,,,60790353.0,-111343.0,,,,,,58530698.0,5518.0,,,23054378.0,,,,,,,,,1022039.0,,,,13398564.0,,7.0,,43756548.0,14799.0,,80204656.0,,96697008.0,157249.0,,,,84.8,,4070.0,2544044.0,,236587.0,,6196431.0,,,,,,,,,99153803.0,1186948976.0,Y,,,,,1550505.0,42909646.0,4393142.0,3348612.0,,69.0,,,336330262.0,10970111.0,2077436.0,,23104.0,,21105402.0,118528.0,,,,-35287.0,6852419094.0,56100954.0,,,,,157693.0,1505664.0,,,,,,257753.0,,,,,,1966579.0,52699479.0,,21008175.0,,33400,P,,,,,,,1384239.0,,1676883.0,,17420.0,2166550.0,,,,,,,,,8433182.0,,,2021-02-15 00:00:00,,,,8027727.0,337148,22.5,68208907.0,3557169.0,,,,,131978471.0,,,70524.0,,,,,,,,7825900.0,,,,,1106124.0,,,,,,,,13078.0,,,,1260297.0,,,,299208409.0,10572067.0,71321982.0,,,,,,80350244.0,13224712.0,,473908.0,-11699213.0,,133723206.0,,,,110522.0,10709638.0,603257.0,,5320900.0,13533960.0,,12475144.0,,,,,,1860.0,9157033.0,6975.0,,,,593707.0,,,,,,,3822735.0,,25.0,,Y,1228012.0,,,,,78122171.0,3397470.0,12003.0,,,,,25138477.0,,,,260.0,189701063.0,,,,,,,,,,,41312.0,N,,,,,10970111.0,48.7,174765.0,,11436.0,Y,General Short Term,9770740.0,,,Y,,,,,,,,2016,Acute Care Hospitals,NORTH SHORE UNIVERSITY HOSPITAL (330106)
44259,NORTH SHORE UNIVERSITY HOSPITAL (330106),General Short Term (Acute Care Hospitals),Voluntary Nonprofit-Other,-73.703029,40.779269,,,,,1242120.0,27888.0,5303245.0,19964.0,,,,,,864491.0,327918.0,,40884476.0,-138378.0,,,,7084.0,,,,,1113239956.0,,,11281568.0,112081883.0,,4811153258.0,,,Y,,1057458.0,,,21826159.0,143663414.0,5528214.0,,266.13,,,1943.0,140541751.0,628230.0,,,,,,34170.0,,124128402.0,1627893.0,,,,382380116.0,,33175806.0,,206242.0,3560530.0,,,,4702640.0,1.0,45528721.0,,,,21308030.0,,,,20529363.0,,16890014.0,,1400093.0,,3906585.0,,45514.0,,,1240.0,,,,,,,107869.0,,1292226539.0,,20574923.0,2541347.0,,27043.0,,1764479.0,,52051.0,30.0,,,,5476.0,-839637.0,259104933.0,,,40884476.0,,,,10528.0,52662.0,,,,,3521494.0,,,652193.0,,,639.0,,1764479.0,,15297238.0,,,,,,,,,45287.0,,,,,1206628.0,,,,,451242418.0,,,9777.0,897006.0,,51.0,869952.0,,1687376.0,,163689230.0,,,,219989.0,32.2,,,N,,764.0,46.33,1876322.0,,28997795.0,,,32941.0,117209.0,,,,,,,,,,,,49235.0,,33,,,,1800.0,13949258.0,5498945.0,,,254763.0,,6617665.0,,,,6986541.0,,2748755.0,,9031455.0,10840943.0,,1130427.0,53675.0,,17756537.0,,2052178.0,,1400093.0,,,1617347.0,,MANHASSET,,,,5540251.0,35319165.0,,1063075.0,,,,,,,,,,,,52495358.0,,,111701802.0,,532619.0,,12265.0,,30.76,,,8737491.0,2632140.0,39949551.0,,,,,,,,,2527480.0,,,1.0,,14746.0,1122488.0,,,378647.0,,,312.82,,38898.0,63479833.0,,,,,,N,138691.0,,278860.0,1740665.0,43.0,,,66.17,,9155394.0,,900564.0,3168666.0,,,17150893.0,,,,19537705.0,,45509044.0,-13335940.0,278837.0,2771.0,,,,,17868954.0,17150893.0,,,,,21704743.0,,122479110.0,-130120.0,,,,6325278.0,4515006.0,5952897.0,,,,2069350.0,,,,1868596233.0,,,,,,,240144009.0,,,184919.0,,,,,,,451242418.0,,,27102.0,,204513497.0,,,51736152.0,,63479833.0,,,44474596.0,10407.0,56.27,17150893.0,9486.0,,,6566624.0,26889.0,,,8858.0,7030370.0,44452057.0,,N,,4180838.0,3543731.0,,,,3547012.0,,228.0,688.0,,,,,548655.0,,23463387.0,,,679300.0,,,,,,,,16838323.0,105358396.0,869952.0,,,,,3904060.0,16167200.0,,,,12398.0,,,-694119673.0,,,,330106,,,,12859034.0,39188.0,,,,,,1444112271.0,,209816742.0,,1252296.0,,,148792808.0,,,,16073527.0,,294708059.0,356866.0,,,393242.0,17836198.0,,,,29.2,198340090.0,,12048.0,,,,5317447.0,8509.0,30491572.0,23457183.0,,,,,,2946263.0,307124.0,,,10428.0,,1668341.0,1311928.0,,,,,13159752.0,,4622123.0,91621.0,30662.0,,,,,,,,36413002.0,171055666.0,-94106.0,,389891.0,,452089.0,5299799.0,,,,,,,,27102.0,684675.0,10.0,,1210836.0,,,,,,,3627735.0,16838323.0,404541264.0,2499757.0,105050205.0,,N,,,50136649.0,62719686.0,,,,,,174679311.0,45813299.0,,47509740.0,3741828.0,1478.0,,,,45528721.0,,,,,20615143.0,,,3715293.0,409700.0,,,197050.0,7190311.0,,,,7803887.0,87893138.0,,,17323637.0,,,,,,,,,,,,,,12127938.0,,,,46484.0,,2814088.0,,,2741753.0,-3693749.0,49235.0,,45803595.0,,,,,,,51.01,,,,,,,,,,,,30983762.0,,,,,-3334871.0,-8908741.0,1255447.0,189904.0,307176134.0,10319604.0,606.0,,,,116288122.0,,-463908.0,,78768695.0,,47935325.0,,256004443.0,,69251.0,,,1773114.0,58439634.0,188479.0,,,,300 COMMUNITY DRIVE,31663778.0,,7273064.0,,,,,,,,16931009.0,,20529363.0,,3917354.0,25518.0,,,1089249.0,,7244871.0,668611.0,,874626.0,,,29703439.0,467.65,,1184818.0,165425.0,,,2052178.0,,,,,,,2892907.0,,4689965.0,3521494.0,828644502.0,1942137.0,,,9459039.0,6196276.0,,,,33284954.0,50992569.0,,223015.0,,87893138.0,,,,,1223184.0,4489023.0,,,,,60216751.0,,6418675.0,,,,815069797.0,,,11667487.0,7025185.0,,28658.0,12491500.0,1643108517.0,1241333.0,,2506890.0,,1053876.0,6117298.0,,,10755524.0,,,3904060.0,,49.94,,,4685036.0,828259859.0,,,11613179.0,,,874626.0,87856941.0,3260791.0,,518131.0,699706.0,,,10335043.0,,,18275347.0,,2586.0,-100744.0,,,2671389.0,149520079.0,,51423776.0,70775270.0,,,,,586166.0,,,,4345.0,,232561.0,,72610599.0,79403356.0,,76884429.0,91621.0,,52812847.0,Y,-2106669.0,,,,,,38336502.0,11276631.0,,2079740.0,,,5670527.0,984823.0,,,721072621.0,,,,-1685474.0,,,24162718.0,,,,15056.0,,4654.0,,,1204334.0,1687376.0,,,,,,115436051.0,,,,,,,,,5355723.0,,,-39407552.0,,10785.67,,,,,58734771.0,10877614.0,18650410.0,,706187,,,,,,55796581.0,,,,,,,,-337078.0,,3499327.0,25298.0,,27530506.0,,,,,15056.0,30561.0,1103325.0,45509044.0,1417.0,,26816779.0,,11364094.0,47509740.0,,289809.0,,,26654754.0,,1015960.0,,,,,144775790.0,-62659.0,30604.0,,,-443223.0,31605.0,,2017.0,1862.0,,299355.0,,59910887.0,863939.0,4608.0,,,,,-156104.0,12144.0,,,1182160.0,378408.0,,,,224670.0,,,256.0,,55694502.0,,,,,,,294708059.0,,573295.0,19280559.0,,,1741.0,49.49,,,,81.97,,,48898166.0,,,,,,,,,1802531.0,,,,,416264.0,,,6018.0,,671380.0,43612080.0,13837405.0,28078952.0,61.0,,,,,335702,,,,,,877220.0,,,,,58.54,,25181068.0,3918146.0,144666.0,44471741.0,,85093856.0,,,,,15625660.0,47240159.0,854157.0,,,,,449097.0,,70775270.0,,,,,3325.0,,,,,95.0,,L,,-102022.0,,,,576718955.0,,,,82223598.0,,,,,,,,2607407.0,,10275.0,,-42271542.0,,20754.0,691064.0,,,,23845.0,-825.0,,,,,,,35004,6240160.0,,2326291.0,,,,,5224.0,,,Y,,,,,,,,,60216705.0,,,,,385689.0,,25.04,,16324.0,,24.55,,,,15159171.0,,,,400399.0,146741.0,,43913261.0,35537.0,,,-688213.0,10877614.0,7800.0,14148.0,,6380948.0,335653004.0,,3328255.0,26374786.0,,,,,,,,12672.0,,,296182906.0,197050.0,,,,,,,23847552.0,,,,5475.0,513.0,,,46809.0,230797.0,,953726.0,230207.0,9296617.0,-4441321.0,,,,,,,2935764.0,,,1289450.0,13853437.0,,13711920.0,,49458.0,245.0,7344.0,,326081.0,864.0,85364.0,325847.0,,10016.0,4844362.0,,96459.0,23679870.0,,,35319165.0,,31062935.0,,25181068.0,74453854.0,,10420623.0,-10131890.0,,,,,,107869.0,2104479.0,,11169262.0,,4617.0,,,,,121000.0,,,,-855321255.0,,,,12080636.0,,24888137.0,,,2196185.0,,,,1445885385.0,,9856.0,107310.0,,1580996.0,N,586847.0,,,2315421.0,,,13159752.0,5380,563320.0,,12672.0,-5504.0,,33027513.0,1544499.0,,7229191.0,,223015.0,,65189724.0,23020910.0,-3255231.0,,,2168542.0,193170.0,,,136033998.0,,149581.0,398125.0,,,,22976.0,23160.0,7082530.0,,140892.0,,,,,18113658.0,,,,,,731047.0,,,,276452736.0,,,,,3918146.0,,,15625660.0,12276.0,,89897173.0,,,,,,,,,,,1630818.0,,,,,,,,17410225.0,,81888.0,,,369538.0,,,52495358.0,10877614.0,,,23987825.0,1540853003.0,474687.0,,,,,,,,6325278.0,1130427.0,450608.0,,3288670.0,NY,,10428.0,2.0,55889.0,133012.0,,,,,151273.0,607676.0,,20.0,,10513045.0,369538.0,59862537.0,,,65402721.0,,910.0,,1100976.0,760889.0,,,40.0,341.45,33279324.0,,,20.0,,6763.0,,,48596253.0,,,13389.0,,,,,,,643731.0,,,1252296.0,6536200.0,,,,,,2179800.0,,13502179.0,28.15,,,,2857791.0,26390048.0,,,,38740903.0,,,454.6,,26856.0,2161.0,,,,,,3609897.0,,193170.0,66767173.0,,,,,,11925127.0,31663778.0,30786180.0,24.0,151273.0,,,,35780.0,,,,,,,,,,,,356004.0,,31142521.0,,,,408554.0,14600.0,,,147849.0,,22365552.0,378408.0,116739.0,33599008.0,91259.0,,50461805.0,,64088646.0,,,,,230797.0,,,,811.0,,,,,3650.0,,,19730170.0,4052853.0,320118.0,,47520.0,,10076.0,2270117.0,3142006.0,36381389.0,,60871.0,55823182.0,,,,2.0,,4820125.0,4008.0,,294708059.0,7803959.0,399590.0,1444112271.0,,1971348.0,,146741.0,5411883.0,9031455.0,,,41568592.0,,,,,,,,,,,,207291.0,,26816779.0,,,,3499327.0,,227634.0,8737491.0,,,7190311.0,,47935325.0,136569522.0,,10687576.0,3970146.0,,,,4276374.0,,55932412.0,534696420.0,,,,,,,369538.0,314730.0,6720438.0,,2017.0,,,,NSUH PSYCHIATRIC EXEMPT UNIT,,,406150.0,2364971.0,79618.0,,332401.0,9031455.0,13001,19841585.0,,,12144.0,,,,,,,,,,76880.0,,,N,29.72,6098298.0,,,21597847.0,,72817.0,1834692.0,,,1206203233.0,355500.0,,,16890014.0,,,878773.0,,F,71.14,44471741.0,,,,881155.0,,,,15.0,,,,,,79403356.0,,,,,,,-16101705.0,473013.0,170994652.0,,,,13979788.0,16354.0,9490899.0,11925127.0,,6205.0,46.0,,,10513045.0,,,,,217850.0,6988667.0,,,,,21826159.0,21185985.0,,,,,,,,,232194.0,85133420.0,38068666.0,,6705074.0,4673380.0,,10192904.0,17155.0,404541264.0,2016.0,,,6940.0,17323637.0,14149434.0,,,7813274.0,,,,,566.0,,,,22964533.0,874626.0,,,8430027.0,,-309645197.0,74453854.0,21185985.0,6171784.0,50562549.0,,,8858.0,6885763.0,,,,8276482.0,,,,,261586.0,,,17652697.0,,,,,777801.0,,65704443.0,,,,,53675.0,-100744.0,,,492749.0,,,,,2069355.0,611.0,,,,,49458.0,,,,,,,,72610599.0,,,,11739.8,,,,42.24,,19343220.0,,,,4894211.0,1983308.0,58061430.0,25707258.0,,54021075.0,33S106,,,303.0,,,,,,55823182.0,,,354769.0,,,4732.0,,109559.0,,41191817.0,,145060811.0,,1996388.0,,,7821106.0,-3693749.0,,2846154.0,,6205.0,,,,,,21597847.0,,,-1166.0,,54266640.0,,,41.84,,136878.0,89897173.0,18615.0,,26656642.0,,,,,8.0,5161.0,,,,,70457.0,,,485574.0,,,,5851445.0,,,,815069797.0,,,3056457.0,,15159171.0,,486065.0,13389.0,,,1292226539.0,,,59202778.0,6.0,0.203205,842.0,,,,,87814523.0,473013.0,778493.0,148792808.0,,7131600.0,,,,,10407.0,63579.0,,,,351442.0,,,,151892868.0,,,,7342268.0,,,,33447916.0,145060811.0,7920.0,,,29571.0,,,,,8221365.0,1125126.0,19964.0,,,91621.0,137268783.0,,49216.0,-2212068.0,,,,,,,,,,23987825.0,1275750.0,,10030,25990143.0,,,,,611.0,55550032.0,N,4515006.0,,,,,,,,,,,,45862521.0,916750129.0,-855321255.0,17836198.0,,2660069.0,1130427.0,,,33284954.0,17652697.0,780211.0,,81068017.0,,,1876322.0,,,,321709.0,,38.63,,,,,245.0,6838078.0,,,,,,,,16413.0,,6356529.0,,,,257197457.0,,,,12859034.0,,,,138132711.0,3102929.0,46484.0,152126.0,,,,227.0,,14149434.0,,2.0,258641.0,,,,374930.0,,,,,1349569.0,,,-518308738.0,137268783.0,,,,,,297083.0,10670.0,,1400093.0,,5462.0,,,,,,7886849.0,,24751522.0,,1291588.0,,,13073774.0,,,15610476.0,,,,65063948.0,874626.0,431481.0,,,,51005.0,,10192904.0,,,,,209816742.0,,,,4008.0,,,5303245.0,,655585.0,10438996.0,6720438.0,,5684393.0,,,,,12127938.0,,,,,,,704274.0,,,,1091290.0,2360288.0,,,,,,,,,,,,,,,,,,7244871.0,,85081591.0,,,,23847552.0,,3421.0,,23846452.0,,688.0,,,,187706325.0,,,,3851216.0,75.19,196827166.0,,6592654.0,20833716.0,,55550032.0,,123246269.0,706058761.0,12265.0,,,111701802.0,341.45,,111422487.0,,,,47.0,87814523.0,13159752.0,857867.0,85155799.0,,280383.0,,,,,,,,,NORTH SHORE UNIVERSITY HOSPITAL,,,3970146.0,,2017-12-31,,243385711.0,,,,,,7898.0,,,,,-1265487.0,,,,,,,,,59910887.0,5380549.0,13842767.0,,136355547.0,1320092.0,,2312136.0,,,,931763989.0,,,,,-2065755.0,,,366.0,,,,38740903.0,,340273583.0,1040.0,,280236687.0,2913215.0,,55160006.0,,,,2295531402.0,,,,,,13692919.0,,,,,14149434.0,25990143.0,,,22244681.0,-3097319.0,,10301887.0,59561326.0,,9486.0,,,273746.0,,135761.0,1271936.0,,,,1627893.0,,,216510867.0,,,76884429.0,17667.0,,3,3817302.0,,,,,1297580.0,,264227535.0,156104.0,-1926684.0,,,,,329.0,,24619793.0,14885808.0,1125126.0,,,,,,10192904.0,,,,,1240.0,,,10873014.0,,1447430.0,,,,,,30236.0,,13979788.0,,,2017-01-01 00:00:00,35.86,,,Y,6325278.0,,122201098.0,1283.0,2694557.0,24513.0,,8957954.0,,,,,,,,,,,,152126.0,16735674.0,,,,98197.0,13531182.0,8393016.0,1463442.0,49216.0,-10847915.0,9031455.0,,,,,,45803595.0,,,,,,44.51,,1048758.0,,,,,118665370.0,669149.0,900564.0,62329.0,1255.0,04/04/2008,,93440.0,,1916628.0,,5411883.0,285442.0,,102940.0,,,,,,294708059.0,,,,,19176524.0,,,,,,,,332763.0,,,,78768695.0,,,,,,7273064.0,,,,848181.0,,,,,207291.0,NASSAU,,2556181.0,,59322.0,,1657314.0,,,10256257.0,,,,682692.0,,,,,,,,,12427687.0,-1265487.0,,52812847.0,,,11833066.0,,,,,723446767.0,41784.0,,1164210.0,,,136878.0,,,63754546.0,-6477.0,,,,,43963.0,59545371.0,5462.0,,,20574923.0,,,,,,,,,1032892.0,,,,13837405.0,,,,47935325.0,15955.0,,81068017.0,,107571881.0,369623.0,,,,81.97,,4617.0,2748755.0,,320118.0,,6097659.0,,,,,,,,,111422487.0,1292226539.0,Y,,,,,1687376.0,48898166.0,4545167.0,3904060.0,,,,,311762447.0,23020910.0,2179800.0,,32264.0,,21309418.0,127759.0,,,,-709534.0,7106684660.0,49808109.0,,,,,171077.0,4872336.0,,,,,,206242.0,,,,,,2166457.0,55796581.0,,6380948.0,,33400,P,,,,,,,1228320.0,,1764479.0,,16413.0,,608312.0,,,,,,,,18275347.0,,,2021-12-03 00:00:00,,,,13090808.0,337148,24.11,55932412.0,4420962.0,,,,,140541751.0,,,,,,,,,,,7229191.0,,,,,979890.0,,,,,,,,10670.0,,,,1252296.0,,,,346372043.0,11833066.0,70931671.0,,,,,,90420988.0,13073774.0,,1133423.0,-13350796.0,,136569522.0,,,,111277.0,9583172.0,606136.0,,7821106.0,12387278.0,,11835056.0,,,,,,2161.0,8723825.0,7015.0,,,,431748.0,,1397.0,,,,,3143650.0,,26.78,,Y,1048758.0,,,,,34975889.0,3521494.0,4732.0,,,,,26656642.0,,,,,204513497.0,,,,11657.0,,,,,,,40331.0,N,,,,,23020910.0,51.39,191157.0,,12048.0,Y,General Short Term,10018039.0,,,Y,,,,,,,,2017,Acute Care Hospitals,NORTH SHORE UNIVERSITY HOSPITAL (330106)
51023,NORTH SHORE UNIVERSITY HOSPITAL (330106),General Short Term (Acute Care Hospitals),Voluntary Nonprofit-Other,-73.703029,40.779269,,,,,1340865.0,20734.0,5353511.0,,,,,,,1363371.0,321354.0,,47881887.0,,,,,5696.0,,,,,932324433.0,,,11689846.0,114454710.0,,5151841452.0,,,Y,,863990.0,,,22858940.0,158414758.0,5260136.0,,260.73,,,7049.0,144407806.0,271144.0,,,,,,27714.0,,129367080.0,2031158.0,,,,403689847.0,,27917720.0,,129590.0,3240661.0,,,,537819.0,1.0,44615329.0,,,,18016743.0,,,,20636821.0,,18295722.0,,1236554.0,,4505053.0,,39728.0,,,1212.0,,,,,,,81636.0,,1356028158.0,,22406542.0,2993467.0,,27714.0,,1726246.0,,44095.0,45.0,,,,5845.0,-420451.0,274099985.0,,,47881887.0,,,,,71568.0,,,,,3464509.0,,,698413.0,,,1179.0,,1726246.0,,16893734.0,,,,,,,,,46532.0,,,,,1246698.0,,,,,487851399.0,,,,877588.0,,51.0,611478.0,,2008485.0,,177632389.0,,,,195724.0,32.62,,,N,,764.0,48.07,2083069.0,,25616133.0,,,33856.0,152336.0,,,,,,,,,,,,71030.0,,33,,,,3768.0,15069275.0,8177756.0,,,260542.0,,7368710.0,,,,6639903.0,,2396414.0,,8860638.0,12029827.0,,997197.0,433701.0,,23987333.0,,1918116.0,,1236554.0,,,1800952.0,,MANHASSET,,,,6095222.0,37030595.0,,1103591.0,,,,,,,,,,,,55399521.0,,,115578293.0,,547740.0,,33033.0,,31.13,,,11279151.0,1965301.0,47238550.0,1224965.0,,,,,,,,2668221.0,,,1.0,,21967.0,849336.0,,,392935.0,,,271.78,,57325.0,67315679.0,,,,,,N,140799.0,,278860.0,2233759.0,124.0,,,68.26,,9061447.0,,881425.0,2720756.0,,,17867459.0,,,,20047002.0,,51769849.0,-14574707.0,593943.0,1112.0,,,,,18716919.0,17867459.0,,,,,23259129.0,,145047244.0,-31319.0,,,,9902350.0,3088359.0,7507153.0,,,,2150802.0,,,,2028287819.0,,,,,,,228306017.0,,,188748.0,,,,,,,487851399.0,,,25560.0,,213932825.0,,,58867025.0,,67315679.0,,,43216129.0,10778.0,57.28,17867459.0,6462.0,,,6641326.0,15685.0,,,15643.0,7813231.0,15981419.0,,N,,4250947.0,8038907.0,,,,3355762.0,,1957.0,1010.0,,,,,187154.0,,22318670.0,,,707024.0,,,,,,,,22077228.0,135362097.0,611478.0,,,,,4055937.0,104544.0,,,,14991.0,,,-774461384.0,,,,330106,,,,12118764.0,11650.0,,,,,,1568721690.0,,219286336.0,,1314249.0,,,154805718.0,,,,14207321.0,,324320699.0,308914.0,,,387322.0,18217141.0,,,,28.98,222498516.0,,13362.0,,,,5462796.0,3501.0,34950768.0,806851.0,,,,,,3782095.0,509499.0,,,9832.0,,1579251.0,1566999.0,,,,,14075715.0,,4698896.0,90735.0,20649.0,,,,,,,,37849722.0,177276347.0,-80986.0,,425561.0,936150.0,1703180.0,5508845.0,,,,,,,,25560.0,694778.0,11.0,,888323.0,,,,,,,3601224.0,22077228.0,445668797.0,3175422.0,118073330.0,,N,,,50979628.0,65546846.0,,,,,,176149255.0,,,45443097.0,3802997.0,1517.0,,,,44615329.0,,,,,22311575.0,,,3930980.0,1814261.0,,,296950.0,7894410.0,,,,9669863.0,100623625.0,,,19732364.0,,,,,,,,,,,,,,18468470.0,,,,24565.0,,2686121.0,,,2134537.0,-3695152.0,71030.0,,49140525.0,,,,,,,52.18,,,,,,,,,,,,40907762.0,,,,,,-9736267.0,,732267.0,322069062.0,10244551.0,575.0,,,,128324696.0,,,,96820357.0,,46445451.0,,224520257.0,,85988.0,,,1428423.0,63964090.0,228309.0,,,,300 COMMUNITY DRIVE,37396747.0,,7295815.0,,,,,,,,20211783.0,,20636821.0,,4226242.0,22770.0,,,967869.0,,5445158.0,830759.0,,750172.0,,,30964278.0,475.81,,1534250.0,204663.0,,,1918116.0,,,,,,,3254258.0,,4785776.0,3332992.0,848524667.0,2279962.0,,,9431444.0,6196276.0,,,,37883970.0,53212304.0,,223015.0,,100623625.0,,,,,1470512.0,4819764.0,,,,,66106177.0,,6584768.0,,,,734302055.0,,,12091564.0,7252504.0,,36481.0,20010000.0,1733865330.0,1395456.0,,2491697.0,,884023.0,4799969.0,,,10157717.0,,,4055937.0,,53.62,,,4882019.0,848030805.0,,,12548284.0,,,750172.0,85620998.0,3298665.0,,779612.0,705754.0,,,8134217.0,,,,,-6501.0,,,,3303961.0,142852992.0,,48383822.0,78876325.0,,,,,431366.0,,,,9952.0,,234030.0,,80082322.0,84364155.0,,84268097.0,90735.0,,59179346.0,Y,-1640933.0,,,,,,33223782.0,9611605.0,,3818053.0,,,7707539.0,973536.0,,,725595910.0,,,,-2675069.0,,,24839191.0,,,,15053.0,,1880.0,,,1322122.0,2008485.0,,,,,,3901225.0,,,,,,,,,4924610.0,,,-24482887.0,,11054.52,,,,,58970223.0,11034143.0,20227034.0,,726057,,,,,,55585039.0,,,,,,,,-31271.0,,3518634.0,54880.0,,31043407.0,,,,,15053.0,90226.0,971637.0,51769849.0,1468.0,,24336397.0,,13798094.0,45443097.0,,78878.0,,,26519450.0,,861079.0,,,,,212001379.0,-69061.0,67954.0,,,-41201.0,404926.0,,1585.0,,,292771.0,,62379580.0,900204.0,2187.0,,,,,-802674.0,12418.0,,,2090708.0,376000.0,,,,209287.0,,,256.0,,56558706.0,,,,,,,324320699.0,,617366.0,19285213.0,,,14476.0,50.18,,,,80.22,,,56494339.0,,,,,,,,,1771163.0,,,,,422809.0,,,23492.0,,851453.0,50436882.0,13424219.0,27384709.0,49.0,,,,,335702,,,,,,1123570.0,,1.0,,,59.93,,24926122.0,4648976.0,149936.0,46468450.0,,94444896.0,,,,,17401878.0,53657668.0,887981.0,,,,,555245.0,,78876325.0,,,,,3854.0,,,,,75.0,,N,,-102023.0,,,,541332455.0,,,,84827047.0,,,,,,,,3053584.0,,19910.0,,-47873738.0,,51200.0,683437.0,,,,12186.0,,,,,,,,35004,6213213.0,,,,,,,6286.0,,,Y,,,,,,,,,66106090.0,,,,,385240.0,,26.24,,18607.0,,25.18,,,,14700872.0,,,,181153.0,144816.0,,2505315.0,37083.0,,,-78707.0,11034143.0,5146.0,19283.0,,5877068.0,351343163.0,,3229862.0,27465301.0,,,,,,,,10667.0,,,313055837.0,296950.0,,,,,,,24693869.0,,,,5475.0,569.0,,,60341.0,228308.0,,1154551.0,239122.0,9220896.0,-256427.0,,,,,,,2877885.0,,,1485127.0,13655155.31,,14096715.0,,48079.0,246.0,6515.0,,397459.0,958.0,86348.0,465580.0,,12106.0,5834573.0,,74272.0,25829664.0,,,37030595.0,,36749576.0,,24926122.0,83282028.0,,9228613.0,-2182526.0,,,,,,81636.0,1999423.0,,11274364.0,,4875.0,,,,,241380.0,,,,-922124488.0,,66594.0,,12763374.0,,41144264.0,,,2249627.0,,,,1570150113.0,,5241.0,230594.0,,1560315.0,N,576242.0,,,2747934.0,,,14075715.0,5380,527530.0,,10667.0,,,33251566.0,1570108.0,,7172594.0,,223015.0,,74496616.0,23213599.0,-9152.0,,,2053792.0,482498.0,,,150859342.0,,170984.0,235801.0,,,,22605.0,20035.31,6536803.0,,147351.0,,,,,20055327.0,,,,,,913724.0,,,,294364411.0,,,,,4648976.0,,,17401878.0,,,94501014.0,-13368773.0,,,,,,,,,,1715293.0,,,,,,,,17569514.0,,82276.0,,,319581.0,,,55399521.0,11034143.0,,,26955670.0,1629090620.0,359113.0,,,,,,,,9902350.0,997197.0,485685.0,,3354595.0,NY,,9832.0,,149713.0,157752.0,,,,,399065.0,667736.0,,27.0,,12174878.0,319581.0,23740693.0,,,74185738.0,,2377.0,,1259847.0,677616.0,,,40.0,335.41,35748452.0,,,20.0,,48443.0,,,49936140.0,,,13698.0,,,,,,,653641.0,,,1314249.0,6021238.0,,,,,,3720825.0,,14132091.0,28.81,48364.0,,,2956975.0,29643227.0,,,,48055703.0,,,518.54,,27724.0,1736.0,,,,,,3668156.0,,482498.0,74666551.0,,,,,,11288966.0,37396747.0,46211828.0,39.0,399065.0,,,,20982.0,,,,,,,,,,,,369669.0,,53858389.0,,,,444072.0,14600.0,,,116270.0,,23174490.0,376000.0,37060.0,35273574.0,,,54672058.0,,,,,,,228308.0,,,,470.0,,,,,4015.0,,,18691426.0,4332542.0,316208.0,,51411.0,,9589.0,,3007475.0,36701193.0,,34206.0,60494497.0,,,,2.0,,5126277.0,3723.0,,324320699.0,8379352.0,459687.0,1568721690.0,,2079285.0,,144816.0,5576821.0,8860638.0,,,46849912.0,,,,133.0,,,,,,,,235432.0,,24336397.0,,,,3518634.0,,308048.0,11279151.0,,,7894410.0,,46445451.0,124730204.0,,10890629.0,1728281.0,,,,4346936.0,,37562011.0,579454103.0,,,,,,,319581.0,381772.0,5993565.0,,1585.0,,,,NSUH PSYCHIATRIC EXEMPT UNIT,,,399459.0,2458429.0,39402.0,,403587.0,8860638.0,13001,24615277.0,,,12418.0,,1990.0,,,,,,,,95165.0,,,N,30.79,6206283.0,,,21605185.0,,56549.0,2040527.0,,,1299961660.0,348119.0,,,18295722.0,,1190481.0,1248793.0,,F,70.6,46468450.0,15005.0,,,870658.0,9335097.0,,,15.0,,,,,,84364155.0,,,,,,,-16034394.0,381313.0,169714351.0,,,,15302221.0,16803.0,10206136.0,11288966.0,,4880.0,87.0,,,12174878.0,,,,,193574.0,7180069.0,,,,,22858940.0,43281488.0,,,,,,,,,229318.0,100218920.0,35147334.0,,11192798.0,4499894.31,,9407831.0,17155.0,445668797.0,2457.0,,,14935.0,19732364.0,14270849.0,,,7299378.0,,,,,,,,,23674926.0,750172.0,,,9698294.0,,-334140612.0,83282028.0,43281488.0,6428197.0,54672058.0,,,15643.0,3703231.0,,,,9098955.0,,,,,265113.0,,,20391862.0,,,,,917344.0,,71726270.0,,,,,433701.0,,,,368934.0,,,,,2155556.0,611.0,,,,,48079.0,,,,,,,,80082322.0,,,,12084.5,,,,41.77,,24398432.0,,,,4841829.0,2096009.0,68769375.0,25718657.0,,59173448.0,33S106,,,337.0,,,,,,60494497.0,,,307341.0,,,19604.0,,7678.0,,58897863.0,,149244627.0,,2074541.0,,,11381546.0,-3695152.0,,3753606.0,,4880.0,,,,,,21605185.0,,,,,64173315.0,,,46.37,,2292608.0,94501014.0,18615.0,,29619385.0,,,,,,12565.0,,,,,65797.0,,,504094.0,,,,6199896.0,,,,734302055.0,,,3007683.0,,14700872.0,,457799.0,13698.0,,,1356028158.0,,,58551675.0,6.0,0.20682,1573.0,,,,,92430116.0,381313.0,1537623.0,154805718.0,,17156931.0,,,,,10778.0,65549.0,,,,352296.0,,,,174945496.0,,,,8317117.0,,,,35864526.0,149244627.0,21091.0,,,29711.0,,,,,27205224.0,694287.0,,,,90735.0,145854847.0,,46460.0,-2626110.0,,,,,,,,,,26955670.0,2301725.0,,10030,26971439.0,,,,,611.0,56803254.0,N,3088359.0,,,,,,,,,,,,48507668.0,932126524.0,-922124488.0,18217141.0,,3125152.0,997197.0,,,37883970.0,20391862.0,793053.0,,84105578.0,,,2083069.0,,,,412790.0,,39.07,,,,,246.0,7243046.0,,,,,,,,17423.0,,6547256.0,,,,316024691.0,,,,12118764.0,,,,158777680.0,3662543.0,24565.0,400729.0,,,,252.0,,14270849.0,,2.0,274601.0,,,,311935.0,,,,,1728571.0,,,-557847419.0,145854847.0,,,,,,347384.0,9352.0,,1236554.0,,4916.0,,,,,,8920255.0,,24154847.0,,1412063.0,,,13716730.0,,,17400882.0,,,,71422093.0,750172.0,448515.0,,,,52188.0,,9407831.0,,,,,219286336.0,,,,3723.0,,,5353511.0,,857010.0,8229574.0,5993565.0,,5777631.0,,,,,18468470.0,,,,,,,690436.0,,,,737507.0,2706518.0,,,,,,,,,,,,,,,,,,5445158.0,,94411863.0,,,,24693869.0,,3764.0,,24698726.0,,1010.0,,,,194899138.0,,,,3747946.0,75.51,150232289.0,,7213637.0,22029211.0,,56803254.0,,143021485.0,712090016.0,33033.0,,,115578293.0,335.41,,113775289.0,,,,47.0,92430116.0,14075715.0,1055206.0,85176358.0,,230547.0,,,,,,,,,NORTH SHORE UNIVERSITY HOSPITAL,,,1728281.0,,2018-12-31,,215983080.0,,,,,,86140.0,,,,,-2061270.0,,,,,228.0,,,,62379580.0,5902195.0,13645803.31,,124635975.0,1436772.0,,2404142.0,,,,945632418.0,,,,,-1600538.0,,,428.0,,,,48055703.0,,362049353.0,1040.0,,299834155.0,2958057.0,,20371482.0,,,,2433107273.0,,,,,,16366337.0,,,,,14270849.0,26971439.0,,,24310974.0,-3645335.0,,10505389.0,65268670.0,,6462.0,160.0,,435058.0,,83712.0,1189523.0,,,,2031158.0,,,209996520.0,,,84268097.0,2562453.0,,2,3275554.0,,,,,2325296.0,,292820495.0,802674.0,1492629.0,,,,,295.0,,24009794.0,12856853.0,694287.0,,,,,,9407831.0,,,,,1212.0,,,11245774.0,,1832096.0,,,,,,21521.0,,15302221.0,,1800.0,2018-01-01 00:00:00,35.36,,,Y,9902350.0,,135940789.0,1423.0,1768207.0,16427.0,,11649748.0,,,,,,,,14957.0,,,,400729.0,16900061.31,,,,94254.0,12837923.0,8141437.0,1378859.0,46460.0,-12827616.0,8860638.0,,,,,,49140525.0,,,,,,43.63,,901919.0,,,,,123044840.0,721614.0,881425.0,53613.0,,04/04/2008,,93440.0,,1765320.0,,5576821.0,283762.0,,101738.0,,,,,,324320699.0,,,,,15626558.0,,,,,,,,22308.0,,,,96820357.0,,,,,,7295815.0,937950.0,,,880779.0,,,,,235432.0,NASSAU,,2657481.0,,62003.0,,845867.0,,,10377037.0,,,,702962.0,,,,,,,,,2807862.0,-2061270.0,,59179346.0,,,12818036.0,,,,,772424330.0,41493.0,,1183104.0,,,2292608.0,,,71341682.0,,,,,,105102.0,65254724.0,4916.0,,,22406542.0,,,,,,,,,1309928.0,,,,13424219.0,,,,46445451.0,13946.0,,84105578.0,,122928757.0,247874.0,,,,80.22,,4875.0,2396414.0,,316208.0,,6205104.0,,,,,,,,,113775289.0,1356028158.0,Y,,,,,2008485.0,56494339.0,4965460.0,4055937.0,,,,,324133459.0,23213599.0,3720825.0,,68374.0,,21160347.0,81365.0,,,,-61661.0,7584948725.0,49820134.0,,,,,171118.0,3126503.0,,,,,,129590.0,,,,,,2456828.0,55585039.0,,5877068.0,,33400,P,,,,4103.0,,,1250144.0,,1726246.0,,17423.0,,,,,,,,,,,,,2022-10-06 00:00:00,,,,11046079.0,337148,24.77,37562011.0,4035005.0,,,,,144407806.0,,,,,,,,,,,7172594.0,,,,,1408607.0,,,,,,,,9352.0,,,,1314249.0,,,,354545285.0,12818036.0,71422123.0,,,,,,105061298.0,13716730.0,,903843.0,-14551835.0,,124730204.0,,,,713505.0,9740611.0,705709.0,,11381546.0,13068589.0,,12678829.0,,,,,,1736.0,8581940.0,7531.0,,,,581947.0,,1010.0,,,,,3267565.0,,27.62,,Y,901919.0,,,,,29729089.0,3464509.0,19604.0,,,,,29619385.0,,,,228.0,213932825.0,,,,,,,,,,,43311.0,N,,,,,23213599.0,50.74,324209.0,,19182.0,Y,General Short Term,10213268.0,,,Y,,1190481.0,,,,,,2018,Acute Care Hospitals,NORTH SHORE UNIVERSITY HOSPITAL (330106)
56139,NORTH SHORE UNIVERSITY HOSPITAL (330106),General Short Term (Acute Care Hospitals),Voluntary Nonprofit-Other,-73.703029,40.779269,,,,,1262585.0,15000.0,3562694.0,,,,,,,3139645.0,87405.0,,52781797.0,,,,,4538.0,,,,,1037313793.0,,,12390075.0,126584474.0,,5646461290.0,,,Y,,947221.0,,,23795651.0,138497572.0,5795964.0,,221.04,,,1552.0,147630005.0,262843.0,,,,2141489.0,,29877.0,,146485893.0,1959807.0,,,,474228722.0,,31815956.0,,187175.0,3694051.0,,,,1238438.0,1.0,26991319.0,,,,25825741.0,,,,20035644.0,,17073568.0,,4081476.0,,8236819.0,,177375.0,,17181.0,1218.0,,,,,,,364788.0,,1495166042.0,,22000449.0,3271658.0,,29877.0,,1653054.0,,23718.0,35.0,,,,5490.0,-6540416.0,298663477.0,,,52781797.0,,,,,59996.0,,,,,3503115.0,,,756594.0,,,,,1653054.0,,15723187.0,,,,,,,,,49936.0,,,,,1407997.0,,,,NY,477473048.0,,,,969116.0,,51.0,620759.0,,1936247.0,,177291026.0,,,,369779.0,34.25,,,N,,782.0,47.67,2053780.0,,29369969.0,,,10937.0,261052.0,,,,,,,,,,,,19619.0,,33,,,,1337.0,15168677.0,8918413.0,,,246553.0,,6809256.0,,,,6998370.0,,7629670.0,,7541262.0,8161334.0,,816147.0,445467.0,,23858668.0,,2227623.0,,4081476.0,,,1769687.0,,MANHASSET,,,,5226733.0,47502742.0,,1245332.0,,,,1060900.0,,,,,,,,60569605.0,,,129353084.0,,575506.0,,25211.0,,23.01,,,14171175.0,5585788.0,68524954.0,,,,,,,,,3170286.0,,,1.0,,6254.0,2771478.0,,,415259.0,,,217.24,,194834.0,54505823.0,,,,,,N,64955.0,,284116.0,554309.0,67.0,25759141.0,,70.0,,12931381.0,,7149850.0,3051186.0,,,19711083.0,,,,18341528.0,,54986180.0,-11064137.0,543199.0,180.0,,,,,20646595.0,19711083.0,,,,,26498542.0,,31348680.0,,,,,11372524.0,3878714.0,8807541.0,,,,2270781.0,,,,2198595598.0,,,,,,,256232187.0,,,196851.0,,,,,,,477473048.0,,,18952.0,,225085579.0,,,60514435.0,,54505823.0,,,42121406.0,8534.0,60.42,19711083.0,3790.0,,,8393974.0,20800.0,,,15573.0,8110738.0,15194187.0,,N,,4034691.0,5016321.0,,,10649.0,3524059.0,,326.0,662.0,,,,93581764.0,1404274.0,,24515232.0,,,746414.0,,,,,,,,22511598.0,148916324.0,620759.0,,,,,1867212.0,,,,,15333.0,,,-576671712.0,,,,330106,,,,13064544.0,20096.0,,,,,,1527258353.0,,254407414.0,,1404472.0,,,145963772.0,,,,16579095.0,,340416398.0,245839.0,,,376960.0,19159480.0,,,,32.37,261990772.0,,14698.0,,,,5488804.0,583.0,39525201.0,15685701.0,,,,,,6650368.0,512089.0,,,9595.0,,2190449.0,1678738.0,,,,,15072022.0,,4460935.0,93034.0,17559.0,,,,,,,,39962072.0,185339930.0,-2305.0,03/11/2019,434620.0,963937.0,1000977.0,5816249.0,,,,,,,,18952.0,660260.0,,,1050931.0,WESTBURY,,,,,,3757219.0,22511598.0,559146453.0,2986570.0,129775253.0,,N,,,48251546.0,66259864.0,,,,,,169496733.0,64088646.0,,49633781.0,3610537.0,1236.0,,,,26991319.0,,,,,27273024.0,,,3115938.0,1201922.0,,,400025.0,7930248.0,,,,11023596.0,119510557.0,,,16245600.0,,,-3993424.0,,,,,,,,,,,19110903.0,,,,31991.0,,1966032.0,,,1847752.0,-3522689.0,19619.0,,55973046.0,,,,,,,50.28,,,,,,,,,,,,52967050.0,,,,,,-6094821.0,1377187.0,96816.0,358448509.0,9489746.0,1237.0,,,,135996171.0,,,,97015553.0,,52185454.0,,231671034.0,,342467.0,,,2137137.0,58757604.0,4604187.0,,,,300 COMMUNITY DRIVE,43192878.0,,6865713.0,,,,,,,,23572811.0,,20035644.0,,1407328.0,20944.0,,,795858.0,,5813981.0,890078.0,,930371.0,,,41064708.0,474.98,,1539689.0,248690.0,,,2227623.0,,,,,,,3377229.0,,5216816.0,3503115.0,781788368.0,3602164.0,,,20813679.0,7421241.0,,,,26465013.0,37813780.0,,223015.0,,119510557.0,,95723004.0,,,1407850.0,4839080.0,,,,,59396264.0,,6827544.0,,,,755816403.0,,,13101570.0,7596814.0,,32866.0,20475075.0,1681646205.0,2106742.0,,2032879.0,,883145.0,6968354.0,,,10457741.0,,,1867212.0,,55.48,,,5073333.0,767583352.0,,NORTHWELL HEALTHCARE INC,13449879.0,,,94512135.0,107581244.0,3317211.0,,810193.0,1287244.0,,,8075376.0,,,13257194.0,,12762.0,,,,4067305.0,150420242.0,,50427475.0,86932499.0,,,,,519196.0,,,,,,242447.0,,60235669.0,87982419.0,,72471192.0,93034.0,,67234099.0,Y,-171882383.0,,,,,,45035160.0,9339605.0,,3695205.0,675216.0,,5869837.0,322591.0,,,644792476.0,,,,-3611434.0,,,25191793.0,,,,16384.0,,3984.0,,,1187924.0,1936247.0,,,,,,85214568.0,,,,,,,,,5155341.0,,,-49231720.0,,11938.51,,,,,59730173.0,13570523.0,44089521.0,,730652,,,,,,61883551.0,25759141.0,593239.0,,,,,,-180204.0,,4233001.0,37215.0,,35111861.0,,,,,16384.0,346056.0,797195.0,55038694.0,1185.0,,35400362.0,,12993905.0,49633781.0,,124430.0,,,13646161.0,,-1036915.0,,HB2348,,,132420903.0,-24582.0,48554.0,,,487570.0,403239.0,,1469.0,,,107986.0,,67681558.0,953565.0,14204.0,,,,,,23034.0,,,2708995.0,379498.0,,,,260018.0,,,,,81347935.0,,,,,,,340669814.0,,676836.0,18475559.0,-4761175.0,,2603.0,48.99,,,,62.06,,,54864985.0,,,,,,,,,2099376.0,,,,,401170.0,,,,,883702.0,52105086.0,12398866.0,29501174.0,51.0,,,,,335702,,,,,,1659802.0,,,,,64.79,,23748673.0,5022494.0,159007.0,47892402.0,,74988832.0,,,,,19027175.0,50134150.0,938274.0,,,,,535992.0,,86932499.0,,,,,17471.0,,,,,92.0,,O,,-102023.0,,,,505521033.0,,,,28923557.0,,593239.0,,,,,,3456174.0,,17109.0,,-62660968.0,,34366.0,624970.0,,,,13268.0,-24697886.0,,,,,,,35004,6815721.0,,,,,,,6009.0,,,Y,,,,,,,,,59396183.0,,,,,283484.0,,26.25,,19972.0,,27.19,,,,16048783.0,,,,617641.0,147829.0,,31906062.0,35955.0,,,-34008496.0,13570523.0,7580.0,,,8075584.0,393907478.0,,3415821.0,27915413.0,,,,,,,,5821.0,,,319578945.0,400025.0,,,,,,,27526267.0,,,,5475.0,523.0,,,77569.0,231588.0,,918270.0,252309.0,10089622.0,-130526381.0,,,,,,,1866262.0,,,1003141.0,13815384.0,,10545105.0,,46441.0,310.0,4924.0,,536936.0,953.0,87264.0,455585.0,,12593.0,7073504.0,,75920.0,29503324.0,,,47502742.0,,36918610.0,,23218816.0,84191275.0,,7182008.0,-1708712.0,,,,,,364788.0,1328054.0,,13011437.0,,4699.0,,,,,988397.0,,,,-1147221973.0,,69272.0,,12794388.0,,28487816.0,,,2582509.0,,,,1529395490.0,,46245.0,176933.0,,2433109.0,N,551285.0,,,2331947.0,,,15072022.0,5380,598690.0,,5821.0,,,34411527.0,1491853.0,,8778191.0,,223015.0,,68738073.0,24421554.0,-3993932.0,,,2102178.0,161839.0,,,169729379.0,,9835846.0,468087.0,,,,22942.0,26763.0,9380206.0,,155065.0,,,,,15240731.0,,,,,,921145.0,,,228.0,297213826.0,,,,,5022494.0,,,19027175.0,,,91018724.0,-12817350.0,,,,,,,,,,1843029.0,,,,,,,,18444031.0,,79399.0,,,251660.0,,,60569605.0,13570523.0,,,24897461.0,1578144548.0,412446.0,,,,,,,,11372524.0,816147.0,465669.0,,3243791.0,NY,,9595.0,,157227.0,158262.0,,,,,295767.0,769270.0,,72.0,,11139074.0,251660.0,25052115.0,,,65635029.0,,1192.0,,1329738.0,564487.0,,,40.0,347.61,68778790.0,,,20.0,,41800.0,,,140024028.0,,,12843.0,,,,,,,620561.0,,,1404472.0,7453000.0,,,,,,3700200.0,,15353879.0,28.75,78630.0,,,2028671.0,44386490.0,,,,49620476.0,,,533.84,,35697.0,1861.0,,,,,,3480990.0,,161839.0,72321673.0,,,,,,11922863.0,43192878.0,48392208.0,,295767.0,,,,23295.0,,,,,,,,,,,,390291.0,,30799405.0,,,,460195.0,14600.0,,,90355.0,,27873878.0,379498.0,129568.0,38829539.0,134589.0,,57709554.0,,77345840.0,,,,,231588.0,,,,639.0,,,,,,,,22365119.0,4905023.0,79825.0,,54143.0,,10423.0,2189723.0,2053437.0,39890163.0,,63487.0,68391772.0,,,,2.0,,5255296.0,3747.0,,340669814.0,8828982.0,484776.0,1504112150.0,,1278316.0,,147829.0,5238424.0,7541262.0,,,48609797.0,,,,,,,,,,,,,,35400362.0,,,,4233001.0,,460930.0,14171175.0,,,7930248.0,,52185454.0,137129760.0,,11480306.0,3445296.0,,,,4126625.0,,91470639.0,272726749.0,,,,,,,251660.0,407526.0,4430990.0,,1469.0,,,,NSUH PSYCHIATRIC EXEMPT UNIT,,,403154.0,2595366.0,41621.0,,374590.0,7541262.0,13001,21844285.0,,,23034.0,,10878.0,,,,,,,,275174.0,,,N,41.16,6719287.0,,,20009441.0,,19296.0,2252309.0,,,1333702136.0,399450.0,,,17073568.0,,2844261.0,1219961.0,,F,84.56,47892402.0,40204.0,,,83706.0,2530906.0,,,15.0,,,,,,87982419.0,,,,,,,-11237975.0,234851.0,168796894.0,,,,15071671.0,18398.0,13055233.0,11922863.0,,5936.0,81.0,,,11139074.0,,,,,159172.0,7357474.0,,,,,23795651.0,17012396.0,,,,,,,,,233050.0,81894676.0,34954677.0,,181161891.0,4529793.0,,17625530.0,22411.0,559146453.0,2301.0,,,9185.0,16245600.0,15126820.0,,,8121203.0,,,,,,,,,24510709.0,94512135.0,,,10930003.0,,-413942556.0,84998055.0,28984259.0,7251041.0,57709554.0,,,15573.0,8288860.0,,,,11156323.0,,,,,252821.0,,,18277225.0,,,,,773193.0,,65442549.0,,,,,445467.0,,,,271254.0,,,,,2351608.0,611.0,,,,,46441.0,,,,,,,,60235669.0,,,,12988.3,,,,44.26,,24650830.0,,,,5030832.0,2571261.0,71886959.0,25318646.0,,53299055.0,33S106,,,298.0,,,,,,68391772.0,,,245428.0,,,,,6648.0,,81393403.0,,81850687.0,,2189306.0,,,13312461.0,-3522689.0,11606.0,4652449.0,,5936.0,,,,,,19940657.0,,,,,65068982.0,,,43.86,,2428240.0,93191785.0,18615.0,,30552349.0,,,,,,,,,,,62985.0,,,532214.0,,,,5846766.0,,,,755816403.0,,,3273901.0,,16048783.0,,481726.0,12843.0,,,1480961026.0,,,59737644.0,35.0,0.184073,411.0,,,,,108072347.0,234851.0,588580.0,145963772.0,,4629148.0,,,,,8534.0,49090.0,,121.0,,366397.0,,,,234266908.0,,,,9546040.0,,,,39529405.0,76382998.0,14333.0,,,29252.0,,,,,7914959.0,976875.0,,,,93034.0,169378698.0,,12864.0,-2735226.0,,,,,,,,,,24897461.0,2539875.0,,10030,27915413.0,,,,,611.0,42685352.0,N,3878714.0,,,,,,,,,,,,43453366.0,967016565.0,-1147221973.0,19159480.0,4699.0,3516170.0,816147.0,,,26465013.0,18277225.0,754285.0,,115238231.0,,,2053780.0,,,,359793.0,,39.71,,,,,310.0,4932012.0,,,,,,,,18529.0,,7940095.0,,,,334792794.0,,,,13064544.0,,,972 BRUSH HOLLOW RD,160560499.0,3015167.0,31991.0,298244.0,,,,274.0,,15126820.0,,2.0,303115.0,,,,406858.0,,,,,2553541.0,,,-709832163.0,169378698.0,,,,,,330195.0,11130.0,,4081476.0,,6415.0,,,,,,9714767.0,,55044884.0,,1491357.0,,,13078590.0,,,50886614.0,,,,65154495.0,930371.0,474394.0,,,,51645.0,,17625530.0,,,,1381965.0,254407414.0,,,,3747.0,,,3562694.0,,830871.0,28122333.0,4430990.0,,5484756.0,,,,,19110903.0,,,,,,,279256.0,,,,980339.0,2801723.0,,,,,,,,,,,-12588.0,,,,,61.9,,5813981.0,,74963621.0,,,,27526267.0,,3012.0,,25424695.0,,662.0,,4948525.0,,171070906.0,,,,4164611.0,84.5,161071802.0,,6854721.0,27991137.0,,42685352.0,,154556901.0,618097016.0,25211.0,,,129353084.0,347.61,,117847003.0,,,,65.0,108072347.0,15072022.0,1614487.0,97307646.0,,163031.0,,,,,,,,,NORTH SHORE UNIVERSITY HOSPITAL,,,3445296.0,,2019-12-31,,301923136.0,,,,,,7300.0,,,,,-2741025.0,,,,,,,,,67681558.0,6617450.0,12292450.0,,136706302.0,24091975.0,,2537546.0,,,,993712025.0,,,,,-1537912.0,,,439.0,,,,49620476.0,,375110849.0,802.0,,293459350.0,2751989.0,,60595645.0,,,,2524812426.0,,,,,,17145084.0,,,,,15126820.0,27915413.0,,,17146370.0,-4038716.0,,11196822.0,58525788.0,,3790.0,397.0,,354472.0,,111126.0,1375974.0,,,,1959807.0,,,231049926.0,,,72471192.0,514408.0,,5,4188695.0,,,,,1984195.0,,339948194.0,-12588.0,2346620.0,,,,,433.0,,22269982.0,15291615.0,976875.0,,,,,,17625530.0,,,,,1218.0,,,11929880.0,,2017613.0,,,,,,20463.0,,15114724.0,,6702.0,2019-01-01 00:00:00,46.07,,,Y,11372524.0,,149486336.0,1682.0,490162.0,16514.0,,12298752.0,,,,,,,,470122.0,,,,298244.0,15669679.0,,,,76035.0,19688046.0,9711967.0,2259529.0,12864.0,-14108493.0,7541262.0,,,,,,56008067.0,,,,,,46.32,,1130438.0,,,,,130840809.0,936655.0,7149850.0,23354.0,,04/04/2008,,,,1616593.0,,5238424.0,284836.0,,105366.0,,,,,,340669814.0,,,,,19076692.0,11590,,,,,,-2469365.0,4759.0,,,,97015553.0,,,,,,6865713.0,1620660.0,721587.0,,935512.0,,,,,218851.0,NASSAU,,2805624.0,,60261.0,,1699368.0,,,11156912.0,,,,702922.0,,,,,,,,,3346988.0,-2741025.0,,67234099.0,,,13652479.0,,93581764.0,,,831193101.0,40994.0,,1049021.0,,,2428240.0,,,71053372.0,-7968747.0,,,,,,58512562.0,6415.0,,,22000449.0,,,,,-753890.0,,,,1359541.0,,,,12398866.0,,,,52185454.0,13226.0,,115238231.0,,136995892.0,281657.0,,,,83.59,,4699.0,7462718.0,,79825.0,,6719287.0,,,,,,,,,117847003.0,1495166042.0,Y,,,,,1936247.0,54931591.0,3964918.0,1867212.0,,,,,294946175.0,24421554.0,3700200.0,,101226.0,,7889173.0,122005.0,,,,-30009.0,8171273716.0,71278040.0,,,,,122112.0,779357.0,,,,,,187175.0,,,,,,2759134.0,63394158.0,,8075584.0,,33400,P,,,,,,,1186797.0,,1653054.0,,18529.0,,,,,,,,,,13257194.0,,,2022-10-07 00:00:00,,,,12701002.0,337148,27.44,91470639.0,4455658.0,,,,95723004.0,147630005.0,,,,,,,,,,,8778191.0,,,,,1550874.0,,,69.27,,,,,1522934.0,,,,1404472.0,,,,396830498.0,13652479.0,69773192.0,,,,,,117284809.0,13078590.0,,2130412.0,-12298839.0,,137129760.0,,,,558101.0,9247819.0,540475.0,,13312461.0,12949370.0,,12235982.0,,,,,,1861.0,17559745.0,8166.0,,,,683937.0,,1462.0,,,,,3449538.0,,33.66,,Y,1130438.0,,,,,38731956.0,3503115.0,,,,,,30552349.0,,,,,225085579.0,,,,57148.0,,,,,,,44148.0,N,,,,,24421554.0,56.57,315829.0,,19303.0,Y,General Short Term,15117705.0,,,Y,,2844261.0,,,,,,2019,Acute Care Hospitals,NORTH SHORE UNIVERSITY HOSPITAL (330106)
64047,NORTH SHORE UNIVERSITY HOSPITAL (330106),General Short Term (Acute Care Hospitals),Voluntary Nonprofit-Other,-73.703029,40.779269,,,,,263550.0,11475.0,3418374.0,,,,,,,4214271.0,82066.0,,38276362.0,,,,,3364.0,,,,,1102346910.0,,,13002552.0,125565779.0,,5160314337.0,,,Y,,805435.0,,,24019275.0,142193213.0,7372107.0,,223.31,,,2177.0,123650453.0,147484.0,,,,3523859.0,,28241.0,,143928853.0,1295928.0,,,,518768757.0,,22242300.0,,137855.0,3963302.0,,,,1586275.0,1.0,18789734.0,,,,29687056.0,,,,18597980.0,,15896434.0,,4238609.0,,12832318.0,,175890.0,,1241.0,1287.0,,,,,,,2686722.0,,1598429281.0,,23482134.0,3071944.0,,28241.0,,1621789.0,,20211.0,41.0,,,,1141.0,-10041974.0,256151797.0,,,38276362.0,,,,,15880.0,,,,,3578095.0,,,750852.0,,,14074.0,,1621789.0,,17887671.0,,,,,,,,,50081.0,,,,,977679.0,,,,NY,396039487.0,,,,1004355.0,,51.0,638501.0,,1847555.0,,141935106.0,,,,209972.37,41.56,,,N,,782.0,66.21,1839762.0,,27176551.0,,,590.0,187456.0,,,,,,,,,,,,56913.0,,33,,,,1290.0,16424704.0,8940132.0,,,145431.0,,6399960.0,,,,6390744.0,,8829099.0,,5877683.0,8629232.0,,478272.0,63389.0,,22360599.0,,2354338.0,,4238609.0,,,1441122.0,,MANHASSET,,,,5963009.0,36700138.0,,927821.0,,,,1069934.0,,,,,,,,40444783.0,,,105450439.0,,516259.97,,32728.0,,24.1,,,9988024.0,8749020.0,54090364.0,,,,,,,,,2181486.0,,,1.0,,22248.0,6019454.0,,,418624.0,,,185.7,,3120981.0,35963878.0,,,,,,N,30137.75,,286212.0,726019.0,46.0,16425745.0,,75.57,,15820390.0,,7563749.0,3080325.0,,,21453455.0,,,,9373227.0,,50968509.0,-6505092.0,313591.0,,,,,,24399062.0,21453455.0,,,,,25803164.0,,14452188.0,-316020.0,,,,8914050.0,2289792.0,7800758.0,,,,2289589.0,,,,1938968861.0,,,,,,,293706146.0,,,312774.0,,,,,,,396039487.0,,,20386.0,,247800471.0,,,39809621.0,,35963878.0,,,31110999.0,12485.0,62.44,21453455.0,3081.0,,,10903953.0,15923.0,,,12533.0,8238643.0,32731713.0,,N,,2375768.0,19637076.0,,,64683.0,3587227.0,,503.0,566.0,,,,73955058.0,386940.0,,,,,752495.0,,,,,,,,17706244.0,121249972.0,638501.0,,,,,909822.0,,,,,15333.0,,,-177028103.0,,,,330106,,,,13151288.0,27089.0,,,,,,1635584464.0,,267644590.0,,1529785.0,,,149720854.0,,,,9600678.0,,324284897.0,141765.0,,,417892.58,18691696.0,,,,32.9,255287899.0,,13409.0,,,,5627674.0,,41976170.0,19470153.0,,,,,,5409556.0,376070.0,,,9254.0,,1477604.0,1169321.0,,,,,16381304.0,,2626100.0,73990.0,6822.0,,,,,,,,40297032.0,183271341.0,-144.0,02/21/2019,342489.0,1389311.0,734003.0,5867153.0,,,,,,,,20386.0,388610.0,8.0,,475745.0,WESTBURY,,,,,,3914580.0,17706244.0,579483976.0,2751013.0,126057498.0,,N,,,27461266.0,53134105.0,,,,,,206623437.0,,,44061527.0,2125436.0,1236.0,,,-79499.0,18789734.0,,,,,30251449.0,,,2778369.0,783117.0,,,337800.0,7317684.0,,,,10364656.0,122576604.0,,,15630078.0,,,-8305903.0,,,,,,,,,,,13684265.0,,,,56502.0,,2366421.0,,,1180167.0,-2919557.0,56913.0,,54839138.0,,,,,,,56.77,,,,,,,,,,,,36050203.0,,,,,,-4791573.0,1389420.0,173752.0,312610438.0,12258038.0,438.0,,,,118061404.0,,,,90932611.0,,55502321.0,,185051564.0,,225600.0,,,1247790.0,51499676.0,4383298.0,,,,300 COMMUNITY DRIVE,35390381.0,,4482309.0,,,,,,,,7474485.0,,18597980.0,,1389065.0,12233.0,,,456149.0,,10210673.0,588205.0,,572035.0,,,26996588.0,,,3993922.0,174542.0,,,2354338.0,,,,,,,3175373.97,,5050741.0,3574994.0,908383850.0,2725539.0,,,10922663.0,6846241.0,,,,27837042.0,25054732.0,,223626.0,,122576604.0,,73955058.0,,,1065280.0,5166699.0,,,,,52098345.0,,5871557.0,,,,778056844.0,,,13573089.0,6641617.0,,31426.0,15296400.0,1781134196.0,2765216.0,,1968373.0,,688162.0,6204940.0,,,12933933.0,,,909822.0,,55.76,,,5134601.0,906061997.0,,NORTHWELL HEALTHCARE INC,14683768.0,,,74527093.0,82203389.0,3388523.0,,829456.0,706901.0,,,7839336.0,,,,,12398.0,-15832029.0,,,2829886.0,162130235.0,,45455101.0,70759480.0,,,,,437131.0,,,,1635.0,,263360.62,,60686579.0,69033557.0,,55681494.0,73990.0,,51319645.0,Y,-403006897.0,,,,,,47761824.0,4521745.0,,4083763.0,1809486.0,,3387800.0,200696.0,,,766434780.0,,,,-2511588.0,,,25919894.0,,,,12034.0,,1236.0,,,343850.0,1847555.0,,,,,,88157682.0,,,,,,,,,4602774.0,,,-66423444.0,,12776.0,,,,,55343664.0,14884594.0,48500716.0,,742981,,,,,,79494718.0,16425745.0,2898752.0,,,,,,-14445.0,,3064625.0,42777.0,,32914981.0,,,,,12034.0,292280.0,457886.0,50968509.0,1185.0,,26519752.0,,11931675.0,44061527.0,,99051.0,,,24785256.0,,147975.0,,HB2348,,,210807841.0,-20272.0,111100.0,,,106960.0,292149.0,,697.0,,,5550.0,,58187267.0,9996984.0,11928.0,,,,,1.0,1215.0,,,3080434.0,258500.0,,,,105250.0,,,,,73078146.0,,,,,,,324424732.0,,666028.0,22558310.0,-14426933.0,,3413.0,54.79,,,,61.97,,,56396341.0,,,,,,,,,172764139.0,,,,,236027.0,,,1102.0,,532066.0,48952555.0,9119111.0,44800766.0,51.0,,,,,335702,,,,,,1597464.0,,,,,61.61,,30130306.0,4768246.0,160515.0,37408904.0,,79151442.0,,510.53,,,13070885.0,34785845.0,945114.0,,,,,373190.0,,70759480.0,,,,,10867.0,,,,,35.0,,P,,-102023.0,,,,552604379.0,,,,91979702.0,,2898752.0,,,,,,3008779.0,,3509.0,,-70660971.0,,13443.0,658429.0,,,,7666.0,-36898861.0,,,,,,,35004,6465805.0,,,,,,,4637.0,,,Y,,,,,,,,,52098461.0,,,,,230307.0,,27.52,,17134.0,,27.89,,,,14131885.0,,,,558743.0,86248.0,,33938681.0,28537.0,,,-72478456.0,14884594.0,3166.0,,,8376735.0,335893482.0,,17246104.0,28836001.0,,,,,,,,5047.0,,,300615664.0,337800.0,,,,,,,28200005.0,,,,5490.0,211.0,,,63583.0,202537.0,,,254256.0,9552722.0,-179932446.0,,,,,,,2310632.0,,,1493892.0,14564642.03,,4550265.0,,39927.0,289.0,2132.0,,331285.0,562.0,,326482.0,,12593.0,4817871.0,,72592.0,28558140.0,,,36700138.0,,28906750.0,,29830894.0,97266771.0,,9217571.0,-1876961.0,,,,,,2686722.0,1817772.0,,11687546.0,,4889.0,,,,,339833.0,,,,-1145438136.0,,22539.0,,8898360.0,,80701778.0,,,2339727.0,,,,1636832254.0,,48179.0,184768.0,,1813038.0,N,577567.57,,,2025997.0,,,16381304.0,5380,652525.0,,5047.0,,,31205204.0,877354.0,,7728197.0,,223626.0,,82906281.0,25744742.0,-6277789.0,,,2311506.0,242645.0,,,139767652.0,,15911308.0,258289.0,,,,10298.0,54986.0,6779276.0,,156663.0,,,,,12883432.0,,,,,,665387.0,,,2184.0,286036383.0,,,,,4768246.0,,,13070885.0,447.0,,71743290.0,,,,,,,,,,,1787970.0,,,,,,,,18426578.0,,46491.0,,,146812.0,,,40444783.0,14870550.0,,,22224321.0,1703429246.0,328684.0,,,,,,,,8914050.0,478272.0,497894.4,,2943799.0,NY,,9254.0,,140581.0,124346.0,,,,,328406.0,770060.0,,32.0,,8792194.0,146812.0,45956070.0,,,67934362.0,,531.0,,1316032.0,331460.0,,,40.0,867.92,74764926.0,,,20.0,,8352.0,,,198894841.0,,,9690.0,,,,,,,365961.0,,,1529785.0,9658842.0,,,,,,2430600.0,,16209635.0,30.19,61308.0,,,3763302.0,18397148.0,,,,52039761.0,,,487.1,,35374.0,1554.0,,,,,,2049145.0,,242645.0,73735955.0,,,,,,10943131.0,35390381.0,55037994.0,1.0,328406.0,,,,83440.0,,,,,,,,,,,,394225.0,,43058990.0,,,,459121.0,14640.0,,,22141.0,,17280466.0,258500.0,75450.0,38824898.0,75924.0,,44100146.0,,,,,,,202537.0,,,,303.0,,,,,2928.0,,,14579281.0,3552964.0,78900.0,,51354.0,,,1289805.0,2448487.0,32688687.0,,27697.0,52937644.0,,,,2.0,,5502638.0,3601.0,,324424732.0,9228035.0,389086.0,1623466213.0,,1207336.0,,86248.0,4154737.0,5877683.0,,,60098332.0,,,,146.0,,,,,,,,151446.0,,26519752.0,,,,3064625.0,,704149.0,9988024.0,,,7317684.0,,55502321.0,169568777.0,,11448347.0,4305199.0,,,,2429411.0,,75697093.0,137890161.0,,,,,,,146812.0,431354.0,4926746.0,,697.0,,,,NSUH PSYCHIATRIC EXEMPT UNIT,,,497053.77,2617041.0,19611.0,,293555.0,5877683.0,13001,34822388.0,,,1215.0,,19845.0,,,,,,,,333143.0,,,N,35.28,8101471.0,,,23602291.0,,19296.0,2636546.0,,,1328143051.0,274767.0,,,15896434.0,,2955995.0,999141.0,,F,70.42,37408904.0,64683.0,,,71282.0,4061362.0,,,15.0,,,,,,69033557.0,,,,,,,-18393805.0,190012.0,170772586.0,,,,15485615.0,17978.0,11065474.0,10943131.0,,1773.0,-116.0,,,8792194.0,,,,,91230.0,7814144.0,,,,,24019275.0,101398757.0,,,,,,,,,203319.0,82016257.0,83974100.0,,283626483.0,5372855.2,,13901266.0,23790.0,579483976.0,2301.0,,,2542.0,15630078.0,15038055.0,,,7807319.0,,,,,,,,,25599082.0,74527093.0,,,10331940.0,,-402857544.0,97608951.0,108397764.0,7531664.0,59932175.0,,,12533.0,7170551.0,,,,12194670.0,,,,,149007.0,,,12336355.0,,,,,670610.0,,55154185.0,,,,,63389.0,,,,170368.0,,,,,2425512.0,611.0,,,,,39927.0,,,,,,,,60686579.0,,,,13263.1,,,,46.45,,27418987.0,,,,4159815.0,3717712.0,48723671.0,24138460.0,,45611953.0,33S106,-7659196.0,,247.0,,,,,,52937644.0,,,141402.0,,,676.0,,50053.0,,68084619.0,,158077637.0,,2207406.0,,,12050453.0,-2919557.0,12818.0,4866676.0,,1773.0,,,,,,23529009.0,,,,,60884230.0,,,45.07,,829982.0,71765814.0,18666.0,,24406991.0,,,,,,2371.0,,,,,58924.08,,,536763.0,,,,3664032.0,,,,778056844.0,,,3086917.0,,14131885.0,,553375.0,9690.0,,,1598429282.0,,,47171020.0,40.0,0.220856,319.0,,,,,77144921.0,190012.0,351478.0,149720854.0,,58341179.0,,,,,12485.0,21322.0,,1062.0,,645585.0,,,,191333713.0,,,,7276423.0,,,,43406163.0,155760328.0,11248.0,,,16689.0,,,,,57728061.0,886457.0,,,,73990.0,164836719.0,,19296.0,-2928925.0,,,,,,,,,,22224321.0,2272200.0,,10030,26514147.0,,,,,611.0,49267117.0,N,2289792.0,,,,,,,,,,,,32368113.0,1100722727.0,-1145438136.0,18691696.0,357.0,3024659.0,478272.0,,,27837042.0,12336355.0,443445.0,,85502120.0,,,1839762.0,,,,134750.0,,40.86,,,,,289.0,6776692.0,,,,,,,,18378.0,,8557738.0,,,,82219467.0,,,,13151288.0,,,972 BRUSH HOLLOW RD,123242113.0,2793443.0,56502.0,329888.0,,,,46.0,,15038055.0,,2.0,205097.0,,,,476887.0,,,,,2457637.0,,,-724984528.0,164836719.0,,,,,,254530.0,6323.0,,4238609.0,,5385.0,,,,,,9321543.0,,67896340.0,,1088643.0,,,15020137.0,,,45449345.0,,,,54973973.0,572035.0,477693.0,,,,54853.25,,13901266.0,,,,1189027.0,267644590.0,,,,3601.0,,,3418374.0,,527039.0,11888541.0,4926746.0,,3229281.0,,,,,13684265.0,,,,,,,370896.0,,,,898794.0,2659114.0,,,,,,,,,,,1.0,,,,,61.82,,10210673.0,,79118714.0,,,,28200005.0,,3071.0,,27238634.0,,566.0,,6404978.0,,177953682.0,,,,5140891.0,81.36,172864273.0,,6189263.0,28117466.0,,49267117.0,,156828416.0,758551044.0,32728.0,,,105450439.0,357.39,,98258103.0,,,,65.0,77144921.0,16381304.0,1203551.0,99632535.0,,115468.0,,,,,,,,,NORTH SHORE UNIVERSITY HOSPITAL,,,4305199.0,,2020-12-31,,301049053.0,,,,,,7320.0,,,,,-3359570.0,,,,,300.0,,,,58187267.0,7122843.0,13362019.03,,169153234.0,24150819.0,,2559255.0,,,,1108606463.0,,,,,-1729919.0,,,439.0,,,,52039761.0,,311910795.0,802.0,,248954738.0,1656882.0,,60681154.0,,,,2190471346.0,,,,,,18767531.0,,,,,15038055.0,26514147.0,,,11296666.0,-4121737.0,,11218040.0,51574962.0,,3081.0,977.0,,257982.0,,694665.0,1481242.0,,,,1295928.0,,,227370626.0,,,55681494.0,1458446.0,,5,4829930.0,,,,,1265822.0,,282182035.0,,-1285370.0,,,,,119.0,,12457778.0,9761410.0,886457.0,,,,,,13901266.0,,,,,1287.0,,,12543431.0,,2684141.0,,,,,,9616.0,,15485615.0,,10270.0,2020-01-01 00:00:00,39.18,,,Y,8914050.0,,147510953.0,3220.0,2981731.0,29006.0,,9913423.0,,,,,,,,290479.0,,,,329888.0,16537393.0,,,,91235.09,30482604.0,9469375.0,1697516.0,19296.0,-18382732.0,5877683.0,,,,,,54929622.0,,,,,,47.41,,1341670.0,,,,,127664002.0,680615.0,7563749.0,16884.0,44.0,04/04/2008,,,,2402099.0,,4154737.0,255945.0,,85551.0,,,,,,324424732.0,,,,,24339781.0,11590,,,,,,-4096754.0,3416.0,,,,90932611.0,,,,,,4482309.0,1882649.0,3186598.0,,3261627.0,,,,,151446.0,NASSAU,,2828921.0,,94450.0,,2290424.0,,,8969013.0,,,,705755.0,,,,,,,,,3955410.0,-3359570.0,,51319645.0,,,15140869.0,,73955058.0,,,682790867.0,,,4849858.0,,,829982.0,,,52558714.0,-9227241.0,,,,,17647.0,51566279.0,5385.0,,,23482134.0,,,,,-2013844.0,,,,818563.0,,,,9119111.0,,,,55502321.0,8683.0,,85502120.0,,141949070.0,239632.0,,,,90.47,,4889.0,8673444.0,,78900.0,,8087397.0,,,,,,,,,98258103.0,1598429281.0,Y,,,,,1847555.0,56481104.0,5610857.0,909822.0,,,,,319951196.0,25744742.0,2430600.0,,296461.0,,12722905.0,70700.0,,,,,7350785683.0,58275634.0,,,,,84141.0,2767955.0,,,,,,137855.0,,,,,,2777824.0,81088518.0,,8376735.0,,33400,P,,,,,,,698545.0,,1621789.0,,18378.0,,393305.0,,,,,,,,,,,2023-05-24 00:00:00,,,,8094506.0,337148,26.04,75697093.0,4610110.0,,,,73955058.0,123650453.0,,,,,,,,,,,7728197.0,,,,,1130642.0,,,62.2,,,,,1202623.0,,,,1529785.0,,,,316867648.0,15140869.0,57585341.0,,,,,,120495615.0,15020137.0,,1921170.0,-6901958.0,,169568777.0,,,,138265.0,5446505.0,337585.0,,12050453.0,14240043.0,,9597814.0,,,,,,1554.0,18496339.0,7136.0,,,,769709.0,,782.0,,,,,3478686.0,,29.92,,Y,1341670.0,,,,,10611159.0,3578095.0,676.0,,,,,24406991.0,,,,300.0,247800471.0,,,,52578.0,,,,,,,40988.72,N,,,,,25744742.0,54.66,303149.0,,16819.0,Y,General Short Term,9114589.0,,,Y,,2955995.0,,,,,,2020,Acute Care Hospitals,NORTH SHORE UNIVERSITY HOSPITAL (330106)
69946,NORTH SHORE UNIVERSITY HOSPITAL (330106),General Short Term (Acute Care Hospitals),Voluntary Nonprofit-Other,-73.703029,40.779269,,,,,155275.0,9977.0,3317792.0,,,,,,,3904195.0,,,42109198.0,,,,,,,,,,1297566201.0,,,12908000.0,132873308.0,,6076516108.0,,,Y,,817482.0,,,21932501.0,213629351.0,5304182.0,,214.54,,,1568.0,142596947.0,110565.0,,,,31235757.0,,30443.0,,160219315.0,634068.0,,,,632891579.0,,32082276.0,,,4450828.0,,,,1600474.0,1.0,20454912.0,,,,106293150.0,,,,21088210.0,,16120404.0,,3615910.0,,17441626.0,,145568.83,,,1307.0,,,,,,,19495.0,,1703915688.0,,21894321.0,3231237.0,,30177.0,,1384546.0,,214021.0,,,,,674.0,-3507805.0,318913044.0,,,42109198.0,,,,,105311.0,,,4961.0,,3709666.0,,,870621.0,,,509.0,,1384546.0,,20613445.0,,,,-14757.0,,,,710640.0,34700.0,,,,,1623995.0,,,,NY,502205446.0,,,,1110311.0,,51.0,678044.0,,1918196.0,,179854904.0,,,,390621.55,37.38,,,N,,782.0,43.3,1990338.0,-19264004.0,38767602.0,,,,358083.0,,,,,,494626.0,,,,,,269665.0,,33,,,,,16254664.0,9536739.0,,,170525.0,,5897937.0,,,,7825993.0,,3074752.0,,,12143510.0,,946751.0,179395.0,,21596190.0,,2273239.0,,3615910.0,,,1281005.0,,MANHASSET,,,,7635011.0,80763419.0,,930646.0,,,,963912.0,,,,,,,,45685062.0,,,120450821.0,,505805.62,,41073.0,,24.84,,,10452417.0,10841210.0,72175423.0,,,,,,,,,3444193.0,,,1.0,,92740.0,6763522.0,,,291479.0,,,273.41,,4859545.0,48062169.0,,,,,,N,10939.0,,285430.0,1236510.0,266.0,20292347.0,,71.06,,15359246.0,,10961657.0,2479340.0,,,18905431.0,,,,10013173.0,,55320230.0,-1136736.0,878160.0,,,,,,20146295.0,18905431.0,,,,,25167244.0,,17755532.0,-72649.0,,,,12076493.0,3031860.0,9392329.0,,494626.0,,1699425.0,,,,2329593187.0,,,,,,,366692847.0,,,94063.0,,,,,,,502205446.0,,,14701.0,,349572662.0,,,43704785.0,,48062169.0,,,38063427.0,14451.0,64.03,18905431.0,4869.0,,,8559974.0,,,,10712.0,8819981.0,31549544.0,,N,,2800704.0,7424740.0,,,28940.0,3557500.0,,1187.0,545.0,,,,74177791.0,1221440.0,,,,,523968.0,,,,,,,,20018352.0,140687011.0,678044.0,-1990466.0,,,,355451.0,8919.0,,,,12302.0,,,-158777514.0,,,,330106,,40907328.0,,14478323.0,,,,,,,1610498051.0,,373182801.0,,1574530.0,,,151852218.0,,,,14171307.0,,326064181.0,264752.0,,,410185.69,18567599.0,,,,33.87,279570093.0,,13029.0,,,,4866596.0,,45441899.0,16805787.0,,,,,,8761818.0,822136.0,,,8060.0,,1832522.0,1863898.0,,,,,16931049.0,,3096735.0,83166.0,,,,,,,,,32551931.0,169179064.0,-9252.0,02/21/2019,246901.0,1935313.0,2323903.0,4082438.0,,,,,,,,14701.0,458371.0,9.0,,,WESTBURY,,,-44710.0,,,4202526.0,20018352.0,335827475.0,2667210.0,120394843.0,,N,,,36132040.0,57830975.0,,,,,,201632742.0,,,48006417.0,2672469.0,399.0,,,-35563.0,20454912.0,,,,,33852566.0,,,2663249.0,3510881.0,,,717600.0,7195580.0,,,,9140621.0,50437595.0,,,15947817.0,,,-9973222.0,,,,,,,,,,,19783629.0,,,,17739.0,,,,,658135.0,-2822891.0,269665.0,,50183462.0,,,,,,,53.51,,,,,,,,,,,,47826040.0,,,,,,-3757931.0,966391.0,1012231.0,349329661.0,10019186.0,,,,,120456803.0,,-336.0,,61067752.0,,47256359.0,,227736416.0,,214458.0,,,1164506.0,65612388.0,262032.0,,,,300 COMMUNITY DRIVE,42117149.0,,3994311.0,,,,,,,,5964892.0,,21088210.0,,1250686.0,29470.0,,,887171.0,,3691547.0,1068372.0,,2536246.0,,,26052692.0,430.12,,4956118.0,350197.0,,,2273239.0,,,,,,,2764603.96,,4434141.0,3528030.0,1273072446.0,4250337.0,,,10998344.0,6846241.0,,,,41374257.0,6919757.0,,223015.0,,50437595.0,,74177791.0,,,822815.0,5689825.0,,,,,67272328.0,,5410099.0,,,,793587688.0,,,14954529.0,6136916.0,,24542.0,21764400.0,1766595583.0,2855529.0,,3129128.0,,763876.0,6188557.0,,,12022067.0,,,355451.0,,57.23,,,8023022.0,1244113707.0,,NORTHWELL HEALTHCARE INC,15258874.0,,,76714037.0,61696251.0,3769054.0,,683432.0,1129692.0,,,11952215.0,,,,,-1296.0,,,,5396693.0,153792795.0,,54625022.0,86086615.0,,,,,249640.0,,,,,,266646.2,,42011540.0,93143688.0,,74668378.0,83166.0,,62394664.0,Y,-461660749.0,,,,,,56135013.0,,,3885708.0,3507000.0,,5056636.0,,,,1140218163.0,,,,-1998678.0,,,26601147.0,,,,13207.0,,,,,,1918196.0,,,,,,92483804.0,,,,,,,,,5769619.0,,,-294073820.0,,12555.43,,,,,104619277.0,14097883.0,53496476.0,,742148,,,,,,63623403.0,20292347.0,2875638.0,,,,,,-101617.0,,3482280.0,41685.0,,36647829.0,,,,,13207.0,329646.0,932050.0,55320230.0,396.0,,20310010.0,,9892117.0,48006417.0,,114652.0,,,25845883.0,,1661561.0,,HB2348,,,251678178.0,-5778.0,71780.0,,,-1407.0,626004.0,,,,,,-192194214.0,65553645.0,309955.0,,,,,,,151035.0,,,3149856.0,350383.0,,,,,,,,,36593993.0,,,,,,,326265525.0,,814616.0,25332505.0,-17791601.0,,11212.0,53.14,,,,62.24,,,54396849.0,,,,,,,,,188408281.0,,,,,278297.0,,,4068.0,,231726.0,34473881.0,10018646.0,36882144.0,3.0,,,,,335702,,,,,,883144.0,,,,,63.45,,29024403.0,4760736.0,111907.0,43977799.0,,91396486.0,-30750.0,,,,16005395.0,24876040.0,658430.0,,,,,135959.0,,86086615.0,,,,,27597.0,,,,,,,P,,-102023.0,,,,573067243.0,,,,88507485.0,,2875638.0,,,,,,2853314.0,,2100.0,,-81311785.0,,,752928.0,,,,,-45151864.0,,,,,,,35004,7657059.0,,,,,,,3535.0,,,Y,,,,,,,,,67272542.0,,,,,306092.0,,28.23,,19283.0,,28.59,,,,12169287.0,,,,596967.0,95588.0,,36202238.0,23085.0,-2958457.0,,-54816524.0,14097883.0,,,,8262937.0,373054351.0,,17178848.0,29271247.0,,,,,,,,3758.0,,,303994494.0,717600.0,,,,,,,28877509.0,,,,5475.0,964.0,,,118294.0,224457.0,,,176969.0,12192434.0,-190592596.0,,,,,,,,,,1343215.0,21877863.28,,2186090.0,,44467.0,,,,678077.0,670.0,71522.0,720097.0,,10340.0,8074885.0,,73934.0,29329707.0,,,80763419.0,,21711860.0,,28650617.0,107071719.0,,9185933.0,-22705481.0,8919.0,,,,,19495.0,3286853.0,,12068896.0,,6009.0,,,,,261560.0,,,,-1452236690.0,,23500.0,,14447659.0,,55308640.0,,,3023655.0,,,,1611662557.0,,,208446.0,,2716815.0,N,608875.26,,,2022585.0,,,16931049.0,5380,734479.0,,3758.0,-171.0,,36954739.0,1035428.0,,11313871.0,,223015.0,,102567938.0,26085285.0,-9251602.0,,,2786610.0,257040.0,,,173063558.0,,13342451.0,234442.0,,,,,13502.11,6982257.0,,108437.0,,,,,14922312.0,,,,,,1077185.0,,,,281491436.0,,,,,4760736.0,,,16005395.0,44879.0,,100745452.0,,,,,,,,,,,2056374.0,,,,,,,,20088896.0,,54568.0,,,268510.0,,,45685062.0,14097883.0,,,27505955.0,1682853390.0,406866.0,,,,,,,,12076493.0,946751.0,499898.09,,2508317.0,NY,,8060.0,,142214.0,93432.0,,,,,345652.0,726817.0,,,,7941859.0,268510.0,54999068.0,,,78962968.0,,,,1036127.0,678241.0,,,40.0,364.38,84589064.0,,,,,17783.0,,,200175847.0,,,10601.0,,,,,,,431087.0,,,1574530.0,11196661.0,,,,,,3522600.0,,18330391.0,32.49,83740.0,,,3033134.0,16963236.0,,,,58382187.0,,,274.15,,55539.0,1636.0,,,,,,2417364.0,,257040.0,91993611.0,,,,,,13079834.0,42117149.0,56023081.0,,345652.0,,,,5465.0,,,,,,,,,,,,274129.0,,41580371.0,,,,538692.0,14600.0,,,,,19010212.0,350383.0,,38773844.0,,,62185092.0,,,,,,,224457.0,,,,289.0,,,,,3285.0,,,22503058.0,5310515.0,,,62333.0,,11146.0,1519719.0,,35352798.0,,,60431463.0,,,,2.0,,5743284.0,3587.0,,326265525.0,10071838.0,519036.0,1594795591.0,,3040128.0,,95588.0,4070613.0,,,,73409520.0,,,,98.0,,,,,,,,108250.0,,20310010.0,,,,3482280.0,,679997.0,10452417.0,,,7195580.0,,47256359.0,245618328.0,,12471783.0,3920321.0,,,,2864821.0,,169939596.0,115746902.0,,,,,,,268510.0,437156.0,5976136.0,,,,,,NSUH PSYCHIATRIC EXEMPT UNIT,,,451267.78,1821742.0,,,742919.0,,13001,33849808.0,,,151035.0,,26857.0,,,,,,,,382680.0,,,N,33.78,6880764.0,,,18964040.0,,20280.0,3375862.0,,,1514916585.0,331131.0,,,16120404.0,,4364403.0,779011.0,,F,99.85,43977799.0,53466.0,,,89200.0,6661223.0,,,15.0,,,,,,93143688.0,,,,,,,-11827000.0,2223806.0,174311311.0,,,,15635411.0,13012.0,9287097.0,13079834.0,,,-214.0,,,7941859.0,,,,,177434.0,8499144.0,,,,,21932501.0,64117923.0,,,,,,,,,225261.0,117588504.0,91898194.0,,305181656.0,5485053.33,,16914990.0,23725.0,335827475.0,1868.0,,,172890.0,15947817.0,16319842.0,,,10113833.0,,,,,,,,,26612769.51,76714037.0,,,10182258.0,,-399274172.0,107515229.0,73556274.0,8234480.0,62185092.0,,,10712.0,8527737.0,,,,16794865.0,,,,,175982.0,,,16994000.0,,,,,607621.0,,70814767.0,,,,,179395.0,,,,195244.0,,,,,2513020.0,611.0,,,-309783.0,,44467.0,,,,,,,,42011540.0,,,,13285.64,,,,50.39,,27943906.0,,,,5823269.0,4164290.0,55781278.0,67664538.0,,59414527.0,33S106,-12075090.0,,339.0,,,,,,60431463.0,,,260388.0,,,3952.0,,50434.0,,83006362.0,,161691417.0,,1537204.0,,,13319440.0,-2822891.0,8525.0,5700944.0,,,,,,,,18872852.0,,,,,44365998.0,,,46.47,,3822734.0,100782597.0,18615.0,,26723071.0,,,,,,,,,,,49045.57,,,373891.0,,,,3443610.0,,,,793587688.0,,,4580085.0,,12169287.0,,563945.0,10601.0,,,1703915687.0,,,52891286.0,,0.181716,,,,09/14/2021,,126448481.0,2223806.0,1833279.0,151852218.0,,33712450.0,,,,,14451.0,10386.0,,,,1098697.0,,,,246284975.0,,,,12480725.0,,,,45957227.0,158414303.0,14126.0,,,20463.0,,,,,32463452.0,925786.0,,,,83166.0,202452606.0,,20280.0,-2678625.0,,,,,,,,,,27505955.0,3952200.0,,10030,312509.0,,,,,611.0,68817063.0,N,3031860.0,,,,,,,,,,,,60212794.0,1554710271.0,-1452236690.0,18567599.0,,,946751.0,,,41374257.0,16994000.0,523853.0,,96346004.0,,,1990338.0,,,,68937.0,,46.7,,,,,,6893764.0,,,,,,,,16901.0,,8942529.0,,,,84883268.0,,,,14478323.0,,,972 BRUSH HOLLOW RD,113469624.0,2790584.0,17739.0,347031.0,,,,57.0,,16319842.0,,2.0,274059.0,-40907328.0,,,414219.0,,,,,1358682.0,,,-849720519.0,202452606.0,,,,,,272632.0,14263.31,,3615910.0,,5106.0,,,,,,10809663.0,,68589126.0,,1424471.0,,,12063609.0,,,61412775.0,,,408587.0,70663129.0,2536246.0,333119.0,,,,55071.0,,16914990.0,,,,1218200.98,373182801.0,,,,3587.0,,,3317792.0,,704001.0,17479286.0,5976136.0,,3807484.0,,,,,19783629.0,,,,,,,-119249.0,,,,765304.0,2258798.34,,,,,,,,,,,,,,,,60.89,,3691547.0,,91355413.0,,,,28877509.0,,3090.0,,27367368.0,,545.0,,10891138.0,,259461101.0,,,,4979211.0,269.29,188379843.0,,6308948.0,29806708.0,,68817063.0,,209126666.0,1104813433.0,41073.0,,,120450821.0,364.38,,119089611.0,,,,65.0,126448481.0,16931049.0,1695769.0,111885229.0,,64319.0,,,,,,,,,NORTH SHORE UNIVERSITY HOSPITAL,,,3920321.0,,2021-12-31,,304336872.0,,,,,,,,,,,-3324449.0,,,,,300.0,,,,65553645.0,1247095.19,20645398.99,,245077510.0,11209068.0,,1780970.0,,,,1590115001.0,,,,,-2067964.0,,,94.0,,,,58382187.0,,382490835.0,782.0,,336421147.0,2241398.0,,64550783.0,,,-101081.0,2699794692.0,,,,8919.0,,19144582.0,,,,,16319842.0,312509.0,,,24158671.0,-4347597.0,,12475474.0,67049538.0,,4869.0,1155.0,,496328.0,,5204.0,1524530.0,,,,634068.0,,,286778320.0,,,74668378.0,3666264.0,,5,6941321.0,,,,,2999017.0,,339521436.0,,-1439641.0,,,,,,,12305763.0,14428173.0,925786.0,,,,,,16914990.0,,,,,1307.0,,,12369308.0,,2864258.0,,,,,,,,15635411.0,,3183.0,2021-01-01 00:00:00,40.17,,,Y,12076493.0,,139300274.0,287.0,1970952.0,7922.0,,11402370.0,,,,,,,,499609.0,,,,347031.0,23410002.95,,,,87823.74,31341835.0,10109399.0,3690282.0,20280.0,-19585891.0,,,,,,,50254286.0,,,,,,53.3,,2251643.0,,,,,145312254.0,974061.0,10961657.0,37870.0,4364.0,04/04/2008,,,,2454334.41,,4070613.0,278057.0,,95588.0,,,,,,326265525.0,,,,,24198030.0,11590,,,,,,-5718947.0,4898.0,,,,61067752.0,,,,,,3994311.0,3014939.0,1599424.0,,1313513.0,,,,,108027.0,NASSAU,,1969216.0,,40311.0,,2280471.0,,,10174267.0,,,,626843.67,,,,,,,,,4046036.0,-3324449.0,,62394664.0,,,15584051.0,,74177791.0,,,820546263.0,,,4815185.0,,,3822734.0,,,67774527.0,-13528467.0,,,,,,67040602.0,5106.0,,,21894321.0,,,,,-1734949.0,,,,356501.0,,,,10018646.0,,,,47256359.0,8936.0,,96346004.0,,132854283.0,256866.0,,,,177.82,,6009.0,2934749.0,,,,6895012.0,,,,,,,,,119089611.0,1703915688.0,Y,,,,,1918196.0,54501792.0,4951330.0,355451.0,,,,,213016059.0,26085285.0,3522600.0,,290906.0,,13066181.0,,,,,,8776310800.0,65442304.0,,,,,95342.56,3099463.0,,,,,,,,,,,,2950176.0,65147655.0,,8262937.0,,33400,P,,,,2310.0,,,823977.0,,1384546.0,12300.0,16901.0,,537505.0,,,,,,,,,,,2023-05-10 00:00:00,,,,11844502.0,337148,26.8,169939596.0,4053870.0,,,,74177791.0,142596947.0,,,,,,,,408587.0,,,11313871.0,,,,,2244525.0,,,60.89,,,,,1232464.29,,,,1574530.0,,,,368255017.0,15584051.0,56623756.0,,,,90.0,,113948852.0,12063609.0,,2792745.0,43032690.0,,245618328.0,,,,199923.0,6419928.0,958202.0,,13319440.0,14120102.0,,11491316.0,,,,,,1636.0,21282457.0,,,,,877660.0,,804.0,,,,,2421182.0,,31.24,,Y,2251643.0,,,,,,3709666.0,3952.0,,,,,26723071.0,,,,300.0,349572662.0,,,,,,,,,,,41274.1,N,,,,,26024489.0,66.85,402835.0,,13029.0,Y,General Short Term,12346729.0,,,Y,,4364403.0,,,,,,2021,Acute Care Hospitals,NORTH SHORE UNIVERSITY HOSPITAL (330106)
72349,NORTH SHORE UNIVERSITY HOSPITAL (330106),General Short Term (Acute Care Hospitals),Voluntary Nonprofit-Other,-73.703029,40.779269,,,,102008.0,309012.0,34799.0,3114995.0,,,,,,,4625366.0,42.0,,8263435.0,,,,,,,,,,1425414721.0,,,13517649.0,140588070.0,,6534499687.0,,,Y,,1128816.0,,,24745975.0,217972752.0,6779959.0,,216.98,,,13.0,157503252.0,215703.0,,,,31658515.0,,31134.0,,182768448.0,811346.0,,,,699855483.0,,41299630.0,,662.0,4866786.0,,,,2954792.0,1.0,21993241.0,,,,29874545.0,,,,25875320.0,,15858986.0,,3733101.0,,19607537.0,,146248.0,,,1139.0,,,,,,,50638.0,,1804105884.0,,25009556.0,3030456.0,,31134.0,,1439256.0,,213129.0,,,,,1059.0,-1630002.0,316241779.0,,,8263435.0,,,,,410840.0,,,,,3831092.0,,,865422.0,,,,,1439256.0,,18777990.0,,,,,,,,5685120.0,51579.0,,,,,2009549.0,,,,NY,531836081.0,,,,1275130.0,,51.0,766637.0,,2142566.0,,233525939.0,,,,328830.0,39.33,,,N,,782.0,71.08,2366745.0,-15111274.0,42735236.0,,,,429230.0,,,,,,8316225.0,,,,,,225520.0,,33,,,,,17831064.0,13205766.0,,,164853.0,,6738265.0,,2254350.0,,9487315.0,,,,5788422.0,14452842.0,,,,,34472827.0,,2929913.0,,3733101.0,,,1422504.0,,MANHASSET,,,,8306745.0,91921568.0,,1021299.0,,,,1395817.0,,,,,,,,71468370.0,,14999.0,118908838.0,,586559.0,,27018.0,,25.53,,,15521496.0,11331675.0,80722032.0,2667655.0,,,,,,,,4325188.0,,,1.0,,82417.0,8466971.0,,,436533.0,,,221.47,,411337.0,53493886.0,,,,,,N,11164.0,,285430.0,451948.0,,,,71.12,,16941409.0,,,2576324.0,,,23066882.0,,,,10853868.0,,91981240.0,-702743.0,637970.0,,,,,,24987468.0,23066882.0,,18063.0,,,29691911.0,,12553094.0,153851.0,,,,15946660.0,3035657.0,11509227.0,,8316225.0,101714.0,2385208.0,,,,2512101350.0,,,,,,,394852967.0,,,197586.0,,,,,,,531836081.0,,,,,391940562.0,,,60021571.0,,53493886.0,,,38936020.0,14532.0,66.87,23066882.0,804.0,,,10153418.0,,,,11806.0,8911921.0,68569649.0,,N,,2706658.0,31772032.0,,,19055.0,3852972.0,,24881.0,859.0,,,,120473376.0,502441.0,,30674595.0,,,783747.0,,,,,,,,27897855.0,164557455.0,766637.0,,,,,367432.0,,,,,14034.0,,,-183637567.0,,,,330106,,34338487.0,,13305507.0,,,,,,,1888232031.0,,395055557.0,,1614058.0,,,162457799.0,,,,20061877.0,,378350139.0,,,,518587.0,19646802.0,,,,35.7,340747202.0,,14196.0,,,,5070291.0,,50099852.0,22150344.0,,,,,,19102716.0,684818.0,,,7525.0,,2669243.0,2251500.0,,,,,18348737.0,,2992914.0,86363.0,612.0,,,,,,,,48700511.0,219148976.0,-9160.0,02/21/2019,307512.0,2539532.0,2466726.0,6107692.0,,,,,,,,,443442.0,9.0,,3770.0,WESTBURY,95334.0,,2679.0,,,4639480.0,27897855.0,319882692.0,2691103.0,152615772.0,,N,,,36076004.0,64377663.0,,,,,,220381573.0,,,53095040.0,2422958.0,618.0,,,-46878.0,21993241.0,,,,,35917830.0,,,3006151.0,2072127.0,,,727800.0,8566191.0,,,,10209648.0,26348508.0,,,16177954.0,,,-12206421.0,,,,,308262.0,,,,,,17475361.0,,,,33155.0,,620.0,,,727586.0,-3640915.0,225520.0,,59735374.0,,,1104455.0,,,,53.54,,,,,,,,,,,,65288093.0,,,,,,-770029.0,1446724.0,339139.0,368371476.0,8393155.0,,,,,141163778.0,,-40073.0,,103874989.0,,63179683.0,,227986690.0,,221970.0,,,1194849.0,69404068.0,-1007221.0,,,,300 COMMUNITY DRIVE,52509893.0,,4676872.0,,,,,,,,15171338.0,,25875320.0,,1337190.0,21880.0,,,,,6764480.0,1105152.0,,4659707.0,3937.0,,29286204.0,,,5123181.0,353384.0,,,2929913.0,,,,,,,1596061.0,,4490109.0,3831092.0,1344094839.0,5048053.0,,,9867170.0,6846241.0,,,,47601120.0,18918202.0,,223015.0,,26348508.0,,120473376.0,,,1089669.0,5978141.0,,,,,70858928.0,,5982744.0,,,,835323240.0,,,16515229.0,6782084.0,,23694.0,20260650.0,2118392011.0,3356180.0,,3630640.0,,924778.0,8170024.0,,,14944865.0,,,367432.0,,58.61,,,13118891.0,1312703826.0,,NORTHWELL HEALTHCARE INC,15862456.0,,,125133083.0,64631297.0,3958196.0,,644176.0,1353554.0,,,14397430.0,,,,,23320.0,,,,5845466.0,166276867.0,,22183863.0,84777507.0,,,,,279775.0,,,,,,270626.0,,46561041.0,99856179.0,,74634915.0,86363.0,,61771714.0,Y,-498975305.0,,,,,,58269648.0,,,4259782.0,3927840.0,,4694441.0,350362.0,,,1179783550.0,,,,-1190537.0,,,31447817.0,,,,12944.0,,,,,892822.0,2142566.0,,,,,,111243977.0,,,,,,,,,7314528.0,,,-221658665.0,,13718.7,,,,,125026700.0,14363629.0,58025914.0,,744619,,,,,,76607175.0,,1921593.0,,,,,,-66520.0,,3264554.0,57381.0,,42902413.0,,,,,12944.0,1598595.0,,91981240.0,610.0,,21185678.0,,15905090.0,53095040.0,,135882.0,,,27718577.0,,,,HB2348,,,278107902.0,-20.0,77232.0,,,562038.0,426127.0,,,,,,-45363233.0,73844817.0,520588.0,2.0,,,,,6078749.0,,,,3864482.0,365843.0,,,,597.0,,,256.0,,36303358.0,,,,,,,378465787.0,,952392.0,20884939.0,-3273532.0,,205796.0,57.5,,,,60.57,,,64359017.0,,,,,,,,,201950716.0,,,,,268366.0,,,1159.0,,232754.0,53061837.0,10895577.0,40306193.0,8.0,,,,,335702,,,,,,1071309.0,,,,,58.29,,34678632.0,5497485.0,167317.0,45294096.0,,108992850.0,-66261.0,,,,18846600.0,35119440.0,985030.0,,,,,197701.0,,84777507.0,,,,,73921.0,,,,,,,P,,,,,,596179103.0,,,,94817520.0,,1921593.0,,,,,,2711769.0,,3937.0,,-91303277.0,,,819055.0,,,,,-36444914.0,,,,,,,35004,8643672.0,,,,,,,3813.0,,,Y,,,,,,,,,70858928.0,,,,,238383.0,,28.95,,17113.0,,29.0,,,,14830356.0,,,,666406.0,137948.0,,44817135.0,26559.0,,,-58992535.0,14363629.0,42.0,,,10269538.0,405687120.0,,15194081.0,31773298.0,,,,,,,,,,,340008497.0,727800.0,,,,,,,35554997.0,,,,5475.0,345.0,,,196581.0,230811.0,,,264184.0,13508666.0,-183089468.0,,,,,,,,,,1478082.0,23301194.0,,3872673.0,,44911.0,,,,629392.0,1323.0,80877.0,662565.0,,11826.0,8860266.0,,107148.0,32968976.0,,,91921568.0,,29848086.0,,34332154.0,118376525.0,,8560143.0,1682266.0,,,,,,50638.0,3323086.0,,14284751.0,,5986.0,,,,,17522.0,,,,-1349891988.0,,40938.0,,23855980.0,,107447999.0,,,3815236.0,,,,1889426880.0,,9.0,258185.0,,3285999.0,N,577908.0,,,2056072.0,,,18348737.0,5380,966417.0,,,,,47132280.0,1000620.0,,12195290.0,,223015.0,,114250129.0,30291827.0,-8884086.0,,,2780082.0,332631.0,,,169795255.0,,1871372.0,229311.0,,,,48.0,30544.0,8500741.0,,162285.0,,,,,16592435.0,,,,,,1112139.0,,,,312901927.0,,,,,5497485.0,,,18846600.0,,,125273166.0,,,,,,,,,,,2172787.0,,,,,,,,19812733.0,,52396.0,,,,,,71468370.0,14363629.0,,,27653242.0,2020220238.0,538123.0,,,,,,23694.0,,15946660.0,,513952.0,,3019659.0,NY,,7525.0,,148544.0,105914.0,,,,,350654.0,799340.0,,,,11951195.0,,109874248.0,,,79372611.0,,,,1306041.0,,,,40.0,373.31,91282770.0,,,,,,,,197977175.0,,,9984.0,,,,,,,416605.0,,,1614058.0,11699107.0,,,,,,3378600.0,,20111760.0,32.91,32950.0,,,3382792.0,25038508.0,,,,61766413.0,,,477.27,,71556.0,1665.0,,,,,,2336057.0,,332631.0,92570219.0,,,,,,16395932.0,52509893.0,59681223.0,,350654.0,,,,241086.0,,,,,,,,,,,,410115.0,,-852251.0,,,,448928.0,14600.0,,,3164.0,,19527227.0,365843.0,,44309865.0,,,58589728.0,,,,,,,230811.0,,,,194.0,,,,,3285.0,,,27106570.0,7266996.0,,,63076.0,,13044.0,1469621.0,662.0,36103577.0,,,76145357.0,,,,2.0,,6115973.0,3762.0,,378465787.0,12813771.0,574364.0,1872714744.0,,4641130.0,,137948.0,3862267.0,5788422.0,,,78704784.0,,,,,-17152.0,,,,,,,125484.0,,21185678.0,,,,3264554.0,,1537990.0,15521496.0,,,8566191.0,,63179683.0,257260123.0,,11980672.0,7447496.0,,,,2769277.0,78182.0,60538598.0,114699011.0,,,,,,,,539125.0,4503998.0,,,,,,NSUH PSYCHIATRIC EXEMPT UNIT,,,454616.0,2726132.0,,,519733.0,5788422.0,13001,26949805.0,,,,,10783.0,,,,,,,,444436.0,,,N,34.74,7083932.0,,,17651164.0,,52803.0,3596531.0,,,1664178115.0,495835.0,,,15858986.0,,5809945.0,773815.0,,F,150.42,45294096.0,59519.0,,,14532.0,10889251.0,,,15.0,,,,,,99856179.0,,,,,,,11230249.0,2033343.0,194094015.0,,,,19399705.0,18870.0,10553925.0,16395932.0,,,,,,11951195.0,,,,,,8829794.0,,,,,24745975.0,41201262.0,,644176.0,,,,,,,231542.0,137230766.0,94012637.0,,337830977.0,4795030.0,,23372695.0,23725.0,319882692.0,1944.0,,,,16177954.0,15854537.0,,,10066739.0,,,,,,,,,26980718.0,125133083.0,,,11389102.0,,-397151547.0,119074633.0,51158914.0,8914636.0,58589728.0,,,11806.0,9501619.0,,,,16956428.0,,,,,169965.0,,,18762291.0,,,,,647350.0,,74376709.0,,,,,,,,,248425.0,,,,,2706733.0,611.0,,,-73700.0,,44911.0,,,,,,,,46561041.0,,,,14195.97,,,,110.07,,31426991.0,,,,7415800.0,5611336.0,75968231.0,77894420.0,,62332001.0,33S106,-15575002.0,,388.0,,,,,,76145357.0,,,,,,1482.0,,66210.0,,79355957.0,,173871471.0,,2299662.0,,,16709324.0,-3640915.0,4839.0,6014882.0,,,,,,,,17629494.0,,,,,68966927.0,,,48.1,,3810318.0,125330197.0,18615.0,,35231547.0,,,,,,,,,,,49709.0,,,558561.0,,,,3966568.0,,,,835323240.0,,,4862315.0,,14830356.0,,585193.0,9984.0,,,1804105885.0,,,52352933.0,,0.199115,,,,09/14/2021,,163389938.0,2033343.0,978507.0,162457799.0,,72975172.0,,,,,14532.0,14698.0,,,,1407311.0,,,,266454998.0,,,,16673288.0,,,,57180547.0,170193364.0,16235.0,,,19169.0,,,,,15470053.0,1053941.0,,,,86363.0,221349899.0,,10223.0,-330320.0,,,,,,,,,,27653242.0,3811800.0,,10030,382284.0,,,,,611.0,69964322.0,N,3035657.0,,,,,,,869557.0,,,,,68166876.0,1657209812.0,-1349891988.0,19646802.0,,3121023.0,,,,47601120.0,18762291.0,506061.0,,94421484.0,,,2366745.0,,,,102008.0,,41.29,,,,,,8047742.0,,,,,,,,17621.0,,10562677.0,,,,68400301.0,,,,13305507.0,,,972 BRUSH HOLLOW RD,142312762.0,2821819.0,33155.0,351915.0,,,,54.0,,15854537.0,,2.0,378145.0,-34338487.0,,,484636.0,,,,,1648168.0,767843.0,,-898389978.0,221349899.0,,,,,,332177.0,26546.0,,3733101.0,,5193.0,,,,,,14313564.0,,61772432.0,,1897061.0,,,13160172.0,,,27154818.0,,,3369437.0,74133988.0,4659707.0,498176.0,,,,55657.0,,23372695.0,,,,2039429.0,395055557.0,,,,3762.0,,,3114995.0,,811179.0,20848724.0,4503998.0,,3679164.0,,,,,17475361.0,,,,,,,,,,,730673.0,1009502.0,,,,,773815.0,,,,,,7408365.0,,,,,59.07,,6764480.0,,108965832.0,,,,35554997.0,,3012.0,,31666798.0,,859.0,,12325151.0,,343326995.0,,,,4862524.0,258.48,197167471.0,,7800893.0,31099019.0,,69964322.0,,198477521.0,1137021172.0,27018.0,,,118908838.0,373.31,,124072041.0,,,,65.0,163389938.0,18348737.0,1487836.0,95219920.0,,58053.0,,,,,,,,,NORTH SHORE UNIVERSITY HOSPITAL,,,7447496.0,,2022-12-31,,333189092.0,,,,,,,,,,,-3730783.0,,,,,,,,,73844817.0,1237536.0,21235219.0,17763.0,256930139.0,1716928.0,,2664489.0,,,,1699972190.0,,,,,-1832228.0,,,264.0,,,,61766413.0,,408765629.0,1038.0,,359917820.0,2312531.0,,71131063.0,,,-96676.0,2870709888.0,,,,,,20122238.0,,,,,15854537.0,382284.0,,,23992411.0,-4633043.0,,11815989.0,70638746.0,,804.0,796.0,,459772.0,,,1759766.0,,,,811346.0,,,282128897.0,,,74634915.0,4560080.0,,1,7577955.0,,,,,2705347.0,,348184981.0,1329616.0,-2178339.0,,,,,,,13640287.0,18246304.0,1053941.0,,,,,,23372695.0,,,,,1139.0,,,13068721.0,,4409205.0,,,,1104455.0,,,,19551825.0,,21647.0,2022-01-01 00:00:00,45.32,,,Y,15946660.0,,175682654.0,280.0,3106054.0,17394.0,,17060025.0,,,,,,,,631534.0,,,,351915.0,22831280.0,,,,84535.0,38077943.0,12074986.0,5058794.0,10223.0,-21511003.0,5788422.0,,,,,,59761666.0,,,,,,151.18,,2523934.0,,,,,155345854.0,1019614.0,,37045.0,,04/04/2008,,93400.0,,1708106.0,,3862267.0,284235.0,,98681.0,,,,,,378465787.0,,,,,26429455.0,11590,,,,,,-3256937.0,8894.0,,,,103874989.0,,,,,,4676872.0,3782550.0,1293707.0,,1766735.0,,,,,125484.0,NASSAU,,2946285.0,,99170.0,,3156248.0,,,9673896.0,,,,769450.0,,,,,,,,,3808662.0,-3730783.0,,61771714.0,,,16371446.0,,120473376.0,,,887168905.0,39267.0,,3782647.0,,,3810318.0,,,73724813.0,-10386437.0,,,,,,70626174.0,5193.0,8500.0,,25009556.0,,,,,-1998611.0,,,,358083.0,,,,10895577.0,,,,63179683.0,12572.0,,94421484.0,,164311289.0,302489.0,,,,175.53,,5986.0,-950275.0,,,,7083932.0,,,,,,,,,124072041.0,1804105884.0,Y,,,,,2142566.0,64459565.0,5525358.0,367432.0,,,,,378788128.0,30291827.0,3378600.0,,625306.0,,14534984.0,,,,,,9405209575.0,109760531.0,,,,,101359.0,3155211.0,,,,,,662.0,,,,,,3245858.0,76974331.0,,10269538.0,,33400,P,,,,2715.0,,,796151.0,,1439256.0,218324.0,17621.0,,1096564.0,,,,,,,,,,,2023-06-19 00:00:00,,,,15404568.0,337148,27.43,60538598.0,4190382.0,,,,120473376.0,157503252.0,,,,,,,,6089963.0,,,12195290.0,,,,,2135683.0,,,59.07,,,,,2065975.0,,,,1614058.0,,,,381514075.0,16371446.0,53839312.0,,,,,,141244407.0,13160172.0,,,53861284.0,,257260123.0,,,,46269.0,6204354.0,2173395.0,,16709324.0,15023812.0,,12044708.0,,,,,,1665.0,20921490.0,8705.0,,,,1211261.0,,731.0,,,,,3621843.0,,31.6,,Y,2523934.0,,,,,,3831092.0,1482.0,,,,,35231547.0,,,,,391940562.0,,,,,,,,,,,44548.0,N,,308262.0,,,30228789.0,82.35,386467.0,,14196.0,Y,General Short Term,16846152.0,,,Y,,5809945.0,,,,,,2022,Acute Care Hospitals,NORTH SHORE UNIVERSITY HOSPITAL (330106)
