,Curated Name and Num,Hospital type (modified),S2_1_C1_21,Lon,Lat,D3_IPF_C2_73,S3_1_C8_32,A8_C2_23,D_5_HOS_C7_71,D1_IRF_C1_53,C_1_C7_9940,B_1_C26_51,S3_1_C9_20,A8_C2_19,D_5_HOS_C3_63,S3_2_C4_10,S3_1_C7_2001,S3_3_C4_2,A7_1_C1_6,S5_C1_13,C_1_C6_58,A_C1_9920,D_4_HOS_C3_75,S3_2_C4_25,B_1_C21_73,D_1_HOS_C4_42,D_4_HOS_C3_71,A_C6_108,S5_C2_5,S3_1_C6_5,S3_1_C3_24,S3_1_C3_1801,D_3_HOS_C9_34,D3_HOS_C2_97,D3_HOS_C3_70,D3_SNF_C3_57,D3_IRF_C3_58,A7_1_C7_7,S3_1_C6_2,S3_1_C6_10,S2_1_C2_1807,C_1_C6_101,A7_1_C1_3,B_2_C26_93,D3_IPF_C2_76,D_4_HOS_C4_53,S4_HHA2_C3_38,D_4_HOS_C11_56,S3_2_C2_2551,S3_2_C4_7,A_C2_64,D_4_HOS_C13_93,D_4_IPF_C13_62,D3_IRF_C3_6250,S3_2_C4_11,S4_HHA2_C4_37,D3_IRF_C3_63,B_1_C26_99,G_C1THRU4_23,E_B_HOS_C1_11,D_4_HOS_C12_73,C_1_C2_65,D_4_HOS_C3_57,S2_1_C2_1501,D_4_HOS_C2_66,D_3_HOS_C9_200,S3_1_C3_2001,B_1_C22_193,A_C1_107,A_C2_192,B_1_C26_53,B_1_C22_58,D_4_HOS_C13_70,D_5_HOS_C5_96,D_4_HOS_C12_91,B_1_C26_200,S3_1_C10_24,D_5_HOS_C3_68,S2_1_C2_1808,D3_HOS_C2_66,D_5_HOS_C6_9201,B_1_C26_98,D_4_HOS_C13_73,D3_IPF_C3_93,D_4_IRF_C11_93,D_4_HOS_C2_94,D_1_HOS_C4_43,D3_HOS_C3_67,S3_1_C8_14,B_1_C26_110,A7_3_C9_1,S3_1_C7_24,C_1_C5_75,D3_IRF_C2_73,G_C1THRU4_31,D_4_HOS_C10_55,E_B_HOS_C1_15,A_C1_8,A_C1_19,B_1_C26_69,D_5_HOS_C3_66,B_1_C22_115,D3_IPF_C2_31,D_5_HOS_C2_98,C_1_C6_59,D3_IRF_C2_41,D_4_IPF_C11_71,D_4_IPF_C13_72,S4_HHA3_C2_35,D3_SNF_C2_40,S3_2_C4_1,B_1_C0_94,C_1_C5_55,C_1_C6_33,D_4_HOS_C12_69,D_4_IPF_C13_90,D_4_IRF_C13_50,B_1_C21_59,D_5_HOS_C7_94,S3_1_C8_8,D3_IRF_C2_58,S2_1_C1_37,D3_HOS_C2_76,B_1_C22_112,B_2_C26_91,D3_IRF_C3_55,C_1_C2_67,A7_3_C11_2,S3_2_C4_16,D3_HOS_C2_40,D3_IRF_C2_60,S2_1_C2_129,S3_1_C2_11,S3_1_C3_8,A7_1_C7_2,B_1_C26_9201,D3_IPF_C3_59,D3_IPF_C3_60,E_B_HOS_C1_1,D_4_HOS_C2_88,S2_1_C1_116,D_4_HOS_C13_53,S2_1_C1_131,A_C6_18,D1_HOS_C1_26,S3_1_C7_25,G_C1THRU4_25,D3_HOS_C3_74,A_C2_58,C_1_C6_112,S3_1_C6_11,A_C1_110,B_1_C26_31,D_4_HOS_C10_58,D_4_IRF_C11_70,D_5_HOS_C4_76,B_1_C0_100,D_4_HOS_C11_98,D3_IRF_C3_56,B_2_C26_95,D3_SNF_C2_90,D3_IPF_C2_58,D_5_HOS_C6_62,D_4_HOS_C4_57,D_5_HOS_C4_71,S3_1_C7_1801,S3_2_C3_1401,G3_C1_5,B_2_C26_202,S3_1_C6_8,D_4_IRF_C13_58,A_C6_191,D_5_HOS_C4_59,D3_SNF_C3_54,C_1_C6_9920,A7_1_C3_8,D_4_IRF_C11_66,B_1_C26_55,S3_1_C8_1801,B_1_C21_69,S10_C1_12,B_1_C26_89,D3_SNF_C2_50,D3_IRF_C2_52,S2_1_C2_130,B_1_C0_57,D_4_HOS_C12_58,D_4_IRF_C13_74,D_4_HOS_C2_200,S4_HHA2_C1_35,B_2_C26_4201,S3_2_C6_30,S3_2_C2_22,B_1_C22_44,D_4_HOS_C4_89,D_4_HOS_C3_89,D_4_IPF_C13_68,D_5_HOS_C4_53,D_5_HOS_C6_97,D_4_SNF_C11_68,D_4_SNF_C11_66,D3_IRF_C2_6250,TRNSMTL_NUM,A_C1_54,A8_C2_1,D_4_HOS_C1_50,S3_1_C5_7,C_1_C6_46,C_1_C7_56,A7_1_C7_3,S3_1_C10_19,A_C2_43,D_4_IPF_C13_52,D_4_IRF_C1_102,D_5_HOS_C4_51,S4_HHA1_C4_37,D3_IRF_C2_40,G_C1THRU4_11,S3_2_C6_43,D_4_HOS_C12_9201,S3_2_C4_38,S4_HHA3_C1_33,C_1_C6_111,D_4_HOS_C3_67,C_1_C5_93,D_5_HOS_C2_66,D1_HOS_C1_41,B_1_C0_14,A7_1_C1_7,B_2_C26_109,S3_2_C2_33,S2_1_C2_1518,A_C2_89,S10_C1_27,C_1_C7_73,D_4_IRF_C11_200,D_5_HOS_C7_59,B_1_C0_13,D_4_IRF_C13_52,A_C2_10,S3_2_C2_12,A_C2_40,A_C2_4501,S3_2_C5_43,D_4_HOS_C3_69,B_1_C0_67,S3_2_C6_39,C_1_C5_101,D_4_HOS_C12_57,S4_HHA1_C1_36,D3_SNF_C3_59,E_B_HOS_C1_34,D_5_HOS_C3_59,D_4_HOS_C4_73,C_1_C6_55,S3_1_C6_24,D3_SNF_C2_32,C_1_C5_90,PRVDR_NUM,B_1_C0_4501,S3_3_C2_5,S3_2_C5_39,D_4_HOS_C12_52,D3_HOS_C2_70,D_5_HOS_C6_98,A_C6_50,D_4_HOS_C11_54,D3_SNF_C2_52,C_1_C6_60,B_1_C26_111,D_5_HOS_C7_73,B_2_C26_46,S2_1_C4_24,B_1_C22_108,D3_HOS_C3_54,S2_1_C2_1502,S3_2_C6_5,D_4_HOS_C2_93,D3_SNF_C2_64,E_B_HOS_C1_33,S2_1_C4_3,D3_HOS_C3_93,D_3_HOS_C6_200,S3_2_C2_25,B_1_C0_9930,D_3_HOS_C9_40,D4_LIVER_C1_69,S2_1_C2_1521,D_4_IRF_C11_73,D3_IPF_C3_76,S3_2_C2_1401,A_C2_41,D3_HOS_C3_6250,S3_2_C5_41,D_4_IRF_C11_98,D3_IPF_C2_67,D_4_SNF_C11_69,S3_2_C5_11,S3_3_C5_1,D_5_HOS_C7_55,C_1_C5_115,B_1_C22_116,D3_HOS_C3_98,S4_HHA1_C2_35,G_C1THRU4_36,D3_SNF_C3_58,S2_1_C1_106,D3_SNF_C2_57,A_C1_15,A8_C2_12,B_1_C26_72,D_5_HOS_C2_67,D_4_SNF_C11_53,D_5_HOS_C6_53,D_4_HOS_C2_97,C_1_C6_65,B_1_C0_64,S2_1_C1_108,D3_HOS_C2_51,C_1_C7_89,D3_IPF_C3_9201,D3_IRF_C2_93,D_5_HOS_C5_93,D3_IRF_C3_62,A8_C2_17,S4_HHA2_C1_33,C_1_C6_32,S3_2_C4_22,S3_2_C2_6,C_1_C5_109,D_4_HOS_C4_66,D_4_HOS_C12_68,D_5_HOS_C3_90,D_5_HOS_C4_90,D3_SNF_C2_71,S3_1_C11_22,D4_PANCREAS_C1_69,D_5_HOS_C4_74,G_C1THRU4_9,G_C1THRU4_44,A_C2_107,D1_HOS_C1_58,A_C1_6,D_4_HOS_C10_69,G_C1THRU4_27,G_C1THRU4_7,B_2_C26_89,D_4_IRF_C11_60,S3_1_C2_24,S4_HHA3_C5_34,D_4_HOS_C11_53,D_4_HOS_C11_200,D_4_HOS_C11_91,S3_1_C10_21,A7_3_C11_3,C_1_C7_54,C_1_C6_42,G_C1THRU4_39,S2_1_C2_2,D1_HOS_C5_45,C_1_C7_108,D_4_HOS_C13_71,S3_2_C2_16,S2_1_C2_1507,D_4_HOS_C11_64,D3_HOS_C3_55,S2_1_C2_1802,G3_C1_4,D_4_IRF_C13_200,C_1_C6_9930,S3_2_C2_11,A7_1_C1_2,S2_1_C2_1603,D_4_IPF_C11_64,B_1_C21_52,B_1_C22_30,C_1_C7_57,D_4_HOS_C3_91,B_1_C0_63,A_C2_12,A_C1_56,A_C2_70,B_1_C21_71,A_C2_61,A8_C2_3,C_1_C6_202,C_1_C7_90,D3_IRF_C2_51,D_4_HOS_C4_58,D_4_HOS_C3_51,S4_HHA1_C2_38,B_2_C26_9910,S3_2_C6_36,D_4_HOS_C10_97,D_5_HOS_C7_200,S2_1_C2_38,D_4_IRF_C13_69,D3_SNF_C2_65,C_1_C6_6250,D_5_HOS_C2_65,D_5_HOS_C4_52,A_C2_17,B_1_C22_111,B_1_C0_16,D3_IPF_C2_9201,S10_C2_22,B_2_C26_54,C_1_C6_52,D_4_HOS_C2_91,A7_1_C2_10,S3_1_C14_16,D_4_IPF_C13_67,S4_HHA3_C3_35,B_1_C26_61,A_C2_9,S3_2_C2_38,D_4_HOS_C2_71,D_4_HOS_C13_98,D3_IPF_C2_60,D_4_IPF_C13_75,S5_C4_1,B_1_C22_190,S2_1_C2_1503,C_1_C7_76,D3_HOS_C2_63,E_B_HOS_C1_3,S3_2_C4_26,S3_1_C8_18,D_4_HOS_C3_94,B_1_C22_63,D_4_IRF_C11_71,S2_1_C2_1001,S3_2_C2_5,D_1_HOS_C4_33,C_1_C6_44,C_1_C7_66,C_1_C5_111,D1_IPF_C1_27,A_C1_12,S2_1_C2_115,S4_HHA2_C1_38,A_C1_71,B_1_C0_9201,S3_1_C8_7,S10_C1_23,D3_SNF_C3_200,C_1_C6_53,D3_IRF_C3_72,D_5_HOS_C6_6250,B_2_C26_55,A_C6_74,S5_C4_6,D3_IPF_C3_70,D_5_HOS_C2_72,B_1_C0_89,S4_HHA2_C1_36,S4_HHA3_C3_36,A_C6_19,S3_2_C6_42,G3_C1_3,C_1_C5_116,D_4_HOS_C4_91,S5_C6_1,S4_HHA1_C3_33,S4_HHA3_C1_35,S3_1_C12_17,A_C6_62,D_4_HOS_C12_76,S3_2_C2_41,D3_IRF_C3_51,D3_IRF_C3_53,S2_1_C2_1803,B_1_C0_19,A_C6_190,B_1_C26_45,D3_HOS_C2_72,E_B_HOS_C1_27,C_1_C7_100,D3_SNF_C2_53,D4_ISLET_C1_69,B_1_C0_45,B_1_C0_70,D3_IRF_C2_50,B_1_C26_40,B_1_C26_71,D_4_SNF_C11_52,D_4_IRF_C11_58,A_C1_30,D_5_HOS_C5_58,A8_C2_25,B_1_C22_70,A8_C2_2,S3_2_C6_31,D_4_IRF_C11_52,D3_SNF_C3_69,D_4_HOS_C2_67,S2_1_C2_12,G_C1THRU4_45,D_1_HOS_C7_41,A_C2_9940,A_C2_6250,B_1_C22_33,D_4_HOS_C10_6250,D_4_IPF_C11_53,B_1_C0_107,S3_2_C5_26,D_4_HOS_C4_51,D_4_HOS_C2_68,B_2_C26_200,C_1_C5_46,D3_IPF_C3_51,S3_2_C6_29,S2_1_C2_4,D_4_IPF_C13_64,B_1_C22_67,S3_2_C2_26,D3_IPF_C3_62,A_C6_46,D_4_HOS_C2_90,B_1_C22_53,B_1_C21_98,D3_IRF_C2_200,G_C1THRU4_35,C_1_C6_50,D_4_HOS_C2_56,B_1_C22_95,D_4_HOS_C3_73,S2_1_C1_47,C_1_C5_51,B_1_C22_57,S2_1_C2_1524,D3_IRF_C2_63,D3_IRF_C3_69,D3_SNF_C2_59,D3_IPF_C2_98,D_4_HOS_C10_65,D_4_HOS_C3_63,S2_1_C2_1504,S4_HHA1_C5_34,A_C2_50,D3_IPF_C2_41,C_1_C6_106,D_4_IPF_C13_66,E_B_HOS_C1_32,A_C2_66,D_4_HOS_C3_58,A_C1_100,B_1_C21_34,B_1_C0_20,A_C2_67,D_5_HOS_C3_72,D_4_HOS_C12_55,D3_SNF_C2_41,D_5_HOS_C5_91,D_4_HOS_C11_70,B_1_C22_194,S3_1_C7_5,D_4_HOS_C10_70,S3_2_C5_30,S3_1_C11_27,S3_2_C4_24,D_5_HOS_C6_68,A_C1_50,D1_IRF_C1_41,B_1_C21_74,A_C6_115,D_4_HOS_C3_60,B_1_C26_190,A_C1_7,D_4_IPF_C11_52,S4_HHA3_C2_38,B_2_C26_107,D_4_HOS_C4_200,D3_HOS_C2_52,D3_IRF_C2_56,A_C2_110,D_5_HOS_C2_60,D3_SNF_C3_60,D3_IPF_C3_69,D_4_IPF_C11_66,D3_IPF_C2_52,D_4_HOS_C3_76,B_1_C21_67,D3_HOS_C2_59,D3_SNF_C3_62,S3_1_C14_14,S3_3_C6_3,E_B_HOS_C1_39,C_1_C5_68,B_1_C22_89,A7_1_C1_10,S3_1_C7_16,A_C2_7,S3_2_C6_1402,D_4_IPF_C11_65,S3_1_C3_11,D_5_HOS_C5_53,S3_1_C5_20,D_4_HOS_C3_88,D_5_HOS_C2_68,A_C1_105,B_2_C26_115,A_C6_45,D3_HOS_C3_97,D4_LUNG_C1_69,C_1_C5_100,S4_HHA3_C4_37,C_1_C7_117,E_B_HOS_C1_28,A_C6_32,D1_IRF_C1_49,D_5_HOS_C7_70,S3_3_C5_2,B_1_C21_90,B_1_C21_101,C_1_C7_63,D_4_SNF_C11_76,S3_2_C2_7,S4_HHA1_C1_35,D_5_HOS_C6_54,S3_1_C2_19,D3_IRF_C3_200,D3_SNF_C2_67,D_5_HOS_C6_52,B_2_C26_99,D_4_SNF_C11_73,S3_2_C4_1602,B_1_C0_110,B_1_C26_115,S3_2_C3_2552,S3_2_C4_19,B_1_C22_107,A_C6_22,C_1_C7_62,D3_IPF_C3_66,D_4_HOS_C4_74,D_5_HOS_C2_71,D_5_HOS_C6_63,C_1_C5_44,D_4_HOS_C2_64,S2_1_C2_16,C_1_C5_74,C_1_C7_50,B_2_C26_192,D_4_HOS_C13_76,D_4_IPF_C11_73,D3_HOS_C3_94,CENSUS,D_5_HOS_C5_64,B_1_C26_33,D_4_HOS_C13_55,C_1_C7_116,C_1_C5_63,E_B_HOS_C1_22,C_1_C6_4201,E_B_HOS_C1_8,D_5_HOS_C5_97,S3_2_C4_9,A_C6_100,D_4_IRF_C13_56,S3_1_C6_12,B_1_C21_56,D_5_HOS_C3_76,G_C1THRU4_34,C_1_C7_91,D3_SNF_C3_71,A_C2_101,D_4_IPF_C3_200,S3_1_C6_14,S3_1_C3_21,S2_1_C2_1605,D_4_HOS_C12_6250,C_1_C7_67,D_4_HOS_C2_55,D_5_HOS_C6_69,A7_1_C5_6,D3_IRF_C3_66,E_B_HOS_C1_19,D_1_HOS_C6_40,B_1_C26_94,C_1_C6_73,S2_1_C2_7,B_1_C26_32,D_5_HOS_C6_56,D_4_HOS_C1_53,B_1_C26_62,C_1_C6_69,S3_3_C6_7,B_1_C22_54,S3_1_C11_24,D3_IPF_C3_55,S3_1_C11_21,D_5_HOS_C4_98,B_1_C21_116,A_C6_44,D_4_IPF_C11_76,D3_IRF_C2_31,D_4_SNF_C11_56,D_4_HOS_C2_70,D_4_IPF_C11_75,B_2_C26_66,S2_1_C2_1516,B_1_C0_116,B_1_C0_193,C_1_C5_112,D_5_HOS_C4_91,B_2_C26_40,D3_HOS_C3_53,RPT_STUS_CD,S10_C3_21,D3_HOS_C2_61,C_1_C6_62,B_1_C0_68,B_1_C22_45,C_1_C5_53,S3_2_C6_12,B_1_C21_112,D3_IRF_C3_70,A_C6_35,C_1_C5_99,B_1_C26_117,D_5_HOS_C6_59,D_5_HOS_C5_74,D_5_HOS_C3_60,C_1_C6_4501,S3_1_C2_7,G_C1THRU4_38,S2_1_C1_36,D_5_HOS_C3_58,B_2_C26_76,S2_1_C2_1805,B_1_C21_30,C_1_C6_75,D_4_HOS_C3_54,D_4_IRF_C11_74,S3_1_C3_12,D3_SNF_C3_64,S3_1_C7_9,A7_3_C10_2,A7_1_C2_3,B_1_C22_52,S3_1_C11_19,A8_C2_7,D_4_HOS_C12_67,S2_1_C2_11801,A_C1_20,D3_SNF_C3_94,S3_2_C4_35,D_5_HOS_C5_71,C_1_C6_34,A_C6_98,D_4_HOS_C11_50,D_4_HOS_C3_55,D_4_HOS_C4_72,D3_HOS_C3_65,A_C2_2,D_4_IPF_C11_63,D3_IRF_C3_96,C_1_C6_93,B_1_C0_71,S10_C1_30,S10_C3_20,C_1_C7_94,D_5_HOS_C5_60,S5_C2_21,S2_1_C2_1519,D_4_IRF_C11_53,S3_2_C4_21,D_5_HOS_C6_61,D_4_HOS_C3_62,D1_HOS_C1_53,S2_1_C1_142,S3_1_C2_14,D1_IRF_C1_27,B_1_C21_54,D1_HOS_C1_51,B_2_C26_75,A_C6_88,C_1_C5_71,D_5_HOS_C7_6250,D4_INTESTINE_C1_69,D_5_HOS_C6_65,A7_1_C1_8,S3_1_C8_25,A_C1_4201,S2_1_C1_35,D1_HOS_C5_44,D3_IPF_C2_35,A_C1_51,A_C6_9910,A_C2_5,D_5_HOS_C3_75,S3_2_C6_7,D_4_HOS_C4_71,D_5_HOS_C7_66,B_1_C22_88,S3_3_C5_6,B_1_C22_69,B_1_C0_88,E_B_HOS_C101_3,E_B_HOS_C1_44,S2_1_C2_13,B_1_C0_56,A_C6_40,A_C2_55,A_C6_14,C_1_C6_96,D_1_HOS_C4_34,D_4_HOS_C11_63,S3_2_C5_42,D_4_HOS_C13_64,D3_HOS_C2_55,S3_2_C4_43,D_4_SNF_C11_93,D_4_HOS_C13_57,S3_2_C5_1,D_4_SNF_C11_60,A_C6_73,B_1_C22_74,S3_2_C5_6,B_1_C0_93,D_5_HOS_C7_72,D_5_HOS_C3_53,D_4_HOS_C12_50,C_1_C6_109,S5_C1_10,D_4_IPF_C11_70,D3_IPF_C3_50,D_4_HOS_C10_9201,D3_IPF_C2_55,B_1_C21_105,B_1_C22_100,A_C2_69,B_1_C26_112,B_1_C22_99,S3_3_C4_4,A_C2_4,D_4_HOS_C11_67,G3_C1_1,B_2_C26_191,S2_1_C7_3,S5_C2_6,E_B_HOS_C1_3998,S3_1_C8_1,A7_1_C2_4,B_1_C26_9910,B_2_C26_45,D_4_IPF_C13_70,G_C1THRU4_17,A7_1_C5_10,D3_IRF_C2_69,C_1_C5_106,D_4_HOS_C10_63,D_4_SNF_C13_73,S4_HHA1_C3_36,D1_HOS_C1_55,D_5_HOS_C6_200,A7_1_C5_1,B_1_C21_31,E_B_HOS_C101_4,D3_HOS_C2_58,C_1_C5_67,G2_C1_28,D3_HOS_C2_68,D_4_IPF_C11_72,D_4_IPF_C13_51,B_1_C0_95,A_C1_4,D_5_HOS_C3_95,C_1_C7_107,S5_C1_12,A_C2_116,S3_2_C4_27,D_5_HOS_C4_94,S3_2_C2_14,B_1_C21_100,S2_1_C2_143,D_4_HOS_C13_50,S10_C1_31,D_4_HOS_C12_59,A_C6_23,A_C6_9930,C_1_C6_9940,C_1_C5_97,D3_IPF_C2_56,D3_IRF_C3_64,S3_3_C4_3,S3_1_C6_7,S2_1_C2_1608,S3_1_C2_17,S5_C1_3,C_1_C7_51,D_4_IPF_C11_51,A_C1_190,B_1_C26_54,B_1_C22_106,D_1_HOS_C6_30,S10_C1_11,B_1_C22_55,D_4_SNF_C11_64,S3_2_C4_31,D_5_HOS_C5_98,C_1_C7_61,S3_2_C2_32,B_2_C26_60,A_C2_114,S2_1_C1_3,A_C2_16,A_C6_97,S3_1_C8_24,B_2_C26_9201,A_C1_9910,C_1_C5_64,B_1_C26_191,S2_1_C2_1607,S2_1_C1_1,S10_C1_14,B_1_C21_93,C_1_C5_6250,D_1_HOS_C4_32,D1_HOS_C1_49,S3_1_C8_26,A_C6_106,S4_HHA1_C5_38,C_1_C5_52,D3_SNF_C2_35,S10_C1_15,B_1_C0_9920,S3_1_C11_20,S3_2_C5_29,S10_C1_3,A_C2_71,D_5_HOS_C6_93,D3_IRF_C3_65,B_1_C0_21,S3_2_C5_9,C_1_C5_108,D_4_IRF_C13_57,C_1_C5_94,E_B_HOS_C1_26,D_4_IRF_C13_91,S3_2_C5_27,A_C2_14,D_4_IPF_C11_90,D_4_HOS_C13_90,D3_SNF_C3_66,S2_1_C2_128,B_1_C26_9930,A7_1_C4_7,C_1_C5_42,C_1_C5_30,B_1_C21_57,D_5_HOS_C2_93,B_1_C21_45,C_1_C5_96,B_1_C26_34,S3_2_C4_1601,D3_SNF_C3_55,S3_1_C4_7,S3_1_C8_9,D_4_HOS_C11_52,D_5_HOS_C5_65,S10_C1_20,A_C1_66,B_1_C22_41,B_1_C22_105,S2_1_C2_1,A8_C2_10,B_1_C26_57,B_1_C0_101,B_1_C21_35,G_C1THRU4_40,S3_1_C5_16,C_1_C5_73,A_C2_42,D_5_HOS_C6_91,A_C2_100,E_B_HOS_C1_13,S2_1_C2_1201,D_5_HOS_C2_200,D_5_HOS_C3_200,E_B_HOS_C1_4001,D_4_HOS_C4_90,D_5_HOS_C2_58,D_4_HOS_C12_51,D3_HOS_C2_6250,D_4_HOS_C3_65,D3_IPF_C2_65,D3_IPF_C2_6250,S3_2_C4_18,A_C6_16,B_2_C26_42,D_4_HOS_C11_69,S3_2_C4_13,D_4_IPF_C13_50,A8_C2_4,B_1_C26_97,D3_IRF_C3_67,D1_HOS_C5_46,E_A_HOS_C1_59,S3_2_C2_28,D_4_IPF_C11_57,D_4_HOS_C11_72,S2_1_C2_1804,C_1_C5_50,A7_1_C5_4,S3_2_C5_38,A_C2_46,D_5_HOS_C5_54,C_1_C5_4501,S10_C1_13,S3_1_C11_26,D_4_IRF_C11_50,D_5_HOS_C2_97,D_4_HOS_C12_70,D_3_HOS_C9_44,A_C2_73,E_B_HOS_C1_30,B_2_C26_52,S2_1_C2_1809,D_5_HOS_C3_94,D3_HOS_C3_66,D_4_HOS_C3_53,D_4_HOS_C4_75,B_1_C21_190,D_1_HOS_C6_34,G3_C1_29,D3_HOS_C2_50,B_1_C0_8,B_1_C0_31,D3_SNF_C2_202,D_4_HOS_C12_200,FI_CREAT_DT,A_C2_109,D_4_HOS_C10_68,D3_SNF_C2_91,C_1_C7_60,A7_1_C7_10,S5_C5_1,D_5_HOS_C4_75,B_1_C22_59,E_B_HOS_C101_8,C_1_C5_9201,D_5_HOS_C2_69,B_2_C26_64,D_5_HOS_C4_68,D3_SNF_C2_60,D_4_IPF_C13_60,A_C1_21,B_1_C22_64,S4_HHA1_C2_33,S3_2_C4_14,A_C2_31,D_4_SNF_C11_58,E_B_HOS_C1_16,B_1_C26_91,A_C2_99,S2_1_C2_1508,B_1_C26_30,D_4_HOS_C2_63,D_4_HOS_C12_63,S4_HHA3_C4_33,S5_C2_8,E_B_HOS_C1_6,B_1_C26_66,B_2_C26_193,S5_C2_10,C_1_C7_59,D_4_HOS_C13_59,S4_HHA2_C5_33,D1_HOS_C1_62,A_C2_32,D_5_HOS_C3_61,D1_HOS_C1_52,A_C2_68,A7_1_C7_1,B_1_C0_12,B_2_C26_74,B_2_C26_44,S2_1_C2_132,B_1_C0_99,D3_IPF_C3_56,D_5_HOS_C5_63,A7_1_C2_5,D_4_HOS_C13_52,D_5_HOS_C3_70,S10_C1_6,D_5_HOS_C6_66,A_C6_68,B_1_C0_32,D_4_IPF_C11_91,A8_C2_26,D3_HOS_C2_57,A7_1_C3_4,D_4_IRF_C13_73,D3_IRF_C3_76,D_5_HOS_C6_55,C_1_C7_111,S3_1_C7_8,S4_HHA2_C2_33,S2_1_C2_1513,B_1_C0_30,D3_IPF_C3_52,D_3_HOS_C9_33,B_1_C26_43,E_B_HOS_C101_5,B_1_C0_7,D_5_HOS_C5_51,D_5_HOS_C5_90,S10_C1_16,B_1_C0_53,UTIL_CODE,D_4_HOS_C10_73,B_1_C0_1,S3_2_C6_9,D_4_SNF_C11_74,A_C1_33,S3_1_C14_1,S3_2_C4_2,A8_C2_22,C_1_C7_70,D3_IPF_C2_53,D3_IRF_C3_61,A_C1_6250,FY_END_DT,S3_2_C2_29,D_4_HOS_C11_74,D_5_HOS_C4_200,B_1_C0_35,D3_HOS_C3_90,S3_2_C3_2553,D_4_SNF_C11_71,FI_NUM,D_4_HOS_C13_65,D3_IRF_C2_54,B_1_C22_62,D_4_HOS_C10_91,B_2_C26_50,D3_SNF_C2_76,S3_2_C3_23,C_1_C5_66,S3_3_C6_4,D_5_HOS_C7_76,C_1_C5_32,S3_3_C4_1,A8_C2_16,S3_2_C4_5,D_4_IPF_C13_74,S4_HHA2_C5_38,C_1_C6_54,A_C6_6250,D_4_HOS_C1_91,C_1_C5_76,A8_C2_21,D_4_HOS_C2_52,A8_C2_15,S4_HHA2_C3_34,S3_1_C2_27,D_4_HOS_C12_54,D3_HOS_C3_200,G3_C1_2,S3_1_C3_18,D_4_HOS_C10_50,D_5_HOS_C3_6250,D_4_HOS_C2_74,S3_1_C7_18,D3_IPF_C3_71,C_1_C7_98,S5_C5_2,A_C6_113,B_1_C0_18,D3_SNF_C2_54,B_1_C26_96,G_C1THRU4_3,A_C2_9930,D_4_IPF_C11_58,B_1_C21_60,A_C6_1,B_1_C26_88,S3_1_C2_8,S3_1_C12_1,S3_2_C2_31,D_3_HOS_C9_31,D_4_HOS_C1_200,S3_1_C5_17,D_4_HOS_C11_93,D3_SNF_C2_56,D3_SNF_C3_90,B_2_C26_51,D_4_SNF_C11_65,B_1_C26_90,D_5_HOS_C2_55,D1_SNF_C1_85,B_2_C26_41,S3_1_C13_16,D_4_HOS_C3_66,D_5_HOS_C7_63,ST_CTY_CD,D_4_IPF_C11_54,D3_IPF_C2_90,B_1_C22_35,A_C2_18,S3_2_C4_23,A_C2_19,B_2_C26_97,D_4_HOS_C4_59,S2_1_C2_1512,A_C1_191,D3_HOS_C3_76,S3_1_C8_28,A_C6_96,E_B_HOS_C1_25,B_1_C21_41,S4_HHA3_C1_36,D_4_IPF_C11_56,D_5_HOS_C5_55,D_4_IRF_C13_64,B_1_C26_9920,D_5_HOS_C2_54,C_1_C6_56,D_4_HOS_C4_93,A_C6_4501,A_C2_111,D_4_IPF_C13_200,D_1_HOS_C7_40,B_1_C26_105,B_1_C0_62,S3_1_C3_14,C_1_C7_106,S10_C3_22,D_4_SNF_C11_70,D3_IRF_C2_9201,D3_IPF_C2_42,C_1_C6_76,S3_1_C9_19,A_C6_21,D3_IPF_C2_70,B_1_C0_33,D3_IRF_C2_70,S3_1_C15_21,C_1_C6_9201,S3_2_C2_39,S3_2_C4_42,FY_BGN_DT,D_4_IPF_C11_9201,A_C6_76,B_1_C26_6250,G_C1THRU4_51,B_1_C0_6250,D_4_IRF_C11_69,D_4_HOS_C4_54,A7_3_C15_3,C_1_C7_101,S3_1_C2_2001,A_C6_200,D3_SNF_C2_58,D_4_IRF_C11_57,A_C6_69,D3_IRF_C2_65,D_4_IRF_C11_68,A_C6_42,D3_IRF_C2_64,D3_IPF_C2_91,D_5_HOS_C6_70,E_B_HOS_C1_12,S2_1_C2_1514,D3_SNF_C3_65,C_1_C5_60,B_1_C21_21,C_1_C6_66,S4_HHA1_C4_35,D_4_HOS_C4_52,A_C1_69,D3_SNF_C2_74,D_1_HOS_C6_32,D_4_HOS_C11_57,A_C2_190,D_4_HOS_C3_74,E_B_HOS_C1_36,C_1_C6_116,S5_C4_4,B_1_C0_17,D3_IPF_C2_74,D3_IRF_C2_57,D_4_HOS_C13_54,D_4_HOS_C12_62,D_5_HOS_C6_51,S2_1_C3_11801,C_1_C2_68,A_C1_89,D1_IRF_C1_50,C_1_C6_94,D3_IRF_C2_55,A_C2_33,S3_2_C6_32,B_1_C21_55,D_4_HOS_C13_200,S3_1_C13_14,B_1_C22_101,D_4_HOS_C4_76,D3_SNF_C3_91,D_4_HOS_C13_9201,D3_HOS_C3_51,D_4_IRF_C11_64,D3_HOS_C3_72,D_1_HOS_C4_30,D_5_HOS_C4_96,D3_IRF_C2_68,D_4_HOS_C3_93,S3_3_C2_2,C_1_C7_75,S5_C1_21,S2_1_C2_1509,C_1_C5_110,D_5_HOS_C4_64,A_C6_192,S2_1_C1_145,D_4_HOS_C3_59,S3_2_C2_20,D_5_HOS_C4_55,D_4_HOS_C3_9201,C_1_C7_115,B_1_C26_58,D_1_HOS_C6_41,D3_HOS_C3_50,A_C6_9,S3_2_C4_37,D3_SNF_C3_67,A8_C2_33,S3_1_C8_12,D_4_HOS_C2_57,S3_1_C7_7,D_5_HOS_C4_72,B_1_C26_101,C_1_C5_200,D3_HOS_C3_59,D3_IRF_C2_76,D_5_HOS_C6_94,S3_1_C12_16,C_1_C6_110,D_5_HOS_C5_73,G_C1THRU4_2,S4_HHA2_C5_36,A_C6_107,A_C1_18,S3_2_C5_12,S3_1_C10_26,S3_2_C4_1402,S2_1_C1_5,A7_1_C7_4,S3_1_C8_11,D_4_IPF_C13_63,D_4_IPF_C11_59,D_4_IPF_C11_200,S3_2_C4_30,S3_1_C7_6,D3_HOS_C2_93,D3_IPF_C3_58,B_1_C21_91,S2_1_C2_1522,D_5_HOS_C2_75,B_2_C26_6250,A_C2_74,B_1_C0_192,D3_IPF_C3_90,A_C6_20,A8_C2_9,S2_1_C2_1505,S3_2_C2_35,D_5_HOS_C7_54,D_4_IRF_C13_72,B_1_C0_65,B_2_C26_56,S4_HHA3_C1_34,S3_1_C7_2,D_4_IPF_C13_57,D_4_SNF_C11_9201,D3_HOS_C3_62,D_4_HOS_C2_9201,D3_IPF_C3_68,D3_IRF_C3_94,G_C1THRU4_37,D_4_IRF_C11_55,D3_SNF_C3_50,B_1_C21_43,D_4_SNF_C11_72,S3_2_C6_11,D_5_HOS_C6_64,C_1_C6_40,D_5_HOS_C3_54,S3_1_C8_10,D_4_HOS_C12_71,B_1_C21_95,S2_1_C2_10,A_C1_60,C_1_C6_51,E_B_HOS_C1_17,D3_IRF_C2_75,C_1_C6_57,D_4_HOS_C2_65,A8_C2_20,C_1_C5_31,S3_1_C9_22,A_C2_115,A_C1_5,B_1_C21_58,S4_HHA2_C4_38,B_2_C26_108,D_5_HOS_C5_72,C_1_C7_64,D_4_SNF_C13_200,D_1_HOS_C7_31,B_1_C21_46,D3_IRF_C3_57,C_1_C6_98,D_4_HOS_C4_50,D_4_HOS_C2_54,S10_C1_10,B_1_C21_66,A7_3_C7_3,S3_1_C7_32,S3_2_C5_3,S4_HHA1_C3_35,D_4_IRF_C13_76,S3_2_C4_15,B_1_C0_9940,B_1_C0_115,B_2_C26_33,A7_1_C1_5,B_2_C26_9930,B_1_C26_116,S3_1_C7_15,D3_HOS_C3_96,S2_1_C1_126,S3_1_C13_18,S3_2_C2_8,S3_2_C4_2552,B_1_C26_67,A_C2_6,S3_1_C2_16,B_1_C21_42,S3_1_C3_19,A8_C2_6,D_5_HOS_C5_62,D3_IPF_C3_57,B_1_C22_76,S2_1_C1_56,S3_1_C4_12,D3_IRF_C2_90,B_1_C0_15,D_4_IRF_C13_66,S3_3_C6_1,A_C6_61,D_4_HOS_C2_53,S5_C1_1,A_C2_20,D_4_HOS_C10_71,D_5_HOS_C5_67,D_4_HOS_C13_67,C_1_C5_33,B_2_C26_4501,B_2_C26_62,C_1_C5_69,B_1_C26_193,D3_IPF_C2_96,S10_C1_2,S3_1_C5_10,S3_2_C6_1401,D_4_IPF_C11_68,D3_IPF_C2_54,D3_IRF_C3_98,S2_1_C2_1601,A_C2_65,A_C1_194,B_1_C22_40,B_1_C0_66,S2_1_C1_3601,B_1_C26_73,D3_IRF_C2_91,S3_1_C6_16,A_C6_5,B_2_C26_63,D3_HOS_C3_63,S3_2_C4_12,D3_HOS_C3_52,C_1_C6_45,D1_IPF_C1_53,A_C2_22,D3_IRF_C2_61,S3_2_C6_27,E_B_HOS_C1_40,A_C1_200,A_C6_116,C_1_C7_109,S3_1_C7_13,S3_2_C2_1,A7_1_C2_8,A_C1_94,D_4_IPF_C6_200,G_C1THRU4_48,D3_HOS_C3_56,D_5_HOS_C2_6250,B_1_C0_91,B_1_C22_117,A7_1_C7_5,S2_1_C2_1523,B_1_C0_109,B_1_C26_44,A8_C2_29,S10_C2_23,D3_IRF_C3_59,S5_C3_3,D_4_HOS_C10_57,S4_HHA2_C4_35,S3_2_C4_4,S3_1_C2_18,C_1_C6_35,C_1_C5_56,E_B_HOS_C1_5,D_4_HOS_C3_68,D_4_HOS_C11_62,S5_C1_2,C_1_C6_64,B_1_C26_50,C_1_C7_202,A_C2_51,D3_HOS_C2_31,S3_2_C2_21,A_C6_17,C_1_C3_202,D3_SNF_C2_98,S3_1_C3_20,A_C6_194,B_1_C21_194,B_2_C26_58,B_1_C0_194,S3_2_C3_2551,D_5_HOS_C3_71,S3_2_C4_34,C_1_C5_4201,S2_1_C2_8,D3_IPF_C3_63,A_C6_89,S2_1_C1_2,A_C1_45,D1_HOS_C1_48,A8_C2_11,S3_1_C7_22,D3_IRF_C3_91,S3_2_C6_26,A_C1_192,D3_SNF_C2_51,S2_1_C1_129,D_4_HOS_C10_59,S2_1_C1_144,S2_1_C1_38,D_1_HOS_C4_35,D_4_IRF_C11_51,S3_2_C6_6,S10_C1_2701,S3_1_C10_22,A_C6_110,D3_SNF_C2_69,D3_IRF_C2_72,A_C2_9920,B_1_C21_63,S3_1_C4_14,S3_2_C2_4,A_C6_75,B_1_C0_52,A_C6_65,D_5_HOS_C4_57,S3_2_C5_33,B_1_C0_41,D_4_HOS_C13_74,C_1_C6_9910,B_1_C22_50,S3_1_C5_1,D_4_HOS_C3_96,D_4_HOS_C11_94,S3_2_C6_3,B_1_C0_46,D3_SNF_C2_94,D_4_HOS_C1_73,C_1_C7_112,S10_C1_21,G_C1THRU4_53,A7_3_C9_2,A_C1_41,C_1_C5_201,A_C2_11,D_4_HOS_C13_68,D_4_HOS_C10_75,D3_HOS_C3_9201,S4_HHA2_C3_33,D_4_HOS_C10_72,S4_HHA1_C1_34,D_4_HOS_C3_98,D3_SNF_C2_70,A_C6_7,D3_HOS_C3_91,A_C2_88,D3_IPF_C2_68,D3_HOS_C2_71,D1_HOS_C1_57,C_1_C7_9201,A_C1_73,D_4_IPF_C13_65,S3_2_C6_4,C_1_C6_99,A_C6_6,D_5_HOS_C3_73,A_C2_60,A7_3_C6_1,C_1_C5_57,B_1_C22_68,S3_1_C7_1,C_1_C6_90,C_1_C6_43,A8_C2_13,S3_1_C3_9,B_1_C0_9910,B_2_C26_69,D_4_IRF_C13_54,A_C1_9201,S3_2_C4_33,S3_2_C2_1402,B_1_C26_108,D_4_HOS_C3_70,S3_1_C8_19,A7_3_C15_1,S4_HHA1_C4_33,B_1_C0_61,S3_1_C9_26,D3_IPF_C2_66,D3_HOS_C3_58,B_1_C22_94,C_1_C6_115,S2_1_C1_134,D3_IRF_C3_71,S3_2_C4_32,C_1_C6_67,D_3_HOS_C8_200,D_5_HOS_C7_90,D_5_HOS_C2_76,D3_HOS_C2_41,S2_1_C1_27,D_4_IPF_C13_71,A_C6_95,C_1_C7_58,A_C1_53,D3_HOS_C3_69,D_5_HOS_C4_65,S2_1_C3_2,B_1_C22_32,S3_1_C4_8,E_B_HOS_C1_43,D_5_HOS_C5_76,D3_SNF_C2_66,A_C1_44,S3_1_C10_18,A_C6_64,A_C6_109,C_1_C7_72,D1_IRF_C1_51,C_1_C6_108,A_C6_10,D3_HOS_C2_54,D_4_IRF_C13_60,B_2_C26_94,A_C2_23,D_4_HOS_C11_51,S3_1_C5_11,A_C6_94,D_4_HOS_C12_93,D3_SNF_C2_34,S3_2_C5_2,A7_1_C2_2,S5_C6_4,A_C2_117,C_1_C7_9930,D_4_IRF_C13_51,D_4_IRF_C11_91,A_C1_91,D3_IPF_C3_96,B_1_C0_5,S2_1_C2_1510,D_4_HOS_C11_76,D_4_SNF_C11_54,A_C6_101,S3_2_C2_30,D3_HOS_C2_62,D_4_HOS_C2_62,B_1_C0_59,G_C1THRU4_1,S3_2_C2_17,B_2_C26_32,S2_1_C1_132,D_4_HOS_C1_76,D_4_HOS_C10_76,D_4_IPF_C13_59,D3_SNF_C2_63,D3_IRF_C2_66,D3_IPF_C3_74,S3_2_C6_35,B_1_C22_42,A_C1_43,D_4_HOS_C2_58,D3_IPF_C2_69,S3_1_C2_10,D_4_IRF_C13_70,C_1_C6_89,D_5_HOS_C7_93,B_2_C26_116,D_5_HOS_C5_70,C_1_C6_91,S3_2_C5_16,B_2_C0_202,D_4_IRF_C13_71,S2_1_C1_93,S3_1_C11_25,D_4_HOS_C10_56,C_1_C5_41,S3_2_C3_25,S3_1_C10_14,D_4_HOS_C2_69,S2_1_C1_127,D_4_IPF_C13_55,D_4_IPF_C13_9201,E_B_HOS_C1_23,D3_IPF_C3_75,S3_1_C2_12,D1_IPF_C1_50,S2_1_C1_4,S3_1_C8_13,A_C2_3,A_C2_76,D_3_HOS_C9_30,D3_HOS_C2_35,D1_HOS_C1_27,S2_1_C6_24,S2_1_C2_3801,D3_IPF_C2_75,D3_HOS_C2_9201,B_1_C26_75,D_4_IRF_C11_59,D_4_HOS_C2_75,D_4_HOS_C4_65,S3_2_C4_1401,D_5_HOS_C6_73,S3_1_C7_20,C_1_C7_93,A_C6_117,B_1_C26_63,S3_3_C2_4,C_1_C6_88,D3_IRF_C3_93,S2_1_C2_1520,D_4_IPF_C13_73,S10_C1_19,S4_HHA2_C2_35,A_C6_112,D_4_IPF_C1_200,B_1_C21_191,S3_3_C6_6,S3_1_C14_18,B_1_C26_52,C_1_C7_9910,D_4_HOS_C10_96,S3_2_C6_28,D_4_HOS_C10_54,S2_1_C2_17,S4_HHA3_C5_35,B_1_C0_108,A_C6_71,D3_IRF_C2_98,D3_IPF_C2_64,A_C6_52,D_4_IPF_C11_69,D_4_IPF_C11_74,S2_1_C1_86,B_1_C26_35,S2_1_C1_24,D_5_HOS_C6_76,D_5_HOS_C7_50,D3_HOS_C2_94,S5_C4_2,A_C1_67,G_C1THRU4_46,D3_IRF_C3_90,D_5_HOS_C2_63,S3_1_C2_32,S3_2_C3_22,S3_2_C5_7,B_2_C26_35,B_2_C26_9920,D_5_HOS_C3_65,D_5_HOS_C2_73,S3_1_C15_16,S5_C1_7,A_C1_10,A8_C2_14,G_C1THRU4_8,A7_1_C5_3,C_1_C5_88,A_C1_16,A_C6_33,A_C1_101,B_1_C22_91,D_4_HOS_C4_67,A_C1_62,D_4_HOS_C11_71,S3_1_C4_1,D_4_HOS_C4_68,B_1_C0_55,S2_1_C2_36,B_1_C0_2,D_4_HOS_C4_55,D_4_HOS_C12_72,D3_HOS_C2_73,A7_1_C1_4,S4_HHA2_C4_33,D_4_HOS_C3_90,C_1_C5_61,S3_1_C6_1,D3_HOS_C2_64,E_B_HOS_C1_21,A_C2_54,S5_C1_5,D_5_HOS_C3_91,D_5_HOS_C6_90,S3_1_C3_1,S2_1_C2_1511,S2_1_C2_126,S3_1_C5_13,B_1_C0_96,B_2_C26_43,A_C6_93,B_2_C26_90,D_3_HOS_C3_200,D3_HOS_C2_65,B_2_C26_110,B_1_C0_44,S4_HHA1_C5_36,A_C6_51,A_C1_114,D3_HOS_C2_98,B_1_C22_192,G_C1THRU4_13,C_1_C6_105,S3_1_C2_20,S3_1_C3_16,D_4_IRF_C11_90,B_1_C21_108,A_C2_59,D_5_HOS_C7_67,B_1_C22_72,A_C2_113,A_C1_74,D3_IRF_C3_50,D3_IPF_C2_51,D3_SNF_C2_72,B_1_C0_69,D_4_HOS_C12_90,D_5_HOS_C7_74,A8_C2_27,A_C2_15,S4_HHA1_C5_35,D_4_HOS_C13_60,A7_1_C1_1,E_B_HOS_C1_29,E_B_HOS_C1_31,S3_1_C8_20,B_1_C0_9,D_4_HOS_C2_73,D_5_HOS_C3_96,D3_IPF_C3_67,C_1_C5_58,B_1_C26_95,D_5_HOS_C4_67,S3_2_C2_37,D_4_HOS_C10_60,A_C2_94,D3_HOS_C2_30,A7_3_C6_3,A_C2_91,A_C1_109,B_1_C21_33,D_4_HOS_C2_98,A_C1_117,S3_2_C6_37,D_4_IRF_C13_75,S5_C1_11,D_1_HOS_C7_32,B_1_C21_9201,B_1_C21_89,S3_1_C13_1,A_C2_108,S3_2_C2_13,D_5_HOS_C4_62,S4_HHA2_C5_37,D_5_HOS_C3_9201,S3_2_C2_15,A_C6_72,S3_1_C15_18,S3_2_C6_8,D_4_HOS_C10_98,D3_IRF_C2_67,S3_1_C6_25,D1_IRF_C1_48,D_5_HOS_C2_90,D3_IRF_C3_73,D3_IPF_C3_53,D_1_HOS_C4_40,RPT_REC_NUM,A7_3_C10_1,A7_3_C11_1,D3_IRF_C2_34,D_5_HOS_C2_96,D3_SNF_C2_62,D_5_HOS_C5_75,A7_3_C5_3,D_4_SNF_C11_200,A_C1_13,D3_IRF_C3_52,E_B_HOS_C1_42,A_C1_4501,B_2_C26_53,D_4_IRF_C11_62,B_2_C26_98,B_2_C26_72,A_C1_9940,A_C6_11,C_1_C6_31,D_3_HOS_C9_41,A_C1_64,D_1_HOS_C4_4201,B_1_C0_58,C_1_C7_110,D3_IPF_C2_62,C_1_C6_117,S4_HHA3_C2_33,D_1_HOS_C6_33,D3_IPF_C3_65,D3_IRF_C3_60,B_1_C22_43,D_4_HOS_C11_59,A_C1_58,A_C6_53,B_1_C22_109,S4_HHA3_C5_37,D3_SNF_C3_51,B_1_C21_192,D_5_HOS_C5_200,D3_IPF_C3_91,S10_C2_20,E_B_HOS_C1_7,S4_HHA1_C4_34,D_5_HOS_C4_54,A8_C2_8,D_5_HOS_C7_53,D_4_IRF_C6_200,D_4_HOS_C11_75,S3_2_C6_15,S4_HHA2_C5_34,A_C1_23,D_1_HOS_C6_35,D_4_HOS_C10_62,D1_IPF_C1_49,S3_1_C9_21,A7_1_C3_7,A_C6_9920,S2_1_C2_1402,A_C1_99,B_1_C0_6,B_1_C21_75,C_1_C7_6250,S3_1_C13_17,D_5_HOS_C6_95,D_4_HOS_C12_56,A_C2_97,C_1_C5_107,S3_1_C5_19,D_4_SNF_C11_91,B_1_C22_71,S3_3_C6_5,D3_HOS_C2_34,C_1_C7_95,S3_1_C12_14,A_C1_97,D_4_HOS_C11_66,B_1_C21_94,A7_1_C3_10,D_5_HOS_C3_56,A_C2_9910,E_B_HOS_C1_14,S3_1_C6_32,A_C6_4201,D_4_IPF_C11_93,A_C2_30,S3_1_C7_14,D_5_HOS_C6_74,A_C6_2,B_1_C26_194,D_5_HOS_C2_91,D_4_HOS_C11_65,B_1_C26_100,S2_1_C2_1202,S2_1_C1_26,B_1_C22_110,S2_1_C1_140,S4_HHA1_C4_38,S3_1_C5_14,D3_SNF_C2_93,D_4_IRF_C13_63,C_1_C6_97,D_5_HOS_C6_96,S3_2_C5_15,S3_2_C6_14,C_1_C7_88,A8_C2_24,D_5_HOS_C5_59,C_1_C7_69,S3_2_C2_3,B_2_C26_31,C_1_C5_98,D_1_HOS_C4_200,D_5_HOS_C5_57,B_1_C0_10,B_1_C26_60,D_5_HOS_C3_51,B_1_C0_50,D_4_HOS_C4_88,C_1_C5_65,B_1_C21_115,D_4_HOS_C13_72,B_2_C26_9940,S3_2_C2_2552,D_4_HOS_C13_75,S2_1_C2_140,E_A_HOS_C1_7093,G_C1THRU4_47,D_5_HOS_C4_93,D_5_HOS_C3_97,A8_C2_50,D3_HOS_C2_42,B_1_C26_65,B_1_C26_93,D_5_HOS_C4_6250,S3_1_C8_15,S3_1_C5_8,S3_1_C7_12,A_C6_193,B_1_C0_106,A_C1_68,D3_SNF_C2_96,A_C1_72,S3_2_C4_28,A_C6_15,D3_SNF_C3_68,A_C6_13,D_4_HOS_C3_56,B_1_C0_73,B_1_C0_111,S3_1_C7_26,D_4_HOS_C2_60,D_4_HOS_C13_69,S2_1_C2_18,B_1_C22_66,S4_HHA1_C2_34,B_1_C21_62,B_1_C22_31,A7_3_C9_3,A_C1_93,A_C6_59,A7_3_C7_2,D3_IPF_C3_54,B_2_C26_73,A_C1_9,A_C1_193,D_5_HOS_C7_64,C_1_C5_91,D_4_IRF_C13_59,A8_C2_31,S2_1_C1_115,A_C1_108,A_C2_35,C_1_C6_72,D_1_HOS_C4_31,D_4_IRF_C11_65,D3_SNF_C3_98,B_1_C0_34,S3_1_C9_27,S5_C3_1,A7_1_C3_5,A_C6_99,D_4_HOS_C3_72,D_5_HOS_C6_58,C_1_C5_72,D3_IRF_C3_9201,S3_2_C2_2553,S3_2_C4_20,B_2_C26_96,E_B_HOS_C1_10,G_C1THRU4_6,S3_2_C4_17,A7_1_C5_7,S2_1_C2_1806,S3_2_C4_2201,D_4_HOS_C11_68,A_C1_59,G3_C1_28,D3_IRF_C3_54,D3_SNF_C2_9201,A_C2_44,D3_SNF_C3_75,C_1_C5_54,B_1_C0_4,S3_1_C3_7,S3_1_C5_9,D_5_HOS_C3_50,D_4_SNF_C11_59,C_1_C5_62,D1_HOS_C1_54,A_C1_42,D_4_HOS_C3_64,C_1_C5_59,S2_1_C2_3601,S2_1_C1_11801,B_1_C22_34,S3_2_C5_31,B_1_C26_76,D_4_IPF_C11_60,G_C1THRU4_12,A_C1_32,A_C6_63,A_C2_194,S2_1_C1_105,B_2_C26_71,D3_SNF_C3_96,A_C6_105,STATE,B_1_C22_73,S3_1_C11_14,D3_SNF_C2_73,S2_1_C2_5,D_5_HOS_C7_60,D_5_HOS_C7_65,B_1_C22_75,B_1_C0_4201,S3_1_C15_14,A_C2_63,A_C2_13,D3_IRF_C2_35,C_1_C6_61,S3_2_C3_14,S3_3_C2_1,D3_SNF_C3_76,D3_IRF_C2_74,S3_2_C2_40,S4_HHA3_C5_33,D_4_HOS_C11_9201,C_1_C7_65,D_5_HOS_C6_67,S3_1_C9_18,S3_1_C10_27,B_2_C26_111,S5_C3_6,D_5_HOS_C4_50,S3_1_C2_21,C_1_C6_68,B_1_C0_22,C_1_C5_105,D_4_IPF_C11_67,D_4_HOS_C3_97,S3_1_C14_17,D_4_HOS_C11_73,A8_C2_28,B_1_C0_75,S3_1_C6_29,D3_IPF_C2_57,S3_2_C5_8,S3_3_C4_7,D3_SNF_C3_56,A_C6_66,B_1_C22_191,D3_SNF_C3_74,S3_2_C6_41,D_5_HOS_C2_52,S3_2_C2_2550,A8_C2_18,D_5_HOS_C7_9201,B_1_C21_72,S3_2_C3_2201,S3_2_C5_40,B_2_C26_100,D3_SNF_C3_70,S3_1_C10_20,A_C1_95,S2_1_C1_128,B_1_C21_44,C_1_C6_95,D_5_HOS_C7_56,S5_C1_14,D_3_HOS_C9_35,D_4_HOS_C11_55,A_C1_70,A_C1_76,D_5_HOS_C5_52,C_1_C7_97,D_4_HOS_C12_96,A_C2_96,D_4_HOS_C3_52,C_1_C7_9920,D_4_SNF_C11_63,A_C6_43,S3_1_C4_9,A_C6_111,B_1_C21_117,A7_1_C2_1,A_C2_4201,B_1_C22_93,A_C6_12,D3_SNF_C2_55,D_5_HOS_C4_66,S3_2_C2_2201,D_4_IRF_C11_75,D3_IRF_C3_68,S2_1_C2_1517,B_1_C21_70,S10_C1_26,D3_IPF_C3_64,D_5_HOS_C2_74,D_1_HOS_C7_35,D3_HOS_C2_43,D_4_HOS_C10_93,MSA,S3_1_C5_12,B_2_C26_68,D_4_IRF_C13_90,D_4_HOS_C12_74,S10_C1_22,B_2_C26_88,S3_1_C10_25,D_5_HOS_C7_51,D1_HOS_C1_63,B_1_C21_193,C_1_C2_66,D_1_HOS_C7_200,D_5_HOS_C7_69,D3_SNF_C3_93,S3_2_C3_1402,A_C1_96,C_1_C5_89,S4_HHA3_C2_37,C_1_C5_117,D_4_IRF_C13_55,D_5_HOS_C3_74,S3_2_C2_19,D3_SNF_C2_75,D_1_HOS_C7_33,A_C6_91,A_C1_90,S3_1_C8_16,S3_2_C4_2553,B_1_C26_9940,E_A_HOS_C1_72,D1_IPF_C1_41,S3_1_C7_11,D3_IRF_C2_71,A_C2_62,B_2_C26_70,B_1_C22_65,S3_3_C5_4,S3_1_C4_10,S3_2_C4_40,D_5_HOS_C3_55,D3_SNF_C3_9201,D_4_HOS_C13_62,A_C1_98,B_1_C26_202,D_4_IRF_C11_76,C_1_C7_71,D3_IPF_C2_34,A_C6_31,D3_IPF_C2_50,G_C1THRU4_52,S3_1_C2_9,B_2_C26_106,S3_2_C6_34,D1_SNF_C1_74,D3_IPF_C2_33,A7_1_C6_7,D3_SNF_C2_30,A_C6_54,S3_2_C3_24,C_1_C6_100,D_4_IRF_C4_200,S3_1_C8_6,A8_C2_5,D_5_HOS_C2_62,D_5_HOS_C4_63,D1_SNF_C1_84,D3_SNF_C2_31,E_B_HOS_C101_2,E_B_HOS_C1_2,S3_2_C3_2550,D3_SNF_C3_52,A7_3_C10_3,A_C6_67,G_C1THRU4_4,S3_2_C4_2550,S4_HHA3_C3_33,B_1_C26_70,D3_HOS_C3_71,S10_C1_17,B_1_C26_4201,A7_3_C6_2,C_1_C5_9920,S3_1_C2_1801,A7_1_C3_2,D_4_HOS_C12_66,A_C6_30,B_1_C0_60,A_C1_52,B_2_C26_101,A_C2_57,D_4_SNF_C11_90,S3_3_C2_3,A_C1_17,S5_C3_2,B_1_C0_105,D3_IRF_C2_32,D_5_HOS_C7_62,A7_1_C3_3,A_C6_70,S2_1_C5_24,A7_1_C2_6,B_2_C26_194,D1_IPF_C1_51,S10_C1_18,S2_1_C3_24,S3_2_C2_42,D_5_HOS_C6_60,S2_1_C1_22,A_C1_40,B_1_C0_74,D_4_IRF_C11_9201,D_1_HOS_C4_41,D3_IPF_C2_94,S3_1_C4_11,D3_IPF_C3_73,S3_2_C4_39,S3_3_C5_7,D3_IPF_C3_200,A_C1_14,S3_1_C13_2,S3_2_C5_13,A7_1_C7_6,D_3_HOS_C9_32,S4_HHA2_C4_34,A7_1_C5_5,A7_1_C2_7,D_4_IRF_C13_62,S4_HHA2_C4_36,A_C6_34,S3_1_C8_22,D_5_HOS_C2_94,A_C1_9930,B_1_C0_90,B_1_C26_74,A_C2_45,D_4_IRF_C13_68,S5_C1_6,D3_IPF_C2_59,S2_1_C1_48,S3_2_C4_41,S3_1_C15_1,S3_1_C8_21,B_1_C26_56,S3_1_C6_9,D3_IRF_C2_94,B_1_C0_200,B_2_C26_67,A7_1_C3_1,A_C1_63,S4_HHA2_C1_34,S4_HHA1_C4_36,D3_IPF_C2_93,S10_C2_21,D3_HOS_C2_53,S4_HHA3_C4_36,C_1_C7_55,C_1_C5_45,B_1_C22_46,A7_3_C15_2,S2_1_C2_14,G_C1THRU4_15,B_1_C0_42,B_1_C21_109,D_4_IRF_C11_67,S4_HHA2_C3_35,B_2_C26_65,D_4_HOS_C10_67,S3_2_C5_28,D_4_HOS_C4_69,S5_C1_9,S3_1_C3_32,S4_HHA1_C1_38,A7_1_C5_2,B_2_C26_190,A_C1_34,B_1_C26_192,D_4_IPF_C13_69,D_4_HOS_C2_50,A_C6_57,S2_1_C1_125,S2_1_C3_3,A_C1_65,B_2_C26_112,S4_HHA2_C2_37,E_B_HOS_C101_6,S2_1_C2_24,D3_SNF_C2_68,G3_C1_26,C_1_C7_53,B_1_C26_107,S10_C1_1,C_1_C7_74,B_2_C26_59,D_5_HOS_C2_64,D_5_HOS_C5_68,D3_HOS_C2_90,D3_IPF_C2_200,B_1_C0_51,B_1_C21_88,A7_3_C7_1,D_4_SNF_C11_75,B_1_C26_68,B_2_C26_57,D_4_IPF_C11_55,A_C1_31,D_4_IPF_C13_93,E_B_HOS_C1_41,B_2_C26_117,S5_C2_2,S4_HHA2_C5_35,D_5_HOS_C4_58,S4_HHA1_C5_33,C_1_C6_70,E_B_HOS_C1_37,S3_2_C2_43,S3_2_C4_3,D3_IRF_C2_62,B_1_C22_51,S3_1_C3_17,D_1_HOS_C6_31,D_4_HOS_C11_90,C_1_C6_63,B_1_C0_43,A_C2_193,S3_3_C4_5,D3_HOS_C2_91,A_C2_95,D_4_HOS_C13_91,D_5_HOS_C5_66,S3_2_C2_10,D_4_IRF_C13_65,D_5_HOS_C2_50,S3_3_C6_2,A_C1_115,D_4_IRF_C13_93,B_2_C26_30,D1_SNF_C1_37,A_C1_55,B_1_C22_98,D3_SNF_C3_63,D_4_IPF_C13_56,D3_HOS_C3_60,D_5_HOS_C7_98,D_5_HOS_C6_50,S4_HHA1_C3_38,A_C6_41,D3_HOS_C2_67,D_1_HOS_C7_34,B_1_C26_201,S4_HHA3_C1_38,S3_2_C2_23,A_C2_21,D_5_HOS_C2_59,D_4_SNF_C11_67,B_1_C26_109,S2_1_C2_1515,C_1_C5_70,D_3_HOS_C2_200,D_4_HOS_C12_94,S3_2_C6_2,S3_1_C6_26,B_2_C26_201,S3_2_C6_13,S2_1_C1_143,D_5_HOS_C2_57,D_4_HOS_C12_98,D_5_HOS_C7_91,E_B_HOS_C1_4,B_1_C21_106,C_1_C5_40,S3_1_C8_17,D_4_HOS_C13_97,E_B_HOS_C1_18,S3_3_C2_6,A_C2_34,D3_HOS_C3_64,S3_1_C6_17,S4_HHA3_C5_38,S3_2_C5_36,S3_2_C4_8,C_1_C6_41,D_4_HOS_C10_66,A_C6_56,A_C6_9940,C_1_C5_9940,S2_1_C2_1606,S3_2_C6_16,D_4_IPF_C13_58,S2_1_C1_3801,S3_1_C6_19,D3_IPF_C2_40,A_C2_105,C_1_C7_96,A_C1_22,S3_1_C6_22,S4_HHA1_C2_37,B_1_C26_46,D_4_SNF_C11_62,D_5_HOS_C3_69,S4_HHA1_C5_37,A_C6_4,A_C2_1,D3_HOS_C2_69,D3_HOS_C2_74,B_1_C0_117,D1_HOS_C1_56,S2_1_C2_127,A_C2_112,B_1_C22_9201,A_C1_116,S3_3_C5_3,G2_C2_28,D1_HOS_C5_43,D3_IPF_C2_72,S2_1_C2_1506,S3_2_C6_38,C_1_C5_95,C_1_C7_52,S4_HHA3_C3_38,C_1_C8_202,C_1_C7_68,D_4_HOS_C13_66,A_C2_53,D_4_IPF_C13_53,D_5_HOS_C7_96,D_5_HOS_C7_52,D_5_HOS_C7_58,S2_1_C2_1801,B_1_C26_4501,S3_2_C5_37,D_5_HOS_C3_52,D3_IPF_C3_98,S3_2_C2_27,B_1_C26_41,D_5_HOS_C2_70,D_4_IPF_C13_91,D_4_IRF_C11_54,S3_1_C15_17,B_1_C21_50,D1_HOS_C1_50,D_4_HOS_C3_200,D_5_HOS_C3_64,D_4_IPF_C11_50,C_1_C6_71,D3_IPF_C2_71,S3_2_C6_10,A_C1_88,A_C1_11,S3_2_C5_10,D_4_IRF_C11_63,D1_IRF_C1_52,D_1_HOS_C6_200,D_4_HOS_C11_58,D_1_HOS_C7_30,D3_SNF_C3_72,A_C2_90,D_5_HOS_C4_9201,B_1_C26_42,D_5_HOS_C2_51,C_1_C5_34,S3_2_C2_2,S3_3_C4_6,G_C1THRU4_54,A_C6_8,B_1_C0_76,D_5_HOS_C7_68,S3_2_C4_36,B_1_C0_54,D_4_HOS_C4_64,D_5_HOS_C4_60,D_4_IRF_C13_53,A_C2_191,D3_HOS_C2_96,G_C1THRU4_50,S3_1_C10_2001,D_4_IPF_C4_200,S3_1_C6_15,S3_2_C4_6,B_1_C21_99,C_1_C6_107,D_5_HOS_C6_72,D1_IPF_C1_52,S3_1_C7_17,A_C6_58,B_1_C22_60,D_4_IPF_C2_200,S5_C4_3,B_1_C0_40,S3_1_C7_19,D_4_HOS_C13_51,D_4_IPF_C13_76,D_3_HOS_C5_200,A_C2_75,S4_HHA1_C3_34,A_C1_106,B_1_C21_65,S3_2_C5_34,A_C6_3,S5_C2_3,S2_1_C2_9,D_4_HOS_C3_6250,B_1_C21_32,A_C2_72,D3_HOS_C2_32,A7_1_C3_6,D_4_SNF_C11_57,A_C6_9201,E_B_HOS_C1_24,S3_1_C7_10,D_5_HOS_C4_56,C_1_C6_74,S5_C1_15,S3_2_C6_1,S10_C1_9,G_C1THRU4_30,S3_2_C5_35,B_1_C22_56,S4_HHA3_C4_38,D3_HOS_C2_75,B_1_C21_40,D1_HOS_C1_37,B_1_C21_53,D3_IRF_C2_59,D3_IPF_C2_63,E_B_HOS_C1_20,A7_1_C7_8,S2_1_C2_142,S5_C6_2,C_1_C5_202,B_1_C21_64,A_C1_75,S2_1_C2_15,A_C1_35,B_1_C0_98,B_1_C0_191,D_5_HOS_C3_57,E_B_HOS_C1_38,D3_HOS_C2_56,E_B_HOS_C1_35,S3_1_C8_2001,D_5_HOS_C5_56,G_C1THRU4_19,D_5_HOS_C4_73,A_C1_46,A_C2_200,D_4_HOS_C4_60,S3_2_C2_34,A7_1_C5_8,D_4_HOS_C13_56,D_4_IPF_C11_62,B_1_C21_68,S3_2_C5_4,S4_HHA2_C3_36,A_C2_56,D3_IRF_C2_96,D_4_HOS_C10_90,D_5_HOS_C5_50,D_4_HOS_C10_52,C_1_C5_9910,S3_2_C4_2551,D3_HOS_C2_60,A_C1_57,A_C1_111,D_4_HOS_C2_72,C_1_C7_99,S3_1_C9_14,S3_2_C5_32,B_1_C21_76,D1_IPF_C1_37,D3_HOS_C3_75,B_1_C21_107,D3_IPF_C2_32,D3_IRF_C3_75,B_1_C22_90,D_4_HOS_C12_53,D_5_HOS_C2_9201,D3_IPF_C3_94,D3_HOS_C3_73,S2_1_C2_1401,S2_1_C3_143,D_4_SNF_C11_51,D_5_HOS_C3_67,B_1_C26_106,S3_2_C2_18,S10_C3_23,A_C1_112,A_C2_8,E_A_HOS_C1_7094,E_B_HOS_C101_7,A_C6_60,B_2_C26_105,D_4_HOS_C12_60,S3_2_C6_33,S4_HHA2_C2_38,S2_1_C2_1604,S4_HHA1_C1_33,S3_1_C10_1801,A7_3_C5_1,D_4_HOS_C10_53,S5_C2_7,B_1_C0_72,B_1_C21_51,G3_C1_25,D_4_HOS_C12_75,D_5_HOS_C6_75,B_1_C0_97,D_5_HOS_C2_56,D_4_HOS_C10_64,D_4_IPF_C13_54,S2_1_C2_1602,G_C1THRU4_49,S3_1_C2_1,S3_2_C6_40,D3_IRF_C2_53,D3_HOS_C3_68,D_4_HOS_C2_59,D3_HOS_C3_61,B_2_C26_34,G_C1THRU4_41,D_5_HOS_C5_6250,D_5_HOS_C4_69,C_1_C5_9930,D3_SNF_C3_73,D_4_HOS_C2_51,D_4_HOS_C13_58,D_5_HOS_C3_62,B_1_C26_59,S2_1_C4_2,A_C6_55,S3_2_C2_24,D_5_HOS_C7_57,E_B_HOS_C1_9,D_4_HOS_C12_97,D1_IPF_C1_48,D_4_HOS_C13_63,D_4_SNF_C11_50,D3_IPF_C3_72,D_4_IRF_C11_56,B_1_C0_190,D_4_HOS_C12_64,S5_C1_8,D_4_IRF_C3_200,D_5_HOS_C5_9201,A_C2_52,S2_1_C1_60,REGION,A7_3_C5_2,D_5_HOS_C5_69,C_1_C5_35,A8_C2_30,D_4_HOS_C2_76,S3_2_C2_9,S4_HHA3_C5_36,D_5_HOS_C3_98,D_4_SNF_C11_55,D_5_HOS_C4_70,A_C2_98,S3_2_C2_36,S3_1_C3_10,D3_HOS_C2_33,S2_1_C1_141,D_4_HOS_C11_60,A_C2_106,D3_HOS_C3_57,D_4_HOS_C12_65,D_5_HOS_C6_71,S5_C2_9,A_C6_90,D_4_IRF_C11_72,D3_SNF_C3_53,B_1_C0_11,S3_2_C5_14,D_5_HOS_C3_93,D_5_HOS_C2_53,S5_C2_1,D4_HEART_C1_69,S4_HHA3_C4_35,S3_1_C9_24,D_5_HOS_C6_57,C_1_C6_30,D4_KIDNEY_C1_69,D1_IRF_C1_37,D_4_HOS_C4_70,D_4_IRF_C2_200,S3_1_C8_5,A_C2_93,D_5_HOS_C7_75,D_4_HOS_C10_51,B_1_C0_23,D_4_HOS_C4_56,E_A_HOS_C1_7099,S3_2_C5_5,S3_2_C4_29,D_4_HOS_C3_50,B_1_C26_64,C_1_C7_105,A_C6_114,S2_1_C1_85,B_1_C0_112,D_4_HOS_C6_200,D3_IRF_C3_74,C_1_C5_43,FFY,Hospital Type (From CMS Hospitals Data Archive),Name and Num
,Curated Name and Num,Hospital type (modified),Type of Control of Hospital (See Table I),Lon,Lat,Drugs Charged to Patients,Labor and Delivery Days -  Title XIX,Adj for Respiratory therapy costs in excess,Medical Supplies Charged to Patients,"Anesthetist, and Medical Education Costs",OSP,Recovery Room,NF,Nursing School,"Blood Storing, Processing, Trans",Excluded Area Salaries,ICF,Excluded Area Salaries,Movable Equipment,"Net costs of Epoietin furnished to
all maintenance dialysis patients
by the provider",MRI,OPT,ASC (Non Distinct Part),Interns & Residents,Drugs Charged to Patients,Subprovider I,Medical Supplies Charged to Patients,Lung  Acquisition,"Number of days in year dialysis 
furnished",Hospital Adults & Ped Swing Bed SNF,Hospice,Subprovider 2,Surgical Intensive Care Unit,Durable Medical Equipment Sold,Electroencephalography,CT Scan,MRI,Assets,HMO,Burn Intensive Care Unit,Renal 8 Provider Number,HHA,Buildings and Fixtures,Other Outpatient Services,Other Ancillary,Anesthesiology,LUPA:  Total Non Routine Med Sup Chgs,Radioisotope,Interns & Residents,Interns & Residents,Intravenous Therapy,Other Outpatient Services,Whole Blood & Packed Red Blood Cells,Blood Clotting Factors for Hemoph.,Contract Labor,PEP:  Total Number of Outlier Episodes,"Blood Storing, Processing, Trans",CMHC,Major Movable Equipment,Total cost,Drugs Charged to Patients,Respiratory Therapy,CT Scan,RHC 2 Provider Number,Physical Therapy,Total,ICF,Nonpaid Workers,Liver Acquisition,Physicians' Private Office,Anesthesiology,MRI,Electroencephalography,Durable Medical Equipment Rented,Emergency,Cross Foot Adjustments,Hospice,Speech Pathology,Renal 9 Provider Number,Physical Therapy,Observation Beds (Distinct Unit),Other Reimbursable,Drugs Charged to Patients,Other Outpatient Services,Other Outpatient Services,Home Program Dialysis,Nursery,Occupational Therapy,Total Hospital,Intestinal Acquisition,New Cap Related Csts Bldg & Fixtures,Hospice,ASC (Non Distinct Part),Drugs Charged to Patients,Investments,Radiology-Therapeutic,Aggregate amount collected from patients,Laundry and Linen Service,Nonphysician Anesthetists,Electrocardiology,Physical Therapy,ASC (Distinct Part),Intensive Care Unit,Other Reimbursable,Cardiac Catheterization,Subprovider-IRF,Medical Supplies Charged to Patients,Impl. Dev. Charged to Patients,With Outliers:  Total Charges,Subprovider-IPF,Total Salaries,Home Program Dialysis,Radiology-Therapeutic,Burn Intensive Care Unit,Electrocardiology,Clinic,Operating Room,Cardiac Catheterization,Home Program Dialysis,Intensive Care Unit,MRI,Number of periods hospital was in MDH status,Other Ancillary,Other Organ Acquisition,Emergency,Radiology-Therapeutic,Occupational Therapy,New Cap Related Csts Movable Equipment,Teaching Physician Salaries,Subprovider-IPF,Laboratory,Medicare Certified Lung TC term date,Surgical Intensive Care Unit,Intensive Care Unit,Land Improvements,Observation Beds (Distinct Unit),Cardiac Catheterization,Laboratory,Medical and Other Services,RHC,Is this hospital classified as a referral center? (Y/N),Anesthesiology,certification date,Other General Service,Total Swing Bed Cost,Outpatient Rehab Provider,Minor Equipment Depreciable,Renal Dialysis,MRI,Other Organ Acquisition,Surgical Intensive Care Unit,Intestinal Acquisition,Intensive Care Unit,MRI,Electroencephalography,Other Ancillary,Int & Res (non approved teaching program,Other Reimbursable,Radioisotope,Ambulance Services,Clinic,MRI,Whole Blood & Packed Red Blood Cells,CT Scan,Medical Supplies Charged to Patients,Subprovider 2,Home Office Salaries,Net Income from Service to Patients,Total,Intensive Care Unit,MRI,Research,Cardiac Catheterization,Radiology-Diagnostic,OPT,Subtotal,Physical Therapy,Radiology-Therapeutic,Subprovider 2,Electrocardiology,Stand-alone CHIP -- Costs minus net revenue (0 min),FQHC,Operating Room,Delivery Room and Labor Room,Medicare Certified Pancreas TC term date,CT Scan,MRI,Renal Dialysis,Total Nursing School,Without Outliers:  Total Charges,Subprovider II,Operation of Plant,Physician Part A,SNF,FQHC,FQHC,Speech Pathology,Anesthesiology,Durable Medical Equipment Sold,Speech Pathology,Physical Therapy,Blood Clotting Factors for Hemoph.,NOT IN THIS FILE,Radiology-Diagnostic,Investment Income-New Bldgs & Fixtures,Operating Room,Total Hospital,OLTC,Radioisotope,Buildings and Fixtures,SNF,Nursery,Delivery Room and Labor Room,Total Nonphysician Anesthetist Cost,Recovery Room,PEP:  Total Number of Outlier Episodes,Subprovider-IRF,Total Current Assets,Other General Service,Observation Beds (Distinct Unit),Nursing Administration,Without Outliers:  Total Visits,Islet Acquisition,Occupational Therapy,Other Outpatient Services,Physical Therapy,Total Program General Inpatient Routine,Central Services and Supply,Begin Balance,Pancreas Acquisition,Housekeeping under contract,RHC 19 Provider Number,FQHC,Medicare reimbursable bad debts for the entire hospital complex,Drugs Charged to Patients,Total,Cardiac Catheterization,Nursing Administration,Delivery Room and Labor Room,Dietary,Management and Administrative Services,Subprovider-IPF,ICF,Other General Service,Electrocardiology,Occupational Therapy,Central Services and Supply,HHA,CT Scan,W/Out Outliers:  Number of Episodes,Cardiac Catheterization,Allowable bad debts,Cardiac Catheterization,Drugs Charged to Patients,Radiology-Therapeutic,Hospice,Coronary Care Unit,Clinic,Hospital Provider Number,ICF,Subtotal Wage Related Csts,Central Services and Supply,Delivery Room and Labor Room,Electroencephalography,Other Reimbursable,Operating Room,Radiology-Diagnostic,Delivery Room and Labor Room,Laboratory,Islet Acquisition,Drugs Charged to Patients,OLTC,Out of State Medicaid eligible days,Lung  Acquisition,Radiology-Diagnostic,RHC 3 Provider Number,Physician-Part B,Other Outpatient Services,Intravenous Therapy,Component rate ESRD,Hospital Type,Other Outpatient Services,Total Patient Days,Interns & Residents,OOT,Subprovider-IPF,Organ Procurement,RHC 22 Provider Number,Drugs Charged to Patients,Other Ancillary,Home Office Salaries,Subprovider-IRF,Blood Clotting Factors for Hemoph.,Medical Records & Med Records Library,Other Reimbursable,Occupational Therapy,Electrocardiology,Contract Labor,Net Salaries,Radiology-Therapeutic,ASC (Distinct Part),Hospice,Other Reimbursable,With Outliers:  Total Charges,Total Assets,MRI,"If this facility qualifies as a RPCH/CAH, has it elected the all inclusive payment for outpatient service? (Y/N)",CT Scan,Pharmacy,Related Organization Transactions,Impl. Dev. Charged to Patients,Occupational Therapy,Anesthesiology,Anesthesiology,Durable Medical Equipment Sold,Respiratory Therapy,Intravenous Therapy,Is this a rural hospital qualifying for an exception to the certified registered nurse anesthetist the CRNA fee schedule? (Y/N),Recovery Room,FQHC,Observation Beds (Distinct Unit),Other Outpatient Services,Other Outpatient Services,Whole Blood & Packed Red Blood Cells,Sale of drugs to other than patients,Without Outliers:  Total Visits,Coronary Care Unit,Physician Part A,Non-Physician Part B,Pancreas Acquisition,Physical Therapy,Speech Pathology,Clinic,Clinic,Medical Supplies Charged to Patients,HHA,Organ Procurement,Renal Dialysis,Other Current Assets,Other Current Liabilities,Liver Acquisition,Bonus Payment,Maintenance and Repairs,Electrocardiology,Health Information Technology Designated Assets,Inventory,FQHC,Laboratory,Hospice,Total Other Charges,Anesthesiology,Total,Emergency,OLTC,Total,Radiology-Diagnostic,Subprovider I,Payroll taxes payable,Hospital State,Burn Intensive Care Unit Program Cost,Lung  Acquisition,Medical Supplies Charged to Patients,Teaching Physician Salaries,RHC 8 Provider Number,Intravenous Therapy,Radiology-Therapeutic,Renal 3 Provider Number,Total Operating Expense,Total,OOT,Contract Labor,Land Improvements,FQHC 4 Provider Number,Intravenous Therapy,Delivery Room and Labor Room,Adults and Pediatrics,CT Scan,Emergency,"Blood Storing, Processing, Trans",Maintenance of Personnel,Radioisotope,Electroencephalography,Medical Supplies Charged to Patients,PBP Clinical Lab Services Program Only,Investment Income-Other,Total,Clinic,Recovery Room,MRI,Recovery Room,With Outliers:  Non Routine Med Sup Chgs,CORF,Cafeteria,Durable Medical Equipment Sold,Total,MDH status ending date (MM/DD/YY),Electrocardiology,Respiratory Therapy,Blood Clotting Factors for Hemoph.,Respiratory Therapy,Delivery Room and Labor Room,Social Service,Islet Acquisition,Medical Records and Medical Rec. Library,Observation Beds (Distinct Unit),Payments received from patients for amounts previously written off as charity care,Radiology-Diagnostic,Delivery Room and Labor Room,Emergency,Total,Title XIX discharges,Occupational Therapy,Total Charges:  LUPA Episodes,PBP Clinical Lab Services Program Only,Housekeeping,Nursing Administration,Medical Supplies Charged to Patients,Other Reimbursable,Laboratory,ASC (Non Distinct Part),"Number of patients in program at 
end of cost reporting period","Gift, Flower, Coffee Shop, Canteen",RHC 4 Provider Number,Other Ancillary,"Blood Storing, Processing, Trans",OPPS payments,Employee Benefits,Subprovider 1,Home Program Dialysis,"Blood Storing, Processing, Trans",Medical Supplies Charged to Patients,ICF Provider Number,Physician-Part B,Burn Intensive Care Unit,SNF,Physical Therapy,Islet Acquisition,net of Swing Bed Cost,Maintenance of Personnel,"If Line 32, Col 1 is yes, enter the method used: (A, B, or E only)",Without Outliers:  Non Routine Med Sup Chgs,Medical Supplies Charged to Patients,Observation Beds (Distinct Unit),Total Adults & Pediatrics,Cost of charity care (uninsured patients + patients w/ coverage not accepted by provider),TOTAL,Anesthesiology,Impl. Dev. Charged to Patients,Blood Clotting Factors for Hemoph.,Radiology-Therapeutic,Renal Dialysis,Number of stations,Electroencephalography,Impl. Dev. Charged to Patients,FQHC,W/Out Outliers:  Number of Episodes,LUPA Episodes:  Total Number of Episodes,Nonphysician Anesthetists,Social Service,Net Patient Revenue,Hospice,Emergency,"Number of patients in program at 
end of cost reporting period",LUPA Episodes:  Total Visits,Without Outliers:  Total Charges,Title V discharges,Whole Blood & Packed Red Blood Cells,Other Ancillary,Medical Records & Med Records Library,Recovery Room,Anesthesiology,Renal 4 Provider Number,Nonphysician Anesthetists,"Gift, Flower, Coffee Shop, Canteen",NF,Impl. Dev. Charged to Patients,Subtotal,Int & Res (non approved teaching program,Anesthesiology,Organ Procurement,NF,Electroencephalography,Operating Room,Subprovider-IPF,Medical Supplies Charged to Patients,Delivery Room and Labor Room,MRI,Adults and Pediatrics,MRI,Utilization Review-physicians compens,Electroencephalography,Investment Income-New Movable Equip,Laundry and Linen Service,Delivery Room and Labor Room,Electrocardiology,Occupational Therapy,HHA 1 Provider Number,Total Current Liabilities,Subprovider-IRF,OSP,Blood Clotting Factors for Hemoph.,Burn Intensive Care Unit,Blood Clotting Factors for Hemoph.,Anesthesiology,Liver Acquisition,Employee Benefits,Recovery Room,Speech Pathology,Cross Foot Adjustments,OLTC,Recovery Room,Admin & Gen Under Contract,IPF Provider Number,Intravenous Therapy,Occupational Therapy,Employee Benefits,Whole Blood & Packed Red Blood Cells,OLTC,Clinic,Anesthesiology,Other Reimbursable,TOTAL,Total Other Assets,Operating Room,Radioisotope,Ambulance Services,Drugs Charged to Patients,"Is this a New Hospital under
42 CFR 412.300 PPS capital
(Y/N)",Recovery Room,CT Scan,RHC 25 Provider Number,"Blood Storing, Processing, Trans",Electrocardiology,Cardiac Catheterization,Other Reimbursable,Respiratory Therapy,"Blood Storing, Processing, Trans",RHC 5 Provider Number,Total Other Charges,Operating Room,Subprovider-IRF,Heart Acquisition,Physical Therapy,Subtotal,Physical Therapy,MRI,Int & Res (non approved teaching program,Surgical Intensive Care Unit,Nursing School,Occupational Therapy,Impl. Dev. Charged to Patients,Radiology-Therapeutic,Subprovider-IRF,Emergency,Electroencephalography,Other Nonreimbursable,Hospital Adlts & Ped Swing Bed SNF,Electroencephalography,Operation of Plant,Total Facility FTEs,Wage Related Costs RHC/FQHC,Speech Pathology,Operating Room,Total Program General Inpatient Routine,Renal Dialysis,ASC (Distinct Part),Laboratory,"Gift, Flower, Coffee Shop, Canteen",Operation of Plant,Delivery Room and Labor Room,With Outliers:  Non Routine Med Sup Chgs,Liver Acquisition,Total Other Medical Education,Delivery Room and Labor Room,Radioisotope,Intestinal Acquisition,Laboratory,Laboratory,Electrocardiology,Physical Therapy,Delivery Room and Labor Room,Other Ancillary,Occupational Therapy,Cardiac Catheterization,Whole Blood & Packed Red Blood Cells,Title XIX discharges,Subtotal Salaries,Other adjustments,Speech Pathology,FQHC,Total,IPF,Operation of Plant,Related Salaries,Respiratory Therapy,Surgical Intensive Care Unit,Anesthesiology,NF,RHC,Speech Pathology,Kidney Acquisition,ASC (Distinct Part),NF,Durable Medical Equipment Sold,Organ Procurement,Int & Res (non approved teaching program,PEP:  Total Number of Outlier Episodes,Other Special Purpose,interns and residents,Coronary Care Unit,Total Program Inpatient Costs,Electroencephalography,Excluded Area Salaries,Clinic,HHA,"Blood Storing, Processing, Trans",Other Ancillary,Interns & Residents,Without Outliers:  Total Charges,Radiology-Diagnostic,SNF,TOTAL,Occupational Therapy,Delivery Room and Labor Room,CMHC,Drugs Charged to Patients,Teaching Physician Salaries,Intestinal Acquisition,ASC (Distinct Part),Interns & Residents,Excluded Areas,Liver Acquisition,Interns & Res Other Program Costs,Whole Blood & Packed Red Blood Cells,Physical Therapy,Renal Dialysis,Medical Supplies Charged to Patients,"Blood Storing, Processing, Trans",SNF,Intravenous Therapy,FQHC 1 Provider Number,Renal Dialysis,Operating Room,Physicians' Private Office,Other Ancillary,Drugs Charged to Patients,Home Program Dialysis,Census Division Code,Intravenous Therapy,Burn Intensive Care Unit,Radiology-Therapeutic,Hospice,"Blood Storing, Processing, Trans",Interns and residents,Subprovider II,Transitional corridor payment,Durable Medical Equipment Sold,SNF,Int & Res (non approved teaching program,Radioisotope,Other Special Care,Radioisotope,Other Ancillary,Other Assets,Emergency,Medical Supplies Charged to Patients,HHA,Total Allied Health,Total Hospital,OLTC,FQHC 6 Provider Number,Blood Clotting Factors for Hemoph.,Occupational Therapy,Radiology-Therapeutic,Electrocardiology,Movable Equipment,Physical Therapy,Excess of customary charges,Subprovider-IPF,Home Program Dialysis,Drugs Charged to Patients,Swing Bed SNF Provider Number,Coronary Care Unit,Radioisotope,Anesthesiology,Whole Blood & Packed Red Blood Cells,Electrocardiology,Total Overhead Costs,Radiology-Diagnostic,Hospice,Radiology-Therapeutic,OLTC,Other Reimbursable,Hospice,SNF,Other Ancillary,Intensive Care Unit,Radioisotope,Electroencephalography,ASC (Non Distinct Part),Physical Therapy,RHC 17 Provider Number,Hospice,Nonpaid Workers,Other Organ Acquisition,Emergency,Subprovider-IPF,Anesthesiology,Report Status Code,Cost of patients approved for charity care and uninsured discounts,PBP Clinical Lab Services Program Only,Whole Blood & Packed Red Blood Cells,Speech Pathology,NF,Anesthesiology,Management and Administrative Services,Other Organ Acquisition,Electroencephalography,Other Special Care Unit,CMHC,Other Special Purpose,Cardiac Catheterization,Renal Dialysis,Laboratory,ICF,Total,"Salaries, Wages, and Fees Payable",Beginning Date of SCH status,MRI,Other Ancillary,Renal 6 Provider Number,Adults and Pediatrics,ASC (Non Distinct Part),Radiology-Diagnostic,Renal Dialysis,Other Special Care,Intravenous Therapy,Coronary Care Unit,New Cap Related Csts Movable Equipment,Buildings and Fixtures,Delivery Room and Labor Room,SNF,Telephone Services,Occupational Therapy,Paid Losses,Nursing School,Home Program Dialysis,Dietary under contract,Medical Supplies Charged to Patients,Surgical Intensive Care Unit,Other Reimbursable,Operating Room,Radiology-Therapeutic,Impl. Dev. Charged to Patients,Respiratory Therapy,New Capital Equipment,"Blood Storing, Processing, Trans",Durable Medical Equipment Rented,Other Outpatient Services,Medical Supplies Charged to Patients,Cost of Uncompensated Care,Charity care charges and uninsured discounts for the entire facility,Home Program Dialysis,Laboratory,Initial Physician Payment Method (Y/N),RHC 20 Provider Number,Anesthesiology,Non-Physician Anesthetist Part B,PBP Clinical Lab Services Program Only,Whole Blood & Packed Red Blood Cells,"Anesthetist, and Medical Education Costs",Home Office Street,Total Hospital,net of Swing Bed Cost,Radiology-Diagnostic,Pass Through Cost for  Program Ancillary,ASC (Non Distinct Part),RHC,Medical Supplies Charged to Patients,Blood Clotting Factors for Hemoph.,Organ Procurement,Respiratory Therapy,Subtotal,Outpatient Rehab Provider,Subprovider II,"If (SCH), enter the # of periods.",Coronary Care Unit Program Cost,Other Special Care Unit,Recovery Room,CORF,Administrative and General,ASC (Non Distinct Part),Interns & Residents,Medical Supplies Charged to Patients,Physical Therapy,RHC,Total,Electrocardiology,RHC,OPPS payments,Protested amounts,ASC 1 Provider Number,Radioisotope,Subprovider-IPF,Radiology-Therapeutic,Central Services and Supply,Durable Medical Equipment Rented,Surgical Intensive Care Unit,"Blood Storing, Processing, Trans",Social Service,Intravenous Therapy,Radiology-Therapeutic,Other General Service,Other Outpatient Services,CT Scan,Total Salaries,Laboratory,Drugs Charged to Patients,Renal Dialysis,Non-Physician Part B,Other Outpatient Services,Impl. Dev. Charged to Patients,Anesthesiology,Operating Room,Pancreas Acquisition,"Percentage of patients re-using
dialyzers",Electroencephalography,Operating Room,Observation Beds (Distinct Unit),Radiology-Therapeutic,Kidney Acquisition,Int & Res (non approved teaching program,Electrocardiology,Other Organ Acquisition,CMHC,Subtotal Other Wages and Related Csts,Employee Benefits,Occupational Therapy,Gross Revenue,Research,Hospital Title 18 Payment System (P/T/O),Number of stations,Partial or full credits from manufacturers,Hospital Adults & Pediatrics,Building Improvements,CORF,NF,Electroencephalography,Leasehold Improvements,Total,Electrocardiology,Heart Acquisition,"Blood Storing, Processing, Trans",Drugs Charged to Patients,LUPA Episodes:  Total Number of Episodes,Target Amount per Discharge,Total,Land,Intensive Care Unit,Outlier payments,MRI,Occupational Therapy,Inpatient Revenue,Speech Pathology,Impl. Dev. Charged to Patients,Recovery Room,Ambulance Services,Employee Benefits,Ambulance Services,Liver Acquisition,"Number of patients transplanted 
during fiscal year",Hospice,Administrative and General,Home Program Dialysis,Home Office Salaries & Wage Related Csts,Int & Res (non approved teaching program,State,Operating Room,Total unreimbursed and uncompensated care,Cardiac Catheterization,Paramedical Education,OOT,OSP,Durable Medical Equipment Sold,Radioisotope,Intravenous Therapy,Subtotal Salaries,Total Adults & Peds,FQHC 9 Provider Number,IRF,"Average patient dialysis time 
including setup",Recovery Room,Recovery Room,"Gift, Flower, Coffee Shop, Canteen",Radiology-Diagnostic,Heart Acquisition,Adults & Pediatrics,Stand-alone CHIP cost,Radiology-Therapeutic,Intravenous Therapy,Laundry and Linen Service,Other Reimbursable,PBP Clinical Lab Services Program Only,Housekeeping,Laboratory,Utilization Review SNF,Hospital Name,Medical Records and Medical Rec. Library,Durable Medical Equipment Sold,Hospice,Observation Beds (Distinct Unit),CORF,Intravenous Therapy,Research,FQHC 8 Provider Number,Hospital Street Address,Total charges to state or local government programs for indigent care (not Medicaid or CHIP),Other Outpatient Services,Blood Clotting Factors for Hemoph.,Coronary Intensive Care Unit,Total Program Inpatient Costs,RHC/FQHC Combined,Heart Acquisition,Total Non Routine Medical  Supply Charges,Delivery Room and Labor Room,Other Special Care Unit,Total costs for patients covered by a state or local government program,OPT,NF,Admin & Gen Under Contract,Received DSH or supplemental payments from Medicaid? (Y/N),Medical Supplies Charged to Patients,Other Outpatient Services,Respiratory Therapy,Interns & Res Salary and Fringe Benefits,SNF,Lung  Acquisition,CT Scan,Home Program Dialysis,Deductibles and coinsurance related to line 24,Emergency,Administrative and General,Central Services and Supply,Clinic,Clinic,Physical Therapy,Medicare Certified Liver TC term date,OOT,Total,Subprovider I,Adults & Pediatrics,CT Scan,Other Outpatient Services,NF,Durable Medical Equipment Rented,Surgical Intensive Care Unit,Teaching Physician Salaries,Radiology-Therapeutic,Total Hospital,Coronary Care Unit,Delivery Room and Labor Room,Respiratory Therapy,Charity care charges and uninsured discounts for the entire facility,Physical Therapy,Subprovider-IRF,Kidney Acquisition,Hospital PO Box,Provider-based physician adjustment,CT Scan,HHA,Other Special Care Unit,Notes and Loans Payable (short term),IPF,Drugs Charged to Patients,Subprovider I,Emergency,Int & Res (non approved teaching program,Organ acquisition charges,HHA 2 Provider Number,Total,Total,Sequestration adjustment,Clinic,MRI,Recovery Room,Blood Clotting Factors for Hemoph.,Respiratory Therapy,Respiratory Therapy,Blood Clotting Factors for Hemoph.,Wage Related Costs Other,Medical Records and Medical Rec. Library,Subprovider I,Electrocardiology,Contract Labor:  Physician Part A,Operating Room,"Trade, Quantity, and Time Discounts",Durable Medical Equipment Sold,Occupational Therapy,Surgical Intensive Care Unit Program Cost,IPPS Payment amount (unadjusted),Administrative & General under contract,CT Scan,Impl. Dev. Charged to Patients,Renal 5 Provider Number,Operating Room,Building Improvements,Nursing Administration,OLTC,Radiology-Diagnostic,ICF,Net revenue from state/local govt indigent care (not Medicaid or CHIP),RHC/FQHC Combined,Operating Room,Durable Medical Equipment Sold,Electroencephalography,SNF,Drugs Charged to Patients,Subtotal,Delivery Room and Labor Room,Renal 10 Provider Number,Home Program Dialysis,Physical Therapy,Anesthesiology,ASC (Non Distinct Part),"Gift, Flower, Coffee Shop, Canteen",Surgical Intensive Care Unit,Net Income,Operating Room,Laundry and Linen Service,Intensive Care Unit,TOTAL,Total,Fiscal Intermediary/MAC Create Date,Pancreas Acquisition,Speech Pathology,Emergency,Laboratory,Total,"Number of patients in program at 
end of cost reporting period",ASC (Non Distinct Part),Cardiac Catheterization,Transitional corridor payment,Observation Beds (Distinct Unit),Electrocardiology,Intravenous Therapy,Speech Pathology,Laboratory,Laboratory,Interns & Res Salary and Fringe Benefits,Intravenous Therapy,With Outliers:  Total Visits,Home Office Salaries & Wage Related Csts,Intensive Care Unit,MRI,Amounts expected under 42 CFR,Emergency,CMHC,RHC 9 Provider Number,Adults and Pediatrics,"Blood Storing, Processing, Trans","Blood Storing, Processing, Trans",PEP Episodes:  Total Visits,Utilization,Line 2 times line 5,Physical Therapy,Nonpaid Workers,"Percentage of patients re-using
dialyzers",Cardiac Catheterization,Cardiac Catheterization,Total Visits,Relief Payment,Coronary Care Unit,PBP Clinical Lab Services Program Only,Total Program Excludable Costs,Speech Pathology,Land,Maintenance of Personnel,Renal Dialysis,SNF,Medicare Certified Islet TC term date,CMHC,Radioisotope,"Blood Storing, Processing, Trans",Fixed Equipment,Delivery Room and Labor Room,Electroencephalography,Medicaid charges,Physical Therapy,Speech Pathology,Coronary Care Unit,Emergency,Depreciation-New Bldgs & Fixtures,CT Scan,Building Improvements,Drugs Charged to Patients,Other Ancillary,Radiology-Therapeutic,Islet Acquisition,Intensive Care Unit,With Outliers:  Total Visits,RHC 14 Provider Number,Adults and Pediatrics,Delivery Room and Labor Room,Burn Intensive Care Unit,Nursery,Payment to cost ratio,Operation of Plant,Recovery Room,Clinic,State or local govt (not Medicaid or CHIP) -- Costs minus net revenue (0 min),Anesthesiology,Utilization Code (L/N/F),Drugs Charged to Patients,New Capital Buildings and Fixtures,SNF,Renal Dialysis,Burn Intensive Care Unit,Title XIX discharges,Non-Physician Anesthetist Part A,Interest expense on Medicare Overpaymts,Electroencephalography,Anesthesiology,PBP Clinical Lab Services Program Only,Blood Clotting Factors for Hemoph.,Fiscal Year End Date,Maintenance and Repairs,Renal Dialysis,Total,Other Special Care Unit,Clinic,Interns & Residents,Medical Supplies Charged to Patients,Fiscal Intermediary Number,Respiratory Therapy,Radiology-Diagnostic,Whole Blood & Packed Red Blood Cells,Emergency,Operating Room,Other Ancillary,Physician Part B,Physical Therapy,Subtotal Other Wages and Related Csts,Other Ancillary,Coronary Care Unit,Net Salaries,Sale of medical and surgical supplies to,Physician-Part B,Renal Dialysis,Total Non Routine Medical  Supply Charges,Radiology-Diagnostic,Blood Clotting Factors for Hemoph.,Emergency,Other Ancillary,"Income from imposition of interest, finance",Delivery Room and Labor Room,Rental of quarters to employee and oths,LUPA Episodes:  Other Charges,Total Facility,Radiology-Diagnostic,TOTAL,Less Contractual Allowance and Discounts on Patients' Accounts,Subprovider 1,Operating Room,Blood Clotting Factors for Hemoph.,Renal Dialysis,Subprovider 1,Medical Supplies Charged to Patients,Other Reimbursable,"Number of days in year dialysis 
furnished",Interest Expense,Other General Service,Radiology-Diagnostic,Durable Medical Equipment Rented,Notes Receivable,OOT,MRI,Laboratory,New Capital Buildings and Fixtures,RHC,Intensive Care Unit,Title V discharges,Laundry and Linen Service,Intensive Care Unit,Total,IRF,Other Outpatient Services,Radioisotope,Clinic,Recovery Room,Respiratory Therapy,Clinic,Radiology-Therapeutic,Utilization Review - Physician Compen,Subprovider-IRF,Title XVIII discharges,Physical Therapy,"Blood Storing, Processing, Trans",SSA State County Code,Radiology-Diagnostic,Clinic,Other Special Care Unit,Other General Service,Physician Part B,Nonphysician Anesthetists,Durable Medical Equipment Sold,Cardiac Catheterization,RHC 13 Provider Number,Research,Other Ancillary,Medicaid Observation Days,Durable Medical Equipment Rented,Deductibles and coinsurance,Subprovider-IRF,W/Out Outliers:  Number of Episodes,Radioisotope,Radiology-Therapeutic,Intravenous Therapy,OPT,Radiology-Diagnostic,Radioisotope,Other Outpatient Services,ICF,Islet Acquisition,Total,Subprovider-IPF,Kidney Acquisition,Whole Blood & Packed Red Blood Cells,Total Hospital,Heart Acquisition,Payments received from patients for amounts previously written off as charity care,Electroencephalography,Observation Beds (Distinct Unit),Subprovider I,Other Ancillary,SNF,Interns & Res Salary and Fringe Benefits,Electroencephalography,Burn Intensive Care Unit,Electroencephalography,Total discharges,Observation Beds (Distinct Unit),Central Services and Supply,Social Service,Fiscal Year Begin Date,Observation Beds (Distinct Unit),Other Ancillary,Blood Clotting Factors for Hemoph.,Total Liabilities,Blood Clotting Factors for Hemoph.,Electrocardiology,Radiology-Diagnostic,Total,HHA,ICF,Total Salaries,MRI,CT Scan,Electrocardiology,Respiratory Therapy,Speech Pathology,Subprovider I,Intravenous Therapy,Emergency,Electroencephalography,Ancillary service charges,RHC 15 Provider Number,Respiratory Therapy,Laboratory,Interns & Res Salary and Fringe Benefits,Physical Therapy,PEP Episodes:  Total Charges:,Delivery Room and Labor Room,Electrocardiology,Renal Dialysis,Coronary Intensive Care Unit,CT Scan,"Gift, Flower, Coffee Shop, Canteen",Renal Dialysis,Allowable bad debts for dual eligibles beneficiaries,Hospice,CAPD exchanges per day,Social Service,Renal Dialysis,CT Scan,Radiology-Diagnostic,Whole Blood & Packed Red Blood Cells,Recovery Room,Self Insurance,Speech Pathology,FQHC,Pass through Cost for Program Inpatient,Home Program Dialysis,Radiology-Therapeutic,Burn Intensive Care Unit,Housekeeping,Radiology-Therapeutic,Total,Title XVIII discharges,HHA,Other Ancillary,Emergency,Observation Beds (Distinct Unit),Recovery Room,Intravenous Therapy,Impl. Dev. Charged to Patients,Adults & Pediatrics,Durable Medical Equipment Rented,Speech Pathology,Other Outpatient Services,Excluded Area Salaries,ASC (Non Distinct Part),MCP Physician Payment Method (Y/N),RHC 10 Provider Number,Intestinal Acquisition,Intravenous Therapy,Physicians' Private Office,"If this Hospital is claiming cost for renal services on Worksheet A, are they inpatient services only? (Y/N)",Cardiac Catheterization,Non-Physician Anesthetist Part A,Radiology-Therapeutic,Observation Beds (Distinct Unit),ASC (Distinct Part),MRI,Subprovider-IRF,Operating Room,Housekeeping,Maintenance of Personnel,Occupational Therapy,Other Adjustments (Summed),Other Special Care,CT Scan,Total Adults & Peds,Impl. Dev. Charged to Patients,HHA,Subtotal,Cardiac Catheterization,Other Ancillary,Home Program Dialysis,Title V discharges,Intestinal Acquisition,Drugs Charged to Patients,Temporary Investments,Total Number of Episodes,Liver Acquisition,Other General Service,Management and Administrative Services,RHC/FQHC Combined,Related Salaries,IRF Provider Number,Building Improvements,Surgical Intensive Care Unit,"Blood Storing, Processing, Trans",Cardiac Catheterization,Total,Operation of Plant,Hospital Adlts & Ped Swing Bed NF,Other Outpatient Services,MRI,Emergency,RHC 23 Provider Number,ASC (Non Distinct Part),Blood Clotting Factors for Hemoph.,Renal Dialysis,Physicians' Private Office,Clinic,Nursing School,Parking Lot,RHC 6 Provider Number,Dietary under contract,Radiology-Diagnostic,Impl. Dev. Charged to Patients,Respiratory Therapy,Radioisotope,Without Outliers:  Other Charges,HMO,CT Scan,Observation Beds (Distinct Unit),Whole Blood & Packed Red Blood Cells,Observation Beds (Distinct Unit),Speech Pathology,Home Program Dialysis,Accounts Payable,Radiology-Therapeutic,Operating Room,Nursery,Impl. Dev. Charged to Patients,Contract Labor,Intravenous Therapy,Subprovider-IPF,Radiology-Diagnostic,Burn Intensive Care Unit,Medical Supplies Charged to Patients,Ambulance Services,NF Provider Number,Laboratory,Recovery Room,Ratio of line 15 to line 16,ASC (Non Distinct Part),CT Scan,Respiratory Therapy,Vending Machines,Intensive Care Unit,HHA,ASC (Distinct Part),Administrative and General,MRI,PEP:  Total Non Routine Med Supply Chgs,Lung  Acquisition,Impl. Dev. Charged to Patients,Intravenous Therapy,Total,Intensive Care Unit,OLTC,CT Scan,Other Reimbursable,Operating Room,Radiology-Diagnostic,Stand-alone CHIP Charges (Gross Revenue),Physical Therapy,Total,Labor and Delivery Days -  Title XIX,Non-Physician Anesthetist Part B,Total Charges:  LUPA Episodes,Other Ancillary,Home Office:  Physician Part A,OSP,ASC (Distinct Part),Burn Intensive Care Unit,Fixed Equipment,OOT,Hospice,RPCH/CAH Visits,Durable Medical Equipment Rented,"Medicare certified kidney 
transplant center cert date",Title XVIII discharges,Home Office Personnel,Interns & Residents,Occupational Therapy,Maintenance and Repairs,IPF,Subprovider I,SNF,Rental of Provider space by suppliers,Whole Blood & Packed Red Blood Cells,CT Scan,Other Ancillary,"Is this a teaching hospital or
affiliated with a teaching hospital? (Y/N)",Other Special Care,Clinic,Pharmacy,Physical Therapy,Net Salaries,PBP Clinical Lab Services Program Only,Anesthesiology,"Number of patients in program at 
end of cost reporting period",Nursing School,Medical Supplies Charged to Patients,Occupational Therapy,Occupational Therapy,Burn Intensive Care Unit,ICF,Whole Blood & Packed Red Blood Cells,Electrocardiology,Nonpaid Workers,Durable Medical Equipment Rented,Net Revenue from Medicaid,Burn Intensive Care Unit,Home Office Salaries,Speech Pathology,Radiology-Diagnostic,Other Reimbursable,FQHC 2 Provider Number,Respiratory Therapy,Other Nonreimbursable,Subprovider-IPF,Physical Therapy,Beginning Date of SCH status,Drugs Charged to Patients,Emergency,IPF,Administrative and General,"Blood Storing, Processing, Trans","Blood Storing, Processing, Trans",Management and Administrative Services,Delivery Room and Labor Room,NF,"Anesthetist, and Medical Education Costs",Interns & Res Other Program Costs,PBP Clinical Lab Services Program Only,Administrative and General,Subtotal,Total Salaries,Hospice,Pancreas Acquisition,Nursery,Total Salaries,Subtotal,Home Program Dialysis,Total Outpatient Program Pass Thru Cost,Unsecured Loans,Radioisotope,Blood Clotting Factors for Hemoph.,Emergency,Other Special Purpose,Fixed Equipment,RHC 24 Provider Number,Pancreas Acquisition,SNF,Physicians' Assistant,Cost of charity care (patients covered by public program + patients w/ coverage accepted by provider),Cardiac Catheterization,"Average patient dialysis time 
including setup",CT Scan,PEP Episodes:  Total Charges:,Physician-Part A,Subprovider 1,Other Special Care Unit,Radioisotope,Payment to cost ratio,Speech Pathology,Whole Blood & Packed Red Blood Cells,Number of Times per week Patient receives Dialysis,Intravenous Therapy,Operating Room,Total,Recovery Room,Intensive Care Unit,Non-Physician Anesthetist Part B,Social Service,Total Costs,Other Reimbursable,NF,Other Nonreimbursable,Other Nonreimbursable,MRI,Other Nonreimbursable,Interns & Residents,Medical Supplies Charged to Patients,Dietary,Subprovider II,Swing Bed NF Provider Number,"Blood Storing, Processing, Trans",FQHC,Hospital City,NF,Program Inpatient Ancillary Service Cost,"Sale of scrap, waste, etc.",HHA,Emergency,Employee Benefits,Physicians' Private Office,Recovery Room,"Medical certified lung
transplant center cert date",Cardiac Catheterization,Are provider based physicians' costs included in Worksheet A? (Y/N),MDH status beginning date (MM/DD/YY),Other Special Care Unit,Recovery Room,Non-Physician Part B,Medicare allowable bad debts for the entire hospital complex,HHA,Intestinal Acquisition,Electrocardiology,Impl. Dev. Charged to Patients,OPT,"Blood Storing, Processing, Trans",Total Hospital,Physician-Part A,ASC (Non Distinct Part),Delivery Room and Labor Room,Respiratory Therapy,CT Scan,Housekeeping under Contract,Subprovider-IRF,Renal Dialysis,CORF,Operating Room,Hospital Adults & Pediatrics,Durable Medical Equipment Rented,Home Program Dialysis,Non-Physician Anesthetist Part B,OLTC,Home Program Dialysis,Drugs Charged to Patients,Other Organ Acquisition,Cost of patients approved for charity care and uninsured discounts,Total Fund Balances,New Cap Related Csts Movable Equipment,Subprovider-IRF,Less Observation Beds,Cafeteria,Speech Pathology,ASC (Non Distinct Part),Observation Beds (Distinct Unit),LUPA Episodes:  Total Visits,Impl. Dev. Charged to Patients,Without Outliers:  Other Charges,Other Reimbursable,Electroencephalography,Operation of Plant,Emergency,RHC,Speech Pathology,Medical Supplies Charged to Patients,Operating Cost and Target Amount,Observation Beds (Distinct Unit),Drugs Charged to Patients,Respiratory Therapy,Physician-Part A,CMHC,Maintenance and Repairs,Drugs Charged to Patients,Laboratory,New Cap Related Csts Bldg & Fixtures,CT Scan,Speech Pathology,Hospital Adults & Pediatrics,Clinic,Nursery,Laundry and Linen Service,Coronary Care Unit,CORF,Electrocardiology,Radiology-Diagnostic,Observation Beds (Distinct Unit),Housekeeping under contract,Related  Salaries,Lung  Acquisition,Electroencephalography,SNF,New Cap Related Csts Bldg & Fixtures,PEP Episodes:  Total Visits,PBP Clinical Lab Services Program Only,RHC/FQHC Combined,Physical Therapy,MRI,Home Program Dialysis,ASC (Distinct Part),"If an Organ Procurement Organization, enter the OPO number",Medical Supplies Charged to Patients,Housekeeping,Occupational Therapy,Total Inpatient Program Days,Clinic,Other Ancillary,Subprovider-IRF,Urban (1) or Rural (2),Medical Supplies Charged to Patients,Ambulance Services,MRI,Anesthesiology,Electrocardiology,Respiratory Therapy,Hospital Zip Code,Coronary Care Unit,Intensive Care Unit,Balance due provider/program,Other Ancillary,Physical Therapy,SNF,Total Subprovider I Interns & Residents,Intravenous Therapy,Pancreas Acquisition,Impl. Dev. Charged to Patients,Pass Through Cost for  Program Ancillary,Lung  Acquisition,Dietary,Radiology-Diagnostic,Laboratory,Home Program Dialysis,Paramedical Education,Recovery Room,Surgical Intensive Care Unit,Home Program Dialysis,Other Outpatient Services,Surgical Intensive Care Unit,Non-Physician Anesthetist Part A,Land Improvements,CAPD exchanges per day,Other Special Purpose,OOT,Recovery Room,Emergency,Emergency,Durable Medical Equipment Rented,Administrative and General,RHC 11 Provider Number,Other Ancillary,Radiology-Diagnostic,HHA,Operation of Plant,Whole Blood & Packed Red Blood Cells,Whole Blood & Packed Red Blood Cells,Cardiac Catheterization,Cash on Hand and in Banks,Wage Related Costs Core,Coronary Care Unit,certification date,Other Ancillary,Other Ancillary,Cardiac Catheterization,"Blood Storing, Processing, Trans",Physical Therapy,Renal Dialysis,Dietary under Contract,Subprovider I,Nursery,MRI,Electrocardiology,Burn Intensive Care Unit,Electroencephalography,FQHC,Other Outpatient Services,Hospice,Electroencephalography,Emergency,Teaching Physician Salaries,Total Directly Assigned New Cap Rel Csts,Medical Supplies Charged to Patients,Does the facility operate an ICF/MR facility for purposes of Title XIX? (Y/N),Outpatient Rehab Provider,Radioisotope,Subprovider-IRF,Interns & Residents,Total Hospital Interns & Residents,Electrocardiology,"Medicare certified heart
transplant center cert date",Radiology-Therapeutic,Observation Beds (Distinct Unit),Cost of physicians svcs in a teaching hospita,ASC (Non Distinct Part),Other Special Care,Pass through Cost for Program Inpatient,IPF Provider Number,Nursery,Other Capital,Other Ancillary,Adults & Pediatrics,Other Special Care Unit,net of Swing Bed Cost,Other Medicaid Days,MDH status ending date (MM/DD/YY),ASC (Non Distinct Part),Observation Beds (Distinct Unit),ASC (Non Distinct Part),Cardiac Catheterization,ASC (Non Distinct Part),Respiratory Therapy,Home Office Salaries,Drugs Charged to Patients,NF,Other Outpatient Services,Other Special Purpose,"Blood Storing, Processing, Trans",Subtotal Other Wages and Related Csts,RHC,Other Outpatient Services,RHC 21 Provider Number,Drugs Charged to Patients,Total unreimbursed cost for Medicaid and CHIP and state and local indigent care programs,With Outliers:  Total Charges,Other Organ Acquisition,Total Nonphysician Anesthetist Cost,Research,Total,Title XIX discharges,Delivery Room and Labor Room,CORF,Durable Medical Equipment Rented,Administrative and General under Contract,Radiology-Diagnostic,CMHC 1 Provider Number,Total Charges,Lung  Acquisition,Medical Supplies Charged to Patients,Other Reimbursable,Intravenous Therapy,Delivery Room and Labor Room,Electrocardiology,Renal Dialysis,Have you established a new subprovider excluded unit under 42 CFR 413.40(f)(1)(I)?(Y/N),Other Special Care Unit,In State Medicaid paid days,Other Ancillary,Operating Room,Home Program Dialysis,"Number of Times per week
 Patient receives Dialysis",Occupational Therapy,Mortgage Payable,Clinic,"Blood Storing, Processing, Trans",Labor and Delivery,Physician Part A,Interns & Residents,Other Special Care Unit,OPT,Respiratory Therapy,Drugs Charged to Patients,Total discharges,"Treatment capacity per day per
station",Dietary,Cafeteria employees and guests,Prepaid expenses,Buildings and Fixtures,RHC,Medical Records and Medical Rec. Library,Burn Intensive Care Unit,HHA,Emergency,Occupational Therapy,Whole Blood & Packed Red Blood Cells,Medical Supplies Charged to Patients,Hospital Adults & Pediatrics,Speech Pathology,Radiology-Therapeutic,Ending Date of SCH status,New Capital Equipment,Radiology-Therapeutic,Impl. Dev. Charged to Patients,Drugs Charged to Patients,Building Improvements,PEP Episodes:  Total Visits,Clinic,PBP Clinical Lab Services Program Only,Hospital Adults & Pediatrics,Intravenous Therapy,Lesser of cost or charges,Radiology-Diagnostic,"Number of days in year dialysis 
furnished",Emergency,Clinic,Hospital Adults & Pediatrics,RHC 12 Provider Number,Medicare Certified Kidney TC term date,Nursery,Durable Medical Equipment Rented,Nursery,Other Outpatient Services,Clinic,Total Other Medical Education Cost,Respiratory Therapy,Intestinal Acquisition,SNF,Total Number of Episodes,Recovery Room,Utilization Review SNF,Other Reimbursable,Physicians' Private Office,Land Improvements,Kidney Acquisition,NF,IPF,Clinic,Lung  Acquisition,Cardiac Catheterization,Occupational Therapy,Impl. Dev. Charged to Patients,Interest Expense,Renal Dialysis,Operating Room,Recovery Room,Impl. Dev. Charged to Patients,Electrocardiology,Clinic,Renal Dialysis,Depreciation-New Movable Equipment,Pharmacy,Total Charges,Laboratory,Land,ESRD DME costs,Primary payer payments,NF,Housekeeping,Drugs Charged to Patients,Durable Medical Equipment Rented,Occupational Therapy,MRI,Ambulance Services,Occupational Therapy,Maintenance of Personnel,Laboratory,Home Program Dialysis,Adults and Pediatrics,Total,Emergency,Pancreas Acquisition,Burn Intensive Care Unit,Other Reimbursable,Other Special Purpose,Maintenance of Personnel,ASC (Non Distinct Part),"Number of patients on transplant 
list",Coronary Intensive Care Unit,Observation Beds (Distinct Unit),FQHC,Title XVIII discharges,Lung  Acquisition,Contract Labor: Pysician Part A,Whole Blood & Packed Red Blood Cells,Total Number of Outlier Episodes,Observation Beds (Distinct Unit),Home Office:  Physician Part A,Impl. Dev. Charged to Patients,Total discharges,Home Office Personnel,Other Reimbursable,Occupational Therapy,CMHC,Program Inpatient Ancillary Service Cost,Clinic,Drugs Charged to Patients,Anesthesiology,Subprovider-IPF,Report Record Number,New Cap Related Csts Bldg & Fixtures,New Cap Related Csts Bldg & Fixtures,Surgical Intensive Care Unit,Durable Medical Equipment Rented,Whole Blood & Packed Red Blood Cells,ASC (Non Distinct Part),Total,Total,Nursing Administration,Delivery Room and Labor Room,Tentative settlement,ICF,Anesthesiology,Whole Blood & Packed Red Blood Cells,Other Reimbursable,Impl. Dev. Charged to Patients,OSP,Cafeteria,Intensive Care Unit,Subprovider-IRF,Intravenous Therapy,Subprovider II,MRI,Intestinal Acquisition,Whole Blood & Packed Red Blood Cells,Other Special Purpose,With Outliers:  Total Visits,Burn Intensive Care Unit,Respiratory Therapy,Laboratory,Nursery,Cardiac Catheterization,MRI,Anesthesiology,Pancreas Acquisition,Total Number of Outlier Episodes,Recovery Room,Physicians' Private Office,Total,Emergency,Charity care charges and uninsured discounts for the entire facility,"Sum of lines 3,4 divided by line 6",PEP Episodes:  Other Charges,Radiology-Diagnostic,Television and Radio Service,Anesthesiology,Total Outpatient Program Pass Thru Cost,ASC (Non Distinct Part),Home Office:  Physician Part A,Total Other Charges,Paramedical Education,Other Special Care Unit,Whole Blood & Packed Red Blood Cells,Total Program Inpatient Costs,OLTC,Donations,OPT,Hospice 3 Provider Number,CMHC,Maintenance and Repairs,ASC (Non Distinct Part),Blood Clotting Factors for Hemoph.,Title XVIII discharges,Ambulance Services,Radioisotope,Durable Medical Equipment Sold,Liver Acquisition,SNF,Emergency,Medical Supplies Charged to Patients,Subtotal Wage Related Csts,Surgical Intensive Care Unit,Ambulance Services,Title V discharges,Durable Medical Equipment Sold,Physical Therapy,Home Program Dialysis,Total,Radioisotope,CORF,Total reasonable charges,Labor and Delivery Days Title 18,Subprovider II,Other Outpatient Services,Adults and Pediatrics,Total Hospital,Renal Dialysis,New Capital Equipment,Other Nonreimbursable,Emergency,Respiratory Therapy,Int & Res (non approved teaching program,HHA 3 Provider Number,Urban/Rural Indicator at beginning,Intestinal Acquisition,"Are there any related organization or how office costs as defined in HCFA Pub. 15-I, chapter 10? (Y/N)",PEP:  Total Non Routine Med Supply Chgs,Total Hospital,Other Outpatient Services,"Blood Storing, Processing, Trans",Durable Medical Equipment Sold,Durable Medical Equipment Rented,Home Office:  Physician Part A,Home Office Salaries & Wage Related Csts,RHC,Adj for Physical therapy costs in excess,Cardiac Catheterization,Electrocardiology,Non-Physician Anesthetist Part B,Intensive Care Unit,Other Reimbursable,Total,CT Scan,Dietary,Laboratory,Recovery Room,Operating Room,RHC,Respiratory Therapy,ASC (Distinct Part),Impl. Dev. Charged to Patients,OSP,Interns & Residents,ASC (Non Distinct Part),FI/Contractor's Name,HVBP payment adjustment amount,Notes Payable,Other Outpatient Services,Durable Medical Equipment Sold,Total,Subprovider I,Respiratory Therapy,Other Outpatient Services,Blood Clotting Factors for Hemoph.,CAH Visits,Intensive Care Unit,Other Special Care,Nonpaid Workers,Heart Acquisition,Speech Pathology,Durable Medical Equipment Rented,Impl. Dev. Charged to Patients,Administrative & General under contract,Pharmacy,Speech Pathology,Nursing Administration,Radioisotope,Drugs Charged to Patients,Islet Acquisition,RHC/FQHC Combined,Laboratory,Electrocardiology,Renal 1 Provider Number,Physical Therapy,With Outliers:  Other Charges,Whole Blood & Packed Red Blood Cells,Intensive Care Unit,Total,Other Outpatient Services,Cardiac Catheterization,New Cap Related Csts Movable Equipment,Radiology-Diagnostic,Drugs Charged to Patients,Housekeeping,Nonpaid Workers,Intravenous Therapy,Emergency,Cardiac Catheterization,Adj for Speech therapy in excess of lim,Is this hospital an All-Inclusive rate provider? (Y/N),Lung  Acquisition,Other Special Care Unit,Impl. Dev. Charged to Patients,Intensive Care Unit,Respiratory Therapy,Other Reimbursable,Surgical Intensive Care Unit,Total Facility FTEs,"Number of patients in program at 
end of cost reporting period",Fixed Equipment,CMHC,Impl. Dev. Charged to Patients,MRI,Impl. Dev. Charged to Patients,Observation Beds (Distinct Unit),Interns & Residents,Non-Physician Anesthetist Part A,Durable Medical Equipment Rented,Organ acquisition,Less: Allowances for uncollectible notes and accounts receivable,Wage Related Costs Core,Disp. And Retirement,Renal 7 Provider Number,Physician Part A Teaching,Speech Pathology,Cardiac Catheterization,Total Other Expenses,Radiology-Diagnostic,Observation Beds (Distinct Unit),SNF,ASC (Non Distinct Part),Radiology-Diagnostic,Employee Benefits,Total Hospital,Coronary Care Unit,Operating Room,Cardiac Catheterization,Whole Blood & Packed Red Blood Cells,Program Discharges,Subprovider I,Intravenous Therapy,Cardiac Catheterization,Ending Date of SCH status,Premiums,Surgical Intensive Care Unit,Laundry and Linen Service,Other Ancillary,Laboratory,Land,Coronary Care Unit,"Blood Storing, Processing, Trans",Other Nonreimbursable,Does the hospital qualify as RPCH/CAH? (Y/N),Medical Supplies Charged to Patients,Durable Medical Equipment Rented,Kidney Acquisition,SSA State Code,Drugs Charged to Patients,Total Hospital Interns & Residents,Drugs Charged to Patients,IRF Provider Number,Laboratory,Respiratory Therapy,ASC (Non Distinct Part),Subprovider II,Total discharges,"Blood Storing, Processing, Trans",Nursing Administration,Other Special Care Unit,PBP Clinical Lab Services Program Only,Home Office Salaries & Wage Related Csts,Net Salaries,Other Ancillary,Renal Dialysis,Pharmacy,Total Visits,Observation Beds (Distinct Unit),Respiratory Therapy,Occupational Therapy,Total Subprovider I Interns & Residents,Total Facility FTEs,Islet Acquisition,Number of stations,Operating Room,OLTC,Speech Pathology,Interns & Res Other Program Costs,Kidney Acquisition,Occupational Therapy,Durable Medical Equipment Sold,Title XIX discharges,Drugs Charged to Patients,Non-physician Anesthetist,ASC (Non Distinct Part),Ambulance Trips,CT Scan,Home Office Personnel,Total Overhead Costs,Radioisotope,Physical Therapy,Research,Renal Dialysis,Medical Records & Med Records Library,Delivery Room and Labor Room,Interns & Residents,Sale of medical records and abstracts,Observation Beds (Distinct Unit),Impl. Dev. Charged to Patients,Physician Part A Teaching,Pharmacy,Int & Res (non approved teaching program,Electroencephalography,NF,Ambulance Services,"Medical certified liver 
transplant center cert date",SNF,Ambulance Services,Radioisotope,"Epoietin amount form worksheet A
for home dialysis program",Other Special Care Unit,Radiology-Therapeutic,Electroencephalography,Other Ancillary,Delivery Room and Labor Room,Durable Medical Equipment Sold,Durable Medical Equipment Rented,Durable Medical Equipment Rented,Delivery Room and Labor Room,OPT,"Blood Storing, Processing, Trans",Nursery,Coronary Care Unit,Islet Acquisition,Other Special Purpose,Land,Subprovider II,Other Outpatient Services,Maintenance of Personnel,Radiology-Therapeutic,Physical Therapy,Physician Part A,ASC (Non Distinct Part),Speech Pathology,RHC 18 Provider Number,Electroencephalography,Total Bad Debt expense,Intravenous Therapy,Renal Dialysis,Other Special Care Unit,Nursery,Other Outpatient Services,Geographic MSA,Other Special Care,Speech Pathology,Clinic,Renal Dialysis,Payments received from patients for amounts previously written off as charity care,RHC,Outpatient Rehab Provider,Recovery Room,Allowable Inpatient Cost Plus Incentive Pt,Nonpaid Workers,Physical Therapy,Total,Electrocardiology,Other Outpatient Services,Related Salaries,Durable Medical Equipment Rented,FQHC,With Outliers:  Number of Episodes,Other Special Purpose,Radiology-Therapeutic,Renal Dialysis,Excluded Areas,ASC (Non Distinct Part),Burn Intensive Care Unit,Emergency,Clinic,IPF,Interns & Residents,OSP,IPPS Interim payment,Total Program General Inpatient Routine,Surgical Intensive Care Unit,Medical Supplies Charged to Patients,Whole Blood & Packed Red Blood Cells,Electroencephalography,Respiratory Therapy,Subtotal Other Wages and Related Csts,Burn Intensive Care Unit,Pharmacy,Radiology-Therapeutic,Observation Beds (Distinct Unit),Whole Blood & Packed Red Blood Cells,Other Reimbursable,Total,Other Ancillary,Medical Supplies Charged to Patients,Surgical Intensive Care Unit,Intensive Care Unit,Operating Room,General Fund Balance,Coronary Care Unit,Heart Acquisition,Dietary,Total Program General Inp. Rtn Service,Burn Intensive Care Unit,Ending Balance,Adults and Pediatrics,Radiology-Diagnostic,Wage Related Costs RHC/FQHC,Int & Res (non approved teaching program,Total Other Medical Education,Hospital Adlts & Ped Swing Bed NF,Refunds and Rebates of Expenses,Whole Blood & Packed Red Blood Cells,"Blood Storing, Processing, Trans",Program Ancillary Services,Intensive Care Unit,Medical and Other Services reimbursed by OPPS,Medical and Other Services reimbursed by OPPS,Interns & Residents,Delivery Room and Labor Room,Total,Occupational Therapy,Accounts Receivable,Interns & Residents,LUPA Episodes:  Total Visits,Electroencephalography,Medical Supplies Charged to Patients,Private grants or donations or endowment income restricted to funding charity care,Subprovider II,New Cap Related Csts Movable Equipment,OPT,Subprovider 2,Land Improvements,Physical Therapy,Adults and Pediatrics,Laboratory,Delivery Room and Labor Room,HHA,CT Scan,Clinic,Subtotal Salaries,Social Service,"Number of Times per week 
Patient receives Dialysis",Kidney Acquisition,Coronary Care Unit,Whole Blood & Packed Red Blood Cells,Buildings and Fixtures,Electroencephalography,Medicaid HMO Days,Movable Equipment,Other Nonreimbursable,Pass Through Cost for  Program Ancillary,Government grants or appropriations or transfers for support of hospital operations,Out of State Medicaid paid days,Social Service,Laboratory,"Does the facility qualify and is it receiving payments for 
disproportionate share? (Y/N)",Subprovider-IPF,Renal Dialysis,Observation Beds (Distinct Unit),Subprovider-IRF,Home Program Dialysis,Surgical Intensive Care Unit,Drugs Charged to Patients,Central Services and Supply,Total Overhead Costs,TOTAL,Central Services and Supply,Title XVIII discharges,Contract Labor:  Physician Part A,Movable Equipment,Coronary Care Unit,PEP Episodes:  Other Charges,Fixed Equipment,Purchase,Whole Blood & Packed Red Blood Cells,PEP Episodes:  Total Number of Episodes,Surgical Intensive Care Unit,HHA,Home Program Dialysis,OOT,Clinic,Renal Dialysis,NF,Speech Pathology,Number of stations,Cardiac Catheterization,Does the hospital elect a fully prospective payment method for capital costs? (Y/N),Medical Records & Med Records Library,Total discharges,OLTC,Radioisotope,Coronary Care Unit,Home Program Dialysis,Total,Occupational Therapy,Land,"Blood Storing, Processing, Trans",Without Outliers:  Other Charges,PEP Episodes:  Total Number of Episodes,Other Outpatient Services,Cost of patients approved for charity care and uninsured discounts,Anesthesiology,PEP Episodes:  Total Number of Episodes,Radiology-Therapeutic,NF,OLTC,New Cap Related Csts Movable Equipment,Hospice 1 Provider Number,Buildings,Subprovider I,Pancreas Acquisition,Occupational Therapy,Total Charges:  LUPA Episodes,Respiratory Therapy,Occupational Therapy,Administrative and General under Contract,Electrocardiology,Average times dialyzers re-used,Labor and Delivery,Without Outliers:  Non Routine Med Sup Chgs,Land Improvements,"Gift, Flower, Coffee Shop, Canteen",Surgical Intensive Care Unit,Physicians' Private Office,Electrocardiology,Operating Room,CT Scan,"Does this facility operate 
transplant center? (Y/N)",Provider's actual MSA or CBSA,Respiratory Therapy,Other Organ Acquisition,With Outliers:  Number of Episodes,Line 2 times line 5,In State Medicaid eligible days,Speech Pathology,Total Income,Anesthesiology,Liver Acquisition,Cost To Charge Ratio,Renal Dialysis,Cardiac Catheterization,Intravenous Therapy,Speech Pathology,Clinic,TOTAL,Recovery Room,RHC,New Cap Related Csts Bldg & Fixtures,ASC (Non Distinct Part),Speech Pathology,CT Scan,Radiology-Therapeutic,Intensive Care Unit,Other Outpatient Services,Interim payments,Other Special Purpose,"Number of Times per week
 Patient receives Dialysis",Total Charges,MRI,Total Visits,Electroencephalography,Subtotal,Other General Service,Non-Physician Anesthetist Part B,Whole Blood & Packed Red Blood Cells,Recovery Room,IRF,Intensive Care Unit,Clinic,"Blood Storing, Processing, Trans",Nursery,Nonpaid Workers,Subtotal Wage Related Csts,Emergency,Ambulance Services,Emergency,Physical Therapy,Excluded Area Salaries,Respiratory Therapy,Operating Room,Excluded Area Salaries,ASC (Distinct Part),Other Outpatient Services,Adults & Pediatrics,net of Swing Bed and Private Room Diff,Radiology-Therapeutic,Other Reimbursable,"Blood Storing, Processing, Trans",Radioisotope,Laboratory,Other Reimbursable,Operating Room,LUPA:  Total Non Routine Med Sup Chgs,Subprovider-IRF,Occupational Therapy,Surgical Intensive Care Unit,Negative Cost Centers,Without Outliers:  Non Routine Med Sup Chgs,Physician Part B,Interns & Res Salary and Fringe Benefits,Cardiac Catheterization,Occupational Therapy,Pancreas Acquisition,RHC 16 Provider Number,Electroencephalography,Total Allied Health Cost,Home Program Dialysis,Non-Physician Anesthetist Part A,RHC/FQHC Combined,Negative Cost Centers,Contract Labor:  Physician Part A,City,CT Scan,Other Reimbursable,Emergency,Outlier payments,Heart Acquisition,Subprovider-IPF,IRF,Durable Medical Equipment Sold,Total customary charges,Total,Surgical Intensive Care Unit,Intravenous Therapy,IRF,Total Non Routine Medical  Supply Charges,Cafeteria,Home Office Personnel,Subprovider-IRF,Physical Therapy,Radioisotope,OSP,OSP,FQHC 7 Provider Number,Teaching Physician Salaries,MRI,MDH status beginning date  (MM/DD/YY),SNF,Subprovider-IPF,Kidney Acquisition,Durable Medical Equipment Rented,Interns & Res Other Program Costs,HHA,With Outliers:  Number of Episodes,OLTC,Whole Blood & Packed Red Blood Cells,Electrocardiology,Total Number of Outlier Episodes,Employee Benefits,New Capital Buildings and Fixtures,Electrocardiology,Renal Dialysis,Other Special Purpose,Target Amount,Medicare Certified Heart TC term date,Other Organ Acquisition,Observation Beds (Distinct Unit),Hospice,Subtotal Salaries,Outpatient Revenue,Intensive Care Unit Program Cost,Impl. Dev. Charged to Patients,RHC 7 Provider Number,Nursing Administration,Ambulance Services,Delivery Room and Labor Room,LUPA:  Total Non Routine Med Sup Chgs,Total Charges,Speech Pathology,Physical Therapy,Anesthesiology,Anesthesiology,Durable Medical Equipment Rented,Delivery Room and Labor Room,MRI,Renal 2 Provider Number,ICF,Maintenance of Personnel,Delivery Room and Labor Room,Other Reimbursable,Administrative and General,Subprovider-IRF,Electroencephalography,Emergency,Radiology-Diagnostic,Total discharges,Operating Room,Pass through Cost for Program Inpatient Routine,Total Allied Health,Intravenous Therapy,Operating Room,Medical Supplies Charged to Patients,Medical Supplies Charged to Patients,Excluded Area Salaries,RHC,Cafeteria,Excluded Area Salaries,"Blood Storing, Processing, Trans",Total Program Excludable Costs,Total,MRI,Adults & Pediatrics,Impl. Dev. Charged to Patients,Clinic,Observation Beds (Distinct Unit),Subprovider I,Recovery Room,Surgical Intensive Care Unit,Non-Physician Anesthetist Part A,Total,Total Liabilities and Fund Balances,Laundry and Linen Service,Other Ancillary,Speech Pathology,Cafeteria,Radiology-Diagnostic,Intravenous Therapy,Laboratory,Anesthesiology,Research,Durable Medical Equipment Rented,Total Long-term Liabilities,ICF,Total Other Medical Education,RPCH/CAH Visits,Non-Physician Part B,CMHC,Liver Acquisition,Impl. Dev. Charged to Patients,Total Program Excludable Costs,IRF,MRI,Laboratory,Total Nursing School,"Average patient dialysis time 
including setup",Subprovider-IPF,SNF,Recovery Room,Other Ancillary,Total Costs,ASC (Non Distinct Part),LUPA Episodes:  Other Charges,Heart Acquisition,Respiratory Therapy,Dietary,Other Capital,"Average patient dialysis time 
including setup",SNF Provider Number,Blood Clotting Factors for Hemoph.,Coronary Care Unit,Impl. Dev. Charged to Patients,Coronary Care Unit,Movable Equipment,CT Scan,Observation Beds (Distinct Unit),Total prospective payment,Burn Intensive Care Unit,Radioisotope,Renal Dialysis,Number of EPO units furnished for Line 13,Total Salaries,Net Revenue from stand-alone SCHIP,Total Fixed Assets,Dietary under Contract,Radioisotope,PEP:  Total Non Routine Med Supply Chgs,ASC (Non Distinct Part),Subprovider-IPF,net of Swing Bed and Private Room Diff,Anesthesiology,Cardiac Catheterization,"Blood Storing, Processing, Trans",Excess of reasonable cost over reasonable charges,Subtotal,Home Office PO Box,"Number of Times per week
 Patient receives Dialysis",Total,Intravenous Therapy,ASC (Non Distinct Part),RHC 1 Provider Number,Other Special Care Unit,Other Reimbursable,Research,CT Scan,MSP-LCC reconciliation amount,Radioisotope,Adjusted reimburseable bad debts,ICF,Radioisotope,Fixed Equipment,Drugs Charged to Patients,OLTC,Total Salaries,Laboratory,Dietary,Subtotal,Radioisotope,Whole Blood & Packed Red Blood Cells,Speech Pathology,Physician-Part A,LUPA Episodes:  Total Number of Episodes,Radioisotope,Durable Medical Equipment Rented,Clinic,Operating Room,Delivery Room and Labor Room,CORF,Interns & Residents,Laboratory,CT Scan,Islet Acquisition,Impl. Dev. Charged to Patients,CMHC,Total Hospital Interns & Residents,Housekeeping,Other Ancillary,net of Swing Bed and Private Room Diff,ASC (Non Distinct Part),Liver Acquisition,Coronary Care Unit,ASC (Non Distinct Part),Clinic,Anesthesiology,Observation Beds (Distinct Unit),Home Program Dialysis,Drugs Charged to Patients,Hospice 2 Provider Number,Zip Code,Recovery Room,Occupational Therapy,Heart Acquisition,Wage Related Costs Other,Cost of charity care,Other Organ Acquisition,Laundry and Linen Service,HRR adjustment amount ,"Sum of lines 3,4 divided by line 6",Laboratory,Kidney Acquisition,Laboratory,Housekeeping under Contract,With Outliers:  Non Routine Med Sup Chgs,FQHC 5 Provider Number,Without Outliers:  Total Visits,Total Subprovider II Interns & Residents,New Cap Related Csts Bldg & Fixtures,Anesthesiology,"Treatment capacity per day per
station",Impl. Dev. Charged to Patients,Recovery Room,Total Other Income,ASC (Non Distinct Part),ASC (Non Distinct Part),Durable Medical Equipment Sold,Radioisotope,Intravenous Therapy,Radiology-Diagnostic,FQHC 3 Provider Number,Other Long-term Liabilities,Hospital Adults & Pediatrics,Pharmacy,Anesthesiology,Speech Pathology,Cardiac Catheterization,PBP Clinical Lab Services Program Only,Surgical Intensive Care Unit,Deferred Income,Blood Clotting Factors for Hemoph.,Electrocardiology,OOT,Drugs Charged to Patients,Recovery Room,MRI,Whole Blood & Packed Red Blood Cells,Cardiac Catheterization,Hospital County,Radiology-Therapeutic,Wage Related Costs RHC/FQHC,CT Scan,Ancillary service other pass through costs,Durable Medical Equipment Sold,Program Inpatient Ancillary Service Cost,"Blood Storing, Processing, Trans",Operating Room,Impl. Dev. Charged to Patients,Radioisotope,"Gift, Flower, Coffee Shop, Canteen",Intravenous Therapy,Utilization,Total Allied Health,Observation Beds (Distinct Unit),Delivery Room and Labor Room,or allied health costs?,CMS Region Code,New Cap Related Csts Movable Equipment,Electrocardiology,Other Special Care Unit,Adj for Occupational therapy in excess of li,Other Ancillary,SNF,Total Number of Episodes,Other Reimbursable,Radiology-Therapeutic,Electroencephalography,Other Reimbursable,Cafeteria,Burn Intensive Care Unit,Burn Intensive Care Unit,Home Office Name,Laboratory,Heart Acquisition,CT Scan,Respiratory Therapy,Medical Supplies Charged to Patients,Average times dialyzers re-used,Clinic,Impl. Dev. Charged to Patients,Anesthesiology,Cafeteria,Home Office Salaries & Wage Related Csts,Other Outpatient Services,Anesthesiology,"Number of patients in program at 
end of cost reporting period",Organ Procurement,PEP Episodes:  Total Charges:,Hospice,CT Scan,Adults & Pediatrics,Organ Procurement,net of Swing Bed and Private Room Diff,Electroencephalography,Total Nursing School,Hospital Adlts & Ped Swing Bed SNF,Other Outpatient Services,ASC (Non Distinct Part),Recovery Room,Paramedical Education,Radioisotope,HAC reduction adjustment amount,Physician-Part B,Admin & Gen Under Contract,Operating Room,Intravenous Therapy,Kidney Acquisition,Utilization Review SNF,Is this a New Hospital under 42 CFR 413.40(f)(1)(I) (TEFRA)? (Y/N),Other Organ Acquisition,Total Outpatient Program Pass Thru Cost,Renal Dialysis,Nursery,FFY,Hospital Type (From CMS Hospitals Data Archive),Name and Num
,Curated Name and Num,Hospital type (modified),,Lon,Lat,INPATIENT ANCILLARY SERVICE COST APPORTIONMENT,Total Inpatient Days/Outpatient Visits,ADJUSTMENTS,APPORTIONMENT OF MEDICAL AND OTHER HEALTH SERVICES,COMPUTATION OF INPATIENT OPERATING COSTS,COMPUTATION OF RATIO OF COST TO CHARGES,COST ALLOCATION,Total Inpatient Days/Outpatient Visits,ADJUSTMENTS,APPORTIONMENT OF MEDICAL AND OTHER HEALTH SERVICES,HOSPITAL WAGE INDEX DATA,Medicaid Inpatient Days/Outpatient Visits,HOSPITAL WAGE INDEX DATA,ANALYSIS OF CHANGES IN NEW CAPITAL BALANCES,RENAL STATISTICAL DATA,COMPUTATION OF RATIO OF COST TO CHARGES,TRIAL BALANCE OF EXPENSE ACCOUNTS,APPORTIONMENT OF INPATIENT/OUTPATIENT ANCILLARY SERVICE OTHER PASS THROUGH COSTS,HOSPITAL WAGE INDEX DATA,COST ALLOCATION,APPORTIONMENT OF INPATIENT ROUTINE SERVICE CAPITAL COSTS,APPORTIONMENT OF INPATIENT/OUTPATIENT ANCILLARY SERVICE OTHER PASS THROUGH COSTS,TRIAL BALANCE OF EXPENSE ACCOUNTS,RENAL STATISTICAL DATA,Medicare Inpatient Days/Outpatient Visits,BED DAYS AVAILABLE,BED DAYS AVAILABLE,APPORTIONMENT OF INPATIENT ROUTINE SERVICE OTHER PASS THROUGH COSTS,INPATIENT ANCILLARY SERVICE COST APPORTIONMENT,INPATIENT ANCILLARY SERVICE COST APPORTIONMENT,INPATIENT ANCILLARY SERVICE COST APPORTIONMENT,INPATIENT ANCILLARY SERVICE COST APPORTIONMENT,ANALYSIS OF CHANGES IN NEW CAPITAL BALANCES,Medicare Inpatient Days/Outpatient Visits,Medicare Inpatient Days/Outpatient Visits,,COMPUTATION OF RATIO OF COST TO CHARGES,ANALYSIS OF CHANGES IN NEW CAPITAL BALANCES,ALLOCATION OF NEW CAPITAL COSTS,INPATIENT ANCILLARY SERVICE COST APPORTIONMENT,APPORTIONMENT OF INPATIENT/OUTPATIENT ANCILLARY SERVICE OTHER PASS THROUGH COSTS,HHA STATISTICAL DATA,APPORTIONMENT OF INPATIENT/OUTPATIENT ANCILLARY SERVICE OTHER PASS THROUGH COSTS,HOSPITAL WAGE INDEX DATA,HOSPITAL WAGE INDEX DATA,TRIAL BALANCE OF EXPENSE ACCOUNTS,APPORTIONMENT OF INPATIENT/OUTPATIENT ANCILLARY SERVICE OTHER PASS THROUGH COSTS,APPORTIONMENT OF INPATIENT/OUTPATIENT ANCILLARY SERVICE OTHER PASS THROUGH COSTS,INPATIENT ANCILLARY SERVICE COST APPORTIONMENT,HOSPITAL WAGE INDEX DATA,HHA STATISTICAL DATA,INPATIENT ANCILLARY SERVICE COST APPORTIONMENT,COST ALLOCATION,BALANCE SHEET,CALCULATION OF REIMBURSEMENT SETTLEMENT,APPORTIONMENT OF INPATIENT/OUTPATIENT ANCILLARY SERVICE OTHER PASS THROUGH COSTS,COMPUTATION OF RATIO OF COST TO CHARGES,APPORTIONMENT OF INPATIENT/OUTPATIENT ANCILLARY SERVICE OTHER PASS THROUGH COSTS,,APPORTIONMENT OF INPATIENT/OUTPATIENT ANCILLARY SERVICE OTHER PASS THROUGH COSTS,APPORTIONMENT OF INPATIENT ROUTINE SERVICE OTHER PASS THROUGH COSTS,BED DAYS AVAILABLE,COST ALLOCATION,TRIAL BALANCE OF EXPENSE ACCOUNTS,TRIAL BALANCE OF EXPENSE ACCOUNTS,COST ALLOCATION,COST ALLOCATION,APPORTIONMENT OF INPATIENT/OUTPATIENT ANCILLARY SERVICE OTHER PASS THROUGH COSTS,APPORTIONMENT OF MEDICAL AND OTHER HEALTH SERVICES,APPORTIONMENT OF INPATIENT/OUTPATIENT ANCILLARY SERVICE OTHER PASS THROUGH COSTS,COST ALLOCATION,Total Inpatient Days/Outpatient Visits,APPORTIONMENT OF MEDICAL AND OTHER HEALTH SERVICES,,INPATIENT ANCILLARY SERVICE COST APPORTIONMENT,APPORTIONMENT OF MEDICAL AND OTHER HEALTH SERVICES,COST ALLOCATION,APPORTIONMENT OF INPATIENT/OUTPATIENT ANCILLARY SERVICE OTHER PASS THROUGH COSTS,INPATIENT ANCILLARY SERVICE COST APPORTIONMENT,APPORTIONMENT OF INPATIENT/OUTPATIENT ANCILLARY SERVICE OTHER PASS THROUGH COSTS,APPORTIONMENT OF INPATIENT/OUTPATIENT ANCILLARY SERVICE OTHER PASS THROUGH COSTS,APPORTIONMENT OF INPATIENT ROUTINE SERVICE CAPITAL COSTS,INPATIENT ANCILLARY SERVICE COST APPORTIONMENT,Total Inpatient Days/Outpatient Visits,COST ALLOCATION,RECONCILIATION OF CAPITAL COST CENTERS,Medicaid Inpatient Days/Outpatient Visits,COMPUTATION OF RATIO OF COST TO CHARGES,INPATIENT ANCILLARY SERVICE COST APPORTIONMENT,BALANCE SHEET,APPORTIONMENT OF INPATIENT/OUTPATIENT ANCILLARY SERVICE OTHER PASS THROUGH COSTS,CALCULATION OF REIMBURSEMENT SETTLEMENT,TRIAL BALANCE OF EXPENSE ACCOUNTS,TRIAL BALANCE OF EXPENSE ACCOUNTS,COST ALLOCATION,APPORTIONMENT OF MEDICAL AND OTHER HEALTH SERVICES,COST ALLOCATION,INPATIENT ANCILLARY SERVICE COST APPORTIONMENT,APPORTIONMENT OF MEDICAL AND OTHER HEALTH SERVICES,COMPUTATION OF RATIO OF COST TO CHARGES,INPATIENT ANCILLARY SERVICE COST APPORTIONMENT,APPORTIONMENT OF INPATIENT/OUTPATIENT ANCILLARY SERVICE OTHER PASS THROUGH COSTS,APPORTIONMENT OF INPATIENT/OUTPATIENT ANCILLARY SERVICE OTHER PASS THROUGH COSTS,HHA STATISTICAL DATA,INPATIENT ANCILLARY SERVICE COST APPORTIONMENT,HOSPITAL WAGE INDEX DATA,COST ALLOCATION,COMPUTATION OF RATIO OF COST TO CHARGES,COMPUTATION OF RATIO OF COST TO CHARGES,APPORTIONMENT OF INPATIENT/OUTPATIENT ANCILLARY SERVICE OTHER PASS THROUGH COSTS,APPORTIONMENT OF INPATIENT/OUTPATIENT ANCILLARY SERVICE OTHER PASS THROUGH COSTS,APPORTIONMENT OF INPATIENT/OUTPATIENT ANCILLARY SERVICE OTHER PASS THROUGH COSTS,COST ALLOCATION,APPORTIONMENT OF MEDICAL AND OTHER HEALTH SERVICES,Total Inpatient Days/Outpatient Visits,INPATIENT ANCILLARY SERVICE COST APPORTIONMENT,,INPATIENT ANCILLARY SERVICE COST APPORTIONMENT,COST ALLOCATION,ALLOCATION OF NEW CAPITAL COSTS,INPATIENT ANCILLARY SERVICE COST APPORTIONMENT,COMPUTATION OF RATIO OF COST TO CHARGES,RECONCILIATION OF CAPITAL COST CENTERS,HOSPITAL WAGE INDEX DATA,INPATIENT ANCILLARY SERVICE COST APPORTIONMENT,INPATIENT ANCILLARY SERVICE COST APPORTIONMENT,,NUMBER OF BEDS,BED DAYS AVAILABLE,ANALYSIS OF CHANGES IN NEW CAPITAL BALANCES,COST ALLOCATION,INPATIENT ANCILLARY SERVICE COST APPORTIONMENT,INPATIENT ANCILLARY SERVICE COST APPORTIONMENT,CALCULATION OF REIMBURSEMENT SETTLEMENT,APPORTIONMENT OF INPATIENT/OUTPATIENT ANCILLARY SERVICE OTHER PASS THROUGH COSTS,,APPORTIONMENT OF INPATIENT/OUTPATIENT ANCILLARY SERVICE OTHER PASS THROUGH COSTS,,TRIAL BALANCE OF EXPENSE ACCOUNTS,COMPUTATION OF INPATIENT OPERATING COSTS,Medicaid Inpatient Days/Outpatient Visits,BALANCE SHEET,INPATIENT ANCILLARY SERVICE COST APPORTIONMENT,TRIAL BALANCE OF EXPENSE ACCOUNTS,COMPUTATION OF RATIO OF COST TO CHARGES,Medicare Inpatient Days/Outpatient Visits,TRIAL BALANCE OF EXPENSE ACCOUNTS,COST ALLOCATION,APPORTIONMENT OF INPATIENT/OUTPATIENT ANCILLARY SERVICE OTHER PASS THROUGH COSTS,APPORTIONMENT OF INPATIENT/OUTPATIENT ANCILLARY SERVICE OTHER PASS THROUGH COSTS,APPORTIONMENT OF MEDICAL AND OTHER HEALTH SERVICES,COST ALLOCATION,APPORTIONMENT OF INPATIENT/OUTPATIENT ANCILLARY SERVICE OTHER PASS THROUGH COSTS,INPATIENT ANCILLARY SERVICE COST APPORTIONMENT,ALLOCATION OF NEW CAPITAL COSTS,INPATIENT ANCILLARY SERVICE COST APPORTIONMENT,INPATIENT ANCILLARY SERVICE COST APPORTIONMENT,APPORTIONMENT OF MEDICAL AND OTHER HEALTH SERVICES,APPORTIONMENT OF INPATIENT/OUTPATIENT ANCILLARY SERVICE OTHER PASS THROUGH COSTS,APPORTIONMENT OF MEDICAL AND OTHER HEALTH SERVICES,Medicaid Inpatient Days/Outpatient Visits,HOSPITAL WAGE INDEX DATA,STATEMENT OF REVENUES AND EXPENSES,ALLOCATION OF NEW CAPITAL COSTS,Medicare Inpatient Days/Outpatient Visits,APPORTIONMENT OF INPATIENT/OUTPATIENT ANCILLARY SERVICE OTHER PASS THROUGH COSTS,TRIAL BALANCE OF EXPENSE ACCOUNTS,APPORTIONMENT OF MEDICAL AND OTHER HEALTH SERVICES,INPATIENT ANCILLARY SERVICE COST APPORTIONMENT,COMPUTATION OF RATIO OF COST TO CHARGES,ANALYSIS OF CHANGES IN NEW CAPITAL BALANCES,APPORTIONMENT OF INPATIENT/OUTPATIENT ANCILLARY SERVICE OTHER PASS THROUGH COSTS,COST ALLOCATION,Total Inpatient Days/Outpatient Visits,COST ALLOCATION,S-10 DATA,COST ALLOCATION,INPATIENT ANCILLARY SERVICE COST APPORTIONMENT,INPATIENT ANCILLARY SERVICE COST APPORTIONMENT,,COST ALLOCATION,APPORTIONMENT OF INPATIENT/OUTPATIENT ANCILLARY SERVICE OTHER PASS THROUGH COSTS,APPORTIONMENT OF INPATIENT/OUTPATIENT ANCILLARY SERVICE OTHER PASS THROUGH COSTS,APPORTIONMENT OF INPATIENT/OUTPATIENT ANCILLARY SERVICE OTHER PASS THROUGH COSTS,HHA STATISTICAL DATA,ALLOCATION OF NEW CAPITAL COSTS,HOSPITAL WAGE INDEX DATA,HOSPITAL WAGE INDEX DATA,COST ALLOCATION,APPORTIONMENT OF INPATIENT/OUTPATIENT ANCILLARY SERVICE OTHER PASS THROUGH COSTS,APPORTIONMENT OF INPATIENT/OUTPATIENT ANCILLARY SERVICE OTHER PASS THROUGH COSTS,APPORTIONMENT OF INPATIENT/OUTPATIENT ANCILLARY SERVICE OTHER PASS THROUGH COSTS,APPORTIONMENT OF MEDICAL AND OTHER HEALTH SERVICES,APPORTIONMENT OF MEDICAL AND OTHER HEALTH SERVICES,APPORTIONMENT OF INPATIENT/OUTPATIENT ANCILLARY SERVICE OTHER PASS THROUGH COSTS,APPORTIONMENT OF INPATIENT/OUTPATIENT ANCILLARY SERVICE OTHER PASS THROUGH COSTS,INPATIENT ANCILLARY SERVICE COST APPORTIONMENT,HOSPITAL IDENTIFICATION INFORMATION,TRIAL BALANCE OF EXPENSE ACCOUNTS,ADJUSTMENTS,APPORTIONMENT OF INPATIENT/OUTPATIENT ANCILLARY SERVICE OTHER PASS THROUGH COSTS,BED DAYS AVAILABLE,COMPUTATION OF RATIO OF COST TO CHARGES,COMPUTATION OF RATIO OF COST TO CHARGES,ANALYSIS OF CHANGES IN NEW CAPITAL BALANCES,Total Inpatient Days/Outpatient Visits,TRIAL BALANCE OF EXPENSE ACCOUNTS,APPORTIONMENT OF INPATIENT/OUTPATIENT ANCILLARY SERVICE OTHER PASS THROUGH COSTS,APPORTIONMENT OF INPATIENT/OUTPATIENT ANCILLARY SERVICE OTHER PASS THROUGH COSTS,APPORTIONMENT OF MEDICAL AND OTHER HEALTH SERVICES,HHA STATISTICAL DATA,INPATIENT ANCILLARY SERVICE COST APPORTIONMENT,BALANCE SHEET,HOSPITAL WAGE INDEX DATA,APPORTIONMENT OF INPATIENT/OUTPATIENT ANCILLARY SERVICE OTHER PASS THROUGH COSTS,HOSPITAL WAGE INDEX DATA,HHA STATISTICAL DATA,COMPUTATION OF RATIO OF COST TO CHARGES,APPORTIONMENT OF INPATIENT/OUTPATIENT ANCILLARY SERVICE OTHER PASS THROUGH COSTS,COMPUTATION OF RATIO OF COST TO CHARGES,APPORTIONMENT OF MEDICAL AND OTHER HEALTH SERVICES,COMPUTATION OF INPATIENT OPERATING COSTS,COST ALLOCATION,ANALYSIS OF CHANGES IN NEW CAPITAL BALANCES,ALLOCATION OF NEW CAPITAL COSTS,HOSPITAL WAGE INDEX DATA,,TRIAL BALANCE OF EXPENSE ACCOUNTS,S-10 DATA,COMPUTATION OF RATIO OF COST TO CHARGES,APPORTIONMENT OF INPATIENT/OUTPATIENT ANCILLARY SERVICE OTHER PASS THROUGH COSTS,APPORTIONMENT OF MEDICAL AND OTHER HEALTH SERVICES,COST ALLOCATION,APPORTIONMENT OF INPATIENT/OUTPATIENT ANCILLARY SERVICE OTHER PASS THROUGH COSTS,TRIAL BALANCE OF EXPENSE ACCOUNTS,HOSPITAL WAGE INDEX DATA,TRIAL BALANCE OF EXPENSE ACCOUNTS,TRIAL BALANCE OF EXPENSE ACCOUNTS,HOSPITAL WAGE INDEX DATA,APPORTIONMENT OF INPATIENT/OUTPATIENT ANCILLARY SERVICE OTHER PASS THROUGH COSTS,COST ALLOCATION,HOSPITAL WAGE INDEX DATA,COMPUTATION OF RATIO OF COST TO CHARGES,APPORTIONMENT OF INPATIENT/OUTPATIENT ANCILLARY SERVICE OTHER PASS THROUGH COSTS,HHA STATISTICAL DATA,INPATIENT ANCILLARY SERVICE COST APPORTIONMENT,CALCULATION OF REIMBURSEMENT SETTLEMENT,APPORTIONMENT OF MEDICAL AND OTHER HEALTH SERVICES,APPORTIONMENT OF INPATIENT/OUTPATIENT ANCILLARY SERVICE OTHER PASS THROUGH COSTS,COMPUTATION OF RATIO OF COST TO CHARGES,Medicare Inpatient Days/Outpatient Visits,INPATIENT ANCILLARY SERVICE COST APPORTIONMENT,COMPUTATION OF RATIO OF COST TO CHARGES,HOSPITAL IDENTIFICATION INFORMATION,COST ALLOCATION,HOSPITAL WAGE INDEX DATA,HOSPITAL WAGE INDEX DATA,APPORTIONMENT OF INPATIENT/OUTPATIENT ANCILLARY SERVICE OTHER PASS THROUGH COSTS,INPATIENT ANCILLARY SERVICE COST APPORTIONMENT,APPORTIONMENT OF MEDICAL AND OTHER HEALTH SERVICES,TRIAL BALANCE OF EXPENSE ACCOUNTS,APPORTIONMENT OF INPATIENT/OUTPATIENT ANCILLARY SERVICE OTHER PASS THROUGH COSTS,INPATIENT ANCILLARY SERVICE COST APPORTIONMENT,COMPUTATION OF RATIO OF COST TO CHARGES,COST ALLOCATION,APPORTIONMENT OF MEDICAL AND OTHER HEALTH SERVICES,ALLOCATION OF NEW CAPITAL COSTS,,COST ALLOCATION,INPATIENT ANCILLARY SERVICE COST APPORTIONMENT,,HOSPITAL WAGE INDEX DATA,APPORTIONMENT OF INPATIENT/OUTPATIENT ANCILLARY SERVICE OTHER PASS THROUGH COSTS,INPATIENT ANCILLARY SERVICE COST APPORTIONMENT,CALCULATION OF REIMBURSEMENT SETTLEMENT,,INPATIENT ANCILLARY SERVICE COST APPORTIONMENT,APPORTIONMENT OF INPATIENT ROUTINE SERVICE OTHER PASS THROUGH COSTS,HOSPITAL WAGE INDEX DATA,COST ALLOCATION,APPORTIONMENT OF INPATIENT ROUTINE SERVICE OTHER PASS THROUGH COSTS,,,APPORTIONMENT OF INPATIENT/OUTPATIENT ANCILLARY SERVICE OTHER PASS THROUGH COSTS,INPATIENT ANCILLARY SERVICE COST APPORTIONMENT,HOSPITAL WAGE INDEX DATA,TRIAL BALANCE OF EXPENSE ACCOUNTS,INPATIENT ANCILLARY SERVICE COST APPORTIONMENT,HOSPITAL WAGE INDEX DATA,APPORTIONMENT OF INPATIENT/OUTPATIENT ANCILLARY SERVICE OTHER PASS THROUGH COSTS,INPATIENT ANCILLARY SERVICE COST APPORTIONMENT,APPORTIONMENT OF INPATIENT/OUTPATIENT ANCILLARY SERVICE OTHER PASS THROUGH COSTS,HOSPITAL WAGE INDEX DATA,HOSPITAL WAGE INDEX DATA,APPORTIONMENT OF MEDICAL AND OTHER HEALTH SERVICES,COMPUTATION OF RATIO OF COST TO CHARGES,COST ALLOCATION,INPATIENT ANCILLARY SERVICE COST APPORTIONMENT,HHA STATISTICAL DATA,BALANCE SHEET,INPATIENT ANCILLARY SERVICE COST APPORTIONMENT,,INPATIENT ANCILLARY SERVICE COST APPORTIONMENT,TRIAL BALANCE OF EXPENSE ACCOUNTS,ADJUSTMENTS,COST ALLOCATION,APPORTIONMENT OF MEDICAL AND OTHER HEALTH SERVICES,APPORTIONMENT OF INPATIENT/OUTPATIENT ANCILLARY SERVICE OTHER PASS THROUGH COSTS,APPORTIONMENT OF MEDICAL AND OTHER HEALTH SERVICES,APPORTIONMENT OF INPATIENT/OUTPATIENT ANCILLARY SERVICE OTHER PASS THROUGH COSTS,COMPUTATION OF RATIO OF COST TO CHARGES,COST ALLOCATION,,INPATIENT ANCILLARY SERVICE COST APPORTIONMENT,COMPUTATION OF RATIO OF COST TO CHARGES,INPATIENT ANCILLARY SERVICE COST APPORTIONMENT,INPATIENT ANCILLARY SERVICE COST APPORTIONMENT,APPORTIONMENT OF MEDICAL AND OTHER HEALTH SERVICES,INPATIENT ANCILLARY SERVICE COST APPORTIONMENT,ADJUSTMENTS,HHA STATISTICAL DATA,COMPUTATION OF RATIO OF COST TO CHARGES,HOSPITAL WAGE INDEX DATA,HOSPITAL WAGE INDEX DATA,COMPUTATION OF RATIO OF COST TO CHARGES,APPORTIONMENT OF INPATIENT/OUTPATIENT ANCILLARY SERVICE OTHER PASS THROUGH COSTS,APPORTIONMENT OF INPATIENT/OUTPATIENT ANCILLARY SERVICE OTHER PASS THROUGH COSTS,APPORTIONMENT OF MEDICAL AND OTHER HEALTH SERVICES,APPORTIONMENT OF MEDICAL AND OTHER HEALTH SERVICES,INPATIENT ANCILLARY SERVICE COST APPORTIONMENT,Total Inpatient Days/Outpatient Visits,,APPORTIONMENT OF MEDICAL AND OTHER HEALTH SERVICES,BALANCE SHEET,BALANCE SHEET,TRIAL BALANCE OF EXPENSE ACCOUNTS,COMPUTATION OF INPATIENT OPERATING COSTS,TRIAL BALANCE OF EXPENSE ACCOUNTS,APPORTIONMENT OF INPATIENT/OUTPATIENT ANCILLARY SERVICE OTHER PASS THROUGH COSTS,BALANCE SHEET,BALANCE SHEET,ALLOCATION OF NEW CAPITAL COSTS,APPORTIONMENT OF INPATIENT/OUTPATIENT ANCILLARY SERVICE OTHER PASS THROUGH COSTS,NUMBER OF BEDS,HHA STATISTICAL DATA,APPORTIONMENT OF INPATIENT/OUTPATIENT ANCILLARY SERVICE OTHER PASS THROUGH COSTS,APPORTIONMENT OF INPATIENT/OUTPATIENT ANCILLARY SERVICE OTHER PASS THROUGH COSTS,APPORTIONMENT OF INPATIENT/OUTPATIENT ANCILLARY SERVICE OTHER PASS THROUGH COSTS,Total Inpatient Days/Outpatient Visits,RECONCILIATION OF CAPITAL COST CENTERS,COMPUTATION OF RATIO OF COST TO CHARGES,COMPUTATION OF RATIO OF COST TO CHARGES,BALANCE SHEET,,COMPUTATION OF INPATIENT OPERATING COSTS,COMPUTATION OF RATIO OF COST TO CHARGES,APPORTIONMENT OF INPATIENT/OUTPATIENT ANCILLARY SERVICE OTHER PASS THROUGH COSTS,HOSPITAL WAGE INDEX DATA,,APPORTIONMENT OF INPATIENT/OUTPATIENT ANCILLARY SERVICE OTHER PASS THROUGH COSTS,INPATIENT ANCILLARY SERVICE COST APPORTIONMENT,,STATEMENT OF REVENUES AND EXPENSES,APPORTIONMENT OF INPATIENT/OUTPATIENT ANCILLARY SERVICE OTHER PASS THROUGH COSTS,COMPUTATION OF RATIO OF COST TO CHARGES,HOSPITAL WAGE INDEX DATA,ANALYSIS OF CHANGES IN NEW CAPITAL BALANCES,,APPORTIONMENT OF INPATIENT/OUTPATIENT ANCILLARY SERVICE OTHER PASS THROUGH COSTS,COST ALLOCATION,COST ALLOCATION,COMPUTATION OF RATIO OF COST TO CHARGES,APPORTIONMENT OF INPATIENT/OUTPATIENT ANCILLARY SERVICE OTHER PASS THROUGH COSTS,COST ALLOCATION,TRIAL BALANCE OF EXPENSE ACCOUNTS,TRIAL BALANCE OF EXPENSE ACCOUNTS,TRIAL BALANCE OF EXPENSE ACCOUNTS,COST ALLOCATION,TRIAL BALANCE OF EXPENSE ACCOUNTS,ADJUSTMENTS,COMPUTATION OF RATIO OF COST TO CHARGES,COMPUTATION OF RATIO OF COST TO CHARGES,INPATIENT ANCILLARY SERVICE COST APPORTIONMENT,APPORTIONMENT OF INPATIENT/OUTPATIENT ANCILLARY SERVICE OTHER PASS THROUGH COSTS,APPORTIONMENT OF INPATIENT/OUTPATIENT ANCILLARY SERVICE OTHER PASS THROUGH COSTS,HHA STATISTICAL DATA,ALLOCATION OF NEW CAPITAL COSTS,HOSPITAL WAGE INDEX DATA,APPORTIONMENT OF INPATIENT/OUTPATIENT ANCILLARY SERVICE OTHER PASS THROUGH COSTS,APPORTIONMENT OF MEDICAL AND OTHER HEALTH SERVICES,,APPORTIONMENT OF INPATIENT/OUTPATIENT ANCILLARY SERVICE OTHER PASS THROUGH COSTS,INPATIENT ANCILLARY SERVICE COST APPORTIONMENT,COMPUTATION OF RATIO OF COST TO CHARGES,APPORTIONMENT OF MEDICAL AND OTHER HEALTH SERVICES,APPORTIONMENT OF MEDICAL AND OTHER HEALTH SERVICES,TRIAL BALANCE OF EXPENSE ACCOUNTS,COST ALLOCATION,COST ALLOCATION,INPATIENT ANCILLARY SERVICE COST APPORTIONMENT,S-10 DATA,ALLOCATION OF NEW CAPITAL COSTS,COMPUTATION OF RATIO OF COST TO CHARGES,APPORTIONMENT OF INPATIENT/OUTPATIENT ANCILLARY SERVICE OTHER PASS THROUGH COSTS,ANALYSIS OF CHANGES IN NEW CAPITAL BALANCES,Total Inpatient Days/Outpatient Visits,APPORTIONMENT OF INPATIENT/OUTPATIENT ANCILLARY SERVICE OTHER PASS THROUGH COSTS,HHA STATISTICAL DATA,COST ALLOCATION,TRIAL BALANCE OF EXPENSE ACCOUNTS,HOSPITAL WAGE INDEX DATA,APPORTIONMENT OF INPATIENT/OUTPATIENT ANCILLARY SERVICE OTHER PASS THROUGH COSTS,APPORTIONMENT OF INPATIENT/OUTPATIENT ANCILLARY SERVICE OTHER PASS THROUGH COSTS,INPATIENT ANCILLARY SERVICE COST APPORTIONMENT,APPORTIONMENT OF INPATIENT/OUTPATIENT ANCILLARY SERVICE OTHER PASS THROUGH COSTS,RENAL STATISTICAL DATA,COST ALLOCATION,,COMPUTATION OF RATIO OF COST TO CHARGES,INPATIENT ANCILLARY SERVICE COST APPORTIONMENT,CALCULATION OF REIMBURSEMENT SETTLEMENT,HOSPITAL WAGE INDEX DATA,Total Inpatient Days/Outpatient Visits,APPORTIONMENT OF INPATIENT/OUTPATIENT ANCILLARY SERVICE OTHER PASS THROUGH COSTS,COST ALLOCATION,APPORTIONMENT OF INPATIENT/OUTPATIENT ANCILLARY SERVICE OTHER PASS THROUGH COSTS,,HOSPITAL WAGE INDEX DATA,APPORTIONMENT OF INPATIENT ROUTINE SERVICE CAPITAL COSTS,COMPUTATION OF RATIO OF COST TO CHARGES,COMPUTATION OF RATIO OF COST TO CHARGES,COMPUTATION OF RATIO OF COST TO CHARGES,COMPUTATION OF INPATIENT OPERATING COSTS,TRIAL BALANCE OF EXPENSE ACCOUNTS,,HHA STATISTICAL DATA,TRIAL BALANCE OF EXPENSE ACCOUNTS,COST ALLOCATION,Total Inpatient Days/Outpatient Visits,S-10 DATA,INPATIENT ANCILLARY SERVICE COST APPORTIONMENT,COMPUTATION OF RATIO OF COST TO CHARGES,INPATIENT ANCILLARY SERVICE COST APPORTIONMENT,APPORTIONMENT OF MEDICAL AND OTHER HEALTH SERVICES,ALLOCATION OF NEW CAPITAL COSTS,TRIAL BALANCE OF EXPENSE ACCOUNTS,RENAL STATISTICAL DATA,INPATIENT ANCILLARY SERVICE COST APPORTIONMENT,APPORTIONMENT OF MEDICAL AND OTHER HEALTH SERVICES,COST ALLOCATION,HHA STATISTICAL DATA,HHA STATISTICAL DATA,TRIAL BALANCE OF EXPENSE ACCOUNTS,HOSPITAL WAGE INDEX DATA,STATEMENT OF REVENUES AND EXPENSES,COMPUTATION OF RATIO OF COST TO CHARGES,APPORTIONMENT OF INPATIENT/OUTPATIENT ANCILLARY SERVICE OTHER PASS THROUGH COSTS,RENAL STATISTICAL DATA,HHA STATISTICAL DATA,HHA STATISTICAL DATA,Total Inpatient Days/Outpatient Visits,TRIAL BALANCE OF EXPENSE ACCOUNTS,APPORTIONMENT OF INPATIENT/OUTPATIENT ANCILLARY SERVICE OTHER PASS THROUGH COSTS,HOSPITAL WAGE INDEX DATA,INPATIENT ANCILLARY SERVICE COST APPORTIONMENT,INPATIENT ANCILLARY SERVICE COST APPORTIONMENT,,COST ALLOCATION,TRIAL BALANCE OF EXPENSE ACCOUNTS,COST ALLOCATION,INPATIENT ANCILLARY SERVICE COST APPORTIONMENT,CALCULATION OF REIMBURSEMENT SETTLEMENT,COMPUTATION OF RATIO OF COST TO CHARGES,INPATIENT ANCILLARY SERVICE COST APPORTIONMENT,,COST ALLOCATION,COST ALLOCATION,INPATIENT ANCILLARY SERVICE COST APPORTIONMENT,COST ALLOCATION,COST ALLOCATION,APPORTIONMENT OF INPATIENT/OUTPATIENT ANCILLARY SERVICE OTHER PASS THROUGH COSTS,APPORTIONMENT OF INPATIENT/OUTPATIENT ANCILLARY SERVICE OTHER PASS THROUGH COSTS,TRIAL BALANCE OF EXPENSE ACCOUNTS,APPORTIONMENT OF MEDICAL AND OTHER HEALTH SERVICES,ADJUSTMENTS,COST ALLOCATION,ADJUSTMENTS,HOSPITAL WAGE INDEX DATA,APPORTIONMENT OF INPATIENT/OUTPATIENT ANCILLARY SERVICE OTHER PASS THROUGH COSTS,INPATIENT ANCILLARY SERVICE COST APPORTIONMENT,APPORTIONMENT OF INPATIENT/OUTPATIENT ANCILLARY SERVICE OTHER PASS THROUGH COSTS,,BALANCE SHEET,APPORTIONMENT OF INPATIENT ROUTINE SERVICE CAPITAL COSTS,TRIAL BALANCE OF EXPENSE ACCOUNTS,TRIAL BALANCE OF EXPENSE ACCOUNTS,COST ALLOCATION,APPORTIONMENT OF INPATIENT/OUTPATIENT ANCILLARY SERVICE OTHER PASS THROUGH COSTS,APPORTIONMENT OF INPATIENT/OUTPATIENT ANCILLARY SERVICE OTHER PASS THROUGH COSTS,COST ALLOCATION,HOSPITAL WAGE INDEX DATA,APPORTIONMENT OF INPATIENT/OUTPATIENT ANCILLARY SERVICE OTHER PASS THROUGH COSTS,APPORTIONMENT OF INPATIENT/OUTPATIENT ANCILLARY SERVICE OTHER PASS THROUGH COSTS,ALLOCATION OF NEW CAPITAL COSTS,COMPUTATION OF RATIO OF COST TO CHARGES,INPATIENT ANCILLARY SERVICE COST APPORTIONMENT,HOSPITAL WAGE INDEX DATA,,APPORTIONMENT OF INPATIENT/OUTPATIENT ANCILLARY SERVICE OTHER PASS THROUGH COSTS,COST ALLOCATION,HOSPITAL WAGE INDEX DATA,INPATIENT ANCILLARY SERVICE COST APPORTIONMENT,TRIAL BALANCE OF EXPENSE ACCOUNTS,APPORTIONMENT OF INPATIENT/OUTPATIENT ANCILLARY SERVICE OTHER PASS THROUGH COSTS,COST ALLOCATION,COST ALLOCATION,INPATIENT ANCILLARY SERVICE COST APPORTIONMENT,BALANCE SHEET,COMPUTATION OF RATIO OF COST TO CHARGES,APPORTIONMENT OF INPATIENT/OUTPATIENT ANCILLARY SERVICE OTHER PASS THROUGH COSTS,COST ALLOCATION,APPORTIONMENT OF INPATIENT/OUTPATIENT ANCILLARY SERVICE OTHER PASS THROUGH COSTS,,COMPUTATION OF RATIO OF COST TO CHARGES,COST ALLOCATION,,INPATIENT ANCILLARY SERVICE COST APPORTIONMENT,INPATIENT ANCILLARY SERVICE COST APPORTIONMENT,INPATIENT ANCILLARY SERVICE COST APPORTIONMENT,INPATIENT ANCILLARY SERVICE COST APPORTIONMENT,APPORTIONMENT OF INPATIENT/OUTPATIENT ANCILLARY SERVICE OTHER PASS THROUGH COSTS,APPORTIONMENT OF INPATIENT/OUTPATIENT ANCILLARY SERVICE OTHER PASS THROUGH COSTS,,HHA STATISTICAL DATA,TRIAL BALANCE OF EXPENSE ACCOUNTS,INPATIENT ANCILLARY SERVICE COST APPORTIONMENT,COMPUTATION OF RATIO OF COST TO CHARGES,APPORTIONMENT OF INPATIENT/OUTPATIENT ANCILLARY SERVICE OTHER PASS THROUGH COSTS,CALCULATION OF REIMBURSEMENT SETTLEMENT,TRIAL BALANCE OF EXPENSE ACCOUNTS,APPORTIONMENT OF INPATIENT/OUTPATIENT ANCILLARY SERVICE OTHER PASS THROUGH COSTS,TRIAL BALANCE OF EXPENSE ACCOUNTS,COST ALLOCATION,COST ALLOCATION,TRIAL BALANCE OF EXPENSE ACCOUNTS,APPORTIONMENT OF MEDICAL AND OTHER HEALTH SERVICES,APPORTIONMENT OF INPATIENT/OUTPATIENT ANCILLARY SERVICE OTHER PASS THROUGH COSTS,INPATIENT ANCILLARY SERVICE COST APPORTIONMENT,APPORTIONMENT OF MEDICAL AND OTHER HEALTH SERVICES,APPORTIONMENT OF INPATIENT/OUTPATIENT ANCILLARY SERVICE OTHER PASS THROUGH COSTS,COST ALLOCATION,Medicaid Inpatient Days/Outpatient Visits,APPORTIONMENT OF INPATIENT/OUTPATIENT ANCILLARY SERVICE OTHER PASS THROUGH COSTS,HOSPITAL WAGE INDEX DATA,Total Inpatient Days/Outpatient Visits,HOSPITAL WAGE INDEX DATA,APPORTIONMENT OF MEDICAL AND OTHER HEALTH SERVICES,TRIAL BALANCE OF EXPENSE ACCOUNTS,COMPUTATION OF INPATIENT OPERATING COSTS,COST ALLOCATION,TRIAL BALANCE OF EXPENSE ACCOUNTS,APPORTIONMENT OF INPATIENT/OUTPATIENT ANCILLARY SERVICE OTHER PASS THROUGH COSTS,COST ALLOCATION,TRIAL BALANCE OF EXPENSE ACCOUNTS,APPORTIONMENT OF INPATIENT/OUTPATIENT ANCILLARY SERVICE OTHER PASS THROUGH COSTS,HHA STATISTICAL DATA,ALLOCATION OF NEW CAPITAL COSTS,APPORTIONMENT OF INPATIENT/OUTPATIENT ANCILLARY SERVICE OTHER PASS THROUGH COSTS,INPATIENT ANCILLARY SERVICE COST APPORTIONMENT,INPATIENT ANCILLARY SERVICE COST APPORTIONMENT,TRIAL BALANCE OF EXPENSE ACCOUNTS,APPORTIONMENT OF MEDICAL AND OTHER HEALTH SERVICES,INPATIENT ANCILLARY SERVICE COST APPORTIONMENT,INPATIENT ANCILLARY SERVICE COST APPORTIONMENT,APPORTIONMENT OF INPATIENT/OUTPATIENT ANCILLARY SERVICE OTHER PASS THROUGH COSTS,INPATIENT ANCILLARY SERVICE COST APPORTIONMENT,APPORTIONMENT OF INPATIENT/OUTPATIENT ANCILLARY SERVICE OTHER PASS THROUGH COSTS,COST ALLOCATION,INPATIENT ANCILLARY SERVICE COST APPORTIONMENT,INPATIENT ANCILLARY SERVICE COST APPORTIONMENT,Total Inpatient Days/Outpatient Visits,HOSPITAL WAGE INDEX DATA,CALCULATION OF REIMBURSEMENT SETTLEMENT,COMPUTATION OF RATIO OF COST TO CHARGES,COST ALLOCATION,ANALYSIS OF CHANGES IN NEW CAPITAL BALANCES,Medicaid Inpatient Days/Outpatient Visits,TRIAL BALANCE OF EXPENSE ACCOUNTS,HOSPITAL WAGE INDEX DATA,APPORTIONMENT OF INPATIENT/OUTPATIENT ANCILLARY SERVICE OTHER PASS THROUGH COSTS,BED DAYS AVAILABLE,APPORTIONMENT OF MEDICAL AND OTHER HEALTH SERVICES,BED DAYS AVAILABLE,APPORTIONMENT OF INPATIENT/OUTPATIENT ANCILLARY SERVICE OTHER PASS THROUGH COSTS,APPORTIONMENT OF MEDICAL AND OTHER HEALTH SERVICES,TRIAL BALANCE OF EXPENSE ACCOUNTS,ALLOCATION OF NEW CAPITAL COSTS,TRIAL BALANCE OF EXPENSE ACCOUNTS,INPATIENT ANCILLARY SERVICE COST APPORTIONMENT,,COMPUTATION OF RATIO OF COST TO CHARGES,HHA STATISTICAL DATA,COMPUTATION OF RATIO OF COST TO CHARGES,CALCULATION OF REIMBURSEMENT SETTLEMENT,TRIAL BALANCE OF EXPENSE ACCOUNTS,COMPUTATION OF INPATIENT OPERATING COSTS,APPORTIONMENT OF MEDICAL AND OTHER HEALTH SERVICES,HOSPITAL WAGE INDEX DATA,COST ALLOCATION,COST ALLOCATION,COMPUTATION OF RATIO OF COST TO CHARGES,APPORTIONMENT OF INPATIENT/OUTPATIENT ANCILLARY SERVICE OTHER PASS THROUGH COSTS,HOSPITAL WAGE INDEX DATA,HHA STATISTICAL DATA,APPORTIONMENT OF MEDICAL AND OTHER HEALTH SERVICES,NUMBER OF BEDS,INPATIENT ANCILLARY SERVICE COST APPORTIONMENT,INPATIENT ANCILLARY SERVICE COST APPORTIONMENT,APPORTIONMENT OF MEDICAL AND OTHER HEALTH SERVICES,ALLOCATION OF NEW CAPITAL COSTS,APPORTIONMENT OF INPATIENT/OUTPATIENT ANCILLARY SERVICE OTHER PASS THROUGH COSTS,HOSPITAL WAGE INDEX DATA,COST ALLOCATION,COST ALLOCATION,HOSPITAL WAGE INDEX DATA,HOSPITAL WAGE INDEX DATA,COST ALLOCATION,TRIAL BALANCE OF EXPENSE ACCOUNTS,COMPUTATION OF RATIO OF COST TO CHARGES,INPATIENT ANCILLARY SERVICE COST APPORTIONMENT,APPORTIONMENT OF INPATIENT/OUTPATIENT ANCILLARY SERVICE OTHER PASS THROUGH COSTS,APPORTIONMENT OF MEDICAL AND OTHER HEALTH SERVICES,APPORTIONMENT OF MEDICAL AND OTHER HEALTH SERVICES,COMPUTATION OF RATIO OF COST TO CHARGES,APPORTIONMENT OF INPATIENT/OUTPATIENT ANCILLARY SERVICE OTHER PASS THROUGH COSTS,,COMPUTATION OF RATIO OF COST TO CHARGES,COMPUTATION OF RATIO OF COST TO CHARGES,ALLOCATION OF NEW CAPITAL COSTS,APPORTIONMENT OF INPATIENT/OUTPATIENT ANCILLARY SERVICE OTHER PASS THROUGH COSTS,APPORTIONMENT OF INPATIENT/OUTPATIENT ANCILLARY SERVICE OTHER PASS THROUGH COSTS,INPATIENT ANCILLARY SERVICE COST APPORTIONMENT,HOSPITAL IDENTIFICATION INFORMATION,APPORTIONMENT OF MEDICAL AND OTHER HEALTH SERVICES,COST ALLOCATION,APPORTIONMENT OF INPATIENT/OUTPATIENT ANCILLARY SERVICE OTHER PASS THROUGH COSTS,COMPUTATION OF RATIO OF COST TO CHARGES,COMPUTATION OF RATIO OF COST TO CHARGES,CALCULATION OF REIMBURSEMENT SETTLEMENT,COMPUTATION OF RATIO OF COST TO CHARGES,CALCULATION OF REIMBURSEMENT SETTLEMENT,APPORTIONMENT OF MEDICAL AND OTHER HEALTH SERVICES,HOSPITAL WAGE INDEX DATA,TRIAL BALANCE OF EXPENSE ACCOUNTS,APPORTIONMENT OF INPATIENT/OUTPATIENT ANCILLARY SERVICE OTHER PASS THROUGH COSTS,Medicare Inpatient Days/Outpatient Visits,COST ALLOCATION,APPORTIONMENT OF MEDICAL AND OTHER HEALTH SERVICES,BALANCE SHEET,COMPUTATION OF RATIO OF COST TO CHARGES,INPATIENT ANCILLARY SERVICE COST APPORTIONMENT,TRIAL BALANCE OF EXPENSE ACCOUNTS,APPORTIONMENT OF INPATIENT/OUTPATIENT ANCILLARY SERVICE OTHER PASS THROUGH COSTS,Medicare Inpatient Days/Outpatient Visits,BED DAYS AVAILABLE,,APPORTIONMENT OF INPATIENT/OUTPATIENT ANCILLARY SERVICE OTHER PASS THROUGH COSTS,COMPUTATION OF RATIO OF COST TO CHARGES,APPORTIONMENT OF INPATIENT/OUTPATIENT ANCILLARY SERVICE OTHER PASS THROUGH COSTS,APPORTIONMENT OF MEDICAL AND OTHER HEALTH SERVICES,ANALYSIS OF CHANGES IN NEW CAPITAL BALANCES,INPATIENT ANCILLARY SERVICE COST APPORTIONMENT,CALCULATION OF REIMBURSEMENT SETTLEMENT,APPORTIONMENT OF INPATIENT ROUTINE SERVICE CAPITAL COSTS,COST ALLOCATION,COMPUTATION OF RATIO OF COST TO CHARGES,,COST ALLOCATION,APPORTIONMENT OF MEDICAL AND OTHER HEALTH SERVICES,APPORTIONMENT OF INPATIENT/OUTPATIENT ANCILLARY SERVICE OTHER PASS THROUGH COSTS,COST ALLOCATION,COMPUTATION OF RATIO OF COST TO CHARGES,HOSPITAL WAGE INDEX DATA,COST ALLOCATION,Total Inpatient Days/Outpatient Visits,INPATIENT ANCILLARY SERVICE COST APPORTIONMENT,Total Inpatient Days/Outpatient Visits,APPORTIONMENT OF MEDICAL AND OTHER HEALTH SERVICES,COST ALLOCATION,TRIAL BALANCE OF EXPENSE ACCOUNTS,APPORTIONMENT OF INPATIENT/OUTPATIENT ANCILLARY SERVICE OTHER PASS THROUGH COSTS,INPATIENT ANCILLARY SERVICE COST APPORTIONMENT,APPORTIONMENT OF INPATIENT/OUTPATIENT ANCILLARY SERVICE OTHER PASS THROUGH COSTS,APPORTIONMENT OF INPATIENT/OUTPATIENT ANCILLARY SERVICE OTHER PASS THROUGH COSTS,APPORTIONMENT OF INPATIENT/OUTPATIENT ANCILLARY SERVICE OTHER PASS THROUGH COSTS,ALLOCATION OF NEW CAPITAL COSTS,,COST ALLOCATION,COST ALLOCATION,COMPUTATION OF RATIO OF COST TO CHARGES,APPORTIONMENT OF MEDICAL AND OTHER HEALTH SERVICES,ALLOCATION OF NEW CAPITAL COSTS,INPATIENT ANCILLARY SERVICE COST APPORTIONMENT,HOSPITAL IDENTIFICATION INFORMATION,S-10 DATA,INPATIENT ANCILLARY SERVICE COST APPORTIONMENT,COMPUTATION OF RATIO OF COST TO CHARGES,COST ALLOCATION,COST ALLOCATION,COMPUTATION OF RATIO OF COST TO CHARGES,HOSPITAL WAGE INDEX DATA,COST ALLOCATION,INPATIENT ANCILLARY SERVICE COST APPORTIONMENT,TRIAL BALANCE OF EXPENSE ACCOUNTS,COMPUTATION OF RATIO OF COST TO CHARGES,COST ALLOCATION,APPORTIONMENT OF MEDICAL AND OTHER HEALTH SERVICES,APPORTIONMENT OF MEDICAL AND OTHER HEALTH SERVICES,APPORTIONMENT OF MEDICAL AND OTHER HEALTH SERVICES,COMPUTATION OF RATIO OF COST TO CHARGES,NUMBER OF BEDS,BALANCE SHEET,,APPORTIONMENT OF MEDICAL AND OTHER HEALTH SERVICES,ALLOCATION OF NEW CAPITAL COSTS,,COST ALLOCATION,COMPUTATION OF RATIO OF COST TO CHARGES,APPORTIONMENT OF INPATIENT/OUTPATIENT ANCILLARY SERVICE OTHER PASS THROUGH COSTS,APPORTIONMENT OF INPATIENT/OUTPATIENT ANCILLARY SERVICE OTHER PASS THROUGH COSTS,BED DAYS AVAILABLE,INPATIENT ANCILLARY SERVICE COST APPORTIONMENT,Medicaid Inpatient Days/Outpatient Visits,RECONCILIATION OF CAPITAL COST CENTERS,ANALYSIS OF CHANGES IN NEW CAPITAL BALANCES,COST ALLOCATION,Total Inpatient Days/Outpatient Visits,ADJUSTMENTS,APPORTIONMENT OF INPATIENT/OUTPATIENT ANCILLARY SERVICE OTHER PASS THROUGH COSTS,,TRIAL BALANCE OF EXPENSE ACCOUNTS,INPATIENT ANCILLARY SERVICE COST APPORTIONMENT,HOSPITAL WAGE INDEX DATA,APPORTIONMENT OF MEDICAL AND OTHER HEALTH SERVICES,COMPUTATION OF RATIO OF COST TO CHARGES,TRIAL BALANCE OF EXPENSE ACCOUNTS,APPORTIONMENT OF INPATIENT/OUTPATIENT ANCILLARY SERVICE OTHER PASS THROUGH COSTS,APPORTIONMENT OF INPATIENT/OUTPATIENT ANCILLARY SERVICE OTHER PASS THROUGH COSTS,APPORTIONMENT OF INPATIENT/OUTPATIENT ANCILLARY SERVICE OTHER PASS THROUGH COSTS,INPATIENT ANCILLARY SERVICE COST APPORTIONMENT,TRIAL BALANCE OF EXPENSE ACCOUNTS,APPORTIONMENT OF INPATIENT/OUTPATIENT ANCILLARY SERVICE OTHER PASS THROUGH COSTS,INPATIENT ANCILLARY SERVICE COST APPORTIONMENT,COMPUTATION OF RATIO OF COST TO CHARGES,COST ALLOCATION,S-10 DATA,S-10 DATA,COMPUTATION OF RATIO OF COST TO CHARGES,APPORTIONMENT OF MEDICAL AND OTHER HEALTH SERVICES,RENAL STATISTICAL DATA,,APPORTIONMENT OF INPATIENT/OUTPATIENT ANCILLARY SERVICE OTHER PASS THROUGH COSTS,HOSPITAL WAGE INDEX DATA,APPORTIONMENT OF MEDICAL AND OTHER HEALTH SERVICES,APPORTIONMENT OF INPATIENT/OUTPATIENT ANCILLARY SERVICE OTHER PASS THROUGH COSTS,COMPUTATION OF INPATIENT OPERATING COSTS,,NUMBER OF BEDS,COMPUTATION OF INPATIENT OPERATING COSTS,COST ALLOCATION,COMPUTATION OF INPATIENT OPERATING COSTS,ALLOCATION OF NEW CAPITAL COSTS,TRIAL BALANCE OF EXPENSE ACCOUNTS,COMPUTATION OF RATIO OF COST TO CHARGES,APPORTIONMENT OF MEDICAL AND OTHER HEALTH SERVICES,,APPORTIONMENT OF MEDICAL AND OTHER HEALTH SERVICES,ANALYSIS OF CHANGES IN NEW CAPITAL BALANCES,Total Inpatient Days/Outpatient Visits,TRIAL BALANCE OF EXPENSE ACCOUNTS,,COMPUTATION OF INPATIENT OPERATING COSTS,INPATIENT ANCILLARY SERVICE COST APPORTIONMENT,TRIAL BALANCE OF EXPENSE ACCOUNTS,TRIAL BALANCE OF EXPENSE ACCOUNTS,TRIAL BALANCE OF EXPENSE ACCOUNTS,APPORTIONMENT OF MEDICAL AND OTHER HEALTH SERVICES,HOSPITAL WAGE INDEX DATA,APPORTIONMENT OF INPATIENT/OUTPATIENT ANCILLARY SERVICE OTHER PASS THROUGH COSTS,APPORTIONMENT OF MEDICAL AND OTHER HEALTH SERVICES,COST ALLOCATION,HOSPITAL WAGE INDEX DATA,COST ALLOCATION,COST ALLOCATION,CALCULATION OF REIMBURSEMENT SETTLEMENT,CALCULATION OF REIMBURSEMENT SETTLEMENT,,COST ALLOCATION,TRIAL BALANCE OF EXPENSE ACCOUNTS,TRIAL BALANCE OF EXPENSE ACCOUNTS,TRIAL BALANCE OF EXPENSE ACCOUNTS,COMPUTATION OF RATIO OF COST TO CHARGES,APPORTIONMENT OF INPATIENT ROUTINE SERVICE CAPITAL COSTS,APPORTIONMENT OF INPATIENT/OUTPATIENT ANCILLARY SERVICE OTHER PASS THROUGH COSTS,HOSPITAL WAGE INDEX DATA,APPORTIONMENT OF INPATIENT/OUTPATIENT ANCILLARY SERVICE OTHER PASS THROUGH COSTS,INPATIENT ANCILLARY SERVICE COST APPORTIONMENT,HOSPITAL WAGE INDEX DATA,APPORTIONMENT OF INPATIENT/OUTPATIENT ANCILLARY SERVICE OTHER PASS THROUGH COSTS,APPORTIONMENT OF INPATIENT/OUTPATIENT ANCILLARY SERVICE OTHER PASS THROUGH COSTS,HOSPITAL WAGE INDEX DATA,APPORTIONMENT OF INPATIENT/OUTPATIENT ANCILLARY SERVICE OTHER PASS THROUGH COSTS,TRIAL BALANCE OF EXPENSE ACCOUNTS,COST ALLOCATION,HOSPITAL WAGE INDEX DATA,COST ALLOCATION,APPORTIONMENT OF MEDICAL AND OTHER HEALTH SERVICES,APPORTIONMENT OF MEDICAL AND OTHER HEALTH SERVICES,APPORTIONMENT OF INPATIENT/OUTPATIENT ANCILLARY SERVICE OTHER PASS THROUGH COSTS,COMPUTATION OF RATIO OF COST TO CHARGES,RENAL STATISTICAL DATA,APPORTIONMENT OF INPATIENT/OUTPATIENT ANCILLARY SERVICE OTHER PASS THROUGH COSTS,INPATIENT ANCILLARY SERVICE COST APPORTIONMENT,APPORTIONMENT OF INPATIENT/OUTPATIENT ANCILLARY SERVICE OTHER PASS THROUGH COSTS,INPATIENT ANCILLARY SERVICE COST APPORTIONMENT,COST ALLOCATION,COST ALLOCATION,TRIAL BALANCE OF EXPENSE ACCOUNTS,COST ALLOCATION,COST ALLOCATION,HOSPITAL WAGE INDEX DATA,TRIAL BALANCE OF EXPENSE ACCOUNTS,APPORTIONMENT OF INPATIENT/OUTPATIENT ANCILLARY SERVICE OTHER PASS THROUGH COSTS,STATEMENT OF REVENUES AND EXPENSES,ALLOCATION OF NEW CAPITAL COSTS,,RENAL STATISTICAL DATA,CALCULATION OF REIMBURSEMENT SETTLEMENT,Total Inpatient Days/Outpatient Visits,ANALYSIS OF CHANGES IN NEW CAPITAL BALANCES,COST ALLOCATION,ALLOCATION OF NEW CAPITAL COSTS,APPORTIONMENT OF INPATIENT/OUTPATIENT ANCILLARY SERVICE OTHER PASS THROUGH COSTS,BALANCE SHEET,ANALYSIS OF CHANGES IN NEW CAPITAL BALANCES,INPATIENT ANCILLARY SERVICE COST APPORTIONMENT,COMPUTATION OF RATIO OF COST TO CHARGES,APPORTIONMENT OF INPATIENT/OUTPATIENT ANCILLARY SERVICE OTHER PASS THROUGH COSTS,APPORTIONMENT OF INPATIENT/OUTPATIENT ANCILLARY SERVICE OTHER PASS THROUGH COSTS,HHA STATISTICAL DATA,COMPUTATION OF INPATIENT OPERATING COSTS,APPORTIONMENT OF MEDICAL AND OTHER HEALTH SERVICES,ANALYSIS OF CHANGES IN NEW CAPITAL BALANCES,COST ALLOCATION,CALCULATION OF REIMBURSEMENT SETTLEMENT,INPATIENT ANCILLARY SERVICE COST APPORTIONMENT,COMPUTATION OF RATIO OF COST TO CHARGES,STATEMENT OF PATIENT REVENUES AND OPERATING EXPENSES,INPATIENT ANCILLARY SERVICE COST APPORTIONMENT,APPORTIONMENT OF INPATIENT/OUTPATIENT ANCILLARY SERVICE OTHER PASS THROUGH COSTS,APPORTIONMENT OF INPATIENT/OUTPATIENT ANCILLARY SERVICE OTHER PASS THROUGH COSTS,COST ALLOCATION,TRIAL BALANCE OF EXPENSE ACCOUNTS,APPORTIONMENT OF MEDICAL AND OTHER HEALTH SERVICES,COMPUTATION OF RATIO OF COST TO CHARGES,RENAL STATISTICAL DATA,TRIAL BALANCE OF EXPENSE ACCOUNTS,HOSPITAL WAGE INDEX DATA,APPORTIONMENT OF MEDICAL AND OTHER HEALTH SERVICES,HOSPITAL WAGE INDEX DATA,COST ALLOCATION,,APPORTIONMENT OF INPATIENT/OUTPATIENT ANCILLARY SERVICE OTHER PASS THROUGH COSTS,S-10 DATA,APPORTIONMENT OF INPATIENT/OUTPATIENT ANCILLARY SERVICE OTHER PASS THROUGH COSTS,TRIAL BALANCE OF EXPENSE ACCOUNTS,TRIAL BALANCE OF EXPENSE ACCOUNTS,COMPUTATION OF RATIO OF COST TO CHARGES,COMPUTATION OF RATIO OF COST TO CHARGES,INPATIENT ANCILLARY SERVICE COST APPORTIONMENT,INPATIENT ANCILLARY SERVICE COST APPORTIONMENT,HOSPITAL WAGE INDEX DATA,Medicare Inpatient Days/Outpatient Visits,,NUMBER OF BEDS,RENAL STATISTICAL DATA,COMPUTATION OF RATIO OF COST TO CHARGES,APPORTIONMENT OF INPATIENT/OUTPATIENT ANCILLARY SERVICE OTHER PASS THROUGH COSTS,TRIAL BALANCE OF EXPENSE ACCOUNTS,COST ALLOCATION,COST ALLOCATION,APPORTIONMENT OF INPATIENT ROUTINE SERVICE CAPITAL COSTS,S-10 DATA,COST ALLOCATION,APPORTIONMENT OF INPATIENT/OUTPATIENT ANCILLARY SERVICE OTHER PASS THROUGH COSTS,HOSPITAL WAGE INDEX DATA,APPORTIONMENT OF MEDICAL AND OTHER HEALTH SERVICES,COMPUTATION OF RATIO OF COST TO CHARGES,HOSPITAL WAGE INDEX DATA,ALLOCATION OF NEW CAPITAL COSTS,TRIAL BALANCE OF EXPENSE ACCOUNTS,,TRIAL BALANCE OF EXPENSE ACCOUNTS,TRIAL BALANCE OF EXPENSE ACCOUNTS,Total Inpatient Days/Outpatient Visits,ALLOCATION OF NEW CAPITAL COSTS,TRIAL BALANCE OF EXPENSE ACCOUNTS,COMPUTATION OF RATIO OF COST TO CHARGES,COST ALLOCATION,,,S-10 DATA,COST ALLOCATION,COMPUTATION OF RATIO OF COST TO CHARGES,APPORTIONMENT OF INPATIENT ROUTINE SERVICE CAPITAL COSTS,COMPUTATION OF INPATIENT OPERATING COSTS,Total Inpatient Days/Outpatient Visits,TRIAL BALANCE OF EXPENSE ACCOUNTS,HHA STATISTICAL DATA,COMPUTATION OF RATIO OF COST TO CHARGES,INPATIENT ANCILLARY SERVICE COST APPORTIONMENT,S-10 DATA,COST ALLOCATION,Total Inpatient Days/Outpatient Visits,HOSPITAL WAGE INDEX DATA,S-10 DATA,TRIAL BALANCE OF EXPENSE ACCOUNTS,APPORTIONMENT OF MEDICAL AND OTHER HEALTH SERVICES,INPATIENT ANCILLARY SERVICE COST APPORTIONMENT,COST ALLOCATION,HOSPITAL WAGE INDEX DATA,COMPUTATION OF RATIO OF COST TO CHARGES,APPORTIONMENT OF INPATIENT/OUTPATIENT ANCILLARY SERVICE OTHER PASS THROUGH COSTS,COMPUTATION OF RATIO OF COST TO CHARGES,CALCULATION OF REIMBURSEMENT SETTLEMENT,APPORTIONMENT OF INPATIENT/OUTPATIENT ANCILLARY SERVICE OTHER PASS THROUGH COSTS,HOSPITAL WAGE INDEX DATA,TRIAL BALANCE OF EXPENSE ACCOUNTS,APPORTIONMENT OF INPATIENT/OUTPATIENT ANCILLARY SERVICE OTHER PASS THROUGH COSTS,APPORTIONMENT OF INPATIENT/OUTPATIENT ANCILLARY SERVICE OTHER PASS THROUGH COSTS,INPATIENT ANCILLARY SERVICE COST APPORTIONMENT,,COST ALLOCATION,ANALYSIS OF CHANGES IN NEW CAPITAL BALANCES,COMPUTATION OF RATIO OF COST TO CHARGES,COMPUTATION OF RATIO OF COST TO CHARGES,COST ALLOCATION,APPORTIONMENT OF MEDICAL AND OTHER HEALTH SERVICES,COST ALLOCATION,COMPUTATION OF RATIO OF COST TO CHARGES,COST ALLOCATION,HOSPITAL WAGE INDEX DATA,INPATIENT ANCILLARY SERVICE COST APPORTIONMENT,BED DAYS AVAILABLE,Total Inpatient Days/Outpatient Visits,APPORTIONMENT OF INPATIENT/OUTPATIENT ANCILLARY SERVICE OTHER PASS THROUGH COSTS,APPORTIONMENT OF MEDICAL AND OTHER HEALTH SERVICES,S-10 DATA,TRIAL BALANCE OF EXPENSE ACCOUNTS,COST ALLOCATION,COST ALLOCATION,,ADJUSTMENTS,COST ALLOCATION,COST ALLOCATION,COST ALLOCATION,BALANCE SHEET,BED DAYS AVAILABLE,COMPUTATION OF RATIO OF COST TO CHARGES,TRIAL BALANCE OF EXPENSE ACCOUNTS,APPORTIONMENT OF MEDICAL AND OTHER HEALTH SERVICES,TRIAL BALANCE OF EXPENSE ACCOUNTS,CALCULATION OF REIMBURSEMENT SETTLEMENT,,APPORTIONMENT OF MEDICAL AND OTHER HEALTH SERVICES,APPORTIONMENT OF MEDICAL AND OTHER HEALTH SERVICES,CALCULATION OF REIMBURSEMENT SETTLEMENT,APPORTIONMENT OF INPATIENT/OUTPATIENT ANCILLARY SERVICE OTHER PASS THROUGH COSTS,APPORTIONMENT OF MEDICAL AND OTHER HEALTH SERVICES,APPORTIONMENT OF INPATIENT/OUTPATIENT ANCILLARY SERVICE OTHER PASS THROUGH COSTS,INPATIENT ANCILLARY SERVICE COST APPORTIONMENT,APPORTIONMENT OF INPATIENT/OUTPATIENT ANCILLARY SERVICE OTHER PASS THROUGH COSTS,INPATIENT ANCILLARY SERVICE COST APPORTIONMENT,INPATIENT ANCILLARY SERVICE COST APPORTIONMENT,HOSPITAL WAGE INDEX DATA,TRIAL BALANCE OF EXPENSE ACCOUNTS,ALLOCATION OF NEW CAPITAL COSTS,APPORTIONMENT OF INPATIENT/OUTPATIENT ANCILLARY SERVICE OTHER PASS THROUGH COSTS,HOSPITAL WAGE INDEX DATA,APPORTIONMENT OF INPATIENT/OUTPATIENT ANCILLARY SERVICE OTHER PASS THROUGH COSTS,ADJUSTMENTS,COST ALLOCATION,INPATIENT ANCILLARY SERVICE COST APPORTIONMENT,COMPUTATION OF INPATIENT OPERATING COSTS,CALCULATION OF REIMBURSEMENT SETTLEMENT (PPS),HOSPITAL WAGE INDEX DATA,APPORTIONMENT OF INPATIENT/OUTPATIENT ANCILLARY SERVICE OTHER PASS THROUGH COSTS,APPORTIONMENT OF INPATIENT/OUTPATIENT ANCILLARY SERVICE OTHER PASS THROUGH COSTS,,COMPUTATION OF RATIO OF COST TO CHARGES,ANALYSIS OF CHANGES IN NEW CAPITAL BALANCES,HOSPITAL WAGE INDEX DATA,TRIAL BALANCE OF EXPENSE ACCOUNTS,APPORTIONMENT OF MEDICAL AND OTHER HEALTH SERVICES,COMPUTATION OF RATIO OF COST TO CHARGES,S-10 DATA,Total Inpatient Days/Outpatient Visits,APPORTIONMENT OF INPATIENT/OUTPATIENT ANCILLARY SERVICE OTHER PASS THROUGH COSTS,APPORTIONMENT OF MEDICAL AND OTHER HEALTH SERVICES,APPORTIONMENT OF INPATIENT/OUTPATIENT ANCILLARY SERVICE OTHER PASS THROUGH COSTS,APPORTIONMENT OF INPATIENT ROUTINE SERVICE OTHER PASS THROUGH COSTS,TRIAL BALANCE OF EXPENSE ACCOUNTS,CALCULATION OF REIMBURSEMENT SETTLEMENT,ALLOCATION OF NEW CAPITAL COSTS,,APPORTIONMENT OF MEDICAL AND OTHER HEALTH SERVICES,INPATIENT ANCILLARY SERVICE COST APPORTIONMENT,APPORTIONMENT OF INPATIENT/OUTPATIENT ANCILLARY SERVICE OTHER PASS THROUGH COSTS,APPORTIONMENT OF INPATIENT/OUTPATIENT ANCILLARY SERVICE OTHER PASS THROUGH COSTS,COST ALLOCATION,APPORTIONMENT OF INPATIENT ROUTINE SERVICE CAPITAL COSTS,STATEMENT OF REVENUES AND EXPENSES,INPATIENT ANCILLARY SERVICE COST APPORTIONMENT,COST ALLOCATION,COST ALLOCATION,INPATIENT ANCILLARY SERVICE COST APPORTIONMENT,APPORTIONMENT OF INPATIENT/OUTPATIENT ANCILLARY SERVICE OTHER PASS THROUGH COSTS,HOSPITAL IDENTIFICATION INFORMATION,TRIAL BALANCE OF EXPENSE ACCOUNTS,APPORTIONMENT OF INPATIENT/OUTPATIENT ANCILLARY SERVICE OTHER PASS THROUGH COSTS,INPATIENT ANCILLARY SERVICE COST APPORTIONMENT,COMPUTATION OF RATIO OF COST TO CHARGES,ANALYSIS OF CHANGES IN NEW CAPITAL BALANCES,RENAL STATISTICAL DATA,APPORTIONMENT OF MEDICAL AND OTHER HEALTH SERVICES,COST ALLOCATION,CALCULATION OF REIMBURSEMENT SETTLEMENT,COMPUTATION OF RATIO OF COST TO CHARGES,APPORTIONMENT OF MEDICAL AND OTHER HEALTH SERVICES,ALLOCATION OF NEW CAPITAL COSTS,APPORTIONMENT OF MEDICAL AND OTHER HEALTH SERVICES,INPATIENT ANCILLARY SERVICE COST APPORTIONMENT,APPORTIONMENT OF INPATIENT/OUTPATIENT ANCILLARY SERVICE OTHER PASS THROUGH COSTS,TRIAL BALANCE OF EXPENSE ACCOUNTS,COST ALLOCATION,HHA STATISTICAL DATA,HOSPITAL WAGE INDEX DATA,TRIAL BALANCE OF EXPENSE ACCOUNTS,APPORTIONMENT OF INPATIENT/OUTPATIENT ANCILLARY SERVICE OTHER PASS THROUGH COSTS,CALCULATION OF REIMBURSEMENT SETTLEMENT,COST ALLOCATION,TRIAL BALANCE OF EXPENSE ACCOUNTS,,COST ALLOCATION,APPORTIONMENT OF INPATIENT/OUTPATIENT ANCILLARY SERVICE OTHER PASS THROUGH COSTS,APPORTIONMENT OF INPATIENT/OUTPATIENT ANCILLARY SERVICE OTHER PASS THROUGH COSTS,HHA STATISTICAL DATA,RENAL STATISTICAL DATA,CALCULATION OF REIMBURSEMENT SETTLEMENT,COST ALLOCATION,ALLOCATION OF NEW CAPITAL COSTS,RENAL STATISTICAL DATA,COMPUTATION OF RATIO OF COST TO CHARGES,APPORTIONMENT OF INPATIENT/OUTPATIENT ANCILLARY SERVICE OTHER PASS THROUGH COSTS,HHA STATISTICAL DATA,COMPUTATION OF INPATIENT OPERATING COSTS,TRIAL BALANCE OF EXPENSE ACCOUNTS,APPORTIONMENT OF MEDICAL AND OTHER HEALTH SERVICES,COMPUTATION OF INPATIENT OPERATING COSTS,TRIAL BALANCE OF EXPENSE ACCOUNTS,ANALYSIS OF CHANGES IN NEW CAPITAL BALANCES,COST ALLOCATION,ALLOCATION OF NEW CAPITAL COSTS,ALLOCATION OF NEW CAPITAL COSTS,,COST ALLOCATION,INPATIENT ANCILLARY SERVICE COST APPORTIONMENT,APPORTIONMENT OF MEDICAL AND OTHER HEALTH SERVICES,ANALYSIS OF CHANGES IN NEW CAPITAL BALANCES,APPORTIONMENT OF INPATIENT/OUTPATIENT ANCILLARY SERVICE OTHER PASS THROUGH COSTS,APPORTIONMENT OF MEDICAL AND OTHER HEALTH SERVICES,S-10 DATA,APPORTIONMENT OF MEDICAL AND OTHER HEALTH SERVICES,TRIAL BALANCE OF EXPENSE ACCOUNTS,COST ALLOCATION,APPORTIONMENT OF INPATIENT/OUTPATIENT ANCILLARY SERVICE OTHER PASS THROUGH COSTS,ADJUSTMENTS,INPATIENT ANCILLARY SERVICE COST APPORTIONMENT,ANALYSIS OF CHANGES IN NEW CAPITAL BALANCES,APPORTIONMENT OF INPATIENT/OUTPATIENT ANCILLARY SERVICE OTHER PASS THROUGH COSTS,INPATIENT ANCILLARY SERVICE COST APPORTIONMENT,APPORTIONMENT OF MEDICAL AND OTHER HEALTH SERVICES,COMPUTATION OF RATIO OF COST TO CHARGES,Medicaid Inpatient Days/Outpatient Visits,HHA STATISTICAL DATA,,COST ALLOCATION,INPATIENT ANCILLARY SERVICE COST APPORTIONMENT,APPORTIONMENT OF INPATIENT ROUTINE SERVICE OTHER PASS THROUGH COSTS,COST ALLOCATION,CALCULATION OF REIMBURSEMENT SETTLEMENT,COST ALLOCATION,APPORTIONMENT OF MEDICAL AND OTHER HEALTH SERVICES,APPORTIONMENT OF MEDICAL AND OTHER HEALTH SERVICES,S-10 DATA,COST ALLOCATION,HOSPITAL IDENTIFICATION INFORMATION,APPORTIONMENT OF INPATIENT/OUTPATIENT ANCILLARY SERVICE OTHER PASS THROUGH COSTS,COST ALLOCATION,HOSPITAL WAGE INDEX DATA,APPORTIONMENT OF INPATIENT/OUTPATIENT ANCILLARY SERVICE OTHER PASS THROUGH COSTS,TRIAL BALANCE OF EXPENSE ACCOUNTS,Total Inpatient Days/Outpatient Visits,HOSPITAL WAGE INDEX DATA,ADJUSTMENTS,COMPUTATION OF RATIO OF COST TO CHARGES,INPATIENT ANCILLARY SERVICE COST APPORTIONMENT,INPATIENT ANCILLARY SERVICE COST APPORTIONMENT,TRIAL BALANCE OF EXPENSE ACCOUNTS,HOSPITAL IDENTIFICATION INFORMATION,HOSPITAL WAGE INDEX DATA,APPORTIONMENT OF INPATIENT/OUTPATIENT ANCILLARY SERVICE OTHER PASS THROUGH COSTS,APPORTIONMENT OF MEDICAL AND OTHER HEALTH SERVICES,COST ALLOCATION,INPATIENT ANCILLARY SERVICE COST APPORTIONMENT,HOSPITAL WAGE INDEX DATA,APPORTIONMENT OF INPATIENT/OUTPATIENT ANCILLARY SERVICE OTHER PASS THROUGH COSTS,HOSPITAL IDENTIFICATION INFORMATION,APPORTIONMENT OF INPATIENT/OUTPATIENT ANCILLARY SERVICE OTHER PASS THROUGH COSTS,INPATIENT ANCILLARY SERVICE COST APPORTIONMENT,COST ALLOCATION,APPORTIONMENT OF INPATIENT/OUTPATIENT ANCILLARY SERVICE OTHER PASS THROUGH COSTS,ALLOCATION OF NEW CAPITAL COSTS,INPATIENT ANCILLARY SERVICE COST APPORTIONMENT,HOSPITAL WAGE INDEX DATA,COMPUTATION OF RATIO OF COST TO CHARGES,HOSPITAL WAGE INDEX DATA,APPORTIONMENT OF MEDICAL AND OTHER HEALTH SERVICES,COMPUTATION OF RATIO OF COST TO CHARGES,HOSPITAL WAGE INDEX DATA,ADJUSTMENTS,HOSPITAL WAGE INDEX DATA,APPORTIONMENT OF INPATIENT/OUTPATIENT ANCILLARY SERVICE OTHER PASS THROUGH COSTS,HHA STATISTICAL DATA,COMPUTATION OF RATIO OF COST TO CHARGES,TRIAL BALANCE OF EXPENSE ACCOUNTS,APPORTIONMENT OF INPATIENT/OUTPATIENT ANCILLARY SERVICE OTHER PASS THROUGH COSTS,COMPUTATION OF RATIO OF COST TO CHARGES,ADJUSTMENTS,APPORTIONMENT OF INPATIENT/OUTPATIENT ANCILLARY SERVICE OTHER PASS THROUGH COSTS,ADJUSTMENTS,HHA STATISTICAL DATA,NUMBER OF BEDS,APPORTIONMENT OF INPATIENT/OUTPATIENT ANCILLARY SERVICE OTHER PASS THROUGH COSTS,INPATIENT ANCILLARY SERVICE COST APPORTIONMENT,STATEMENT OF REVENUES AND EXPENSES,BED DAYS AVAILABLE,APPORTIONMENT OF INPATIENT/OUTPATIENT ANCILLARY SERVICE OTHER PASS THROUGH COSTS,APPORTIONMENT OF MEDICAL AND OTHER HEALTH SERVICES,APPORTIONMENT OF INPATIENT/OUTPATIENT ANCILLARY SERVICE OTHER PASS THROUGH COSTS,Medicaid Inpatient Days/Outpatient Visits,INPATIENT ANCILLARY SERVICE COST APPORTIONMENT,COMPUTATION OF RATIO OF COST TO CHARGES,RENAL STATISTICAL DATA,TRIAL BALANCE OF EXPENSE ACCOUNTS,COST ALLOCATION,INPATIENT ANCILLARY SERVICE COST APPORTIONMENT,COST ALLOCATION,BALANCE SHEET,TRIAL BALANCE OF EXPENSE ACCOUNTS,APPORTIONMENT OF INPATIENT/OUTPATIENT ANCILLARY SERVICE OTHER PASS THROUGH COSTS,COST ALLOCATION,TRIAL BALANCE OF EXPENSE ACCOUNTS,COST ALLOCATION,NUMBER OF BEDS,Total Inpatient Days/Outpatient Visits,HOSPITAL WAGE INDEX DATA,APPORTIONMENT OF INPATIENT ROUTINE SERVICE OTHER PASS THROUGH COSTS,APPORTIONMENT OF INPATIENT/OUTPATIENT ANCILLARY SERVICE OTHER PASS THROUGH COSTS,BED DAYS AVAILABLE,APPORTIONMENT OF INPATIENT/OUTPATIENT ANCILLARY SERVICE OTHER PASS THROUGH COSTS,INPATIENT ANCILLARY SERVICE COST APPORTIONMENT,INPATIENT ANCILLARY SERVICE COST APPORTIONMENT,ALLOCATION OF NEW CAPITAL COSTS,APPORTIONMENT OF INPATIENT/OUTPATIENT ANCILLARY SERVICE OTHER PASS THROUGH COSTS,COST ALLOCATION,APPORTIONMENT OF MEDICAL AND OTHER HEALTH SERVICES,COMPUTATION OF INPATIENT OPERATING COSTS,ALLOCATION OF NEW CAPITAL COSTS,Total Inpatient Days/Outpatient Visits,APPORTIONMENT OF INPATIENT/OUTPATIENT ANCILLARY SERVICE OTHER PASS THROUGH COSTS,APPORTIONMENT OF MEDICAL AND OTHER HEALTH SERVICES,HOSPITAL IDENTIFICATION INFORMATION,APPORTIONMENT OF INPATIENT/OUTPATIENT ANCILLARY SERVICE OTHER PASS THROUGH COSTS,INPATIENT ANCILLARY SERVICE COST APPORTIONMENT,COST ALLOCATION,TRIAL BALANCE OF EXPENSE ACCOUNTS,HOSPITAL WAGE INDEX DATA,TRIAL BALANCE OF EXPENSE ACCOUNTS,ALLOCATION OF NEW CAPITAL COSTS,APPORTIONMENT OF INPATIENT/OUTPATIENT ANCILLARY SERVICE OTHER PASS THROUGH COSTS,,TRIAL BALANCE OF EXPENSE ACCOUNTS,INPATIENT ANCILLARY SERVICE COST APPORTIONMENT,Total Inpatient Days/Outpatient Visits,TRIAL BALANCE OF EXPENSE ACCOUNTS,CALCULATION OF REIMBURSEMENT SETTLEMENT,COST ALLOCATION,HHA STATISTICAL DATA,APPORTIONMENT OF INPATIENT/OUTPATIENT ANCILLARY SERVICE OTHER PASS THROUGH COSTS,APPORTIONMENT OF MEDICAL AND OTHER HEALTH SERVICES,APPORTIONMENT OF INPATIENT/OUTPATIENT ANCILLARY SERVICE OTHER PASS THROUGH COSTS,COST ALLOCATION,APPORTIONMENT OF MEDICAL AND OTHER HEALTH SERVICES,COMPUTATION OF RATIO OF COST TO CHARGES,APPORTIONMENT OF INPATIENT/OUTPATIENT ANCILLARY SERVICE OTHER PASS THROUGH COSTS,TRIAL BALANCE OF EXPENSE ACCOUNTS,TRIAL BALANCE OF EXPENSE ACCOUNTS,APPORTIONMENT OF INPATIENT/OUTPATIENT ANCILLARY SERVICE OTHER PASS THROUGH COSTS,APPORTIONMENT OF INPATIENT ROUTINE SERVICE CAPITAL COSTS,COST ALLOCATION,COST ALLOCATION,BED DAYS AVAILABLE,COMPUTATION OF RATIO OF COST TO CHARGES,S-10 DATA,APPORTIONMENT OF INPATIENT/OUTPATIENT ANCILLARY SERVICE OTHER PASS THROUGH COSTS,INPATIENT ANCILLARY SERVICE COST APPORTIONMENT,INPATIENT ANCILLARY SERVICE COST APPORTIONMENT,COMPUTATION OF RATIO OF COST TO CHARGES,Total Inpatient Days/Outpatient Visits,TRIAL BALANCE OF EXPENSE ACCOUNTS,INPATIENT ANCILLARY SERVICE COST APPORTIONMENT,COST ALLOCATION,INPATIENT ANCILLARY SERVICE COST APPORTIONMENT,Total Inpatient Days/Outpatient Visits,COMPUTATION OF RATIO OF COST TO CHARGES,HOSPITAL WAGE INDEX DATA,HOSPITAL WAGE INDEX DATA,HOSPITAL IDENTIFICATION INFORMATION,APPORTIONMENT OF INPATIENT/OUTPATIENT ANCILLARY SERVICE OTHER PASS THROUGH COSTS,TRIAL BALANCE OF EXPENSE ACCOUNTS,COST ALLOCATION,BALANCE SHEET,COST ALLOCATION,APPORTIONMENT OF INPATIENT/OUTPATIENT ANCILLARY SERVICE OTHER PASS THROUGH COSTS,APPORTIONMENT OF INPATIENT/OUTPATIENT ANCILLARY SERVICE OTHER PASS THROUGH COSTS,RECONCILIATION OF CAPITAL COST CENTERS,COMPUTATION OF RATIO OF COST TO CHARGES,NUMBER OF BEDS,TRIAL BALANCE OF EXPENSE ACCOUNTS,INPATIENT ANCILLARY SERVICE COST APPORTIONMENT,APPORTIONMENT OF INPATIENT/OUTPATIENT ANCILLARY SERVICE OTHER PASS THROUGH COSTS,TRIAL BALANCE OF EXPENSE ACCOUNTS,INPATIENT ANCILLARY SERVICE COST APPORTIONMENT,APPORTIONMENT OF INPATIENT/OUTPATIENT ANCILLARY SERVICE OTHER PASS THROUGH COSTS,TRIAL BALANCE OF EXPENSE ACCOUNTS,INPATIENT ANCILLARY SERVICE COST APPORTIONMENT,INPATIENT ANCILLARY SERVICE COST APPORTIONMENT,APPORTIONMENT OF MEDICAL AND OTHER HEALTH SERVICES,CALCULATION OF REIMBURSEMENT SETTLEMENT,,INPATIENT ANCILLARY SERVICE COST APPORTIONMENT,COMPUTATION OF RATIO OF COST TO CHARGES,COST ALLOCATION,COMPUTATION OF RATIO OF COST TO CHARGES,HHA STATISTICAL DATA,APPORTIONMENT OF INPATIENT/OUTPATIENT ANCILLARY SERVICE OTHER PASS THROUGH COSTS,TRIAL BALANCE OF EXPENSE ACCOUNTS,INPATIENT ANCILLARY SERVICE COST APPORTIONMENT,APPORTIONMENT OF INPATIENT ROUTINE SERVICE CAPITAL COSTS,APPORTIONMENT OF INPATIENT/OUTPATIENT ANCILLARY SERVICE OTHER PASS THROUGH COSTS,TRIAL BALANCE OF EXPENSE ACCOUNTS,APPORTIONMENT OF INPATIENT/OUTPATIENT ANCILLARY SERVICE OTHER PASS THROUGH COSTS,CALCULATION OF REIMBURSEMENT SETTLEMENT,COMPUTATION OF RATIO OF COST TO CHARGES,RENAL STATISTICAL DATA,COST ALLOCATION,INPATIENT ANCILLARY SERVICE COST APPORTIONMENT,INPATIENT ANCILLARY SERVICE COST APPORTIONMENT,APPORTIONMENT OF INPATIENT/OUTPATIENT ANCILLARY SERVICE OTHER PASS THROUGH COSTS,APPORTIONMENT OF INPATIENT/OUTPATIENT ANCILLARY SERVICE OTHER PASS THROUGH COSTS,APPORTIONMENT OF MEDICAL AND OTHER HEALTH SERVICES,,COMPUTATION OF RATIO OF COST TO CHARGES,TRIAL BALANCE OF EXPENSE ACCOUNTS,COMPUTATION OF INPATIENT OPERATING COSTS,COMPUTATION OF RATIO OF COST TO CHARGES,INPATIENT ANCILLARY SERVICE COST APPORTIONMENT,TRIAL BALANCE OF EXPENSE ACCOUNTS,HOSPITAL WAGE INDEX DATA,COST ALLOCATION,APPORTIONMENT OF INPATIENT/OUTPATIENT ANCILLARY SERVICE OTHER PASS THROUGH COSTS,Total Inpatient Days/Outpatient Visits,COST ALLOCATION,APPORTIONMENT OF INPATIENT/OUTPATIENT ANCILLARY SERVICE OTHER PASS THROUGH COSTS,INPATIENT ANCILLARY SERVICE COST APPORTIONMENT,APPORTIONMENT OF INPATIENT/OUTPATIENT ANCILLARY SERVICE OTHER PASS THROUGH COSTS,INPATIENT ANCILLARY SERVICE COST APPORTIONMENT,APPORTIONMENT OF INPATIENT/OUTPATIENT ANCILLARY SERVICE OTHER PASS THROUGH COSTS,INPATIENT ANCILLARY SERVICE COST APPORTIONMENT,APPORTIONMENT OF INPATIENT ROUTINE SERVICE CAPITAL COSTS,APPORTIONMENT OF MEDICAL AND OTHER HEALTH SERVICES,INPATIENT ANCILLARY SERVICE COST APPORTIONMENT,APPORTIONMENT OF INPATIENT/OUTPATIENT ANCILLARY SERVICE OTHER PASS THROUGH COSTS,HOSPITAL WAGE INDEX DATA,COMPUTATION OF RATIO OF COST TO CHARGES,RENAL STATISTICAL DATA,,COMPUTATION OF RATIO OF COST TO CHARGES,APPORTIONMENT OF MEDICAL AND OTHER HEALTH SERVICES,TRIAL BALANCE OF EXPENSE ACCOUNTS,,APPORTIONMENT OF INPATIENT/OUTPATIENT ANCILLARY SERVICE OTHER PASS THROUGH COSTS,HOSPITAL WAGE INDEX DATA,APPORTIONMENT OF MEDICAL AND OTHER HEALTH SERVICES,APPORTIONMENT OF INPATIENT/OUTPATIENT ANCILLARY SERVICE OTHER PASS THROUGH COSTS,COMPUTATION OF RATIO OF COST TO CHARGES,COST ALLOCATION,APPORTIONMENT OF INPATIENT ROUTINE SERVICE CAPITAL COSTS,INPATIENT ANCILLARY SERVICE COST APPORTIONMENT,TRIAL BALANCE OF EXPENSE ACCOUNTS,HOSPITAL WAGE INDEX DATA,INPATIENT ANCILLARY SERVICE COST APPORTIONMENT,ADJUSTMENTS,Total Inpatient Days/Outpatient Visits,APPORTIONMENT OF INPATIENT/OUTPATIENT ANCILLARY SERVICE OTHER PASS THROUGH COSTS,Medicaid Inpatient Days/Outpatient Visits,APPORTIONMENT OF MEDICAL AND OTHER HEALTH SERVICES,COST ALLOCATION,COMPUTATION OF RATIO OF COST TO CHARGES,INPATIENT ANCILLARY SERVICE COST APPORTIONMENT,INPATIENT ANCILLARY SERVICE COST APPORTIONMENT,APPORTIONMENT OF MEDICAL AND OTHER HEALTH SERVICES,Total Inpatient Days/Outpatient Visits,COMPUTATION OF RATIO OF COST TO CHARGES,APPORTIONMENT OF MEDICAL AND OTHER HEALTH SERVICES,BALANCE SHEET,HHA STATISTICAL DATA,TRIAL BALANCE OF EXPENSE ACCOUNTS,TRIAL BALANCE OF EXPENSE ACCOUNTS,HOSPITAL WAGE INDEX DATA,Total Inpatient Days/Outpatient Visits,HOSPITAL WAGE INDEX DATA,,ANALYSIS OF CHANGES IN NEW CAPITAL BALANCES,Total Inpatient Days/Outpatient Visits,APPORTIONMENT OF INPATIENT/OUTPATIENT ANCILLARY SERVICE OTHER PASS THROUGH COSTS,APPORTIONMENT OF INPATIENT/OUTPATIENT ANCILLARY SERVICE OTHER PASS THROUGH COSTS,APPORTIONMENT OF INPATIENT/OUTPATIENT ANCILLARY SERVICE OTHER PASS THROUGH COSTS,HOSPITAL WAGE INDEX DATA,Medicaid Inpatient Days/Outpatient Visits,INPATIENT ANCILLARY SERVICE COST APPORTIONMENT,INPATIENT ANCILLARY SERVICE COST APPORTIONMENT,COST ALLOCATION,,APPORTIONMENT OF MEDICAL AND OTHER HEALTH SERVICES,ALLOCATION OF NEW CAPITAL COSTS,TRIAL BALANCE OF EXPENSE ACCOUNTS,COST ALLOCATION,INPATIENT ANCILLARY SERVICE COST APPORTIONMENT,TRIAL BALANCE OF EXPENSE ACCOUNTS,ADJUSTMENTS,,HOSPITAL WAGE INDEX DATA,APPORTIONMENT OF MEDICAL AND OTHER HEALTH SERVICES,APPORTIONMENT OF INPATIENT/OUTPATIENT ANCILLARY SERVICE OTHER PASS THROUGH COSTS,COST ALLOCATION,ALLOCATION OF NEW CAPITAL COSTS,HHA STATISTICAL DATA,Medicaid Inpatient Days/Outpatient Visits,APPORTIONMENT OF INPATIENT/OUTPATIENT ANCILLARY SERVICE OTHER PASS THROUGH COSTS,APPORTIONMENT OF INPATIENT/OUTPATIENT ANCILLARY SERVICE OTHER PASS THROUGH COSTS,INPATIENT ANCILLARY SERVICE COST APPORTIONMENT,APPORTIONMENT OF INPATIENT/OUTPATIENT ANCILLARY SERVICE OTHER PASS THROUGH COSTS,INPATIENT ANCILLARY SERVICE COST APPORTIONMENT,INPATIENT ANCILLARY SERVICE COST APPORTIONMENT,BALANCE SHEET,APPORTIONMENT OF INPATIENT/OUTPATIENT ANCILLARY SERVICE OTHER PASS THROUGH COSTS,INPATIENT ANCILLARY SERVICE COST APPORTIONMENT,COST ALLOCATION,APPORTIONMENT OF INPATIENT/OUTPATIENT ANCILLARY SERVICE OTHER PASS THROUGH COSTS,HOSPITAL WAGE INDEX DATA,APPORTIONMENT OF MEDICAL AND OTHER HEALTH SERVICES,COMPUTATION OF RATIO OF COST TO CHARGES,APPORTIONMENT OF MEDICAL AND OTHER HEALTH SERVICES,Total Inpatient Days/Outpatient Visits,APPORTIONMENT OF INPATIENT/OUTPATIENT ANCILLARY SERVICE OTHER PASS THROUGH COSTS,COST ALLOCATION,,TRIAL BALANCE OF EXPENSE ACCOUNTS,COMPUTATION OF RATIO OF COST TO CHARGES,CALCULATION OF REIMBURSEMENT SETTLEMENT,INPATIENT ANCILLARY SERVICE COST APPORTIONMENT,COMPUTATION OF RATIO OF COST TO CHARGES,APPORTIONMENT OF INPATIENT/OUTPATIENT ANCILLARY SERVICE OTHER PASS THROUGH COSTS,ADJUSTMENTS,COMPUTATION OF RATIO OF COST TO CHARGES,Total Inpatient Days/Outpatient Visits,TRIAL BALANCE OF EXPENSE ACCOUNTS,TRIAL BALANCE OF EXPENSE ACCOUNTS,COST ALLOCATION,HHA STATISTICAL DATA,ALLOCATION OF NEW CAPITAL COSTS,APPORTIONMENT OF MEDICAL AND OTHER HEALTH SERVICES,COMPUTATION OF RATIO OF COST TO CHARGES,APPORTIONMENT OF INPATIENT/OUTPATIENT ANCILLARY SERVICE OTHER PASS THROUGH COSTS,APPORTIONMENT OF INPATIENT ROUTINE SERVICE CAPITAL COSTS,COST ALLOCATION,INPATIENT ANCILLARY SERVICE COST APPORTIONMENT,COMPUTATION OF RATIO OF COST TO CHARGES,APPORTIONMENT OF INPATIENT/OUTPATIENT ANCILLARY SERVICE OTHER PASS THROUGH COSTS,APPORTIONMENT OF INPATIENT/OUTPATIENT ANCILLARY SERVICE OTHER PASS THROUGH COSTS,S-10 DATA,COST ALLOCATION,RECONCILIATION OF CAPITAL COST CENTERS,Medicaid Inpatient Days/Outpatient Visits,HOSPITAL WAGE INDEX DATA,HHA STATISTICAL DATA,APPORTIONMENT OF INPATIENT/OUTPATIENT ANCILLARY SERVICE OTHER PASS THROUGH COSTS,HOSPITAL WAGE INDEX DATA,COST ALLOCATION,COST ALLOCATION,ALLOCATION OF NEW CAPITAL COSTS,ANALYSIS OF CHANGES IN NEW CAPITAL BALANCES,ALLOCATION OF NEW CAPITAL COSTS,COST ALLOCATION,Medicaid Inpatient Days/Outpatient Visits,INPATIENT ANCILLARY SERVICE COST APPORTIONMENT,,Total Inpatient Days/Outpatient Visits,HOSPITAL WAGE INDEX DATA,HOSPITAL WAGE INDEX DATA,COST ALLOCATION,TRIAL BALANCE OF EXPENSE ACCOUNTS,NUMBER OF BEDS,COST ALLOCATION,BED DAYS AVAILABLE,ADJUSTMENTS,APPORTIONMENT OF MEDICAL AND OTHER HEALTH SERVICES,INPATIENT ANCILLARY SERVICE COST APPORTIONMENT,COST ALLOCATION,,BED DAYS AVAILABLE,INPATIENT ANCILLARY SERVICE COST APPORTIONMENT,COST ALLOCATION,APPORTIONMENT OF INPATIENT/OUTPATIENT ANCILLARY SERVICE OTHER PASS THROUGH COSTS,HOSPITAL WAGE INDEX DATA,TRIAL BALANCE OF EXPENSE ACCOUNTS,APPORTIONMENT OF INPATIENT/OUTPATIENT ANCILLARY SERVICE OTHER PASS THROUGH COSTS,RENAL STATISTICAL DATA,TRIAL BALANCE OF EXPENSE ACCOUNTS,APPORTIONMENT OF INPATIENT/OUTPATIENT ANCILLARY SERVICE OTHER PASS THROUGH COSTS,APPORTIONMENT OF MEDICAL AND OTHER HEALTH SERVICES,APPORTIONMENT OF INPATIENT/OUTPATIENT ANCILLARY SERVICE OTHER PASS THROUGH COSTS,COMPUTATION OF RATIO OF COST TO CHARGES,ALLOCATION OF NEW CAPITAL COSTS,ALLOCATION OF NEW CAPITAL COSTS,COMPUTATION OF RATIO OF COST TO CHARGES,COST ALLOCATION,INPATIENT ANCILLARY SERVICE COST APPORTIONMENT,S-10 DATA,BED DAYS AVAILABLE,HOSPITAL WAGE INDEX DATA,APPORTIONMENT OF INPATIENT/OUTPATIENT ANCILLARY SERVICE OTHER PASS THROUGH COSTS,INPATIENT ANCILLARY SERVICE COST APPORTIONMENT,INPATIENT ANCILLARY SERVICE COST APPORTIONMENT,,TRIAL BALANCE OF EXPENSE ACCOUNTS,TRIAL BALANCE OF EXPENSE ACCOUNTS,COST ALLOCATION,COST ALLOCATION,,COST ALLOCATION,INPATIENT ANCILLARY SERVICE COST APPORTIONMENT,Medicare Inpatient Days/Outpatient Visits,TRIAL BALANCE OF EXPENSE ACCOUNTS,ALLOCATION OF NEW CAPITAL COSTS,INPATIENT ANCILLARY SERVICE COST APPORTIONMENT,HOSPITAL WAGE INDEX DATA,INPATIENT ANCILLARY SERVICE COST APPORTIONMENT,COMPUTATION OF RATIO OF COST TO CHARGES,COMPUTATION OF INPATIENT OPERATING COSTS,TRIAL BALANCE OF EXPENSE ACCOUNTS,INPATIENT ANCILLARY SERVICE COST APPORTIONMENT,HOSPITAL WAGE INDEX DATA,CALCULATION OF REIMBURSEMENT SETTLEMENT,TRIAL BALANCE OF EXPENSE ACCOUNTS,TRIAL BALANCE OF EXPENSE ACCOUNTS,COMPUTATION OF RATIO OF COST TO CHARGES,Medicaid Inpatient Days/Outpatient Visits,HOSPITAL WAGE INDEX DATA,ANALYSIS OF CHANGES IN NEW CAPITAL BALANCES,TRIAL BALANCE OF EXPENSE ACCOUNTS,APPORTIONMENT OF INPATIENT/OUTPATIENT ANCILLARY SERVICE OTHER PASS THROUGH COSTS,BALANCE SHEET,INPATIENT ANCILLARY SERVICE COST APPORTIONMENT,APPORTIONMENT OF MEDICAL AND OTHER HEALTH SERVICES,COST ALLOCATION,COST ALLOCATION,ANALYSIS OF CHANGES IN NEW CAPITAL BALANCES,,COST ALLOCATION,COST ALLOCATION,ADJUSTMENTS,S-10 DATA,INPATIENT ANCILLARY SERVICE COST APPORTIONMENT,RENAL STATISTICAL DATA,APPORTIONMENT OF INPATIENT/OUTPATIENT ANCILLARY SERVICE OTHER PASS THROUGH COSTS,HHA STATISTICAL DATA,HOSPITAL WAGE INDEX DATA,NUMBER OF BEDS,COMPUTATION OF RATIO OF COST TO CHARGES,COMPUTATION OF RATIO OF COST TO CHARGES,CALCULATION OF REIMBURSEMENT SETTLEMENT,APPORTIONMENT OF INPATIENT/OUTPATIENT ANCILLARY SERVICE OTHER PASS THROUGH COSTS,APPORTIONMENT OF INPATIENT/OUTPATIENT ANCILLARY SERVICE OTHER PASS THROUGH COSTS,RENAL STATISTICAL DATA,COMPUTATION OF RATIO OF COST TO CHARGES,COST ALLOCATION,COMPUTATION OF RATIO OF COST TO CHARGES,TRIAL BALANCE OF EXPENSE ACCOUNTS,INPATIENT ANCILLARY SERVICE COST APPORTIONMENT,HOSPITAL WAGE INDEX DATA,TRIAL BALANCE OF EXPENSE ACCOUNTS,COMPUTATION OF RATIO OF COST TO CHARGES,INPATIENT ANCILLARY SERVICE COST APPORTIONMENT,BED DAYS AVAILABLE,TRIAL BALANCE OF EXPENSE ACCOUNTS,COST ALLOCATION,ALLOCATION OF NEW CAPITAL COSTS,COST ALLOCATION,HOSPITAL WAGE INDEX DATA,APPORTIONMENT OF MEDICAL AND OTHER HEALTH SERVICES,HOSPITAL WAGE INDEX DATA,COMPUTATION OF RATIO OF COST TO CHARGES,,INPATIENT ANCILLARY SERVICE COST APPORTIONMENT,TRIAL BALANCE OF EXPENSE ACCOUNTS,,TRIAL BALANCE OF EXPENSE ACCOUNTS,COMPUTATION OF INPATIENT OPERATING COSTS,ADJUSTMENTS,Medicaid Inpatient Days/Outpatient Visits,INPATIENT ANCILLARY SERVICE COST APPORTIONMENT,HOSPITAL WAGE INDEX DATA,TRIAL BALANCE OF EXPENSE ACCOUNTS,INPATIENT ANCILLARY SERVICE COST APPORTIONMENT,,APPORTIONMENT OF INPATIENT/OUTPATIENT ANCILLARY SERVICE OTHER PASS THROUGH COSTS,,,APPORTIONMENT OF INPATIENT ROUTINE SERVICE CAPITAL COSTS,APPORTIONMENT OF INPATIENT/OUTPATIENT ANCILLARY SERVICE OTHER PASS THROUGH COSTS,HOSPITAL WAGE INDEX DATA,S-10 DATA,Total Inpatient Days/Outpatient Visits,TRIAL BALANCE OF EXPENSE ACCOUNTS,INPATIENT ANCILLARY SERVICE COST APPORTIONMENT,INPATIENT ANCILLARY SERVICE COST APPORTIONMENT,TRIAL BALANCE OF EXPENSE ACCOUNTS,COST ALLOCATION,BED DAYS AVAILABLE,HOSPITAL WAGE INDEX DATA,TRIAL BALANCE OF EXPENSE ACCOUNTS,COST ALLOCATION,TRIAL BALANCE OF EXPENSE ACCOUNTS,APPORTIONMENT OF MEDICAL AND OTHER HEALTH SERVICES,HOSPITAL WAGE INDEX DATA,COST ALLOCATION,APPORTIONMENT OF INPATIENT/OUTPATIENT ANCILLARY SERVICE OTHER PASS THROUGH COSTS,COMPUTATION OF RATIO OF COST TO CHARGES,COST ALLOCATION,BED DAYS AVAILABLE,APPORTIONMENT OF INPATIENT/OUTPATIENT ANCILLARY SERVICE OTHER PASS THROUGH COSTS,APPORTIONMENT OF INPATIENT/OUTPATIENT ANCILLARY SERVICE OTHER PASS THROUGH COSTS,HOSPITAL WAGE INDEX DATA,COST ALLOCATION,INPATIENT ANCILLARY SERVICE COST APPORTIONMENT,APPORTIONMENT OF INPATIENT/OUTPATIENT ANCILLARY SERVICE OTHER PASS THROUGH COSTS,COMPUTATION OF RATIO OF COST TO CHARGES,S-10 DATA,BALANCE SHEET,RECONCILIATION OF CAPITAL COST CENTERS,TRIAL BALANCE OF EXPENSE ACCOUNTS,COMPUTATION OF RATIO OF COST TO CHARGES,TRIAL BALANCE OF EXPENSE ACCOUNTS,APPORTIONMENT OF INPATIENT/OUTPATIENT ANCILLARY SERVICE OTHER PASS THROUGH COSTS,APPORTIONMENT OF INPATIENT/OUTPATIENT ANCILLARY SERVICE OTHER PASS THROUGH COSTS,INPATIENT ANCILLARY SERVICE COST APPORTIONMENT,HHA STATISTICAL DATA,APPORTIONMENT OF INPATIENT/OUTPATIENT ANCILLARY SERVICE OTHER PASS THROUGH COSTS,HHA STATISTICAL DATA,APPORTIONMENT OF INPATIENT/OUTPATIENT ANCILLARY SERVICE OTHER PASS THROUGH COSTS,INPATIENT ANCILLARY SERVICE COST APPORTIONMENT,TRIAL BALANCE OF EXPENSE ACCOUNTS,INPATIENT ANCILLARY SERVICE COST APPORTIONMENT,TRIAL BALANCE OF EXPENSE ACCOUNTS,INPATIENT ANCILLARY SERVICE COST APPORTIONMENT,INPATIENT ANCILLARY SERVICE COST APPORTIONMENT,COMPUTATION OF INPATIENT OPERATING COSTS,COMPUTATION OF RATIO OF COST TO CHARGES,TRIAL BALANCE OF EXPENSE ACCOUNTS,APPORTIONMENT OF INPATIENT/OUTPATIENT ANCILLARY SERVICE OTHER PASS THROUGH COSTS,HOSPITAL WAGE INDEX DATA,COMPUTATION OF RATIO OF COST TO CHARGES,TRIAL BALANCE OF EXPENSE ACCOUNTS,APPORTIONMENT OF MEDICAL AND OTHER HEALTH SERVICES,TRIAL BALANCE OF EXPENSE ACCOUNTS,RECONCILIATION OF CAPITAL COST CENTERS,COMPUTATION OF RATIO OF COST TO CHARGES,COST ALLOCATION,Medicaid Inpatient Days/Outpatient Visits,COMPUTATION OF RATIO OF COST TO CHARGES,COMPUTATION OF RATIO OF COST TO CHARGES,ADJUSTMENTS,BED DAYS AVAILABLE,COST ALLOCATION,ALLOCATION OF NEW CAPITAL COSTS,APPORTIONMENT OF INPATIENT/OUTPATIENT ANCILLARY SERVICE OTHER PASS THROUGH COSTS,TRIAL BALANCE OF EXPENSE ACCOUNTS,HOSPITAL WAGE INDEX DATA,HOSPITAL WAGE INDEX DATA,COST ALLOCATION,APPORTIONMENT OF INPATIENT/OUTPATIENT ANCILLARY SERVICE OTHER PASS THROUGH COSTS,Total Inpatient Days/Outpatient Visits,RECONCILIATION OF CAPITAL COST CENTERS,HHA STATISTICAL DATA,COST ALLOCATION,Total Inpatient Days/Outpatient Visits,INPATIENT ANCILLARY SERVICE COST APPORTIONMENT,INPATIENT ANCILLARY SERVICE COST APPORTIONMENT,COST ALLOCATION,COMPUTATION OF RATIO OF COST TO CHARGES,,INPATIENT ANCILLARY SERVICE COST APPORTIONMENT,HOSPITAL WAGE INDEX DATA,COMPUTATION OF RATIO OF COST TO CHARGES,APPORTIONMENT OF INPATIENT ROUTINE SERVICE OTHER PASS THROUGH COSTS,APPORTIONMENT OF MEDICAL AND OTHER HEALTH SERVICES,APPORTIONMENT OF MEDICAL AND OTHER HEALTH SERVICES,INPATIENT ANCILLARY SERVICE COST APPORTIONMENT,,APPORTIONMENT OF INPATIENT/OUTPATIENT ANCILLARY SERVICE OTHER PASS THROUGH COSTS,TRIAL BALANCE OF EXPENSE ACCOUNTS,COMPUTATION OF RATIO OF COST TO CHARGES,TRIAL BALANCE OF EXPENSE ACCOUNTS,INPATIENT ANCILLARY SERVICE COST APPORTIONMENT,APPORTIONMENT OF MEDICAL AND OTHER HEALTH SERVICES,,COST ALLOCATION,BED DAYS AVAILABLE,CALCULATION OF REIMBURSEMENT SETTLEMENT,APPORTIONMENT OF MEDICAL AND OTHER HEALTH SERVICES,INPATIENT ANCILLARY SERVICE COST APPORTIONMENT,TRIAL BALANCE OF EXPENSE ACCOUNTS,Total Inpatient Days/Outpatient Visits,TRIAL BALANCE OF EXPENSE ACCOUNTS,TRIAL BALANCE OF EXPENSE ACCOUNTS,COMPUTATION OF RATIO OF COST TO CHARGES,COMPUTATION OF INPATIENT OPERATING COSTS,COMPUTATION OF RATIO OF COST TO CHARGES,TRIAL BALANCE OF EXPENSE ACCOUNTS,INPATIENT ANCILLARY SERVICE COST APPORTIONMENT,APPORTIONMENT OF INPATIENT/OUTPATIENT ANCILLARY SERVICE OTHER PASS THROUGH COSTS,ALLOCATION OF NEW CAPITAL COSTS,TRIAL BALANCE OF EXPENSE ACCOUNTS,APPORTIONMENT OF INPATIENT/OUTPATIENT ANCILLARY SERVICE OTHER PASS THROUGH COSTS,BED DAYS AVAILABLE,TRIAL BALANCE OF EXPENSE ACCOUNTS,APPORTIONMENT OF INPATIENT/OUTPATIENT ANCILLARY SERVICE OTHER PASS THROUGH COSTS,INPATIENT ANCILLARY SERVICE COST APPORTIONMENT,HOSPITAL WAGE INDEX DATA,ANALYSIS OF CHANGES IN NEW CAPITAL BALANCES,RENAL STATISTICAL DATA,TRIAL BALANCE OF EXPENSE ACCOUNTS,COMPUTATION OF RATIO OF COST TO CHARGES,APPORTIONMENT OF INPATIENT/OUTPATIENT ANCILLARY SERVICE OTHER PASS THROUGH COSTS,APPORTIONMENT OF INPATIENT/OUTPATIENT ANCILLARY SERVICE OTHER PASS THROUGH COSTS,TRIAL BALANCE OF EXPENSE ACCOUNTS,INPATIENT ANCILLARY SERVICE COST APPORTIONMENT,COST ALLOCATION,,APPORTIONMENT OF INPATIENT/OUTPATIENT ANCILLARY SERVICE OTHER PASS THROUGH COSTS,APPORTIONMENT OF INPATIENT/OUTPATIENT ANCILLARY SERVICE OTHER PASS THROUGH COSTS,TRIAL BALANCE OF EXPENSE ACCOUNTS,HOSPITAL WAGE INDEX DATA,INPATIENT ANCILLARY SERVICE COST APPORTIONMENT,APPORTIONMENT OF INPATIENT/OUTPATIENT ANCILLARY SERVICE OTHER PASS THROUGH COSTS,COST ALLOCATION,BALANCE SHEET,HOSPITAL WAGE INDEX DATA,ALLOCATION OF NEW CAPITAL COSTS,,APPORTIONMENT OF INPATIENT/OUTPATIENT ANCILLARY SERVICE OTHER PASS THROUGH COSTS,APPORTIONMENT OF INPATIENT/OUTPATIENT ANCILLARY SERVICE OTHER PASS THROUGH COSTS,APPORTIONMENT OF INPATIENT/OUTPATIENT ANCILLARY SERVICE OTHER PASS THROUGH COSTS,INPATIENT ANCILLARY SERVICE COST APPORTIONMENT,INPATIENT ANCILLARY SERVICE COST APPORTIONMENT,INPATIENT ANCILLARY SERVICE COST APPORTIONMENT,HOSPITAL WAGE INDEX DATA,COST ALLOCATION,TRIAL BALANCE OF EXPENSE ACCOUNTS,APPORTIONMENT OF INPATIENT/OUTPATIENT ANCILLARY SERVICE OTHER PASS THROUGH COSTS,INPATIENT ANCILLARY SERVICE COST APPORTIONMENT,NUMBER OF BEDS,APPORTIONMENT OF INPATIENT/OUTPATIENT ANCILLARY SERVICE OTHER PASS THROUGH COSTS,COMPUTATION OF RATIO OF COST TO CHARGES,APPORTIONMENT OF MEDICAL AND OTHER HEALTH SERVICES,ALLOCATION OF NEW CAPITAL COSTS,APPORTIONMENT OF MEDICAL AND OTHER HEALTH SERVICES,COMPUTATION OF RATIO OF COST TO CHARGES,HOSPITAL WAGE INDEX DATA,ALLOCATION OF NEW CAPITAL COSTS,APPORTIONMENT OF INPATIENT/OUTPATIENT ANCILLARY SERVICE OTHER PASS THROUGH COSTS,,Total Inpatient Days/Outpatient Visits,APPORTIONMENT OF INPATIENT/OUTPATIENT ANCILLARY SERVICE OTHER PASS THROUGH COSTS,COMPUTATION OF RATIO OF COST TO CHARGES,HOSPITAL WAGE INDEX DATA,Total Inpatient Days/Outpatient Visits,APPORTIONMENT OF INPATIENT/OUTPATIENT ANCILLARY SERVICE OTHER PASS THROUGH COSTS,,APPORTIONMENT OF INPATIENT/OUTPATIENT ANCILLARY SERVICE OTHER PASS THROUGH COSTS,APPORTIONMENT OF INPATIENT/OUTPATIENT ANCILLARY SERVICE OTHER PASS THROUGH COSTS,CALCULATION OF REIMBURSEMENT SETTLEMENT,INPATIENT ANCILLARY SERVICE COST APPORTIONMENT,NUMBER OF BEDS,COMPUTATION OF INPATIENT OPERATING COSTS,,Total Inpatient Days/Outpatient Visits,TRIAL BALANCE OF EXPENSE ACCOUNTS,TRIAL BALANCE OF EXPENSE ACCOUNTS,APPORTIONMENT OF INPATIENT ROUTINE SERVICE OTHER PASS THROUGH COSTS,INPATIENT ANCILLARY SERVICE COST APPORTIONMENT,COMPUTATION OF INPATIENT OPERATING COSTS,,,INPATIENT ANCILLARY SERVICE COST APPORTIONMENT,INPATIENT ANCILLARY SERVICE COST APPORTIONMENT,COST ALLOCATION,APPORTIONMENT OF INPATIENT/OUTPATIENT ANCILLARY SERVICE OTHER PASS THROUGH COSTS,APPORTIONMENT OF INPATIENT/OUTPATIENT ANCILLARY SERVICE OTHER PASS THROUGH COSTS,APPORTIONMENT OF INPATIENT/OUTPATIENT ANCILLARY SERVICE OTHER PASS THROUGH COSTS,HOSPITAL WAGE INDEX DATA,APPORTIONMENT OF MEDICAL AND OTHER HEALTH SERVICES,Medicaid Inpatient Days/Outpatient Visits,COMPUTATION OF RATIO OF COST TO CHARGES,TRIAL BALANCE OF EXPENSE ACCOUNTS,COST ALLOCATION,HOSPITAL WAGE INDEX DATA,COMPUTATION OF RATIO OF COST TO CHARGES,INPATIENT ANCILLARY SERVICE COST APPORTIONMENT,,APPORTIONMENT OF INPATIENT/OUTPATIENT ANCILLARY SERVICE OTHER PASS THROUGH COSTS,S-10 DATA,HHA STATISTICAL DATA,TRIAL BALANCE OF EXPENSE ACCOUNTS,APPORTIONMENT OF INPATIENT/OUTPATIENT ANCILLARY SERVICE OTHER PASS THROUGH COSTS,COST ALLOCATION,HOSPITAL WAGE INDEX DATA,Total Inpatient Days/Outpatient Visits,COST ALLOCATION,COMPUTATION OF RATIO OF COST TO CHARGES,APPORTIONMENT OF INPATIENT/OUTPATIENT ANCILLARY SERVICE OTHER PASS THROUGH COSTS,HOSPITAL WAGE INDEX DATA,APPORTIONMENT OF INPATIENT/OUTPATIENT ANCILLARY SERVICE OTHER PASS THROUGH COSTS,,HHA STATISTICAL DATA,COST ALLOCATION,TRIAL BALANCE OF EXPENSE ACCOUNTS,INPATIENT ANCILLARY SERVICE COST APPORTIONMENT,INPATIENT ANCILLARY SERVICE COST APPORTIONMENT,TRIAL BALANCE OF EXPENSE ACCOUNTS,APPORTIONMENT OF INPATIENT/OUTPATIENT ANCILLARY SERVICE OTHER PASS THROUGH COSTS,APPORTIONMENT OF INPATIENT/OUTPATIENT ANCILLARY SERVICE OTHER PASS THROUGH COSTS,,COST ALLOCATION,,APPORTIONMENT OF MEDICAL AND OTHER HEALTH SERVICES,APPORTIONMENT OF MEDICAL AND OTHER HEALTH SERVICES,INPATIENT ANCILLARY SERVICE COST APPORTIONMENT,RENAL STATISTICAL DATA,TRIAL BALANCE OF EXPENSE ACCOUNTS,BALANCE SHEET,INPATIENT ANCILLARY SERVICE COST APPORTIONMENT,APPORTIONMENT OF MEDICAL AND OTHER HEALTH SERVICES,NUMBER OF BEDS,HOSPITAL WAGE INDEX DATA,HOSPITAL WAGE INDEX DATA,ALLOCATION OF NEW CAPITAL COSTS,ALLOCATION OF NEW CAPITAL COSTS,APPORTIONMENT OF MEDICAL AND OTHER HEALTH SERVICES,APPORTIONMENT OF MEDICAL AND OTHER HEALTH SERVICES,Total Inpatient Days/Outpatient Visits,RENAL STATISTICAL DATA,TRIAL BALANCE OF EXPENSE ACCOUNTS,ADJUSTMENTS,BALANCE SHEET,ANALYSIS OF CHANGES IN NEW CAPITAL BALANCES,COMPUTATION OF RATIO OF COST TO CHARGES,TRIAL BALANCE OF EXPENSE ACCOUNTS,TRIAL BALANCE OF EXPENSE ACCOUNTS,TRIAL BALANCE OF EXPENSE ACCOUNTS,COST ALLOCATION,APPORTIONMENT OF INPATIENT/OUTPATIENT ANCILLARY SERVICE OTHER PASS THROUGH COSTS,TRIAL BALANCE OF EXPENSE ACCOUNTS,APPORTIONMENT OF INPATIENT/OUTPATIENT ANCILLARY SERVICE OTHER PASS THROUGH COSTS,BED DAYS AVAILABLE,APPORTIONMENT OF INPATIENT/OUTPATIENT ANCILLARY SERVICE OTHER PASS THROUGH COSTS,COST ALLOCATION,,COST ALLOCATION,APPORTIONMENT OF INPATIENT/OUTPATIENT ANCILLARY SERVICE OTHER PASS THROUGH COSTS,APPORTIONMENT OF INPATIENT/OUTPATIENT ANCILLARY SERVICE OTHER PASS THROUGH COSTS,INPATIENT ANCILLARY SERVICE COST APPORTIONMENT,ANALYSIS OF CHANGES IN NEW CAPITAL BALANCES,HHA STATISTICAL DATA,APPORTIONMENT OF INPATIENT/OUTPATIENT ANCILLARY SERVICE OTHER PASS THROUGH COSTS,COMPUTATION OF RATIO OF COST TO CHARGES,Medicare Inpatient Days/Outpatient Visits,INPATIENT ANCILLARY SERVICE COST APPORTIONMENT,CALCULATION OF REIMBURSEMENT SETTLEMENT,TRIAL BALANCE OF EXPENSE ACCOUNTS,RENAL STATISTICAL DATA,APPORTIONMENT OF MEDICAL AND OTHER HEALTH SERVICES,APPORTIONMENT OF MEDICAL AND OTHER HEALTH SERVICES,BED DAYS AVAILABLE,,,BED DAYS AVAILABLE,COST ALLOCATION,ALLOCATION OF NEW CAPITAL COSTS,TRIAL BALANCE OF EXPENSE ACCOUNTS,ALLOCATION OF NEW CAPITAL COSTS,APPORTIONMENT OF INPATIENT ROUTINE SERVICE OTHER PASS THROUGH COSTS,INPATIENT ANCILLARY SERVICE COST APPORTIONMENT,ALLOCATION OF NEW CAPITAL COSTS,COST ALLOCATION,HHA STATISTICAL DATA,TRIAL BALANCE OF EXPENSE ACCOUNTS,TRIAL BALANCE OF EXPENSE ACCOUNTS,INPATIENT ANCILLARY SERVICE COST APPORTIONMENT,COST ALLOCATION,BALANCE SHEET,COMPUTATION OF RATIO OF COST TO CHARGES,NUMBER OF BEDS,BED DAYS AVAILABLE,APPORTIONMENT OF INPATIENT/OUTPATIENT ANCILLARY SERVICE OTHER PASS THROUGH COSTS,COST ALLOCATION,TRIAL BALANCE OF EXPENSE ACCOUNTS,APPORTIONMENT OF MEDICAL AND OTHER HEALTH SERVICES,COST ALLOCATION,TRIAL BALANCE OF EXPENSE ACCOUNTS,TRIAL BALANCE OF EXPENSE ACCOUNTS,INPATIENT ANCILLARY SERVICE COST APPORTIONMENT,INPATIENT ANCILLARY SERVICE COST APPORTIONMENT,INPATIENT ANCILLARY SERVICE COST APPORTIONMENT,COST ALLOCATION,APPORTIONMENT OF INPATIENT/OUTPATIENT ANCILLARY SERVICE OTHER PASS THROUGH COSTS,APPORTIONMENT OF MEDICAL AND OTHER HEALTH SERVICES,ADJUSTMENTS,TRIAL BALANCE OF EXPENSE ACCOUNTS,HHA STATISTICAL DATA,APPORTIONMENT OF INPATIENT/OUTPATIENT ANCILLARY SERVICE OTHER PASS THROUGH COSTS,ANALYSIS OF CHANGES IN NEW CAPITAL BALANCES,CALCULATION OF REIMBURSEMENT SETTLEMENT,CALCULATION OF REIMBURSEMENT SETTLEMENT,Total Inpatient Days/Outpatient Visits,COST ALLOCATION,APPORTIONMENT OF INPATIENT/OUTPATIENT ANCILLARY SERVICE OTHER PASS THROUGH COSTS,APPORTIONMENT OF MEDICAL AND OTHER HEALTH SERVICES,INPATIENT ANCILLARY SERVICE COST APPORTIONMENT,COMPUTATION OF RATIO OF COST TO CHARGES,COST ALLOCATION,APPORTIONMENT OF MEDICAL AND OTHER HEALTH SERVICES,HOSPITAL WAGE INDEX DATA,APPORTIONMENT OF INPATIENT/OUTPATIENT ANCILLARY SERVICE OTHER PASS THROUGH COSTS,TRIAL BALANCE OF EXPENSE ACCOUNTS,INPATIENT ANCILLARY SERVICE COST APPORTIONMENT,RECONCILIATION OF CAPITAL COST CENTERS,TRIAL BALANCE OF EXPENSE ACCOUNTS,TRIAL BALANCE OF EXPENSE ACCOUNTS,COST ALLOCATION,APPORTIONMENT OF INPATIENT/OUTPATIENT ANCILLARY SERVICE OTHER PASS THROUGH COSTS,TRIAL BALANCE OF EXPENSE ACCOUNTS,HOSPITAL WAGE INDEX DATA,APPORTIONMENT OF INPATIENT/OUTPATIENT ANCILLARY SERVICE OTHER PASS THROUGH COSTS,RENAL STATISTICAL DATA,APPORTIONMENT OF INPATIENT ROUTINE SERVICE CAPITAL COSTS,COST ALLOCATION,COST ALLOCATION,Total Inpatient Days/Outpatient Visits,TRIAL BALANCE OF EXPENSE ACCOUNTS,HOSPITAL WAGE INDEX DATA,APPORTIONMENT OF MEDICAL AND OTHER HEALTH SERVICES,HHA STATISTICAL DATA,APPORTIONMENT OF MEDICAL AND OTHER HEALTH SERVICES,HOSPITAL WAGE INDEX DATA,TRIAL BALANCE OF EXPENSE ACCOUNTS,Total Inpatient Days/Outpatient Visits,HOSPITAL WAGE INDEX DATA,APPORTIONMENT OF INPATIENT/OUTPATIENT ANCILLARY SERVICE OTHER PASS THROUGH COSTS,INPATIENT ANCILLARY SERVICE COST APPORTIONMENT,Medicare Inpatient Days/Outpatient Visits,COMPUTATION OF INPATIENT OPERATING COSTS,APPORTIONMENT OF MEDICAL AND OTHER HEALTH SERVICES,INPATIENT ANCILLARY SERVICE COST APPORTIONMENT,INPATIENT ANCILLARY SERVICE COST APPORTIONMENT,APPORTIONMENT OF INPATIENT ROUTINE SERVICE CAPITAL COSTS,HOSPITAL IDENTIFICATION INFORMATION,RECONCILIATION OF CAPITAL COST CENTERS,RECONCILIATION OF CAPITAL COST CENTERS,INPATIENT ANCILLARY SERVICE COST APPORTIONMENT,APPORTIONMENT OF MEDICAL AND OTHER HEALTH SERVICES,INPATIENT ANCILLARY SERVICE COST APPORTIONMENT,APPORTIONMENT OF MEDICAL AND OTHER HEALTH SERVICES,RECONCILIATION OF CAPITAL COST CENTERS,APPORTIONMENT OF INPATIENT/OUTPATIENT ANCILLARY SERVICE OTHER PASS THROUGH COSTS,TRIAL BALANCE OF EXPENSE ACCOUNTS,INPATIENT ANCILLARY SERVICE COST APPORTIONMENT,CALCULATION OF REIMBURSEMENT SETTLEMENT,TRIAL BALANCE OF EXPENSE ACCOUNTS,ALLOCATION OF NEW CAPITAL COSTS,APPORTIONMENT OF INPATIENT/OUTPATIENT ANCILLARY SERVICE OTHER PASS THROUGH COSTS,ALLOCATION OF NEW CAPITAL COSTS,ALLOCATION OF NEW CAPITAL COSTS,TRIAL BALANCE OF EXPENSE ACCOUNTS,TRIAL BALANCE OF EXPENSE ACCOUNTS,COMPUTATION OF RATIO OF COST TO CHARGES,APPORTIONMENT OF INPATIENT ROUTINE SERVICE OTHER PASS THROUGH COSTS,TRIAL BALANCE OF EXPENSE ACCOUNTS,APPORTIONMENT OF INPATIENT ROUTINE SERVICE CAPITAL COSTS,COST ALLOCATION,COMPUTATION OF RATIO OF COST TO CHARGES,INPATIENT ANCILLARY SERVICE COST APPORTIONMENT,COMPUTATION OF RATIO OF COST TO CHARGES,HHA STATISTICAL DATA,APPORTIONMENT OF INPATIENT ROUTINE SERVICE CAPITAL COSTS,INPATIENT ANCILLARY SERVICE COST APPORTIONMENT,INPATIENT ANCILLARY SERVICE COST APPORTIONMENT,COST ALLOCATION,APPORTIONMENT OF INPATIENT/OUTPATIENT ANCILLARY SERVICE OTHER PASS THROUGH COSTS,TRIAL BALANCE OF EXPENSE ACCOUNTS,TRIAL BALANCE OF EXPENSE ACCOUNTS,COST ALLOCATION,HHA STATISTICAL DATA,INPATIENT ANCILLARY SERVICE COST APPORTIONMENT,COST ALLOCATION,APPORTIONMENT OF MEDICAL AND OTHER HEALTH SERVICES,INPATIENT ANCILLARY SERVICE COST APPORTIONMENT,S-10 DATA,CALCULATION OF REIMBURSEMENT SETTLEMENT,HHA STATISTICAL DATA,APPORTIONMENT OF MEDICAL AND OTHER HEALTH SERVICES,ADJUSTMENTS,APPORTIONMENT OF MEDICAL AND OTHER HEALTH SERVICES,APPORTIONMENT OF INPATIENT/OUTPATIENT ANCILLARY SERVICE OTHER PASS THROUGH COSTS,APPORTIONMENT OF INPATIENT/OUTPATIENT ANCILLARY SERVICE OTHER PASS THROUGH COSTS,HOSPITAL WAGE INDEX DATA,HHA STATISTICAL DATA,TRIAL BALANCE OF EXPENSE ACCOUNTS,APPORTIONMENT OF INPATIENT ROUTINE SERVICE CAPITAL COSTS,APPORTIONMENT OF INPATIENT/OUTPATIENT ANCILLARY SERVICE OTHER PASS THROUGH COSTS,COMPUTATION OF INPATIENT OPERATING COSTS,Total Inpatient Days/Outpatient Visits,ANALYSIS OF CHANGES IN NEW CAPITAL BALANCES,TRIAL BALANCE OF EXPENSE ACCOUNTS,,TRIAL BALANCE OF EXPENSE ACCOUNTS,COST ALLOCATION,COST ALLOCATION,COMPUTATION OF RATIO OF COST TO CHARGES,Total Inpatient Days/Outpatient Visits,APPORTIONMENT OF MEDICAL AND OTHER HEALTH SERVICES,APPORTIONMENT OF INPATIENT/OUTPATIENT ANCILLARY SERVICE OTHER PASS THROUGH COSTS,TRIAL BALANCE OF EXPENSE ACCOUNTS,COMPUTATION OF RATIO OF COST TO CHARGES,BED DAYS AVAILABLE,APPORTIONMENT OF INPATIENT/OUTPATIENT ANCILLARY SERVICE OTHER PASS THROUGH COSTS,COST ALLOCATION,HOSPITAL WAGE INDEX DATA,INPATIENT ANCILLARY SERVICE COST APPORTIONMENT,COMPUTATION OF RATIO OF COST TO CHARGES,Total Inpatient Days/Outpatient Visits,TRIAL BALANCE OF EXPENSE ACCOUNTS,APPORTIONMENT OF INPATIENT/OUTPATIENT ANCILLARY SERVICE OTHER PASS THROUGH COSTS,COST ALLOCATION,ANALYSIS OF CHANGES IN NEW CAPITAL BALANCES,APPORTIONMENT OF MEDICAL AND OTHER HEALTH SERVICES,TRIAL BALANCE OF EXPENSE ACCOUNTS,CALCULATION OF REIMBURSEMENT SETTLEMENT,Medicare Inpatient Days/Outpatient Visits,TRIAL BALANCE OF EXPENSE ACCOUNTS,APPORTIONMENT OF INPATIENT/OUTPATIENT ANCILLARY SERVICE OTHER PASS THROUGH COSTS,TRIAL BALANCE OF EXPENSE ACCOUNTS,Medicaid Inpatient Days/Outpatient Visits,APPORTIONMENT OF MEDICAL AND OTHER HEALTH SERVICES,TRIAL BALANCE OF EXPENSE ACCOUNTS,COST ALLOCATION,APPORTIONMENT OF MEDICAL AND OTHER HEALTH SERVICES,APPORTIONMENT OF INPATIENT/OUTPATIENT ANCILLARY SERVICE OTHER PASS THROUGH COSTS,COST ALLOCATION,,,COST ALLOCATION,,HHA STATISTICAL DATA,BED DAYS AVAILABLE,INPATIENT ANCILLARY SERVICE COST APPORTIONMENT,APPORTIONMENT OF INPATIENT/OUTPATIENT ANCILLARY SERVICE OTHER PASS THROUGH COSTS,COMPUTATION OF RATIO OF COST TO CHARGES,APPORTIONMENT OF MEDICAL AND OTHER HEALTH SERVICES,HOSPITAL WAGE INDEX DATA,HOSPITAL WAGE INDEX DATA,COMPUTATION OF RATIO OF COST TO CHARGES,ADJUSTMENTS,APPORTIONMENT OF MEDICAL AND OTHER HEALTH SERVICES,COMPUTATION OF RATIO OF COST TO CHARGES,HOSPITAL WAGE INDEX DATA,ALLOCATION OF NEW CAPITAL COSTS,COMPUTATION OF RATIO OF COST TO CHARGES,APPORTIONMENT OF INPATIENT ROUTINE SERVICE CAPITAL COSTS,APPORTIONMENT OF MEDICAL AND OTHER HEALTH SERVICES,COST ALLOCATION,COST ALLOCATION,APPORTIONMENT OF MEDICAL AND OTHER HEALTH SERVICES,COST ALLOCATION,APPORTIONMENT OF INPATIENT/OUTPATIENT ANCILLARY SERVICE OTHER PASS THROUGH COSTS,COMPUTATION OF RATIO OF COST TO CHARGES,COST ALLOCATION,APPORTIONMENT OF INPATIENT/OUTPATIENT ANCILLARY SERVICE OTHER PASS THROUGH COSTS,ALLOCATION OF NEW CAPITAL COSTS,HOSPITAL WAGE INDEX DATA,APPORTIONMENT OF INPATIENT/OUTPATIENT ANCILLARY SERVICE OTHER PASS THROUGH COSTS,,CALCULATION OF REIMBURSEMENT SETTLEMENT (PPS),BALANCE SHEET,APPORTIONMENT OF MEDICAL AND OTHER HEALTH SERVICES,APPORTIONMENT OF MEDICAL AND OTHER HEALTH SERVICES,ADJUSTMENTS,INPATIENT ANCILLARY SERVICE COST APPORTIONMENT,COST ALLOCATION,COST ALLOCATION,APPORTIONMENT OF MEDICAL AND OTHER HEALTH SERVICES,Total Inpatient Days/Outpatient Visits,BED DAYS AVAILABLE,Medicaid Inpatient Days/Outpatient Visits,TRIAL BALANCE OF EXPENSE ACCOUNTS,COST ALLOCATION,TRIAL BALANCE OF EXPENSE ACCOUNTS,INPATIENT ANCILLARY SERVICE COST APPORTIONMENT,TRIAL BALANCE OF EXPENSE ACCOUNTS,HOSPITAL WAGE INDEX DATA,TRIAL BALANCE OF EXPENSE ACCOUNTS,INPATIENT ANCILLARY SERVICE COST APPORTIONMENT,TRIAL BALANCE OF EXPENSE ACCOUNTS,APPORTIONMENT OF INPATIENT/OUTPATIENT ANCILLARY SERVICE OTHER PASS THROUGH COSTS,COST ALLOCATION,COST ALLOCATION,Medicaid Inpatient Days/Outpatient Visits,APPORTIONMENT OF INPATIENT/OUTPATIENT ANCILLARY SERVICE OTHER PASS THROUGH COSTS,APPORTIONMENT OF INPATIENT/OUTPATIENT ANCILLARY SERVICE OTHER PASS THROUGH COSTS,,COST ALLOCATION,HHA STATISTICAL DATA,COST ALLOCATION,COST ALLOCATION,RECONCILIATION OF CAPITAL COST CENTERS,TRIAL BALANCE OF EXPENSE ACCOUNTS,TRIAL BALANCE OF EXPENSE ACCOUNTS,RECONCILIATION OF CAPITAL COST CENTERS,INPATIENT ANCILLARY SERVICE COST APPORTIONMENT,ALLOCATION OF NEW CAPITAL COSTS,TRIAL BALANCE OF EXPENSE ACCOUNTS,TRIAL BALANCE OF EXPENSE ACCOUNTS,APPORTIONMENT OF MEDICAL AND OTHER HEALTH SERVICES,COMPUTATION OF RATIO OF COST TO CHARGES,APPORTIONMENT OF INPATIENT/OUTPATIENT ANCILLARY SERVICE OTHER PASS THROUGH COSTS,ADJUSTMENTS,,TRIAL BALANCE OF EXPENSE ACCOUNTS,TRIAL BALANCE OF EXPENSE ACCOUNTS,COMPUTATION OF RATIO OF COST TO CHARGES,APPORTIONMENT OF INPATIENT ROUTINE SERVICE CAPITAL COSTS,APPORTIONMENT OF INPATIENT/OUTPATIENT ANCILLARY SERVICE OTHER PASS THROUGH COSTS,INPATIENT ANCILLARY SERVICE COST APPORTIONMENT,COST ALLOCATION,Total Inpatient Days/Outpatient Visits,RENAL STATISTICAL DATA,ANALYSIS OF CHANGES IN NEW CAPITAL BALANCES,TRIAL BALANCE OF EXPENSE ACCOUNTS,APPORTIONMENT OF INPATIENT/OUTPATIENT ANCILLARY SERVICE OTHER PASS THROUGH COSTS,APPORTIONMENT OF MEDICAL AND OTHER HEALTH SERVICES,COMPUTATION OF RATIO OF COST TO CHARGES,INPATIENT ANCILLARY SERVICE COST APPORTIONMENT,HOSPITAL WAGE INDEX DATA,HOSPITAL WAGE INDEX DATA,ALLOCATION OF NEW CAPITAL COSTS,CALCULATION OF REIMBURSEMENT SETTLEMENT,BALANCE SHEET,HOSPITAL WAGE INDEX DATA,ANALYSIS OF CHANGES IN NEW CAPITAL BALANCES,,HOSPITAL WAGE INDEX DATA,APPORTIONMENT OF INPATIENT/OUTPATIENT ANCILLARY SERVICE OTHER PASS THROUGH COSTS,TRIAL BALANCE OF EXPENSE ACCOUNTS,STATEMENT OF REVENUES AND EXPENSES,INPATIENT ANCILLARY SERVICE COST APPORTIONMENT,INPATIENT ANCILLARY SERVICE COST APPORTIONMENT,TRIAL BALANCE OF EXPENSE ACCOUNTS,INPATIENT ANCILLARY SERVICE COST APPORTIONMENT,COMPUTATION OF RATIO OF COST TO CHARGES,COST ALLOCATION,BED DAYS AVAILABLE,BED DAYS AVAILABLE,APPORTIONMENT OF MEDICAL AND OTHER HEALTH SERVICES,APPORTIONMENT OF INPATIENT/OUTPATIENT ANCILLARY SERVICE OTHER PASS THROUGH COSTS,COMPUTATION OF RATIO OF COST TO CHARGES,COMPUTATION OF INPATIENT OPERATING COSTS,TRIAL BALANCE OF EXPENSE ACCOUNTS,APPORTIONMENT OF INPATIENT/OUTPATIENT ANCILLARY SERVICE OTHER PASS THROUGH COSTS,COMPUTATION OF RATIO OF COST TO CHARGES,,,COST ALLOCATION,HOSPITAL WAGE INDEX DATA,COST ALLOCATION,APPORTIONMENT OF INPATIENT/OUTPATIENT ANCILLARY SERVICE OTHER PASS THROUGH COSTS,BALANCE SHEET,TRIAL BALANCE OF EXPENSE ACCOUNTS,TRIAL BALANCE OF EXPENSE ACCOUNTS,TRIAL BALANCE OF EXPENSE ACCOUNTS,,ALLOCATION OF NEW CAPITAL COSTS,INPATIENT ANCILLARY SERVICE COST APPORTIONMENT,TRIAL BALANCE OF EXPENSE ACCOUNTS,HOSPITAL IDENTIFICATION INFORMATION,COST ALLOCATION,Total Inpatient Days/Outpatient Visits,INPATIENT ANCILLARY SERVICE COST APPORTIONMENT,,APPORTIONMENT OF MEDICAL AND OTHER HEALTH SERVICES,APPORTIONMENT OF MEDICAL AND OTHER HEALTH SERVICES,COST ALLOCATION,COST ALLOCATION,Total Inpatient Days/Outpatient Visits,TRIAL BALANCE OF EXPENSE ACCOUNTS,TRIAL BALANCE OF EXPENSE ACCOUNTS,INPATIENT ANCILLARY SERVICE COST APPORTIONMENT,COMPUTATION OF RATIO OF COST TO CHARGES,HOSPITAL WAGE INDEX DATA,HOSPITAL WAGE INDEX DATA,INPATIENT ANCILLARY SERVICE COST APPORTIONMENT,INPATIENT ANCILLARY SERVICE COST APPORTIONMENT,HOSPITAL WAGE INDEX DATA,HHA STATISTICAL DATA,APPORTIONMENT OF INPATIENT/OUTPATIENT ANCILLARY SERVICE OTHER PASS THROUGH COSTS,COMPUTATION OF RATIO OF COST TO CHARGES,APPORTIONMENT OF MEDICAL AND OTHER HEALTH SERVICES,Total Inpatient Days/Outpatient Visits,Total Inpatient Days/Outpatient Visits,ALLOCATION OF NEW CAPITAL COSTS,RENAL STATISTICAL DATA,APPORTIONMENT OF MEDICAL AND OTHER HEALTH SERVICES,NUMBER OF BEDS,COMPUTATION OF RATIO OF COST TO CHARGES,COST ALLOCATION,COMPUTATION OF RATIO OF COST TO CHARGES,APPORTIONMENT OF INPATIENT/OUTPATIENT ANCILLARY SERVICE OTHER PASS THROUGH COSTS,APPORTIONMENT OF INPATIENT/OUTPATIENT ANCILLARY SERVICE OTHER PASS THROUGH COSTS,Total Inpatient Days/Outpatient Visits,APPORTIONMENT OF INPATIENT/OUTPATIENT ANCILLARY SERVICE OTHER PASS THROUGH COSTS,ADJUSTMENTS,COST ALLOCATION,Medicare Inpatient Days/Outpatient Visits,INPATIENT ANCILLARY SERVICE COST APPORTIONMENT,HOSPITAL WAGE INDEX DATA,HOSPITAL WAGE INDEX DATA,INPATIENT ANCILLARY SERVICE COST APPORTIONMENT,TRIAL BALANCE OF EXPENSE ACCOUNTS,COST ALLOCATION,INPATIENT ANCILLARY SERVICE COST APPORTIONMENT,HOSPITAL WAGE INDEX DATA,APPORTIONMENT OF MEDICAL AND OTHER HEALTH SERVICES,HOSPITAL WAGE INDEX DATA,ADJUSTMENTS,APPORTIONMENT OF MEDICAL AND OTHER HEALTH SERVICES,COST ALLOCATION,HOSPITAL WAGE INDEX DATA,HOSPITAL WAGE INDEX DATA,ALLOCATION OF NEW CAPITAL COSTS,INPATIENT ANCILLARY SERVICE COST APPORTIONMENT,Total Inpatient Days/Outpatient Visits,TRIAL BALANCE OF EXPENSE ACCOUNTS,,COST ALLOCATION,COMPUTATION OF RATIO OF COST TO CHARGES,APPORTIONMENT OF MEDICAL AND OTHER HEALTH SERVICES,RENAL STATISTICAL DATA,APPORTIONMENT OF INPATIENT ROUTINE SERVICE OTHER PASS THROUGH COSTS,APPORTIONMENT OF INPATIENT/OUTPATIENT ANCILLARY SERVICE OTHER PASS THROUGH COSTS,TRIAL BALANCE OF EXPENSE ACCOUNTS,TRIAL BALANCE OF EXPENSE ACCOUNTS,APPORTIONMENT OF MEDICAL AND OTHER HEALTH SERVICES,COMPUTATION OF RATIO OF COST TO CHARGES,APPORTIONMENT OF INPATIENT/OUTPATIENT ANCILLARY SERVICE OTHER PASS THROUGH COSTS,TRIAL BALANCE OF EXPENSE ACCOUNTS,APPORTIONMENT OF INPATIENT/OUTPATIENT ANCILLARY SERVICE OTHER PASS THROUGH COSTS,COMPUTATION OF RATIO OF COST TO CHARGES,APPORTIONMENT OF INPATIENT/OUTPATIENT ANCILLARY SERVICE OTHER PASS THROUGH COSTS,TRIAL BALANCE OF EXPENSE ACCOUNTS,BED DAYS AVAILABLE,TRIAL BALANCE OF EXPENSE ACCOUNTS,COST ALLOCATION,ANALYSIS OF CHANGES IN NEW CAPITAL BALANCES,TRIAL BALANCE OF EXPENSE ACCOUNTS,COST ALLOCATION,TRIAL BALANCE OF EXPENSE ACCOUNTS,INPATIENT ANCILLARY SERVICE COST APPORTIONMENT,APPORTIONMENT OF MEDICAL AND OTHER HEALTH SERVICES,HOSPITAL WAGE INDEX DATA,APPORTIONMENT OF INPATIENT/OUTPATIENT ANCILLARY SERVICE OTHER PASS THROUGH COSTS,INPATIENT ANCILLARY SERVICE COST APPORTIONMENT,,COST ALLOCATION,S-10 DATA,INPATIENT ANCILLARY SERVICE COST APPORTIONMENT,APPORTIONMENT OF MEDICAL AND OTHER HEALTH SERVICES,APPORTIONMENT OF INPATIENT ROUTINE SERVICE CAPITAL COSTS,INPATIENT ANCILLARY SERVICE COST APPORTIONMENT,APPORTIONMENT OF INPATIENT/OUTPATIENT ANCILLARY SERVICE OTHER PASS THROUGH COSTS,HOSPITAL IDENTIFICATION INFORMATION,BED DAYS AVAILABLE,ALLOCATION OF NEW CAPITAL COSTS,APPORTIONMENT OF INPATIENT/OUTPATIENT ANCILLARY SERVICE OTHER PASS THROUGH COSTS,APPORTIONMENT OF INPATIENT/OUTPATIENT ANCILLARY SERVICE OTHER PASS THROUGH COSTS,S-10 DATA,ALLOCATION OF NEW CAPITAL COSTS,Total Inpatient Days/Outpatient Visits,APPORTIONMENT OF MEDICAL AND OTHER HEALTH SERVICES,COMPUTATION OF INPATIENT OPERATING COSTS,COST ALLOCATION,COMPUTATION OF RATIO OF COST TO CHARGES,APPORTIONMENT OF INPATIENT ROUTINE SERVICE CAPITAL COSTS,APPORTIONMENT OF MEDICAL AND OTHER HEALTH SERVICES,INPATIENT ANCILLARY SERVICE COST APPORTIONMENT,HOSPITAL WAGE INDEX DATA,TRIAL BALANCE OF EXPENSE ACCOUNTS,COMPUTATION OF RATIO OF COST TO CHARGES,HHA STATISTICAL DATA,COMPUTATION OF RATIO OF COST TO CHARGES,APPORTIONMENT OF INPATIENT/OUTPATIENT ANCILLARY SERVICE OTHER PASS THROUGH COSTS,APPORTIONMENT OF MEDICAL AND OTHER HEALTH SERVICES,HOSPITAL WAGE INDEX DATA,INPATIENT ANCILLARY SERVICE COST APPORTIONMENT,APPORTIONMENT OF INPATIENT ROUTINE SERVICE CAPITAL COSTS,TRIAL BALANCE OF EXPENSE ACCOUNTS,TRIAL BALANCE OF EXPENSE ACCOUNTS,Total Inpatient Days/Outpatient Visits,HOSPITAL WAGE INDEX DATA,COST ALLOCATION,CALCULATION OF REIMBURSEMENT SETTLEMENT (PPS),COMPUTATION OF INPATIENT OPERATING COSTS,Medicaid Inpatient Days/Outpatient Visits,INPATIENT ANCILLARY SERVICE COST APPORTIONMENT,TRIAL BALANCE OF EXPENSE ACCOUNTS,ALLOCATION OF NEW CAPITAL COSTS,COST ALLOCATION,HOSPITAL WAGE INDEX DATA,BED DAYS AVAILABLE,HOSPITAL WAGE INDEX DATA,APPORTIONMENT OF MEDICAL AND OTHER HEALTH SERVICES,INPATIENT ANCILLARY SERVICE COST APPORTIONMENT,APPORTIONMENT OF INPATIENT/OUTPATIENT ANCILLARY SERVICE OTHER PASS THROUGH COSTS,TRIAL BALANCE OF EXPENSE ACCOUNTS,COST ALLOCATION,APPORTIONMENT OF INPATIENT/OUTPATIENT ANCILLARY SERVICE OTHER PASS THROUGH COSTS,COMPUTATION OF RATIO OF COST TO CHARGES,INPATIENT ANCILLARY SERVICE COST APPORTIONMENT,TRIAL BALANCE OF EXPENSE ACCOUNTS,INPATIENT ANCILLARY SERVICE COST APPORTIONMENT,BALANCE SHEET,NUMBER OF BEDS,ALLOCATION OF NEW CAPITAL COSTS,HOSPITAL WAGE INDEX DATA,COMPUTATION OF INPATIENT OPERATING COSTS,INPATIENT ANCILLARY SERVICE COST APPORTIONMENT,ANALYSIS OF CHANGES IN NEW CAPITAL BALANCES,INPATIENT ANCILLARY SERVICE COST APPORTIONMENT,TRIAL BALANCE OF EXPENSE ACCOUNTS,HOSPITAL WAGE INDEX DATA,COMPUTATION OF RATIO OF COST TO CHARGES,APPORTIONMENT OF INPATIENT/OUTPATIENT ANCILLARY SERVICE OTHER PASS THROUGH COSTS,Total Inpatient Days/Outpatient Visits,ADJUSTMENTS,APPORTIONMENT OF MEDICAL AND OTHER HEALTH SERVICES,APPORTIONMENT OF MEDICAL AND OTHER HEALTH SERVICES,COMPUTATION OF INPATIENT OPERATING COSTS,INPATIENT ANCILLARY SERVICE COST APPORTIONMENT,CALCULATION OF REIMBURSEMENT SETTLEMENT,CALCULATION OF REIMBURSEMENT SETTLEMENT,HOSPITAL WAGE INDEX DATA,INPATIENT ANCILLARY SERVICE COST APPORTIONMENT,RECONCILIATION OF CAPITAL COST CENTERS,TRIAL BALANCE OF EXPENSE ACCOUNTS,BALANCE SHEET,HOSPITAL WAGE INDEX DATA,HHA STATISTICAL DATA,COST ALLOCATION,INPATIENT ANCILLARY SERVICE COST APPORTIONMENT,S-10 DATA,COST ALLOCATION,RECONCILIATION OF CAPITAL COST CENTERS,COMPUTATION OF RATIO OF COST TO CHARGES,NUMBER OF BEDS,ANALYSIS OF CHANGES IN NEW CAPITAL BALANCES,APPORTIONMENT OF INPATIENT/OUTPATIENT ANCILLARY SERVICE OTHER PASS THROUGH COSTS,TRIAL BALANCE OF EXPENSE ACCOUNTS,COST ALLOCATION,TRIAL BALANCE OF EXPENSE ACCOUNTS,ALLOCATION OF NEW CAPITAL COSTS,TRIAL BALANCE OF EXPENSE ACCOUNTS,APPORTIONMENT OF INPATIENT/OUTPATIENT ANCILLARY SERVICE OTHER PASS THROUGH COSTS,HOSPITAL WAGE INDEX DATA,TRIAL BALANCE OF EXPENSE ACCOUNTS,RENAL STATISTICAL DATA,COST ALLOCATION,INPATIENT ANCILLARY SERVICE COST APPORTIONMENT,APPORTIONMENT OF MEDICAL AND OTHER HEALTH SERVICES,ANALYSIS OF CHANGES IN NEW CAPITAL BALANCES,TRIAL BALANCE OF EXPENSE ACCOUNTS,,ANALYSIS OF CHANGES IN NEW CAPITAL BALANCES,ALLOCATION OF NEW CAPITAL COSTS,COMPUTATION OF INPATIENT OPERATING COSTS,S-10 DATA,,HOSPITAL WAGE INDEX DATA,APPORTIONMENT OF MEDICAL AND OTHER HEALTH SERVICES,,TRIAL BALANCE OF EXPENSE ACCOUNTS,COST ALLOCATION,APPORTIONMENT OF INPATIENT/OUTPATIENT ANCILLARY SERVICE OTHER PASS THROUGH COSTS,APPORTIONMENT OF INPATIENT ROUTINE SERVICE CAPITAL COSTS,INPATIENT ANCILLARY SERVICE COST APPORTIONMENT,BED DAYS AVAILABLE,INPATIENT ANCILLARY SERVICE COST APPORTIONMENT,HOSPITAL WAGE INDEX DATA,HOSPITAL WAGE INDEX DATA,INPATIENT ANCILLARY SERVICE COST APPORTIONMENT,TRIAL BALANCE OF EXPENSE ACCOUNTS,Total Inpatient Days/Outpatient Visits,HOSPITAL WAGE INDEX DATA,ANALYSIS OF CHANGES IN NEW CAPITAL BALANCES,APPORTIONMENT OF INPATIENT ROUTINE SERVICE OTHER PASS THROUGH COSTS,HHA STATISTICAL DATA,ANALYSIS OF CHANGES IN NEW CAPITAL BALANCES,ANALYSIS OF CHANGES IN NEW CAPITAL BALANCES,APPORTIONMENT OF INPATIENT/OUTPATIENT ANCILLARY SERVICE OTHER PASS THROUGH COSTS,HHA STATISTICAL DATA,TRIAL BALANCE OF EXPENSE ACCOUNTS,Total Inpatient Days/Outpatient Visits,APPORTIONMENT OF MEDICAL AND OTHER HEALTH SERVICES,TRIAL BALANCE OF EXPENSE ACCOUNTS,COST ALLOCATION,COST ALLOCATION,TRIAL BALANCE OF EXPENSE ACCOUNTS,APPORTIONMENT OF INPATIENT/OUTPATIENT ANCILLARY SERVICE OTHER PASS THROUGH COSTS,RENAL STATISTICAL DATA,INPATIENT ANCILLARY SERVICE COST APPORTIONMENT,,HOSPITAL WAGE INDEX DATA,Total Inpatient Days/Outpatient Visits,Total Inpatient Days/Outpatient Visits,COST ALLOCATION,Medicare Inpatient Days/Outpatient Visits,INPATIENT ANCILLARY SERVICE COST APPORTIONMENT,COST ALLOCATION,ALLOCATION OF NEW CAPITAL COSTS,ANALYSIS OF CHANGES IN NEW CAPITAL BALANCES,TRIAL BALANCE OF EXPENSE ACCOUNTS,HHA STATISTICAL DATA,HHA STATISTICAL DATA,INPATIENT ANCILLARY SERVICE COST APPORTIONMENT,S-10 DATA,INPATIENT ANCILLARY SERVICE COST APPORTIONMENT,HHA STATISTICAL DATA,COMPUTATION OF RATIO OF COST TO CHARGES,COMPUTATION OF RATIO OF COST TO CHARGES,COST ALLOCATION,RECONCILIATION OF CAPITAL COST CENTERS,,BALANCE SHEET,COST ALLOCATION,COST ALLOCATION,APPORTIONMENT OF INPATIENT/OUTPATIENT ANCILLARY SERVICE OTHER PASS THROUGH COSTS,HHA STATISTICAL DATA,ALLOCATION OF NEW CAPITAL COSTS,APPORTIONMENT OF INPATIENT/OUTPATIENT ANCILLARY SERVICE OTHER PASS THROUGH COSTS,HOSPITAL WAGE INDEX DATA,APPORTIONMENT OF INPATIENT/OUTPATIENT ANCILLARY SERVICE OTHER PASS THROUGH COSTS,RENAL STATISTICAL DATA,BED DAYS AVAILABLE,HHA STATISTICAL DATA,ANALYSIS OF CHANGES IN NEW CAPITAL BALANCES,ALLOCATION OF NEW CAPITAL COSTS,TRIAL BALANCE OF EXPENSE ACCOUNTS,COST ALLOCATION,APPORTIONMENT OF INPATIENT/OUTPATIENT ANCILLARY SERVICE OTHER PASS THROUGH COSTS,APPORTIONMENT OF INPATIENT/OUTPATIENT ANCILLARY SERVICE OTHER PASS THROUGH COSTS,TRIAL BALANCE OF EXPENSE ACCOUNTS,,,TRIAL BALANCE OF EXPENSE ACCOUNTS,ALLOCATION OF NEW CAPITAL COSTS,HHA STATISTICAL DATA,CALCULATION OF REIMBURSEMENT SETTLEMENT,,INPATIENT ANCILLARY SERVICE COST APPORTIONMENT,STATEMENT OF REVENUES AND EXPENSES,COMPUTATION OF RATIO OF COST TO CHARGES,COST ALLOCATION,S-10 DATA,COMPUTATION OF RATIO OF COST TO CHARGES,ALLOCATION OF NEW CAPITAL COSTS,APPORTIONMENT OF MEDICAL AND OTHER HEALTH SERVICES,APPORTIONMENT OF MEDICAL AND OTHER HEALTH SERVICES,INPATIENT ANCILLARY SERVICE COST APPORTIONMENT,INPATIENT ANCILLARY SERVICE COST APPORTIONMENT,COST ALLOCATION,COST ALLOCATION,RECONCILIATION OF CAPITAL COST CENTERS,APPORTIONMENT OF INPATIENT/OUTPATIENT ANCILLARY SERVICE OTHER PASS THROUGH COSTS,COST ALLOCATION,ALLOCATION OF NEW CAPITAL COSTS,APPORTIONMENT OF INPATIENT/OUTPATIENT ANCILLARY SERVICE OTHER PASS THROUGH COSTS,TRIAL BALANCE OF EXPENSE ACCOUNTS,APPORTIONMENT OF INPATIENT/OUTPATIENT ANCILLARY SERVICE OTHER PASS THROUGH COSTS,CALCULATION OF REIMBURSEMENT SETTLEMENT,ALLOCATION OF NEW CAPITAL COSTS,RENAL STATISTICAL DATA,HHA STATISTICAL DATA,APPORTIONMENT OF MEDICAL AND OTHER HEALTH SERVICES,HHA STATISTICAL DATA,COMPUTATION OF RATIO OF COST TO CHARGES,CALCULATION OF REIMBURSEMENT SETTLEMENT,HOSPITAL WAGE INDEX DATA,HOSPITAL WAGE INDEX DATA,INPATIENT ANCILLARY SERVICE COST APPORTIONMENT,COST ALLOCATION,BED DAYS AVAILABLE,APPORTIONMENT OF INPATIENT ROUTINE SERVICE CAPITAL COSTS,APPORTIONMENT OF INPATIENT/OUTPATIENT ANCILLARY SERVICE OTHER PASS THROUGH COSTS,COMPUTATION OF RATIO OF COST TO CHARGES,COST ALLOCATION,TRIAL BALANCE OF EXPENSE ACCOUNTS,HOSPITAL WAGE INDEX DATA,INPATIENT ANCILLARY SERVICE COST APPORTIONMENT,TRIAL BALANCE OF EXPENSE ACCOUNTS,APPORTIONMENT OF INPATIENT/OUTPATIENT ANCILLARY SERVICE OTHER PASS THROUGH COSTS,APPORTIONMENT OF MEDICAL AND OTHER HEALTH SERVICES,HOSPITAL WAGE INDEX DATA,APPORTIONMENT OF INPATIENT/OUTPATIENT ANCILLARY SERVICE OTHER PASS THROUGH COSTS,APPORTIONMENT OF MEDICAL AND OTHER HEALTH SERVICES,HOSPITAL WAGE INDEX DATA,TRIAL BALANCE OF EXPENSE ACCOUNTS,APPORTIONMENT OF INPATIENT/OUTPATIENT ANCILLARY SERVICE OTHER PASS THROUGH COSTS,ALLOCATION OF NEW CAPITAL COSTS,COMPUTATION OF INPATIENT OPERATING COSTS,TRIAL BALANCE OF EXPENSE ACCOUNTS,COST ALLOCATION,INPATIENT ANCILLARY SERVICE COST APPORTIONMENT,APPORTIONMENT OF INPATIENT/OUTPATIENT ANCILLARY SERVICE OTHER PASS THROUGH COSTS,INPATIENT ANCILLARY SERVICE COST APPORTIONMENT,APPORTIONMENT OF MEDICAL AND OTHER HEALTH SERVICES,APPORTIONMENT OF MEDICAL AND OTHER HEALTH SERVICES,HHA STATISTICAL DATA,TRIAL BALANCE OF EXPENSE ACCOUNTS,INPATIENT ANCILLARY SERVICE COST APPORTIONMENT,APPORTIONMENT OF INPATIENT ROUTINE SERVICE CAPITAL COSTS,COST ALLOCATION,HHA STATISTICAL DATA,HOSPITAL WAGE INDEX DATA,TRIAL BALANCE OF EXPENSE ACCOUNTS,APPORTIONMENT OF MEDICAL AND OTHER HEALTH SERVICES,APPORTIONMENT OF INPATIENT/OUTPATIENT ANCILLARY SERVICE OTHER PASS THROUGH COSTS,COST ALLOCATION,,COMPUTATION OF RATIO OF COST TO CHARGES,APPORTIONMENT OF INPATIENT ROUTINE SERVICE OTHER PASS THROUGH COSTS,APPORTIONMENT OF INPATIENT/OUTPATIENT ANCILLARY SERVICE OTHER PASS THROUGH COSTS,HOSPITAL WAGE INDEX DATA,Medicare Inpatient Days/Outpatient Visits,ALLOCATION OF NEW CAPITAL COSTS,HOSPITAL WAGE INDEX DATA,,APPORTIONMENT OF MEDICAL AND OTHER HEALTH SERVICES,APPORTIONMENT OF INPATIENT/OUTPATIENT ANCILLARY SERVICE OTHER PASS THROUGH COSTS,APPORTIONMENT OF MEDICAL AND OTHER HEALTH SERVICES,CALCULATION OF REIMBURSEMENT SETTLEMENT,COST ALLOCATION,COMPUTATION OF RATIO OF COST TO CHARGES,Total Inpatient Days/Outpatient Visits,APPORTIONMENT OF INPATIENT/OUTPATIENT ANCILLARY SERVICE OTHER PASS THROUGH COSTS,CALCULATION OF REIMBURSEMENT SETTLEMENT,HOSPITAL WAGE INDEX DATA,TRIAL BALANCE OF EXPENSE ACCOUNTS,INPATIENT ANCILLARY SERVICE COST APPORTIONMENT,Medicare Inpatient Days/Outpatient Visits,HHA STATISTICAL DATA,HOSPITAL WAGE INDEX DATA,HOSPITAL WAGE INDEX DATA,COMPUTATION OF RATIO OF COST TO CHARGES,APPORTIONMENT OF INPATIENT/OUTPATIENT ANCILLARY SERVICE OTHER PASS THROUGH COSTS,TRIAL BALANCE OF EXPENSE ACCOUNTS,TRIAL BALANCE OF EXPENSE ACCOUNTS,COMPUTATION OF RATIO OF COST TO CHARGES,,HOSPITAL WAGE INDEX DATA,APPORTIONMENT OF INPATIENT/OUTPATIENT ANCILLARY SERVICE OTHER PASS THROUGH COSTS,,Medicare Inpatient Days/Outpatient Visits,INPATIENT ANCILLARY SERVICE COST APPORTIONMENT,TRIAL BALANCE OF EXPENSE ACCOUNTS,COMPUTATION OF RATIO OF COST TO CHARGES,TRIAL BALANCE OF EXPENSE ACCOUNTS,Medicare Inpatient Days/Outpatient Visits,HHA STATISTICAL DATA,COST ALLOCATION,APPORTIONMENT OF INPATIENT/OUTPATIENT ANCILLARY SERVICE OTHER PASS THROUGH COSTS,APPORTIONMENT OF MEDICAL AND OTHER HEALTH SERVICES,HHA STATISTICAL DATA,TRIAL BALANCE OF EXPENSE ACCOUNTS,TRIAL BALANCE OF EXPENSE ACCOUNTS,INPATIENT ANCILLARY SERVICE COST APPORTIONMENT,INPATIENT ANCILLARY SERVICE COST APPORTIONMENT,COST ALLOCATION,COMPUTATION OF INPATIENT OPERATING COSTS,,TRIAL BALANCE OF EXPENSE ACCOUNTS,COST ALLOCATION,TRIAL BALANCE OF EXPENSE ACCOUNTS,HOSPITAL WAGE INDEX DATA,STATEMENT OF PATIENT REVENUES AND OPERATING EXPENSES,COMPUTATION OF INPATIENT OPERATING COSTS,INPATIENT ANCILLARY SERVICE COST APPORTIONMENT,,HOSPITAL WAGE INDEX DATA,COMPUTATION OF RATIO OF COST TO CHARGES,COMPUTATION OF RATIO OF COST TO CHARGES,HHA STATISTICAL DATA,COMPUTATION OF RATIO OF COST TO CHARGES,COMPUTATION OF RATIO OF COST TO CHARGES,APPORTIONMENT OF INPATIENT/OUTPATIENT ANCILLARY SERVICE OTHER PASS THROUGH COSTS,TRIAL BALANCE OF EXPENSE ACCOUNTS,APPORTIONMENT OF INPATIENT/OUTPATIENT ANCILLARY SERVICE OTHER PASS THROUGH COSTS,APPORTIONMENT OF MEDICAL AND OTHER HEALTH SERVICES,APPORTIONMENT OF MEDICAL AND OTHER HEALTH SERVICES,APPORTIONMENT OF MEDICAL AND OTHER HEALTH SERVICES,,COST ALLOCATION,HOSPITAL WAGE INDEX DATA,APPORTIONMENT OF MEDICAL AND OTHER HEALTH SERVICES,INPATIENT ANCILLARY SERVICE COST APPORTIONMENT,HOSPITAL WAGE INDEX DATA,COST ALLOCATION,APPORTIONMENT OF MEDICAL AND OTHER HEALTH SERVICES,APPORTIONMENT OF INPATIENT/OUTPATIENT ANCILLARY SERVICE OTHER PASS THROUGH COSTS,APPORTIONMENT OF INPATIENT/OUTPATIENT ANCILLARY SERVICE OTHER PASS THROUGH COSTS,Total Inpatient Days/Outpatient Visits,COST ALLOCATION,COMPUTATION OF INPATIENT OPERATING COSTS,APPORTIONMENT OF INPATIENT/OUTPATIENT ANCILLARY SERVICE OTHER PASS THROUGH COSTS,APPORTIONMENT OF MEDICAL AND OTHER HEALTH SERVICES,APPORTIONMENT OF INPATIENT/OUTPATIENT ANCILLARY SERVICE OTHER PASS THROUGH COSTS,COMPUTATION OF RATIO OF COST TO CHARGES,INPATIENT ANCILLARY SERVICE COST APPORTIONMENT,HOSPITAL WAGE INDEX DATA,TRIAL BALANCE OF EXPENSE ACCOUNTS,TRIAL BALANCE OF EXPENSE ACCOUNTS,HOSPITAL WAGE INDEX DATA,APPORTIONMENT OF INPATIENT/OUTPATIENT ANCILLARY SERVICE OTHER PASS THROUGH COSTS,COMPUTATION OF INPATIENT OPERATING COSTS,APPORTIONMENT OF INPATIENT ROUTINE SERVICE CAPITAL COSTS,APPORTIONMENT OF INPATIENT/OUTPATIENT ANCILLARY SERVICE OTHER PASS THROUGH COSTS,APPORTIONMENT OF INPATIENT ROUTINE SERVICE CAPITAL COSTS,INPATIENT ANCILLARY SERVICE COST APPORTIONMENT,TRIAL BALANCE OF EXPENSE ACCOUNTS,APPORTIONMENT OF MEDICAL AND OTHER HEALTH SERVICES,COST ALLOCATION,APPORTIONMENT OF MEDICAL AND OTHER HEALTH SERVICES,COMPUTATION OF RATIO OF COST TO CHARGES,HOSPITAL WAGE INDEX DATA,HOSPITAL WAGE INDEX DATA,BALANCE SHEET,TRIAL BALANCE OF EXPENSE ACCOUNTS,COST ALLOCATION,APPORTIONMENT OF MEDICAL AND OTHER HEALTH SERVICES,HOSPITAL WAGE INDEX DATA,COST ALLOCATION,APPORTIONMENT OF INPATIENT/OUTPATIENT ANCILLARY SERVICE OTHER PASS THROUGH COSTS,APPORTIONMENT OF MEDICAL AND OTHER HEALTH SERVICES,APPORTIONMENT OF INPATIENT/OUTPATIENT ANCILLARY SERVICE OTHER PASS THROUGH COSTS,TRIAL BALANCE OF EXPENSE ACCOUNTS,INPATIENT ANCILLARY SERVICE COST APPORTIONMENT,BALANCE SHEET,Total Inpatient Days/Outpatient Visits,APPORTIONMENT OF INPATIENT/OUTPATIENT ANCILLARY SERVICE OTHER PASS THROUGH COSTS,Medicare Inpatient Days/Outpatient Visits,HOSPITAL WAGE INDEX DATA,COST ALLOCATION,COMPUTATION OF RATIO OF COST TO CHARGES,APPORTIONMENT OF MEDICAL AND OTHER HEALTH SERVICES,COMPUTATION OF INPATIENT OPERATING COSTS,Medicaid Inpatient Days/Outpatient Visits,TRIAL BALANCE OF EXPENSE ACCOUNTS,COST ALLOCATION,APPORTIONMENT OF INPATIENT/OUTPATIENT ANCILLARY SERVICE OTHER PASS THROUGH COSTS,RENAL STATISTICAL DATA,COST ALLOCATION,Medicaid Inpatient Days/Outpatient Visits,APPORTIONMENT OF INPATIENT/OUTPATIENT ANCILLARY SERVICE OTHER PASS THROUGH COSTS,APPORTIONMENT OF INPATIENT/OUTPATIENT ANCILLARY SERVICE OTHER PASS THROUGH COSTS,APPORTIONMENT OF INPATIENT ROUTINE SERVICE OTHER PASS THROUGH COSTS,TRIAL BALANCE OF EXPENSE ACCOUNTS,HHA STATISTICAL DATA,TRIAL BALANCE OF EXPENSE ACCOUNTS,COST ALLOCATION,HOSPITAL WAGE INDEX DATA,TRIAL BALANCE OF EXPENSE ACCOUNTS,RENAL STATISTICAL DATA,,APPORTIONMENT OF INPATIENT/OUTPATIENT ANCILLARY SERVICE OTHER PASS THROUGH COSTS,COST ALLOCATION,TRIAL BALANCE OF EXPENSE ACCOUNTS,INPATIENT ANCILLARY SERVICE COST APPORTIONMENT,ANALYSIS OF CHANGES IN NEW CAPITAL BALANCES,APPORTIONMENT OF INPATIENT/OUTPATIENT ANCILLARY SERVICE OTHER PASS THROUGH COSTS,TRIAL BALANCE OF EXPENSE ACCOUNTS,CALCULATION OF REIMBURSEMENT SETTLEMENT,Medicaid Inpatient Days/Outpatient Visits,APPORTIONMENT OF MEDICAL AND OTHER HEALTH SERVICES,COMPUTATION OF RATIO OF COST TO CHARGES,RENAL STATISTICAL DATA,HOSPITAL WAGE INDEX DATA,S-10 DATA,BALANCE SHEET,HOSPITAL WAGE INDEX DATA,COST ALLOCATION,HHA STATISTICAL DATA,INPATIENT ANCILLARY SERVICE COST APPORTIONMENT,COST ALLOCATION,COMPUTATION OF INPATIENT OPERATING COSTS,COST ALLOCATION,INPATIENT ANCILLARY SERVICE COST APPORTIONMENT,INPATIENT ANCILLARY SERVICE COST APPORTIONMENT,CALCULATION OF REIMBURSEMENT SETTLEMENT,ANALYSIS OF CHANGES IN NEW CAPITAL BALANCES,,RENAL STATISTICAL DATA,COMPUTATION OF RATIO OF COST TO CHARGES,COST ALLOCATION,TRIAL BALANCE OF EXPENSE ACCOUNTS,,TRIAL BALANCE OF EXPENSE ACCOUNTS,COST ALLOCATION,COST ALLOCATION,APPORTIONMENT OF MEDICAL AND OTHER HEALTH SERVICES,CALCULATION OF REIMBURSEMENT SETTLEMENT,INPATIENT ANCILLARY SERVICE COST APPORTIONMENT,CALCULATION OF REIMBURSEMENT SETTLEMENT,Total Inpatient Days/Outpatient Visits,APPORTIONMENT OF MEDICAL AND OTHER HEALTH SERVICES,BALANCE SHEET,APPORTIONMENT OF MEDICAL AND OTHER HEALTH SERVICES,TRIAL BALANCE OF EXPENSE ACCOUNTS,TRIAL BALANCE OF EXPENSE ACCOUNTS,APPORTIONMENT OF INPATIENT/OUTPATIENT ANCILLARY SERVICE OTHER PASS THROUGH COSTS,HOSPITAL WAGE INDEX DATA,ANALYSIS OF CHANGES IN NEW CAPITAL BALANCES,APPORTIONMENT OF INPATIENT/OUTPATIENT ANCILLARY SERVICE OTHER PASS THROUGH COSTS,APPORTIONMENT OF INPATIENT/OUTPATIENT ANCILLARY SERVICE OTHER PASS THROUGH COSTS,COST ALLOCATION,HOSPITAL WAGE INDEX DATA,HHA STATISTICAL DATA,TRIAL BALANCE OF EXPENSE ACCOUNTS,INPATIENT ANCILLARY SERVICE COST APPORTIONMENT,APPORTIONMENT OF INPATIENT/OUTPATIENT ANCILLARY SERVICE OTHER PASS THROUGH COSTS,APPORTIONMENT OF MEDICAL AND OTHER HEALTH SERVICES,APPORTIONMENT OF INPATIENT/OUTPATIENT ANCILLARY SERVICE OTHER PASS THROUGH COSTS,COMPUTATION OF RATIO OF COST TO CHARGES,HOSPITAL WAGE INDEX DATA,INPATIENT ANCILLARY SERVICE COST APPORTIONMENT,TRIAL BALANCE OF EXPENSE ACCOUNTS,TRIAL BALANCE OF EXPENSE ACCOUNTS,APPORTIONMENT OF INPATIENT/OUTPATIENT ANCILLARY SERVICE OTHER PASS THROUGH COSTS,COMPUTATION OF RATIO OF COST TO CHARGES,Total Inpatient Days/Outpatient Visits,HOSPITAL WAGE INDEX DATA,COST ALLOCATION,COMPUTATION OF INPATIENT OPERATING COSTS,INPATIENT ANCILLARY SERVICE COST APPORTIONMENT,COST ALLOCATION,INPATIENT ANCILLARY SERVICE COST APPORTIONMENT,INPATIENT ANCILLARY SERVICE COST APPORTIONMENT,COST ALLOCATION,APPORTIONMENT OF INPATIENT/OUTPATIENT ANCILLARY SERVICE OTHER PASS THROUGH COSTS,APPORTIONMENT OF MEDICAL AND OTHER HEALTH SERVICES,INPATIENT ANCILLARY SERVICE COST APPORTIONMENT,INPATIENT ANCILLARY SERVICE COST APPORTIONMENT,,,APPORTIONMENT OF INPATIENT/OUTPATIENT ANCILLARY SERVICE OTHER PASS THROUGH COSTS,APPORTIONMENT OF MEDICAL AND OTHER HEALTH SERVICES,COST ALLOCATION,HOSPITAL WAGE INDEX DATA,S-10 DATA,TRIAL BALANCE OF EXPENSE ACCOUNTS,TRIAL BALANCE OF EXPENSE ACCOUNTS,CALCULATION OF REIMBURSEMENT SETTLEMENT (PPS),CALCULATION OF REIMBURSEMENT SETTLEMENT,TRIAL BALANCE OF EXPENSE ACCOUNTS,ALLOCATION OF NEW CAPITAL COSTS,APPORTIONMENT OF INPATIENT/OUTPATIENT ANCILLARY SERVICE OTHER PASS THROUGH COSTS,HOSPITAL WAGE INDEX DATA,HHA STATISTICAL DATA,,HHA STATISTICAL DATA,Total Inpatient Days/Outpatient Visits,RECONCILIATION OF CAPITAL COST CENTERS,APPORTIONMENT OF INPATIENT/OUTPATIENT ANCILLARY SERVICE OTHER PASS THROUGH COSTS,RENAL STATISTICAL DATA,COST ALLOCATION,COST ALLOCATION,STATEMENT OF REVENUES AND EXPENSES,APPORTIONMENT OF INPATIENT/OUTPATIENT ANCILLARY SERVICE OTHER PASS THROUGH COSTS,APPORTIONMENT OF MEDICAL AND OTHER HEALTH SERVICES,COST ALLOCATION,APPORTIONMENT OF MEDICAL AND OTHER HEALTH SERVICES,APPORTIONMENT OF INPATIENT/OUTPATIENT ANCILLARY SERVICE OTHER PASS THROUGH COSTS,APPORTIONMENT OF INPATIENT/OUTPATIENT ANCILLARY SERVICE OTHER PASS THROUGH COSTS,,BALANCE SHEET,NUMBER OF BEDS,HOSPITAL WAGE INDEX DATA,INPATIENT ANCILLARY SERVICE COST APPORTIONMENT,INPATIENT ANCILLARY SERVICE COST APPORTIONMENT,APPORTIONMENT OF INPATIENT/OUTPATIENT ANCILLARY SERVICE OTHER PASS THROUGH COSTS,INPATIENT ANCILLARY SERVICE COST APPORTIONMENT,ALLOCATION OF NEW CAPITAL COSTS,BALANCE SHEET,APPORTIONMENT OF MEDICAL AND OTHER HEALTH SERVICES,APPORTIONMENT OF MEDICAL AND OTHER HEALTH SERVICES,COMPUTATION OF RATIO OF COST TO CHARGES,INPATIENT ANCILLARY SERVICE COST APPORTIONMENT,APPORTIONMENT OF INPATIENT/OUTPATIENT ANCILLARY SERVICE OTHER PASS THROUGH COSTS,APPORTIONMENT OF INPATIENT/OUTPATIENT ANCILLARY SERVICE OTHER PASS THROUGH COSTS,APPORTIONMENT OF MEDICAL AND OTHER HEALTH SERVICES,COST ALLOCATION,,TRIAL BALANCE OF EXPENSE ACCOUNTS,HOSPITAL WAGE INDEX DATA,APPORTIONMENT OF MEDICAL AND OTHER HEALTH SERVICES,CALCULATION OF REIMBURSEMENT SETTLEMENT,APPORTIONMENT OF INPATIENT/OUTPATIENT ANCILLARY SERVICE OTHER PASS THROUGH COSTS,COMPUTATION OF INPATIENT OPERATING COSTS,APPORTIONMENT OF INPATIENT/OUTPATIENT ANCILLARY SERVICE OTHER PASS THROUGH COSTS,APPORTIONMENT OF INPATIENT/OUTPATIENT ANCILLARY SERVICE OTHER PASS THROUGH COSTS,INPATIENT ANCILLARY SERVICE COST APPORTIONMENT,APPORTIONMENT OF INPATIENT/OUTPATIENT ANCILLARY SERVICE OTHER PASS THROUGH COSTS,COST ALLOCATION,APPORTIONMENT OF INPATIENT/OUTPATIENT ANCILLARY SERVICE OTHER PASS THROUGH COSTS,RENAL STATISTICAL DATA,APPORTIONMENT OF INPATIENT/OUTPATIENT ANCILLARY SERVICE OTHER PASS THROUGH COSTS,APPORTIONMENT OF MEDICAL AND OTHER HEALTH SERVICES,TRIAL BALANCE OF EXPENSE ACCOUNTS,,HOSPITAL IDENTIFICATION INFORMATION,RECONCILIATION OF CAPITAL COST CENTERS,APPORTIONMENT OF MEDICAL AND OTHER HEALTH SERVICES,COMPUTATION OF RATIO OF COST TO CHARGES,ADJUSTMENTS,APPORTIONMENT OF INPATIENT/OUTPATIENT ANCILLARY SERVICE OTHER PASS THROUGH COSTS,HOSPITAL WAGE INDEX DATA,HHA STATISTICAL DATA,APPORTIONMENT OF MEDICAL AND OTHER HEALTH SERVICES,APPORTIONMENT OF INPATIENT/OUTPATIENT ANCILLARY SERVICE OTHER PASS THROUGH COSTS,APPORTIONMENT OF MEDICAL AND OTHER HEALTH SERVICES,TRIAL BALANCE OF EXPENSE ACCOUNTS,HOSPITAL WAGE INDEX DATA,BED DAYS AVAILABLE,INPATIENT ANCILLARY SERVICE COST APPORTIONMENT,,APPORTIONMENT OF INPATIENT/OUTPATIENT ANCILLARY SERVICE OTHER PASS THROUGH COSTS,TRIAL BALANCE OF EXPENSE ACCOUNTS,INPATIENT ANCILLARY SERVICE COST APPORTIONMENT,APPORTIONMENT OF INPATIENT/OUTPATIENT ANCILLARY SERVICE OTHER PASS THROUGH COSTS,APPORTIONMENT OF MEDICAL AND OTHER HEALTH SERVICES,RENAL STATISTICAL DATA,TRIAL BALANCE OF EXPENSE ACCOUNTS,APPORTIONMENT OF INPATIENT/OUTPATIENT ANCILLARY SERVICE OTHER PASS THROUGH COSTS,INPATIENT ANCILLARY SERVICE COST APPORTIONMENT,COST ALLOCATION,HOSPITAL WAGE INDEX DATA,APPORTIONMENT OF MEDICAL AND OTHER HEALTH SERVICES,APPORTIONMENT OF MEDICAL AND OTHER HEALTH SERVICES,RENAL STATISTICAL DATA,,HHA STATISTICAL DATA,Total Inpatient Days/Outpatient Visits,APPORTIONMENT OF MEDICAL AND OTHER HEALTH SERVICES,COMPUTATION OF RATIO OF COST TO CHARGES,,COMPUTATION OF INPATIENT OPERATING COSTS,APPORTIONMENT OF INPATIENT/OUTPATIENT ANCILLARY SERVICE OTHER PASS THROUGH COSTS,APPORTIONMENT OF INPATIENT/OUTPATIENT ANCILLARY SERVICE OTHER PASS THROUGH COSTS,Total Inpatient Days/Outpatient Visits,TRIAL BALANCE OF EXPENSE ACCOUNTS,APPORTIONMENT OF MEDICAL AND OTHER HEALTH SERVICES,APPORTIONMENT OF INPATIENT/OUTPATIENT ANCILLARY SERVICE OTHER PASS THROUGH COSTS,COST ALLOCATION,APPORTIONMENT OF INPATIENT/OUTPATIENT ANCILLARY SERVICE OTHER PASS THROUGH COSTS,CALCULATION OF REIMBURSEMENT SETTLEMENT (PPS),HOSPITAL WAGE INDEX DATA,HOSPITAL WAGE INDEX DATA,APPORTIONMENT OF INPATIENT/OUTPATIENT ANCILLARY SERVICE OTHER PASS THROUGH COSTS,COST ALLOCATION,COMPUTATION OF RATIO OF COST TO CHARGES,TRIAL BALANCE OF EXPENSE ACCOUNTS,,COST ALLOCATION,APPORTIONMENT OF INPATIENT/OUTPATIENT ANCILLARY SERVICE OTHER PASS THROUGH COSTS,INPATIENT ANCILLARY SERVICE COST APPORTIONMENT,COMPUTATION OF RATIO OF COST TO CHARGES,FFY,Hospital Type (From CMS Hospitals Data Archive),Name and Num
,Curated Name and Num,Hospital type (modified),Type of Control of Hospital (See Table I) (S2_1_C1_21),Lon,Lat,Drugs Charged to Patients (D3_IPF_C2_73),Labor and Delivery Days -  Title XIX (S3_1_C8_32),Adj for Respiratory therapy costs in excess (A8_C2_23),"COST SERVICES NOT SUBJECT TO DEDUCTIBLES AND COINSURANCE - COST, Medical Supplies Charged to Patients (D_5_HOS_C7_71)","Total Program Inpatient Operating Cost excluding Capital Related, Nonphysician, Anesthetist, and Medical Education Costs (D1_IRF_C1_53)",OSP (C_1_C7_9940),Recovery Room (B_1_C26_51),NF (S3_1_C9_20),Nursing School (A8_C2_19),"COST REIMBURSED SERVICES SUBJECT TO DEDUCTIBLES  AND COINSURANCE - CHARGES, Blood Storing, Processing, Trans (D_5_HOS_C3_63)","ADJUSTED SALARIES, Excluded Area Salaries (S3_2_C4_10)",ICF (S3_1_C7_2001),"ADJUSTED SALARIES, Excluded Area Salaries (S3_3_C4_2)","Beginning Balances, Movable Equipment (A7_1_C1_6)","Net costs of Epoietin furnished to
all maintenance dialysis patients
by the provider (S5_C1_13)","Total Inpatient Charges, MRI (C_1_C6_58)",OPT (A_C1_9920),ASC (Non Distinct Part) (D_4_HOS_C3_75),"ADJUSTED SALARIES, Interns & Residents (S3_2_C4_25)",Drugs Charged to Patients (B_1_C21_73),Subprovider I (D_1_HOS_C4_42),Medical Supplies Charged to Patients (D_4_HOS_C3_71),Lung  Acquisition (A_C6_108),"Number of days in year dialysis 
furnished (S5_C2_5)",Hospital Adults & Ped Swing Bed SNF (S3_1_C6_5),Hospice (S3_1_C3_24),Subprovider 2 (S3_1_C3_1801),Surgical Intensive Care Unit (D_3_HOS_C9_34),Durable Medical Equipment Sold (D3_HOS_C2_97),Electroencephalography (D3_HOS_C3_70),CT Scan (D3_SNF_C3_57),MRI (D3_IRF_C3_58),"Fully Depreciated Assets, Assets (A7_1_C7_7)",HMO (S3_1_C6_2),Burn Intensive Care Unit (S3_1_C6_10),Renal 8 Provider Number (S2_1_C2_1807),HHA (C_1_C6_101),"Beginning Balances, Buildings and Fixtures (A7_1_C1_3)",Other Outpatient Services (B_2_C26_93),Other Ancillary (D3_IPF_C2_76),Anesthesiology (D_4_HOS_C4_53),"HHA II, LUPA:  Total Non Routine Med Sup Chgs (S4_HHA2_C3_38)",Radioisotope (D_4_HOS_C11_56),"AMOUNT REPORTED, Interns & Residents (S3_2_C2_2551)","ADJUSTED SALARIES, Interns & Residents (S3_2_C4_7)",Intravenous Therapy (A_C2_64),Other Outpatient Services (D_4_HOS_C13_93),Whole Blood & Packed Red Blood Cells (D_4_IPF_C13_62),Blood Clotting Factors for Hemoph. (D3_IRF_C3_6250),"ADJUSTED SALARIES, Contract Labor (S3_2_C4_11)","HHA II, PEP:  Total Number of Outlier Episodes (S4_HHA2_C4_37)","Blood Storing, Processing, Trans (D3_IRF_C3_63)",CMHC (B_1_C26_99),Major Movable Equipment (G_C1THRU4_23),Total cost (E_B_HOS_C1_11),Drugs Charged to Patients (D_4_HOS_C12_73),Respiratory Therapy (C_1_C2_65),CT Scan (D_4_HOS_C3_57),RHC 2 Provider Number (S2_1_C2_1501),Physical Therapy (D_4_HOS_C2_66),Total (D_3_HOS_C9_200),ICF (S3_1_C3_2001),Nonpaid Workers (B_1_C22_193),Liver Acquisition (A_C1_107),Physicians' Private Office (A_C2_192),Anesthesiology (B_1_C26_53),"Allocation of Interns & Residents Program Costs, MRI (B_1_C22_58)",Electroencephalography (D_4_HOS_C13_70),"PPS SERVICES COST, Durable Medical Equipment Rented (D_5_HOS_C5_96)",Emergency (D_4_HOS_C12_91),Cross Foot Adjustments (B_1_C26_200),Hospice (S3_1_C10_24),"COST REIMBURSED SERVICES SUBJECT TO DEDUCTIBLES  AND COINSURANCE - CHARGES, Speech Pathology (D_5_HOS_C3_68)",Renal 9 Provider Number (S2_1_C2_1808),Physical Therapy (D3_HOS_C2_66),"COST SERVICES SUBJECT TO DEDUCTIBLES AND COINSURANCE - COST, Observation Beds (Distinct Unit) (D_5_HOS_C6_9201)",Other Reimbursable (B_1_C26_98),Drugs Charged to Patients (D_4_HOS_C13_73),Other Outpatient Services (D3_IPF_C3_93),Other Outpatient Services (D_4_IRF_C11_93),Home Program Dialysis (D_4_HOS_C2_94),Nursery (D_1_HOS_C4_43),Occupational Therapy (D3_HOS_C3_67),Total Hospital (S3_1_C8_14),Intestinal Acquisition (B_1_C26_110),"Depreciation, New Cap Related Csts Bldg & Fixtures (A7_3_C9_1)",Hospice (S3_1_C7_24),ASC (Non Distinct Part) (C_1_C5_75),Drugs Charged to Patients (D3_IRF_C2_73),Investments (G_C1THRU4_31),Radiology-Therapeutic (D_4_HOS_C10_55),Aggregate amount collected from patients (E_B_HOS_C1_15),Laundry and Linen Service (A_C1_8),Nonphysician Anesthetists (A_C1_19),Electrocardiology (B_1_C26_69),"COST REIMBURSED SERVICES SUBJECT TO DEDUCTIBLES  AND COINSURANCE - CHARGES, Physical Therapy (D_5_HOS_C3_66)",ASC (Distinct Part) (B_1_C22_115),Intensive Care Unit (D3_IPF_C2_31),"PPS REIMBURSED SERVICES -  CHARGES, Other Reimbursable (D_5_HOS_C2_98)","Total Inpatient Charges, Cardiac Catheterization (C_1_C6_59)",Subprovider-IRF (D3_IRF_C2_41),Medical Supplies Charged to Patients (D_4_IPF_C11_71),Impl. Dev. Charged to Patients (D_4_IPF_C13_72),"HHA III, With Outliers:  Total Charges (S4_HHA3_C2_35)",Subprovider-IPF (D3_SNF_C2_40),"ADJUSTED SALARIES, Total Salaries (S3_2_C4_1)","Net Expense for Cost Allocation, Home Program Dialysis (B_1_C0_94)",Radiology-Therapeutic (C_1_C5_55),"Total Inpatient Charges, Burn Intensive Care Unit (C_1_C6_33)",Electrocardiology (D_4_HOS_C12_69),Clinic (D_4_IPF_C13_90),Operating Room (D_4_IRF_C13_50),"Allocation of Interns & Residents Salary and Fringes, Cardiac Catheterization (B_1_C21_59)","COST SERVICES NOT SUBJECT TO DEDUCTIBLES AND COINSURANCE - COST, Home Program Dialysis (D_5_HOS_C7_94)",Intensive Care Unit (S3_1_C8_8),MRI (D3_IRF_C2_58),Number of periods hospital was in MDH status (S2_1_C1_37),Other Ancillary (D3_HOS_C2_76),Other Organ Acquisition (B_1_C22_112),Emergency (B_2_C26_91),Radiology-Therapeutic (D3_IRF_C3_55),Occupational Therapy (C_1_C2_67),"Interest, New Cap Related Csts Movable Equipment (A7_3_C11_2)","ADJUSTED SALARIES, Teaching Physician Salaries (S3_2_C4_16)",Subprovider-IPF (D3_HOS_C2_40),Laboratory (D3_IRF_C2_60),Medicare Certified Lung TC term date (S2_1_C2_129),Surgical Intensive Care Unit (S3_1_C2_11),Intensive Care Unit (S3_1_C3_8),"Disposals and Retirements, Land Improvements (A7_1_C7_2)",Observation Beds (Distinct Unit) (B_1_C26_9201),Cardiac Catheterization (D3_IPF_C3_59),Laboratory (D3_IPF_C3_60),Medical and Other Services (E_B_HOS_C1_1),RHC (D_4_HOS_C2_88),Is this hospital classified as a referral center? (Y/N) (S2_1_C1_116),Anesthesiology (D_4_HOS_C13_53),certification date (S2_1_C1_131),Other General Service (A_C6_18),Total Swing Bed Cost (D1_HOS_C1_26),Outpatient Rehab Provider (S3_1_C7_25),Minor Equipment Depreciable (G_C1THRU4_25),Renal Dialysis (D3_HOS_C3_74),MRI (A_C2_58),Other Organ Acquisition (C_1_C6_112),Surgical Intensive Care Unit (S3_1_C6_11),Intestinal Acquisition (A_C1_110),Intensive Care Unit (B_1_C26_31),MRI (D_4_HOS_C10_58),Electroencephalography (D_4_IRF_C11_70),"COST REIMBURSED SERVICES NOT SUBJECT TO DEDUCTIBLES AND COINSURANCE - CHARGES, Other Ancillary (D_5_HOS_C4_76)","Net Expense for Cost Allocation, Int & Res (non approved teaching program (B_1_C0_100)",Other Reimbursable (D_4_HOS_C11_98),Radioisotope (D3_IRF_C3_56),Ambulance Services (B_2_C26_95),Clinic (D3_SNF_C2_90),MRI (D3_IPF_C2_58),"COST SERVICES SUBJECT TO DEDUCTIBLES AND COINSURANCE - COST, Whole Blood & Packed Red Blood Cells (D_5_HOS_C6_62)",CT Scan (D_4_HOS_C4_57),"COST REIMBURSED SERVICES NOT SUBJECT TO DEDUCTIBLES AND COINSURANCE - CHARGES, Medical Supplies Charged to Patients (D_5_HOS_C4_71)",Subprovider 2 (S3_1_C7_1801),"AMOUNT REPORTED, Home Office Salaries (S3_2_C3_1401)",Net Income from Service to Patients (G3_C1_5),Total (B_2_C26_202),Intensive Care Unit (S3_1_C6_8),MRI (D_4_IRF_C13_58),Research (A_C6_191),"COST REIMBURSED SERVICES NOT SUBJECT TO DEDUCTIBLES AND COINSURANCE - CHARGES, Cardiac Catheterization (D_5_HOS_C4_59)",Radiology-Diagnostic (D3_SNF_C3_54),OPT (C_1_C6_9920),"Donations, Subtotal (A7_1_C3_8)",Physical Therapy (D_4_IRF_C11_66),Radiology-Therapeutic (B_1_C26_55),Subprovider 2 (S3_1_C8_1801),"Allocation of Interns & Residents Salary and Fringes, Electrocardiology (B_1_C21_69)",Stand-alone CHIP -- Costs minus net revenue (0 min) (S10_C1_12),FQHC (B_1_C26_89),Operating Room (D3_SNF_C2_50),Delivery Room and Labor Room (D3_IRF_C2_52),Medicare Certified Pancreas TC term date (S2_1_C2_130),"Net Expense for Cost Allocation, CT Scan (B_1_C0_57)",MRI (D_4_HOS_C12_58),Renal Dialysis (D_4_IRF_C13_74),Total Nursing School (D_4_HOS_C2_200),"HHA II, Without Outliers:  Total Charges (S4_HHA2_C1_35)","TOTAL CAPITAL COSTS AFTER COST ALLOCATION, Subprovider II (B_2_C26_4201)","AVERAGE HOURLY WAGE, Operation of Plant (S3_2_C6_30)","AMOUNT REPORTED, Physician Part A (S3_2_C2_22)","Allocation of Interns & Residents Program Costs, SNF (B_1_C22_44)",FQHC (D_4_HOS_C4_89),FQHC (D_4_HOS_C3_89),Speech Pathology (D_4_IPF_C13_68),"COST REIMBURSED SERVICES NOT SUBJECT TO DEDUCTIBLES AND COINSURANCE - CHARGES, Anesthesiology (D_5_HOS_C4_53)","COST SERVICES SUBJECT TO DEDUCTIBLES AND COINSURANCE - COST, Durable Medical Equipment Sold (D_5_HOS_C6_97)",Speech Pathology (D_4_SNF_C11_68),Physical Therapy (D_4_SNF_C11_66),Blood Clotting Factors for Hemoph. (D3_IRF_C2_6250),NOT IN THIS FILE (TRNSMTL_NUM),Radiology-Diagnostic (A_C1_54),Investment Income-New Bldgs & Fixtures (A8_C2_1),Operating Room (D_4_HOS_C1_50),Total Hospital (S3_1_C5_7),"Total Inpatient Charges, OLTC (C_1_C6_46)","Total Outpatient Charges, Radioisotope (C_1_C7_56)","Disposals and Retirements, Buildings and Fixtures (A7_1_C7_3)",SNF (S3_1_C10_19),Nursery (A_C2_43),Delivery Room and Labor Room (D_4_IPF_C13_52),Total Nonphysician Anesthetist Cost (D_4_IRF_C1_102),"COST REIMBURSED SERVICES NOT SUBJECT TO DEDUCTIBLES AND COINSURANCE - CHARGES, Recovery Room (D_5_HOS_C4_51)","HHA I, PEP:  Total Number of Outlier Episodes (S4_HHA1_C4_37)",Subprovider-IRF (D3_IRF_C2_40),Total Current Assets (G_C1THRU4_11),"AVERAGE HOURLY WAGE, Other General Service (S3_2_C6_43)",Observation Beds (Distinct Unit) (D_4_HOS_C12_9201),"ADJUSTED SALARIES, Nursing Administration (S3_2_C4_38)","HHA III, Without Outliers:  Total Visits (S4_HHA3_C1_33)",Islet Acquisition (C_1_C6_111),Occupational Therapy (D_4_HOS_C3_67),Other Outpatient Services (C_1_C5_93),"PPS REIMBURSED SERVICES -  CHARGES, Physical Therapy (D_5_HOS_C2_66)",Total Program General Inpatient Routine (D1_HOS_C1_41),"Net Expense for Cost Allocation, Central Services and Supply (B_1_C0_14)","Fully Depreciated Assets, Begin Balance (A7_1_C1_7)",Pancreas Acquisition (B_2_C26_109),"AMOUNT REPORTED, Housekeeping under contract (S3_2_C2_33)",RHC 19 Provider Number (S2_1_C2_1518),FQHC (A_C2_89),Medicare reimbursable bad debts for the entire hospital complex (S10_C1_27),Drugs Charged to Patients (C_1_C7_73),Total (D_4_IRF_C11_200),"COST SERVICES NOT SUBJECT TO DEDUCTIBLES AND COINSURANCE - COST, Cardiac Catheterization (D_5_HOS_C7_59)","Net Expense for Cost Allocation, Nursing Administration (B_1_C0_13)",Delivery Room and Labor Room (D_4_IRF_C13_52),Dietary (A_C2_10),"AMOUNT REPORTED, Management and Administrative Services (S3_2_C2_12)",Subprovider-IPF (A_C2_40),ICF (A_C2_4501),"PAID HOURS RELATED TO SALARIES, Other General Service (S3_2_C5_43)",Electrocardiology (D_4_HOS_C3_69),"Net Expense for Cost Allocation, Occupational Therapy (B_1_C0_67)","AVERAGE HOURLY WAGE, Central Services and Supply (S3_2_C6_39)",HHA (C_1_C5_101),CT Scan (D_4_HOS_C12_57),"HHA I, W/Out Outliers:  Number of Episodes (S4_HHA1_C1_36)",Cardiac Catheterization (D3_SNF_C3_59),Allowable bad debts (E_B_HOS_C1_34),"COST REIMBURSED SERVICES SUBJECT TO DEDUCTIBLES  AND COINSURANCE - CHARGES, Cardiac Catheterization (D_5_HOS_C3_59)",Drugs Charged to Patients (D_4_HOS_C4_73),"Total Inpatient Charges, Radiology-Therapeutic (C_1_C6_55)",Hospice (S3_1_C6_24),Coronary Care Unit (D3_SNF_C2_32),Clinic (C_1_C5_90),Hospital Provider Number (PRVDR_NUM),"Net Expense for Cost Allocation, ICF (B_1_C0_4501)","AMOUNT REPORTED, Subtotal Wage Related Csts (S3_3_C2_5)","PAID HOURS RELATED TO SALARIES, Central Services and Supply (S3_2_C5_39)",Delivery Room and Labor Room (D_4_HOS_C12_52),Electroencephalography (D3_HOS_C2_70),"COST SERVICES SUBJECT TO DEDUCTIBLES AND COINSURANCE - COST, Other Reimbursable (D_5_HOS_C6_98)",Operating Room (A_C6_50),Radiology-Diagnostic (D_4_HOS_C11_54),Delivery Room and Labor Room (D3_SNF_C2_52),"Total Inpatient Charges, Laboratory (C_1_C6_60)",Islet Acquisition (B_1_C26_111),"COST SERVICES NOT SUBJECT TO DEDUCTIBLES AND COINSURANCE - COST, Drugs Charged to Patients (D_5_HOS_C7_73)","TOTAL CAPITAL COSTS AFTER COST ALLOCATION, OLTC (B_2_C26_46)",Out of State Medicaid eligible days (S2_1_C4_24),Lung  Acquisition (B_1_C22_108),Radiology-Diagnostic (D3_HOS_C3_54),RHC 3 Provider Number (S2_1_C2_1502),"AVERAGE HOURLY WAGE, Physician-Part B (S3_2_C6_5)",Other Outpatient Services (D_4_HOS_C2_93),Intravenous Therapy (D3_SNF_C2_64),Component rate ESRD (E_B_HOS_C1_33),Hospital Type (S2_1_C4_3),Other Outpatient Services (D3_HOS_C3_93),Total Patient Days (D_3_HOS_C6_200),"AMOUNT REPORTED, Interns & Residents (S3_2_C2_25)","Net Expense for Cost Allocation, OOT (B_1_C0_9930)",Subprovider-IPF (D_3_HOS_C9_40),Organ Procurement (D4_LIVER_C1_69),RHC 22 Provider Number (S2_1_C2_1521),Drugs Charged to Patients (D_4_IRF_C11_73),Other Ancillary (D3_IPF_C3_76),"AMOUNT REPORTED, Home Office Salaries (S3_2_C2_1401)",Subprovider-IRF (A_C2_41),Blood Clotting Factors for Hemoph. (D3_HOS_C3_6250),"PAID HOURS RELATED TO SALARIES, Medical Records & Med Records Library (S3_2_C5_41)",Other Reimbursable (D_4_IRF_C11_98),Occupational Therapy (D3_IPF_C2_67),Electrocardiology (D_4_SNF_C11_69),"PAID HOURS RELATED TO SALARIES, Contract Labor (S3_2_C5_11)","PAID HOURS RELATED TO SALARIES, Net Salaries (S3_3_C5_1)","COST SERVICES NOT SUBJECT TO DEDUCTIBLES AND COINSURANCE - COST, Radiology-Therapeutic (D_5_HOS_C7_55)",ASC (Distinct Part) (C_1_C5_115),Hospice (B_1_C22_116),Other Reimbursable (D3_HOS_C3_98),"HHA I, With Outliers:  Total Charges (S4_HHA1_C2_35)",Total Assets (G_C1THRU4_36),MRI (D3_SNF_C3_58),"If this facility qualifies as a RPCH/CAH, has it elected the all inclusive payment for outpatient service? (Y/N) (S2_1_C1_106)",CT Scan (D3_SNF_C2_57),Pharmacy (A_C1_15),Related Organization Transactions (A8_C2_12),Impl. Dev. Charged to Patients (B_1_C26_72),"PPS REIMBURSED SERVICES -  CHARGES, Occupational Therapy (D_5_HOS_C2_67)",Anesthesiology (D_4_SNF_C11_53),"COST SERVICES SUBJECT TO DEDUCTIBLES AND COINSURANCE - COST, Anesthesiology (D_5_HOS_C6_53)",Durable Medical Equipment Sold (D_4_HOS_C2_97),Respiratory Therapy (C_1_C6_65),"Net Expense for Cost Allocation, Intravenous Therapy (B_1_C0_64)",Is this a rural hospital qualifying for an exception to the certified registered nurse anesthetist the CRNA fee schedule? (Y/N) (S2_1_C1_108),Recovery Room (D3_HOS_C2_51),FQHC (C_1_C7_89),Observation Beds (Distinct Unit) (D3_IPF_C3_9201),Other Outpatient Services (D3_IRF_C2_93),"PPS SERVICES COST, Other Outpatient Services (D_5_HOS_C5_93)",Whole Blood & Packed Red Blood Cells (D3_IRF_C3_62),Sale of drugs to other than patients (A8_C2_17),"HHA II, Without Outliers:  Total Visits (S4_HHA2_C1_33)","Total Inpatient Charges, Coronary Care Unit (C_1_C6_32)","ADJUSTED SALARIES, Physician Part A (S3_2_C4_22)","AMOUNT REPORTED, Non-Physician Part B (S3_2_C2_6)",Pancreas Acquisition (C_1_C5_109),Physical Therapy (D_4_HOS_C4_66),Speech Pathology (D_4_HOS_C12_68),"COST REIMBURSED SERVICES SUBJECT TO DEDUCTIBLES  AND COINSURANCE - CHARGES, Clinic (D_5_HOS_C3_90)","COST REIMBURSED SERVICES NOT SUBJECT TO DEDUCTIBLES AND COINSURANCE - CHARGES, Clinic (D_5_HOS_C4_90)",Medical Supplies Charged to Patients (D3_SNF_C2_71),HHA (S3_1_C11_22),Organ Procurement (D4_PANCREAS_C1_69),"COST REIMBURSED SERVICES NOT SUBJECT TO DEDUCTIBLES AND COINSURANCE - CHARGES, Renal Dialysis (D_5_HOS_C4_74)",Other Current Assets (G_C1THRU4_9),Other Current Liabilities (G_C1THRU4_44),Liver Acquisition (A_C2_107),Bonus Payment (D1_HOS_C1_58),Maintenance and Repairs (A_C1_6),Electrocardiology (D_4_HOS_C10_69),Health Information Technology Designated Assets (G_C1THRU4_27),Inventory (G_C1THRU4_7),FQHC (B_2_C26_89),Laboratory (D_4_IRF_C11_60),Hospice (S3_1_C2_24),"HHA III, Total Other Charges (S4_HHA3_C5_34)",Anesthesiology (D_4_HOS_C11_53),Total (D_4_HOS_C11_200),Emergency (D_4_HOS_C11_91),OLTC (S3_1_C10_21),"Interest, Total (A7_3_C11_3)","Total Outpatient Charges, Radiology-Diagnostic (C_1_C7_54)","Total Inpatient Charges, Subprovider I (C_1_C6_42)",Payroll taxes payable (G_C1THRU4_39),Hospital State (S2_1_C2_2),Burn Intensive Care Unit Program Cost (D1_HOS_C5_45),Lung  Acquisition (C_1_C7_108),Medical Supplies Charged to Patients (D_4_HOS_C13_71),"AMOUNT REPORTED, Teaching Physician Salaries (S3_2_C2_16)",RHC 8 Provider Number (S2_1_C2_1507),Intravenous Therapy (D_4_HOS_C11_64),Radiology-Therapeutic (D3_HOS_C3_55),Renal 3 Provider Number (S2_1_C2_1802),Total Operating Expense (G3_C1_4),Total (D_4_IRF_C13_200),OOT (C_1_C6_9930),"AMOUNT REPORTED, Contract Labor (S3_2_C2_11)","Beginning Balances, Land Improvements (A7_1_C1_2)",FQHC 4 Provider Number (S2_1_C2_1603),Intravenous Therapy (D_4_IPF_C11_64),"Allocation of Interns & Residents Salary and Fringes, Delivery Room and Labor Room (B_1_C21_52)","Allocation of Interns & Residents Program Costs, Adults and Pediatrics (B_1_C22_30)","Total Outpatient Charges, CT Scan (C_1_C7_57)",Emergency (D_4_HOS_C3_91),"Net Expense for Cost Allocation, Blood Storing, Processing, Trans (B_1_C0_63)",Maintenance of Personnel (A_C2_12),Radioisotope (A_C1_56),Electroencephalography (A_C2_70),"Allocation of Interns & Residents Salary and Fringes, Medical Supplies Charged to Patients (B_1_C21_71)",PBP Clinical Lab Services Program Only (A_C2_61),Investment Income-Other (A8_C2_3),Total (C_1_C6_202),Clinic (C_1_C7_90),Recovery Room (D3_IRF_C2_51),MRI (D_4_HOS_C4_58),Recovery Room (D_4_HOS_C3_51),"HHA I, With Outliers:  Non Routine Med Sup Chgs (S4_HHA1_C2_38)",CORF (B_2_C26_9910),"AVERAGE HOURLY WAGE, Cafeteria (S3_2_C6_36)",Durable Medical Equipment Sold (D_4_HOS_C10_97),"COST SERVICES NOT SUBJECT TO DEDUCTIBLES AND COINSURANCE - COST, Total (D_5_HOS_C7_200)",MDH status ending date (MM/DD/YY) (S2_1_C2_38),Electrocardiology (D_4_IRF_C13_69),Respiratory Therapy (D3_SNF_C2_65),"Total Inpatient Charges, Blood Clotting Factors for Hemoph. (C_1_C6_6250)","PPS REIMBURSED SERVICES -  CHARGES, Respiratory Therapy (D_5_HOS_C2_65)","COST REIMBURSED SERVICES NOT SUBJECT TO DEDUCTIBLES AND COINSURANCE - CHARGES, Delivery Room and Labor Room (D_5_HOS_C4_52)",Social Service (A_C2_17),Islet Acquisition (B_1_C22_111),"Net Expense for Cost Allocation, Medical Records and Medical Rec. Library (B_1_C0_16)",Observation Beds (Distinct Unit) (D3_IPF_C2_9201),Payments received from patients for amounts previously written off as charity care (S10_C2_22),"TOTAL CAPITAL COSTS AFTER COST ALLOCATION, Radiology-Diagnostic (B_2_C26_54)","Total Inpatient Charges, Delivery Room and Labor Room (C_1_C6_52)",Emergency (D_4_HOS_C2_91),"Purchases, Total (A7_1_C2_10)",Title XIX discharges (S3_1_C14_16),Occupational Therapy (D_4_IPF_C13_67),"HHA III, Total Charges:  LUPA Episodes (S4_HHA3_C3_35)",PBP Clinical Lab Services Program Only (B_1_C26_61),Housekeeping (A_C2_9),"AMOUNT REPORTED, Nursing Administration (S3_2_C2_38)",Medical Supplies Charged to Patients (D_4_HOS_C2_71),Other Reimbursable (D_4_HOS_C13_98),Laboratory (D3_IPF_C2_60),ASC (Non Distinct Part) (D_4_IPF_C13_75),"Number of patients in program at 
end of cost reporting period (S5_C4_1)","Gift, Flower, Coffee Shop, Canteen (B_1_C22_190)",RHC 4 Provider Number (S2_1_C2_1503),Other Ancillary (C_1_C7_76),"Blood Storing, Processing, Trans (D3_HOS_C2_63)",OPPS payments (E_B_HOS_C1_3),"ADJUSTED SALARIES, Employee Benefits (S3_2_C4_26)",Subprovider 1 (S3_1_C8_18),Home Program Dialysis (D_4_HOS_C3_94),"Allocation of Interns & Residents Program Costs, Blood Storing, Processing, Trans (B_1_C22_63)",Medical Supplies Charged to Patients (D_4_IRF_C11_71),ICF Provider Number (S2_1_C2_1001),"AMOUNT REPORTED, Physician-Part B (S3_2_C2_5)",Burn Intensive Care Unit (D_1_HOS_C4_33),"Total Inpatient Charges, SNF (C_1_C6_44)",Physical Therapy (C_1_C7_66),Islet Acquisition (C_1_C5_111),"General Inpatient Routine Service Cost, net of Swing Bed Cost (D1_IPF_C1_27)",Maintenance of Personnel (A_C1_12),"If Line 32, Col 1 is yes, enter the method used: (A, B, or E only) (S2_1_C2_115)","HHA II, Without Outliers:  Non Routine Med Sup Chgs (S4_HHA2_C1_38)",Medical Supplies Charged to Patients (A_C1_71),"Net Expense for Cost Allocation, Observation Beds (Distinct Unit) (B_1_C0_9201)",Total Adults & Pediatrics (S3_1_C8_7),Cost of charity care (uninsured patients + patients w/ coverage not accepted by provider) (S10_C1_23),TOTAL (D3_SNF_C3_200),"Total Inpatient Charges, Anesthesiology (C_1_C6_53)",Impl. Dev. Charged to Patients (D3_IRF_C3_72),"COST SERVICES SUBJECT TO DEDUCTIBLES AND COINSURANCE - COST, Blood Clotting Factors for Hemoph. (D_5_HOS_C6_6250)","TOTAL CAPITAL COSTS AFTER COST ALLOCATION, Radiology-Therapeutic (B_2_C26_55)",Renal Dialysis (A_C6_74),Number of stations (S5_C4_6),Electroencephalography (D3_IPF_C3_70),"PPS REIMBURSED SERVICES -  CHARGES, Impl. Dev. Charged to Patients (D_5_HOS_C2_72)","Net Expense for Cost Allocation, FQHC (B_1_C0_89)","HHA II, W/Out Outliers:  Number of Episodes (S4_HHA2_C1_36)","HHA III, LUPA Episodes:  Total Number of Episodes (S4_HHA3_C3_36)",Nonphysician Anesthetists (A_C6_19),"AVERAGE HOURLY WAGE, Social Service (S3_2_C6_42)",Net Patient Revenue (G3_C1_3),Hospice (C_1_C5_116),Emergency (D_4_HOS_C4_91),"Number of patients in program at 
end of cost reporting period (S5_C6_1)","HHA I, LUPA Episodes:  Total Visits (S4_HHA1_C3_33)","HHA III, Without Outliers:  Total Charges (S4_HHA3_C1_35)",Title V discharges (S3_1_C12_17),Whole Blood & Packed Red Blood Cells (A_C6_62),Other Ancillary (D_4_HOS_C12_76),"AMOUNT REPORTED, Medical Records & Med Records Library (S3_2_C2_41)",Recovery Room (D3_IRF_C3_51),Anesthesiology (D3_IRF_C3_53),Renal 4 Provider Number (S2_1_C2_1803),"Net Expense for Cost Allocation, Nonphysician Anesthetists (B_1_C0_19)","Gift, Flower, Coffee Shop, Canteen (A_C6_190)",NF (B_1_C26_45),Impl. Dev. Charged to Patients (D3_HOS_C2_72),Subtotal (E_B_HOS_C1_27),Int & Res (non approved teaching program (C_1_C7_100),Anesthesiology (D3_SNF_C2_53),Organ Procurement (D4_ISLET_C1_69),"Net Expense for Cost Allocation, NF (B_1_C0_45)","Net Expense for Cost Allocation, Electroencephalography (B_1_C0_70)",Operating Room (D3_IRF_C2_50),Subprovider-IPF (B_1_C26_40),Medical Supplies Charged to Patients (B_1_C26_71),Delivery Room and Labor Room (D_4_SNF_C11_52),MRI (D_4_IRF_C11_58),Adults and Pediatrics (A_C1_30),"PPS SERVICES COST, MRI (D_5_HOS_C5_58)",Utilization Review-physicians compens (A8_C2_25),"Allocation of Interns & Residents Program Costs, Electroencephalography (B_1_C22_70)",Investment Income-New Movable Equip (A8_C2_2),"AVERAGE HOURLY WAGE, Laundry and Linen Service (S3_2_C6_31)",Delivery Room and Labor Room (D_4_IRF_C11_52),Electrocardiology (D3_SNF_C3_69),Occupational Therapy (D_4_HOS_C2_67),HHA 1 Provider Number (S2_1_C2_12),Total Current Liabilities (G_C1THRU4_45),Subprovider-IRF (D_1_HOS_C7_41),OSP (A_C2_9940),Blood Clotting Factors for Hemoph. (A_C2_6250),"Allocation of Interns & Residents Program Costs, Burn Intensive Care Unit (B_1_C22_33)",Blood Clotting Factors for Hemoph. (D_4_HOS_C10_6250),Anesthesiology (D_4_IPF_C11_53),"Net Expense for Cost Allocation, Liver Acquisition (B_1_C0_107)","PAID HOURS RELATED TO SALARIES, Employee Benefits (S3_2_C5_26)",Recovery Room (D_4_HOS_C4_51),Speech Pathology (D_4_HOS_C2_68),Cross Foot Adjustments (B_2_C26_200),OLTC (C_1_C5_46),Recovery Room (D3_IPF_C3_51),"AVERAGE HOURLY WAGE, Admin & Gen Under Contract (S3_2_C6_29)",IPF Provider Number (S2_1_C2_4),Intravenous Therapy (D_4_IPF_C13_64),"Allocation of Interns & Residents Program Costs, Occupational Therapy (B_1_C22_67)","AMOUNT REPORTED, Employee Benefits (S3_2_C2_26)",Whole Blood & Packed Red Blood Cells (D3_IPF_C3_62),OLTC (A_C6_46),Clinic (D_4_HOS_C2_90),"Allocation of Interns & Residents Program Costs, Anesthesiology (B_1_C22_53)",Other Reimbursable (B_1_C21_98),TOTAL (D3_IRF_C2_200),Total Other Assets (G_C1THRU4_35),"Total Inpatient Charges, Operating Room (C_1_C6_50)",Radioisotope (D_4_HOS_C2_56),Ambulance Services (B_1_C22_95),Drugs Charged to Patients (D_4_HOS_C3_73),"Is this a New Hospital under
42 CFR 412.300 PPS capital
(Y/N) (S2_1_C1_47)",Recovery Room (C_1_C5_51),"Allocation of Interns & Residents Program Costs, CT Scan (B_1_C22_57)",RHC 25 Provider Number (S2_1_C2_1524),"Blood Storing, Processing, Trans (D3_IRF_C2_63)",Electrocardiology (D3_IRF_C3_69),Cardiac Catheterization (D3_SNF_C2_59),Other Reimbursable (D3_IPF_C2_98),Respiratory Therapy (D_4_HOS_C10_65),"Blood Storing, Processing, Trans (D_4_HOS_C3_63)",RHC 5 Provider Number (S2_1_C2_1504),"HHA I, Total Other Charges (S4_HHA1_C5_34)",Operating Room (A_C2_50),Subprovider-IRF (D3_IPF_C2_41),Heart Acquisition (C_1_C6_106),Physical Therapy (D_4_IPF_C13_66),Subtotal (E_B_HOS_C1_32),Physical Therapy (A_C2_66),MRI (D_4_HOS_C3_58),Int & Res (non approved teaching program (A_C1_100),"Allocation of Interns & Residents Salary and Fringes, Surgical Intensive Care Unit (B_1_C21_34)","Net Expense for Cost Allocation, Nursing School (B_1_C0_20)",Occupational Therapy (A_C2_67),"COST REIMBURSED SERVICES SUBJECT TO DEDUCTIBLES  AND COINSURANCE - CHARGES, Impl. Dev. Charged to Patients (D_5_HOS_C3_72)",Radiology-Therapeutic (D_4_HOS_C12_55),Subprovider-IRF (D3_SNF_C2_41),"PPS SERVICES COST, Emergency (D_5_HOS_C5_91)",Electroencephalography (D_4_HOS_C11_70),Other Nonreimbursable (B_1_C22_194),Hospital Adlts & Ped Swing Bed SNF (S3_1_C7_5),Electroencephalography (D_4_HOS_C10_70),"PAID HOURS RELATED TO SALARIES, Operation of Plant (S3_2_C5_30)",Total Facility FTEs (S3_1_C11_27),"ADJUSTED SALARIES, Wage Related Costs RHC/FQHC (S3_2_C4_24)","COST SERVICES SUBJECT TO DEDUCTIBLES AND COINSURANCE - COST, Speech Pathology (D_5_HOS_C6_68)",Operating Room (A_C1_50),Total Program General Inpatient Routine (D1_IRF_C1_41),Renal Dialysis (B_1_C21_74),ASC (Distinct Part) (A_C6_115),Laboratory (D_4_HOS_C3_60),"Gift, Flower, Coffee Shop, Canteen (B_1_C26_190)",Operation of Plant (A_C1_7),Delivery Room and Labor Room (D_4_IPF_C11_52),"HHA III, With Outliers:  Non Routine Med Sup Chgs (S4_HHA3_C2_38)",Liver Acquisition (B_2_C26_107),Total Other Medical Education (D_4_HOS_C4_200),Delivery Room and Labor Room (D3_HOS_C2_52),Radioisotope (D3_IRF_C2_56),Intestinal Acquisition (A_C2_110),"PPS REIMBURSED SERVICES -  CHARGES, Laboratory (D_5_HOS_C2_60)",Laboratory (D3_SNF_C3_60),Electrocardiology (D3_IPF_C3_69),Physical Therapy (D_4_IPF_C11_66),Delivery Room and Labor Room (D3_IPF_C2_52),Other Ancillary (D_4_HOS_C3_76),"Allocation of Interns & Residents Salary and Fringes, Occupational Therapy (B_1_C21_67)",Cardiac Catheterization (D3_HOS_C2_59),Whole Blood & Packed Red Blood Cells (D3_SNF_C3_62),Title XIX discharges (S3_1_C14_14),"AVERAGE HOURLY WAGE, Subtotal Salaries (S3_3_C6_3)",Other adjustments (E_B_HOS_C1_39),Speech Pathology (C_1_C5_68),FQHC (B_1_C22_89),"Beginning Balances, Total (A7_1_C1_10)",IPF (S3_1_C7_16),Operation of Plant (A_C2_7),"AVERAGE HOURLY WAGE, Related Salaries (S3_2_C6_1402)",Respiratory Therapy (D_4_IPF_C11_65),Surgical Intensive Care Unit (S3_1_C3_11),"PPS SERVICES COST, Anesthesiology (D_5_HOS_C5_53)",NF (S3_1_C5_20),RHC (D_4_HOS_C3_88),"PPS REIMBURSED SERVICES -  CHARGES, Speech Pathology (D_5_HOS_C2_68)",Kidney Acquisition (A_C1_105),ASC (Distinct Part) (B_2_C26_115),NF (A_C6_45),Durable Medical Equipment Sold (D3_HOS_C3_97),Organ Procurement (D4_LUNG_C1_69),Int & Res (non approved teaching program (C_1_C5_100),"HHA III, PEP:  Total Number of Outlier Episodes (S4_HHA3_C4_37)",Other Special Purpose (C_1_C7_117),interns and residents (E_B_HOS_C1_28),Coronary Care Unit (A_C6_32),Total Program Inpatient Costs (D1_IRF_C1_49),"COST SERVICES NOT SUBJECT TO DEDUCTIBLES AND COINSURANCE - COST, Electroencephalography (D_5_HOS_C7_70)","PAID HOURS RELATED TO SALARIES, Excluded Area Salaries (S3_3_C5_2)",Clinic (B_1_C21_90),HHA (B_1_C21_101),"Blood Storing, Processing, Trans (C_1_C7_63)",Other Ancillary (D_4_SNF_C11_76),"AMOUNT REPORTED, Interns & Residents (S3_2_C2_7)","HHA I, Without Outliers:  Total Charges (S4_HHA1_C1_35)","COST SERVICES SUBJECT TO DEDUCTIBLES AND COINSURANCE - COST, Radiology-Diagnostic (D_5_HOS_C6_54)",SNF (S3_1_C2_19),TOTAL (D3_IRF_C3_200),Occupational Therapy (D3_SNF_C2_67),"COST SERVICES SUBJECT TO DEDUCTIBLES AND COINSURANCE - COST, Delivery Room and Labor Room (D_5_HOS_C6_52)",CMHC (B_2_C26_99),Drugs Charged to Patients (D_4_SNF_C11_73),"ADJUSTED SALARIES, Teaching Physician Salaries (S3_2_C4_1602)","Net Expense for Cost Allocation, Intestinal Acquisition (B_1_C0_110)",ASC (Distinct Part) (B_1_C26_115),"AMOUNT REPORTED, Interns & Residents (S3_2_C3_2552)","ADJUSTED SALARIES, Excluded Areas (S3_2_C4_19)",Liver Acquisition (B_1_C22_107),Interns & Res Other Program Costs (A_C6_22),"Total Outpatient Charges, Whole Blood & Packed Red Blood Cells (C_1_C7_62)",Physical Therapy (D3_IPF_C3_66),Renal Dialysis (D_4_HOS_C4_74),"PPS REIMBURSED SERVICES -  CHARGES, Medical Supplies Charged to Patients (D_5_HOS_C2_71)","COST SERVICES SUBJECT TO DEDUCTIBLES AND COINSURANCE - COST, Blood Storing, Processing, Trans (D_5_HOS_C6_63)",SNF (C_1_C5_44),Intravenous Therapy (D_4_HOS_C2_64),FQHC 1 Provider Number (S2_1_C2_16),Renal Dialysis (C_1_C5_74),"Total Outpatient Charges, Operating Room (C_1_C7_50)",Physicians' Private Office (B_2_C26_192),Other Ancillary (D_4_HOS_C13_76),Drugs Charged to Patients (D_4_IPF_C11_73),Home Program Dialysis (D3_HOS_C3_94),Census Division Code (CENSUS),"PPS SERVICES COST, Intravenous Therapy (D_5_HOS_C5_64)",Burn Intensive Care Unit (B_1_C26_33),Radiology-Therapeutic (D_4_HOS_C13_55),Hospice (C_1_C7_116),"Blood Storing, Processing, Trans (C_1_C5_63)",Interns and residents (E_B_HOS_C1_22),"Total Inpatient Charges, Subprovider II (C_1_C6_4201)",Transitional corridor payment (E_B_HOS_C1_8),"PPS SERVICES COST, Durable Medical Equipment Sold (D_5_HOS_C5_97)","ADJUSTED SALARIES, SNF (S3_2_C4_9)",Int & Res (non approved teaching program (A_C6_100),Radioisotope (D_4_IRF_C13_56),Other Special Care (S3_1_C6_12),"Allocation of Interns & Residents Salary and Fringes, Radioisotope (B_1_C21_56)","COST REIMBURSED SERVICES SUBJECT TO DEDUCTIBLES  AND COINSURANCE - CHARGES, Other Ancillary (D_5_HOS_C3_76)",Other Assets (G_C1THRU4_34),Emergency (C_1_C7_91),Medical Supplies Charged to Patients (D3_SNF_C3_71),HHA (A_C2_101),Total Allied Health (D_4_IPF_C3_200),Total Hospital (S3_1_C6_14),OLTC (S3_1_C3_21),FQHC 6 Provider Number (S2_1_C2_1605),Blood Clotting Factors for Hemoph. (D_4_HOS_C12_6250),Occupational Therapy (C_1_C7_67),Radiology-Therapeutic (D_4_HOS_C2_55),"COST SERVICES SUBJECT TO DEDUCTIBLES AND COINSURANCE - COST, Electrocardiology (D_5_HOS_C6_69)","Disposals and Retirements, Movable Equipment (A7_1_C5_6)",Physical Therapy (D3_IRF_C3_66),Excess of customary charges (E_B_HOS_C1_19),Subprovider-IPF (D_1_HOS_C6_40),Home Program Dialysis (B_1_C26_94),Drugs Charged to Patients (C_1_C6_73),Swing Bed SNF Provider Number (S2_1_C2_7),Coronary Care Unit (B_1_C26_32),"COST SERVICES SUBJECT TO DEDUCTIBLES AND COINSURANCE - COST, Radioisotope (D_5_HOS_C6_56)",Anesthesiology (D_4_HOS_C1_53),Whole Blood & Packed Red Blood Cells (B_1_C26_62),Electrocardiology (C_1_C6_69),"AVERAGE HOURLY WAGE, Total Overhead Costs (S3_3_C6_7)","Allocation of Interns & Residents Program Costs, Radiology-Diagnostic (B_1_C22_54)",Hospice (S3_1_C11_24),Radiology-Therapeutic (D3_IPF_C3_55),OLTC (S3_1_C11_21),"COST REIMBURSED SERVICES NOT SUBJECT TO DEDUCTIBLES AND COINSURANCE - CHARGES, Other Reimbursable (D_5_HOS_C4_98)",Hospice (B_1_C21_116),SNF (A_C6_44),Other Ancillary (D_4_IPF_C11_76),Intensive Care Unit (D3_IRF_C2_31),Radioisotope (D_4_SNF_C11_56),Electroencephalography (D_4_HOS_C2_70),ASC (Non Distinct Part) (D_4_IPF_C11_75),Physical Therapy (B_2_C26_66),RHC 17 Provider Number (S2_1_C2_1516),"Net Expense for Cost Allocation, Hospice (B_1_C0_116)","Net Expense for Cost Allocation, Nonpaid Workers (B_1_C0_193)",Other Organ Acquisition (C_1_C5_112),"COST REIMBURSED SERVICES NOT SUBJECT TO DEDUCTIBLES AND COINSURANCE - CHARGES, Emergency (D_5_HOS_C4_91)","TOTAL CAPITAL COSTS AFTER COST ALLOCATION, Subprovider-IPF (B_2_C26_40)",Anesthesiology (D3_HOS_C3_53),Report Status Code (RPT_STUS_CD),Cost of patients approved for charity care and uninsured discounts (S10_C3_21),PBP Clinical Lab Services Program Only (D3_HOS_C2_61),"Total Inpatient Charges, Whole Blood & Packed Red Blood Cells (C_1_C6_62)","Net Expense for Cost Allocation, Speech Pathology (B_1_C0_68)","Allocation of Interns & Residents Program Costs, NF (B_1_C22_45)",Anesthesiology (C_1_C5_53),"AVERAGE HOURLY WAGE, Management and Administrative Services (S3_2_C6_12)",Other Organ Acquisition (B_1_C21_112),Electroencephalography (D3_IRF_C3_70),Other Special Care Unit (A_C6_35),CMHC (C_1_C5_99),Other Special Purpose (B_1_C26_117),"COST SERVICES SUBJECT TO DEDUCTIBLES AND COINSURANCE - COST, Cardiac Catheterization (D_5_HOS_C6_59)","PPS SERVICES COST, Renal Dialysis (D_5_HOS_C5_74)","COST REIMBURSED SERVICES SUBJECT TO DEDUCTIBLES  AND COINSURANCE - CHARGES, Laboratory (D_5_HOS_C3_60)","Total Inpatient Charges, ICF (C_1_C6_4501)",Total (S3_1_C2_7),"Salaries, Wages, and Fees Payable (G_C1THRU4_38)",Beginning Date of SCH status (S2_1_C1_36),"COST REIMBURSED SERVICES SUBJECT TO DEDUCTIBLES  AND COINSURANCE - CHARGES, MRI (D_5_HOS_C3_58)",Other Ancillary (B_2_C26_76),Renal 6 Provider Number (S2_1_C2_1805),"Allocation of Interns & Residents Salary and Fringes, Adults and Pediatrics (B_1_C21_30)",ASC (Non Distinct Part) (C_1_C6_75),Radiology-Diagnostic (D_4_HOS_C3_54),Renal Dialysis (D_4_IRF_C11_74),Other Special Care (S3_1_C3_12),Intravenous Therapy (D3_SNF_C3_64),Coronary Care Unit (S3_1_C7_9),"Lease, New Cap Related Csts Movable Equipment (A7_3_C10_2)","Purchases, Buildings and Fixtures (A7_1_C2_3)","Allocation of Interns & Residents Program Costs, Delivery Room and Labor Room (B_1_C22_52)",SNF (S3_1_C11_19),Telephone Services (A8_C2_7),Occupational Therapy (D_4_HOS_C12_67),Paid Losses (S2_1_C2_11801),Nursing School (A_C1_20),Home Program Dialysis (D3_SNF_C3_94),"ADJUSTED SALARIES, Dietary under contract (S3_2_C4_35)","PPS SERVICES COST, Medical Supplies Charged to Patients (D_5_HOS_C5_71)","Total Inpatient Charges, Surgical Intensive Care Unit (C_1_C6_34)",Other Reimbursable (A_C6_98),Operating Room (D_4_HOS_C11_50),Radiology-Therapeutic (D_4_HOS_C3_55),Impl. Dev. Charged to Patients (D_4_HOS_C4_72),Respiratory Therapy (D3_HOS_C3_65),New Capital Equipment (A_C2_2),"Blood Storing, Processing, Trans (D_4_IPF_C11_63)",Durable Medical Equipment Rented (D3_IRF_C3_96),Other Outpatient Services (C_1_C6_93),"Net Expense for Cost Allocation, Medical Supplies Charged to Patients (B_1_C0_71)",Cost of Uncompensated Care (S10_C1_30),Charity care charges and uninsured discounts for the entire facility (S10_C3_20),Home Program Dialysis (C_1_C7_94),"PPS SERVICES COST, Laboratory (D_5_HOS_C5_60)",Initial Physician Payment Method (Y/N) (S5_C2_21),RHC 20 Provider Number (S2_1_C2_1519),Anesthesiology (D_4_IRF_C11_53),"ADJUSTED SALARIES, Non-Physician Anesthetist Part B (S3_2_C4_21)","COST SERVICES SUBJECT TO DEDUCTIBLES AND COINSURANCE - COST, PBP Clinical Lab Services Program Only (D_5_HOS_C6_61)",Whole Blood & Packed Red Blood Cells (D_4_HOS_C3_62),"Total Program Inpatient Operating Cost excluding Capital Related, Nonphysician, Anesthetist, and Medical Education Costs (D1_HOS_C1_53)",Home Office Street (S2_1_C1_142),Total Hospital (S3_1_C2_14),"General Inpatient Routine Service Cost, net of Swing Bed Cost (D1_IRF_C1_27)","Allocation of Interns & Residents Salary and Fringes, Radiology-Diagnostic (B_1_C21_54)",Pass Through Cost for  Program Ancillary (D1_HOS_C1_51),ASC (Non Distinct Part) (B_2_C26_75),RHC (A_C6_88),Medical Supplies Charged to Patients (C_1_C5_71),"COST SERVICES NOT SUBJECT TO DEDUCTIBLES AND COINSURANCE - COST, Blood Clotting Factors for Hemoph. (D_5_HOS_C7_6250)",Organ Procurement (D4_INTESTINE_C1_69),"COST SERVICES SUBJECT TO DEDUCTIBLES AND COINSURANCE - COST, Respiratory Therapy (D_5_HOS_C6_65)","Beginning Balances, Subtotal (A7_1_C1_8)",Outpatient Rehab Provider (S3_1_C8_25),Subprovider II (A_C1_4201),"If (SCH), enter the # of periods. (S2_1_C1_35)",Coronary Care Unit Program Cost (D1_HOS_C5_44),Other Special Care Unit (D3_IPF_C2_35),Recovery Room (A_C1_51),CORF (A_C6_9910),Administrative and General (A_C2_5),"COST REIMBURSED SERVICES SUBJECT TO DEDUCTIBLES  AND COINSURANCE - CHARGES, ASC (Non Distinct Part) (D_5_HOS_C3_75)","AVERAGE HOURLY WAGE, Interns & Residents (S3_2_C6_7)",Medical Supplies Charged to Patients (D_4_HOS_C4_71),"COST SERVICES NOT SUBJECT TO DEDUCTIBLES AND COINSURANCE - COST, Physical Therapy (D_5_HOS_C7_66)",RHC (B_1_C22_88),"PAID HOURS RELATED TO SALARIES, Total (S3_3_C5_6)","Allocation of Interns & Residents Program Costs, Electrocardiology (B_1_C22_69)","Net Expense for Cost Allocation, RHC (B_1_C0_88)",OPPS payments (E_B_HOS_C101_3),Protested amounts (E_B_HOS_C1_44),ASC 1 Provider Number (S2_1_C2_13),"Net Expense for Cost Allocation, Radioisotope (B_1_C0_56)",Subprovider-IPF (A_C6_40),Radiology-Therapeutic (A_C2_55),Central Services and Supply (A_C6_14),Durable Medical Equipment Rented (C_1_C6_96),Surgical Intensive Care Unit (D_1_HOS_C4_34),"Blood Storing, Processing, Trans (D_4_HOS_C11_63)","PAID HOURS RELATED TO SALARIES, Social Service (S3_2_C5_42)",Intravenous Therapy (D_4_HOS_C13_64),Radiology-Therapeutic (D3_HOS_C2_55),"ADJUSTED SALARIES, Other General Service (S3_2_C4_43)",Other Outpatient Services (D_4_SNF_C11_93),CT Scan (D_4_HOS_C13_57),"PAID HOURS RELATED TO SALARIES, Total Salaries (S3_2_C5_1)",Laboratory (D_4_SNF_C11_60),Drugs Charged to Patients (A_C6_73),Renal Dialysis (B_1_C22_74),"PAID HOURS RELATED TO SALARIES, Non-Physician Part B (S3_2_C5_6)","Net Expense for Cost Allocation, Other Outpatient Services (B_1_C0_93)","COST SERVICES NOT SUBJECT TO DEDUCTIBLES AND COINSURANCE - COST, Impl. Dev. Charged to Patients (D_5_HOS_C7_72)","COST REIMBURSED SERVICES SUBJECT TO DEDUCTIBLES  AND COINSURANCE - CHARGES, Anesthesiology (D_5_HOS_C3_53)",Operating Room (D_4_HOS_C12_50),Pancreas Acquisition (C_1_C6_109),"Percentage of patients re-using
dialyzers (S5_C1_10)",Electroencephalography (D_4_IPF_C11_70),Operating Room (D3_IPF_C3_50),Observation Beds (Distinct Unit) (D_4_HOS_C10_9201),Radiology-Therapeutic (D3_IPF_C2_55),Kidney Acquisition (B_1_C21_105),Int & Res (non approved teaching program (B_1_C22_100),Electrocardiology (A_C2_69),Other Organ Acquisition (B_1_C26_112),CMHC (B_1_C22_99),"ADJUSTED SALARIES, Subtotal Other Wages and Related Csts (S3_3_C4_4)",Employee Benefits (A_C2_4),Occupational Therapy (D_4_HOS_C11_67),Gross Revenue (G3_C1_1),Research (B_2_C26_191),Hospital Title 18 Payment System (P/T/O) (S2_1_C7_3),Number of stations (S5_C2_6),Partial or full credits from manufacturers (E_B_HOS_C1_3998),Hospital Adults & Pediatrics (S3_1_C8_1),"Purchases, Building Improvements (A7_1_C2_4)",CORF (B_1_C26_9910),"TOTAL CAPITAL COSTS AFTER COST ALLOCATION, NF (B_2_C26_45)",Electroencephalography (D_4_IPF_C13_70),Leasehold Improvements (G_C1THRU4_17),"Disposals and Retirements, Total (A7_1_C5_10)",Electrocardiology (D3_IRF_C2_69),Heart Acquisition (C_1_C5_106),"Blood Storing, Processing, Trans (D_4_HOS_C10_63)",Drugs Charged to Patients (D_4_SNF_C13_73),"HHA I, LUPA Episodes:  Total Number of Episodes (S4_HHA1_C3_36)",Target Amount per Discharge (D1_HOS_C1_55),"COST SERVICES SUBJECT TO DEDUCTIBLES AND COINSURANCE - COST, Total (D_5_HOS_C6_200)","Disposals and Retirements, Land (A7_1_C5_1)","Allocation of Interns & Residents Salary and Fringes, Intensive Care Unit (B_1_C21_31)",Outlier payments (E_B_HOS_C101_4),MRI (D3_HOS_C2_58),Occupational Therapy (C_1_C5_67),Inpatient Revenue (G2_C1_28),Speech Pathology (D3_HOS_C2_68),Impl. Dev. Charged to Patients (D_4_IPF_C11_72),Recovery Room (D_4_IPF_C13_51),"Net Expense for Cost Allocation, Ambulance Services (B_1_C0_95)",Employee Benefits (A_C1_4),"COST REIMBURSED SERVICES SUBJECT TO DEDUCTIBLES  AND COINSURANCE - CHARGES, Ambulance Services (D_5_HOS_C3_95)",Liver Acquisition (C_1_C7_107),"Number of patients transplanted 
during fiscal year (S5_C1_12)",Hospice (A_C2_116),"ADJUSTED SALARIES, Administrative and General (S3_2_C4_27)","COST REIMBURSED SERVICES NOT SUBJECT TO DEDUCTIBLES AND COINSURANCE - CHARGES, Home Program Dialysis (D_5_HOS_C4_94)","AMOUNT REPORTED, Home Office Salaries & Wage Related Csts (S3_2_C2_14)",Int & Res (non approved teaching program (B_1_C21_100),State (S2_1_C2_143),Operating Room (D_4_HOS_C13_50),Total unreimbursed and uncompensated care (S10_C1_31),Cardiac Catheterization (D_4_HOS_C12_59),Paramedical Education (A_C6_23),OOT (A_C6_9930),OSP (C_1_C6_9940),Durable Medical Equipment Sold (C_1_C5_97),Radioisotope (D3_IPF_C2_56),Intravenous Therapy (D3_IRF_C3_64),"ADJUSTED SALARIES, Subtotal Salaries (S3_3_C4_3)",Total Adults & Peds (S3_1_C6_7),FQHC 9 Provider Number (S2_1_C2_1608),IRF (S3_1_C2_17),"Average patient dialysis time 
including setup (S5_C1_3)","Total Outpatient Charges, Recovery Room (C_1_C7_51)",Recovery Room (D_4_IPF_C11_51),"Gift, Flower, Coffee Shop, Canteen (A_C1_190)",Radiology-Diagnostic (B_1_C26_54),Heart Acquisition (B_1_C22_106),Adults & Pediatrics (D_1_HOS_C6_30),Stand-alone CHIP cost (S10_C1_11),"Allocation of Interns & Residents Program Costs, Radiology-Therapeutic (B_1_C22_55)",Intravenous Therapy (D_4_SNF_C11_64),"ADJUSTED SALARIES, Laundry and Linen Service (S3_2_C4_31)","PPS SERVICES COST, Other Reimbursable (D_5_HOS_C5_98)","Total Outpatient Charges, PBP Clinical Lab Services Program Only (C_1_C7_61)","AMOUNT REPORTED, Housekeeping (S3_2_C2_32)","TOTAL CAPITAL COSTS AFTER COST ALLOCATION, Laboratory (B_2_C26_60)",Utilization Review SNF (A_C2_114),Hospital Name (S2_1_C1_3),Medical Records and Medical Rec. Library (A_C2_16),Durable Medical Equipment Sold (A_C6_97),Hospice (S3_1_C8_24),Observation Beds (Distinct Unit) (B_2_C26_9201),CORF (A_C1_9910),Intravenous Therapy (C_1_C5_64),Research (B_1_C26_191),FQHC 8 Provider Number (S2_1_C2_1607),Hospital Street Address (S2_1_C1_1),Total charges to state or local government programs for indigent care (not Medicaid or CHIP) (S10_C1_14),Other Outpatient Services (B_1_C21_93),Blood Clotting Factors for Hemoph. (C_1_C5_6250),Coronary Intensive Care Unit (D_1_HOS_C4_32),Total Program Inpatient Costs (D1_HOS_C1_49),RHC/FQHC Combined (S3_1_C8_26),Heart Acquisition (A_C6_106),"HHA I, Total Non Routine Medical  Supply Charges (S4_HHA1_C5_38)",Delivery Room and Labor Room (C_1_C5_52),Other Special Care Unit (D3_SNF_C2_35),Total costs for patients covered by a state or local government program (S10_C1_15),"Net Expense for Cost Allocation, OPT (B_1_C0_9920)",NF (S3_1_C11_20),"PAID HOURS RELATED TO SALARIES, Admin & Gen Under Contract (S3_2_C5_29)",Received DSH or supplemental payments from Medicaid? (Y/N) (S10_C1_3),Medical Supplies Charged to Patients (A_C2_71),"COST SERVICES SUBJECT TO DEDUCTIBLES AND COINSURANCE - COST, Other Outpatient Services (D_5_HOS_C6_93)",Respiratory Therapy (D3_IRF_C3_65),"Net Expense for Cost Allocation, Interns & Res Salary and Fringe Benefits (B_1_C0_21)","PAID HOURS RELATED TO SALARIES, SNF (S3_2_C5_9)",Lung  Acquisition (C_1_C5_108),CT Scan (D_4_IRF_C13_57),Home Program Dialysis (C_1_C5_94),Deductibles and coinsurance related to line 24 (E_B_HOS_C1_26),Emergency (D_4_IRF_C13_91),"PAID HOURS RELATED TO SALARIES, Administrative and General (S3_2_C5_27)",Central Services and Supply (A_C2_14),Clinic (D_4_IPF_C11_90),Clinic (D_4_HOS_C13_90),Physical Therapy (D3_SNF_C3_66),Medicare Certified Liver TC term date (S2_1_C2_128),OOT (B_1_C26_9930),"Fully Depreciated Assets, Total (A7_1_C4_7)",Subprovider I (C_1_C5_42),Adults & Pediatrics (C_1_C5_30),"Allocation of Interns & Residents Salary and Fringes, CT Scan (B_1_C21_57)","PPS REIMBURSED SERVICES -  CHARGES, Other Outpatient Services (D_5_HOS_C2_93)","Allocation of Interns & Residents Salary and Fringes, NF (B_1_C21_45)",Durable Medical Equipment Rented (C_1_C5_96),Surgical Intensive Care Unit (B_1_C26_34),"ADJUSTED SALARIES, Teaching Physician Salaries (S3_2_C4_1601)",Radiology-Therapeutic (D3_SNF_C3_55),Total Hospital (S3_1_C4_7),Coronary Care Unit (S3_1_C8_9),Delivery Room and Labor Room (D_4_HOS_C11_52),"PPS SERVICES COST, Respiratory Therapy (D_5_HOS_C5_65)",Charity care charges and uninsured discounts for the entire facility (S10_C1_20),Physical Therapy (A_C1_66),"Allocation of Interns & Residents Program Costs, Subprovider-IRF (B_1_C22_41)",Kidney Acquisition (B_1_C22_105),Hospital PO Box (S2_1_C2_1),Provider-based physician adjustment (A8_C2_10),CT Scan (B_1_C26_57),"Net Expense for Cost Allocation, HHA (B_1_C0_101)","Allocation of Interns & Residents Salary and Fringes, Other Special Care Unit (B_1_C21_35)",Notes and Loans Payable (short term) (G_C1THRU4_40),IPF (S3_1_C5_16),Drugs Charged to Patients (C_1_C5_73),Subprovider I (A_C2_42),"COST SERVICES SUBJECT TO DEDUCTIBLES AND COINSURANCE - COST, Emergency (D_5_HOS_C6_91)",Int & Res (non approved teaching program (A_C2_100),Organ acquisition charges (E_B_HOS_C1_13),HHA 2 Provider Number (S2_1_C2_1201),"PPS REIMBURSED SERVICES -  CHARGES, Total (D_5_HOS_C2_200)","COST REIMBURSED SERVICES SUBJECT TO DEDUCTIBLES  AND COINSURANCE - CHARGES, Total (D_5_HOS_C3_200)",Sequestration adjustment (E_B_HOS_C1_4001),Clinic (D_4_HOS_C4_90),"PPS REIMBURSED SERVICES -  CHARGES, MRI (D_5_HOS_C2_58)",Recovery Room (D_4_HOS_C12_51),Blood Clotting Factors for Hemoph. (D3_HOS_C2_6250),Respiratory Therapy (D_4_HOS_C3_65),Respiratory Therapy (D3_IPF_C2_65),Blood Clotting Factors for Hemoph. (D3_IPF_C2_6250),"ADJUSTED SALARIES, Wage Related Costs Other (S3_2_C4_18)",Medical Records and Medical Rec. Library (A_C6_16),"TOTAL CAPITAL COSTS AFTER COST ALLOCATION, Subprovider I (B_2_C26_42)",Electrocardiology (D_4_HOS_C11_69),"ADJUSTED SALARIES, Contract Labor:  Physician Part A (S3_2_C4_13)",Operating Room (D_4_IPF_C13_50),"Trade, Quantity, and Time Discounts (A8_C2_4)",Durable Medical Equipment Sold (B_1_C26_97),Occupational Therapy (D3_IRF_C3_67),Surgical Intensive Care Unit Program Cost (D1_HOS_C5_46),IPPS Payment amount (unadjusted) (E_A_HOS_C1_59),"AMOUNT REPORTED, Administrative & General under contract (S3_2_C2_28)",CT Scan (D_4_IPF_C11_57),Impl. Dev. Charged to Patients (D_4_HOS_C11_72),Renal 5 Provider Number (S2_1_C2_1804),Operating Room (C_1_C5_50),"Disposals and Retirements, Building Improvements (A7_1_C5_4)","PAID HOURS RELATED TO SALARIES, Nursing Administration (S3_2_C5_38)",OLTC (A_C2_46),"PPS SERVICES COST, Radiology-Diagnostic (D_5_HOS_C5_54)",ICF (C_1_C5_4501),Net revenue from state/local govt indigent care (not Medicaid or CHIP) (S10_C1_13),RHC/FQHC Combined (S3_1_C11_26),Operating Room (D_4_IRF_C11_50),"PPS REIMBURSED SERVICES -  CHARGES, Durable Medical Equipment Sold (D_5_HOS_C2_97)",Electroencephalography (D_4_HOS_C12_70),SNF (D_3_HOS_C9_44),Drugs Charged to Patients (A_C2_73),Subtotal (E_B_HOS_C1_30),"TOTAL CAPITAL COSTS AFTER COST ALLOCATION, Delivery Room and Labor Room (B_2_C26_52)",Renal 10 Provider Number (S2_1_C2_1809),"COST REIMBURSED SERVICES SUBJECT TO DEDUCTIBLES  AND COINSURANCE - CHARGES, Home Program Dialysis (D_5_HOS_C3_94)",Physical Therapy (D3_HOS_C3_66),Anesthesiology (D_4_HOS_C3_53),ASC (Non Distinct Part) (D_4_HOS_C4_75),"Gift, Flower, Coffee Shop, Canteen (B_1_C21_190)",Surgical Intensive Care Unit (D_1_HOS_C6_34),Net Income (G3_C1_29),Operating Room (D3_HOS_C2_50),"Net Expense for Cost Allocation, Laundry and Linen Service (B_1_C0_8)","Net Expense for Cost Allocation, Intensive Care Unit (B_1_C0_31)",TOTAL (D3_SNF_C2_202),Total (D_4_HOS_C12_200),Fiscal Intermediary/MAC Create Date (FI_CREAT_DT),Pancreas Acquisition (A_C2_109),Speech Pathology (D_4_HOS_C10_68),Emergency (D3_SNF_C2_91),"Total Outpatient Charges, Laboratory (C_1_C7_60)","Fully Depreciated Assets, Total (A7_1_C7_10)","Number of patients in program at 
end of cost reporting period (S5_C5_1)","COST REIMBURSED SERVICES NOT SUBJECT TO DEDUCTIBLES AND COINSURANCE - CHARGES, ASC (Non Distinct Part) (D_5_HOS_C4_75)","Allocation of Interns & Residents Program Costs, Cardiac Catheterization (B_1_C22_59)",Transitional corridor payment (E_B_HOS_C101_8),Observation Beds (Distinct Unit) (C_1_C5_9201),"PPS REIMBURSED SERVICES -  CHARGES, Electrocardiology (D_5_HOS_C2_69)",Intravenous Therapy (B_2_C26_64),"COST REIMBURSED SERVICES NOT SUBJECT TO DEDUCTIBLES AND COINSURANCE - CHARGES, Speech Pathology (D_5_HOS_C4_68)",Laboratory (D3_SNF_C2_60),Laboratory (D_4_IPF_C13_60),Interns & Res Salary and Fringe Benefits (A_C1_21),"Allocation of Interns & Residents Program Costs, Intravenous Therapy (B_1_C22_64)","HHA I, With Outliers:  Total Visits (S4_HHA1_C2_33)","ADJUSTED SALARIES, Home Office Salaries & Wage Related Csts (S3_2_C4_14)",Intensive Care Unit (A_C2_31),MRI (D_4_SNF_C11_58),Amounts expected under 42 CFR (E_B_HOS_C1_16),Emergency (B_1_C26_91),CMHC (A_C2_99),RHC 9 Provider Number (S2_1_C2_1508),Adults and Pediatrics (B_1_C26_30),"Blood Storing, Processing, Trans (D_4_HOS_C2_63)","Blood Storing, Processing, Trans (D_4_HOS_C12_63)","HHA III, PEP Episodes:  Total Visits (S4_HHA3_C4_33)",Utilization (S5_C2_8),Line 2 times line 5 (E_B_HOS_C1_6),Physical Therapy (B_1_C26_66),Nonpaid Workers (B_2_C26_193),"Percentage of patients re-using
dialyzers (S5_C2_10)","Total Outpatient Charges, Cardiac Catheterization (C_1_C7_59)",Cardiac Catheterization (D_4_HOS_C13_59),"HHA II, Total Visits (S4_HHA2_C5_33)",Relief Payment (D1_HOS_C1_62),Coronary Care Unit (A_C2_32),"COST REIMBURSED SERVICES SUBJECT TO DEDUCTIBLES  AND COINSURANCE - CHARGES, PBP Clinical Lab Services Program Only (D_5_HOS_C3_61)",Total Program Excludable Costs (D1_HOS_C1_52),Speech Pathology (A_C2_68),"Disposals and Retirements, Land (A7_1_C7_1)","Net Expense for Cost Allocation, Maintenance of Personnel (B_1_C0_12)",Renal Dialysis (B_2_C26_74),"TOTAL CAPITAL COSTS AFTER COST ALLOCATION, SNF (B_2_C26_44)",Medicare Certified Islet TC term date (S2_1_C2_132),"Net Expense for Cost Allocation, CMHC (B_1_C0_99)",Radioisotope (D3_IPF_C3_56),"PPS SERVICES COST, Blood Storing, Processing, Trans (D_5_HOS_C5_63)","Purchases, Fixed Equipment (A7_1_C2_5)",Delivery Room and Labor Room (D_4_HOS_C13_52),"COST REIMBURSED SERVICES SUBJECT TO DEDUCTIBLES  AND COINSURANCE - CHARGES, Electroencephalography (D_5_HOS_C3_70)",Medicaid charges (S10_C1_6),"COST SERVICES SUBJECT TO DEDUCTIBLES AND COINSURANCE - COST, Physical Therapy (D_5_HOS_C6_66)",Speech Pathology (A_C6_68),"Net Expense for Cost Allocation, Coronary Care Unit (B_1_C0_32)",Emergency (D_4_IPF_C11_91),Depreciation-New Bldgs & Fixtures (A8_C2_26),CT Scan (D3_HOS_C2_57),"Donations, Building Improvements (A7_1_C3_4)",Drugs Charged to Patients (D_4_IRF_C13_73),Other Ancillary (D3_IRF_C3_76),"COST SERVICES SUBJECT TO DEDUCTIBLES AND COINSURANCE - COST, Radiology-Therapeutic (D_5_HOS_C6_55)",Islet Acquisition (C_1_C7_111),Intensive Care Unit (S3_1_C7_8),"HHA II, With Outliers:  Total Visits (S4_HHA2_C2_33)",RHC 14 Provider Number (S2_1_C2_1513),"Net Expense for Cost Allocation, Adults and Pediatrics (B_1_C0_30)",Delivery Room and Labor Room (D3_IPF_C3_52),Burn Intensive Care Unit (D_3_HOS_C9_33),Nursery (B_1_C26_43),Payment to cost ratio (E_B_HOS_C101_5),"Net Expense for Cost Allocation, Operation of Plant (B_1_C0_7)","PPS SERVICES COST, Recovery Room (D_5_HOS_C5_51)","PPS SERVICES COST, Clinic (D_5_HOS_C5_90)",State or local govt (not Medicaid or CHIP) -- Costs minus net revenue (0 min) (S10_C1_16),"Net Expense for Cost Allocation, Anesthesiology (B_1_C0_53)",Utilization Code (L/N/F) (UTIL_CODE),Drugs Charged to Patients (D_4_HOS_C10_73),"Net Expense for Cost Allocation, New Capital Buildings and Fixtures (B_1_C0_1)","AVERAGE HOURLY WAGE, SNF (S3_2_C6_9)",Renal Dialysis (D_4_SNF_C11_74),Burn Intensive Care Unit (A_C1_33),Title XIX discharges (S3_1_C14_1),"ADJUSTED SALARIES, Non-Physician Anesthetist Part A (S3_2_C4_2)",Interest expense on Medicare Overpaymts (A8_C2_22),Electroencephalography (C_1_C7_70),Anesthesiology (D3_IPF_C2_53),PBP Clinical Lab Services Program Only (D3_IRF_C3_61),Blood Clotting Factors for Hemoph. (A_C1_6250),Fiscal Year End Date (FY_END_DT),"AMOUNT REPORTED, Maintenance and Repairs (S3_2_C2_29)",Renal Dialysis (D_4_HOS_C11_74),"COST REIMBURSED SERVICES NOT SUBJECT TO DEDUCTIBLES AND COINSURANCE - CHARGES, Total (D_5_HOS_C4_200)","Net Expense for Cost Allocation, Other Special Care Unit (B_1_C0_35)",Clinic (D3_HOS_C3_90),"AMOUNT REPORTED, Interns & Residents (S3_2_C3_2553)",Medical Supplies Charged to Patients (D_4_SNF_C11_71),Fiscal Intermediary Number (FI_NUM),Respiratory Therapy (D_4_HOS_C13_65),Radiology-Diagnostic (D3_IRF_C2_54),"Allocation of Interns & Residents Program Costs, Whole Blood & Packed Red Blood Cells (B_1_C22_62)",Emergency (D_4_HOS_C10_91),"TOTAL CAPITAL COSTS AFTER COST ALLOCATION, Operating Room (B_2_C26_50)",Other Ancillary (D3_SNF_C2_76),"AMOUNT REPORTED, Physician Part B (S3_2_C3_23)",Physical Therapy (C_1_C5_66),"AVERAGE HOURLY WAGE, Subtotal Other Wages and Related Csts (S3_3_C6_4)","COST SERVICES NOT SUBJECT TO DEDUCTIBLES AND COINSURANCE - COST, Other Ancillary (D_5_HOS_C7_76)",Coronary Care Unit (C_1_C5_32),"ADJUSTED SALARIES, Net Salaries (S3_3_C4_1)",Sale of medical and surgical supplies to (A8_C2_16),"ADJUSTED SALARIES, Physician-Part B (S3_2_C4_5)",Renal Dialysis (D_4_IPF_C13_74),"HHA II, Total Non Routine Medical  Supply Charges (S4_HHA2_C5_38)","Total Inpatient Charges, Radiology-Diagnostic (C_1_C6_54)",Blood Clotting Factors for Hemoph. (A_C6_6250),Emergency (D_4_HOS_C1_91),Other Ancillary (C_1_C5_76),"Income from imposition of interest, finance (A8_C2_21)",Delivery Room and Labor Room (D_4_HOS_C2_52),Rental of quarters to employee and oths (A8_C2_15),"HHA II, LUPA Episodes:  Other Charges (S4_HHA2_C3_34)",Total Facility (S3_1_C2_27),Radiology-Diagnostic (D_4_HOS_C12_54),TOTAL (D3_HOS_C3_200),Less Contractual Allowance and Discounts on Patients' Accounts (G3_C1_2),Subprovider 1 (S3_1_C3_18),Operating Room (D_4_HOS_C10_50),"COST REIMBURSED SERVICES SUBJECT TO DEDUCTIBLES  AND COINSURANCE - CHARGES, Blood Clotting Factors for Hemoph. (D_5_HOS_C3_6250)",Renal Dialysis (D_4_HOS_C2_74),Subprovider 1 (S3_1_C7_18),Medical Supplies Charged to Patients (D3_IPF_C3_71),Other Reimbursable (C_1_C7_98),"Number of days in year dialysis 
furnished (S5_C5_2)",Interest Expense (A_C6_113),"Net Expense for Cost Allocation, Other General Service (B_1_C0_18)",Radiology-Diagnostic (D3_SNF_C2_54),Durable Medical Equipment Rented (B_1_C26_96),Notes Receivable (G_C1THRU4_3),OOT (A_C2_9930),MRI (D_4_IPF_C11_58),"Allocation of Interns & Residents Salary and Fringes, Laboratory (B_1_C21_60)",New Capital Buildings and Fixtures (A_C6_1),RHC (B_1_C26_88),Intensive Care Unit (S3_1_C2_8),Title V discharges (S3_1_C12_1),"AMOUNT REPORTED, Laundry and Linen Service (S3_2_C2_31)",Intensive Care Unit (D_3_HOS_C9_31),Total (D_4_HOS_C1_200),IRF (S3_1_C5_17),Other Outpatient Services (D_4_HOS_C11_93),Radioisotope (D3_SNF_C2_56),Clinic (D3_SNF_C3_90),"TOTAL CAPITAL COSTS AFTER COST ALLOCATION, Recovery Room (B_2_C26_51)",Respiratory Therapy (D_4_SNF_C11_65),Clinic (B_1_C26_90),"PPS REIMBURSED SERVICES -  CHARGES, Radiology-Therapeutic (D_5_HOS_C2_55)",Utilization Review - Physician Compen (D1_SNF_C1_85),"TOTAL CAPITAL COSTS AFTER COST ALLOCATION, Subprovider-IRF (B_2_C26_41)",Title XVIII discharges (S3_1_C13_16),Physical Therapy (D_4_HOS_C3_66),"COST SERVICES NOT SUBJECT TO DEDUCTIBLES AND COINSURANCE - COST, Blood Storing, Processing, Trans (D_5_HOS_C7_63)",SSA State County Code (ST_CTY_CD),Radiology-Diagnostic (D_4_IPF_C11_54),Clinic (D3_IPF_C2_90),"Allocation of Interns & Residents Program Costs, Other Special Care Unit (B_1_C22_35)",Other General Service (A_C2_18),"ADJUSTED SALARIES, Physician Part B (S3_2_C4_23)",Nonphysician Anesthetists (A_C2_19),Durable Medical Equipment Sold (B_2_C26_97),Cardiac Catheterization (D_4_HOS_C4_59),RHC 13 Provider Number (S2_1_C2_1512),Research (A_C1_191),Other Ancillary (D3_HOS_C3_76),Medicaid Observation Days (S3_1_C8_28),Durable Medical Equipment Rented (A_C6_96),Deductibles and coinsurance (E_B_HOS_C1_25),"Allocation of Interns & Residents Salary and Fringes, Subprovider-IRF (B_1_C21_41)","HHA III, W/Out Outliers:  Number of Episodes (S4_HHA3_C1_36)",Radioisotope (D_4_IPF_C11_56),"PPS SERVICES COST, Radiology-Therapeutic (D_5_HOS_C5_55)",Intravenous Therapy (D_4_IRF_C13_64),OPT (B_1_C26_9920),"PPS REIMBURSED SERVICES -  CHARGES, Radiology-Diagnostic (D_5_HOS_C2_54)","Total Inpatient Charges, Radioisotope (C_1_C6_56)",Other Outpatient Services (D_4_HOS_C4_93),ICF (A_C6_4501),Islet Acquisition (A_C2_111),Total (D_4_IPF_C13_200),Subprovider-IPF (D_1_HOS_C7_40),Kidney Acquisition (B_1_C26_105),"Net Expense for Cost Allocation, Whole Blood & Packed Red Blood Cells (B_1_C0_62)",Total Hospital (S3_1_C3_14),Heart Acquisition (C_1_C7_106),Payments received from patients for amounts previously written off as charity care (S10_C3_22),Electroencephalography (D_4_SNF_C11_70),Observation Beds (Distinct Unit) (D3_IRF_C2_9201),Subprovider I (D3_IPF_C2_42),Other Ancillary (C_1_C6_76),SNF (S3_1_C9_19),Interns & Res Salary and Fringe Benefits (A_C6_21),Electroencephalography (D3_IPF_C2_70),"Net Expense for Cost Allocation, Burn Intensive Care Unit (B_1_C0_33)",Electroencephalography (D3_IRF_C2_70),Total discharges (S3_1_C15_21),Observation Beds (Distinct Unit) (C_1_C6_9201),"AMOUNT REPORTED, Central Services and Supply (S3_2_C2_39)","ADJUSTED SALARIES, Social Service (S3_2_C4_42)",Fiscal Year Begin Date (FY_BGN_DT),Observation Beds (Distinct Unit) (D_4_IPF_C11_9201),Other Ancillary (A_C6_76),Blood Clotting Factors for Hemoph. (B_1_C26_6250),Total Liabilities (G_C1THRU4_51),"Net Expense for Cost Allocation, Blood Clotting Factors for Hemoph. (B_1_C0_6250)",Electrocardiology (D_4_IRF_C11_69),Radiology-Diagnostic (D_4_HOS_C4_54),"Total, Total (A7_3_C15_3)",HHA (C_1_C7_101),ICF (S3_1_C2_2001),Total Salaries (A_C6_200),MRI (D3_SNF_C2_58),CT Scan (D_4_IRF_C11_57),Electrocardiology (A_C6_69),Respiratory Therapy (D3_IRF_C2_65),Speech Pathology (D_4_IRF_C11_68),Subprovider I (A_C6_42),Intravenous Therapy (D3_IRF_C2_64),Emergency (D3_IPF_C2_91),"COST SERVICES SUBJECT TO DEDUCTIBLES AND COINSURANCE - COST, Electroencephalography (D_5_HOS_C6_70)",Ancillary service charges (E_B_HOS_C1_12),RHC 15 Provider Number (S2_1_C2_1514),Respiratory Therapy (D3_SNF_C3_65),Laboratory (C_1_C5_60),"Allocation of Interns & Residents Salary and Fringes, Interns & Res Salary and Fringe Benefits (B_1_C21_21)",Physical Therapy (C_1_C6_66),"HHA I, PEP Episodes:  Total Charges: (S4_HHA1_C4_35)",Delivery Room and Labor Room (D_4_HOS_C4_52),Electrocardiology (A_C1_69),Renal Dialysis (D3_SNF_C2_74),Coronary Intensive Care Unit (D_1_HOS_C6_32),CT Scan (D_4_HOS_C11_57),"Gift, Flower, Coffee Shop, Canteen (A_C2_190)",Renal Dialysis (D_4_HOS_C3_74),Allowable bad debts for dual eligibles beneficiaries (E_B_HOS_C1_36),Hospice (C_1_C6_116),CAPD exchanges per day (S5_C4_4),"Net Expense for Cost Allocation, Social Service (B_1_C0_17)",Renal Dialysis (D3_IPF_C2_74),CT Scan (D3_IRF_C2_57),Radiology-Diagnostic (D_4_HOS_C13_54),Whole Blood & Packed Red Blood Cells (D_4_HOS_C12_62),"COST SERVICES SUBJECT TO DEDUCTIBLES AND COINSURANCE - COST, Recovery Room (D_5_HOS_C6_51)",Self Insurance (S2_1_C3_11801),Speech Pathology (C_1_C2_68),FQHC (A_C1_89),Pass through Cost for Program Inpatient (D1_IRF_C1_50),Home Program Dialysis (C_1_C6_94),Radiology-Therapeutic (D3_IRF_C2_55),Burn Intensive Care Unit (A_C2_33),"AVERAGE HOURLY WAGE, Housekeeping (S3_2_C6_32)","Allocation of Interns & Residents Salary and Fringes, Radiology-Therapeutic (B_1_C21_55)",Total (D_4_HOS_C13_200),Title XVIII discharges (S3_1_C13_14),HHA (B_1_C22_101),Other Ancillary (D_4_HOS_C4_76),Emergency (D3_SNF_C3_91),Observation Beds (Distinct Unit) (D_4_HOS_C13_9201),Recovery Room (D3_HOS_C3_51),Intravenous Therapy (D_4_IRF_C11_64),Impl. Dev. Charged to Patients (D3_HOS_C3_72),Adults & Pediatrics (D_1_HOS_C4_30),"COST REIMBURSED SERVICES NOT SUBJECT TO DEDUCTIBLES AND COINSURANCE - CHARGES, Durable Medical Equipment Rented (D_5_HOS_C4_96)",Speech Pathology (D3_IRF_C2_68),Other Outpatient Services (D_4_HOS_C3_93),"AMOUNT REPORTED, Excluded Area Salaries (S3_3_C2_2)",ASC (Non Distinct Part) (C_1_C7_75),MCP Physician Payment Method (Y/N) (S5_C1_21),RHC 10 Provider Number (S2_1_C2_1509),Intestinal Acquisition (C_1_C5_110),"COST REIMBURSED SERVICES NOT SUBJECT TO DEDUCTIBLES AND COINSURANCE - CHARGES, Intravenous Therapy (D_5_HOS_C4_64)",Physicians' Private Office (A_C6_192),"If this Hospital is claiming cost for renal services on Worksheet A, are they inpatient services only? (Y/N) (S2_1_C1_145)",Cardiac Catheterization (D_4_HOS_C3_59),"AMOUNT REPORTED, Non-Physician Anesthetist Part A (S3_2_C2_20)","COST REIMBURSED SERVICES NOT SUBJECT TO DEDUCTIBLES AND COINSURANCE - CHARGES, Radiology-Therapeutic (D_5_HOS_C4_55)",Observation Beds (Distinct Unit) (D_4_HOS_C3_9201),ASC (Distinct Part) (C_1_C7_115),MRI (B_1_C26_58),Subprovider-IRF (D_1_HOS_C6_41),Operating Room (D3_HOS_C3_50),Housekeeping (A_C6_9),"ADJUSTED SALARIES, Maintenance of Personnel (S3_2_C4_37)",Occupational Therapy (D3_SNF_C3_67),Other Adjustments (Summed) (A8_C2_33),Other Special Care (S3_1_C8_12),CT Scan (D_4_HOS_C2_57),Total Adults & Peds (S3_1_C7_7),"COST REIMBURSED SERVICES NOT SUBJECT TO DEDUCTIBLES AND COINSURANCE - CHARGES, Impl. Dev. Charged to Patients (D_5_HOS_C4_72)",HHA (B_1_C26_101),Subtotal (C_1_C5_200),Cardiac Catheterization (D3_HOS_C3_59),Other Ancillary (D3_IRF_C2_76),"COST SERVICES SUBJECT TO DEDUCTIBLES AND COINSURANCE - COST, Home Program Dialysis (D_5_HOS_C6_94)",Title V discharges (S3_1_C12_16),Intestinal Acquisition (C_1_C6_110),"PPS SERVICES COST, Drugs Charged to Patients (D_5_HOS_C5_73)",Temporary Investments (G_C1THRU4_2),"HHA II, Total Number of Episodes (S4_HHA2_C5_36)",Liver Acquisition (A_C6_107),Other General Service (A_C1_18),"PAID HOURS RELATED TO SALARIES, Management and Administrative Services (S3_2_C5_12)",RHC/FQHC Combined (S3_1_C10_26),"ADJUSTED SALARIES, Related Salaries (S3_2_C4_1402)",IRF Provider Number (S2_1_C1_5),"Disposals and Retirements, Building Improvements (A7_1_C7_4)",Surgical Intensive Care Unit (S3_1_C8_11),"Blood Storing, Processing, Trans (D_4_IPF_C13_63)",Cardiac Catheterization (D_4_IPF_C11_59),Total (D_4_IPF_C11_200),"ADJUSTED SALARIES, Operation of Plant (S3_2_C4_30)",Hospital Adlts & Ped Swing Bed NF (S3_1_C7_6),Other Outpatient Services (D3_HOS_C2_93),MRI (D3_IPF_C3_58),Emergency (B_1_C21_91),RHC 23 Provider Number (S2_1_C2_1522),"PPS REIMBURSED SERVICES -  CHARGES, ASC (Non Distinct Part) (D_5_HOS_C2_75)","TOTAL CAPITAL COSTS AFTER COST ALLOCATION, Blood Clotting Factors for Hemoph. (B_2_C26_6250)",Renal Dialysis (A_C2_74),"Net Expense for Cost Allocation, Physicians' Private Office (B_1_C0_192)",Clinic (D3_IPF_C3_90),Nursing School (A_C6_20),Parking Lot (A8_C2_9),RHC 6 Provider Number (S2_1_C2_1505),"AMOUNT REPORTED, Dietary under contract (S3_2_C2_35)","COST SERVICES NOT SUBJECT TO DEDUCTIBLES AND COINSURANCE - COST, Radiology-Diagnostic (D_5_HOS_C7_54)",Impl. Dev. Charged to Patients (D_4_IRF_C13_72),"Net Expense for Cost Allocation, Respiratory Therapy (B_1_C0_65)","TOTAL CAPITAL COSTS AFTER COST ALLOCATION, Radioisotope (B_2_C26_56)","HHA III, Without Outliers:  Other Charges (S4_HHA3_C1_34)",HMO (S3_1_C7_2),CT Scan (D_4_IPF_C13_57),Observation Beds (Distinct Unit) (D_4_SNF_C11_9201),Whole Blood & Packed Red Blood Cells (D3_HOS_C3_62),Observation Beds (Distinct Unit) (D_4_HOS_C2_9201),Speech Pathology (D3_IPF_C3_68),Home Program Dialysis (D3_IRF_C3_94),Accounts Payable (G_C1THRU4_37),Radiology-Therapeutic (D_4_IRF_C11_55),Operating Room (D3_SNF_C3_50),"Allocation of Interns & Residents Salary and Fringes, Nursery (B_1_C21_43)",Impl. Dev. Charged to Patients (D_4_SNF_C11_72),"AVERAGE HOURLY WAGE, Contract Labor (S3_2_C6_11)","COST SERVICES SUBJECT TO DEDUCTIBLES AND COINSURANCE - COST, Intravenous Therapy (D_5_HOS_C6_64)","Total Inpatient Charges, Subprovider-IPF (C_1_C6_40)","COST REIMBURSED SERVICES SUBJECT TO DEDUCTIBLES  AND COINSURANCE - CHARGES, Radiology-Diagnostic (D_5_HOS_C3_54)",Burn Intensive Care Unit (S3_1_C8_10),Medical Supplies Charged to Patients (D_4_HOS_C12_71),Ambulance Services (B_1_C21_95),NF Provider Number (S2_1_C2_10),Laboratory (A_C1_60),"Total Inpatient Charges, Recovery Room (C_1_C6_51)",Ratio of line 15 to line 16 (E_B_HOS_C1_17),ASC (Non Distinct Part) (D3_IRF_C2_75),"Total Inpatient Charges, CT Scan (C_1_C6_57)",Respiratory Therapy (D_4_HOS_C2_65),Vending Machines (A8_C2_20),Intensive Care Unit (C_1_C5_31),HHA (S3_1_C9_22),ASC (Distinct Part) (A_C2_115),Administrative and General (A_C1_5),"Allocation of Interns & Residents Salary and Fringes, MRI (B_1_C21_58)","HHA II, PEP:  Total Non Routine Med Supply Chgs (S4_HHA2_C4_38)",Lung  Acquisition (B_2_C26_108),"PPS SERVICES COST, Impl. Dev. Charged to Patients (D_5_HOS_C5_72)",Intravenous Therapy (C_1_C7_64),Total (D_4_SNF_C13_200),Intensive Care Unit (D_1_HOS_C7_31),"Allocation of Interns & Residents Salary and Fringes, OLTC (B_1_C21_46)",CT Scan (D3_IRF_C3_57),Other Reimbursable (C_1_C6_98),Operating Room (D_4_HOS_C4_50),Radiology-Diagnostic (D_4_HOS_C2_54),Stand-alone CHIP Charges (Gross Revenue) (S10_C1_10),"Allocation of Interns & Residents Salary and Fringes, Physical Therapy (B_1_C21_66)","Other Capital Related Costs, Total (A7_3_C7_3)",Labor and Delivery Days -  Title XIX (S3_1_C7_32),"PAID HOURS RELATED TO SALARIES, Non-Physician Anesthetist Part B (S3_2_C5_3)","HHA I, Total Charges:  LUPA Episodes (S4_HHA1_C3_35)",Other Ancillary (D_4_IRF_C13_76),"ADJUSTED SALARIES, Home Office:  Physician Part A (S3_2_C4_15)","Net Expense for Cost Allocation, OSP (B_1_C0_9940)","Net Expense for Cost Allocation, ASC (Distinct Part) (B_1_C0_115)","TOTAL CAPITAL COSTS AFTER COST ALLOCATION, Burn Intensive Care Unit (B_2_C26_33)","Beginning Balances, Fixed Equipment (A7_1_C1_5)",OOT (B_2_C26_9930),Hospice (B_1_C26_116),RPCH/CAH Visits (S3_1_C7_15),Durable Medical Equipment Rented (D3_HOS_C3_96),"Medicare certified kidney 
transplant center cert date (S2_1_C1_126)",Title XVIII discharges (S3_1_C13_18),"AMOUNT REPORTED, Home Office Personnel (S3_2_C2_8)","ADJUSTED SALARIES, Interns & Residents (S3_2_C4_2552)",Occupational Therapy (B_1_C26_67),Maintenance and Repairs (A_C2_6),IPF (S3_1_C2_16),"Allocation of Interns & Residents Salary and Fringes, Subprovider I (B_1_C21_42)",SNF (S3_1_C3_19),Rental of Provider space by suppliers (A8_C2_6),"PPS SERVICES COST, Whole Blood & Packed Red Blood Cells (D_5_HOS_C5_62)",CT Scan (D3_IPF_C3_57),Other Ancillary (B_1_C22_76),"Is this a teaching hospital or
affiliated with a teaching hospital? (Y/N) (S2_1_C1_56)",Other Special Care (S3_1_C4_12),Clinic (D3_IRF_C2_90),"Net Expense for Cost Allocation, Pharmacy (B_1_C0_15)",Physical Therapy (D_4_IRF_C13_66),"AVERAGE HOURLY WAGE, Net Salaries (S3_3_C6_1)",PBP Clinical Lab Services Program Only (A_C6_61),Anesthesiology (D_4_HOS_C2_53),"Number of patients in program at 
end of cost reporting period (S5_C1_1)",Nursing School (A_C2_20),Medical Supplies Charged to Patients (D_4_HOS_C10_71),"PPS SERVICES COST, Occupational Therapy (D_5_HOS_C5_67)",Occupational Therapy (D_4_HOS_C13_67),Burn Intensive Care Unit (C_1_C5_33),"TOTAL CAPITAL COSTS AFTER COST ALLOCATION, ICF (B_2_C26_4501)","TOTAL CAPITAL COSTS AFTER COST ALLOCATION, Whole Blood & Packed Red Blood Cells (B_2_C26_62)",Electrocardiology (C_1_C5_69),Nonpaid Workers (B_1_C26_193),Durable Medical Equipment Rented (D3_IPF_C2_96),Net Revenue from Medicaid (S10_C1_2),Burn Intensive Care Unit (S3_1_C5_10),"AVERAGE HOURLY WAGE, Home Office Salaries (S3_2_C6_1401)",Speech Pathology (D_4_IPF_C11_68),Radiology-Diagnostic (D3_IPF_C2_54),Other Reimbursable (D3_IRF_C3_98),FQHC 2 Provider Number (S2_1_C2_1601),Respiratory Therapy (A_C2_65),Other Nonreimbursable (A_C1_194),"Allocation of Interns & Residents Program Costs, Subprovider-IPF (B_1_C22_40)","Net Expense for Cost Allocation, Physical Therapy (B_1_C0_66)",Beginning Date of SCH status (S2_1_C1_3601),Drugs Charged to Patients (B_1_C26_73),Emergency (D3_IRF_C2_91),IPF (S3_1_C6_16),Administrative and General (A_C6_5),"Blood Storing, Processing, Trans (B_2_C26_63)","Blood Storing, Processing, Trans (D3_HOS_C3_63)","ADJUSTED SALARIES, Management and Administrative Services (S3_2_C4_12)",Delivery Room and Labor Room (D3_HOS_C3_52),"Total Inpatient Charges, NF (C_1_C6_45)","Total Program Inpatient Operating Cost excluding Capital Related, Nonphysician, Anesthetist, and Medical Education Costs (D1_IPF_C1_53)",Interns & Res Other Program Costs (A_C2_22),PBP Clinical Lab Services Program Only (D3_IRF_C2_61),"AVERAGE HOURLY WAGE, Administrative and General (S3_2_C6_27)",Subtotal (E_B_HOS_C1_40),Total Salaries (A_C1_200),Hospice (A_C6_116),Pancreas Acquisition (C_1_C7_109),Nursery (S3_1_C7_13),"AMOUNT REPORTED, Total Salaries (S3_2_C2_1)","Purchases, Subtotal (A7_1_C2_8)",Home Program Dialysis (A_C1_94),Total Outpatient Program Pass Thru Cost (D_4_IPF_C6_200),Unsecured Loans (G_C1THRU4_48),Radioisotope (D3_HOS_C3_56),"PPS REIMBURSED SERVICES -  CHARGES, Blood Clotting Factors for Hemoph. (D_5_HOS_C2_6250)","Net Expense for Cost Allocation, Emergency (B_1_C0_91)",Other Special Purpose (B_1_C22_117),"Disposals and Retirements, Fixed Equipment (A7_1_C7_5)",RHC 24 Provider Number (S2_1_C2_1523),"Net Expense for Cost Allocation, Pancreas Acquisition (B_1_C0_109)",SNF (B_1_C26_44),Physicians' Assistant (A8_C2_29),Cost of charity care (patients covered by public program + patients w/ coverage accepted by provider) (S10_C2_23),Cardiac Catheterization (D3_IRF_C3_59),"Average patient dialysis time 
including setup (S5_C3_3)",CT Scan (D_4_HOS_C10_57),"HHA II, PEP Episodes:  Total Charges: (S4_HHA2_C4_35)","ADJUSTED SALARIES, Physician-Part A (S3_2_C4_4)",Subprovider 1 (S3_1_C2_18),"Total Inpatient Charges, Other Special Care Unit (C_1_C6_35)",Radioisotope (C_1_C5_56),Payment to cost ratio (E_B_HOS_C1_5),Speech Pathology (D_4_HOS_C3_68),Whole Blood & Packed Red Blood Cells (D_4_HOS_C11_62),Number of Times per week Patient receives Dialysis (S5_C1_2),Intravenous Therapy (C_1_C6_64),Operating Room (B_1_C26_50),Total (C_1_C7_202),Recovery Room (A_C2_51),Intensive Care Unit (D3_HOS_C2_31),"AMOUNT REPORTED, Non-Physician Anesthetist Part B (S3_2_C2_21)",Social Service (A_C6_17),Total Costs (C_1_C3_202),Other Reimbursable (D3_SNF_C2_98),NF (S3_1_C3_20),Other Nonreimbursable (A_C6_194),Other Nonreimbursable (B_1_C21_194),"TOTAL CAPITAL COSTS AFTER COST ALLOCATION, MRI (B_2_C26_58)","Net Expense for Cost Allocation, Other Nonreimbursable (B_1_C0_194)","AMOUNT REPORTED, Interns & Residents (S3_2_C3_2551)","COST REIMBURSED SERVICES SUBJECT TO DEDUCTIBLES  AND COINSURANCE - CHARGES, Medical Supplies Charged to Patients (D_5_HOS_C3_71)","ADJUSTED SALARIES, Dietary (S3_2_C4_34)",Subprovider II (C_1_C5_4201),Swing Bed NF Provider Number (S2_1_C2_8),"Blood Storing, Processing, Trans (D3_IPF_C3_63)",FQHC (A_C6_89),Hospital City (S2_1_C1_2),NF (A_C1_45),Program Inpatient Ancillary Service Cost (D1_HOS_C1_48),"Sale of scrap, waste, etc. (A8_C2_11)",HHA (S3_1_C7_22),Emergency (D3_IRF_C3_91),"AVERAGE HOURLY WAGE, Employee Benefits (S3_2_C6_26)",Physicians' Private Office (A_C1_192),Recovery Room (D3_SNF_C2_51),"Medical certified lung
transplant center cert date (S2_1_C1_129)",Cardiac Catheterization (D_4_HOS_C10_59),Are provider based physicians' costs included in Worksheet A? (Y/N) (S2_1_C1_144),MDH status beginning date (MM/DD/YY) (S2_1_C1_38),Other Special Care Unit (D_1_HOS_C4_35),Recovery Room (D_4_IRF_C11_51),"AVERAGE HOURLY WAGE, Non-Physician Part B (S3_2_C6_6)",Medicare allowable bad debts for the entire hospital complex (S10_C1_2701),HHA (S3_1_C10_22),Intestinal Acquisition (A_C6_110),Electrocardiology (D3_SNF_C2_69),Impl. Dev. Charged to Patients (D3_IRF_C2_72),OPT (A_C2_9920),"Allocation of Interns & Residents Salary and Fringes, Blood Storing, Processing, Trans (B_1_C21_63)",Total Hospital (S3_1_C4_14),"AMOUNT REPORTED, Physician-Part A (S3_2_C2_4)",ASC (Non Distinct Part) (A_C6_75),"Net Expense for Cost Allocation, Delivery Room and Labor Room (B_1_C0_52)",Respiratory Therapy (A_C6_65),"COST REIMBURSED SERVICES NOT SUBJECT TO DEDUCTIBLES AND COINSURANCE - CHARGES, CT Scan (D_5_HOS_C4_57)","PAID HOURS RELATED TO SALARIES, Housekeeping under Contract (S3_2_C5_33)","Net Expense for Cost Allocation, Subprovider-IRF (B_1_C0_41)",Renal Dialysis (D_4_HOS_C13_74),CORF (C_1_C6_9910),"Allocation of Interns & Residents Program Costs, Operating Room (B_1_C22_50)",Hospital Adults & Pediatrics (S3_1_C5_1),Durable Medical Equipment Rented (D_4_HOS_C3_96),Home Program Dialysis (D_4_HOS_C11_94),"AVERAGE HOURLY WAGE, Non-Physician Anesthetist Part B (S3_2_C6_3)","Net Expense for Cost Allocation, OLTC (B_1_C0_46)",Home Program Dialysis (D3_SNF_C2_94),Drugs Charged to Patients (D_4_HOS_C1_73),Other Organ Acquisition (C_1_C7_112),Cost of patients approved for charity care and uninsured discounts (S10_C1_21),Total Fund Balances (G_C1THRU4_53),"Depreciation, New Cap Related Csts Movable Equipment (A7_3_C9_2)",Subprovider-IRF (A_C1_41),Less Observation Beds (C_1_C5_201),Cafeteria (A_C2_11),Speech Pathology (D_4_HOS_C13_68),ASC (Non Distinct Part) (D_4_HOS_C10_75),Observation Beds (Distinct Unit) (D3_HOS_C3_9201),"HHA II, LUPA Episodes:  Total Visits (S4_HHA2_C3_33)",Impl. Dev. Charged to Patients (D_4_HOS_C10_72),"HHA I, Without Outliers:  Other Charges (S4_HHA1_C1_34)",Other Reimbursable (D_4_HOS_C3_98),Electroencephalography (D3_SNF_C2_70),Operation of Plant (A_C6_7),Emergency (D3_HOS_C3_91),RHC (A_C2_88),Speech Pathology (D3_IPF_C2_68),Medical Supplies Charged to Patients (D3_HOS_C2_71),"Difference between Adjusted Inpatient, Operating Cost and Target Amount (D1_HOS_C1_57)",Observation Beds (Distinct Unit) (C_1_C7_9201),Drugs Charged to Patients (A_C1_73),Respiratory Therapy (D_4_IPF_C13_65),"AVERAGE HOURLY WAGE, Physician-Part A (S3_2_C6_4)",CMHC (C_1_C6_99),Maintenance and Repairs (A_C6_6),"COST REIMBURSED SERVICES SUBJECT TO DEDUCTIBLES  AND COINSURANCE - CHARGES, Drugs Charged to Patients (D_5_HOS_C3_73)",Laboratory (A_C2_60),"Taxes, New Cap Related Csts Bldg & Fixtures (A7_3_C6_1)",CT Scan (C_1_C5_57),"Allocation of Interns & Residents Program Costs, Speech Pathology (B_1_C22_68)",Hospital Adults & Pediatrics (S3_1_C7_1),Clinic (C_1_C6_90),"Total Inpatient Charges, Nursery (C_1_C6_43)",Laundry and Linen Service (A8_C2_13),Coronary Care Unit (S3_1_C3_9),"Net Expense for Cost Allocation, CORF (B_1_C0_9910)",Electrocardiology (B_2_C26_69),Radiology-Diagnostic (D_4_IRF_C13_54),Observation Beds (Distinct Unit) (A_C1_9201),"ADJUSTED SALARIES, Housekeeping under contract (S3_2_C4_33)","AMOUNT REPORTED, Related  Salaries (S3_2_C2_1402)",Lung  Acquisition (B_1_C26_108),Electroencephalography (D_4_HOS_C3_70),SNF (S3_1_C8_19),"Total, New Cap Related Csts Bldg & Fixtures (A7_3_C15_1)","HHA I, PEP Episodes:  Total Visits (S4_HHA1_C4_33)","Net Expense for Cost Allocation, PBP Clinical Lab Services Program Only (B_1_C0_61)",RHC/FQHC Combined (S3_1_C9_26),Physical Therapy (D3_IPF_C2_66),MRI (D3_HOS_C3_58),Home Program Dialysis (B_1_C22_94),ASC (Distinct Part) (C_1_C6_115),"If an Organ Procurement Organization, enter the OPO number (S2_1_C1_134)",Medical Supplies Charged to Patients (D3_IRF_C3_71),"ADJUSTED SALARIES, Housekeeping (S3_2_C4_32)",Occupational Therapy (C_1_C6_67),Total Inpatient Program Days (D_3_HOS_C8_200),"COST SERVICES NOT SUBJECT TO DEDUCTIBLES AND COINSURANCE - COST, Clinic (D_5_HOS_C7_90)","PPS REIMBURSED SERVICES -  CHARGES, Other Ancillary (D_5_HOS_C2_76)",Subprovider-IRF (D3_HOS_C2_41),Urban (1) or Rural (2) (S2_1_C1_27),Medical Supplies Charged to Patients (D_4_IPF_C13_71),Ambulance Services (A_C6_95),"Total Outpatient Charges, MRI (C_1_C7_58)",Anesthesiology (A_C1_53),Electrocardiology (D3_HOS_C3_69),"COST REIMBURSED SERVICES NOT SUBJECT TO DEDUCTIBLES AND COINSURANCE - CHARGES, Respiratory Therapy (D_5_HOS_C4_65)",Hospital Zip Code (S2_1_C3_2),"Allocation of Interns & Residents Program Costs, Coronary Care Unit (B_1_C22_32)",Intensive Care Unit (S3_1_C4_8),Balance due provider/program (E_B_HOS_C1_43),"PPS SERVICES COST, Other Ancillary (D_5_HOS_C5_76)",Physical Therapy (D3_SNF_C2_66),SNF (A_C1_44),Total Subprovider I Interns & Residents (S3_1_C10_18),Intravenous Therapy (A_C6_64),Pancreas Acquisition (A_C6_109),Impl. Dev. Charged to Patients (C_1_C7_72),Pass Through Cost for  Program Ancillary (D1_IRF_C1_51),Lung  Acquisition (C_1_C6_108),Dietary (A_C6_10),Radiology-Diagnostic (D3_HOS_C2_54),Laboratory (D_4_IRF_C13_60),Home Program Dialysis (B_2_C26_94),Paramedical Education (A_C2_23),Recovery Room (D_4_HOS_C11_51),Surgical Intensive Care Unit (S3_1_C5_11),Home Program Dialysis (A_C6_94),Other Outpatient Services (D_4_HOS_C12_93),Surgical Intensive Care Unit (D3_SNF_C2_34),"PAID HOURS RELATED TO SALARIES, Non-Physician Anesthetist Part A (S3_2_C5_2)","Purchases, Land Improvements (A7_1_C2_2)",CAPD exchanges per day (S5_C6_4),Other Special Purpose (A_C2_117),OOT (C_1_C7_9930),Recovery Room (D_4_IRF_C13_51),Emergency (D_4_IRF_C11_91),Emergency (A_C1_91),Durable Medical Equipment Rented (D3_IPF_C3_96),"Net Expense for Cost Allocation, Administrative and General (B_1_C0_5)",RHC 11 Provider Number (S2_1_C2_1510),Other Ancillary (D_4_HOS_C11_76),Radiology-Diagnostic (D_4_SNF_C11_54),HHA (A_C6_101),"AMOUNT REPORTED, Operation of Plant (S3_2_C2_30)",Whole Blood & Packed Red Blood Cells (D3_HOS_C2_62),Whole Blood & Packed Red Blood Cells (D_4_HOS_C2_62),"Net Expense for Cost Allocation, Cardiac Catheterization (B_1_C0_59)",Cash on Hand and in Banks (G_C1THRU4_1),"AMOUNT REPORTED, Wage Related Costs Core (S3_2_C2_17)","TOTAL CAPITAL COSTS AFTER COST ALLOCATION, Coronary Care Unit (B_2_C26_32)",certification date (S2_1_C1_132),Other Ancillary (D_4_HOS_C1_76),Other Ancillary (D_4_HOS_C10_76),Cardiac Catheterization (D_4_IPF_C13_59),"Blood Storing, Processing, Trans (D3_SNF_C2_63)",Physical Therapy (D3_IRF_C2_66),Renal Dialysis (D3_IPF_C3_74),"AVERAGE HOURLY WAGE, Dietary under Contract (S3_2_C6_35)","Allocation of Interns & Residents Program Costs, Subprovider I (B_1_C22_42)",Nursery (A_C1_43),MRI (D_4_HOS_C2_58),Electrocardiology (D3_IPF_C2_69),Burn Intensive Care Unit (S3_1_C2_10),Electroencephalography (D_4_IRF_C13_70),FQHC (C_1_C6_89),"COST SERVICES NOT SUBJECT TO DEDUCTIBLES AND COINSURANCE - COST, Other Outpatient Services (D_5_HOS_C7_93)",Hospice (B_2_C26_116),"PPS SERVICES COST, Electroencephalography (D_5_HOS_C5_70)",Emergency (C_1_C6_91),"PAID HOURS RELATED TO SALARIES, Teaching Physician Salaries (S3_2_C5_16)","TOTAL CAPITAL COSTS AFTER COST ALLOCATION, Total Directly Assigned New Cap Rel Csts (B_2_C0_202)",Medical Supplies Charged to Patients (D_4_IRF_C13_71),Does the facility operate an ICF/MR facility for purposes of Title XIX? (Y/N) (S2_1_C1_93),Outpatient Rehab Provider (S3_1_C11_25),Radioisotope (D_4_HOS_C10_56),Subprovider-IRF (C_1_C5_41),"AMOUNT REPORTED, Interns & Residents (S3_2_C3_25)",Total Hospital Interns & Residents (S3_1_C10_14),Electrocardiology (D_4_HOS_C2_69),"Medicare certified heart
transplant center cert date (S2_1_C1_127)",Radiology-Therapeutic (D_4_IPF_C13_55),Observation Beds (Distinct Unit) (D_4_IPF_C13_9201),Cost of physicians svcs in a teaching hospita (E_B_HOS_C1_23),ASC (Non Distinct Part) (D3_IPF_C3_75),Other Special Care (S3_1_C2_12),Pass through Cost for Program Inpatient (D1_IPF_C1_50),IPF Provider Number (S2_1_C1_4),Nursery (S3_1_C8_13),Other Capital (A_C2_3),Other Ancillary (A_C2_76),Adults & Pediatrics (D_3_HOS_C9_30),Other Special Care Unit (D3_HOS_C2_35),"General Inpatient Routine Service Cost, net of Swing Bed Cost (D1_HOS_C1_27)",Other Medicaid Days (S2_1_C6_24),MDH status ending date (MM/DD/YY) (S2_1_C2_3801),ASC (Non Distinct Part) (D3_IPF_C2_75),Observation Beds (Distinct Unit) (D3_HOS_C2_9201),ASC (Non Distinct Part) (B_1_C26_75),Cardiac Catheterization (D_4_IRF_C11_59),ASC (Non Distinct Part) (D_4_HOS_C2_75),Respiratory Therapy (D_4_HOS_C4_65),"ADJUSTED SALARIES, Home Office Salaries (S3_2_C4_1401)","COST SERVICES SUBJECT TO DEDUCTIBLES AND COINSURANCE - COST, Drugs Charged to Patients (D_5_HOS_C6_73)",NF (S3_1_C7_20),Other Outpatient Services (C_1_C7_93),Other Special Purpose (A_C6_117),"Blood Storing, Processing, Trans (B_1_C26_63)","AMOUNT REPORTED, Subtotal Other Wages and Related Csts (S3_3_C2_4)",RHC (C_1_C6_88),Other Outpatient Services (D3_IRF_C3_93),RHC 21 Provider Number (S2_1_C2_1520),Drugs Charged to Patients (D_4_IPF_C13_73),Total unreimbursed cost for Medicaid and CHIP and state and local indigent care programs (S10_C1_19),"HHA II, With Outliers:  Total Charges (S4_HHA2_C2_35)",Other Organ Acquisition (A_C6_112),Total Nonphysician Anesthetist Cost (D_4_IPF_C1_200),Research (B_1_C21_191),"AVERAGE HOURLY WAGE, Total (S3_3_C6_6)",Title XIX discharges (S3_1_C14_18),Delivery Room and Labor Room (B_1_C26_52),CORF (C_1_C7_9910),Durable Medical Equipment Rented (D_4_HOS_C10_96),"AVERAGE HOURLY WAGE, Administrative and General under Contract (S3_2_C6_28)",Radiology-Diagnostic (D_4_HOS_C10_54),CMHC 1 Provider Number (S2_1_C2_17),"HHA III, Total Charges (S4_HHA3_C5_35)","Net Expense for Cost Allocation, Lung  Acquisition (B_1_C0_108)",Medical Supplies Charged to Patients (A_C6_71),Other Reimbursable (D3_IRF_C2_98),Intravenous Therapy (D3_IPF_C2_64),Delivery Room and Labor Room (A_C6_52),Electrocardiology (D_4_IPF_C11_69),Renal Dialysis (D_4_IPF_C11_74),Have you established a new subprovider excluded unit under 42 CFR 413.40(f)(1)(I)?(Y/N) (S2_1_C1_86),Other Special Care Unit (B_1_C26_35),In State Medicaid paid days (S2_1_C1_24),"COST SERVICES SUBJECT TO DEDUCTIBLES AND COINSURANCE - COST, Other Ancillary (D_5_HOS_C6_76)","COST SERVICES NOT SUBJECT TO DEDUCTIBLES AND COINSURANCE - COST, Operating Room (D_5_HOS_C7_50)",Home Program Dialysis (D3_HOS_C2_94),"Number of Times per week
 Patient receives Dialysis (S5_C4_2)",Occupational Therapy (A_C1_67),Mortgage Payable (G_C1THRU4_46),Clinic (D3_IRF_C3_90),"PPS REIMBURSED SERVICES -  CHARGES, Blood Storing, Processing, Trans (D_5_HOS_C2_63)",Labor and Delivery (S3_1_C2_32),"AMOUNT REPORTED, Physician Part A (S3_2_C3_22)","PAID HOURS RELATED TO SALARIES, Interns & Residents (S3_2_C5_7)","TOTAL CAPITAL COSTS AFTER COST ALLOCATION, Other Special Care Unit (B_2_C26_35)",OPT (B_2_C26_9920),"COST REIMBURSED SERVICES SUBJECT TO DEDUCTIBLES  AND COINSURANCE - CHARGES, Respiratory Therapy (D_5_HOS_C3_65)","PPS REIMBURSED SERVICES -  CHARGES, Drugs Charged to Patients (D_5_HOS_C2_73)",Total discharges (S3_1_C15_16),"Treatment capacity per day per
station (S5_C1_7)",Dietary (A_C1_10),Cafeteria employees and guests (A8_C2_14),Prepaid expenses (G_C1THRU4_8),"Disposals and Retirements, Buildings and Fixtures (A7_1_C5_3)",RHC (C_1_C5_88),Medical Records and Medical Rec. Library (A_C1_16),Burn Intensive Care Unit (A_C6_33),HHA (A_C1_101),Emergency (B_1_C22_91),Occupational Therapy (D_4_HOS_C4_67),Whole Blood & Packed Red Blood Cells (A_C1_62),Medical Supplies Charged to Patients (D_4_HOS_C11_71),Hospital Adults & Pediatrics (S3_1_C4_1),Speech Pathology (D_4_HOS_C4_68),"Net Expense for Cost Allocation, Radiology-Therapeutic (B_1_C0_55)",Ending Date of SCH status (S2_1_C2_36),"Net Expense for Cost Allocation, New Capital Equipment (B_1_C0_2)",Radiology-Therapeutic (D_4_HOS_C4_55),Impl. Dev. Charged to Patients (D_4_HOS_C12_72),Drugs Charged to Patients (D3_HOS_C2_73),"Beginning Balances, Building Improvements (A7_1_C1_4)","HHA II, PEP Episodes:  Total Visits (S4_HHA2_C4_33)",Clinic (D_4_HOS_C3_90),PBP Clinical Lab Services Program Only (C_1_C5_61),Hospital Adults & Pediatrics (S3_1_C6_1),Intravenous Therapy (D3_HOS_C2_64),Lesser of cost or charges (E_B_HOS_C1_21),Radiology-Diagnostic (A_C2_54),"Number of days in year dialysis 
furnished (S5_C1_5)","COST REIMBURSED SERVICES SUBJECT TO DEDUCTIBLES  AND COINSURANCE - CHARGES, Emergency (D_5_HOS_C3_91)","COST SERVICES SUBJECT TO DEDUCTIBLES AND COINSURANCE - COST, Clinic (D_5_HOS_C6_90)",Hospital Adults & Pediatrics (S3_1_C3_1),RHC 12 Provider Number (S2_1_C2_1511),Medicare Certified Kidney TC term date (S2_1_C2_126),Nursery (S3_1_C5_13),"Net Expense for Cost Allocation, Durable Medical Equipment Rented (B_1_C0_96)","TOTAL CAPITAL COSTS AFTER COST ALLOCATION, Nursery (B_2_C26_43)",Other Outpatient Services (A_C6_93),Clinic (B_2_C26_90),Total Other Medical Education Cost (D_3_HOS_C3_200),Respiratory Therapy (D3_HOS_C2_65),Intestinal Acquisition (B_2_C26_110),"Net Expense for Cost Allocation, SNF (B_1_C0_44)","HHA I, Total Number of Episodes (S4_HHA1_C5_36)",Recovery Room (A_C6_51),Utilization Review SNF (A_C1_114),Other Reimbursable (D3_HOS_C2_98),Physicians' Private Office (B_1_C22_192),Land Improvements (G_C1THRU4_13),Kidney Acquisition (C_1_C6_105),NF (S3_1_C2_20),IPF (S3_1_C3_16),Clinic (D_4_IRF_C11_90),Lung  Acquisition (B_1_C21_108),Cardiac Catheterization (A_C2_59),"COST SERVICES NOT SUBJECT TO DEDUCTIBLES AND COINSURANCE - COST, Occupational Therapy (D_5_HOS_C7_67)","Allocation of Interns & Residents Program Costs, Impl. Dev. Charged to Patients (B_1_C22_72)",Interest Expense (A_C2_113),Renal Dialysis (A_C1_74),Operating Room (D3_IRF_C3_50),Recovery Room (D3_IPF_C2_51),Impl. Dev. Charged to Patients (D3_SNF_C2_72),"Net Expense for Cost Allocation, Electrocardiology (B_1_C0_69)",Clinic (D_4_HOS_C12_90),"COST SERVICES NOT SUBJECT TO DEDUCTIBLES AND COINSURANCE - COST, Renal Dialysis (D_5_HOS_C7_74)",Depreciation-New Movable Equipment (A8_C2_27),Pharmacy (A_C2_15),"HHA I, Total Charges (S4_HHA1_C5_35)",Laboratory (D_4_HOS_C13_60),"Beginning Balances, Land (A7_1_C1_1)",ESRD DME costs (E_B_HOS_C1_29),Primary payer payments (E_B_HOS_C1_31),NF (S3_1_C8_20),"Net Expense for Cost Allocation, Housekeeping (B_1_C0_9)",Drugs Charged to Patients (D_4_HOS_C2_73),"COST REIMBURSED SERVICES SUBJECT TO DEDUCTIBLES  AND COINSURANCE - CHARGES, Durable Medical Equipment Rented (D_5_HOS_C3_96)",Occupational Therapy (D3_IPF_C3_67),MRI (C_1_C5_58),Ambulance Services (B_1_C26_95),"COST REIMBURSED SERVICES NOT SUBJECT TO DEDUCTIBLES AND COINSURANCE - CHARGES, Occupational Therapy (D_5_HOS_C4_67)","AMOUNT REPORTED, Maintenance of Personnel (S3_2_C2_37)",Laboratory (D_4_HOS_C10_60),Home Program Dialysis (A_C2_94),Adults and Pediatrics (D3_HOS_C2_30),"Taxes, Total (A7_3_C6_3)",Emergency (A_C2_91),Pancreas Acquisition (A_C1_109),"Allocation of Interns & Residents Salary and Fringes, Burn Intensive Care Unit (B_1_C21_33)",Other Reimbursable (D_4_HOS_C2_98),Other Special Purpose (A_C1_117),"AVERAGE HOURLY WAGE, Maintenance of Personnel (S3_2_C6_37)",ASC (Non Distinct Part) (D_4_IRF_C13_75),"Number of patients on transplant 
list (S5_C1_11)",Coronary Intensive Care Unit (D_1_HOS_C7_32),Observation Beds (Distinct Unit) (B_1_C21_9201),FQHC (B_1_C21_89),Title XVIII discharges (S3_1_C13_1),Lung  Acquisition (A_C2_108),"AMOUNT REPORTED, Contract Labor: Pysician Part A (S3_2_C2_13)","COST REIMBURSED SERVICES NOT SUBJECT TO DEDUCTIBLES AND COINSURANCE - CHARGES, Whole Blood & Packed Red Blood Cells (D_5_HOS_C4_62)","HHA II, Total Number of Outlier Episodes (S4_HHA2_C5_37)","COST REIMBURSED SERVICES SUBJECT TO DEDUCTIBLES  AND COINSURANCE - CHARGES, Observation Beds (Distinct Unit) (D_5_HOS_C3_9201)","AMOUNT REPORTED, Home Office:  Physician Part A (S3_2_C2_15)",Impl. Dev. Charged to Patients (A_C6_72),Total discharges (S3_1_C15_18),"AVERAGE HOURLY WAGE, Home Office Personnel (S3_2_C6_8)",Other Reimbursable (D_4_HOS_C10_98),Occupational Therapy (D3_IRF_C2_67),CMHC (S3_1_C6_25),Program Inpatient Ancillary Service Cost (D1_IRF_C1_48),"PPS REIMBURSED SERVICES -  CHARGES, Clinic (D_5_HOS_C2_90)",Drugs Charged to Patients (D3_IRF_C3_73),Anesthesiology (D3_IPF_C3_53),Subprovider-IPF (D_1_HOS_C4_40),Report Record Number (RPT_REC_NUM),"Lease, New Cap Related Csts Bldg & Fixtures (A7_3_C10_1)","Interest, New Cap Related Csts Bldg & Fixtures (A7_3_C11_1)",Surgical Intensive Care Unit (D3_IRF_C2_34),"PPS REIMBURSED SERVICES -  CHARGES, Durable Medical Equipment Rented (D_5_HOS_C2_96)",Whole Blood & Packed Red Blood Cells (D3_SNF_C2_62),"PPS SERVICES COST, ASC (Non Distinct Part) (D_5_HOS_C5_75)","Insurance, Total (A7_3_C5_3)",Total (D_4_SNF_C11_200),Nursing Administration (A_C1_13),Delivery Room and Labor Room (D3_IRF_C3_52),Tentative settlement (E_B_HOS_C1_42),ICF (A_C1_4501),"TOTAL CAPITAL COSTS AFTER COST ALLOCATION, Anesthesiology (B_2_C26_53)",Whole Blood & Packed Red Blood Cells (D_4_IRF_C11_62),Other Reimbursable (B_2_C26_98),Impl. Dev. Charged to Patients (B_2_C26_72),OSP (A_C1_9940),Cafeteria (A_C6_11),"Total Inpatient Charges, Intensive Care Unit (C_1_C6_31)",Subprovider-IRF (D_3_HOS_C9_41),Intravenous Therapy (A_C1_64),Subprovider II (D_1_HOS_C4_4201),"Net Expense for Cost Allocation, MRI (B_1_C0_58)",Intestinal Acquisition (C_1_C7_110),Whole Blood & Packed Red Blood Cells (D3_IPF_C2_62),Other Special Purpose (C_1_C6_117),"HHA III, With Outliers:  Total Visits (S4_HHA3_C2_33)",Burn Intensive Care Unit (D_1_HOS_C6_33),Respiratory Therapy (D3_IPF_C3_65),Laboratory (D3_IRF_C3_60),"Allocation of Interns & Residents Program Costs, Nursery (B_1_C22_43)",Cardiac Catheterization (D_4_HOS_C11_59),MRI (A_C1_58),Anesthesiology (A_C6_53),Pancreas Acquisition (B_1_C22_109),"HHA III, Total Number of Outlier Episodes (S4_HHA3_C5_37)",Recovery Room (D3_SNF_C3_51),Physicians' Private Office (B_1_C21_192),"PPS SERVICES COST, Total (D_5_HOS_C5_200)",Emergency (D3_IPF_C3_91),Charity care charges and uninsured discounts for the entire facility (S10_C2_20),"Sum of lines 3,4 divided by line 6 (E_B_HOS_C1_7)","HHA I, PEP Episodes:  Other Charges (S4_HHA1_C4_34)","COST REIMBURSED SERVICES NOT SUBJECT TO DEDUCTIBLES AND COINSURANCE - CHARGES, Radiology-Diagnostic (D_5_HOS_C4_54)",Television and Radio Service (A8_C2_8),"COST SERVICES NOT SUBJECT TO DEDUCTIBLES AND COINSURANCE - COST, Anesthesiology (D_5_HOS_C7_53)",Total Outpatient Program Pass Thru Cost (D_4_IRF_C6_200),ASC (Non Distinct Part) (D_4_HOS_C11_75),"AVERAGE HOURLY WAGE, Home Office:  Physician Part A (S3_2_C6_15)","HHA II, Total Other Charges (S4_HHA2_C5_34)",Paramedical Education (A_C1_23),Other Special Care Unit (D_1_HOS_C6_35),Whole Blood & Packed Red Blood Cells (D_4_HOS_C10_62),Total Program Inpatient Costs (D1_IPF_C1_49),OLTC (S3_1_C9_21),"Fully Depreciated Assets, Donations (A7_1_C3_7)",OPT (A_C6_9920),Hospice 3 Provider Number (S2_1_C2_1402),CMHC (A_C1_99),"Net Expense for Cost Allocation, Maintenance and Repairs (B_1_C0_6)",ASC (Non Distinct Part) (B_1_C21_75),"Total Outpatient Charges, Blood Clotting Factors for Hemoph. (C_1_C7_6250)",Title XVIII discharges (S3_1_C13_17),"COST SERVICES SUBJECT TO DEDUCTIBLES AND COINSURANCE - COST, Ambulance Services (D_5_HOS_C6_95)",Radioisotope (D_4_HOS_C12_56),Durable Medical Equipment Sold (A_C2_97),Liver Acquisition (C_1_C5_107),SNF (S3_1_C5_19),Emergency (D_4_SNF_C11_91),"Allocation of Interns & Residents Program Costs, Medical Supplies Charged to Patients (B_1_C22_71)","AVERAGE HOURLY WAGE, Subtotal Wage Related Csts (S3_3_C6_5)",Surgical Intensive Care Unit (D3_HOS_C2_34),Ambulance Services (C_1_C7_95),Title V discharges (S3_1_C12_14),Durable Medical Equipment Sold (A_C1_97),Physical Therapy (D_4_HOS_C11_66),Home Program Dialysis (B_1_C21_94),"Donations, Total (A7_1_C3_10)","COST REIMBURSED SERVICES SUBJECT TO DEDUCTIBLES  AND COINSURANCE - CHARGES, Radioisotope (D_5_HOS_C3_56)",CORF (A_C2_9910),Total reasonable charges (E_B_HOS_C1_14),Labor and Delivery Days Title 18 (S3_1_C6_32),Subprovider II (A_C6_4201),Other Outpatient Services (D_4_IPF_C11_93),Adults and Pediatrics (A_C2_30),Total Hospital (S3_1_C7_14),"COST SERVICES SUBJECT TO DEDUCTIBLES AND COINSURANCE - COST, Renal Dialysis (D_5_HOS_C6_74)",New Capital Equipment (A_C6_2),Other Nonreimbursable (B_1_C26_194),"PPS REIMBURSED SERVICES -  CHARGES, Emergency (D_5_HOS_C2_91)",Respiratory Therapy (D_4_HOS_C11_65),Int & Res (non approved teaching program (B_1_C26_100),HHA 3 Provider Number (S2_1_C2_1202),Urban/Rural Indicator at beginning (S2_1_C1_26),Intestinal Acquisition (B_1_C22_110),"Are there any related organization or how office costs as defined in HCFA Pub. 15-I, chapter 10? (Y/N) (S2_1_C1_140)","HHA I, PEP:  Total Non Routine Med Supply Chgs (S4_HHA1_C4_38)",Total Hospital (S3_1_C5_14),Other Outpatient Services (D3_SNF_C2_93),"Blood Storing, Processing, Trans (D_4_IRF_C13_63)",Durable Medical Equipment Sold (C_1_C6_97),"COST SERVICES SUBJECT TO DEDUCTIBLES AND COINSURANCE - COST, Durable Medical Equipment Rented (D_5_HOS_C6_96)","PAID HOURS RELATED TO SALARIES, Home Office:  Physician Part A (S3_2_C5_15)","AVERAGE HOURLY WAGE, Home Office Salaries & Wage Related Csts (S3_2_C6_14)",RHC (C_1_C7_88),Adj for Physical therapy costs in excess (A8_C2_24),"PPS SERVICES COST, Cardiac Catheterization (D_5_HOS_C5_59)",Electrocardiology (C_1_C7_69),"AMOUNT REPORTED, Non-Physician Anesthetist Part B (S3_2_C2_3)","TOTAL CAPITAL COSTS AFTER COST ALLOCATION, Intensive Care Unit (B_2_C26_31)",Other Reimbursable (C_1_C5_98),Total (D_1_HOS_C4_200),"PPS SERVICES COST, CT Scan (D_5_HOS_C5_57)","Net Expense for Cost Allocation, Dietary (B_1_C0_10)",Laboratory (B_1_C26_60),"COST REIMBURSED SERVICES SUBJECT TO DEDUCTIBLES  AND COINSURANCE - CHARGES, Recovery Room (D_5_HOS_C3_51)","Net Expense for Cost Allocation, Operating Room (B_1_C0_50)",RHC (D_4_HOS_C4_88),Respiratory Therapy (C_1_C5_65),ASC (Distinct Part) (B_1_C21_115),Impl. Dev. Charged to Patients (D_4_HOS_C13_72),OSP (B_2_C26_9940),"AMOUNT REPORTED, Interns & Residents (S3_2_C2_2552)",ASC (Non Distinct Part) (D_4_HOS_C13_75),FI/Contractor's Name (S2_1_C2_140),HVBP payment adjustment amount (E_A_HOS_C1_7093),Notes Payable (G_C1THRU4_47),"COST REIMBURSED SERVICES NOT SUBJECT TO DEDUCTIBLES AND COINSURANCE - CHARGES, Other Outpatient Services (D_5_HOS_C4_93)","COST REIMBURSED SERVICES SUBJECT TO DEDUCTIBLES  AND COINSURANCE - CHARGES, Durable Medical Equipment Sold (D_5_HOS_C3_97)",Total (A8_C2_50),Subprovider I (D3_HOS_C2_42),Respiratory Therapy (B_1_C26_65),Other Outpatient Services (B_1_C26_93),"COST REIMBURSED SERVICES NOT SUBJECT TO DEDUCTIBLES AND COINSURANCE - CHARGES, Blood Clotting Factors for Hemoph. (D_5_HOS_C4_6250)",CAH Visits (S3_1_C8_15),Intensive Care Unit (S3_1_C5_8),Other Special Care (S3_1_C7_12),Nonpaid Workers (A_C6_193),"Net Expense for Cost Allocation, Heart Acquisition (B_1_C0_106)",Speech Pathology (A_C1_68),Durable Medical Equipment Rented (D3_SNF_C2_96),Impl. Dev. Charged to Patients (A_C1_72),"ADJUSTED SALARIES, Administrative & General under contract (S3_2_C4_28)",Pharmacy (A_C6_15),Speech Pathology (D3_SNF_C3_68),Nursing Administration (A_C6_13),Radioisotope (D_4_HOS_C3_56),"Net Expense for Cost Allocation, Drugs Charged to Patients (B_1_C0_73)","Net Expense for Cost Allocation, Islet Acquisition (B_1_C0_111)",RHC/FQHC Combined (S3_1_C7_26),Laboratory (D_4_HOS_C2_60),Electrocardiology (D_4_HOS_C13_69),Renal 1 Provider Number (S2_1_C2_18),"Allocation of Interns & Residents Program Costs, Physical Therapy (B_1_C22_66)","HHA I, With Outliers:  Other Charges (S4_HHA1_C2_34)","Allocation of Interns & Residents Salary and Fringes, Whole Blood & Packed Red Blood Cells (B_1_C21_62)","Allocation of Interns & Residents Program Costs, Intensive Care Unit (B_1_C22_31)","Depreciation, Total (A7_3_C9_3)",Other Outpatient Services (A_C1_93),Cardiac Catheterization (A_C6_59),"Other Capital Related Costs, New Cap Related Csts Movable Equipment (A7_3_C7_2)",Radiology-Diagnostic (D3_IPF_C3_54),Drugs Charged to Patients (B_2_C26_73),Housekeeping (A_C1_9),Nonpaid Workers (A_C1_193),"COST SERVICES NOT SUBJECT TO DEDUCTIBLES AND COINSURANCE - COST, Intravenous Therapy (D_5_HOS_C7_64)",Emergency (C_1_C5_91),Cardiac Catheterization (D_4_IRF_C13_59),Adj for Speech therapy in excess of lim (A8_C2_31),Is this hospital an All-Inclusive rate provider? (Y/N) (S2_1_C1_115),Lung  Acquisition (A_C1_108),Other Special Care Unit (A_C2_35),Impl. Dev. Charged to Patients (C_1_C6_72),Intensive Care Unit (D_1_HOS_C4_31),Respiratory Therapy (D_4_IRF_C11_65),Other Reimbursable (D3_SNF_C3_98),"Net Expense for Cost Allocation, Surgical Intensive Care Unit (B_1_C0_34)",Total Facility FTEs (S3_1_C9_27),"Number of patients in program at 
end of cost reporting period (S5_C3_1)","Donations, Fixed Equipment (A7_1_C3_5)",CMHC (A_C6_99),Impl. Dev. Charged to Patients (D_4_HOS_C3_72),"COST SERVICES SUBJECT TO DEDUCTIBLES AND COINSURANCE - COST, MRI (D_5_HOS_C6_58)",Impl. Dev. Charged to Patients (C_1_C5_72),Observation Beds (Distinct Unit) (D3_IRF_C3_9201),"AMOUNT REPORTED, Interns & Residents (S3_2_C2_2553)","ADJUSTED SALARIES, Non-Physician Anesthetist Part A (S3_2_C4_20)",Durable Medical Equipment Rented (B_2_C26_96),Organ acquisition (E_B_HOS_C1_10),Less: Allowances for uncollectible notes and accounts receivable (G_C1THRU4_6),"ADJUSTED SALARIES, Wage Related Costs Core (S3_2_C4_17)","Fully Depreciated Assets, Disp. And Retirement (A7_1_C5_7)",Renal 7 Provider Number (S2_1_C2_1806),"ADJUSTED SALARIES, Physician Part A Teaching (S3_2_C4_2201)",Speech Pathology (D_4_HOS_C11_68),Cardiac Catheterization (A_C1_59),Total Other Expenses (G3_C1_28),Radiology-Diagnostic (D3_IRF_C3_54),Observation Beds (Distinct Unit) (D3_SNF_C2_9201),SNF (A_C2_44),ASC (Non Distinct Part) (D3_SNF_C3_75),Radiology-Diagnostic (C_1_C5_54),"Net Expense for Cost Allocation, Employee Benefits (B_1_C0_4)",Total Hospital (S3_1_C3_7),Coronary Care Unit (S3_1_C5_9),"COST REIMBURSED SERVICES SUBJECT TO DEDUCTIBLES  AND COINSURANCE - CHARGES, Operating Room (D_5_HOS_C3_50)",Cardiac Catheterization (D_4_SNF_C11_59),Whole Blood & Packed Red Blood Cells (C_1_C5_62),Program Discharges (D1_HOS_C1_54),Subprovider I (A_C1_42),Intravenous Therapy (D_4_HOS_C3_64),Cardiac Catheterization (C_1_C5_59),Ending Date of SCH status (S2_1_C2_3601),Premiums (S2_1_C1_11801),"Allocation of Interns & Residents Program Costs, Surgical Intensive Care Unit (B_1_C22_34)","PAID HOURS RELATED TO SALARIES, Laundry and Linen Service (S3_2_C5_31)",Other Ancillary (B_1_C26_76),Laboratory (D_4_IPF_C11_60),Land (G_C1THRU4_12),Coronary Care Unit (A_C1_32),"Blood Storing, Processing, Trans (A_C6_63)",Other Nonreimbursable (A_C2_194),Does the hospital qualify as RPCH/CAH? (Y/N) (S2_1_C1_105),Medical Supplies Charged to Patients (B_2_C26_71),Durable Medical Equipment Rented (D3_SNF_C3_96),Kidney Acquisition (A_C6_105),SSA State Code (STATE),Drugs Charged to Patients (B_1_C22_73),Total Hospital Interns & Residents (S3_1_C11_14),Drugs Charged to Patients (D3_SNF_C2_73),IRF Provider Number (S2_1_C2_5),"COST SERVICES NOT SUBJECT TO DEDUCTIBLES AND COINSURANCE - COST, Laboratory (D_5_HOS_C7_60)","COST SERVICES NOT SUBJECT TO DEDUCTIBLES AND COINSURANCE - COST, Respiratory Therapy (D_5_HOS_C7_65)",ASC (Non Distinct Part) (B_1_C22_75),"Net Expense for Cost Allocation, Subprovider II (B_1_C0_4201)",Total discharges (S3_1_C15_14),"Blood Storing, Processing, Trans (A_C2_63)",Nursing Administration (A_C2_13),Other Special Care Unit (D3_IRF_C2_35),"Total Inpatient Charges, PBP Clinical Lab Services Program Only (C_1_C6_61)","AMOUNT REPORTED, Home Office Salaries & Wage Related Csts (S3_2_C3_14)","AMOUNT REPORTED, Net Salaries (S3_3_C2_1)",Other Ancillary (D3_SNF_C3_76),Renal Dialysis (D3_IRF_C2_74),"AMOUNT REPORTED, Pharmacy (S3_2_C2_40)","HHA III, Total Visits (S4_HHA3_C5_33)",Observation Beds (Distinct Unit) (D_4_HOS_C11_9201),Respiratory Therapy (C_1_C7_65),"COST SERVICES SUBJECT TO DEDUCTIBLES AND COINSURANCE - COST, Occupational Therapy (D_5_HOS_C6_67)",Total Subprovider I Interns & Residents (S3_1_C9_18),Total Facility FTEs (S3_1_C10_27),Islet Acquisition (B_2_C26_111),Number of stations (S5_C3_6),"COST REIMBURSED SERVICES NOT SUBJECT TO DEDUCTIBLES AND COINSURANCE - CHARGES, Operating Room (D_5_HOS_C4_50)",OLTC (S3_1_C2_21),Speech Pathology (C_1_C6_68),"Net Expense for Cost Allocation, Interns & Res Other Program Costs (B_1_C0_22)",Kidney Acquisition (C_1_C5_105),Occupational Therapy (D_4_IPF_C11_67),Durable Medical Equipment Sold (D_4_HOS_C3_97),Title XIX discharges (S3_1_C14_17),Drugs Charged to Patients (D_4_HOS_C11_73),Non-physician Anesthetist (A8_C2_28),"Net Expense for Cost Allocation, ASC (Non Distinct Part) (B_1_C0_75)",Ambulance Trips (S3_1_C6_29),CT Scan (D3_IPF_C2_57),"PAID HOURS RELATED TO SALARIES, Home Office Personnel (S3_2_C5_8)","ADJUSTED SALARIES, Total Overhead Costs (S3_3_C4_7)",Radioisotope (D3_SNF_C3_56),Physical Therapy (A_C6_66),Research (B_1_C22_191),Renal Dialysis (D3_SNF_C3_74),"AVERAGE HOURLY WAGE, Medical Records & Med Records Library (S3_2_C6_41)","PPS REIMBURSED SERVICES -  CHARGES, Delivery Room and Labor Room (D_5_HOS_C2_52)","AMOUNT REPORTED, Interns & Residents (S3_2_C2_2550)",Sale of medical records and abstracts (A8_C2_18),"COST SERVICES NOT SUBJECT TO DEDUCTIBLES AND COINSURANCE - COST, Observation Beds (Distinct Unit) (D_5_HOS_C7_9201)","Allocation of Interns & Residents Salary and Fringes, Impl. Dev. Charged to Patients (B_1_C21_72)","AMOUNT REPORTED, Physician Part A Teaching (S3_2_C3_2201)","PAID HOURS RELATED TO SALARIES, Pharmacy (S3_2_C5_40)",Int & Res (non approved teaching program (B_2_C26_100),Electroencephalography (D3_SNF_C3_70),NF (S3_1_C10_20),Ambulance Services (A_C1_95),"Medical certified liver 
transplant center cert date (S2_1_C1_128)","Allocation of Interns & Residents Salary and Fringes, SNF (B_1_C21_44)",Ambulance Services (C_1_C6_95),"COST SERVICES NOT SUBJECT TO DEDUCTIBLES AND COINSURANCE - COST, Radioisotope (D_5_HOS_C7_56)","Epoietin amount form worksheet A
for home dialysis program (S5_C1_14)",Other Special Care Unit (D_3_HOS_C9_35),Radiology-Therapeutic (D_4_HOS_C11_55),Electroencephalography (A_C1_70),Other Ancillary (A_C1_76),"PPS SERVICES COST, Delivery Room and Labor Room (D_5_HOS_C5_52)",Durable Medical Equipment Sold (C_1_C7_97),Durable Medical Equipment Rented (D_4_HOS_C12_96),Durable Medical Equipment Rented (A_C2_96),Delivery Room and Labor Room (D_4_HOS_C3_52),OPT (C_1_C7_9920),"Blood Storing, Processing, Trans (D_4_SNF_C11_63)",Nursery (A_C6_43),Coronary Care Unit (S3_1_C4_9),Islet Acquisition (A_C6_111),Other Special Purpose (B_1_C21_117),"Purchases, Land (A7_1_C2_1)",Subprovider II (A_C2_4201),Other Outpatient Services (B_1_C22_93),Maintenance of Personnel (A_C6_12),Radiology-Therapeutic (D3_SNF_C2_55),"COST REIMBURSED SERVICES NOT SUBJECT TO DEDUCTIBLES AND COINSURANCE - CHARGES, Physical Therapy (D_5_HOS_C4_66)","AMOUNT REPORTED, Physician Part A (S3_2_C2_2201)",ASC (Non Distinct Part) (D_4_IRF_C11_75),Speech Pathology (D3_IRF_C3_68),RHC 18 Provider Number (S2_1_C2_1517),"Allocation of Interns & Residents Salary and Fringes, Electroencephalography (B_1_C21_70)",Total Bad Debt expense (S10_C1_26),Intravenous Therapy (D3_IPF_C3_64),"PPS REIMBURSED SERVICES -  CHARGES, Renal Dialysis (D_5_HOS_C2_74)",Other Special Care Unit (D_1_HOS_C7_35),Nursery (D3_HOS_C2_43),Other Outpatient Services (D_4_HOS_C10_93),Geographic MSA (MSA),Other Special Care (S3_1_C5_12),Speech Pathology (B_2_C26_68),Clinic (D_4_IRF_C13_90),Renal Dialysis (D_4_HOS_C12_74),Payments received from patients for amounts previously written off as charity care (S10_C1_22),RHC (B_2_C26_88),Outpatient Rehab Provider (S3_1_C10_25),"COST SERVICES NOT SUBJECT TO DEDUCTIBLES AND COINSURANCE - COST, Recovery Room (D_5_HOS_C7_51)",Allowable Inpatient Cost Plus Incentive Pt (D1_HOS_C1_63),Nonpaid Workers (B_1_C21_193),Physical Therapy (C_1_C2_66),Total (D_1_HOS_C7_200),"COST SERVICES NOT SUBJECT TO DEDUCTIBLES AND COINSURANCE - COST, Electrocardiology (D_5_HOS_C7_69)",Other Outpatient Services (D3_SNF_C3_93),"AMOUNT REPORTED, Related Salaries (S3_2_C3_1402)",Durable Medical Equipment Rented (A_C1_96),FQHC (C_1_C5_89),"HHA III, With Outliers:  Number of Episodes (S4_HHA3_C2_37)",Other Special Purpose (C_1_C5_117),Radiology-Therapeutic (D_4_IRF_C13_55),"COST REIMBURSED SERVICES SUBJECT TO DEDUCTIBLES  AND COINSURANCE - CHARGES, Renal Dialysis (D_5_HOS_C3_74)","AMOUNT REPORTED, Excluded Areas (S3_2_C2_19)",ASC (Non Distinct Part) (D3_SNF_C2_75),Burn Intensive Care Unit (D_1_HOS_C7_33),Emergency (A_C6_91),Clinic (A_C1_90),IPF (S3_1_C8_16),"ADJUSTED SALARIES, Interns & Residents (S3_2_C4_2553)",OSP (B_1_C26_9940),IPPS Interim payment (E_A_HOS_C1_72),Total Program General Inpatient Routine (D1_IPF_C1_41),Surgical Intensive Care Unit (S3_1_C7_11),Medical Supplies Charged to Patients (D3_IRF_C2_71),Whole Blood & Packed Red Blood Cells (A_C2_62),Electroencephalography (B_2_C26_70),"Allocation of Interns & Residents Program Costs, Respiratory Therapy (B_1_C22_65)","PAID HOURS RELATED TO SALARIES, Subtotal Other Wages and Related Csts (S3_3_C5_4)",Burn Intensive Care Unit (S3_1_C4_10),"ADJUSTED SALARIES, Pharmacy (S3_2_C4_40)","COST REIMBURSED SERVICES SUBJECT TO DEDUCTIBLES  AND COINSURANCE - CHARGES, Radiology-Therapeutic (D_5_HOS_C3_55)",Observation Beds (Distinct Unit) (D3_SNF_C3_9201),Whole Blood & Packed Red Blood Cells (D_4_HOS_C13_62),Other Reimbursable (A_C1_98),Total (B_1_C26_202),Other Ancillary (D_4_IRF_C11_76),Medical Supplies Charged to Patients (C_1_C7_71),Surgical Intensive Care Unit (D3_IPF_C2_34),Intensive Care Unit (A_C6_31),Operating Room (D3_IPF_C2_50),General Fund Balance (G_C1THRU4_52),Coronary Care Unit (S3_1_C2_9),Heart Acquisition (B_2_C26_106),"AVERAGE HOURLY WAGE, Dietary (S3_2_C6_34)",Total Program General Inp. Rtn Service (D1_SNF_C1_74),Burn Intensive Care Unit (D3_IPF_C2_33),"Fully Depreciated Assets, Ending Balance (A7_1_C6_7)",Adults and Pediatrics (D3_SNF_C2_30),Radiology-Diagnostic (A_C6_54),"AMOUNT REPORTED, Wage Related Costs RHC/FQHC (S3_2_C3_24)",Int & Res (non approved teaching program (C_1_C6_100),Total Other Medical Education (D_4_IRF_C4_200),Hospital Adlts & Ped Swing Bed NF (S3_1_C8_6),Refunds and Rebates of Expenses (A8_C2_5),"PPS REIMBURSED SERVICES -  CHARGES, Whole Blood & Packed Red Blood Cells (D_5_HOS_C2_62)","COST REIMBURSED SERVICES NOT SUBJECT TO DEDUCTIBLES AND COINSURANCE - CHARGES, Blood Storing, Processing, Trans (D_5_HOS_C4_63)",Program Ancillary Services (D1_SNF_C1_84),Intensive Care Unit (D3_SNF_C2_31),Medical and Other Services reimbursed by OPPS (E_B_HOS_C101_2),Medical and Other Services reimbursed by OPPS (E_B_HOS_C1_2),"AMOUNT REPORTED, Interns & Residents (S3_2_C3_2550)",Delivery Room and Labor Room (D3_SNF_C3_52),"Lease, Total (A7_3_C10_3)",Occupational Therapy (A_C6_67),Accounts Receivable (G_C1THRU4_4),"ADJUSTED SALARIES, Interns & Residents (S3_2_C4_2550)","HHA III, LUPA Episodes:  Total Visits (S4_HHA3_C3_33)",Electroencephalography (B_1_C26_70),Medical Supplies Charged to Patients (D3_HOS_C3_71),Private grants or donations or endowment income restricted to funding charity care (S10_C1_17),Subprovider II (B_1_C26_4201),"Taxes, New Cap Related Csts Movable Equipment (A7_3_C6_2)",OPT (C_1_C5_9920),Subprovider 2 (S3_1_C2_1801),"Donations, Land Improvements (A7_1_C3_2)",Physical Therapy (D_4_HOS_C12_66),Adults and Pediatrics (A_C6_30),"Net Expense for Cost Allocation, Laboratory (B_1_C0_60)",Delivery Room and Labor Room (A_C1_52),HHA (B_2_C26_101),CT Scan (A_C2_57),Clinic (D_4_SNF_C11_90),"AMOUNT REPORTED, Subtotal Salaries (S3_3_C2_3)",Social Service (A_C1_17),"Number of Times per week 
Patient receives Dialysis (S5_C3_2)","Net Expense for Cost Allocation, Kidney Acquisition (B_1_C0_105)",Coronary Care Unit (D3_IRF_C2_32),"COST SERVICES NOT SUBJECT TO DEDUCTIBLES AND COINSURANCE - COST, Whole Blood & Packed Red Blood Cells (D_5_HOS_C7_62)","Donations, Buildings and Fixtures (A7_1_C3_3)",Electroencephalography (A_C6_70),Medicaid HMO Days (S2_1_C5_24),"Purchases, Movable Equipment (A7_1_C2_6)",Other Nonreimbursable (B_2_C26_194),Pass Through Cost for  Program Ancillary (D1_IPF_C1_51),Government grants or appropriations or transfers for support of hospital operations (S10_C1_18),Out of State Medicaid paid days (S2_1_C3_24),"AMOUNT REPORTED, Social Service (S3_2_C2_42)","COST SERVICES SUBJECT TO DEDUCTIBLES AND COINSURANCE - COST, Laboratory (D_5_HOS_C6_60)","Does the facility qualify and is it receiving payments for 
disproportionate share? (Y/N) (S2_1_C1_22)",Subprovider-IPF (A_C1_40),"Net Expense for Cost Allocation, Renal Dialysis (B_1_C0_74)",Observation Beds (Distinct Unit) (D_4_IRF_C11_9201),Subprovider-IRF (D_1_HOS_C4_41),Home Program Dialysis (D3_IPF_C2_94),Surgical Intensive Care Unit (S3_1_C4_11),Drugs Charged to Patients (D3_IPF_C3_73),"ADJUSTED SALARIES, Central Services and Supply (S3_2_C4_39)","PAID HOURS RELATED TO SALARIES, Total Overhead Costs (S3_3_C5_7)",TOTAL (D3_IPF_C3_200),Central Services and Supply (A_C1_14),Title XVIII discharges (S3_1_C13_2),"PAID HOURS RELATED TO SALARIES, Contract Labor:  Physician Part A (S3_2_C5_13)","Disposals and Retirements, Movable Equipment (A7_1_C7_6)",Coronary Care Unit (D_3_HOS_C9_32),"HHA II, PEP Episodes:  Other Charges (S4_HHA2_C4_34)","Disposals and Retirements, Fixed Equipment (A7_1_C5_5)","Fully Depreciated Assets, Purchase (A7_1_C2_7)",Whole Blood & Packed Red Blood Cells (D_4_IRF_C13_62),"HHA II, PEP Episodes:  Total Number of Episodes (S4_HHA2_C4_36)",Surgical Intensive Care Unit (A_C6_34),HHA (S3_1_C8_22),"PPS REIMBURSED SERVICES -  CHARGES, Home Program Dialysis (D_5_HOS_C2_94)",OOT (A_C1_9930),"Net Expense for Cost Allocation, Clinic (B_1_C0_90)",Renal Dialysis (B_1_C26_74),NF (A_C2_45),Speech Pathology (D_4_IRF_C13_68),Number of stations (S5_C1_6),Cardiac Catheterization (D3_IPF_C2_59),Does the hospital elect a fully prospective payment method for capital costs? (Y/N) (S2_1_C1_48),"ADJUSTED SALARIES, Medical Records & Med Records Library (S3_2_C4_41)",Total discharges (S3_1_C15_1),OLTC (S3_1_C8_21),Radioisotope (B_1_C26_56),Coronary Care Unit (S3_1_C6_9),Home Program Dialysis (D3_IRF_C2_94),"Net Expense for Cost Allocation, Total (B_1_C0_200)",Occupational Therapy (B_2_C26_67),"Donations, Land (A7_1_C3_1)","Blood Storing, Processing, Trans (A_C1_63)","HHA II, Without Outliers:  Other Charges (S4_HHA2_C1_34)","HHA I, PEP Episodes:  Total Number of Episodes (S4_HHA1_C4_36)",Other Outpatient Services (D3_IPF_C2_93),Cost of patients approved for charity care and uninsured discounts (S10_C2_21),Anesthesiology (D3_HOS_C2_53),"HHA III, PEP Episodes:  Total Number of Episodes (S4_HHA3_C4_36)","Total Outpatient Charges, Radiology-Therapeutic (C_1_C7_55)",NF (C_1_C5_45),"Allocation of Interns & Residents Program Costs, OLTC (B_1_C22_46)","Total, New Cap Related Csts Movable Equipment (A7_3_C15_2)",Hospice 1 Provider Number (S2_1_C2_14),Buildings (G_C1THRU4_15),"Net Expense for Cost Allocation, Subprovider I (B_1_C0_42)",Pancreas Acquisition (B_1_C21_109),Occupational Therapy (D_4_IRF_C11_67),"HHA II, Total Charges:  LUPA Episodes (S4_HHA2_C3_35)",Respiratory Therapy (B_2_C26_65),Occupational Therapy (D_4_HOS_C10_67),"PAID HOURS RELATED TO SALARIES, Administrative and General under Contract (S3_2_C5_28)",Electrocardiology (D_4_HOS_C4_69),Average times dialyzers re-used (S5_C1_9),Labor and Delivery (S3_1_C3_32),"HHA I, Without Outliers:  Non Routine Med Sup Chgs (S4_HHA1_C1_38)","Disposals and Retirements, Land Improvements (A7_1_C5_2)","Gift, Flower, Coffee Shop, Canteen (B_2_C26_190)",Surgical Intensive Care Unit (A_C1_34),Physicians' Private Office (B_1_C26_192),Electrocardiology (D_4_IPF_C13_69),Operating Room (D_4_HOS_C2_50),CT Scan (A_C6_57),"Does this facility operate 
transplant center? (Y/N) (S2_1_C1_125)",Provider's actual MSA or CBSA (S2_1_C3_3),Respiratory Therapy (A_C1_65),Other Organ Acquisition (B_2_C26_112),"HHA II, With Outliers:  Number of Episodes (S4_HHA2_C2_37)",Line 2 times line 5 (E_B_HOS_C101_6),In State Medicaid eligible days (S2_1_C2_24),Speech Pathology (D3_SNF_C2_68),Total Income (G3_C1_26),"Total Outpatient Charges, Anesthesiology (C_1_C7_53)",Liver Acquisition (B_1_C26_107),Cost To Charge Ratio (S10_C1_1),Renal Dialysis (C_1_C7_74),"TOTAL CAPITAL COSTS AFTER COST ALLOCATION, Cardiac Catheterization (B_2_C26_59)","PPS REIMBURSED SERVICES -  CHARGES, Intravenous Therapy (D_5_HOS_C2_64)","PPS SERVICES COST, Speech Pathology (D_5_HOS_C5_68)",Clinic (D3_HOS_C2_90),TOTAL (D3_IPF_C2_200),"Net Expense for Cost Allocation, Recovery Room (B_1_C0_51)",RHC (B_1_C21_88),"Other Capital Related Costs, New Cap Related Csts Bldg & Fixtures (A7_3_C7_1)",ASC (Non Distinct Part) (D_4_SNF_C11_75),Speech Pathology (B_1_C26_68),"TOTAL CAPITAL COSTS AFTER COST ALLOCATION, CT Scan (B_2_C26_57)",Radiology-Therapeutic (D_4_IPF_C11_55),Intensive Care Unit (A_C1_31),Other Outpatient Services (D_4_IPF_C13_93),Interim payments (E_B_HOS_C1_41),Other Special Purpose (B_2_C26_117),"Number of Times per week
 Patient receives Dialysis (S5_C2_2)","HHA II, Total Charges (S4_HHA2_C5_35)","COST REIMBURSED SERVICES NOT SUBJECT TO DEDUCTIBLES AND COINSURANCE - CHARGES, MRI (D_5_HOS_C4_58)","HHA I, Total Visits (S4_HHA1_C5_33)",Electroencephalography (C_1_C6_70),Subtotal (E_B_HOS_C1_37),"AMOUNT REPORTED, Other General Service (S3_2_C2_43)","ADJUSTED SALARIES, Non-Physician Anesthetist Part B (S3_2_C4_3)",Whole Blood & Packed Red Blood Cells (D3_IRF_C2_62),"Allocation of Interns & Residents Program Costs, Recovery Room (B_1_C22_51)",IRF (S3_1_C3_17),Intensive Care Unit (D_1_HOS_C6_31),Clinic (D_4_HOS_C11_90),"Blood Storing, Processing, Trans (C_1_C6_63)","Net Expense for Cost Allocation, Nursery (B_1_C0_43)",Nonpaid Workers (A_C2_193),"ADJUSTED SALARIES, Subtotal Wage Related Csts (S3_3_C4_5)",Emergency (D3_HOS_C2_91),Ambulance Services (A_C2_95),Emergency (D_4_HOS_C13_91),"PPS SERVICES COST, Physical Therapy (D_5_HOS_C5_66)","AMOUNT REPORTED, Excluded Area Salaries (S3_2_C2_10)",Respiratory Therapy (D_4_IRF_C13_65),"PPS REIMBURSED SERVICES -  CHARGES, Operating Room (D_5_HOS_C2_50)","AVERAGE HOURLY WAGE, Excluded Area Salaries (S3_3_C6_2)",ASC (Distinct Part) (A_C1_115),Other Outpatient Services (D_4_IRF_C13_93),"TOTAL CAPITAL COSTS AFTER COST ALLOCATION, Adults & Pediatrics (B_2_C26_30)","General Inpatient Routine Service Cost, net of Swing Bed and Private Room Diff (D1_SNF_C1_37)",Radiology-Therapeutic (A_C1_55),Other Reimbursable (B_1_C22_98),"Blood Storing, Processing, Trans (D3_SNF_C3_63)",Radioisotope (D_4_IPF_C13_56),Laboratory (D3_HOS_C3_60),"COST SERVICES NOT SUBJECT TO DEDUCTIBLES AND COINSURANCE - COST, Other Reimbursable (D_5_HOS_C7_98)","COST SERVICES SUBJECT TO DEDUCTIBLES AND COINSURANCE - COST, Operating Room (D_5_HOS_C6_50)","HHA I, LUPA:  Total Non Routine Med Sup Chgs (S4_HHA1_C3_38)",Subprovider-IRF (A_C6_41),Occupational Therapy (D3_HOS_C2_67),Surgical Intensive Care Unit (D_1_HOS_C7_34),Negative Cost Centers (B_1_C26_201),"HHA III, Without Outliers:  Non Routine Med Sup Chgs (S4_HHA3_C1_38)","AMOUNT REPORTED, Physician Part B (S3_2_C2_23)",Interns & Res Salary and Fringe Benefits (A_C2_21),"PPS REIMBURSED SERVICES -  CHARGES, Cardiac Catheterization (D_5_HOS_C2_59)",Occupational Therapy (D_4_SNF_C11_67),Pancreas Acquisition (B_1_C26_109),RHC 16 Provider Number (S2_1_C2_1515),Electroencephalography (C_1_C5_70),Total Allied Health Cost (D_3_HOS_C2_200),Home Program Dialysis (D_4_HOS_C12_94),"AVERAGE HOURLY WAGE, Non-Physician Anesthetist Part A (S3_2_C6_2)",RHC/FQHC Combined (S3_1_C6_26),Negative Cost Centers (B_2_C26_201),"AVERAGE HOURLY WAGE, Contract Labor:  Physician Part A (S3_2_C6_13)",City (S2_1_C1_143),"PPS REIMBURSED SERVICES -  CHARGES, CT Scan (D_5_HOS_C2_57)",Other Reimbursable (D_4_HOS_C12_98),"COST SERVICES NOT SUBJECT TO DEDUCTIBLES AND COINSURANCE - COST, Emergency (D_5_HOS_C7_91)",Outlier payments (E_B_HOS_C1_4),Heart Acquisition (B_1_C21_106),Subprovider-IPF (C_1_C5_40),IRF (S3_1_C8_17),Durable Medical Equipment Sold (D_4_HOS_C13_97),Total customary charges (E_B_HOS_C1_18),"AMOUNT REPORTED, Total (S3_3_C2_6)",Surgical Intensive Care Unit (A_C2_34),Intravenous Therapy (D3_HOS_C3_64),IRF (S3_1_C6_17),"HHA III, Total Non Routine Medical  Supply Charges (S4_HHA3_C5_38)","PAID HOURS RELATED TO SALARIES, Cafeteria (S3_2_C5_36)","ADJUSTED SALARIES, Home Office Personnel (S3_2_C4_8)","Total Inpatient Charges, Subprovider-IRF (C_1_C6_41)",Physical Therapy (D_4_HOS_C10_66),Radioisotope (A_C6_56),OSP (A_C6_9940),OSP (C_1_C5_9940),FQHC 7 Provider Number (S2_1_C2_1606),"AVERAGE HOURLY WAGE, Teaching Physician Salaries (S3_2_C6_16)",MRI (D_4_IPF_C13_58),MDH status beginning date  (MM/DD/YY) (S2_1_C1_3801),SNF (S3_1_C6_19),Subprovider-IPF (D3_IPF_C2_40),Kidney Acquisition (A_C2_105),Durable Medical Equipment Rented (C_1_C7_96),Interns & Res Other Program Costs (A_C1_22),HHA (S3_1_C6_22),"HHA I, With Outliers:  Number of Episodes (S4_HHA1_C2_37)",OLTC (B_1_C26_46),Whole Blood & Packed Red Blood Cells (D_4_SNF_C11_62),"COST REIMBURSED SERVICES SUBJECT TO DEDUCTIBLES  AND COINSURANCE - CHARGES, Electrocardiology (D_5_HOS_C3_69)","HHA I, Total Number of Outlier Episodes (S4_HHA1_C5_37)",Employee Benefits (A_C6_4),New Capital Buildings and Fixtures (A_C2_1),Electrocardiology (D3_HOS_C2_69),Renal Dialysis (D3_HOS_C2_74),"Net Expense for Cost Allocation, Other Special Purpose (B_1_C0_117)",Target Amount (D1_HOS_C1_56),Medicare Certified Heart TC term date (S2_1_C2_127),Other Organ Acquisition (A_C2_112),Observation Beds (Distinct Unit) (B_1_C22_9201),Hospice (A_C1_116),"PAID HOURS RELATED TO SALARIES, Subtotal Salaries (S3_3_C5_3)",Outpatient Revenue (G2_C2_28),Intensive Care Unit Program Cost (D1_HOS_C5_43),Impl. Dev. Charged to Patients (D3_IPF_C2_72),RHC 7 Provider Number (S2_1_C2_1506),"AVERAGE HOURLY WAGE, Nursing Administration (S3_2_C6_38)",Ambulance Services (C_1_C5_95),"Total Outpatient Charges, Delivery Room and Labor Room (C_1_C7_52)","HHA III, LUPA:  Total Non Routine Med Sup Chgs (S4_HHA3_C3_38)",Total Charges (C_1_C8_202),Speech Pathology (C_1_C7_68),Physical Therapy (D_4_HOS_C13_66),Anesthesiology (A_C2_53),Anesthesiology (D_4_IPF_C13_53),"COST SERVICES NOT SUBJECT TO DEDUCTIBLES AND COINSURANCE - COST, Durable Medical Equipment Rented (D_5_HOS_C7_96)","COST SERVICES NOT SUBJECT TO DEDUCTIBLES AND COINSURANCE - COST, Delivery Room and Labor Room (D_5_HOS_C7_52)","COST SERVICES NOT SUBJECT TO DEDUCTIBLES AND COINSURANCE - COST, MRI (D_5_HOS_C7_58)",Renal 2 Provider Number (S2_1_C2_1801),ICF (B_1_C26_4501),"PAID HOURS RELATED TO SALARIES, Maintenance of Personnel (S3_2_C5_37)","COST REIMBURSED SERVICES SUBJECT TO DEDUCTIBLES  AND COINSURANCE - CHARGES, Delivery Room and Labor Room (D_5_HOS_C3_52)",Other Reimbursable (D3_IPF_C3_98),"AMOUNT REPORTED, Administrative and General (S3_2_C2_27)",Subprovider-IRF (B_1_C26_41),"PPS REIMBURSED SERVICES -  CHARGES, Electroencephalography (D_5_HOS_C2_70)",Emergency (D_4_IPF_C13_91),Radiology-Diagnostic (D_4_IRF_C11_54),Total discharges (S3_1_C15_17),"Allocation of Interns & Residents Salary and Fringes, Operating Room (B_1_C21_50)",Pass through Cost for Program Inpatient Routine (D1_HOS_C1_50),Total Allied Health (D_4_HOS_C3_200),"COST REIMBURSED SERVICES SUBJECT TO DEDUCTIBLES  AND COINSURANCE - CHARGES, Intravenous Therapy (D_5_HOS_C3_64)",Operating Room (D_4_IPF_C11_50),Medical Supplies Charged to Patients (C_1_C6_71),Medical Supplies Charged to Patients (D3_IPF_C2_71),"AVERAGE HOURLY WAGE, Excluded Area Salaries (S3_2_C6_10)",RHC (A_C1_88),Cafeteria (A_C1_11),"PAID HOURS RELATED TO SALARIES, Excluded Area Salaries (S3_2_C5_10)","Blood Storing, Processing, Trans (D_4_IRF_C11_63)",Total Program Excludable Costs (D1_IRF_C1_52),Total (D_1_HOS_C6_200),MRI (D_4_HOS_C11_58),Adults & Pediatrics (D_1_HOS_C7_30),Impl. Dev. Charged to Patients (D3_SNF_C3_72),Clinic (A_C2_90),"COST REIMBURSED SERVICES NOT SUBJECT TO DEDUCTIBLES AND COINSURANCE - CHARGES, Observation Beds (Distinct Unit) (D_5_HOS_C4_9201)",Subprovider I (B_1_C26_42),"PPS REIMBURSED SERVICES -  CHARGES, Recovery Room (D_5_HOS_C2_51)",Surgical Intensive Care Unit (C_1_C5_34),"AMOUNT REPORTED, Non-Physician Anesthetist Part A (S3_2_C2_2)","ADJUSTED SALARIES, Total (S3_3_C4_6)",Total Liabilities and Fund Balances (G_C1THRU4_54),Laundry and Linen Service (A_C6_8),"Net Expense for Cost Allocation, Other Ancillary (B_1_C0_76)","COST SERVICES NOT SUBJECT TO DEDUCTIBLES AND COINSURANCE - COST, Speech Pathology (D_5_HOS_C7_68)","ADJUSTED SALARIES, Cafeteria (S3_2_C4_36)","Net Expense for Cost Allocation, Radiology-Diagnostic (B_1_C0_54)",Intravenous Therapy (D_4_HOS_C4_64),"COST REIMBURSED SERVICES NOT SUBJECT TO DEDUCTIBLES AND COINSURANCE - CHARGES, Laboratory (D_5_HOS_C4_60)",Anesthesiology (D_4_IRF_C13_53),Research (A_C2_191),Durable Medical Equipment Rented (D3_HOS_C2_96),Total Long-term Liabilities (G_C1THRU4_50),ICF (S3_1_C10_2001),Total Other Medical Education (D_4_IPF_C4_200),RPCH/CAH Visits (S3_1_C6_15),"ADJUSTED SALARIES, Non-Physician Part B (S3_2_C4_6)",CMHC (B_1_C21_99),Liver Acquisition (C_1_C6_107),"COST SERVICES SUBJECT TO DEDUCTIBLES AND COINSURANCE - COST, Impl. Dev. Charged to Patients (D_5_HOS_C6_72)",Total Program Excludable Costs (D1_IPF_C1_52),IRF (S3_1_C7_17),MRI (A_C6_58),"Allocation of Interns & Residents Program Costs, Laboratory (B_1_C22_60)",Total Nursing School (D_4_IPF_C2_200),"Average patient dialysis time 
including setup (S5_C4_3)","Net Expense for Cost Allocation, Subprovider-IPF (B_1_C0_40)",SNF (S3_1_C7_19),Recovery Room (D_4_HOS_C13_51),Other Ancillary (D_4_IPF_C13_76),Total Costs (D_3_HOS_C5_200),ASC (Non Distinct Part) (A_C2_75),"HHA I, LUPA Episodes:  Other Charges (S4_HHA1_C3_34)",Heart Acquisition (A_C1_106),"Allocation of Interns & Residents Salary and Fringes, Respiratory Therapy (B_1_C21_65)","PAID HOURS RELATED TO SALARIES, Dietary (S3_2_C5_34)",Other Capital (A_C6_3),"Average patient dialysis time 
including setup (S5_C2_3)",SNF Provider Number (S2_1_C2_9),Blood Clotting Factors for Hemoph. (D_4_HOS_C3_6250),"Allocation of Interns & Residents Salary and Fringes, Coronary Care Unit (B_1_C21_32)",Impl. Dev. Charged to Patients (A_C2_72),Coronary Care Unit (D3_HOS_C2_32),"Donations, Movable Equipment (A7_1_C3_6)",CT Scan (D_4_SNF_C11_57),Observation Beds (Distinct Unit) (A_C6_9201),Total prospective payment (E_B_HOS_C1_24),Burn Intensive Care Unit (S3_1_C7_10),"COST REIMBURSED SERVICES NOT SUBJECT TO DEDUCTIBLES AND COINSURANCE - CHARGES, Radioisotope (D_5_HOS_C4_56)",Renal Dialysis (C_1_C6_74),Number of EPO units furnished for Line 13 (S5_C1_15),"AVERAGE HOURLY WAGE, Total Salaries (S3_2_C6_1)",Net Revenue from stand-alone SCHIP (S10_C1_9),Total Fixed Assets (G_C1THRU4_30),"PAID HOURS RELATED TO SALARIES, Dietary under Contract (S3_2_C5_35)","Allocation of Interns & Residents Program Costs, Radioisotope (B_1_C22_56)","HHA III, PEP:  Total Non Routine Med Supply Chgs (S4_HHA3_C4_38)",ASC (Non Distinct Part) (D3_HOS_C2_75),"Allocation of Interns & Residents Salary and Fringes, Subprovider-IPF (B_1_C21_40)","General Inpatient Routine Service Cost, net of Swing Bed and Private Room Diff (D1_HOS_C1_37)","Allocation of Interns & Residents Salary and Fringes, Anesthesiology (B_1_C21_53)",Cardiac Catheterization (D3_IRF_C2_59),"Blood Storing, Processing, Trans (D3_IPF_C2_63)",Excess of reasonable cost over reasonable charges (E_B_HOS_C1_20),"Fully Depreciated Assets, Subtotal (A7_1_C7_8)",Home Office PO Box (S2_1_C2_142),"Number of Times per week
 Patient receives Dialysis (S5_C6_2)",Total (C_1_C5_202),"Allocation of Interns & Residents Salary and Fringes, Intravenous Therapy (B_1_C21_64)",ASC (Non Distinct Part) (A_C1_75),RHC 1 Provider Number (S2_1_C2_15),Other Special Care Unit (A_C1_35),"Net Expense for Cost Allocation, Other Reimbursable (B_1_C0_98)","Net Expense for Cost Allocation, Research (B_1_C0_191)","COST REIMBURSED SERVICES SUBJECT TO DEDUCTIBLES  AND COINSURANCE - CHARGES, CT Scan (D_5_HOS_C3_57)",MSP-LCC reconciliation amount (E_B_HOS_C1_38),Radioisotope (D3_HOS_C2_56),Adjusted reimburseable bad debts (E_B_HOS_C1_35),ICF (S3_1_C8_2001),"PPS SERVICES COST, Radioisotope (D_5_HOS_C5_56)",Fixed Equipment (G_C1THRU4_19),"COST REIMBURSED SERVICES NOT SUBJECT TO DEDUCTIBLES AND COINSURANCE - CHARGES, Drugs Charged to Patients (D_5_HOS_C4_73)",OLTC (A_C1_46),Total Salaries (A_C2_200),Laboratory (D_4_HOS_C4_60),"AMOUNT REPORTED, Dietary (S3_2_C2_34)","Disposals and Retirements, Subtotal (A7_1_C5_8)",Radioisotope (D_4_HOS_C13_56),Whole Blood & Packed Red Blood Cells (D_4_IPF_C11_62),"Allocation of Interns & Residents Salary and Fringes, Speech Pathology (B_1_C21_68)","PAID HOURS RELATED TO SALARIES, Physician-Part A (S3_2_C5_4)","HHA II, LUPA Episodes:  Total Number of Episodes (S4_HHA2_C3_36)",Radioisotope (A_C2_56),Durable Medical Equipment Rented (D3_IRF_C2_96),Clinic (D_4_HOS_C10_90),"PPS SERVICES COST, Operating Room (D_5_HOS_C5_50)",Delivery Room and Labor Room (D_4_HOS_C10_52),CORF (C_1_C5_9910),"ADJUSTED SALARIES, Interns & Residents (S3_2_C4_2551)",Laboratory (D3_HOS_C2_60),CT Scan (A_C1_57),Islet Acquisition (A_C1_111),Impl. Dev. Charged to Patients (D_4_HOS_C2_72),CMHC (C_1_C7_99),Total Hospital Interns & Residents (S3_1_C9_14),"PAID HOURS RELATED TO SALARIES, Housekeeping (S3_2_C5_32)",Other Ancillary (B_1_C21_76),"General Inpatient Routine Service Cost, net of Swing Bed and Private Room Diff (D1_IPF_C1_37)",ASC (Non Distinct Part) (D3_HOS_C3_75),Liver Acquisition (B_1_C21_107),Coronary Care Unit (D3_IPF_C2_32),ASC (Non Distinct Part) (D3_IRF_C3_75),Clinic (B_1_C22_90),Anesthesiology (D_4_HOS_C12_53),"PPS REIMBURSED SERVICES -  CHARGES, Observation Beds (Distinct Unit) (D_5_HOS_C2_9201)",Home Program Dialysis (D3_IPF_C3_94),Drugs Charged to Patients (D3_HOS_C3_73),Hospice 2 Provider Number (S2_1_C2_1401),Zip Code (S2_1_C3_143),Recovery Room (D_4_SNF_C11_51),"COST REIMBURSED SERVICES SUBJECT TO DEDUCTIBLES  AND COINSURANCE - CHARGES, Occupational Therapy (D_5_HOS_C3_67)",Heart Acquisition (B_1_C26_106),"AMOUNT REPORTED, Wage Related Costs Other (S3_2_C2_18)",Cost of charity care (S10_C3_23),Other Organ Acquisition (A_C1_112),Laundry and Linen Service (A_C2_8),HRR adjustment amount  (E_A_HOS_C1_7094),"Sum of lines 3,4 divided by line 6 (E_B_HOS_C101_7)",Laboratory (A_C6_60),Kidney Acquisition (B_2_C26_105),Laboratory (D_4_HOS_C12_60),"AVERAGE HOURLY WAGE, Housekeeping under Contract (S3_2_C6_33)","HHA II, With Outliers:  Non Routine Med Sup Chgs (S4_HHA2_C2_38)",FQHC 5 Provider Number (S2_1_C2_1604),"HHA I, Without Outliers:  Total Visits (S4_HHA1_C1_33)",Total Subprovider II Interns & Residents (S3_1_C10_1801),"Insurance, New Cap Related Csts Bldg & Fixtures (A7_3_C5_1)",Anesthesiology (D_4_HOS_C10_53),"Treatment capacity per day per
station (S5_C2_7)","Net Expense for Cost Allocation, Impl. Dev. Charged to Patients (B_1_C0_72)","Allocation of Interns & Residents Salary and Fringes, Recovery Room (B_1_C21_51)",Total Other Income (G3_C1_25),ASC (Non Distinct Part) (D_4_HOS_C12_75),"COST SERVICES SUBJECT TO DEDUCTIBLES AND COINSURANCE - COST, ASC (Non Distinct Part) (D_5_HOS_C6_75)","Net Expense for Cost Allocation, Durable Medical Equipment Sold (B_1_C0_97)","PPS REIMBURSED SERVICES -  CHARGES, Radioisotope (D_5_HOS_C2_56)",Intravenous Therapy (D_4_HOS_C10_64),Radiology-Diagnostic (D_4_IPF_C13_54),FQHC 3 Provider Number (S2_1_C2_1602),Other Long-term Liabilities (G_C1THRU4_49),Hospital Adults & Pediatrics (S3_1_C2_1),"AVERAGE HOURLY WAGE, Pharmacy (S3_2_C6_40)",Anesthesiology (D3_IRF_C2_53),Speech Pathology (D3_HOS_C3_68),Cardiac Catheterization (D_4_HOS_C2_59),PBP Clinical Lab Services Program Only (D3_HOS_C3_61),"TOTAL CAPITAL COSTS AFTER COST ALLOCATION, Surgical Intensive Care Unit (B_2_C26_34)",Deferred Income (G_C1THRU4_41),"PPS SERVICES COST, Blood Clotting Factors for Hemoph. (D_5_HOS_C5_6250)","COST REIMBURSED SERVICES NOT SUBJECT TO DEDUCTIBLES AND COINSURANCE - CHARGES, Electrocardiology (D_5_HOS_C4_69)",OOT (C_1_C5_9930),Drugs Charged to Patients (D3_SNF_C3_73),Recovery Room (D_4_HOS_C2_51),MRI (D_4_HOS_C13_58),"COST REIMBURSED SERVICES SUBJECT TO DEDUCTIBLES  AND COINSURANCE - CHARGES, Whole Blood & Packed Red Blood Cells (D_5_HOS_C3_62)",Cardiac Catheterization (B_1_C26_59),Hospital County (S2_1_C4_2),Radiology-Therapeutic (A_C6_55),"AMOUNT REPORTED, Wage Related Costs RHC/FQHC (S3_2_C2_24)","COST SERVICES NOT SUBJECT TO DEDUCTIBLES AND COINSURANCE - COST, CT Scan (D_5_HOS_C7_57)",Ancillary service other pass through costs (E_B_HOS_C1_9),Durable Medical Equipment Sold (D_4_HOS_C12_97),Program Inpatient Ancillary Service Cost (D1_IPF_C1_48),"Blood Storing, Processing, Trans (D_4_HOS_C13_63)",Operating Room (D_4_SNF_C11_50),Impl. Dev. Charged to Patients (D3_IPF_C3_72),Radioisotope (D_4_IRF_C11_56),"Net Expense for Cost Allocation, Gift, Flower, Coffee Shop, Canteen (B_1_C0_190)",Intravenous Therapy (D_4_HOS_C12_64),Utilization (S5_C1_8),Total Allied Health (D_4_IRF_C3_200),"PPS SERVICES COST, Observation Beds (Distinct Unit) (D_5_HOS_C5_9201)",Delivery Room and Labor Room (A_C2_52),or allied health costs? (S2_1_C1_60),CMS Region Code (REGION),"Insurance, New Cap Related Csts Movable Equipment (A7_3_C5_2)","PPS SERVICES COST, Electrocardiology (D_5_HOS_C5_69)",Other Special Care Unit (C_1_C5_35),Adj for Occupational therapy in excess of li (A8_C2_30),Other Ancillary (D_4_HOS_C2_76),"AMOUNT REPORTED, SNF (S3_2_C2_9)","HHA III, Total Number of Episodes (S4_HHA3_C5_36)","COST REIMBURSED SERVICES SUBJECT TO DEDUCTIBLES  AND COINSURANCE - CHARGES, Other Reimbursable (D_5_HOS_C3_98)",Radiology-Therapeutic (D_4_SNF_C11_55),"COST REIMBURSED SERVICES NOT SUBJECT TO DEDUCTIBLES AND COINSURANCE - CHARGES, Electroencephalography (D_5_HOS_C4_70)",Other Reimbursable (A_C2_98),"AMOUNT REPORTED, Cafeteria (S3_2_C2_36)",Burn Intensive Care Unit (S3_1_C3_10),Burn Intensive Care Unit (D3_HOS_C2_33),Home Office Name (S2_1_C1_141),Laboratory (D_4_HOS_C11_60),Heart Acquisition (A_C2_106),CT Scan (D3_HOS_C3_57),Respiratory Therapy (D_4_HOS_C12_65),"COST SERVICES SUBJECT TO DEDUCTIBLES AND COINSURANCE - COST, Medical Supplies Charged to Patients (D_5_HOS_C6_71)",Average times dialyzers re-used (S5_C2_9),Clinic (A_C6_90),Impl. Dev. Charged to Patients (D_4_IRF_C11_72),Anesthesiology (D3_SNF_C3_53),"Net Expense for Cost Allocation, Cafeteria (B_1_C0_11)","PAID HOURS RELATED TO SALARIES, Home Office Salaries & Wage Related Csts (S3_2_C5_14)","COST REIMBURSED SERVICES SUBJECT TO DEDUCTIBLES  AND COINSURANCE - CHARGES, Other Outpatient Services (D_5_HOS_C3_93)","PPS REIMBURSED SERVICES -  CHARGES, Anesthesiology (D_5_HOS_C2_53)","Number of patients in program at 
end of cost reporting period (S5_C2_1)",Organ Procurement (D4_HEART_C1_69),"HHA III, PEP Episodes:  Total Charges: (S4_HHA3_C4_35)",Hospice (S3_1_C9_24),"COST SERVICES SUBJECT TO DEDUCTIBLES AND COINSURANCE - COST, CT Scan (D_5_HOS_C6_57)","Total Inpatient Charges, Adults & Pediatrics (C_1_C6_30)",Organ Procurement (D4_KIDNEY_C1_69),"General Inpatient Routine Service Cost, net of Swing Bed and Private Room Diff (D1_IRF_C1_37)",Electroencephalography (D_4_HOS_C4_70),Total Nursing School (D_4_IRF_C2_200),Hospital Adlts & Ped Swing Bed SNF (S3_1_C8_5),Other Outpatient Services (A_C2_93),"COST SERVICES NOT SUBJECT TO DEDUCTIBLES AND COINSURANCE - COST, ASC (Non Distinct Part) (D_5_HOS_C7_75)",Recovery Room (D_4_HOS_C10_51),"Net Expense for Cost Allocation, Paramedical Education (B_1_C0_23)",Radioisotope (D_4_HOS_C4_56),HAC reduction adjustment amount (E_A_HOS_C1_7099),"PAID HOURS RELATED TO SALARIES, Physician-Part B (S3_2_C5_5)","ADJUSTED SALARIES, Admin & Gen Under Contract (S3_2_C4_29)",Operating Room (D_4_HOS_C3_50),Intravenous Therapy (B_1_C26_64),Kidney Acquisition (C_1_C7_105),Utilization Review SNF (A_C6_114),Is this a New Hospital under 42 CFR 413.40(f)(1)(I) (TEFRA)? (Y/N) (S2_1_C1_85),"Net Expense for Cost Allocation, Other Organ Acquisition (B_1_C0_112)",Total Outpatient Program Pass Thru Cost (D_4_HOS_C6_200),Renal Dialysis (D3_IRF_C3_74),Nursery (C_1_C5_43),FFY,Hospital Type (From CMS Hospitals Data Archive),Name and Num
4381,NORTH SHORE UNIVERSITY HOSPITAL (330106),General Short Term (Acute Care Hospitals),Voluntary Nonprofit-Other,-73.703029,40.779269,47796.0,2370.0,,,,,14904791.0,,,,67296087.0,,80307625.0,137545919.0,402692.0,34907210.0,,,3597032.0,,,,,,,,,,,755051.0,,,,40271.0,,,,429829687.0,70055.0,,,,,,22933645.0,,,,,1629359.0,,,,158029849.0,,6759299.0,,,,,358866.0,,,,,,209198.0,,,14495641.0,,,,,7562163.0,,22636758.0,,,,,13173.0,,283917.0,,32038933.0,,21414145.0,,,3431146.0,,2374809.0,,35285715.0,,,,,,,,,,,801550870.0,681279.0,6065866.0,,10705717.0,,,,,6913.0,,,46789.0,,2340794.0,,,2913428.0,,,,,40.0,21150.0,,,,100752.0,,,N,,,-326300453.0,,,942571.0,245285.0,1420678.0,,9208.0,,14928819.0,11068270.0,,,,,,2577321.0,,27682.0,,,,,,-272169719.0,86123443.0,2691.0,,,,75431.0,,,,6065866.0,,2140765.0,,,,,,3883811.0,12010924.0,,,,,25.95,25746940.0,,,,,,,,,,C,17785281.0,-10146424.0,,,,44647060.0,,428.0,75388.0,,,,,,850312279.0,,,8109694.0,,,,2384118.0,76291.0,109674110.0,6082243.0,,,,,,553129.0,7028814.0,,,8567601.0,,7373995.0,,61583.0,,3531067.0,,,23.53,48552917.0,18458297.0,,,280242.0,,,5290971.0,,,19249921.0,330106,,185448480.0,150596.0,,1061919.0,,-1069004.0,,,221322786.0,,,,84.0,,6084535.0,,199.2,,,,General Short Term,,380421.0,3597032.0,,,,,,,,,,211782.0,,,,23736.0,15986176.0,,,,,5032535.0,1535218949.0,,,,8233946.0,,88159340.0,,,,,18068673.0,,N,14116258.0,,,,,,-51226.0,,42776116.0,25746940.0,,,,,,,,,,,143254050.0,26615219.0,,,848482.0,38398132.0,,,,,,,,,,,12946170.0,115516768.0,,,NY,,,,,,,404570.0,,1660769666.0,,,1629359.0,2175913.0,,,363054.0,575706.0,68290856.0,,11109370.0,,1043732.0,260128.0,,,,3084726268.0,35707028.0,,,,,,22.71,,,,,184.0,,7752.0,,22447.0,,11748974.0,,439289.0,8032857.0,30733342.0,,104690749.0,210.0,,,,2479271.0,8109694.0,,,610780.0,,,,,3956390.0,14350331.0,42074975.0,6558637.0,,,,,,119282407.0,,49127226.0,304111.0,,12053738.0,,,,,,231838.0,16645328.0,5096393.0,,,,929753.0,-1731521.0,,1773.0,14389765.0,,,,,38.89,1388599947.0,,,35.0,3711.0,,,,920410.0,6017303.0,,,,,,,68056104.0,32309866.0,,,,,1635607.0,,12053738.0,,,,103017016.0,872245.0,,112645.0,-2806478.0,23.78,,,,337148,404253377.0,,,,,,,,165358.0,,,2363189.0,,20457.0,33.3,33S106,,,6558637.0,,,,,,,205736001.0,222610311.0,,,,N,14904791.0,321841.0,,,,,,7269809.0,,,,73640609.0,,,,35784649.0,847962.0,,,425649.0,,,,10298790.0,,2491859.0,,,,1061919.0,420323.0,,,,30842820.0,,625955.0,,,219101.0,10905815.0,,,,,22872.0,,,13182809.0,368621.0,13207.0,,,,,,,2117.0,39.67,,1732933.0,,655545899.0,4038.0,24079576.0,,,14600.0,,,,,779835.0,,,,,,,,3488470.0,,,,2032195.0,2466262.0,,12885997.0,,22847315.0,21511435.0,,249.0,,,,,,,,,,16885882.0,,-5156912.0,,41374.0,,,,35634830.0,,,16305574.0,122407565.0,2127440.0,,,,2.0,,,,,15715083.0,,,,,13011538.0,,,,663512.0,,205736001.0,122358538.0,,8967732.0,15889.0,109356.0,,,,,,,15866072.0,,,4875.0,443259.0,54677203.0,,16322136.0,,,,100678585.0,20.1,2767839.0,,,,,,-120340.0,,,,,,410718.0,,,,,,1020261.0,,5,20455108.0,,,1027965.0,,,,,,,,,,634.0,,,617.0,105015396.0,,,274815.0,,9201530.0,,,,18615.0,,53.0,9627244.0,44367840.0,466671.0,,,,,,,,,165898946.0,,,,,4725688.0,43759612.0,,,184527.0,,25882104.0,80729612.0,4180437.0,1458681.0,,,,,,,234465029.0,,777.0,,2153284.0,6796334.0,1436140.0,,,,,,655545899.0,,,,9381911.0,,7681125.0,,137642726.0,,35.37,,,,13977717.0,2751747.0,,,,,4397983.0,-60324.0,566359.0,,,16929.0,,68330.0,,3431146.0,,,,17369138.0,,-51226.0,39164.0,,793945.0,,,13304723.0,,,,15206.0,,,,,26805950.0,,,1629359.0,165120974.0,,4412137138.0,405429.0,P,,,231838.0,,,,,11291676.0,26636246.0,,,14350331.0,,,,,,2441222.0,,11068270.0,,3087646641.0,,,,15873176.0,6558637.0,,,19.0,,69155087.0,,,,,,25882104.0,,,,,,819.0,,553536831.0,95190.0,,,4.3,19073964.0,,,51558026.0,,95190.0,12321999.0,32185.0,,2374809.0,,,11976974.0,3492447.0,,NORTH SHORE UNIVERSITY HOSPITAL,5748097.0,,,,,,15671819.0,,300 COMMUNITY DRIVE,,,,3944.0,253966556.0,,,,16120219.0,,,,,25483.0,Y,,,,22579727.0,471941.0,,,443259.0,9768630.0,,1335156.0,2520899.0,,3521.0,3543731.0,,,,,267113593.0,250382.0,,,,14646902.0,,,,3944.0,,5039.0,70270817.0,7292268.0,,,,-163567334.0,7361155.0,32300361.0,388092.0,7500000.0,,55269185.0,,,,,,205214743.0,,,,12010924.0,,,,7030.0,,,,,,,,,,,,298843783.0,4457707.0,,,,101282312.0,168.0,129943.0,,7149584.0,,,,,,86789.0,,40252083.0,35798336.0,1321793.0,,,4488136.0,,,,9208.0,101407704.0,63977879.0,4107596.0,6941241.0,9664415.0,205214743.0,2014-04-25 00:00:00,,,,150536678.0,,,,,,,10705717.0,,,2192490.0,,22847315.0,,26035.0,,873186.0,,,36259314.0,,,267113593.0,,137055.0,,,36388142.0,13208504.0,,,,,,,569456.0,,19501527.0,99487.0,,,592844.0,2454049.0,,,140.0,30199.0,20165157.0,,,438287278.0,,,8296557.0,,,22319285.0,,,,,,447.0,,,108947697.0,,,8167019.0,,32804886.0,,2396876.0,,,F,24517585.0,43612717.0,27.57,,,2117.0,,,173855.0,,,,2011-12-31,848482.0,,,7974888.0,,,,13201,,,,37762013.0,7932389.0,,,13208504.0,68.65,,16322136.0,633844456.0,,119282407.0,,,98282590.0,,,2121736.0,,,,,1072.0,24897441.0,121150750.0,3023537191.0,,63977879.0,,,,,,,-500347.0,11019154.0,221007.0,,,,,2053131.0,-12590154.0,,54.0,,2374809.0,,,,,,,679047.0,,19249921.0,10298790.0,,,287.0,,,33400,,,498854.0,109766462.0,47108902.0,,,,,2394426.0,24194.0,,,,,,,1214341.0,,,24897441.0,3227456.0,,,,,319264.0,3002876.0,,285267.0,,1599040.0,,,,146858.0,,-357196.0,2493.0,,,,,2891554.0,2657381.0,2011-01-01 00:00:00,,,,935043779.0,,,,86123443.0,,,-445757910.0,,,-1177154.0,,,,,470902.0,,,,120.0,60993698.0,36029944.0,21951214.0,789115.0,,13796284.0,,2267.0,,,,,,,2679828.0,,,,,,,,,,,,,23.57,25038.0,3521.0,16826.0,,,,,3924898.0,,24664417.0,231838.0,,,,72572143.0,101362777.0,X,,,,,N,,,,,,7220776.0,,18781154.0,,,,-263163603.0,11120.0,,10245.0,,48552917.0,1082804569.0,,,,,,6054209.0,452392553.0,,,267053244.0,,,,,,16929.0,,,,10905815.0,,,2010.0,3355116.0,,56213055.0,,2523572.0,,,,-1959503.0,,,,,7233101.0,587783.0,,24367.0,,,,,,,123969150.0,,,,,68.65,,50927436.0,,,,,,15523733.0,34532450.0,,,58319545.0,,-30114.0,14928819.0,,,70879973.0,162748.0,,,5215038.0,,,324642.0,,,,,,48630897.0,225344.0,,,,737320.0,,,,,,72906598.0,,,,,04/04/2008,,,,,2873360.0,46.0,,90885.0,,,5679.0,,Y,,,9053313.0,,39.65,,,192.0,,,,,,,,35285715.0,,,96552917.0,,,,109445.0,,,1375189.0,5792626.0,28981.0,8140230.0,,55269185.0,,4875.0,-39778217.0,482205.0,3161938.0,,10357.0,,3792915.0,1542109.0,,51.8,35980399.0,801550870.0,,,334.0,801550870.0,104690749.0,,15889.0,,355865.0,,18421408.0,,,,,35634830.0,,2210740.0,,4.3,22319285.0,,24034164.0,,105928719.0,8172783.0,0.765,,,3.0,,101282312.0,1188743633.0,477496.0,25419737.0,,,1082804569.0,,,,,1165904.0,18942839.0,,,8648170.0,,,,,MANHASSET,,121150750.0,,32158.0,,39.66,,,,,Y,,11120.0,,,,312.9,,,,,,,24034164.0,-99722.0,8875969.0,,,,,,,6855229.0,,,,,,,,,17805079.0,39177776.0,32765740.0,,,907528.0,,,,,68056104.0,,,9951.0,-1959963.0,6491441.0,,,,,,,,218.28,,,,51937030.0,,7361155.0,,10245.0,,49699556.0,,5475.0,,4158997.0,,,,,,,80925.0,43612717.0,4039.0,,,69712.0,803789.0,,,,,11976974.0,,154786.0,,920410.0,,1.0,,-5746854.0,64523098.0,,8282217.0,,10030,1078169.0,,103329.0,475932.0,5970913.0,13011538.0,,,,42995681.0,,,-35182.0,20587708.0,,21319.0,,,,,,,,29842.0,,,,,,16078953.0,,168020962.0,,,,-502236.0,10905815.0,,,,83520970.0,159701540.0,1415908.0,,,46789.0,,,,,,,3773238.0,,85484.0,,,,,,61709.0,88568766.0,,,,N,,2084578.0,,,8096.1,,,,,,,51.0,319264.0,NSUH PSYCHIATRIC EXEMPT UNIT,13173.0,,304000.0,358866.0,,267113593.0,104.0,,,,21414145.0,,,,,,,2346583.0,,15715083.0,1629359.0,,,,,,,,,112672.0,52.99,,16120219.0,,,219.68,20587708.0,,,,,,,,,,,16171942.0,13878.0,,,,7.0,,,,137055.0,,,648455.0,994405.0,,,6759299.0,1151.0,3.0,8648170.0,-4033228.0,,9412833.0,,6017303.0,,23834865.0,4312679.0,,,,,,2611588.0,,42510726.0,,14389765.0,24517585.0,8456506.0,,15889.0,,95190.0,,,13639904.0,314.0,,,225427.0,,,,,352109.0,-2334051.0,2391925.0,,7269809.0,,13423669.0,,,,,,1993726.0,,,16790.0,,,,,,13446517.0,8290183.0,,73576.0,18485.0,16580302.0,3746134.0,,,970987.0,28070405.0,,4631276.0,,13687.0,,14456245.0,,,,7220776.0,27908206.0,,,90914806.0,,501984245.0,,2681262.0,,,,,,,60.0,813853.0,,,16826.0,,,,,,,,,,,,,,3746134.0,,,15579.0,533354,10436292.0,10032742.0,,,,11875682.0,,,8109694.0,,,,,,693501.0,1617492.0,,-4033228.0,64342384.0,,,,3282290.0,,,,,,4570.0,,,,1876060.0,,,,,,47569720.0,80950.0,10458795.0,,,,,,,,,,,,,4135273.0,,,,,,3721842.0,2253436.0,,,,5522433.0,,,,,,33.5,86962259.0,131660348.0,,,,,,,,,,,,8321918.0,13878.0,,-4162314.0,26533730.0,14495641.0,,,,1.0,,Y,,,,,,,,,,,,57181526.0,,1235111.0,22636758.0,380421.0,1073165.0,12850795.0,60993698.0,,58588902.0,,11789637.0,,,,,,,,,,,-445757910.0,,11789637.0,2384118.0,,,,2704.0,,,928478.0,,,4457707.0,,48779.0,-34.0,,37033541.0,,,,,333550,289658.0,,,3137957.0,64804673.0,2983980.0,,,34460.0,1757333.0,11976974.0,,,36259314.0,,,N,,757561.0,200260628.0,6913.0,,,6064526.0,328.34,,,,,,88159340.0,,,,,,,159701540.0,,,,,,5668000.0,,,532471.0,,51558026.0,164713385.0,225427.0,,,,,,,,,,,547131.0,99849.0,2121736.0,,4631276.0,7731219.0,,11945395.0,N,,,30394.0,33,,,1167750.0,,,,2896575.0,,50039.0,8367099.0,457941.0,,,,633930786.0,,,8233946.0,,,68044.0,,,8902.8,,,,,2969439.0,35104886.0,3002876.0,,,,,,10922576.0,13403.0,97680.0,,145044020.0,,,144828.0,,28.41,,,,,,,183658.0,,7075.0,,16565042.0,,,,,116308.0,,,1412445.0,554705.0,,,,,,,,,,,,,,,,,,,,,,87634.0,28282592.0,,1418.0,,,,5380,,69551.0,,1418.0,1159751.0,,,,,,,13895219.0,,,,,,,,,,16885882.0,,,-337422.0,5780182.0,15579.0,,,283850743.0,3771885.0,95.0,,,108046.0,,23736.0,,8098449.0,,,,5388553.0,1130173170.0,,,,-199701.0,51798.0,543096840.0,15.0,,29.54,17857989.0,,,,-260876.0,,,,,,,,5096393.0,,,47566199.0,,,20063536.0,,171144706.0,,,2646743.0,,,,,,,,76291.0,-1340337.0,38907996.0,7622799.0,1307422.0,1612626.0,,561358643.0,2657381.0,,2165649.0,,,,,12514.0,40127910.0,699912.0,23094.0,522077.0,,2657381.0,,Y,4805258.0,10875767.0,,,,,42810.0,3543092.0,7217227.0,363388.0,2891554.0,,,,,,1145144.0,,,,,259845.0,,,7268862.0,16305574.0,,,36.0,,N,6017303.0,50039.0,,8172783.0,2267.0,,1215011756.0,,,2742271.0,,,,2650029.0,,,46153515.0,,,42510726.0,,539790394.0,,,,,618050.0,,20292.0,,,,,212029.0,91559.0,5147043.0,4943951.0,,,,Y,35004,5857912.0,,,,11665.0,83635.0,107075704.0,,,0.253378,30516448.0,,,,,1655197.0,8158621.0,,,,1732933.0,807557.0,,5226989.0,,35877070.0,,,,,144224.0,3548576.0,35980818.0,,,,,,2691.0,,58436412.0,3848626.0,,185448480.0,37762013.0,5246195.0,,45279.0,59560605.0,,13304723.0,39.52,,,26114745.0,35634830.0,2045229.0,,,,14689514.0,,,,,,485630.0,,,47108902.0,5078.0,,,,,2646743.0,873884.0,,,,,,,18458297.0,,,,,12053738.0,,,,748436482.0,919897.0,,,,74517.0,,,7562163.0,,,,,,,,40555.0,15462162.0,1317738.0,,5326722.0,,,,,,,-6966226.0,47217092.0,38398132.0,548442.0,,,,,,,13953981.0,1324490497.0,5793023.0,,,62.41,27908206.0,4865765.0,,4273469901.0,1787.0,,,,,,,,,,,,70879973.0,,86789.0,,,,5333133.0,12705193.0,15889.0,,,,,43.13,,1692420.0,1560254.0,,,154786.0,,10722202.0,6699.0,2133806.0,,,,14646902.0,,740614670.0,17900554.0,,1056665.0,,1692420.0,26423354.0,,,,1424512.0,,530790402.0,,,,,,,,342358.0,,,2639102.0,,,4806517.0,11135.0,,,873884.0,5466236.0,,,,292762.0,,,335702,,838779.0,,21406094.0,,,,42078496.0,,,5941763.0,42613.0,46.15,21152510.0,479170669.0,,852880.0,,,463206.0,267113593.0,,,,,,,7.0,1082804569.0,,7433831.0,,7217327.0,16760946.0,11788643.0,,419.0,2084578.0,196169.0,,942751.0,91926611.0,,,859218796.0,,8648170.0,26636246.0,,,,110108.0,,3357251.0,,,3905695.0,22872.0,,,90914806.0,2271185.0,,,,325.1,508111.0,,12053738.0,,,,,3170140.0,,,,21960058.0,,,,,,,18856068.0,,1732787.0,,,-28536600.0,78506.0,13182809.0,,,,110439.0,,,,,72804265.0,,379245423.0,56213055.0,,,5522433.0,,,,530790402.0,617.0,44.1,,,,,892762.0,,,,,1045937.0,,,,,NASSAU,,,,3521.0,,363388.0,,,,,,,,,,1253170.0,Y,2.0,,2300802.0,16171942.0,,,13011538.0,,,,,11372393.0,1692420.0,,,,,,1297643.0,7752.0,,,-380710.0,,,1702826.0,,,,,,,,,1291366580.0,2276228.0,,,,,144016.0,,14116258.0,823318.0,,,598796.0,848482.0,,,,,N,,15889.0,,8167019.0,2011,Acute Care Hospitals,NORTH SHORE UNIVERSITY HOSPITAL (330106)
9791,NORTH SHORE UNIVERSITY HOSPITAL (330106),General Short Term (Acute Care Hospitals),Voluntary Nonprofit-Other,-73.703029,40.779269,28353.0,1799.0,,,,,16733524.0,,,,68260458.0,,82072666.0,148884957.0,640440.0,36743901.0,,,5911888.0,,,,,,,,,,,437669.0,,,,40777.0,,,,557045220.0,81092.0,,,,,,23905562.0,,,,,1417931.0,,,,152143037.0,326920.0,6202872.0,,,,,91871.0,,,,,,181247.0,,,19497370.0,,,,,10476424.0,,27594731.0,,,,,13830.0,,273309.0,,35457710.0,,23183113.0,,131721001.0,2436866.0,,2517882.0,,36143181.0,,,,,,,,,,,864011752.0,664410.0,6281200.0,,17401721.0,,,,,5851.0,,,122731.0,,2247070.0,,,3075763.0,,,,,40.0,19764.0,,1258780.0,,97372.0,326920.0,,N,,,-341209885.0,,,450365.0,68375.0,1781508.0,,8429.0,,20298748.0,11943573.0,,,,,,2855560.0,,19554.0,,,,,,-321067360.0,88562759.0,2303.0,,,,74140.0,,,,6281200.0,,2069438.0,,,,,,4424630.0,19766631.0,,,,,25.59,7588999.0,,,,,,,,,,C,20340628.0,-9572942.0,,,,21051021.0,,450.71,3947.0,,,,,,1046655000.0,,1489250.0,8087120.0,,,,2721012.0,,100630025.0,6857839.0,,,,,,752251.0,19663309.0,,,8569642.0,,7421448.0,,73829.0,,,,,24.83,46463254.0,35382422.0,7384.0,,193147.0,,,6023688.0,,,20573201.0,330106,,187469600.0,177884.0,,1214997.0,,-1170237.0,,,259261315.0,,14526.0,,202.0,,7615872.0,,67.28,,,,General Short Term,,373125.0,5678848.0,,,,,,,,,,220241.0,,,,24195.0,14305661.0,,,,,5164035.0,1859356001.0,,,,8977610.0,,81928933.0,,,,,59357030.0,,N,11601915.0,,,,673775.0,,-2438837.0,,42640085.0,7588999.0,,,,,382.0,,,,,,72615000.0,17043000.0,,,1081011.0,40552204.0,11907862.0,,,,,,,10.0,,,11303280.0,158751032.0,,,NY,,,,,,,283690.0,,1730131126.0,,,1417931.0,2300710.0,,,397969.0,600804.0,124303032.0,,11352863.0,,1179367.0,309598.0,,,,3341117301.0,39993604.0,,,,56472.0,,22.45,,14526.0,,,,,138510.0,,17327.0,,12471934.0,,1054036.0,10083889.0,31178302.0,,94654971.0,218.0,,,,2429534.0,8087120.0,,,694052.0,,,,,4047328.0,12764280.0,43134850.0,8853993.0,,,,,,207667365.0,,52739719.0,276016.0,,12397661.0,,,,,404599.0,224230.0,13706456.0,5146751.0,,,,884120.0,-2527144.0,,1012.0,10929562.0,,,,,32.19,1409063766.0,,,,3764.0,,,,1563235.0,6465767.0,,,,,,,59789357.0,32958087.0,,,,,1681008.0,,12397661.0,,,,95529789.0,1290781.0,,,-2696989.0,24.33,,947.0,,337148,405920000.0,,,,,,,,182094.0,,,2394664.0,,42486.0,35.1,33S106,,,8853993.0,,,,,,,326065322.0,219462016.0,,,,N,16733524.0,296585.0,,,,,,29223765.0,,,,32734193.0,,,,36837319.0,1123484.0,,,451031.0,,,821118.0,12534767.0,,3312467.0,,,,1214997.0,425050.0,,,,34050289.0,,504094.0,,,614939.0,10878401.0,,,,,20393.0,,,21395299.0,413592.0,5463.0,,,,,,,1970.0,44.05,,1882741.0,,728667218.0,3723.0,21351547.0,,,14640.0,,,,,699495.0,,,,,,,,3908545.0,-1774.0,,,2146338.0,2812313.0,,3504604.0,,23672522.0,20827715.0,,249.0,,,,,,,,,,25167515.0,,-7351979.0,,57585.0,,,,38683593.0,,,14531086.0,133303902.0,2593569.0,,,,2.0,,,,,16289686.0,,,,,13812208.0,,,,703078.0,,194344321.0,139319459.0,,7462000.0,1297.0,99917.0,,,,,,,12599705.0,,531293.0,4267.0,208912.0,75952325.0,,8501267.0,,,,113847107.0,42.3,2685747.0,,,,,,-203896.0,,,,,,456095.0,,,,,,983714.0,,5,28503180.0,,,1086549.0,,,,,,,,,,6142.0,,,621.0,116362000.0,,,263840.0,,9339000.0,2646202.0,,,18666.0,,81.0,9293443.0,49103889.0,494309.0,,,,1185180.0,,,,,161576331.0,,,,,6071880.0,47278649.0,,,,,31961417.0,121983093.0,4697869.0,4145769.0,,,,,,,224549099.0,,781.0,,2162298.0,6470758.0,1480770.0,,,,,,728667218.0,,,,3701629.0,,8411527.0,,121423840.0,,36.74,,,,12183518.0,2570408.0,,,,,4849112.0,,435253.0,,,15345.0,,97976.0,,2436866.0,,,,18139965.0,,-2470286.0,32430.0,,906201.0,,,31275120.0,,,,23074.0,,,,,4323011.0,,,1417931.0,178387635.0,,4872218748.0,429221.0,P,,,224230.0,,,,,9007045.0,52758869.0,,,12764280.0,,1393.0,,312394.0,,2467407.0,,11943573.0,,3341117301.0,409571.0,,,19244589.0,8853993.0,,,19.0,,89613869.0,,,,,,32357697.0,,,,,,5888.0,,535593702.0,87496.0,,,4.3,35294463.0,,,60431671.0,,87496.0,24504580.0,16477.0,,2517882.0,,,13039170.0,3365501.0,,NORTH SHORE UNIVERSITY HOSPITAL,6021392.0,,,218970.0,,,16970994.0,,300 COMMUNITY DRIVE,1341774.0,1313297.0,,3879.0,242023120.0,,,181549.0,17250525.0,,313526.0,,,30795.0,Y,,,,23862112.0,488935.0,,,208912.0,10339657.0,,1550871.0,2371344.0,,198.0,3850535.0,,,11907863.0,,257889268.0,238781.0,3015424.0,,,32558685.0,,,,3879.0,,28778.0,62200319.0,8391567.0,,,,-173385919.0,9202769.0,29941195.0,371438.0,7500000.0,,56262673.0,,76.0,,,,255165452.0,833526.0,,,19766631.0,8094348.0,,,160332.0,,,,,,,,,,,,278915942.0,9166018.0,,,,114239834.0,,151996.0,,8359255.0,,89828.0,,,,1143682.0,,41064503.0,36866632.0,1304087.0,,,4898084.0,,,,8429.0,143131330.0,61786515.0,4267076.0,9525272.0,12737598.0,255165452.0,2014-12-15 00:00:00,,409571.0,4455.0,164934683.0,,,,,,1258780.0,17401721.0,,,2946990.0,,23672522.0,,26909.0,,962862.0,,,38973075.0,,,257889268.0,,994114.0,,,,15684575.0,,,,,,,270241.0,,17474021.0,139997.0,,,540047.0,2444238.0,,,1755.0,425259.0,340186.0,,,542022789.0,,,3459563.0,,,33779181.0,,,,,,215.0,,,99984581.0,,,9147798.0,,30819756.0,1693362.0,2294106.0,223698.0,,F,23891283.0,41479731.0,28.25,,,1970.0,,,4034650.0,,,,2012-12-31,1081011.0,,24687.0,7719769.0,85201.0,,,13001,,,,30198576.0,8459247.0,,,15684575.0,58.6,,8501267.0,617666368.0,,207667365.0,,,81878813.0,,,1991368.0,,,,,1076.0,33354645.0,112529263.0,3463154982.0,,61786515.0,,,,,55583667.0,,-1500176.0,19088563.0,250098.0,,,,,2666391.0,-17424220.0,,54.0,,2517882.0,,,,,,,755193.0,,20573201.0,12534767.0,,,249.0,,,33400,,,461356.0,116490858.0,38968997.0,,,,,2335072.0,55703.0,,,164224.0,,,,1459247.0,,,33354645.0,9405362.0,,,,,272405.0,3281623.0,,285666.0,,1881618.0,,,,340250.0,,-43450.0,2808.0,,,,,3258933.0,3153624.0,2012-01-01 00:00:00,,,,1125668573.0,,,,88562759.0,78991391.0,,-453627887.0,,,-1309829.0,,,,,360085.0,,,,,62545754.0,38602976.0,33271429.0,693690.0,,13669526.0,,1689.0,,,,,,,3170951.0,,,,,,17343436.0,,,,,,,22.15,13266.0,198.0,15560.0,,,757.0,,2427155.0,,22233569.0,224230.0,,,,73757059.0,88425735.0,X,,,,,N,,,,,,9177186.0,,20008945.0,,,,-261812924.0,10174.0,,8592.0,,46463254.0,1138466652.0,,,,,,3649925.0,651932000.0,,,285450960.0,,,,,,15345.0,,,,10878401.0,,,1277.0,3276610.0,,20539975.0,,2510345.0,,,,-1188016.0,,,,,7334445.0,587768.0,,33198.0,,,,,90.0,,98231000.0,,,,,58.6,,54059507.0,,,,,,16301315.0,44692587.0,,,88367507.0,,-33256.0,20298748.0,,,91656893.0,145922.0,,,4064322.0,,,350767.0,,,,,,104870564.0,53063.0,,,,735745.0,,,,,,15230055.0,,,,,04/04/2008,,,,,2925746.0,46.0,,91134.0,,,4951.0,,Y,,,9706267.0,,43.18,,,192.0,,,,,,,,36143181.0,,,102692366.0,,,,122847.0,,,1244871.0,5078078.0,41817.0,9515051.0,,56262673.0,,4267.0,-25542997.0,468433.0,5460265.0,,9778.0,,3520235.0,1708356.0,,57.78,36973713.0,864011752.0,,,353.0,864011752.0,94654971.0,,1297.0,,914835.0,,19153412.0,,,,,38683593.0,,12915106.0,,4.3,33779181.0,,24538651.0,,106281337.0,9075381.0,,,,3.0,,114239834.0,1531101447.0,460326.0,43850439.0,,,1138466652.0,,,,,953767.0,16571549.0,,,9646527.0,,,50.0,,MANHASSET,,112529263.0,,18546.0,,48.62,,,,,Y,,10174.0,,,,286.83,,4304.0,,,,,24538651.0,-70158.0,9428615.0,,,,,,,6854420.0,,,,,,,,,14534038.0,57748346.0,37408656.0,,,106600.0,,971429.0,,,59789357.0,,,13482.0,-1188016.0,5130527.0,,102.0,,,9893891.0,,,215.72,,,11578.0,50896080.0,,9202769.0,,8592.0,213802.0,53612420.0,,5490.0,,3943442.0,,393109.0,,,,,84408.0,41479731.0,3567.0,,,123168.0,779927.0,,,,,13039170.0,,147092.0,,1563235.0,,1.0,,-5244445.0,103792964.0,,7734371.0,,10030,1103957.0,,23797.0,709498.0,8235840.0,13812208.0,,,,34452824.0,,,-95916.0,26937767.0,,29129.0,,,,,3015424.0,,,318060.0,,,,,,17328861.0,,186696618.0,,,,,10878401.0,,,,58943000.0,179880601.0,1116186.0,,,122731.0,,,,,,,4166479.0,,80098.0,,,,,,411979.0,90078479.0,,,,N,,3070122.0,,233040.0,8432.93,,,,,,52.0,51.0,272405.0,NSUH PSYCHIATRIC EXEMPT UNIT,13830.0,,163112.0,91871.0,,257889268.0,178.0,,204.0,,23183113.0,,,,,6813.0,,11277345.0,,16289686.0,1417931.0,,,,,396280.0,,,,145922.0,59.46,,17250525.0,,,265.53,26937767.0,,,,,,,,,,,16199046.0,11116.0,,,,7.0,,,,994114.0,,,650604.0,918570.0,,,6202872.0,1168.0,3.0,9646527.0,-2499004.0,,39105015.0,,6465767.0,,22916063.0,4069812.0,,,,,,2614680.0,,47083028.0,,10929562.0,23891283.0,,,1297.0,,87496.0,,326920.0,10676788.0,314.0,448.0,160.0,227106.0,,,,,360649.0,-2403833.0,2354735.0,,29223765.0,,14219849.0,9043.0,,,,,2065104.0,,,16836.0,,,,,,12803456.0,8074165.0,,203086.0,5574.0,16682708.0,4620723.0,,,864416.0,27421185.0,,5206276.0,,29313.0,,15468704.0,,,,9177186.0,33493612.0,,,90842013.0,,528475110.0,,2429883.0,,,,,,,60.0,486010.0,,,15560.0,,,,,,,,,,,,,,4620723.0,,,15408.0,545904,5944825.0,8227517.0,,,,5228615.0,,,8087120.0,,,,,,777157.0,1511015.0,,-2499004.0,112188442.0,,,,4336373.0,,,,,,33313.0,,,,2554865.0,,,,,,54681594.0,61176.0,59782774.0,,,,,,,,,,,,,3816030.0,,,,,,4006757.0,2414344.0,,,,5811388.0,,,,,,35.0,63154394.0,139695430.0,,,,,,,,858213.0,,,,7097461.0,11116.0,,-3271384.0,25497528.0,19497370.0,,,,1.0,,Y,2083.0,,,,,,,,,,,71963672.0,,1368899.0,27594731.0,373125.0,1531068.0,13857852.0,62545754.0,,65494378.0,,12546248.0,,,,,,,-91216.0,209081250.0,,,-453627887.0,,12546248.0,2721012.0,,,,1769.0,,,946552.0,,,9166018.0,,146699.0,,,36679574.0,,,,,333550,65908.0,,,3064717.0,72866366.0,3102463.0,,,36376.0,1744849.0,13039170.0,,,38973075.0,,,N,,601361.0,185865987.0,5851.0,,,16457289.0,333.5,,,,,,81928933.0,,,,,,-61441179.0,179880601.0,,,8344171.0,,,5508000.0,,,611537.0,,60431671.0,180689512.0,227106.0,,,,,,,,,,34537743.0,560217.0,103505.0,1991368.0,,5621276.0,3191096.0,,10393226.0,N,,,30394.0,33,,,1109998.0,,,,2998809.0,,47887.0,8287186.0,482522.0,,,,617899408.0,,,8977610.0,,,1027797.0,,,9235.5,,,,,2133379.0,35087828.0,3281623.0,,,,,,11675259.0,15603.0,114409.0,,177137910.0,,,181247.0,,29.36,,,,,,,182282.0,,4857.0,,18524211.0,,,,,214142.0,,,1472899.0,556546.0,,,,,,,,,,,,990000.0,,1631220.0,,,,8344171.0,,,,,23604861.0,,14394.0,,,,5380,,90008.0,,14394.0,827582.0,,,,,,,12426413.0,,,,,,,,,,25167515.0,,,-605332.0,6121257.0,15408.0,,,261336857.0,3433314.0,106.0,,,141804.0,,24195.0,,8842122.0,,,,5678288.0,1187120984.0,,,,-210756.0,71251.0,656292017.0,15.0,,25.37,19664307.0,,11907863.0,,-260919.0,,,,,,,,5146751.0,,,54681396.0,,,15238268.0,,256379179.0,,,2840938.0,,,,,,,,,-1173799.0,38287393.0,8043997.0,1490096.0,1783926.0,,544142349.0,3153624.0,,2365876.0,,,,-27462.0,22156.0,31994973.0,1913903.0,23390.0,4213.0,,3153624.0,,Y,4713644.0,9275994.0,,,,,16684.0,4416539.0,4187559.0,382716.0,3258933.0,,,,,,813562.0,11907863.0,,,,248999.0,,,7498773.0,14531086.0,,,36.0,,N,6465767.0,47887.0,,9075381.0,1689.0,,1276503239.0,,,3065677.0,,266.0,,13969142.0,,,47931123.0,,,47083028.0,,571269856.0,,,,,599566.0,,34520.0,,,,118008.0,240587.0,237338.0,14375578.0,5570871.0,,,,Y,35004,6089574.0,,,,10662.0,166857.0,148639330.0,,,0.233665,30083917.0,,,,201806.0,1986354.0,8871853.0,,,,1882741.0,789653.0,,7323411.0,,36949916.0,,,,,142269.0,3851972.0,36972522.0,,,,,,2303.0,10.0,34575263.0,4170426.0,,187469600.0,30198576.0,6150652.0,,,59944851.0,,31275120.0,38.24,,,23824670.0,38683593.0,2179427.0,,,,12186120.0,,,4986.0,,,778165.0,,,38968997.0,,,,,,2840938.0,235372.0,,,,,,,35382422.0,,,,,12397661.0,,,858213.0,733029880.0,2081711.0,,,,61278.0,,,10476424.0,,,,,,,,42908.0,14751790.0,1467011.0,,7773814.0,142269.0,490.0,,,,490.0,-6552116.0,51233692.0,40552204.0,160234.0,,,,,,,12159323.0,1531101447.0,7266098.0,,,53.21,33493612.0,4798651.0,,4872218748.0,8068.0,,,,,,,,,,,,91656893.0,,1143682.0,,,,5518501.0,11003263.0,1297.0,,,,,41.19,,1375867.0,1657403.0,,,147092.0,,9296450.0,2073.0,1911180.0,,,8094348.0,32558685.0,,724481233.0,19647065.0,,922802.0,,1375867.0,29640669.0,,,,955101.0,,719748573.0,,,,,,,305345.0,295795.0,,,3311872.0,,,4787473.0,10433.0,,,235372.0,3999894.0,,,,380263.0,,,335702,,888797.0,66626168.0,16666480.0,,,,43135048.0,,,3968900.0,4655.0,47.63,46243379.0,486635679.0,,873280.0,,971429.0,650016.0,257889268.0,,,117.0,,,,7.0,1138466652.0,,7745523.0,,7118408.0,20424437.0,12793355.0,,-1191.0,3070122.0,135203.0,,1731677.0,67850389.0,24687.0,,866119374.0,,9646527.0,52758869.0,,,,113750.0,,3669745.0,,201806.0,10128135.0,20393.0,,,90842013.0,2640704.0,,,,330.9,588804.0,,12397661.0,247285.0,,,,3493118.0,,1489250.0,,14058228.0,,,,,,,26621562.0,,1749194.0,-425853.0,,-28896450.0,83560.0,21395299.0,,,,108029.0,,,,,66626168.0,,469706690.0,20539975.0,,,5811388.0,,,,510667323.0,621.0,48.51,,360091.0,,,1416675.0,,,,,653151.0,,,,,NASSAU,,,,198.0,,382716.0,,,,,,,,,189474.0,1384618.0,Y,2.0,,3347960.0,16199046.0,,,13812208.0,,,,,14746149.0,1375867.0,,,,,,1461693.0,138510.0,,,-402818.0,,,2097670.0,,,,,,,,,1374903844.0,2978336.0,,,,,207571.0,,11601915.0,148657.0,,,3086494.0,1081011.0,,,,,N,,1297.0,,9147798.0,2012,Acute Care Hospitals,NORTH SHORE UNIVERSITY HOSPITAL (330106)
16722,NORTH SHORE UNIVERSITY HOSPITAL (330106),General Short Term (Acute Care Hospitals),Voluntary Nonprofit-Other,-73.703029,40.779269,23215.0,1901.0,,,,,16876084.0,,,,73129705.0,,86924116.0,172025135.0,,34823426.0,,,5810038.0,,,,,,,,,,,864903.0,,,,39895.0,,,,643305248.0,85008.0,,,,,,23802377.0,,,,,1256830.0,,,,161604805.0,319336.0,6568022.0,,,,,126899.0,,,,,,171788.0,,,21682124.0,,,,,11292418.0,,29719001.0,,,,,14322.0,,259577.0,,35174531.0,,23952916.0,,,2202658.0,,2399207.0,,36767855.0,,,,,,,,,,,934733685.0,2340875.0,6425317.0,,23113436.0,,,,,5165.0,,,44105.0,,2242388.0,,,4991546.0,,,,,40.0,19493.0,,1408478.0,,81110.0,319336.0,,N,,,-389898107.0,,,436357.0,247983.0,2022267.0,,8360.0,,19856786.0,10614456.0,,,,,,3412233.0,,18669.0,,,,,,-361276409.0,91282113.0,2317.0,,,,65578.0,,,,6425317.0,,1909179.0,34791.0,,,,,4009894.0,24765017.0,,,,,27.52,6873419.0,,,,,,,,,,G,22461765.0,-11266735.0,,,,22370138.0,,459.3,1012.0,,,,22.0,,1042756000.0,,2391200.0,8218445.0,,,,2875898.0,,97424914.0,6410000.0,11907863.0,,,,,723263.0,25850788.0,,,8862420.0,,7154573.0,,55418.0,,,,,18.18,42504249.0,48957919.0,6871.0,,753961.0,,,6314212.0,,,21201939.0,330106,,201321312.0,186074.0,1388.0,2582409.0,,-1150975.0,,,227983050.0,,14927.0,,110.0,,7551487.0,,210.74,,,,General Short Term,,356810.0,5810038.0,,,,,,,,,,225954.0,,,,18284.0,17676308.37,,,,,5918421.0,1952791479.0,,,,9307616.0,,90039089.0,,,,,77592452.0,,N,12968646.0,,,,610499.0,,-307932.0,,44883624.0,6873419.0,,,,,270.0,,,,,,122676000.0,207312000.0,,,1287077.0,68682256.0,11907863.0,,,,,,,4.0,,,13136788.0,185882999.0,,,NY,,,,,,,312068.0,,1784140171.0,,,1256830.0,2378183.0,,,364811.0,782585.0,167221978.0,,11532977.0,,1327886.0,368351.0,,,,3544932145.0,54974348.0,,,,135450.0,,23.01,,14927.0,,,,,242009.0,,23436.0,,11990572.0,,399890.0,10253334.0,29820756.0,,150472018.0,200.0,,,,2635621.0,7860722.0,,,570601.0,,,,,4419591.0,14565467.0,47065209.0,9943430.0,,,,,,166575586.0,,55474897.0,215822.0,,12354375.0,,,,,389143.0,211171.0,17783005.0,4741316.0,,,,840374.0,-2295850.0,,3041.0,14566005.0,,,,,39.95,1422863762.0,,,59.0,4155.0,,,,2714954.0,6521737.0,,,,,,,66423015.0,36517123.0,,,,,1800197.0,,12354375.0,,,,91696734.0,1632039.0,,,-3211803.0,24.04,,13198.0,,337148,433216000.0,,,,,,,,206238.0,,,2367204.0,,40782.0,34.44,33S106,,,9943430.0,,,,,,,345635973.0,246802286.0,,,,N,16876084.0,281109.0,,,,,,40139770.0,,,,29372406.0,,,,40678339.0,1141192.0,,,413453.0,,,791754.0,9973917.0,,3658035.0,,,,2582409.0,389744.0,,,,32951489.0,,462094.0,,,611043.0,10461551.0,,,,,43028.0,,,25189480.0,321823.0,7815.0,,,,,,,1941.0,40.7,,2023035.0,,844186315.0,3260.0,22989983.0,,,14600.0,,,,,915022.0,,,,,,,,4181365.0,,,,2053659.0,2578000.0,,5219560.0,,23544940.0,19189856.0,,249.0,,,,,,,,,,24098373.0,,-12590188.0,,44188.0,,,,37647833.0,,,13520862.0,154275173.0,3252147.0,,,,2.0,,,,,16616788.0,,,,,13794411.0,,,,656660.0,,345635973.0,143370707.0,,5783683.0,1466.0,92787.0,,,,,,,19922259.0,,521865.0,4931.0,1716560.0,79424774.0,,8782738.0,,,,197880342.0,45.38,2545593.0,,,,,,-206872.0,,,,,,469589.0,,,,,,972528.0,,5,20871131.0,,,1223486.0,,,,,,,,,,514808.0,13114.0,,576.0,110555000.0,,,175941.0,,8585227.0,4107816.0,,,18615.0,,68.0,9632673.0,116244149.0,468514.0,,,,775747.0,,,,,205972929.0,,,,,5988854.0,53488908.0,,,,,24122497.0,95456269.0,5116580.0,4063849.0,,,,,,,222813691.0,,729.0,,1982142.0,6375392.0,1660535.0,,,,,,850569384.0,,,,4148553.0,,8485843.0,,128290942.0,,35.9,,,,15641277.37,2451891.0,,,,,4974979.0,,440883.0,,,15590.0,,80849.0,,2202658.0,,,,19245818.0,,-307932.0,42122.0,,1228977.0,,,35012257.0,,,,29423.0,319900.0,,,,4487815.0,,,1318534.0,119067697.0,,5298609768.0,516507.0,P,,,211171.0,,,,,8779331.0,44216026.0,,,14565467.0,,1315.0,,304409.0,,2273990.0,,10614456.0,,3544932145.0,1091521.0,,,21529402.0,9943430.0,,,11.0,,97459751.0,,,,,,41777930.0,,,,,,4917.0,,635871606.0,80316.0,,,4.5,36752246.0,,,67700234.0,,80316.0,1560397.0,15617.0,,2430251.0,,,12690768.0,3145429.0,,NORTH SHORE UNIVERSITY HOSPITAL,5113693.0,,,220967.0,,,20331723.0,,300 COMMUNITY DRIVE,799360.0,1203877.0,,3798.0,239932318.0,,,379459.0,18015622.0,,174777.0,,,37375.0,Y,,,,23241155.0,516117.0,,,1716560.0,10974406.0,,1659502.0,3027387.0,,118.0,3646966.0,,,7237931.0,,256154872.0,218887.0,3534717.0,,,36391958.0,,,,3798.0,,36108.0,85894675.0,8316552.0,,,,-206108619.0,11487279.0,28315214.0,340491.0,7500000.0,,56948056.0,,42.0,,,,306641167.0,813607.0,621652.0,,24765017.0,9331754.0,,,181439.0,,,,,,61704.0,,,,,,280951422.0,13626711.0,,,,110553859.0,,124317.0,,10708072.0,,226370.0,,,,40633.0,,39973129.0,40698488.0,1277289.0,,,4372379.0,,,,8360.0,131601852.0,66720173.0,3963068.0,9127680.0,13141492.0,306641167.0,2016-03-24 00:00:00,,1091521.0,1224.0,187400650.0,,,,,,1408478.0,23113436.0,,,2264003.0,,23544940.0,,31070.0,,1060245.0,,,39987132.0,,,256154872.0,,1507773.0,,,,15188719.0,,,,,,,327211.0,,17118627.0,137707.0,,,490384.0,2419308.0,,,1504.0,532885.0,1007313.0,,,640470216.0,,,3593982.0,,,41306915.0,,,,,,699.0,,,98968183.0,,,9433562.0,,33644029.0,1834063.0,1168833.0,,,F,21543011.0,38660179.0,26.73,,,1941.0,,,42759.0,,,,2013-12-31,1287077.0,,27594.0,7872760.0,29587.0,,,10001,,,,29996172.0,9057032.0,,,15188719.0,70.78,,8782738.0,722795722.0,,166575586.0,,,76254503.0,,,1819416.0,,,,,1024.0,41453448.0,110949351.0,3875746006.0,,66720173.0,,,,,61927791.0,,-1494588.0,54224387.0,205201.0,,,,,2444236.0,-18987706.0,,47.0,,2399207.0,,,,,,,808325.0,,21201939.0,9973917.0,,,256.0,,,33400,,,437280.0,149602309.0,38546138.0,,,,,2297486.0,17438.0,,,158351.0,,,,1413085.0,,,41453448.0,8266342.0,,,,,321501.0,3060611.0,,270052.0,,1397412.0,,,,182287.0,,-561222.0,9080.0,,,,351890.0,3246536.0,3229536.0,2013-01-01 00:00:00,,,,1065111867.0,,,,91282113.0,75137010.0,,-491292140.0,,,-1179496.0,,,,,400667.0,,,,,60662342.0,35471819.0,39011671.0,630611.0,,12384786.0,,1794.0,,,,617303.0,,,3252972.0,,,,,,26248207.0,,,,,,,24.09,12160.0,118.0,14894.0,,,207.0,,2548858.0,,24997106.0,211171.0,,,,75298403.0,102770377.0,X,,,,,N,,,,,,10846314.0,,18390882.0,,,,-266750906.0,9531.0,,7763.0,,42504249.0,1159441822.0,,,,,,3552926.0,704639000.0,,,351097129.0,,,,,,15590.0,,,,10727407.0,,,1230.0,3015773.0,,25035536.0,,2836883.0,,,,-1188033.0,,,,,6748837.0,593063.0,,35587.0,,,,,2160.0,,107849000.0,,,,,68.74,,69014884.0,,,,,,15543906.0,49113782.0,,,106552410.0,,-38874.0,19856786.0,,,96178008.0,133764.0,,,5481654.0,,,386823.0,,,,,,7136635.0,48642.0,,,,712871.0,,,,,,14756679.0,,,,,04/04/2008,,,,,3215728.0,46.0,,90885.0,,,6305.0,,Y,,,9955576.0,,40.89,,,196.0,,,,,,,,36767855.0,,,100773031.0,,,,103708.0,,,1114656.0,5580425.0,54315.0,9457744.0,,56948056.0,,4931.0,-9656031.0,495278.0,5147800.0,,23195.0,,4097118.0,2252117.0,,58.73,41169037.0,928843331.0,,,320.0,928843331.0,150700891.0,,1466.0,,907109.0,,19380851.0,,,,,37647833.0,,1690714.0,,4.3,41306915.0,,30294665.0,,121953322.0,9370629.0,,,,3.0,,110553859.0,1757896992.0,450017.0,42167852.0,,,1159441822.0,,,,,826512.0,15004611.0,,,10055950.0,,,2.0,,MANHASSET,,110949351.0,,,,48.21,,,,,Y,,9531.0,,,,237.9,,100845.0,,,,,30294665.0,-105935.0,10483370.0,,,,-1188033.0,,,6512346.0,,,,,,,,,18780527.0,66645046.0,41180784.0,,,68624.0,,1539530.0,29886.0,,66423015.0,,,16483.0,,5060714.0,,2808.0,,,14724242.0,,,234.1,,,8219.0,48710658.0,,11487279.0,,7763.0,175754.0,55500221.0,,5475.0,,3849444.0,,472412.0,,,,,82317.0,38660179.0,3320.0,,,114123.0,699503.0,,,,,12765770.0,,141441.0,,2714954.0,,1.0,,-5158835.0,129761687.0,,8335824.0,,10030,1046348.0,,138597.0,1073395.0,9418915.0,13622124.0,,,,41075222.0,,,-65532.0,26055754.0,,73861.0,,,,,3534717.0,,,140740.0,,,,,,18499998.0,,210023549.0,,,,,10461551.0,,,,18792000.0,194447893.0,1081054.0,,,44105.0,,,,,,,4268520.0,,120572.0,,,,,,13609.0,93642823.0,,,,N,,2965718.0,,,9079.4,,,,,,5.0,51.0,321501.0,NSUH PSYCHIATRIC EXEMPT UNIT,14322.0,,163246.0,126899.0,,256154872.0,,,22.0,319900.0,23952916.0,,,,,4446.0,,13383434.0,,16616788.0,1318534.0,,,,,17655433.0,,,,133764.0,53.61,,18015622.0,,,225.49,26055754.0,,,,,,,,,,,16900025.0,10034.0,,,,7.0,,,,1507773.0,6.0,,662981.0,936474.0,,,6568022.0,1109.0,3.0,9589696.0,-2419238.0,,23505146.0,,6521737.0,,22249179.0,3873050.0,,,,,,2653821.0,,52621934.0,,14566005.0,21543011.0,,,1466.0,,80316.0,,319336.0,11973607.0,313.0,250.0,95.0,211869.0,,,,,377507.0,-2215814.0,2422717.0,,40139770.0,,14204093.0,8444.0,,,,,1507188.0,,,16790.0,,,,,,10974864.0,7770955.0,,207498.0,10350.0,15763640.0,3291373.0,,,871867.0,26451759.0,,6196276.0,,20149.0,,15401391.0,,,,10846314.0,35747504.0,,,80587548.0,,507789512.0,,2262652.0,,,,,,,60.0,510644.0,,,14894.0,,61704.0,,,,,,,,,,,,3291373.0,,,14916.0,572883,4963390.0,8145242.0,,,,5610814.0,,,7860722.0,,521349.0,,,,1000728.0,1802791.0,,-2419238.0,118117448.0,,,,4643260.0,,,,,,27071.0,,,,2620993.0,,,,,,58430858.0,67597.0,9561594.0,,,,,,,,,,,,,4440110.0,,,,,,4502805.0,2213189.0,,,,6155473.0,,,,,,31.66,71372796.0,151573099.0,,,,,,,,841201.0,,,,7768737.0,10034.0,,-3397237.0,24259327.0,21682124.0,,,,1.0,,Y,5866.0,,,,,,,,,,,103934381.0,,1356733.0,29719001.0,356810.0,2054225.0,14151634.0,60662342.0,,61470652.0,,11842013.0,,,,,,,-343592.0,,,,-491292140.0,,11842013.0,2875898.0,,,,623.0,,,993169.0,,,13626711.0,,255502.0,,,37770371.0,,,,,333550,62469.0,,,2920403.0,76355315.0,3049306.0,,,30422.0,1814602.0,12690768.0,,,39987132.0,,,N,,680410.0,198179297.0,5165.0,,,18242393.0,332.9,,,,,,90039089.0,,,,,,-64676000.0,194447893.0,,,8233775.0,,,7373000.0,,,616554.0,,67700234.0,126138402.0,211869.0,,,,,,,,,,18896076.0,530983.0,101093.0,1819416.0,,5621276.0,3257013.0,,9245948.0,N,,,-224805.0,33,,,792368.0,,,,2842320.0,,47283.0,8514824.0,643975.0,,,,717162805.0,,,9307616.0,,,1777667.0,,,9837.6,,,,,2626975.0,33259953.0,3060611.0,,,,,,11866443.0,15408.0,150267.0,,190511254.0,,,171788.0,,30.43,1388.0,,,,,,189214.0,,5521.0,,20485709.0,,,,,,,,1620891.0,559053.0,748.0,,,,,,,,,,,,,1546097.0,,,,8233775.0,,,,,21984929.0,,1112732.0,,,,5380,,110825.0,,1112732.0,997522.0,,,,,,,12222856.0,,,,,,,,,,24098373.0,,,-1393319.0,6800855.0,14916.0,,,254799866.0,4084150.0,561.0,,,191400.0,,18628.0,,9103722.0,,,,5626285.0,1209926194.0,,,,-212051.0,106743.0,801401522.0,15.0,,29.0,19996714.0,,19145794.0,,-179034.0,,,,,,,,4741316.0,,,58430740.0,,,14596063.0,,261325000.0,,,3041872.0,,,,,,,,,-1158134.0,35580945.0,8812445.0,1763539.0,1319428.0,,641864402.0,3218129.0,,2218974.0,,,,-102588.0,23602.0,26070758.0,2191330.0,21491.0,658.0,,3218129.0,1864.0,Y,4522173.0,7914262.0,,,,,12558.0,3382613.0,4198411.37,355960.0,3246536.0,6368.0,344.0,,,,652557.0,7237931.0,,,,232104.0,,,8113526.0,13520862.0,,,34.0,,N,6876879.0,47283.0,,9370629.0,1794.0,,1292848031.0,,,2989325.0,,258.0,,2090604.0,,,39037325.0,,,52621934.0,,654273659.0,,,,,539382.0,,60430.37,,,1901.0,227400.0,694906.0,224529.0,15773241.0,6470312.0,,,,Y,35004,5596250.0,,,,11875.0,332103.0,138974852.0,,,0.218646,21860043.0,,,,83230.0,2016320.0,8935860.0,,,,2023035.0,975681.0,,8465873.0,,39887439.0,,,,,139534.0,9039606.0,41168414.0,,,,,,2317.0,4.0,41796849.0,4269532.0,,201321312.0,29996172.0,6389243.0,,,61676279.0,,35012257.0,42.33,,,23307667.0,37647833.0,2212938.0,,,,10852251.0,,,10743.0,-1188033.0,,854392.0,,,38546138.0,,,,,,3041872.0,334403.0,,,,,179.37,,48957919.0,,,265217.0,,12354375.0,,,841201.0,844504248.0,2421717.0,,,,61010.0,,,11292418.0,,,,,,,,43723.0,22051475.0,1301046.0,,,139534.0,621.0,,,,643.0,-4808012.0,52030680.0,68682256.0,536004.0,,,,,,,15622649.37,1753677623.0,7894668.0,1985.0,,66.11,35747504.0,3599426.0,,5302829137.0,2580.0,,,,,,,,,,,,96178008.0,-1188033.0,40633.0,,,,5070877.0,10743235.0,1466.0,,,,,47.56,,1378031.0,1537542.0,,,141441.0,,8864477.0,3895.0,2403309.0,,,9331754.0,36391958.0,,838511452.0,19633044.0,,904831.0,,1403712.0,34324882.0,,,,527954.0,,631895867.0,,,,,,,297962.0,342992.0,,,3139045.0,,,4601537.0,9802.0,,,334403.0,3952780.0,,,,346743.0,,,335702,,814745.0,72224312.0,18835321.0,,,-102022.0,47330544.0,,,7364680.0,,48.57,1525606.0,564399506.0,,843326.0,,1539530.0,595858.0,256154872.0,,,6.0,,,,7.0,1159441822.0,,8019598.0,,7178089.0,22237671.0,15537509.0,,-623.0,2965718.0,490075.0,,1882744.0,65697182.0,27594.0,,855296840.0,,9589696.0,44774868.0,,,,129410.0,,3647093.0,,83230.0,9650849.0,43028.0,,,80587548.0,2690466.0,,,,331.43,529868.0,,12354375.0,345030.0,,,,3310833.0,,2391200.0,,11653541.0,,,,,,,19473719.0,,1532817.0,-1642571.0,,-28689514.0,87119.0,25189480.0,,,,100989.0,,,,,72224312.0,,500251261.0,25035536.0,,,6155473.0,,,,631895867.0,576.0,48.11,,839756.0,,,1593355.0,,,,,428626.0,,,,,NASSAU,,,,118.0,,355960.0,,,747.0,,,,,,223395.0,1670925.0,Y,2.0,,2714223.0,16900025.0,,,13622124.0,,,,,16537752.0,1378031.0,,,,,,1733197.0,242009.0,,,-1543070.0,,,2046455.0,,,,,,,,,1336706837.0,2824331.0,,,,,387796.0,,12968646.0,223907.0,,,790413.0,1287077.0,,,4219369.0,,N,,1466.0,,9433562.0,2013,Acute Care Hospitals,NORTH SHORE UNIVERSITY HOSPITAL (330106)
26956,NORTH SHORE UNIVERSITY HOSPITAL (330106),General Short Term (Acute Care Hospitals),Voluntary Nonprofit-Other,-73.703029,40.779269,11997.0,2492.0,,,,,19557935.0,,,,77545542.0,,91950738.0,183275524.0,,43961711.0,,,5964315.0,,,,,,,,,,,974542.0,5.0,,,42851.0,,,,555521340.0,107115.0,,,,,,24066438.0,,,,,868713.0,,,,174817000.0,270955.0,8411573.0,,,,,83152.0,,,,,,227084.0,,,24866932.0,,,,,11693550.0,,,20280.0,,,,14084.0,,263914.0,,33034500.0,,15969485.0,,205789000.0,1542970.0,,2495063.0,,36447089.0,,,,,,,,,,,1009628358.0,2184949.0,2392044.0,,42501328.0,,,,,10115.0,,,10223.0,,2828386.0,,,9027098.0,,,,,40.0,17155.0,,1359811.0,,60467.0,270955.0,,N,,,-486382599.0,,,347000.0,589104.0,2348954.0,,6023.0,,20723709.0,14367876.0,,,,,,4239573.0,,13756.0,,,,,,-433858908.0,104311995.0,3661.0,,,,40858.0,,,,2392044.0,,1917674.0,489598.0,,,,,4677650.0,30588231.0,,,,,25.44,7464190.0,,,,,,,,,,J,24697016.0,-8166219.0,,,,25626113.0,,457.65,8372.0,,,,24.0,,1156055000.0,,2224250.0,9045722.0,,,,2978664.0,,101912210.0,6375306.0,19145794.0,,,,,998264.0,26429154.0,,,9655145.0,,7676564.0,,57228.0,,,,,24.63,47420186.0,58670611.0,7491.0,,1063307.0,,,4870572.0,,,18863917.0,330106,,195318898.0,143945.0,713.0,4194917.0,,-2776298.0,,,236533038.0,,91897.0,,191.0,,5425068.0,,75.3,,,,General Short Term,,360713.0,5964315.0,,,,,,,,,,179663.0,,,,12913.0,16227552.0,,,,,5699000.0,2000840000.0,,,162.0,9845427.0,,99909148.0,,,,,44319879.0,,N,14643056.0,,,,752977.0,,-456248.0,,45701011.0,7464190.0,,,,1620.0,,,,,,,68373000.0,107265000.0,,,1397452.0,68554293.0,11908000.0,,,,,,,67580.0,,,18260714.0,242118785.0,,,NY,,,,,,,698902.0,,1929249913.0,,,868713.0,1839076.0,,,368784.0,728546.0,210050240.0,,12212883.0,,1366388.0,333047.0,,,,3806000694.0,46521468.0,,,,153672.0,,23.28,,91897.0,,,,,178004.0,,27622.0,,10212745.0,,2066677.0,11739059.0,30434401.0,,56516132.0,183.0,,,,3128823.0,9045722.0,,,452514.0,,,,,10861632.0,24955649.0,57802796.0,10413158.0,,,,,,234657526.0,,54121941.0,333815.0,,13686900.0,,,,,420674.0,210149.0,12382862.0,4873568.0,,,,827734.0,-2303128.0,,3841.0,26306879.0,,,,,33.29,1495391005.0,,,69.0,3677.0,,,,2962391.0,5051798.0,,,,,,,72435545.0,45967452.0,,,,,1867961.0,,13686900.0,,,,94632786.0,1467807.0,,,-2327941.0,25.19,,,,337148,361477000.0,,,,,,,,240991.0,,,3337575.0,,7276.0,36.26,33S106,,,10413158.0,,,,,,,393560000.0,277666873.0,,,274598.0,N,19557935.0,371593.0,,,,,,21769945.0,,,,32301659.0,,,,51049799.0,460821.0,,,417955.0,,,485081.0,702803.0,,4173542.0,,,,4194917.0,408207.0,,,,37477801.0,,467126.0,,,655051.0,10383048.0,,,,,37243.0,,,40261852.0,165733.0,5438.0,,,,,,,1673.0,45.71,2468.0,2203487.0,,812466516.0,3589.0,20439491.0,,,14600.0,,,,1620.0,1093134.0,,,,,,,,5113688.0,,,,2326469.0,2593778.0,,5893068.0,,23716128.0,21655040.0,,249.0,,,,,2700.0,,,,,29465502.0,,,,17503.0,,,,38845383.0,,,20394338.0,162427709.0,1479727.0,,29.0,,2.0,,,,,17868385.0,,,,,14405196.0,,,,651518.0,,187771000.0,161942927.0,,7051241.0,317204.0,95471.0,,,,,,,15677809.0,,447973.0,4228.0,2173869.0,87448492.0,,9253276.0,,,,210209807.0,44.37,3344331.0,,13284.0,,,,-116305.0,,,,,,611844.0,,,,,,1181155.0,,4,33575611.0,,,1352614.0,,,,,,,,,,1062.0,1360.0,,615.0,122299000.0,,,116253.0,,9207296.0,4832170.0,,,18615.0,,50.0,9140774.0,90812507.0,619320.0,,,,4701354.0,,,,,198821041.0,,,,,5483261.0,60332651.0,,,,,34294695.0,85478967.0,7987131.0,7782477.0,,,,,,,221175084.0,,768.0,,1991431.0,7401590.0,1747594.0,,,,,,781143370.0,,,,3464168.0,,10231590.0,,121484786.0,,36.71,,,,13913996.0,3220465.0,,,,,5704862.0,,367934.0,-165.0,,15918.0,,102561.0,,1542970.0,,,,20124825.0,,-456248.0,36963.0,,1085131.0,,,63084973.0,,,,6742.0,105700.0,29327.0,,,4122879.0,,,868713.0,139842983.0,,5728458821.0,803334.0,P,,2468.0,210149.0,,,,,492000.0,30865316.0,,,24955649.0,,1377.0,,179058.0,,2274166.0,,14367876.0,,3806000694.0,1413865.0,,,22439989.0,10413158.0,,,14.0,,119734891.0,,,,,,37957769.0,,,,,,,,635390601.0,84370.0,,,4.5,42844238.0,,,71887490.0,,84370.0,1475534.0,20644.0,,2495063.0,,,12653284.0,3796229.0,,NORTH SHORE UNIVERSITY HOSPITAL,5160947.0,,1151.0,239914.0,,,23058105.0,,300 COMMUNITY DRIVE,271827.0,1204693.0,,3785.0,241265801.0,,,486630.0,20469063.0,,55782.0,,,38537.0,Y,,,,22780205.0,513519.0,,,2173869.0,12287189.0,,2091399.0,2830243.0,,,3890075.0,,,11842697.0,,253952942.0,221270.0,4746630.0,,5037488.0,34933200.0,,,,3785.0,,44834.0,65304737.0,9400829.0,,,,-213709504.0,10619167.0,30936680.0,344198.0,21200000.0,,49225626.0,,,,,,386102354.0,506335.0,1034840.0,,30588231.0,19070354.0,,,77646.0,,,,,,,,,,,,287649242.0,12531387.0,,,,119006432.0,,172464.0,,11393927.0,,62400.0,,,,137724.0,,27639634.0,51081140.0,1564651.0,,,4551609.0,,,,6023.0,84861731.0,76773794.0,3893557.0,9758358.0,12950947.0,386102354.0,2024-01-04 00:00:00,,1413865.0,61744.0,199964509.0,,,,,,1359811.0,42501328.0,,,1240386.0,,23716128.0,,29590.0,,990883.0,,,43193272.0,,,253952942.0,,1909278.0,,,,16115370.0,,,,,,,345409.0,,20090717.0,406001.0,,,887687.0,2879030.0,,,,521309.0,1198745.0,,,693084237.0,,,3926751.0,,,48261404.0,,,,,,657.0,,,100004277.0,,,11487426.0,,29840905.0,3712712.0,1083461.0,,,F,28030036.0,44066803.0,28.05,,,1673.0,,,105274.0,,,,2014-12-31,1397452.0,,212593.0,8768254.0,18334.0,,,13001,,,,32887880.0,10396888.0,,,16115370.0,67.27,,9253276.0,727341339.0,,234657526.0,,,82911015.0,,,1302463.0,,,,,1063.0,47394386.0,115170835.0,4233067816.0,,76773794.0,,,,,,,-1179397.0,20326337.0,120670.0,5037488.0,,,,2458557.0,-14790621.0,,47.0,,2495063.0,19403.0,,,,,,1037911.0,,18863917.0,702803.0,,,228.0,,,33400,,39813.0,578033.0,179760266.0,62078780.0,,,,,1999264.0,3389.0,90.0,,97016.0,,,,318341.0,,,47394386.0,10066656.0,,,,,331179.0,4679025.0,,269679.0,,3085196.0,,,,62538.0,,-1286233.0,16532.0,,,,1167250.0,3545228.0,3414765.0,2014-01-01 00:00:00,,-107427.0,,1074677000.0,,,,104311995.0,84142291.0,,-608112614.0,,,-1355593.0,,,,,404866.0,,718928.0,,,69032362.0,35944108.0,41068266.0,819905.0,,13458994.0,,1417.0,,10032.0,,855228.0,,,3442387.0,,,,,,11002696.0,,,,,,,22.16,12293.0,20280.0,14445.0,,,10363.0,,2850783.0,,25426687.0,210239.0,,,42606.0,78621802.0,104839397.0,X,,,,,N,,,,,,10768235.0,,20760478.0,-173.0,,,-379785877.0,9863.0,,8462.0,,47420186.0,1175663505.0,,,,,,3636054.0,793094000.0,,,386678113.0,,,,,,15918.0,,,29.0,10383048.0,,,660.0,3024026.0,,2337049.0,,3939060.0,,55891.0,,-981634.0,,,,,7023531.0,819723.0,,28997.0,,,,,104.0,,110713000.0,,,,,67.27,,82170971.0,,,,,,18787328.0,57615012.0,,,122092089.0,,,20723709.0,,,119742052.0,135221.0,,,9234372.0,,,596340.0,,,,,,7190257.0,49171.0,,492.0,,733195.0,,,,,,15165360.0,,,,,04/04/2008,,,,,3481927.0,46.0,,90885.0,,,3333.0,,Y,,,21179780.0,,44.82,,,242.0,,,,,,,,36447089.0,,,118726350.0,,,,63333.0,,,1459601.0,7012523.0,,9861485.0,,49225626.0,,4228.0,-21328130.0,685024.0,6813890.0,,24341.0,,3764239.0,1887288.0,,57.25,51742006.0,1009628358.0,,,290.0,1009628358.0,127928604.0,288896.0,317204.0,,1170179.0,,21747902.0,,,,,38845383.0,,18107553.0,,,48261404.0,,34762119.0,,129465106.0,12079585.0,,,,3.0,,119006432.0,1922458127.0,426427.0,43922754.0,,,1175554792.0,,,,,845665.0,11604044.0,,,9510428.0,,,1.0,,MANHASSET,,115170835.0,,6964.0,,43.21,,,,,Y,,9863.0,,,1535791.0,255.9,,,,,,,34762119.0,,11599526.0,,,,,,,9104009.0,,,,,,,,,13401381.0,72052000.0,44454027.0,,108713.0,33271.0,,3761117.0,9528.0,,72435545.0,,,483.0,-981634.0,5519737.0,,152.0,,,13917973.0,,,233.23,,,19894.0,56067765.0,,10619167.0,,8462.0,267585.0,58645116.0,,5475.0,,4440565.0,,508944.0,,,,,81629.0,44066803.0,4184.0,,,44967.0,689457.0,,,,,12653284.0,,142735.0,,2962391.0,,1.0,,-7249533.0,180443172.0,,7673126.0,,10030,1383149.0,,,336962.0,9994001.0,14405196.0,,,,63133124.0,,,-114042.0,20489050.0,,135245.0,13789.0,,,,4746630.0,,,237026.0,5.0,,,,,20596206.0,,218955769.0,,,,,10383048.0,,,,3020000.0,187854708.0,1266728.0,,,10223.0,,,,,,,5546896.0,,110138.0,,,,,,31995.0,95413049.0,,,,N,,3457650.0,,,9528.73,,,,,,1.0,51.0,331179.0,NSUH PSYCHIATRIC EXEMPT UNIT,14084.0,,59462.0,48091.0,,253952942.0,259.0,,7.0,105700.0,15969485.0,,,,,8600.0,,15709166.0,,17868385.0,868713.0,,,,,3663074.0,,,,135221.0,59.77,,20469063.0,,,210.19,20489050.0,,,,,,,,,,,17642786.0,11185.0,,,,,,,,1909278.0,7.0,,655636.0,1041753.0,,,8411573.0,986.0,3.0,9510428.0,-2614214.0,,14614866.0,,5051798.0,,23893348.0,5078427.0,,,,,,417964.0,,60245192.0,,26306879.0,28030036.0,,,,,84370.0,,270955.0,12413705.0,313.0,,,213834.0,,,,3492498.0,504744.0,-2977096.0,2694266.0,,21769945.0,,14914217.0,9179.0,,,,,1632000.0,,,16790.0,,,,,,11549508.0,8697600.0,,37375.0,5468.0,16117905.0,2798408.0,,,11492389.0,28907140.0,,6196276.0,,31341.0,,15781934.0,,,,10768235.0,39418020.0,,,80862881.0,756634.0,573469989.0,,2530332.0,,,,,,,60.0,474227.0,,,14445.0,,,,,,,,,,,,,,2798408.0,,,15080.0,761451,8498737.0,9233616.0,,,,340302.0,,2700.0,9045722.0,,1339390.0,,,,,2576029.0,,-2614214.0,119722478.0,,,,5151981.0,,,,,,19557.0,,,,2803027.0,,,,,,71168744.0,67951.0,20174230.0,,,,-70977.0,,,,,,166354.0,,,4123261.0,,,,,,4875868.0,2224994.0,,,,6944541.0,,,,,,30.74,72260015.0,157022582.0,,,,,,,,718928.0,,,,7342052.0,10693.0,,-2393132.0,19189459.0,24866932.0,,,,1.0,,Y,8972.0,,,,,,,,,,,112228522.0,,1647629.0,,360713.0,1875817.0,13837635.0,69032362.0,,67003162.0,,11442736.0,,,,,,,-262790.0,168252000.0,,,-608112614.0,,11442736.0,2978664.0,,,,1005.0,,,946613.0,,,12531387.0,-16343733.0,280373.0,-94168.0,,25043419.0,,,,,333550,82576.0,,,3819142.0,77488527.0,3772465.0,,,18609.0,1950558.0,12653284.0,,,43193272.0,,,N,,906222.0,221487949.0,10115.0,,,18045134.0,327.82,,,,,,99909148.0,,,,419582.0,,-58074000.0,187854708.0,,,8330197.0,,,4815000.0,,,625326.0,,71887490.0,144216931.0,213834.0,,,,,,,,,,27156030.0,701897.0,99047.0,1302463.0,,5621000.0,3581342.0,,20446356.0,N,,,-254582.0,33,,,1119976.0,,,,3736566.0,,46931.0,9091971.0,703591.0,,,,727691649.0,,,9845427.0,,,1110675.0,,,10310.92,,,,,3192981.0,46073181.0,4679025.0,,,,67580.0,,6984630.0,16319.0,104262.0,,211262939.0,,-165.0,227084.0,,28.12,713.0,,,,,,206693.0,,112.0,,23461555.0,,,,,,,,1728193.0,428597.0,466.0,,,2653955.0,,,,,,,,,,2023113.0,,,,8330197.0,,,,,17454630.0,,1824.0,,,,5380,,134566.0,,1824.0,1018519.0,,,,,,,14455034.0,,,,838543.0,,,,,,29465502.0,,,-1378636.0,5433476.0,15080.0,,,261894581.0,3837417.0,229.0,,,226347.0,,12913.0,,9698876.0,,,,,1222690137.0,,,,-10102.0,24932.0,834478000.0,15.0,,24.5,20479972.0,,30988491.0,,-379252.0,,,,,,,,4873568.0,,,71148464.0,,,17639511.0,,299692000.0,,,3214478.0,,,,,,,,,-843611.0,42395444.0,9923309.0,2146963.0,1850897.0,,649069847.0,3414765.0,,3400687.0,,,,-119617.0,22828.0,23837629.0,2256297.0,27843.0,,,3414765.0,182.0,Y,5462989.0,11703888.0,,,,,5186.0,3545228.0,4761879.0,285844.0,3545228.0,6627.0,,,15658.0,,454369.0,11842697.0,,,-599.0,251732.0,,,6498897.0,20394338.0,,,34.0,,N,5051798.0,46931.0,,12079585.0,1417.0,,1321137298.0,,,3120912.0,,311.0,,20174230.0,,,410355.0,,,60245192.0,,558405000.0,,,,,529121.0,,59620.0,,,2555.0,308758.0,118272.0,259013.0,15700183.0,4232730.0,,,,Y,35004,5563930.0,,,,5719.0,408057.0,89676731.0,,,0.205213,31822433.0,,,1113.0,55255.0,1431621.0,10658017.0,,,,2203487.0,919681.0,,7650627.0,,49367776.0,,,,,147597.0,13731448.0,51740949.0,,,,,,3661.0,,59549253.0,5555268.0,,195318898.0,32887880.0,6408173.0,,,64216606.0,,63084973.0,39.52,,,27073485.0,38845383.0,50030.0,,,,11309799.0,,,15228.0,,,671083.0,,,62078780.0,,,,,,3214478.0,215376.0,,,,,,,58670611.0,,,257626.0,,13686900.0,,,718928.0,845257458.0,2345550.0,,,,59615.0,,,11693550.0,,,,,,,,43036.0,22364055.0,2182266.0,13673433.0,,147597.0,571.0,,,,595.0,-6039210.0,50294454.0,68554293.0,1011468.0,,,,,,,13901083.0,1922458127.0,7500693.0,,,52.45,39418020.0,884948.0,,5728458821.0,13993.0,,,,,,,,,,,,119742052.0,,137724.0,,,,5421119.0,12689127.0,317255.0,,,,,42.77,,1387839.0,1812950.0,,,142735.0,,10864325.0,1919.0,2772676.0,,,19070354.0,34933200.0,,831578212.0,19633000.0,,560068.0,,1387839.0,36310974.0,,,,241558.0,,713200000.0,,,,,,,170276.0,359022.0,,,4128803.0,,,5520217.0,8995.0,,,215376.0,2051446.0,,,,388142.0,,,335702,,823617.0,78748733.0,17002357.0,,,-102023.0,58080702.0,,,3193840.0,,50.17,985936.0,451225000.0,,1094133.0,,3761117.0,,253952942.0,,,4.0,,,,7.0,1175554792.0,,4933184.0,,7862032.0,,17279411.0,,-1057.0,3457650.0,691150.0,,2350255.0,67145000.0,212593.0,,919621554.0,,9510428.0,30865316.0,,,,149048.0,,4338474.0,,55255.0,17058871.0,37243.0,,,80862881.0,2826753.0,,,,327.82,570995.0,,13686900.0,547664.0,,,,4355887.0,,2224250.0,,12116488.0,,,,,,,30490415.0,,1398494.0,-1461571.0,,-32453018.0,143720.0,40261852.0,,,,110146.0,,,,,78748733.0,,523535639.0,2337049.0,,,6944541.0,,,,544948000.0,615.0,46.92,,971455.0,,,1773632.0,,,,,484130.0,,,,,NASSAU,,,,20280.0,,285844.0,,,,,10032.0,,,,200498.0,1676217.0,Y,2.0,,4849590.0,17642786.0,,,14405196.0,,,,,,1387839.0,,,,,,1543014.0,178004.0,,,-1681930.0,,,2042211.0,,,,,,,,,1464500456.0,3942067.0,,,,,289762.0,,14643056.0,345340.0,,663930.0,3116195.0,1397452.0,,,,,N,,317255.0,,11487426.0,2014,Acute Care Hospitals,NORTH SHORE UNIVERSITY HOSPITAL (330106)
33111,NORTH SHORE UNIVERSITY HOSPITAL (330106),General Short Term (Acute Care Hospitals),Voluntary Nonprofit-Other,-73.703029,40.779269,71064.0,2274.0,,,,,20487538.0,,,,85503906.0,,101669805.0,191435344.0,,41081061.0,,,6621080.0,,,,,,,,,,,1140168.0,,,,47255.0,,,,591629655.0,109943.0,,,,,,25156847.0,,,,,1535845.0,,,,177558000.0,426208.0,8772600.0,,,,,112209.0,,,,,,236396.0,,,24315709.0,,,,,11894003.0,,,17633.0,,,,13805.0,,280503.0,,38269390.0,,16162992.0,,,1645402.0,,1255903.0,,42538719.0,,,,,,,,,,,1081739256.0,2470919.0,2417847.0,,53172244.0,,,,,10404.0,,,47265.0,,2869212.0,,,-16687.0,,,,,40.0,17155.0,,1389778.0,,74494.0,426208.0,,N,,,-522834775.0,,,311000.0,848087.0,2202520.0,,5739.0,,23473043.0,13109670.0,,,,,,4032095.0,,20535.0,,,,,,-559534013.0,111605020.0,4219.0,,,,91666.0,,,,2417847.0,,2038630.0,276011.0,,,,,5221732.0,32647841.0,,,,,25.6,4732013.0,,,,,,,,,,J,28379663.0,-7941086.0,,,,28745391.0,,447.86,7237.0,,,,20.0,,1145866000.0,,1958950.0,12281765.0,,,,3383558.0,7597.0,110049191.0,5089345.0,30988491.0,,,,,1434569.0,30300989.0,,,13176862.0,,8338381.0,,79209.0,,,,,25.48,58723254.0,59575536.0,8120.0,,1442054.0,,,4980164.0,,,18595052.0,330106,,189068160.0,136650.0,,5643699.0,,-2955254.0,,,299652518.0,,131989.0,,207.0,,5949729.0,,63.41,,,,General Short Term,,378055.0,6621080.0,,,,,,,,,,111379.0,,,,17316.0,15326671.0,,,,,8058717.0,1999298000.0,,,,10447728.0,,118752122.0,,,,,55083627.0,,N,14856664.0,,,,,,-32120.0,,49567968.0,4732013.0,,,,2439.0,,,,,,,106714000.0,,,,1442009.0,77020716.0,11908000.0,,,,,,,60001.0,,,117224.0,255679380.0,,,NY,,,,,,,684412.0,,2177386677.0,,,1535845.0,1957829.0,,,389547.0,652412.0,214006731.0,,12778144.0,,1417372.0,322791.0,,,,4255727832.0,52630314.0,,,,191111.0,,23.64,,131989.0,,,,,239264.0,,28131.0,,5523017.0,,1646013.0,12405762.0,29972817.0,,55139293.0,174.0,,,,2941132.0,12281765.0,,,649975.0,,,,,9958433.0,23843933.0,61763733.0,10952306.0,,,,,,295630305.0,,54734385.0,398939.0,,15144081.0,,,,,391334.0,225741.0,10075928.0,6115646.0,,,,930101.0,-2516241.0,,678.0,28783375.0,,,,,35.96,1617852664.0,,,69.0,4622.0,,,,3473181.0,3096136.0,,,,,,,80868326.0,50059439.0,,,,,1970651.0,,15144081.0,,,,103224641.0,1592007.0,,,-11740723.0,22.63,,1324.0,,337148,366145000.0,,,,,,,,208177.0,,,3430591.0,,17675.0,36.45,33S106,,,10952306.0,,,,,,,396043000.0,305276149.0,,,244099.0,N,20487538.0,386830.0,,,,,,25276342.0,,,,38023191.0,,,,55398371.0,443891.0,,,441487.0,,,788237.0,606456.0,,4759411.0,,,,5643699.0,407163.0,,,,41611321.0,,493427.0,,,756079.0,10424261.0,,,,,24168.0,,,41981823.0,327966.0,4662.0,,,,,,,1772.0,48.78,625.0,2386841.0,,838117170.0,2332.0,21254334.0,,,14600.0,,,,2439.0,1052233.0,,,,,,,,5354061.0,,,,2373742.0,2765786.0,,6047680.0,,24871254.0,26446323.0,1281.0,249.0,,,,,2524.0,,,,,33075110.0,,,,26993.0,,,,43255295.0,,,21837916.0,175785049.0,1628282.0,,143.0,,2.0,,,,,19019795.0,,,,,16165899.0,,,,701185.0,,396043000.0,153319849.0,,8909607.0,277364.0,99991.0,,,,,,,23092317.0,,711679.0,4930.0,1710337.0,91135192.0,,10465334.0,,,,254711683.0,47.52,3502957.0,,,,,,-109243.0,,,,,,679743.0,,,,,,1311257.0,,4,30300382.0,,,1463171.0,,,,,,,,,,7072.0,230.0,,613.0,126913000.0,,,73087.0,,9167348.0,5113971.0,,,18615.0,,244.0,8841558.0,21635089.0,644716.0,,-77752.0,,1301736.0,,,,,220362246.0,,,,,5421371.0,66999768.0,,,,,29528046.0,76717114.0,7478634.0,7690944.0,,,,,,,236476407.0,,766.0,,2116540.0,7260710.0,1532198.0,,,,,,838117170.0,,,,3541089.0,,10360964.0,,184809962.0,,37.76,,,,12970245.0,3374014.0,,,,,6237135.0,,194410.0,,,17327.0,,98263.0,,1645402.0,,,,20798139.0,,-32120.0,35116.0,,1253386.0,,,69205939.0,,,,17224.0,,,,,3887865.0,,,1535845.0,158242802.0,,6299555498.0,867940.0,P,,625.0,225741.0,,,,,525000.0,39157951.0,,,23843933.0,,1765.0,,294219.0,,2428178.0,,13109670.0,,4255727826.0,1303145.0,,,25939533.0,10952306.0,,,16.0,,132645913.0,,,,,,38635313.0,,,,,,,,631836221.0,88710.0,,,4.0,45360139.0,,,84207496.0,,88710.0,1709626.0,21490.0,,1255903.0,,,13192431.0,4106804.0,,NORTH SHORE UNIVERSITY HOSPITAL,2601897.0,,1199.0,278657.0,,,26001639.0,,300 COMMUNITY DRIVE,274330.0,1285506.0,,3910.0,257912175.0,,,500711.0,21712355.0,,56645.0,,,39559.0,Y,,,,23392342.0,513258.0,,,1710337.0,12232427.0,,2140380.0,1607050.0,,,4755076.0,,,6391626.0,,280252475.0,233728.0,,,,37540115.0,,,,3910.0,,51318.0,58495017.0,9838989.0,,,,-246474993.0,11692187.0,37049516.0,363577.0,17010000.0,,49526406.0,,,,,,413655461.0,814256.0,1126716.0,,32647841.0,19924633.0,,,135164.0,,,,,,,,,,,,301875442.0,10006921.0,,,,136068520.0,,227323.0,,12846865.0,,60000.0,,,,65665.0,,32446253.0,55413500.0,1758681.0,,,4373199.0,,,,5739.0,37252349.0,79920511.0,4146001.0,10960564.0,17954511.0,413655461.0,2024-01-05 00:00:00,,1303145.0,,211676699.0,,,,,,1389778.0,53172244.0,,,2876972.0,,24871254.0,,37201.0,,1238786.0,,,48445181.0,,,280252475.0,,2064521.0,,,,17596170.0,,,,,,,399528.0,,21435768.0,408737.0,,,835948.0,3163142.0,,,,549132.0,1236557.0,,,871664538.0,,,4369298.0,,,46043561.0,,,,,,866.0,,,108266432.0,,,11953190.0,,30671032.0,3898932.0,3285893.0,,,F,29836200.0,54752673.0,31.5,,,1772.0,,,71833.0,,,,2015-12-31,1442009.0,,323631.0,8805327.0,6875.0,,,13001,,,,29281670.0,10507066.0,,,17596170.0,88.7,,10465334.0,733506026.0,,295630305.0,,,85168144.0,,,972874.0,,,,,1015.0,48159165.0,122369211.0,4681702834.0,,79920511.0,,,,,,,-241377.0,23155188.0,229283.0,,,,,2609967.0,-14787160.0,,47.0,,1255903.0,7721.0,,,,,,1060576.0,,18595052.0,606456.0,,,253.0,,,33400,,680.0,601735.0,202444229.0,68774923.0,,,,,2819630.0,9422.0,169.0,,157647.0,,,,252258.0,,,48159165.0,9804045.0,,,,,441580.0,5584472.0,,275898.0,,3648370.0,,,,113955.0,,-1764505.0,3357.0,,,,1167250.0,3482295.0,3533058.0,2015-01-01 00:00:00,,-130856.0,,1042474000.0,,,,111605020.0,94358807.0,,-704987439.0,,,-1953049.0,,,,,398116.0,,1137887.0,,,72351575.0,38253546.0,47458229.0,859350.0,,16469657.0,,1323.0,,17918.0,,974831.0,,,3561189.0,12401.0,,,,,25963566.0,,,,,,,22.89,12985.0,17633.0,14751.0,,,,,2907211.0,,29105966.0,225910.0,,,33265.0,88793802.0,114724106.0,X,,,,,N,,,,,,11713630.0,,22605596.0,,,,-434906472.0,9316.0,,9162.0,,58723254.0,1300967388.0,,,,,,3577808.0,750927000.0,,,404492091.0,,,,,,17327.0,,,143.0,10424261.0,,,1001.0,3220258.0,,2378764.0,,4801679.0,,1243.0,,-1000734.0,,,,,7093747.0,791179.0,,35214.0,,,,,1983.0,,120011000.0,,,,,88.7,,79035308.0,3204.0,,,,,19597288.0,59336811.0,,,120044572.0,,,23473043.0,,,132645913.0,142834.0,,,10359655.0,,,800091.0,,,,,,8279701.0,51940.0,,,,1056380.0,,,,,,15909575.0,,,,,04/04/2008,,,,,3262078.0,,,90885.0,,,4787.0,,Y,,,22565484.0,,47.86,,,207.0,,,,,,,,42538719.0,,,150823454.0,,,,79634.0,,,1360933.0,8328414.0,45281.0,10282880.0,,49526406.0,,4930.0,-45120117.0,690807.0,6342129.0,,17262.0,,4961680.0,1708390.0,,61.97,56335788.0,1081739256.0,,,206.0,1081739256.0,55139293.0,264361.0,277364.0,,1084925.0,,24442152.0,,,,,43255295.0,,16576084.0,,,46043561.0,,37218783.0,,124334213.0,11880703.0,,,,3.0,,136068520.0,2043827672.0,373505.0,50050074.0,,,1300757735.0,,,,,730140.0,13502895.0,,,9857543.0,,,1766.0,,MANHASSET,,122369211.0,,,,52.61,,,,,Y,,9316.0,,,2207030.0,280.57,,48528.0,,,,,37218783.0,-316.0,11763569.0,,,,,,,9563288.0,,,,,,,,,12078285.0,70066000.0,48032518.0,,209653.0,17462.0,,3849415.0,,,80868326.0,,,,-1000734.0,5731418.0,,2813.0,,,12270097.0,,,243.96,,,22585.0,57106589.0,,11692187.0,,9162.0,150570.0,63754264.0,,5475.0,,4955046.0,,490316.0,,,,,82743.0,54752673.0,3839.0,,,73413.0,639267.0,,,,,13192431.0,,150012.0,,3473181.0,,1.0,,-5853551.0,199133569.0,,8138530.0,,10030,1439866.0,,,281269.0,12932613.0,16165899.0,,,,74912674.0,,,-99005.0,22356651.0,,109231.0,27215.0,,,,,,,162956.0,5.0,,,,,22599898.0,,272975732.0,,,,-112100.0,10424261.0,,,,3441000.0,184336147.0,1476941.0,,,47265.0,,,,7301.0,,,5617907.0,,125855.0,,,,,,13266.0,94185146.0,,,,N,,3520267.0,,,9835.37,,,,,,,51.0,441580.0,NSUH PSYCHIATRIC EXEMPT UNIT,13805.0,,31415.0,82500.0,,280252475.0,221.0,,,,16162992.0,,,,,9211.0,,14761054.0,,19019795.0,1535845.0,,,,,9107267.0,,,,142834.0,63.41,,21712355.0,,,215.05,22356651.0,,,,,,,,,,,18116183.0,12348.0,,,,,,126296000.0,,2064521.0,6.0,,666276.0,1120092.0,,,8772600.0,1033.0,3.0,9857543.0,-2813559.0,,12092811.0,,3096136.0,,28487888.0,5329652.0,,,,,,266355.0,,56852347.0,,28783375.0,29836200.0,,,,,88710.0,,426208.0,16227173.0,314.0,,,220053.0,,,,,513888.0,-2985814.0,2984748.0,,25276342.0,,16746731.0,10171.0,,,,,1567000.0,,,,,,,,,7848817.0,9083697.0,,90325.0,10231.0,18226290.0,8248058.0,,,12272824.0,36420770.0,,6196276.0,,15129.0,,16133563.0,,,,11713630.0,45389346.0,,,100724765.0,864384.0,637946865.0,,3221377.0,,,,,,,40.0,499737.0,,,14751.0,,,,,,,,,,,,,,8248058.0,,,14640.0,761452,10447877.0,133911.0,,,,320833.0,,2524.0,12281765.0,,949900.0,,,,,2803659.0,,-2813559.0,126019735.0,,,,5621827.0,,,,,,28991.0,,,,3419307.0,,,,,,79620468.0,77925.0,18222097.0,,,,,,,,,,170007.0,,,5423510.0,,,,,,4609051.0,2363254.0,,,,8059689.0,,,,,,29.92,73711207.0,165457000.0,,,,,,,,1137887.0,,,,7278407.0,12348.0,,-11762678.0,35902097.0,24315709.0,,,,1.0,,Y,9864.0,,,,,,,,,,,141167508.0,,1973051.0,,378055.0,2085203.0,14533053.0,72351575.0,,76591472.0,,12083325.0,,,,,,,-268876.0,,,,-704987439.0,,12083325.0,3383558.0,,,,499.0,,,1054434.0,,,10006921.0,-41667129.0,423730.0,-111513.0,,29582546.0,,,,,333550,85962.0,,,4018730.0,86301908.0,3951382.0,,,27126.0,1508352.0,13192431.0,,,48445181.0,,,N,,749344.0,255029701.0,10404.0,,,19166818.0,331.82,,,,,,118752122.0,,,,,,-69215000.0,184336147.0,,,5490353.0,,,2480009.0,,,690075.0,,84207496.0,162334365.0,220053.0,,,,,,,,,,19446114.0,730678.0,55490.0,972874.0,,5621000.0,3969770.0,,46548852.0,N,,,-227965.0,33,,,1255892.0,,,,3911278.0,,48909.0,9507663.0,1006610.0,,,,733791619.0,,,10447728.0,,,1253151.0,,,10638.51,,,,,3375571.0,47057076.0,5584472.0,,,,59971.0,,7100570.0,16181.0,136777.0,,223955019.0,,,236396.0,,27.8,,,,,,,214444.0,,,,25442898.0,,,,,,,,1897688.0,229129.0,,,,,,,,,,,,,,2127563.0,,,,5490353.0,,,,,12394612.0,,12012.0,,,,5380,,91145.0,,12012.0,2002357.0,,,,,,,16228258.0,,,,,,,,,,33075110.0,,,-1379123.0,5421088.0,14640.0,,,276735301.0,5099740.0,1371.0,,,212374.0,,17316.0,,10304145.0,,,,,1368002990.0,,,,-2002.0,60893.0,859325000.0,15.0,,25.39,23572222.0,,37380117.0,,-574739.0,,,,,,,,6115646.0,,,79602835.0,,,19289435.0,,353999000.0,,,3504352.0,,,,,,,,7597.0,-1125701.0,42736573.0,10236931.0,2165629.0,1870106.0,,644997817.0,3533058.0,,4021724.0,,,,-125040.0,28867.0,25713065.0,2757233.0,20250.0,,,3533058.0,26.0,Y,6062472.0,13051011.0,,,,,28983.0,3482295.0,4712430.0,323770.0,3482295.0,6927.0,,,21988.0,,3460820.0,6391626.0,,,-1932.0,288989.0,,,5956844.0,21837916.0,,,34.0,,N,3096136.0,48909.0,,11880703.0,1323.0,,1472399238.0,,,3270481.0,,286.0,,18222097.0,,,832613.0,,,56852347.0,,584210000.0,,,,,599718.0,,46532.0,,,2190.0,278548.0,512003.0,311895.0,16525392.0,4585440.0,,,,Y,35004,5732814.0,,,,5919.0,600992.0,39732358.0,,,0.206484,33060547.0,,,1720.0,24271.0,1870248.0,10734469.0,,,,2386841.0,967540.0,,8612865.0,,54259172.0,,,,,164169.0,17274260.0,56335706.0,,,,,,4219.0,,65459357.0,5625144.0,,189068160.0,29281670.0,6169829.0,,2793.0,72627903.0,,69205939.0,42.83,,,30992450.0,43255295.0,71945.0,,,,12105009.0,,,21188.0,,,592896.0,,,68774923.0,,,,,,3504352.0,293227.0,,,,,,,59575536.0,,,241939.0,,15144081.0,,,1137887.0,835601822.0,2643358.0,,,,62611.0,,,11894003.0,,,,,,,,45091.0,26578251.0,2911386.0,,,164169.0,747.0,,,,767.0,-6860743.0,62516532.0,77020716.0,1440551.0,,,,,,,12952929.0,2043827672.0,9518739.0,2607.0,,54.03,45389346.0,426711.0,,6299555504.0,9775.0,,,,,,,,,,,,132645913.0,,65665.0,,,,5778285.0,14175058.0,277521.0,,,,,45.96,,1480333.0,1860484.0,,,150012.0,,12170125.0,3682.0,2722899.0,,,19924633.0,37540115.0,,822440226.0,27433000.0,,365313.0,,1480333.0,42743140.0,,,,971975.0,,676329000.0,,,,,,,283701.0,461830.0,,,4319597.0,,,6141681.0,7070.0,,,293227.0,2103006.0,,,,388180.0,,,335702,,869989.0,91440563.0,16689330.0,,,-102022.0,62023305.0,,,4033107.0,,52.01,1433615.0,457389000.0,,1160489.0,,3849415.0,636261.0,280252475.0,,,6639.0,,,,7.0,1300757735.0,,4997880.0,,8055983.0,,18862608.0,,-82.0,3520267.0,937335.0,,2483948.0,72464000.0,323631.0,,1095647421.0,,9857543.0,39157951.0,,,,152560.0,,4819763.0,,24271.0,19574969.0,24168.0,,,100724765.0,3351626.0,,,,331.82,576279.0,,15144081.0,519186.0,,,,4577484.0,,1958950.0,,12168366.0,,,,,,,26652012.0,,2890098.0,-906689.0,,-33930448.0,143617.0,41981823.0,,,,118507.0,,,,,91440563.0,,599266371.0,2378764.0,,,8059689.0,,,,550033000.0,613.0,48.05,,918784.0,,,1790022.0,,,,,512202.0,,,,,NASSAU,,,,17633.0,,323770.0,,,938.0,,17918.0,,92.0,,202608.0,1526638.0,Y,2.0,,5782564.0,18116183.0,,,16165899.0,,,,,,1480333.0,,,,,,1611571.0,239264.0,,,-1806628.0,,,2248102.0,,,,,,,,,1687555113.0,3480998.0,,,,,303807.0,,14856664.0,360834.0,,2756529.0,4662058.0,1442009.0,,,,,N,,277521.0,,11953190.0,2015,Acute Care Hospitals,NORTH SHORE UNIVERSITY HOSPITAL (330106)
39272,NORTH SHORE UNIVERSITY HOSPITAL (330106),General Short Term (Acute Care Hospitals),Voluntary Nonprofit-Other,-73.703029,40.779269,36785.0,2349.0,,,,,20909923.0,,,,93680384.0,,110027148.0,173669009.0,,43108125.0,,,7458813.0,,,,,,,,,,,1142825.0,,,,48132.0,,,,584682609.0,65417.0,,,,,,25831005.0,,,,,1109003.0,,,,185393000.0,412874.0,10596735.0,,,,,157249.0,,,,,,291418.0,,,25138477.0,,,,,12277329.0,,,20568.0,,,,14255.0,,290266.0,,18958402.0,,16667088.0,,,887146.0,,1260297.0,,42909646.0,,,,,,,,,,,1186948976.0,2684437.0,2544044.0,,56315049.0,,,,,10330.0,,,16375.0,,1801202.0,,,1.0,,,,,40.0,17202.0,,1338395.0,,69482.0,412874.0,,N,,,-608766209.0,,,246000.0,1135002.0,2210535.0,,5518.0,,24155124.0,13398564.0,,,,,,2833190.0,,,,,,,,-557827800.0,73067518.0,4070.0,,,,67426.0,,,,2544044.0,,2422038.0,8940781.0,,,,,6110805.0,40541174.0,,,,,26.43,4631985.0,,,,,,,,,,J,31364006.0,-7803361.0,,,,34721040.0,,460.24,1104.0,,,,38.0,,1144958000.0,,2077436.0,10970111.0,,,,3606559.0,42770.0,115437520.0,5646841.0,37380117.0,,,,,823015.0,35947080.0,,,11561861.0,,8132660.0,,71328.0,,,,,25.56,72224592.0,66202918.0,9517.0,,1022039.0,,,3101715.0,,,16616331.0,330106,,194333048.0,130994.0,,6231969.0,,-4144877.0,,,352100172.0,,78511.0,,90.0,,4889633.0,,75.23,,,,General Short Term,,386815.0,7458813.0,,,,,,,,,,46546.0,,,,13078.0,16401818.83,,,,,9521370.0,2109264000.0,,,,10572067.0,,131978471.0,,,,,88211720.0,,N,15774007.0,,,,,,-326617.0,,53938943.0,4631985.0,,,,260.0,13.0,278.0,,,,,110025000.0,84969000.0,,,1550505.0,80204656.0,11908000.0,,,,,,,63002.0,,,,305126796.0,,,NY,,,,,,,518395.0,,2353230565.0,,,1109003.0,1336015.0,,,466899.0,635134.0,234262508.0,,15225111.0,,1534878.0,218260.0,,,,4651898260.0,51714077.0,,,,239771.0,,23.26,,78699.0,,,,,328402.0,,23730.0,,5297387.0,,353360.0,9770740.0,30981156.0,,68208907.0,125.0,,,,3702857.0,10970111.0,,,658073.0,,,,,9510429.0,25878443.0,64973816.0,11942765.0,,,,,,357852058.0,,59414497.0,370039.0,,14644737.0,,,,,379349.0,234730.0,5167689.0,7896187.0,,,,600962.0,-3155131.0,,,32142492.0,,,,,34.37,1795402765.0,,,69.0,5020.0,,,,5657197.0,1387358.0,,,,,,,103848098.0,53430530.0,,,,,1966579.0,,14644737.0,,,,109156494.0,1983639.0,,,-11681241.0,22.46,,1175.0,,337148,311155000.0,,,,,,,,221569.0,,,2014400.0,,24541.0,37.53,33S106,,,11942765.0,,,,,,,520571000.0,297579862.0,,,283457.0,N,20909923.0,461413.0,,,,,,41361259.0,,,,36974527.0,,,,58530698.0,363729.0,,,525261.0,,,942970.0,811014.0,,5176364.0,,,,6231969.0,428954.0,,,,45602163.0,,583624.0,,,738128.0,11336978.0,,,,,52517.0,,,45926777.0,294067.0,5392.0,,,,,,,1860.0,48.03,,2209003.0,,815655501.0,2462.0,22152753.0,,,14640.0,,,,260.0,847667.0,,,,,,,,5114967.0,-54369.0,,,2577036.0,904617.0,,7032259.0,,25218427.0,29921664.0,,249.0,,,,,2357.0,,,,,37810641.0,,,,22523.0,,,,43756548.0,,,21008175.0,145669786.0,1083057.0,,71.0,,2.0,,,,,23054378.0,,,,,16346764.0,,,,831664.0,,520571000.0,158889527.0,,9988952.0,323250.0,102823.0,,,,,,,29666471.0,,701760.0,4166.0,2166550.0,110114487.0,,12853415.0,,,,269963685.0,48.7,4177002.0,,,,,,-113171.0,,,,,,411348.0,,,,,556.0,823763.0,,4,16437113.0,,,1316522.0,,,,,,,,,,7595.0,2444.0,,603.0,101089000.0,,,44130.0,,9571426.0,593707.0,,,18666.0,,215.0,8994129.0,28362533.0,777116.0,,-64731.0,,10115252.0,,,,,243158546.0,,,,,5995232.0,57171344.0,,,,,20336633.0,39109876.0,8440716.0,7106505.0,,,,,,,272595730.0,,756.0,,2509582.0,5075325.0,965222.0,,,,,,815655501.0,,,,4463172.0,,10392227.0,,199825569.0,2.0,38.79,,,,13837860.83,4031293.0,,,,,6450890.0,,229072.0,,,17420.0,,98848.0,,887146.0,,,,21989395.0,,-326617.0,38728.0,,1322905.0,,,66343109.0,,,,,225750.0,,,,1796896.0,,,1109003.0,170342597.0,,6852419085.0,584399.0,P,,,234730.0,,,,,674000.0,68799017.0,,,25878443.0,,1926.0,,334175.0,,2217770.0,,13398564.0,,4651898260.0,1228012.0,,,27281659.0,11942765.0,,,16.0,,133723206.0,,,,,,49900986.0,,,,,,2032.0,,664060010.0,91903.0,,,4.0,40199224.0,,,86978736.0,,91903.0,10694219.0,24285.0,,1260297.0,,,13674612.0,2574659.0,,NORTH SHORE UNIVERSITY HOSPITAL,3910029.0,,1317.0,182179.0,,,26901286.0,,300 COMMUNITY DRIVE,,1532012.0,,3836.0,287028318.0,,,669042.0,23048358.0,,,,,41312.0,Y,,,,23517143.0,525078.0,,,2166550.0,12475144.0,,1993670.0,2298229.0,,,6350944.0,,,8433182.0,,294839697.0,277221.0,,,,42877691.0,,,,3836.0,,47601.0,28477897.0,10156823.0,,,,-274521918.0,14030220.0,44611213.0,437718.0,7500000.0,,70790394.0,,5.0,,,,438672841.0,951774.0,1183902.0,,40541174.0,18403334.0,,,180507.0,,,,,,,,,,,,333078357.0,7376433.0,,,,141008578.0,,205709.0,,12106448.0,,56927.0,,,,84968.0,,47487014.0,58545497.0,1127964.0,,,3781638.0,,,,5518.0,171619125.0,99339316.0,3557169.0,11188713.0,25962997.0,438672841.0,2024-01-05 00:00:00,,1228012.0,135.0,215085259.0,,,34.0,,,1338395.0,56315049.0,,,2785146.0,,25218427.0,,42975.0,,1196812.0,,,52699479.0,,,294839697.0,,1546720.0,,,,18608023.0,,,,,,,642466.0,,14432588.0,421692.0,,,459471.0,1998523.0,,,503.0,424864.0,566182.0,,,1630323444.0,,,6002739.0,,,51357091.0,,,,,,487.0,,,114965643.0,,,13224712.0,,32272811.0,3810410.0,571975.0,,,F,32458717.0,36593298.0,31.13,,,1860.0,,,110522.0,,,,2016-12-31,1550505.0,,162860.0,9340574.0,2662.0,,,13001,,,,33073967.0,6858574.0,,,18608023.0,84.8,,12853415.0,774087158.0,,357852058.0,,,96884998.0,,,968235.0,,,,,1051.0,53664502.0,144028481.0,5057016320.0,,99339316.0,,,,,,,,30796491.0,187039.0,,,,,3107796.0,-31165296.0,,47.0,,1260297.0,,,,,,,662940.0,,16616331.0,811014.0,,,183.0,,,33400,,,728547.0,227075712.0,72587127.0,,,,,2882753.0,3764.0,,,188594.0,,,,473908.0,,,53664502.0,10127299.0,,,,,236587.0,5320900.0,,283006.0,,990805.0,,,,47060.0,,-2313862.0,,,,,1930250.0,3348612.0,3397470.0,2016-01-01 00:00:00,,-81799.0,,979835000.0,,,,73067518.0,123549396.0,,-796315804.0,,,-2912252.0,,,,,331569.0,,1114634.0,,,70733647.0,39744770.0,60042104.0,1089385.0,,18777938.0,,1332.0,,9812.0,,1008537.0,,,3421200.0,,,,,,28690745.0,,,,,,,22.5,14591.0,20568.0,15315.0,,,28.0,,3266008.0,,36435624.0,234730.0,,,39793.0,96697008.0,110273605.0,X,,,,,N,,,,,,13310373.0,,31602320.0,,,,-497346465.0,9695.0,,8408.0,,72224592.0,1396844406.0,,,,,,5135824.0,708247000.0,,,475127160.0,,,,,,17420.0,,,71.0,11336978.0,,,,3822735.0,,2697388.0,,4493901.0,,,,-1216920.0,,,,,7278737.0,524639.0,,35186.0,,,,,113.0,,117597000.0,,,,,84.8,,78122171.0,,,,,,17458652.0,60790353.0,,,134384268.0,,,24155124.0,,,133723206.0,175087.0,,,11277354.0,,,476027.0,,,,,,52461988.0,58362.0,,247.0,,1177325.0,,,,,,12391475.0,,,,,04/04/2008,,,,,2842637.0,46.0,,91134.0,,,3646.0,,Y,,,11777685.0,,47.2,,,195.0,,,,,,,,42909646.0,,,286740548.0,,,,61062.0,,,1364978.0,7217454.0,,10520552.0,,70790394.0,,4166.0,-28903056.0,467062.0,7108472.0,,35286.0,,4217352.0,1733099.0,,67.07,59195123.0,1186948976.0,,,288.0,1186948976.0,68208907.0,268130.0,323250.0,,851050.0,,26500057.0,,,,,43756548.0,,10278619.0,,,51357091.0,,38429600.0,,137012768.0,11096183.0,,,,3.0,,141008578.0,2200520834.0,374664.0,56100954.0,,,1396844406.0,,,,,555641.0,11571952.0,,,10195054.0,,,,,MANHASSET,,144028481.0,,,,53.9,,,,,Y,,9695.0,,,1266177.0,349.63,,10798.0,,,,,38429600.0,-834.0,12599375.0,,,,,,,10709638.0,,,,,,,,,5805134.0,80718000.0,27485132.0,,,6880.0,,153684.0,20620.0,,103848098.0,,,,-1216920.0,6810393.0,,217.0,,,12722500.0,,,243.7,,,6319.0,63790462.0,,14030220.0,,8408.0,27902.0,66486370.0,,5490.0,,3186102.0,,470669.0,,,,,82044.0,36593298.0,4746.0,,,73121.0,655578.0,,,,,13674612.0,,151042.0,69.0,5657197.0,,1.0,,-8587374.0,228924366.0,,7801459.0,,10030,1724228.0,,,423065.0,20618744.0,16346764.0,,,,76953638.0,,,-79864.0,20111450.0,,70524.0,16351.0,,,,,,,170237.0,5.0,,,,,24596234.0,,336330262.0,,,,-35287.0,11336978.0,,,,9605000.0,189701063.0,996050.0,,,16375.0,,,,,,,6196431.0,,113948.0,,,,,,15582.0,97039979.0,,,,N,,3439754.0,,,10314.56,,,,,,,51.0,236587.0,NSUH PSYCHIATRIC EXEMPT UNIT,14255.0,,41643.0,129583.0,,294839697.0,247.0,,,225750.0,16667088.0,,,,,3063.0,,11904520.0,,23054378.0,1109003.0,,,,,29564353.0,,,,,62.11,,23048358.0,,,279.97,20111450.0,,,,,,,,,,,19342179.0,11436.0,,,,,,,,1546720.0,7.0,,665971.0,699479.0,,,10596735.0,812.0,3.0,10195054.0,-3354551.0,,36330592.0,,1387358.0,,34657548.0,6362642.0,,,,,,525624.0,,36474220.0,,32142492.0,32458717.0,,,,,91903.0,,412874.0,12964282.0,315.0,26.0,3.0,227008.0,,,,,323618.0,-3210270.0,1536839.0,,41361259.0,,16960076.0,11784.0,,,,,1493000.0,,,16836.0,,,,,,19484602.0,9635912.0,,118528.0,14932.0,17586932.0,2314216.0,,,1450039.0,41709744.0,,6196276.0,,14799.0,,17377469.0,,,,13310373.0,48634361.0,,,120910393.0,950301.0,683363435.0,,3342616.0,,,,,,,40.0,345867.0,,,15315.0,,,,,,,,,,,,,,2314216.0,,,14505.0,761453,13429361.0,-1.0,,,,405509.0,,2357.0,10970111.0,,-1702623.0,,,,,1654480.0,,-3354551.0,137491745.0,,,,5988745.0,,,,,,26164.0,,,,3778210.0,,,,,,80487915.0,68275.0,10631979.0,,,,,,,,,,174765.0,,,4463872.0,,,,,,4393142.0,2815984.0,,,,7825900.0,,,,,,29.26,76063427.0,196426870.0,,,,,,,,1114634.0,,,,7927154.0,11436.0,,-11699213.0,19596609.0,25138477.0,,,,1.0,,Y,8617.0,,,,,,,,,,,157830919.0,,1208169.0,,386815.0,2519617.0,14742501.0,70733647.0,,78431813.0,,13065229.0,,,,,,,-384799.0,,,,-796315804.0,,13065229.0,3606559.0,,,,820.0,,,894830.0,,,7376433.0,-29393108.0,588689.0,-245120.0,,44439045.0,,,,,333550,97140.0,,,3691304.0,46443534.0,4270459.0,,,19286.0,1275363.0,13674612.0,,,52699479.0,,,N,,1077788.0,299208409.0,10330.0,,,22481828.0,336.5,,,,,,131978471.0,,,,,,-78437000.0,189701063.0,,,5197096.0,,,-716000.0,,,726483.0,,86978736.0,174528237.0,227008.0,,,,,,,,,,16569644.0,874256.0,56105.0,968235.0,,5621000.0,5414642.0,-2004188.0,33454848.0,N,,,-38160.0,33,,,1214497.0,,,,4686985.0,,50179.0,13533960.0,836870.0,,,,774699736.0,,,10572067.0,,,1925896.0,,,11193.4,,,,,4242473.0,48376160.0,5320900.0,,,,63002.0,,7578750.0,16161.0,95796.0,,222179415.0,,,,,29.81,,,,,,,224602.0,,,,28567119.0,,,,,,,,1967697.0,148685.0,,,,,,,,,,,,,,2549913.0,,,,5197096.0,,,,,23082356.0,,12003.0,,,,5380,,51972.0,,12003.0,637445.0,,,,,,,10509732.0,,,,,,,,,,37810641.0,,,-1438793.0,5902398.0,14505.0,,,304934689.0,4206119.0,1218.0,,,140917.0,,13078.0,,10339131.0,,,,,1448296592.0,,,,-111343.0,,1020613000.0,15.0,,25.0,23494786.0,,45813299.0,,-537875.0,,,,,,,,7896187.0,,,80467347.0,,,22423490.0,,395518000.0,,,3624432.0,,,,,,,,42770.0,-1171794.0,40037460.0,10947306.0,1247612.0,2030658.0,,678002728.0,3397470.0,,3784341.0,,,,-134336.0,28491.0,30676773.0,1332984.0,9933.0,,,3397470.0,258.0,Y,5734808.0,12230028.0,,,,,17828.0,3348612.0,4562243.83,257753.0,3348612.0,6975.0,,,27666.0,,2537034.0,8433182.0,,,-6326.0,326279.0,,,5722363.0,21008175.0,,,34.0,,N,1387358.0,50179.0,,11096183.0,1332.0,,1556914761.0,,,3695339.0,,341.0,,10631979.0,,,1251989.0,,,36474220.0,,544914000.0,,,,,411933.0,,26346.83,,,2562.0,390348.0,264920.0,235685.0,19554952.0,4216163.0,,,,Y,35004,5913759.0,,,,6605.0,1131706.0,170903125.0,,,0.203847,28350746.0,,,135.0,10769.0,1671638.0,10766891.0,,,,2209003.0,603257.0,,9157033.0,,59713844.0,,,,,182180.0,19653965.0,59195023.0,,,,,,4070.0,,76897282.0,6197535.0,,194333048.0,33073967.0,7301914.0,,13174.0,80350244.0,,66343109.0,42.7,,,20504075.0,43756548.0,296552.0,,,,13624557.0,,,30306.0,,,350393.0,,,72587127.0,,,,,,3624432.0,409577.0,,,,,,,66202918.0,,114.0,687010.0,,14644737.0,,,1114634.0,873444779.0,2933202.0,,,,72094.0,,,12277329.0,,,,,,,,44053.0,22403590.0,2466290.0,,,182180.0,904.0,,,,942.0,-7757125.0,71321982.0,80204656.0,1793834.0,,,,,,,13824782.83,2200520825.0,9517085.0,,,53.33,48634361.0,3322617.0,,6852419094.0,4160.0,,,,,,,,,,,,133723206.0,,84968.0,,,,6434451.0,9357263.0,323250.0,,,,,45.65,,1676883.0,2051958.0,,,151042.0,,8027727.0,5239.0,1863251.0,,,18403334.0,42877691.0,,859502061.0,28098000.0,,361581.0,,1676883.0,43537361.0,,,,1074537.0,,668680000.0,,,,,,,330846.0,246520.0,,,5172683.0,,,5806136.0,8790.0,,,409577.0,2336343.0,,,,407843.0,,,335702,,1035932.0,99153803.0,18361577.0,,,-102023.0,65681394.0,,,4852019.0,,53.98,1753438.0,443735000.0,,1384239.0,,153684.0,,294839697.0,,,,,,,7.0,1396844406.0,,5243241.0,,8262786.0,,19062850.0,,-100.0,3439754.0,664325.0,,1936253.0,84237000.0,161992.0,,1166281589.0,,10195054.0,68799017.0,,,,157693.0,,4916012.0,,10769.0,21105402.0,52517.0,,,120910393.0,4080147.0,,,,336.5,607651.0,,14644737.0,23104.0,,,,1505664.0,,2077436.0,,15731474.0,,,,,,,15446308.0,,2296872.0,-968081.0,,-41211654.0,72853.0,45926777.0,,,,129439.0,,,,,99153803.0,,728730925.0,2697388.0,,,7825900.0,,,,668680000.0,603.0,46.03,,638785.0,,,1106124.0,,,,,588619.0,,,,,NASSAU,,,,20568.0,,257753.0,,,,,9812.0,,0.77,,189755.0,1652069.0,Y,2.0,,5756936.0,19342179.0,,,16346764.0,,,,,,1676883.0,,,,,,1954600.0,328402.0,,,-2043007.0,,,1834561.0,,,,,,,,,1813483030.0,4686335.0,,,,,262716.0,5.0,15774007.0,435537.0,,3047303.0,4756661.0,1550505.0,,,,,N,,323250.0,,13224712.0,2016,Acute Care Hospitals,NORTH SHORE UNIVERSITY HOSPITAL (330106)
45388,NORTH SHORE UNIVERSITY HOSPITAL (330106),General Short Term (Acute Care Hospitals),Voluntary Nonprofit-Other,-73.703029,40.779269,9856.0,3421.0,,,,,21826159.0,,,,105050205.0,,122201098.0,174679311.0,,44474596.0,,,7190311.0,,,,,,,,,9777.0,,1100976.0,,,,47520.0,,,,576718955.0,30561.0,,,,,,26374786.0,,,,,874626.0,,,,192572000.0,369538.0,12127938.0,,,,,369623.0,,,,,,261586.0,,,26656642.0,,,,,12859034.0,,,7920.0,,,,13389.0,,285442.0,,33027513.0,,20529363.0,,,107869.0,,1252296.0,,48898166.0,,,,,,,,,,,1292226539.0,,2748755.0,,55550032.0,,,,,10407.0,,,49216.0,,1942137.0,,,156104.0,,,,,40.0,17155.0,,1876322.0,,22976.0,369538.0,,N,,,-694119673.0,,,16000.0,2506890.0,2541347.0,,5462.0,,25181068.0,13837405.0,,,,,,2946263.0,,,,,,,,-671512494.0,87814523.0,4617.0,,,,59322.0,,,,2748755.0,,1996388.0,,,,,,6988667.0,44471741.0,,,,,29.2,5303245.0,,,,,,,,,,L,33279324.0,-8908741.0,,,,28997795.0,,467.65,639.0,,,,61.0,,1331694000.0,,2179800.0,23020910.0,,,,3970146.0,49235.0,116288122.0,6536200.0,45813299.0,,,,,877220.0,41191817.0,,,23846452.0,,8393016.0,,52662.0,,,,,28.15,78768695.0,70775270.0,10016.0,,1032892.0,,,863939.0,,,21185985.0,330106,,209816742.0,138691.0,19964.0,8737491.0,,-4441321.0,,,382380116.0,,12672.0,,43.0,,7082530.0,,75.19,,,,General Short Term,,378408.0,7190311.0,,,,,,,,,,45514.0,,,,10670.0,16735674.0,,,,,13711920.0,2368123000.0,,,,11833066.0,,140541751.0,,,,,124128402.0,,N,15625660.0,,,,,,-100744.0,,55160006.0,5303245.0,,,,,,,,,,,119202000.0,87228000.0,,,1687376.0,81068017.0,11908000.0,,,,,,,30604.0,5161.0,,,340273583.0,,,NY,,,,,,,135761.0,,2498429772.0,,,874626.0,1241333.0,,,378647.0,655585.0,259104933.0,43963.0,13949258.0,,1630818.0,314730.0,,,,4811153258.0,51423776.0,,,,321709.0,,25.04,,12672.0,,,,,473013.0,,25518.0,,5317447.0,,,10018039.0,38336502.0,,55932412.0,20.0,,,,3260791.0,23020910.0,,,224670.0,,,,,10335043.0,23987825.0,65063948.0,10192904.0,,,,,,404541264.0,,62719686.0,351442.0,,9031455.0,,,,,573295.0,230797.0,10513045.0,7273064.0,,,,881155.0,-3097319.0,,,33284954.0,,,,,35.86,1826917278.0,,,,5224.0,,,,4515006.0,1400093.0,,,,,,,111701802.0,54021075.0,,,,,2166457.0,,9031455.0,,,,112081883.0,2499757.0,,,-13335940.0,24.55,,228.0,,337148,347098000.0,,,,,,,,219989.0,,,1297580.0,,26889.0,41.84,33S106,,,10192904.0,,,,,,,576852000.0,280236687.0,,,107310.0,N,21826159.0,416264.0,,,,,,59910887.0,,,,38068666.0,,,,59545371.0,385689.0,,,431481.0,,,1089249.0,900564.0,,5528214.0,,,,8737491.0,450608.0,,,,48596253.0,,485574.0,,,1057458.0,13159752.0,,,,,46484.0,,,47509740.0,280383.0,4654.0,,,,,,,2161.0,51.01,,2052178.0,,815069797.0,606.0,21704743.0,,,14600.0,,,,,1182160.0,,,,,,,,5540251.0,-1166.0,,,2892907.0,2694557.0,,7813274.0,,25990143.0,31062935.0,,256.0,,,,,688.0,,,,,40884476.0,,,,23845.0,,,,47935325.0,,,6380948.0,151892868.0,1668341.0,,6.0,,2.0,,,,,20574923.0,,,,,17150893.0,,,,679300.0,,576852000.0,163689230.0,,11364094.0,151273.0,102940.0,,,,,,,19841585.0,,760889.0,2017.0,,123246269.0,,15159171.0,,,,264227535.0,51.39,3741828.0,,,,,,-130120.0,,,,,,325847.0,,,,,,984823.0,,4,16838323.0,,,1271936.0,,,,,,,,,,6018.0,12276.0,,611.0,107253000.0,,,62329.0,,8957954.0,431748.0,,,18615.0,,227.0,9459039.0,15610476.0,684675.0,,-62659.0,,10438996.0,,,,,243385711.0,,,,,6592654.0,55694502.0,,,,,17756537.0,58061430.0,,7803887.0,,,,,,,276452736.0,,764.0,,2069350.0,4844362.0,1206628.0,,,,,,815069797.0,,,,4689965.0,,10873014.0,,187706325.0,,38.63,,,,13853437.0,3609897.0,,,,,6986541.0,,38898.0,,,16413.0,,98197.0,,107869.0,,,,22964533.0,,-100744.0,35537.0,,1657314.0,,,63479833.0,,,,39188.0,197050.0,,,,1983308.0,,,874626.0,170994652.0,,7105113028.0,278837.0,P,,,230797.0,,,,,883000.0,72610599.0,,,23987825.0,,2016.0,,356866.0,,2364971.0,,13837405.0,,4815678811.0,1048758.0,,,27530506.0,10192904.0,,,,,136355547.0,,,,,,24888137.0,,,,,,1862.0,,706058761.0,91621.0,,,,39949551.0,,,89897173.0,,91621.0,23457183.0,29571.0,,1252296.0,,,14149434.0,2671389.0,,NORTH SHORE UNIVERSITY HOSPITAL,3917354.0,,811.0,258641.0,,,29703439.0,,300 COMMUNITY DRIVE,474687.0,1255447.0,,4008.0,296182906.0,,,878773.0,23847552.0,,96459.0,,,40331.0,Y,,,,24162718.0,532619.0,,,,11835056.0,,1916628.0,2632140.0,,,5851445.0,,,18275347.0,,294708059.0,230207.0,,,,45803595.0,,,,4008.0,,52051.0,51736152.0,10301887.0,,,,-309645197.0,17323637.0,54266640.0,356004.0,7500000.0,,76884429.0,,,,,,451242418.0,1103325.0,1204334.0,,44471741.0,17652697.0,,,299355.0,,,,,,,,,,,,335776367.0,7244871.0,,,,145060811.0,,393242.0,,12080636.0,,109559.0,,,,53675.0,,50562549.0,59561326.0,1311928.0,,,3851216.0,,,,5462.0,191009147.0,79403356.0,4420962.0,10755524.0,24619793.0,451242418.0,2024-01-05 00:00:00,,1048758.0,,216510867.0,,,,,,1876322.0,55550032.0,,,2741753.0,,25990143.0,,63579.0,,1184818.0,,,55796581.0,,,294708059.0,,1627893.0,,,,17836198.0,,,,,,,607676.0,,19730170.0,374930.0,,,165425.0,2527480.0,,,566.0,449097.0,548655.0,,,1113239956.0,,,7025185.0,24.0,,52812847.0,,,,,,513.0,,,118665370.0,,,13073774.0,,33599008.0,3715293.0,17667.0,,,F,38740903.0,52495358.0,32.2,,,2161.0,,,111277.0,,,,2017-12-31,1687376.0,,27102.0,10319604.0,6940.0,,,13001,,,,31663778.0,7342268.0,,,17836198.0,81.97,,15159171.0,828259859.0,,404541264.0,,,87856941.0,,,1125126.0,,,,,1040.0,55823182.0,148792808.0,5278195750.0,,79403356.0,,,,,,,,31142521.0,184919.0,,,,,2556181.0,-16101705.0,,47.0,,1252296.0,289809.0,,,,,,668611.0,,21185985.0,900564.0,,,95.0,,,33400,,91259.0,643731.0,257197457.0,87893138.0,,,,,3906585.0,1943.0,1397.0,,217850.0,,,,1133423.0,,,55823182.0,10256257.0,,,,,320118.0,7821106.0,,278860.0,,,,,,72817.0,,-2212068.0,,,,,1275750.0,3904060.0,3521494.0,2017-01-01 00:00:00,,-5504.0,,1021664000.0,,,,87814523.0,138132711.0,,-855321255.0,,,-3255231.0,,,,,147849.0,,1130427.0,,,74453854.0,36413002.0,59202778.0,1242120.0,,20615143.0,,1240.0,,9486.0,,953726.0,,,3547012.0,,,,,,30786180.0,,,,,,,24.11,16354.0,12265.0,15056.0,,,,,3288670.0,,36381389.0,232194.0,,,,107571881.0,122479110.0,,,,,,Y,,,,,,16890014.0,,26654754.0,,,,-518308738.0,10428.0,,8858.0,,78768695.0,1445885385.0,,,,,,5670527.0,796215000.0,,,534696420.0,,,,,,16413.0,,,30.0,13159752.0,,,,3143650.0,,6720438.0,,486065.0,,11657.0,,-1265487.0,,,,,7803959.0,669149.0,,34170.0,,,,,,,145117000.0,,,,,81.97,,34975889.0,,,,,,18650410.0,63754546.0,,,136033998.0,,,25181068.0,,,136569522.0,144666.0,,,10840943.0,,,699706.0,,,,,,115436051.0,45287.0,,245.0,,1223184.0,,,,,,10420623.0,,,,,04/04/2008,,,,,2857791.0,20.0,,93440.0,,,910.0,,Y,,,13692919.0,,49.49,,,,,,,,,,,48898166.0,,,196827166.0,,,,30236.0,,,1447430.0,8430027.0,,10687576.0,,76884429.0,,2017.0,-39407552.0,307124.0,6617665.0,,24513.0,,2814088.0,1617347.0,,71.14,60216705.0,1292226539.0,,,303.0,1292226539.0,55932412.0,,151273.0,,1063075.0,,28078952.0,,,,,47935325.0,,6325278.0,,,52812847.0,,45528721.0,,149520079.0,11925127.0,,,,,,145060811.0,2295531402.0,408554.0,49808109.0,,,1444112271.0,,,,,857867.0,44452057.0,,,10877614.0,,,2.0,,MANHASSET,,148792808.0,,,,46.33,,,,,Y,,10428.0,,,1349569.0,454.6,,1741.0,,,,,45528721.0,,13502179.0,,,,,,,9583172.0,,,,,,,,,10513045.0,117431000.0,25707258.0,,1773114.0,2586.0,,193170.0,26856.0,,111701802.0,,,,-1265487.0,6566624.0,,,,,12491500.0,,,266.13,,,1800.0,65189724.0,,17323637.0,,8858.0,121000.0,65402721.0,,5475.0,,4052853.0,,652193.0,,,,,85364.0,52495358.0,5476.0,,,79618.0,777801.0,,,,,14149434.0,,146741.0,,4515006.0,,1.0,,-10847915.0,256004443.0,,9490899.0,,10030,1544499.0,,,398125.0,19537705.0,17150893.0,,,,85133420.0,,,-94106.0,26816779.0,,,27888.0,,,,,,,189904.0,,,,,,24751522.0,,311762447.0,,,,-709534.0,13159752.0,,,,64992000.0,204513497.0,1291588.0,,,49216.0,,,,,,,6097659.0,,60871.0,,,,,,6763.0,105358396.0,,,,N,,3499327.0,,,10785.67,,,,,,,51.0,320118.0,NSUH PSYCHIATRIC EXEMPT UNIT,13389.0,,69251.0,55889.0,,294708059.0,245.0,,,197050.0,20529363.0,,,,,842.0,,16167200.0,,20574923.0,874626.0,,,,,7131600.0,,,,140892.0,66.17,,23847552.0,,,312.82,26816779.0,,,,,,,,,,,21597847.0,12048.0,,,,,,,,1627893.0,10.0,,682692.0,731047.0,,,12127938.0,329.0,,10877614.0,-3693749.0,,50992569.0,,1400093.0,,43612080.0,5684393.0,,,,,,188479.0,,35319165.0,,33284954.0,38740903.0,,,,,91621.0,,369538.0,13531182.0,,,,223015.0,,,,,273746.0,-3334871.0,2104479.0,,59910887.0,,17868954.0,12398.0,,,,,1666000.0,,,7898.0,,,,,,22244681.0,6171784.0,,127759.0,8509.0,19343220.0,136878.0,,,2079740.0,47240159.0,,6196276.0,,15955.0,,17410225.0,,,,16890014.0,45509044.0,,,137268783.0,,723446767.0,,3328255.0,,,,,,,,399590.0,,,15056.0,,,,,,,,,,,,,,136878.0,,,6205.0,761454,16931009.0,-156104.0,,,,1122488.0,,688.0,23020910.0,,572737.0,,,,,409700.0,,-3693749.0,144775790.0,,,,7030370.0,,,,,,32941.0,,,,4489023.0,,,,,,85093856.0,30662.0,6325278.0,,,,,,,,,,191157.0,,,3142006.0,,,,,,4545167.0,2312136.0,,,,7229191.0,,,,,,29.72,85155799.0,198340090.0,,,,,,,,1130427.0,,,,8276482.0,12048.0,,-13350796.0,59862537.0,26656642.0,,,,1.0,,Y,10275.0,,,,,,,,,,,143663414.0,,1580996.0,,378408.0,3102929.0,19176524.0,74453854.0,,82223598.0,,13979788.0,,,,,,,704274.0,,,,-855321255.0,,13979788.0,3970146.0,,,,864.0,,,897006.0,,,7244871.0,,586166.0,-463908.0,,50461805.0,,,,,,81888.0,,,4276374.0,58734771.0,4702640.0,,,7344.0,778493.0,14149434.0,,,55796581.0,,,N,,1164210.0,346372043.0,10407.0,,,23679870.0,341.45,,,,,,140541751.0,,,,,,-83191000.0,204513497.0,,,5411883.0,,,-1812000.0,,,848181.0,,89897173.0,171055666.0,223015.0,,,,,,,,,,12427687.0,780211.0,51005.0,1125126.0,,5621000.0,6418675.0,-2065755.0,33447916.0,N,,,-337078.0,33,,,1053876.0,,,,4180838.0,,49458.0,12387278.0,1289450.0,,,,828644502.0,,,11833066.0,,,2913215.0,,,11739.8,,,,,3817302.0,50136649.0,7821106.0,,,,25298.0,,9296617.0,16324.0,20754.0,,240144009.0,,,254763.0,,30.76,19964.0,,,,,,232561.0,,,,30491572.0,,,,,,,,2069355.0,76880.0,10528.0,,,,,,,,,,,,,2270117.0,,,,5411883.0,,,,,3543731.0,,4732.0,,,,5380,,46809.0,,4732.0,,,,,,,,16073527.0,,,,,,,,,,40884476.0,,,-825.0,6705074.0,6205.0,,,307176134.0,2935764.0,1283.0,,,117209.0,,10670.0,,11613179.0,,,,,1540853003.0,,,,-6477.0,116739.0,1200828000.0,15.0,,26.78,23463387.0,,64088646.0,,-688213.0,,,,,,,,7273064.0,,,85081591.0,,,26390048.0,,434476000.0,,,3918146.0,,,,,,,,49235.0,-839637.0,41568592.0,11667487.0,452089.0,2168542.0,,721072621.0,3521494.0,,5952897.0,,,,-138378.0,27043.0,21308030.0,1463442.0,7800.0,,,3521494.0,1255.0,Y,2607407.0,3560530.0,,,,,4608.0,3904060.0,4673380.0,206242.0,3904060.0,7015.0,,,14148.0,,1740665.0,18275347.0,,,,389891.0,,,8221365.0,6380948.0,,,,,N,1400093.0,49458.0,,11925127.0,1240.0,,1643108517.0,,,3627735.0,,366.0,,6325278.0,,,1320092.0,,,35319165.0,,545453000.0,,,,,332401.0,,23160.0,,,3650.0,518131.0,35780.0,355500.0,20833716.0,6117298.0,,,,Y,35004,6356529.0,,,,7084.0,1091290.0,189197147.0,,,0.203205,332763.0,,,,12144.0,1210836.0,11281568.0,,,,2052178.0,606136.0,,8723825.0,,58439634.0,,,,,207291.0,30983762.0,60216751.0,,,,,,4617.0,,66767173.0,6098298.0,,209816742.0,31663778.0,7886849.0,4345.0,14746.0,90420988.0,,63479833.0,42.24,,,33175806.0,47935325.0,149581.0,,,,15297238.0,,,28658.0,,,326081.0,,,87893138.0,,,,,,3918146.0,869952.0,,,,608312.0,,,70775270.0,,,628230.0,,9031455.0,,,1130427.0,931763989.0,2846154.0,,,,70457.0,,,12859034.0,,,,,,,,41784.0,11276631.0,4894211.0,,,207291.0,1417.0,,,,1478.0,-10131890.0,70931671.0,81068017.0,1971348.0,,,,,,,13842767.0,2289434217.0,11169262.0,,,58.54,45509044.0,6885763.0,,7106684660.0,3325.0,,,,,,,,,,,,136569522.0,,53675.0,,,,5299799.0,14885808.0,152126.0,,,,,44.51,,1764479.0,2360288.0,,,146741.0,,13090808.0,2771.0,1802531.0,,,17652697.0,45803595.0,,916750129.0,28200000.0,,400399.0,,1764479.0,45862521.0,,,,864491.0,,674566000.0,,,,,,,354769.0,327918.0,,,4622123.0,,,2660069.0,10076.0,,,869952.0,3056457.0,,,,406150.0,,,335702,,854157.0,111422487.0,19280559.0,,,-102022.0,65704443.0,,,4685036.0,,56.27,43913261.0,459577000.0,,1228320.0,,193170.0,,294708059.0,,,8.0,,,,,1444112271.0,,6240160.0,,9155394.0,,22365552.0,,46.0,3499327.0,671380.0,,2196185.0,82848000.0,27102.0,,1206203233.0,,10877614.0,72610599.0,,,,171077.0,,5355723.0,,12144.0,21309418.0,46484.0,,,137268783.0,4820125.0,,,,341.45,586847.0,,9031455.0,32264.0,,,,4872336.0,,2179800.0,,18113658.0,,,,,,,16838323.0,,3168666.0,-1685474.0,,-42271542.0,31605.0,47509740.0,,,,133012.0,,,,,111422487.0,,860709641.0,6720438.0,,,7229191.0,,,,674566000.0,611.0,49.94,,563320.0,,,979890.0,,,,,492749.0,,,,,NASSAU,,,,12265.0,,206242.0,,,,,9486.0,,,,297083.0,1834692.0,Y,2.0,,6838078.0,21597847.0,,,17150893.0,,,,,,1764479.0,,,,,,2315421.0,473013.0,,,-2106669.0,,,-1926684.0,,,,,,,,,1868596233.0,5498945.0,,,,,227634.0,,15625660.0,691064.0,,2326291.0,5380549.0,1687376.0,,,,,N,,152126.0,,13073774.0,2017,Acute Care Hospitals,NORTH SHORE UNIVERSITY HOSPITAL (330106)
51475,NORTH SHORE UNIVERSITY HOSPITAL (330106),General Short Term (Acute Care Hospitals),Voluntary Nonprofit-Other,-73.703029,40.779269,5241.0,3764.0,,,,,22858940.0,,,,118073330.0,,135940789.0,176149255.0,,43216129.0,,48364.0,7894410.0,,,,,,,,,,,1259847.0,,,,51411.0,,,,541332455.0,90226.0,,,,,,27465301.0,,,,,750172.0,,,,188354000.0,319581.0,18468470.0,,,,,247874.0,,,,,,265113.0,,,29619385.0,,,,,12118764.0,,,21091.0,,,,13698.0,,283762.0,,33251566.0,,20636821.0,,,81636.0,,1314249.0,,56494339.0,,,,,,,,,,,1356028158.0,,2396414.0,,56803254.0,,,,,10778.0,,,46460.0,,2279962.0,,,802674.0,,,,,40.0,17155.0,,2083069.0,,22605.0,319581.0,,N,,,-774461384.0,,,15000.0,2491697.0,2993467.0,,4916.0,,24926122.0,13424219.0,,,,,,3782095.0,,,,,,,,-772596934.0,92430116.0,4875.0,,,,62003.0,,,,2396414.0,,2074541.0,,,,,,7180069.0,46468450.0,,,,,28.98,5353511.0,,,,,,,,,,N,35748452.0,-9736267.0,,,,25616133.0,,475.81,1179.0,,,,49.0,,1149687000.0,,3720825.0,23213599.0,,,,1728281.0,71030.0,128324696.0,6021238.0,,,,,,1123570.0,58897863.0,,,24698726.0,,8141437.0,,71568.0,,,,,28.81,96820357.0,78876325.0,12106.0,,1309928.0,,,900204.0,,,43281488.0,330106,,219286336.0,140799.0,,11279151.0,,-256427.0,,,403689847.0,,10667.0,,124.0,,6536803.0,,75.51,,,,General Short Term,,376000.0,7894410.0,,,,,,,,,,39728.0,,,,9352.0,16900061.31,,,,,14096715.0,2244393000.0,,,,12818036.0,,144407806.0,,,,,129367080.0,,N,17401878.0,,,,,,,,20371482.0,5353511.0,,,,228.0,,,,,,,126926000.0,114785000.0,,,2008485.0,84105578.0,11908000.0,,,,,,,67954.0,12565.0,,,362049353.0,,,NY,,,,,,,83712.0,,2655989818.0,,,750172.0,1395456.0,,,392935.0,857010.0,274099985.0,105102.0,15069275.0,,1715293.0,381772.0,,,,5151841452.0,48383822.0,,,,412790.0,,26.24,,10667.0,,,,,381313.0,,22770.0,,5462796.0,,,10213268.0,33223782.0,,37562011.0,27.0,,,,3298665.0,23213599.0,,,209287.0,,,,,8134217.0,26955670.0,71422093.0,9407831.0,,,,,,445668797.0,,65546846.0,352296.0,,8860638.0,,,,,617366.0,228308.0,12174878.0,7295815.0,,,,870658.0,-3645335.0,,,37883970.0,,,,,35.36,1883392884.0,,,,6286.0,,,,3088359.0,1236554.0,,,,,,,115578293.0,59173448.0,,,,,2456828.0,,8860638.0,,,,114454710.0,3175422.0,,,-14574707.0,25.18,,1957.0,,337148,378908000.0,,,,,,,,195724.0,,,2325296.0,,15685.0,46.37,33S106,,,9407831.0,,,,,,,624219000.0,299834155.0,,,230594.0,N,22858940.0,422809.0,,,,,,62379580.0,,,,35147334.0,,,,65254724.0,385240.0,,,448515.0,,,967869.0,881425.0,,5260136.0,,,,11279151.0,485685.0,,,,49936140.0,,504094.0,,,863990.0,14075715.0,,,,,24565.0,,,45443097.0,230547.0,1880.0,,,,,,,1736.0,52.18,,1918116.0,,734302055.0,575.0,23259129.0,,,14600.0,,,,228.0,2090708.0,,,,,,,,6095222.0,,,,3254258.0,1768207.0,,7299378.0,,26971439.0,36749576.0,,256.0,,,,,1010.0,,,,,47881887.0,,,,12186.0,,,,46445451.0,,,5877068.0,174945496.0,1579251.0,,6.0,,2.0,,,,,22406542.0,,,,,17867459.0,,,,707024.0,,624219000.0,177632389.0,,13798094.0,399065.0,101738.0,,,,,,,24615277.0,,677616.0,1585.0,,143021485.0,,14700872.0,,,,292820495.0,50.74,3802997.0,,,,,,-31319.0,,,,,,465580.0,,,,,,973536.0,,4,22077228.0,,,1189523.0,,,,,,,,,,23492.0,,,611.0,118291000.0,,,53613.0,,11649748.0,581947.0,,,18615.0,,252.0,9431444.0,17400882.0,694778.0,,-69061.0,,8229574.0,,,,,215983080.0,,,,,7213637.0,56558706.0,,,9335097.0,,23987333.0,68769375.0,,9669863.0,,,,,,,294364411.0,,764.0,,2150802.0,5834573.0,1246698.0,,,,,,734302055.0,,,,4785776.0,,11245774.0,,194899138.0,,39.07,,,,13655155.31,3668156.0,,,,,6639903.0,,57325.0,,,17423.0,,94254.0,,81636.0,,,,23674926.0,,,37083.0,,845867.0,,,67315679.0,,,,11650.0,296950.0,,,,2096009.0,,,750172.0,169714351.0,,7580413688.0,593943.0,P,,,228308.0,,,,,2108000.0,80082322.0,,1190481.0,26955670.0,,2457.0,,308914.0,,2458429.0,,13424219.0,,5151841451.0,901919.0,,,31043407.0,9407831.0,,,,,124635975.0,,,,,,41144264.0,,,,,,,,712090016.0,90735.0,,,,47238550.0,,,94501014.0,,90735.0,806851.0,29711.0,,1314249.0,,,14270849.0,3303961.0,,NORTH SHORE UNIVERSITY HOSPITAL,4226242.0,,470.0,274601.0,,,30964278.0,,300 COMMUNITY DRIVE,359113.0,,,3723.0,313055837.0,,,1248793.0,24693869.0,,74272.0,,,43311.0,Y,,,,24839191.0,547740.0,,,,12678829.0,,1765320.0,1965301.0,,,6199896.0,,,,,324320699.0,239122.0,,,,49140525.0,,,,3723.0,,44095.0,58867025.0,10505389.0,,,,-334140612.0,19732364.0,64173315.0,369669.0,7500000.0,,84268097.0,,,,,,487851399.0,971637.0,1322122.0,,46468450.0,20391862.0,,,292771.0,,,,,,,,,,,,351498026.0,5445158.0,,,,149244627.0,,387322.0,,12763374.0,,7678.0,,,,433701.0,,54672058.0,65268670.0,1566999.0,,,3747946.0,,,,4916.0,38736104.0,84364155.0,4035005.0,10157717.0,24009794.0,487851399.0,2024-01-05 00:00:00,,901919.0,,209996520.0,,,,,,2083069.0,56803254.0,,,2134537.0,,26971439.0,,65549.0,,1534250.0,,,55585039.0,,,324320699.0,,2031158.0,,,,18217141.0,,,,,,,667736.0,,18691426.0,311935.0,,,204663.0,2668221.0,,,,555245.0,187154.0,,,932324433.0,,,7252504.0,39.0,,59179346.0,,,,,,569.0,,,123044840.0,,,13716730.0,,35273574.0,3930980.0,2562453.0,66594.0,,F,48055703.0,55399521.0,32.62,,,1736.0,,,713505.0,,,,2018-12-31,2008485.0,,25560.0,10244551.0,14935.0,,,13001,,,,37396747.0,8317117.0,,,18217141.0,80.22,,14700872.0,848030805.0,,445668797.0,,,85620998.0,,,694287.0,,,,,1040.0,60494497.0,154805718.0,5697020804.0,,84364155.0,,,,,,,,53858389.0,188748.0,,,,,2657481.0,-16034394.0,,47.0,,1314249.0,78878.0,,,,,,830759.0,,43281488.0,881425.0,,,75.0,,,33400,,,653641.0,316024691.0,100623625.0,,,,,4505053.0,7049.0,1010.0,,193574.0,,,,903843.0,,,60494497.0,10377037.0,,,,,316208.0,11381546.0,,278860.0,,,,,,56549.0,,-2626110.0,,,,,2301725.0,4055937.0,3332992.0,2018-01-01 00:00:00,,,,1077143000.0,,,,92430116.0,158777680.0,,-922124488.0,,,-9152.0,,,,,116270.0,,997197.0,,,83282028.0,37849722.0,58551675.0,1340865.0,,22311575.0,,1212.0,,6462.0,,1154551.0,,,3355762.0,,,,,,46211828.0,,,,,,,24.77,16803.0,33033.0,15053.0,,,,,3354595.0,,36701193.0,229318.0,,,15005.0,122928757.0,145047244.0,,,,,,Y,,,,,,18295722.0,,26519450.0,,,,-557847419.0,9832.0,,15643.0,,96820357.0,1570150113.0,,,,,,7707539.0,642541000.0,,,579454103.0,,,,,,17423.0,,,45.0,14075715.0,,,,3267565.0,,5993565.0,,457799.0,,,,-2061270.0,,,,,8379352.0,721614.0,,27714.0,,,,,,,138332000.0,,,,,80.22,,29729089.0,,,,,,20227034.0,71341682.0,,,150859342.0,,,24926122.0,,,124730204.0,149936.0,,,12029827.0,,,705754.0,,,,,,3901225.0,46532.0,,246.0,,1470512.0,,,,,,9228613.0,,,,,04/04/2008,,,,,2956975.0,20.0,,93440.0,,,2377.0,,Y,,,16366337.0,,50.18,,,,,,,,,,,56494339.0,,,150232289.0,,,,21521.0,,,1832096.0,9698294.0,,10890629.0,,84268097.0,,1585.0,-24482887.0,509499.0,7368710.0,,16427.0,,2686121.0,1800952.0,,70.6,66106090.0,1356028158.0,,,337.0,1356028158.0,37562011.0,,399065.0,,1103591.0,,27384709.0,,,,,46445451.0,,9902350.0,,,59179346.0,,44615329.0,,142852992.0,11288966.0,,,,,,149244627.0,2433107273.0,444072.0,49820134.0,,,1568721690.0,,,,,1055206.0,15981419.0,,,11034143.0,,,,,MANHASSET,,154805718.0,,4103.0,,48.07,,,,,Y,,9832.0,,,1728571.0,518.54,,14476.0,,,,,44615329.0,,14132091.0,,,,,,,9740611.0,,,,,,,,,12174878.0,122840000.0,25718657.0,,1428423.0,-6501.0,,482498.0,27724.0,,115578293.0,,,,-2061270.0,6641326.0,,,,,20010000.0,,,260.73,,,3768.0,74496616.0,,19732364.0,,15643.0,241380.0,74185738.0,,5475.0,,4332542.0,,698413.0,,,,,86348.0,55399521.0,5845.0,,,39402.0,917344.0,,,,,14270849.0,,144816.0,,3088359.0,,1.0,,-12827616.0,224520257.0,,10206136.0,,10030,1570108.0,,,235801.0,20047002.0,17867459.0,,,,100218920.0,,,-80986.0,24336397.0,,,20734.0,,,,,,,732267.0,,,,,,24154847.0,,324133459.0,,,,-61661.0,14075715.0,,,,31240000.0,213932825.0,1412063.0,,,46460.0,,,,,,,6205104.0,,34206.0,,,,,,48443.0,135362097.0,,,,N,,3518634.0,,,11054.52,,,,,,,51.0,316208.0,NSUH PSYCHIATRIC EXEMPT UNIT,13698.0,,85988.0,149713.0,,324320699.0,246.0,,,296950.0,20636821.0,,,,,1573.0,,104544.0,,22406542.0,750172.0,,,,,17156931.0,,,,147351.0,68.26,,24693869.0,,,271.78,24336397.0,,,,,,,,,,,21605185.0,13362.0,,,,,,,,2031158.0,11.0,,702962.0,913724.0,,,18468470.0,295.0,,11034143.0,-3695152.0,,53212304.0,,1236554.0,,50436882.0,5777631.0,,,,,,228309.0,,37030595.0,,37883970.0,48055703.0,,,,,90735.0,,319581.0,12837923.0,,,,223015.0,,,,,435058.0,,1999423.0,,62379580.0,,18716919.0,14991.0,,,,,2681000.0,,,86140.0,,,,,,24310974.0,6428197.0,,81365.0,3501.0,24398432.0,2292608.0,,,3818053.0,53657668.0,,6196276.0,,13946.0,,17569514.0,,,,18295722.0,51769849.0,,,145854847.0,,772424330.0,,3229862.0,,,,,,,,459687.0,,,15053.0,,,,,,,,,,,,,,2292608.0,,,4880.0,761455,20211783.0,-802674.0,,,,849336.0,,1010.0,23213599.0,,819878.0,,,,,1814261.0,,-3695152.0,212001379.0,,,,7813231.0,,,,,,33856.0,,,,4819764.0,,,,,,94444896.0,20649.0,9902350.0,,,,,,,160.0,,,324209.0,,,3007475.0,,,,,,4965460.0,2404142.0,,,,7172594.0,,,,,,30.79,85176358.0,222498516.0,,,,,,,,997197.0,1.0,,,9098955.0,19182.0,,-14551835.0,23740693.0,29619385.0,,,,1.0,,Y,19910.0,,,,,,,,,,,158414758.0,,1560315.0,,376000.0,3662543.0,15626558.0,83282028.0,,84827047.0,,15302221.0,,,,,1990.0,,690436.0,,,,-922124488.0,,15302221.0,1728281.0,,,,958.0,,937950.0,877588.0,,,5445158.0,-13368773.0,431366.0,,,54672058.0,,,,,,82276.0,,,4346936.0,58970223.0,537819.0,,,6515.0,1537623.0,14270849.0,,,55585039.0,,,N,,1183104.0,354545285.0,10778.0,,,25829664.0,335.41,,,,,,144407806.0,,,,,,-85471000.0,213932825.0,,,5576821.0,,,-3139000.0,,,880779.0,,94501014.0,177276347.0,223015.0,,,,,,,,,,2807862.0,793053.0,52188.0,694287.0,,6846000.0,6584768.0,-1600538.0,35864526.0,N,,,-31271.0,33,,,884023.0,,,,4250947.0,,48079.0,13068589.0,1485127.0,,,,848524667.0,,,12818036.0,,,2958057.0,,,12084.5,,,,,3275554.0,50979628.0,11381546.0,,,,54880.0,,9220896.0,18607.0,51200.0,,228306017.0,,,260542.0,,31.13,,,,,,,234030.0,,,,34950768.0,,,,,,,,2155556.0,95165.0,,,,,,,,,,,,1224965.0,,,,,,5576821.0,,,,,8038907.0,,19604.0,,,,5380,,60341.0,,19604.0,,,,,,,,14207321.0,,,,,,,,,,47881887.0,,,,11192798.0,4880.0,,,322069062.0,2877885.0,1423.0,,,152336.0,,9352.0,,12548284.0,,,,,1629090620.0,,,,,37060.0,1016309000.0,15.0,14957.0,27.62,22318670.0,,,,-78707.0,,,,,,,,7295815.0,,,94411863.0,,,29643227.0,,434451000.0,,,4648976.0,,,,,,,,71030.0,-420451.0,46849912.0,12091564.0,1703180.0,2053792.0,,725595910.0,3464509.0,,7507153.0,,,,,27714.0,18016743.0,1378859.0,5146.0,,,3464509.0,,Y,3053584.0,3240661.0,,,,,2187.0,4055937.0,4499894.31,129590.0,4055937.0,7531.0,,,19283.0,,2233759.0,,,,,425561.0,,,27205224.0,5877068.0,,,,,N,1236554.0,48079.0,,11288966.0,1212.0,,1733865330.0,,,3601224.0,,428.0,,9902350.0,,,1436772.0,,,37030595.0,,534265000.0,,,,,403587.0,,20035.31,,,4015.0,779612.0,20982.0,348119.0,22029211.0,4799969.0,,,,Y,35004,6547256.0,,,,5696.0,737507.0,35597104.0,,,0.20682,22308.0,,,133.0,12418.0,888323.0,11689846.0,,,,1918116.0,705709.0,,8581940.0,,63964090.0,,,,,235432.0,40907762.0,66106177.0,,,,,,4875.0,,74666551.0,6206283.0,,219286336.0,37396747.0,8920255.0,9952.0,21967.0,105061298.0,,67315679.0,41.77,,,27917720.0,46445451.0,170984.0,,,,16893734.0,,,36481.0,,,397459.0,,,100623625.0,,,,,,4648976.0,611478.0,,,,,,,78876325.0,,,271144.0,,8860638.0,,,997197.0,945632418.0,3753606.0,,,,65797.0,,,12118764.0,,,,,,,,41493.0,9611605.0,4841829.0,,,235432.0,1468.0,,,,1517.0,-2182526.0,71422123.0,84105578.0,2079285.0,,,,,,,13645803.31,2428572237.0,11274364.0,,,59.93,51769849.0,3703231.0,,7584948725.0,3854.0,,,,,,,,,,,,124730204.0,,433701.0,,,,5508845.0,12856853.0,400729.0,,,,,43.63,,1726246.0,2706518.0,,,144816.0,,11046079.0,1112.0,1771163.0,,,20391862.0,49140525.0,,932126524.0,28101000.0,,181153.0,,1726246.0,48507668.0,,,,1363371.0,,698235000.0,,,,,,,307341.0,321354.0,,,4698896.0,,,3125152.0,9589.0,,,611478.0,3007683.0,,1800.0,,399459.0,,,335702,,887981.0,113775289.0,19285213.0,,,-102023.0,71726270.0,,,4882019.0,,57.28,2505315.0,470487000.0,,1250144.0,,482498.0,,324320699.0,,,,,,,,1568721690.0,,6213213.0,,9061447.0,,23174490.0,,87.0,3518634.0,851453.0,,2249627.0,85827000.0,25560.0,,1299961660.0,,11034143.0,80082322.0,,,,171118.0,,4924610.0,,12418.0,21160347.0,24565.0,,,145854847.0,5126277.0,,,,335.41,576242.0,,8860638.0,68374.0,,,,3126503.0,,3720825.0,,20055327.0,,,,,1190481.0,,22077228.0,,2720756.0,-2675069.0,,-47873738.0,404926.0,45443097.0,,,,157752.0,,,,,113775289.0,,808194038.0,5993565.0,,,7172594.0,,,,698235000.0,611.0,53.62,,527530.0,,,1408607.0,,,,,368934.0,,,,,NASSAU,,,,33033.0,,129590.0,,,,,6462.0,,,,347384.0,2040527.0,Y,2.0,,7243046.0,21605185.0,,,17867459.0,,,,,,1726246.0,,,,,936150.0,2747934.0,381313.0,,,-1640933.0,,,1492629.0,,,,,,,,,2028287819.0,8177756.0,,,,,308048.0,,17401878.0,683437.0,,,5902195.0,2008485.0,,,,,N,,400729.0,,13716730.0,2018,Acute Care Hospitals,NORTH SHORE UNIVERSITY HOSPITAL (330106)
54973,NORTH SHORE UNIVERSITY HOSPITAL (330106),General Short Term (Acute Care Hospitals),Voluntary Nonprofit-Other,-73.703029,40.779269,46245.0,3012.0,,,,,23795651.0,,,,129775253.0,,149486336.0,169496733.0,,42121406.0,,78630.0,7930248.0,,,,,,,,,,,1329738.0,,,,54143.0,,,,505521033.0,346056.0,,,,,,27915413.0,,,,,930371.0,,,,193463000.0,251660.0,19110903.0,,,,,281657.0,,,,,,252821.0,,,30552349.0,,,,,13064544.0,,,14333.0,,,,12843.0,,284836.0,,34411527.0,,20035644.0,,,364788.0,,1404472.0,,54864985.0,,,,,,,,,,,1480961026.0,,7629670.0,,42685352.0,,,,,8534.0,,,12864.0,,3602164.0,,,-12588.0,,,,,40.0,22411.0,,2053780.0,,22942.0,251660.0,,N,,,-576671712.0,,,14000.0,2032879.0,3271658.0,,6415.0,,23218816.0,12398866.0,,,,,,6650368.0,,,,,,,,-738428093.0,108072347.0,4699.0,,,,60261.0,,,,7462718.0,,2189306.0,,,,,,7357474.0,47892402.0,,,,,32.37,3562694.0,,,,,,,,,,O,68778790.0,-6094821.0,,,,29369969.0,,474.98,,,,,51.0,,1284151000.0,,3700200.0,24421554.0,,,,3445296.0,19619.0,135996171.0,7453000.0,64088646.0,,,,,1659802.0,81393403.0,,,25424695.0,,9711967.0,,59996.0,,,,,28.75,97015553.0,86932499.0,12593.0,,1359541.0,,,953565.0,,,28984259.0,330106,,254407414.0,64955.0,,14171175.0,,-130526381.0,,,474228722.0,,5821.0,,67.0,,9380206.0,,84.5,,,,General Short Term,721587.0,379498.0,7930248.0,,,,,,,93581764.0,,,177375.0,,,,11130.0,15669679.0,,,,,10545105.0,2546248000.0,,,,13652479.0,,147630005.0,,,,,146485893.0,,N,19027175.0,,,,,,,,60595645.0,3562694.0,,,,,,,,,,,161760000.0,29312000.0,,,1936247.0,115238231.0,11908000.0,,,,,,,48554.0,,,-12588.0,375110849.0,,,NY,,,,,,,111126.0,,2828868178.0,,,930371.0,2106742.0,,,415259.0,830871.0,298663477.0,,15168677.0,,1843029.0,407526.0,,,,5646461290.0,50427475.0,,,,359793.0,,26.25,,5821.0,,,,,234851.0,,20944.0,,5488804.0,,,15117705.0,45035160.0,,91470639.0,72.0,,,,3317211.0,24421554.0,,,260018.0,,,,,8075376.0,24897461.0,65154495.0,17625530.0,,,,,,559146453.0,,66259864.0,366397.0,,7541262.0,,,,,676836.0,231588.0,11139074.0,6865713.0,,,,83706.0,-4038716.0,,,26465013.0,,,,,46.07,2090440085.0,,,,6009.0,,,,3878714.0,4081476.0,,,,,,,129353084.0,53299055.0,,,,,2759134.0,,7541262.0,,,,126584474.0,2986570.0,,,-11064137.0,27.19,,326.0,,337148,467460000.0,,,,,,,,369779.0,,,1984195.0,,20800.0,43.86,33S106,,,17625530.0,,,,,,,802127000.0,293459350.0,,,176933.0,N,23795651.0,401170.0,,,,,,67681558.0,,,,34954677.0,,675216.0,,58512562.0,283484.0,,,474394.0,,,795858.0,7149850.0,,5795964.0,,,,14171175.0,465669.0,,,,140024028.0,,532214.0,,,947221.0,15072022.0,,,,,31991.0,,,49633781.0,163031.0,3984.0,,,,,,,1861.0,50.28,,2227623.0,,755816403.0,1237.0,26498542.0,,,14600.0,,,,,2708995.0,,,,,,,,5226733.0,,,,3377229.0,490162.0,,8121203.0,,27915413.0,36918610.0,,,,,,,662.0,,,,,52781797.0,,,,13268.0,,,,52185454.0,,,8075584.0,234266908.0,2190449.0,,35.0,,2.0,,,,,22000449.0,,,,,19711083.0,,,,746414.0,,802127000.0,177291026.0,,12993905.0,295767.0,105366.0,,,,,,,21844285.0,,564487.0,1469.0,,154556901.0,,16048783.0,,,,339948194.0,56.57,3610537.0,,,,,,,,,,,,455585.0,,,,,,322591.0,,5,22511598.0,,,1375974.0,,,,,,-3993424.0,,,,,,,611.0,133108000.0,,,23354.0,,12298752.0,683937.0,,,18615.0,,274.0,20813679.0,50886614.0,660260.0,,-24582.0,,28122333.0,,,,,301923136.0,,,,,6854721.0,81347935.0,,,2530906.0,,23858668.0,71886959.0,,11023596.0,,,,,,,297213826.0,972 BRUSH HOLLOW RD,782.0,,2270781.0,7073504.0,1407997.0,,,,,,755816403.0,,,,5216816.0,,11929880.0,,171070906.0,,39.71,,,,13815384.0,3480990.0,,,,,6998370.0,,194834.0,,,18529.0,,76035.0,,364788.0,,,,24510709.0,,,35955.0,,1699368.0,,,54505823.0,,,,20096.0,400025.0,,,,2571261.0,,,94512135.0,168796894.0,,8171273716.0,543199.0,P,,,231588.0,,,,,1922000.0,60235669.0,,2844261.0,24897461.0,,2301.0,,245839.0,,2595366.0,,12398866.0,,5646461290.0,1130438.0,,,35111861.0,17625530.0,,,,,136706302.0,,,,NY,,28487816.0,,,,,,,,618097016.0,93034.0,,,,68524954.0,,,91018724.0,,93034.0,15685701.0,29252.0,,1404472.0,,,15126820.0,4067305.0,,NORTH SHORE UNIVERSITY HOSPITAL,1407328.0,,639.0,303115.0,,,41064708.0,,300 COMMUNITY DRIVE,412446.0,1377187.0,,3747.0,319578945.0,,,1219961.0,27526267.0,,75920.0,,,44148.0,Y,,,,25191793.0,575506.0,,,,12235982.0,,1616593.0,5585788.0,,,5846766.0,,,13257194.0,,340669814.0,252309.0,,,,55973046.0,,,,3747.0,,23718.0,60514435.0,11196822.0,,,,-413942556.0,16245600.0,65068982.0,390291.0,47000000.0,,72471192.0,,,,,,477473048.0,797195.0,1187924.0,,47892402.0,18277225.0,,,107986.0,,,,,,,,,,,,393907478.0,5813981.0,,,,81850687.0,,376960.0,,12794388.0,,6648.0,,,,445467.0,,57709554.0,58525788.0,1678738.0,,,4164611.0,,,,6415.0,208086587.0,87982419.0,4455658.0,10457741.0,22269982.0,477473048.0,2022-10-07 00:00:00,,1130438.0,,231049926.0,,,,,,2053780.0,42685352.0,,,1847752.0,,27915413.0,,49090.0,,1539689.0,,,61883551.0,,,340416398.0,,1959807.0,,,,19159480.0,,,,,,,769270.0,,22365119.0,406858.0,,,248690.0,3170286.0,,,,535992.0,1404274.0,,,1037313793.0,,,7596814.0,,,67234099.0,,,,,,523.0,,,130840809.0,,,13078590.0,,38829539.0,3115938.0,514408.0,69272.0,,F,49620476.0,60569605.0,34.25,,,1861.0,,,558101.0,,,,2019-12-31,1936247.0,,18952.0,9489746.0,9185.0,,,13001,,,,43192878.0,9546040.0,,,19159480.0,62.06,,16048783.0,767583352.0,,559146453.0,,,107581244.0,,,976875.0,,,,,802.0,68391772.0,145963772.0,6080833631.0,,87982419.0,,,,,,,,30799405.0,196851.0,,,,,2805624.0,-11237975.0,,65.0,,1404472.0,124430.0,,,10649.0,,,890078.0,,17012396.0,7149850.0,,,92.0,,,33400,,134589.0,620561.0,334792794.0,119510557.0,,,,,8236819.0,1552.0,1462.0,,159172.0,,,,2130412.0,,,68391772.0,11156912.0,,,,,79825.0,13312461.0,,284116.0,,,,,,19296.0,,-2735226.0,,,,,2539875.0,1867212.0,3503115.0,2019-01-01 00:00:00,,,,1273522000.0,,,,108072347.0,160560499.0,,-1147221973.0,,,-3993932.0,,,,,90355.0,,816147.0,,,84998055.0,39962072.0,59737644.0,1262585.0,,27273024.0,,1218.0,,3790.0,,918270.0,,,3524059.0,,,,,,48392208.0,,,,,,,27.44,18398.0,25211.0,16384.0,,,,,3243791.0,,39890163.0,233050.0,,,40204.0,136995892.0,31348680.0,,,,,,Y,,,,,,17073568.0,,13646161.0,,,,-709832163.0,9595.0,,15573.0,,97015553.0,1529395490.0,,,,,,5869837.0,629077000.0,,,272726749.0,,,,,,18529.0,,,35.0,15072022.0,,593239.0,,3449538.0,,4430990.0,,481726.0,,57148.0,,-2741025.0,,,,,8828982.0,936655.0,,29877.0,,,,,121.0,,145076000.0,,,,,83.59,,38731956.0,,,,,,44089521.0,71053372.0,,,169729379.0,,,23748673.0,,,137129760.0,159007.0,,,8161334.0,,,1287244.0,,,,,,85214568.0,49936.0,,310.0,,1407850.0,,,,,,7182008.0,,,,,04/04/2008,,95723004.0,,,2028671.0,20.0,,,,,1192.0,,Y,,,17145084.0,,48.99,,,,,,,,,,,54931591.0,,,161071802.0,,61.9,,20463.0,,,2017613.0,10930003.0,,11480306.0,,72471192.0,,1469.0,-49231720.0,512089.0,6809256.0,,16514.0,,1966032.0,1769687.0,,84.56,59396183.0,1495166042.0,,,298.0,1495166042.0,91470639.0,,295767.0,,1245332.0,,29501174.0,,,,,52185454.0,,11372524.0,,,67234099.0,,26991319.0,,150420242.0,11922863.0,,,,,,76382998.0,2524812426.0,460195.0,71278040.0,,,1504112150.0,,,,,1614487.0,15194187.0,,,13570523.0,,,,,MANHASSET,,145963772.0,,,,47.67,,,,,Y,,9595.0,,,2553541.0,533.84,,2603.0,,,,,26991319.0,,15353879.0,-753890.0,,,,,,9247819.0,,,,,,,,,11139074.0,131041000.0,25318646.0,,2137137.0,12762.0,,161839.0,35697.0,,129353084.0,,,,-2741025.0,8393974.0,,228.0,,,20475075.0,,,221.04,,,1337.0,68738073.0,,16245600.0,,15573.0,988397.0,65635029.0,,5475.0,,4905023.0,,756594.0,,,,,87264.0,60569605.0,5490.0,,,41621.0,773193.0,,,,,15126820.0,,147829.0,,3878714.0,,1.0,,-14108493.0,231671034.0,,13055233.0,,10030,1491853.0,,487570.0,468087.0,18341528.0,19711083.0,,,,81894676.0,,,-2305.0,35400362.0,,,15000.0,,,,,,,96816.0,,,,,,55044884.0,,294946175.0,,,,-30009.0,15072022.0,,,,28828000.0,225085579.0,1491357.0,,,12864.0,,17181.0,,,,,6719287.0,,63487.0,,,,,,41800.0,148916324.0,,,,N,,4233001.0,,,11938.51,,03/11/2019,,,,,51.0,79825.0,NSUH PSYCHIATRIC EXEMPT UNIT,12843.0,,342467.0,157227.0,,340669814.0,310.0,,,400025.0,20035644.0,,,,93581764.0,411.0,,,,22000449.0,94512135.0,,,,,4629148.0,,,,155065.0,70.0,,27526267.0,,,217.24,35400362.0,,,,,,,,,,,19940657.0,14698.0,,,,,,,,1959807.0,,,702922.0,921145.0,,,19110903.0,433.0,,13570523.0,-3522689.0,,37813780.0,,4081476.0,,52105086.0,5484756.0,,,,,,4604187.0,,47502742.0,,26465013.0,49620476.0,,,,,93034.0,,251660.0,19688046.0,,,,223015.0,,,,,354472.0,,1328054.0,,67681558.0,,20646595.0,15333.0,,,,,2765000.0,4948525.0,,7300.0,,,,,,17146370.0,7251041.0,,122005.0,583.0,24650830.0,2428240.0,,,3695205.0,50134150.0,,7421241.0,,13226.0,,18444031.0,,,,17073568.0,54986180.0,,,169378698.0,,831193101.0,,3415821.0,,,,,,,,484776.0,,,16384.0,,,,,,,,,69.27,,,,,2428240.0,,,5936.0,730652,23572811.0,,,,,2771478.0,,662.0,24421554.0,,-1036915.0,,,,,1201922.0,,-3522689.0,132420903.0,,,,8110738.0,,,,,,10937.0,,,,4839080.0,,,,,,74988832.0,17559.0,11372524.0,,,,,,,397.0,,,315829.0,,,2053437.0,,,,,,3964918.0,2537546.0,,,,8778191.0,,,,,,41.16,97307646.0,261990772.0,,,,,,,,816147.0,,,,11156323.0,19303.0,,-12298839.0,25052115.0,30552349.0,,,,1.0,,Y,17109.0,,,,,,,,,,,138497572.0,,2433109.0,,379498.0,3015167.0,19076692.0,84191275.0,,28923557.0,,15114724.0,,,,,10878.0,HB2348,279256.0,,,,-1147221973.0,,15071671.0,3445296.0,,,,953.0,,1620660.0,969116.0,,,5813981.0,-12817350.0,519196.0,,,57709554.0,,,,,,79399.0,,,4126625.0,59730173.0,1238438.0,,,4924.0,588580.0,15126820.0,,,63394158.0,,,N,,1049021.0,396830498.0,8534.0,,,29503324.0,347.61,,,,,,147630005.0,,,,,,-91625000.0,225085579.0,,,5238424.0,,,112440555.0,,,935512.0,,93191785.0,185339930.0,223015.0,,,,,,,,,,3346988.0,754285.0,51645.0,976875.0,,6846000.0,6827544.0,-1537912.0,39529405.0,N,,,-180204.0,33,,,883145.0,,,,4034691.0,,46441.0,12949370.0,1003141.0,,,,781788368.0,,,13652479.0,,,2751989.0,,,12988.3,,,,,4188695.0,48251546.0,13312461.0,,,,37215.0,,10089622.0,19972.0,34366.0,1381965.0,256232187.0,,,246553.0,,23.01,,25759141.0,,,,,242447.0,,,,39525201.0,,,,,,,,2351608.0,275174.0,,,,,,,,,,,,,,2189723.0,,,,5238424.0,,,,,5016321.0,,,,,593239.0,5380,,77569.0,,,,,,,,,,16579095.0,,,,,,,,,,52781797.0,,,-24697886.0,181161891.0,5936.0,,,358448509.0,1866262.0,1682.0,,,261052.0,,1522934.0,,13449879.0,,,,,1578144548.0,,,,-7968747.0,129568.0,1113628000.0,15.0,470122.0,33.66,24515232.0,,77345840.0,,-34008496.0,,,,,,,,6865713.0,,,74963621.0,,,44386490.0,,556111000.0,25759141.0,,5022494.0,,,,,,,,19619.0,-6540416.0,48609797.0,13101570.0,1000977.0,2102178.0,,644792476.0,3503115.0,,8807541.0,,,,,29877.0,25825741.0,2259529.0,7580.0,,,3503115.0,,Y,3456174.0,3694051.0,,,,,14204.0,1867212.0,4529793.0,187175.0,1867212.0,8166.0,,,,,554309.0,13257194.0,,,-2469365.0,434620.0,,,7914959.0,8075584.0,,,,,N,4081476.0,46441.0,,11922863.0,1218.0,,1681646205.0,,,3757219.0,,439.0,,11372524.0,,,24091975.0,,,47502742.0,,492003000.0,,,,,374590.0,,26763.0,,,,810193.0,23295.0,399450.0,27991137.0,6968354.0,,,,Y,35004,7940095.0,,,,4538.0,980339.0,320527142.0,,,0.184073,4759.0,,,,23034.0,1050931.0,12390075.0,,,,2227623.0,540475.0,,17559745.0,,58757604.0,,,,,218851.0,52967050.0,59396264.0,,,,,,4699.0,,72321673.0,6719287.0,,254407414.0,43192878.0,9714767.0,,6254.0,117284809.0,,54505823.0,44.26,,,31815956.0,52185454.0,9835846.0,,4699.0,,15723187.0,,,32866.0,,,536936.0,,,119510557.0,11606.0,,,,,5022494.0,620759.0,,,,,,WESTBURY,86932499.0,,,262843.0,,7541262.0,,,816147.0,993712025.0,4652449.0,,,,62985.0,95723004.0,,13064544.0,,,,,,,,40994.0,9339605.0,5030832.0,,2141489.0,,1185.0,,,,1236.0,-1708712.0,69773192.0,115238231.0,1278316.0,,,,,,,12292450.0,2524812426.0,13011437.0,,,64.79,55038694.0,8288860.0,,8171273716.0,17471.0,,,,,,,,,,,,137129760.0,,445467.0,,,,5816249.0,15291615.0,298244.0,,,,,46.32,,1653054.0,2801723.0,,,147829.0,,12701002.0,180.0,2099376.0,,,18277225.0,56008067.0,,967016565.0,28057000.0,,617641.0,,1653054.0,43453366.0,,,,3139645.0,,806062000.0,,,,,,,245428.0,87405.0,,,4460935.0,,,3516170.0,10423.0,,,620759.0,3273901.0,,6702.0,,403154.0,,,335702,,938274.0,117847003.0,18475559.0,,,-102023.0,65442549.0,,,5073333.0,,60.42,31906062.0,459970000.0,,1186797.0,,161839.0,,340669814.0,,,,,,,,1527258353.0,,6815721.0,,12931381.0,,27873878.0,,81.0,4233001.0,883702.0,,2582509.0,107772000.0,18952.0,,1333702136.0,,13570523.0,60235669.0,,,,122112.0,,5155341.0,,23034.0,7889173.0,31991.0,,,169378698.0,5255296.0,,,,347.61,551285.0,,7541262.0,101226.0,,,,779357.0,,3700200.0,,15240731.0,,11590,,,2844261.0,,22511598.0,,3051186.0,-3611434.0,,-62660968.0,403239.0,49633781.0,,,,158262.0,,,,,117847003.0,,1058955235.0,4430990.0,,,8778191.0,,,,806062000.0,611.0,55.48,,598690.0,,,1550874.0,,,,,271254.0,,,,,NASSAU,-4761175.0,,,25211.0,,187175.0,,,,,3790.0,,,,330195.0,2252309.0,Y,2.0,,4932012.0,20009441.0,,,19711083.0,,,,,,1653054.0,,,NORTHWELL HEALTHCARE INC,,963937.0,2331947.0,234851.0,,,-171882383.0,,,2346620.0,,,,,1060900.0,,,,2198595598.0,8918413.0,,,,,460930.0,,19027175.0,624970.0,,,6617450.0,1936247.0,,,,,N,,298244.0,,13078590.0,2019,Acute Care Hospitals,NORTH SHORE UNIVERSITY HOSPITAL (330106)
61410,NORTH SHORE UNIVERSITY HOSPITAL (330106),General Short Term (Acute Care Hospitals),Voluntary Nonprofit-Other,-73.703029,40.779269,48179.0,3071.0,,,,,24019275.0,,,,126057498.0,,147510953.0,206623437.0,,31110999.0,,61308.0,7317684.0,,,,,,,,,,,1316032.0,,,,51354.0,,,,552604379.0,292280.0,,,,,,28836001.0,,,,,572035.0,,,,186681000.0,146812.0,13684265.0,,,,,239632.0,,,,,,149007.0,,,24406991.0,,,,,13151288.0,,,11248.0,,,,9690.0,,255945.0,,31205204.0,,18597980.0,,305202000.0,2686722.0,,1529785.0,,56396341.0,,,,,,,,,,,1598429282.0,,8829099.0,,49267117.0,,,,,12485.0,,,19296.0,,2725539.0,,,,,,,,40.0,23790.0,,1839762.0,,10298.0,146812.0,,N,,,-177028103.0,,,14000.0,1968373.0,3071944.0,,5385.0,,29830894.0,9119111.0,,,,,,5409556.0,,,,,,,,-1078492515.0,77144921.0,4889.0,,-7659196.0,,94450.0,,,,8673444.0,,2207406.0,,,,,,7814144.0,37408904.0,,,,,32.9,3418374.0,,,,,,,,,,P,74764926.0,-4791573.0,,,,27176551.0,,,14074.0,,,,51.0,,1542080000.0,,2430600.0,25744742.0,,,,4305199.0,56913.0,118061404.0,9658842.0,,,,,,1597464.0,68084619.0,,,27238634.0,,9469375.0,,15880.0,,,,,30.19,90932611.0,70759480.0,12593.0,,818563.0,,,9996984.0,,,108397764.0,330106,,267644590.0,30137.75,,9988024.0,,-179932446.0,,,518768757.0,,5047.0,,46.0,,6779276.0,,81.36,,,,General Short Term,3186598.0,258500.0,7317684.0,,,,,,,73955058.0,,,175890.0,,,,6323.0,16537393.0,,,,,4550265.0,2904046000.0,,,,15140869.0,,123650453.0,,,,,143928853.0,,N,13070885.0,,,,,,,,60681154.0,3418374.0,,,,300.0,,,,,,,56373000.0,,,,1847555.0,85502120.0,11908000.0,115338000.0,,,,,,111100.0,2371.0,,1.0,311910795.0,,35000000.0,NY,,,,,,,694665.0,,2926572332.0,,,572035.0,2765216.0,,,418624.0,527039.0,256151797.0,17647.0,16424704.0,,1787970.0,431354.0,,,,5160314337.0,45455101.0,,,,134750.0,,27.52,,5047.0,,,,,190012.0,,12233.0,,5627674.0,,,9114589.0,47761824.0,,75697093.0,32.0,,,,3388523.0,25744742.0,,,105250.0,,,,,7839336.0,22224321.0,54973973.0,13901266.0,,,,,,579483976.0,,53134105.0,645585.0,,5877683.0,,,,,666028.0,202537.0,8792194.0,4482309.0,,,,71282.0,-4121737.0,,,27837042.0,,,,,39.18,1848079817.0,,,,4637.0,,,,2289792.0,4238609.0,,,,,,,105450439.0,45611953.0,,,,,2777824.0,,5877683.0,,,,125565779.0,2751013.0,,,-6505092.0,27.89,,503.0,,337148,752888357.0,,,,,,,,209972.37,,,1265822.0,,15923.0,45.07,33S106,,,13901266.0,,,,,,,839294000.0,248954738.0,,,184768.0,N,24019275.0,236027.0,,,,,,58187267.0,,,,83974100.0,,1809486.0,,51566279.0,230307.0,,,477693.0,,,456149.0,7563749.0,,7372107.0,,,,9988024.0,497894.4,,,,198894841.0,,536763.0,,,805435.0,16381304.0,,,,,56502.0,,,44061527.0,115468.0,1236.0,,,,,,,1554.0,56.77,,2354338.0,,778056844.0,438.0,25803164.0,,,14640.0,,,,300.0,3080434.0,,,,,,,,5963009.0,,,,3175373.97,2981731.0,,7807319.0,,26514147.0,28906750.0,,,,,,,566.0,,,,,38276362.0,,-79499.0,,7666.0,,,,55502321.0,,,8376735.0,191333713.0,1477604.0,,40.0,,2.0,,,,,23482134.0,,,,,21453455.0,,,,752495.0,,534092000.0,141935106.0,,11931675.0,328406.0,85551.0,,,,,,,34822388.0,,331460.0,697.0,,156828416.0,,14131885.0,,,,282182035.0,54.66,2125436.0,,,,,,-316020.0,,,,,,326482.0,,,,,,200696.0,,5,17706244.0,,,1481242.0,,,,,,-8305903.0,,,,1102.0,447.0,,611.0,163427000.0,,,16884.0,,9913423.0,769709.0,,,18666.0,,46.0,10922663.0,45449345.0,388610.0,,-20272.0,,11888541.0,,,,,301049053.0,,,,,6189263.0,73078146.0,,,4061362.0,,22360599.0,48723671.0,,10364656.0,,,,,,,286036383.0,972 BRUSH HOLLOW RD,782.0,,2289589.0,4817871.0,977679.0,,,,,,778056844.0,,,,5050741.0,,12543431.0,,177953682.0,,40.86,,,,14564642.03,2049145.0,,,,,6390744.0,,3120981.0,,,18378.0,,91235.09,,2686722.0,,,,25599082.0,,-15832029.0,28537.0,,2290424.0,,,35963878.0,,,,27089.0,337800.0,,,,3717712.0,,,74527093.0,170772586.0,,7351405373.0,313591.0,P,,,202537.0,,,,,4316000.0,60686579.0,,2955995.0,22224321.0,,2301.0,,141765.0,,2617041.0,,9119111.0,,5160934027.0,1341670.0,,,32914981.0,13901266.0,,,,,169153234.0,,,,NY,,80701778.0,,,,,,,,758551044.0,73990.0,,,,54090364.0,,,71743290.0,,73990.0,19470153.0,16689.0,,1529785.0,,,15038055.0,2829886.0,,NORTH SHORE UNIVERSITY HOSPITAL,1389065.0,,303.0,205097.0,,,26996588.0,,300 COMMUNITY DRIVE,328684.0,1389420.0,,3601.0,300615664.0,,,999141.0,28200005.0,,72592.0,,,40988.72,Y,,,,25919894.0,516259.97,,,,9597814.0,,2402099.0,8749020.0,,,3664032.0,,,,,324424732.0,254256.0,,,,54839138.0,,,,3601.0,,20211.0,39809621.0,11218040.0,,,,-402857544.0,15630078.0,60884230.0,394225.0,,,55681494.0,,,,,,396039487.0,457886.0,343850.0,,37408904.0,12336355.0,,,5550.0,,,,,,,,,,,,335893482.0,10210673.0,,,,158077637.0,,417892.58,,8898360.0,,50053.0,,,,63389.0,,59932175.0,51574962.0,1169321.0,,,5140891.0,,,,5385.0,159961000.0,69033557.0,4610110.0,12933933.0,12457778.0,396039487.0,2023-05-24 00:00:00,,1341670.0,,227370626.0,,,,,,1839762.0,49267117.0,,,1180167.0,,26514147.0,,21322.0,,3993922.0,,,79494718.0,,,324284897.0,,1295928.0,,,,18691696.0,,,,,,,770060.0,,14579281.0,476887.0,,,174542.0,2181486.0,,,,373190.0,386940.0,,,1102346910.0,,,6641617.0,1.0,,51319645.0,,,,,,211.0,,,127664002.0,,,15020137.0,,38824898.0,2778369.0,1458446.0,22539.0,,F,52039761.0,40444783.0,41.56,,,1554.0,,,138265.0,,,,2020-12-31,1847555.0,,20386.0,12258038.0,2542.0,,,13001,,,,35390381.0,7276423.0,,,18691696.0,61.97,,14131885.0,906061997.0,,579483976.0,,,82203389.0,,,886457.0,,,,,802.0,52937644.0,149720854.0,5503325556.0,,69033557.0,,,,,,,,43058990.0,312774.0,,,,,2828921.0,-18393805.0,,65.0,,1529785.0,99051.0,,,64683.0,,,588205.0,,101398757.0,7563749.0,,,35.0,,,33400,,75924.0,365961.0,82219467.0,122576604.0,,,,,12832318.0,2177.0,782.0,,91230.0,,,,1921170.0,,,52937644.0,8969013.0,,,,,78900.0,12050453.0,,286212.0,,,,,,19296.0,,-2928925.0,,,,,2272200.0,909822.0,3574994.0,2020-01-01 00:00:00,,,,1595710000.0,,,,77144921.0,123242113.0,,-1145438136.0,,,-6277789.0,,,,,22141.0,,478272.0,,,97608951.0,40297032.0,47171020.0,263550.0,,30251449.0,,1287.0,,3081.0,,,,,3587227.0,,,,,,55037994.0,,,,,,,26.04,17978.0,32728.0,12034.0,,,,,2943799.0,,32688687.0,203319.0,,,64683.0,141949070.0,14452188.0,,,,,,Y,,,,,,15896434.0,,24785256.0,,,,-724984528.0,9254.0,,12533.0,,90932611.0,1636832254.0,,,,,,3387800.0,846405000.0,,,137890161.0,,,,,,18378.0,,,41.0,16381304.0,,2898752.0,,3478686.0,,4926746.0,,553375.0,,52578.0,,-3359570.0,,,,,9228035.0,680615.0,,28241.0,,,,,1062.0,,162060000.0,,,,,90.47,,10611159.0,,,,,,48500716.0,52558714.0,,,139767652.0,,,30130306.0,510.53,,169568777.0,160515.0,,,8629232.0,,,706901.0,,,,,,88157682.0,50081.0,,289.0,,1065280.0,,,,,,9217571.0,,,,,04/04/2008,,73955058.0,,,3763302.0,20.0,,,,,531.0,,Y,,,18767531.0,,54.79,,,,,,,,,,,56481104.0,,,172864273.0,,61.82,,9616.0,,,2684141.0,10331940.0,,11448347.0,,55681494.0,,697.0,-66423444.0,376070.0,6399960.0,,29006.0,,2366421.0,1441122.0,,70.42,52098461.0,1598429281.0,,,247.0,1598429281.0,75697093.0,,328406.0,79844000.0,927821.0,,44800766.0,,,,,55502321.0,,8914050.0,,,51319645.0,,18789734.0,,162130235.0,10943131.0,,,,,,155760328.0,2190471346.0,459121.0,58275634.0,,,1623466213.0,,,,,1203551.0,32731713.0,,,14870550.0,,,,,MANHASSET,,149720854.0,,,,66.21,,,,,Y,,9254.0,,,2457637.0,487.1,,3413.0,,,,,18789734.0,,16209635.0,-2013844.0,,,,,,5446505.0,,,,,,,,,8792194.0,147823000.0,24138460.0,,1247790.0,12398.0,,242645.0,35374.0,,105450439.0,,,,-3359570.0,10903953.0,,2184.0,,,15296400.0,,,223.31,,,1290.0,82906281.0,,15630078.0,,12533.0,339833.0,67934362.0,,5490.0,,3552964.0,,750852.0,,,,,,40444783.0,1141.0,,,19611.0,670610.0,,,,,15038055.0,,86248.0,,2289792.0,,1.0,,-18382732.0,185051564.0,,11065474.0,,10030,877354.0,,106960.0,258289.0,9373227.0,21453455.0,,,,82016257.0,,,-144.0,26519752.0,,,11475.0,,,,,,,173752.0,,,,,,67896340.0,,319951196.0,,,,,16381304.0,,,,66305000.0,247800471.0,1088643.0,,,19296.0,,1241.0,,,,,8087397.0,,27697.0,,,,,,8352.0,121249972.0,,,,N,,3064625.0,,,12776.0,,02/21/2019,,,,,51.0,78900.0,NSUH PSYCHIATRIC EXEMPT UNIT,9690.0,,225600.0,140581.0,,324424732.0,289.0,,,337800.0,18597980.0,,,,73955058.0,319.0,,,,23482134.0,74527093.0,,,,,58341179.0,,,,156663.0,75.57,,28200005.0,,,185.7,26519752.0,,,,,,,,,,,23529009.0,13409.0,,,,,,248116000.0,,1295928.0,8.0,,705755.0,665387.0,,,13684265.0,119.0,,14884594.0,-2919557.0,,25054732.0,,4238609.0,,48952555.0,3229281.0,,,,,,4383298.0,,36700138.0,,27837042.0,52039761.0,,,,,73990.0,,146812.0,30482604.0,,,,223626.0,,,,,257982.0,,1817772.0,,58187267.0,,24399062.0,15333.0,,,,,2856000.0,6404978.0,,7320.0,,,,,,11296666.0,7531664.0,,70700.0,,27418987.0,829982.0,,,4083763.0,34785845.0,,6846241.0,,8683.0,,18426578.0,,,,15896434.0,50968509.0,,,164836719.0,,682790867.0,,17246104.0,,,,,,,,389086.0,,,12034.0,,,,,,,,,62.2,,,,,829982.0,,,1773.0,742981,7474485.0,1.0,,,,6019454.0,,566.0,25744742.0,,147975.0,,,,,783117.0,,-2919557.0,210807841.0,,,,8238643.0,,,,,,590.0,,,,5166699.0,,,,,,79151442.0,6822.0,8914050.0,,,,,,,977.0,,,303149.0,,,2448487.0,,,,,,5610857.0,2559255.0,,,,7728197.0,,,,,,35.28,99632535.0,255287899.0,,,,,,,,478272.0,,,,12194670.0,16819.0,,-6901958.0,45956070.0,24406991.0,,,,1.0,,Y,3509.0,,,,,,,,,,,142193213.0,,1813038.0,,258500.0,2793443.0,24339781.0,97266771.0,,91979702.0,,15485615.0,,,,,19845.0,HB2348,370896.0,318922000.0,,,-1145438136.0,,15485615.0,4305199.0,,,,562.0,,1882649.0,1004355.0,,,10210673.0,,437131.0,,,44100146.0,,,,,,46491.0,,,2429411.0,55343664.0,1586275.0,,,2132.0,351478.0,15038055.0,,,81088518.0,,,N,,4849858.0,316867648.0,12485.0,,,28558140.0,867.92,,,,,,123650453.0,,,,,,-93461000.0,247800471.0,,,4154737.0,,,167520044.0,,,3261627.0,,71765814.0,183271341.0,223626.0,,,,,,,,,,3955410.0,443445.0,54853.25,886457.0,,6846000.0,5871557.0,-1729919.0,43406163.0,N,,,-14445.0,33,,,688162.0,,,,2375768.0,,39927.0,14240043.0,1493892.0,,,,908383850.0,,,15140869.0,,,1656882.0,,,13263.1,,,,,4829930.0,27461266.0,12050453.0,,,,42777.0,,9552722.0,17134.0,13443.0,1189027.0,293706146.0,,,145431.0,,24.1,,16425745.0,,,,,263360.62,,,,41976170.0,,,,,,,,2425512.0,333143.0,,,,,,,,,,,,,,1289805.0,,,,4154737.0,,,,,19637076.0,,676.0,,,2898752.0,5380,,63583.0,,676.0,,,,,,,,9600678.0,,,,,,,,,,38276362.0,,,-36898861.0,283626483.0,1773.0,,,312610438.0,2310632.0,3220.0,,,187456.0,,1202623.0,,14683768.0,,,,,1703429246.0,,,,-9227241.0,75450.0,1132523000.0,15.0,290479.0,29.92,,,,,-72478456.0,,,,,,,,4482309.0,,,79118714.0,,,18397148.0,,551120000.0,16425745.0,,4768246.0,,,,,,,,56913.0,-10041974.0,60098332.0,13573089.0,734003.0,2311506.0,,766434780.0,3578095.0,,7800758.0,,,,,28241.0,29687056.0,1697516.0,3166.0,,,3578095.0,44.0,Y,3008779.0,3963302.0,,,,,11928.0,909822.0,5372855.2,137855.0,909822.0,7136.0,,,,,726019.0,,,,-4096754.0,342489.0,,,57728061.0,8376735.0,,,,,N,4238609.0,39927.0,,10943131.0,1287.0,,1781134196.0,,,3914580.0,,439.0,,8914050.0,,,24150819.0,,,36700138.0,,550640000.0,,,,,293555.0,,54986.0,,,2928.0,829456.0,83440.0,274767.0,28117466.0,6204940.0,,,,Y,35004,8557738.0,,,,3364.0,898794.0,327481044.0,,,0.220856,3416.0,,,146.0,1215.0,475745.0,13002552.0,,,,2354338.0,337585.0,,18496339.0,,51499676.0,,,,,151446.0,36050203.0,52098345.0,,,,,,4889.0,,73735955.0,8101471.0,,267644590.0,35390381.0,9321543.0,1635.0,22248.0,120495615.0,,35963878.0,46.45,,,22242300.0,55502321.0,15911308.0,,357.0,,17887671.0,,,31426.0,,,331285.0,,,122576604.0,12818.0,,,,,4768246.0,638501.0,,,,393305.0,,WESTBURY,70759480.0,,,147484.0,,5877683.0,,,478272.0,1108606463.0,4866676.0,,,,58924.08,73955058.0,,13151288.0,,,,,,,,,4521745.0,4159815.0,,3523859.0,151446.0,1185.0,,,,1236.0,-1876961.0,57585341.0,85502120.0,1207336.0,,,,,,,13362019.03,2190471346.0,11687546.0,,,61.61,50968509.0,7170551.0,,7350785683.0,10867.0,,,,,,,,,,,,169568777.0,,63389.0,,,,5867153.0,9761410.0,329888.0,,,,,47.41,,1621789.0,2659114.0,,,86248.0,,8094506.0,,172764139.0,,,12336355.0,54929622.0,,1100722727.0,27990000.0,,558743.0,,1621789.0,32368113.0,,,,4214271.0,,842821643.0,,,,,,,141402.0,82066.0,,,2626100.0,,,3024659.0,,,,638501.0,3086917.0,,10270.0,,497053.77,,,335702,,945114.0,98258103.0,22558310.0,,,-102023.0,55154185.0,,,5134601.0,,62.44,33938681.0,522672000.0,,698545.0,,242645.0,,324424732.0,,,,,,,,1635584464.0,,6465805.0,,15820390.0,,17280466.0,,-116.0,3064625.0,532066.0,,2339727.0,117279000.0,20386.0,,1328143051.0,,14884594.0,60686579.0,,,,84141.0,,4602774.0,,1215.0,12722905.0,56502.0,,,164836719.0,5502638.0,,,,357.39,577567.57,,5877683.0,296461.0,,,,2767955.0,,2430600.0,,12883432.0,,11590,,,2955995.0,,17706244.0,,3080325.0,-2511588.0,,-70660971.0,292149.0,44061527.0,,,,124346.0,,,,,98258103.0,,1405973559.0,4926746.0,,,7728197.0,,,,195939643.0,611.0,55.76,,652525.0,,,1130642.0,24507000.0,,,,170368.0,,,,,NASSAU,-14426933.0,,,32728.0,,137855.0,,,,,3081.0,,,,254530.0,2636546.0,Y,2.0,,6776692.0,23602291.0,,,21453455.0,,,,,,1621789.0,,,NORTHWELL HEALTHCARE INC,,1389311.0,2025997.0,190012.0,,,-403006897.0,,,-1285370.0,,,,,1069934.0,,,,1938968861.0,8940132.0,,,,,704149.0,,13070885.0,658429.0,,,7122843.0,1847555.0,,,,,N,,329888.0,,15020137.0,2020,Acute Care Hospitals,NORTH SHORE UNIVERSITY HOSPITAL (330106)
68956,NORTH SHORE UNIVERSITY HOSPITAL (330106),General Short Term (Acute Care Hospitals),Voluntary Nonprofit-Other,-73.703029,40.779269,,3101.0,,,,,22057310.0,,,,120394843.0,,139300274.0,201632742.0,,38063427.0,,84204.0,7659968.0,,,,,,,,,,,1042221.0,,,,62333.0,,,,573067243.0,329714.0,,,,,,29271247.0,,90.0,,,2441830.0,,,,196853000.0,269067.0,19783629.0,,,,,254983.0,,,,,,177452.0,,,26723071.0,,,,,14478323.0,,,14185.0,,,,10616.0,,278599.0,,36954739.0,,21170939.0,,,19495.0,,1574530.0,,53952849.0,,,,,,,,,,,1703915687.0,,18148498.0,,68817063.0,,,,,15027.0,,,20280.0,,4558531.0,,,,,,,,40.0,23725.0,,1999428.0,,,269067.0,,N,,,-158705175.0,,,,3153534.0,3231237.0,,5106.0,,29511065.0,10018646.0,,,,,,8786357.0,,,,,,,,-1070163233.0,126448481.0,6009.0,,-12075090.0,,36152.0,,,,18148498.0,,1541374.0,,,,,,8499144.0,43977799.0,,,,,33.87,2752835.0,,,,,,,,,,P,84589064.0,-3757931.0,,,,38767602.0,,430.12,509.0,,,,3.0,,1501787000.0,,3522600.0,26024489.0,,,,3929471.0,269665.0,113783563.0,11196661.0,,,,,,924256.0,83006362.0,,,27367368.0,,10109399.0,,105311.0,,,,,32.49,61288204.0,86086615.0,10340.0,,389019.0,,,309955.0,,,57433125.0,330106,,261958577.0,10939.0,,10452417.0,,-190995904.0,,,632891579.0,,3767.0,,129.0,,6287641.0,,87.86,,,,General Short Term,1603381.0,350921.0,7659968.0,,,,,,,74177791.0,,,145568.83,,,,13324.5,15753791.77,,,,,2186090.0,3115969000.0,,,,15584051.0,-192194214.0,142951596.0,,,,,160219315.0,,N,16005395.0,,,,4973.0,,,,64550783.0,2752835.0,,,,300.0,,,,,,,55045000.0,26365000.0,408587.0,,1918196.0,96346004.0,11908000.0,110351000.0,,,,,,72123.0,,,,382490835.0,,,NY,,,,,,,30715.0,,3221849478.0,,,2441830.0,2855529.0,,,292269.0,704904.0,318913044.0,,16254664.0,,2056374.0,437156.0,,,,6076516108.0,54625022.0,,,,68937.0,,28.23,,3767.0,,,,,2223806.0,,29470.0,,4866596.0,,,12164094.0,56135013.0,,169939596.0,,,,,3769054.0,26085285.0,,,,,,,,11952215.0,27505955.0,70663129.0,16914990.0,,,,,,719041136.0,,57830975.0,1098697.0,,,,,,,814616.0,224315.0,8361383.0,4007856.0,,,,462428.0,-4347597.0,,,41374257.0,,,,,40.17,2151686245.0,,,,3535.0,,,,3031860.0,3615910.0,,,,,,,120450821.0,59415292.0,,,,,2950176.0,,,,,,132873308.0,2680183.0,,,-1136736.0,28.59,,1177.0,,337148,831047000.0,,,,,,,408587.0,390621.55,,,3063261.0,,,46.47,33S106,,,16914990.0,,,,,,,950600000.0,336421147.0,,,209601.0,N,22057310.0,280621.0,,,,,,65553645.0,,,,91898194.0,,3507000.0,,67973366.0,306092.0,,,334022.0,,,887171.0,10961657.0,,6242643.0,,,,10452417.0,499898.09,,,,200175847.0,,374905.0,,,815438.0,16931049.0,,,12412.0,,17739.0,,,48006417.0,62866.0,,,,,,,,2537.0,56.55,,2285136.0,,793587688.0,,25167244.0,,,14600.0,,,,300.0,3149856.0,,,,,,,,8567010.0,,,,2968486.62,2081550.0,,9981362.0,,312509.0,21711860.0,,,,,,,548.0,,,,,46490355.0,,-35563.0,,,,,,46839791.0,,,8327389.0,246284975.0,1826111.0,,,,2.0,,,,,21975320.0,,,,,18905431.0,,,,525389.0,,950600000.0,179854904.0,,9892117.0,347568.0,95588.0,,,,,,,33849808.0,,677684.0,,,209126666.0,,12195637.0,,,,339521436.0,66.99,2528347.0,,,,,,-72649.0,,,,,,728667.0,,,,,,,,5,13741945.0,,,1524530.0,,,,,,-10400008.0,,,,4099.0,44879.0,,611.0,151120000.0,,,38784.0,,11433301.0,877660.0,,,18615.0,,329.0,10998344.0,61412775.0,462200.0,,-5778.0,,17479286.0,,,,,304336872.0,,,,,6350116.0,36593993.0,,,6661223.0,,15862531.0,51862130.0,,9015719.0,,,,,,,275093147.0,972 BRUSH HOLLOW RD,782.0,,1598784.0,8138609.0,1630653.0,,,,,,793587688.0,,,,4421555.0,,12369308.0,,259461101.0,,45.01,,,,14016830.63,2437557.0,,,,,7825993.0,-2958457.0,4859545.0,,,16953.0,,87823.74,,19495.0,,,,25902667.0,,,23114.0,,2280471.0,,,48062169.0,,,,,717600.0,,,,4164290.0,,,76619621.0,174311311.0,,8776000847.0,895140.0,P,,,224315.0,,,,,3724000.0,42011540.0,,4373091.0,27505955.0,,1868.0,,265300.0,,1826684.0,,10018646.0,,6076916110.0,2251643.0,,,36987247.0,16914990.0,,,,,245077510.0,,,,NY,,47199690.0,,,,,,,,723028643.0,83166.0,,,,72175423.0,,,91701818.0,,83166.0,16636542.0,20634.0,,1574530.0,,,16319842.0,5378546.0,,NORTH SHORE UNIVERSITY HOSPITAL,1250686.0,,290.0,274736.0,,,26204564.0,,300 COMMUNITY DRIVE,406866.0,969012.0,,3605.0,297570526.0,,,779011.0,29029139.0,,73189.0,,,41274.1,Y,,,,26601147.0,505805.62,,,,11491316.0,,2454334.41,10841210.0,,,3460983.0,,,,,307991700.0,177449.0,8919.0,,,50137223.0,,,,3605.0,,215418.0,46481568.0,12475474.0,,,,-426270632.0,16046847.0,44365998.0,274872.0,203000000.0,,74854720.0,,,,,,502205446.0,932050.0,,,43977799.0,16994000.0,,,,,,,,,,,,,,,373155147.0,5063444.0,,,,161755149.0,,410185.69,,13129726.0,,50434.0,,,,179395.0,,62185092.0,67982302.0,1878247.0,,,5004331.0,,,,5106.0,150721568.0,93143688.0,4053870.0,12732317.0,12305763.0,502205446.0,2024-02-29 00:00:00,,2251643.0,,286778320.0,,,,,,1999428.0,68817063.0,,,658135.0,,312509.0,,10386.0,,4956118.0,,,74880272.0,,,307765072.0,,634068.0,,,,18661273.0,,,,,,,726817.0,,22477379.0,414219.0,,,356418.0,3456090.0,,,,139624.0,1221440.0,,,1297566201.0,,,6136916.0,,,62394664.0,,,,,,851.0,,,129577086.0,,,12030363.0,,38773844.0,2678407.0,2574416.0,22755.0,,F,58382187.0,45685062.0,37.38,,,2537.0,,,199923.0,,,,2021-12-31,1918196.0,,14701.0,9592400.0,128125.0,,,13001,,,,42117149.0,12544916.0,,,18661273.0,62.22,,12195637.0,862328917.0,,719041136.0,,,61696251.0,,,937753.0,,,,,782.0,60431463.0,152302778.0,6624314602.0,,93143688.0,,,,,,,-19264004.0,41652710.0,94063.0,,,,,1974559.0,-11827000.0,,65.0,,1574530.0,111106.0,,,29101.0,,,1080115.0,,31781408.0,10961657.0,,,,,,33400,,,434689.0,84883268.0,154481458.0,,,,,17441626.0,1577.0,800.0,,177434.0,,,,17270354.0,,,60431463.0,10174267.0,,,,,,13381942.0,,285430.0,,,,,,20280.0,,-2678625.0,,,,,3952200.0,355451.0,3528030.0,2021-01-01 00:00:00,,-171.0,,1661324000.0,,,,126448481.0,113469624.0,,-1484089382.0,,,-9859746.0,,,,,,,946751.0,,,105150999.0,32640233.0,52891286.0,155275.0,,33852566.0,,1307.0,,4869.0,,193.0,,,3557500.0,,,,,,56023081.0,,,,,,,26.8,13048.0,41281.0,13207.0,,,,,2522594.0,,35440727.0,225115.0,,,53763.0,132854283.0,17755532.0,,,,,,Y,,,,,,16199020.0,,25856036.0,,,,-854576751.0,8083.0,,14727.0,,61288204.0,1593396031.0,,,,,,5069258.0,787024000.0,,,115746902.0,,,,,,16953.0,,,,16931049.0,,2875638.0,,2427750.0,,5976136.0,,563945.0,,,,-3324449.0,,,,,10080259.0,978199.0,,29820.0,,,,,,,185453000.0,,,,,183.26,,,,,,,,53496476.0,67774527.0,,,173063558.0,,,29863789.0,,,245618328.0,112211.0,,,12173713.0,,,1098385.0,,,,,,92483804.0,34794.0,,293.0,,822815.0,,,,,,9185933.0,,,,,04/04/2008,,74177791.0,,,3033134.0,,,,,,,,Y,,,19144582.0,,54.74,,,,,,,,,,,54054862.0,,,188379843.0,,60.89,,,,,2864258.0,10182258.0,,12471783.0,,74854720.0,,,-292815523.0,829982.0,6056894.0,,7964.0,,,1281005.0,,99.85,68226442.0,1703915688.0,,,308.0,1703915688.0,169939596.0,,347568.0,,933934.0,,45953826.0,,,,,46839791.0,,5380562.0,,,62394664.0,,19062707.0,,153792795.0,13126032.0,,,,,,158794980.0,2699794692.0,538692.0,65442304.0,,,1578736920.0,,,-1990466.0,,1703816.0,31549544.0,,,14097883.0,,,,,MANHASSET,,152302778.0,,2310.0,,43.3,,,,,Y,,8083.0,,,1421932.0,274.15,,11212.0,,,,,19062707.0,-44710.0,18330391.0,-1726528.0,,,,,,6473556.0,,,,,,,,,8361383.0,177233000.0,67664538.0,,1094520.0,-1296.0,,257040.0,55793.0,,120450821.0,,,,-3324449.0,9883210.0,,,,,21764400.0,,,219.46,,,,102567938.0,,16046847.0,,14727.0,261560.0,78962968.0,,5475.0,,5319242.0,,870621.0,,,,,71522.0,45685062.0,674.0,,,,610576.0,,,,,16319842.0,,95588.0,,3031860.0,,1.0,,-19246473.0,227736416.0,,9211900.0,,10030,1044078.0,,-280848.0,235833.0,10013173.0,18905431.0,,,,117588504.0,,,-2832143.0,20310010.0,,,9977.0,,,,8919.0,,,1012231.0,,,,,,68589126.0,,214274356.0,,,,,16931049.0,,,,3817000.0,238913395.0,1429061.0,,,20280.0,,,,,,,6895012.0,,,,,,,,17888.0,140687011.0,,,,N,,3482280.0,,,12555.43,,02/21/2019,,,,,51.0,,NSUH PSYCHIATRIC EXEMPT UNIT,10616.0,40907328.0,214458.0,143877.0,,307991700.0,293.0,,,717600.0,21170939.0,,,,74177791.0,,,8919.0,,21975320.0,76619621.0,,,,,31337159.0,,,,108731.0,75.74,,29029139.0,,,219.19,20310010.0,,,,,,,,,,,18400890.0,12941.0,,,,,,131344000.0,,634068.0,9.0,,650288.0,1074382.0,,,19783629.0,,,14097883.0,-2822891.0,,6919757.0,,3615910.0,,34473881.0,3839289.0,,,,,,15065726.0,,80763419.0,,41374257.0,58382187.0,,,,,83166.0,,269067.0,31341835.0,,,,223015.0,,,,,500952.0,,3005821.0,,65553645.0,,20146295.0,12302.0,,,,,3356000.0,10891138.0,,,,,,,,24158671.0,8234480.0,,,,27335762.0,3822734.0,,,3885708.0,24876040.0,,6846241.0,,8936.0,,20088896.0,,,,16199020.0,55883936.0,,,202452606.0,,820546263.0,,17178848.0,,,,,,,,518108.0,,,13207.0,,,,,,,,,60.89,,,,,3822734.0,,,,764967,5964892.0,,,,,6790056.0,,548.0,26085285.0,,1660154.0,,,,,3541368.0,,,251678178.0,,,,8819981.0,,,,,,,,,,5689825.0,,,,,,104386212.0,,5380562.0,,,,,,,1162.0,,,402835.0,,,,,,,,,4951330.0,1785801.0,,,,11313871.0,,495902.0,,,,36.23,111885229.0,279570093.0,,,,,,,,946751.0,,,,16794865.0,18296.0,,43032690.0,55209649.0,26723071.0,,,,1.0,,Y,2100.0,,,,,,,,,,,213629351.0,,2746791.0,,350921.0,2807887.0,21375139.0,104686178.0,,88104177.0,,15737457.0,,,,,27006.0,HB2348,-119249.0,122723000.0,,,-1484089382.0,,15737457.0,3929471.0,,,,723.0,,3014939.0,1110311.0,,,5063444.0,,250946.0,-336.0,,62185092.0,,,,,,55024.0,,,2888752.0,104619277.0,1600474.0,,,,1849198.0,16319842.0,,,75218524.0,,,N,,4815185.0,368255017.0,15027.0,,,29179806.0,364.38,,,,,,142951596.0,,,,,,-113237000.0,238913395.0,,,3705740.0,,,-8906754.0,,,1313513.0,,91728385.0,169179064.0,223015.0,,,,,,,,,,4046036.0,528229.0,55071.0,937753.0,,6846000.0,5410099.0,-2067964.0,45957227.0,N,,,-90468.0,33,,,763876.0,,,,2824100.0,,47744.0,14120102.0,1343215.0,,,,891287656.0,,,15584051.0,,,2241398.0,,,13285.64,,,,,6941321.0,36132040.0,13381942.0,,,,41860.0,,12192434.0,19283.0,,1218200.98,368064744.0,,-309783.0,171950.0,,24.84,,20292347.0,,,,,266646.2,,,,45441899.0,09/14/2021,,,,,,,2513020.0,382680.0,,,,,,,,-14757.0,,,,,,1532414.0,,,,3705740.0,,,,,10443813.0,,3952.0,,,2875638.0,5380,,119546.0,,3952.0,,,,,,,,14083787.0,,,,,,,,,,46490355.0,,,-36080182.0,305181656.0,,,,349090207.0,,1358.0,,,361127.0,,1231525.48,,15258874.0,,,,,1650484779.0,,,,-12818217.0,,1249378000.0,15.0,500036.0,31.24,,,,,-62778045.0,,,,,,,,4007856.0,,,104344931.0,,,16963236.0,,658787000.0,20292347.0,,4788712.0,,,,,,,,269665.0,-19242973.0,71013831.0,14954529.0,2338512.0,2786610.0,,758433373.0,3709666.0,,9403478.0,,,,,29820.0,106293150.0,3710252.0,,,,3709666.0,4264.0,Y,2853314.0,4450828.0,,,,,,355451.0,5494651.97,,355451.0,,,,,,1236510.0,,,,-5868848.0,246901.0,,,2016027.0,8327389.0,,,,,N,3615910.0,47744.0,,13126032.0,1307.0,,1734742891.0,,,4202526.0,,94.0,,5380562.0,,,11209068.0,,,80763419.0,,698686000.0,,,,,753026.0,,23100.75,,,3285.0,683432.0,5465.0,330456.0,29806708.0,6165613.0,,,-30750.0,Y,35004,8942529.0,,,,5226.0,765304.0,141814814.0,,495902.0,0.179886,4898.0,,,98.0,151035.0,,12908000.0,,,,2285136.0,969500.0,,21282457.0,,66847136.0,,,,,108027.0,47826040.0,68226228.0,,,,,,6009.0,,89814327.0,6880764.0,,261958577.0,42117149.0,10809663.0,,93208.0,113948852.0,,48062169.0,46.93,,,31898165.0,46839791.0,13342451.0,,,,20096451.0,,,24542.0,,,682672.0,,,154481458.0,8525.0,,,,,4788712.0,682870.0,,,,,,WESTBURY,86086615.0,,,110565.0,,,,,946751.0,1097011571.0,5700944.0,,,,49045.57,74177791.0,,14478323.0,,,,,,,,,,5823269.0,,31235757.0,108250.0,396.0,,,,399.0,-22705481.0,56623756.0,96346004.0,3040128.0,,,,,,,12785305.15,2699084737.0,11941926.0,,,63.45,55883936.0,8527737.0,,8776310800.0,27597.0,,,,,,,,,,,,245618328.0,,179395.0,,,,4093512.0,14338770.0,348950.0,,,,,48.89,,1384546.0,2462681.0,,,95588.0,,11784622.0,,188408281.0,,,16994000.0,50203991.0,,1061606841.0,28034000.0,,596967.0,,1384546.0,52251273.0,,,,3904195.0,,830277000.0,,,,,,710640.0,261036.0,,,-101081.0,3122604.0,,,,11146.0,,,682870.0,4580085.0,,3183.0,,451267.78,-40907328.0,,335702,,660216.0,119089611.0,25332505.0,,,-102023.0,70814975.0,,,8023022.0,,65.78,36202238.0,663582000.0,,830860.0,,257040.0,,307991700.0,,,,,,,,1592301511.0,,7657059.0,,15359246.0,,19010212.0,,-214.0,3482280.0,252862.0,,3034335.0,119970000.0,14701.0,,1514916585.0,,14097883.0,42011540.0,,,,86862.47,,5769619.0,,151035.0,13097566.0,17739.0,,,202452606.0,5743284.0,,,,364.38,608875.26,,,292048.0,,,,3291802.0,,3522600.0,,14959560.0,,11590,,,4373091.0,,13741945.0,,2479340.0,-1998678.0,,-83707474.0,630779.0,48006417.0,,,,93432.0,,,,,119089611.0,,1211978047.0,5976136.0,,,11313871.0,,,,576210000.0,611.0,57.23,,738323.0,,,2266611.0,,,,,195732.0,,,,,NASSAU,-3013284.0,,,41281.0,,,,,,,4869.0,,,,273879.0,3375862.0,Y,2.0,,6836929.0,18423227.0,,,18905431.0,,,,,,1384546.0,,,NORTHWELL HEALTHCARE INC,,1935313.0,2035127.0,2223806.0,,,-492082797.0,,,1383250.0,,,,,965807.0,,,,2329593187.0,9544596.0,,,,,679997.0,,16005395.0,752928.0,,,8183496.0,1918196.0,,,,,N,,348950.0,,12030363.0,2021,Acute Care Hospitals,NORTH SHORE UNIVERSITY HOSPITAL (330106)
75528,NORTH SHORE UNIVERSITY HOSPITAL (330106),General Short Term (Acute Care Hospitals),Voluntary Nonprofit-Other,-73.703029,40.779269,9.0,3012.0,,,,,24908172.0,,,,152615772.0,,175682654.0,220381573.0,,38936020.0,,33364.0,8566191.0,,,,,,,,,,,1304411.0,,,,64183.0,,,,596179103.0,1317852.0,,,,,,31773298.0,,,,,4659707.0,,,,212762000.0,,17475361.0,,,,,309009.0,,,,,,171049.0,,,35231547.0,,,,,13305507.0,,,16444.0,,,,9983.0,,286177.0,,38060932.0,,25839781.0,,,50638.0,,1614058.0,,63939225.0,,,,,,,,,,,1804105885.0,,,,69964322.0,,,,,15179.0,,,10223.0,,4326798.0,,,1329616.0,,,,,40.0,23725.0,,2335730.0,,48.0,,,N,,,-182785316.0,,,,3660798.0,3030456.0,,5251.0,,34242765.0,10895577.0,,,,,,15597168.0,,,,,,,,-1198449851.0,137192828.0,6436.0,,-15575002.0,,96683.0,,,,,,2328536.0,,,,,,8829794.0,45294096.0,,,,,35.7,3114995.0,,,,,,,,,,P,91282770.0,-770029.0,,,,42735236.0,,,,,,,8.0,,1292499000.0,,3378600.0,30228789.0,,,,7191469.0,225520.0,131620361.0,11699107.0,,,,,,1203011.0,79355957.0,,,31666798.0,,12074986.0,,410840.0,,,,,32.91,104754768.0,84777507.0,11826.0,,495960.0,,,520588.0,,,48065790.0,330106,,395055557.0,11164.0,,15521496.0,,-183089468.0,,,699855483.0,,,,311.0,,8291967.0,,258.48,,,,General Short Term,1301318.0,367785.0,8566191.0,,,2271732.0,,,,120473376.0,,,146248.0,,,,26546.0,22831280.0,,,,,3872673.0,3394457000.0,,,,16371446.0,-45363233.0,159241005.0,,,,,182768448.0,,N,18846600.0,,,,,,,,71131063.0,3114995.0,,,,,,,,,,,210709000.0,68171000.0,3369437.0,,2142566.0,94421484.0,,,,,,,,78223.0,,,7408365.0,408765629.0,,,NY,,,,,,,,,3470115072.0,,,4659707.0,3356180.0,,,442014.0,800429.0,316241779.0,,17831064.0,,2172787.0,539125.0,,,,6534499687.0,22183863.0,,,,102008.0,,28.95,,,,,,,2033343.0,,21880.0,,5070291.0,,,14086688.0,58269648.0,,60538598.0,,,,,3958196.0,30291827.0,,,597.0,,,,,14397430.0,27653242.0,74133988.0,23372695.0,,,,,,319882692.0,,64377663.0,1407311.0,,,,,,,952392.0,232035.0,11757025.0,4709972.0,,,,,-4633043.0,,,47601120.0,,,,,45.32,2271665221.0,,,,3813.0,,,,3035657.0,3733101.0,,,,,,,118908838.0,62332345.0,,,,,3245858.0,,,,,,140588070.0,2681818.0,,,-702743.0,29.0,,24719.0,,337148,765005000.0,,,,,,,6089963.0,328830.0,,,2347421.0,,,48.1,33S106,,,23372695.0,,,,,,,1249297000.0,359917820.0,,,261435.0,N,24908172.0,270078.0,,,,,,73844817.0,,,773815.0,94012637.0,,3927840.0,,70705144.0,238383.0,,,504431.0,,,,,,6797786.0,,,,15521496.0,513952.0,,,,197977175.0,,565574.0,,,1054515.0,18348737.0,,,183816.0,,33155.0,,,53095040.0,58462.0,,,,,,,,1662.0,53.54,,2930180.0,,835323240.0,,29691911.0,,,14600.0,,,,,3864482.0,,,,,,,,8385371.0,,,,1596061.0,3145052.0,,10066739.0,,382284.0,29848086.0,,256.0,,,,,870.0,,,,,8263435.0,,-46878.0,,,,,,63273434.0,,,10354837.0,266454998.0,2277359.0,,,,2.0,,,,,25235100.0,,,,,23066882.0,,,,793588.0,,1249297000.0,233525939.0,,15905090.0,355067.0,98397.0,,,,,,,26949805.0,,,,,198477521.0,,14717013.0,,,,348184981.0,82.35,2457713.0,,,,,,153851.0,,,,,,568732.0,,,,,,,,5,27703685.0,,,1759766.0,,,,,,-12206421.0,,,,1169.0,,,611.0,192880000.0,,,31509.0,,17274226.0,1211261.0,,,18615.0,,297.0,9867170.0,27154818.0,446272.0,,-20.0,,20848724.0,,,,,333189092.0,,,,,8004187.0,36303358.0,,,10889251.0,,34212434.0,75968231.0,,10221166.0,,,,,,,308650128.0,972 BRUSH HOLLOW RD,782.0,,2434262.0,7508276.0,1704396.0,,,,,,835323240.0,,,,4469759.0,,13068721.0,,343326995.0,,41.29,,,,23301194.0,2350968.0,,,,,9487315.0,-3121023.0,411337.0,,,17686.0,,84535.0,,50638.0,,,,26980718.0,,,26207.0,,3156248.0,,,53493886.0,,,,,727800.0,,,,5611336.0,,,125133083.0,194094015.0,,9405217283.0,560390.0,P,,,232035.0,,,,,3736000.0,46561041.0,,5780078.0,27653242.0,,1944.0,,,,2760360.0,,10895577.0,,6534535646.0,2523934.0,,,42902413.0,23372695.0,,,,,256930139.0,,,,NY,,102574650.0,,,,,,,,1137021172.0,85565.0,,,,80722032.0,,,122362261.0,,85565.0,21790470.0,,,1614058.0,,,15854537.0,4975628.0,,NORTH SHORE UNIVERSITY HOSPITAL,1337190.0,,197.0,326661.0,,,29609537.0,,300 COMMUNITY DRIVE,538123.0,1464889.0,,3770.0,331732989.0,,17763.0,773815.0,35660259.0,,105408.0,,,44548.0,Y,,,,31447817.0,586559.0,1116528.0,,,12044708.0,,1708106.0,11331675.0,,,3999140.0,,,,,358052036.0,267501.0,,,,60219053.0,,,,3770.0,,218727.0,60021571.0,11815989.0,,,,-397151948.0,15996691.0,68966927.0,415264.0,203000000.0,,75458773.0,,,,,,531836081.0,,894947.0,,45294096.0,18762291.0,,,,,,,,,,,,,,,406651973.0,6764480.0,,,,172926769.0,,518587.0,,23287156.0,,66210.0,,,,,18470.0,58589728.0,70717716.0,1944992.0,,,4902454.0,,,,5251.0,-122323910.0,99856179.0,4190382.0,14948388.0,13640287.0,531836081.0,2024-05-01 00:00:00,,2523934.0,,282128897.0,,,,,,2335730.0,69964322.0,,,727586.0,,382284.0,,14698.0,,5123181.0,,,76808510.0,,,357818987.0,,811346.0,,,,19808142.0,,,,,,,799340.0,,23082861.0,484636.0,,,304643.0,3697508.0,,,,199484.0,502441.0,,,1425414721.0,,,6782084.0,,,61771714.0,,,,,,717.0,,,139109574.0,,,13276138.0,,44309865.0,3025851.0,4546703.0,39198.0,,F,61766413.0,62397022.0,39.33,,,1662.0,,,46269.0,,,,2022-12-31,2142566.0,,,8393155.0,,,,13001,,,,52509893.0,13962193.0,,,19808142.0,60.57,,14717013.0,1312703826.0,,319882692.0,,,64631297.0,,,1063476.0,,,,,1038.0,76145357.0,163091360.0,7133552062.0,,99856179.0,,,,,,,-15111274.0,,197586.0,,,,,2983278.0,2158901.0,,65.0,,1614058.0,141656.0,,,19295.0,,,948974.0,,38219873.0,,,,,,,33400,,,419265.0,68400301.0,26348508.0,,,,,19607537.0,14.0,731.0,,,,,,,,,76145357.0,9673896.0,,,,,,16864507.0,,285430.0,,,,,,52803.0,,-330320.0,,,,,3811800.0,367432.0,3831092.0,2022-01-01 00:00:00,,,,2127266000.0,,,,137192828.0,142312762.0,,-1378192451.0,,,-8884086.0,,,,,3164.0,,,,,119729593.0,49311977.0,52352933.0,309012.0,,35917830.0,,1145.0,,804.0,,62349.0,,,3852972.0,,,,,,59681223.0,,,,,,,27.43,,27362.0,14890.0,,,,,3039448.0,,36501922.0,232766.0,,,60268.0,164311289.0,12553094.0,,,,,,Y,,,,,,15804123.0,,27567894.0,,,,-928868379.0,7524.0,,15537.0,,104754768.0,1858935933.0,,,,,,4746256.0,469432000.0,,,114699011.0,,,,,,17686.0,,,,18348737.0,,1921593.0,,3667317.0,,4503998.0,,585193.0,,,,-3730783.0,,,,,12891953.0,867977.0,,31214.0,,,,,,,196483000.0,,,,,175.53,,,,,,,,58025914.0,73724813.0,,,169795255.0,,,34585720.0,,,257260123.0,169418.0,,12712.0,14612306.0,,,1195423.0,,,,,,111243977.0,52226.0,,296.0,,1089669.0,,,,,,8560143.0,,,,,04/04/2008,,120473376.0,,,3382792.0,,,93400.0,,,,,Y,,,20122238.0,,57.5,,,,,,,,,,,64039773.0,,,197167471.0,,59.07,,,,,4392053.0,11389102.0,,11980672.0,,75458773.0,,,-205220564.0,583530.0,6799047.0,,17446.0,,627.0,1422504.0,,150.42,71027518.0,1804105884.0,,,392.0,1804105884.0,60538598.0,,355067.0,,1023607.0,,40306193.0,,,,,63273434.0,,15946660.0,,,61771714.0,,21993241.0,,166276867.0,16432996.0,,,,,,169248662.0,2870709888.0,448928.0,109760531.0,,,1842288519.0,,,,,1248527.0,68569649.0,,,14363629.0,,,,,MANHASSET,,163091360.0,,2715.0,,71.08,,,,,Y,,7524.0,,,1850786.0,477.27,,205796.0,,,,,21993241.0,2679.0,20111760.0,-1998611.0,,,,,,6243954.0,,,,,,,,,11757025.0,187987000.0,60768658.0,,1124461.0,23320.0,,332631.0,70618.0,,118908838.0,644176.0,,,-3730783.0,10179988.0,,,,,20260650.0,,,216.98,,,,114250129.0,,15996691.0,,15537.0,17522.0,79372611.0,,5475.0,,6188581.0,,865422.0,,,1116528.0,,80877.0,62397022.0,1059.0,,,,645116.0,,,,,15854537.0,,137694.0,,3035657.0,,1.0,,-21511003.0,227986690.0,,10485176.0,,10030,1007006.0,,1401213.0,231375.0,10853868.0,23066882.0,,,,137230766.0,,,-9160.0,21185678.0,,,34799.0,,,,,,,339139.0,,,,,,61772432.0,,395226229.0,,,,,18348737.0,,,,5565000.0,391940562.0,1640299.0,,,10223.0,,,,,,,7083932.0,,,,,,,,,164557455.0,,,,N,,3264554.0,,,13718.7,,02/21/2019,,,,,51.0,,NSUH PSYCHIATRIC EXEMPT UNIT,9983.0,34338487.0,221970.0,148883.0,,358052036.0,296.0,,,727800.0,25839781.0,,,,120473376.0,,,,,25235100.0,125133083.0,,,,,68362216.0,,,,164322.0,71.12,,35660259.0,,,221.47,21185678.0,,,869557.0,,,,,,,,17706992.0,14124.0,,,,,,744055000.0,,811346.0,9.0,,769450.0,962905.0,,,17475361.0,,,14363629.0,-1462576.0,,18918202.0,,3733101.0,,53061837.0,3702645.0,,,,,,,,74795806.0,,47601120.0,61766413.0,,,,,85565.0,,,38077943.0,,,,223015.0,,,,,398909.0,,2900933.0,,73844817.0,,24987468.0,14034.0,,,,,3454000.0,12325151.0,,,,,,,,23992411.0,8914636.0,,,,31426991.0,3810318.0,,,4259782.0,35119440.0,,6846241.0,,12572.0,,19812733.0,,,,15804123.0,88820528.0,,,221349899.0,,887168905.0,,15194081.0,,,,,,,,498178.0,,,14890.0,767843.0,,,,,,,,59.07,,,,,3810318.0,,,,770669,15171338.0,6078749.0,,,,8455342.0,,870.0,30291827.0,,562038.0,,,,,1758473.0,,-1462576.0,278107902.0,,,,8911921.0,,,,,,,,,,5978141.0,,,,,,108499596.0,613.0,15946660.0,,3937.0,,,,,806.0,,,386467.0,,,663.0,,,,,,5525358.0,2697943.0,,,,12195290.0,,8384002.0,,,,34.74,95219920.0,340747202.0,,,,,,,,,,,,16956428.0,19130.0,,36735522.0,110276702.0,35231547.0,,,,1.0,,Y,3937.0,,,,,,,,,,,217972752.0,,2819331.0,,367785.0,2790197.0,26429455.0,119031485.0,,94817520.0,,20061223.0,,,,,10918.0,HB2348,,,,,-1378192451.0,,19909103.0,7191469.0,,,,1081.0,,3782550.0,1275130.0,,,6764480.0,,279801.0,-40073.0,,58589728.0,,,,,,52730.0,102008.0,,2786951.0,98829590.0,2954792.0,,,,830392.0,15854537.0,,,77175666.0,,,N,101714.0,3782647.0,381514075.0,15179.0,,,32968976.0,373.31,,,,,,159241005.0,,,,,,-120639000.0,391940562.0,,,3862267.0,,,-4367000.0,,,1766735.0,,122419292.0,219148976.0,223015.0,,,,,,,,,,3808662.0,509291.0,55657.0,1063476.0,,9514000.0,5982744.0,-1832228.0,57180547.0,N,,,-66520.0,33,,,924778.0,,,,2723933.0,,48306.0,15023812.0,1478082.0,,,,1344094839.0,,,16371446.0,,,2312531.0,,,14195.97,,,,,7577955.0,36076004.0,16864507.0,,,,58122.0,,13508666.0,17113.0,,2039429.0,394852967.0,,-73700.0,165905.0,,25.53,,,,,,,270626.0,,,,50099852.0,09/14/2021,,,,,,,2706733.0,444436.0,,,,,,,,,,,,2667655.0,,1479000.0,,,,3862267.0,,,,,31772032.0,,1482.0,,,1921593.0,5380,,163795.0,,1482.0,,,,,,,,17080705.0,,,,,,,,,,8263435.0,,,-36444914.0,337830977.0,,,,368610930.0,,1106.0,,,356319.0,,2065975.0,,15862456.0,,,,,1990992558.0,,,,-10382914.0,,1051068000.0,15.0,546050.0,31.6,30743615.0,,,,-59999756.0,,,,,,,,4709972.0,,,108472234.0,,,25038508.0,,727432000.0,,,5490620.0,,,,,,,,225520.0,-17866282.0,78704784.0,16515229.0,2059062.0,2780082.0,,1179783550.0,3831092.0,,11509227.0,,,,,31214.0,29874545.0,4190844.0,36.0,,,3831092.0,,Y,2711769.0,4866786.0,,,,,2.0,367432.0,4795030.0,663.0,367432.0,8870.0,,,,,451948.0,,,,-3256937.0,307512.0,,,13251789.0,10354837.0,,,,,N,3733101.0,48306.0,,16432996.0,1145.0,,2090091548.0,,,4639480.0,,264.0,,15946660.0,,,1716928.0,,,74795806.0,,894815000.0,,,,,452683.0,,30544.0,,,3285.0,644176.0,241086.0,426823.0,31099019.0,7763285.0,,,-66261.0,Y,35004,10658011.0,,,,4695.0,730673.0,-126690910.0,,8384002.0,0.19588,8894.0,,,,,3770.0,13517649.0,,,,2930180.0,1807985.0,,20921490.0,,68169320.0,,,,,125484.0,65288093.0,71027518.0,,,,,,6436.0,,92570219.0,7083932.0,,395055557.0,52509893.0,14313564.0,,83094.0,141244407.0,,53493886.0,110.07,,,35494187.0,63273434.0,1871372.0,,,,18896394.0,,,23694.0,,,542638.0,,,26348508.0,4839.0,,,,,5490620.0,776484.0,,,,,,WESTBURY,84777507.0,,,215703.0,,,,,,1699972190.0,6014882.0,,,,49709.0,120473376.0,,13305507.0,,,,,,,,39297.0,,7415800.0,,31658515.0,125484.0,610.0,,,,618.0,1682266.0,53839312.0,94421484.0,4641130.0,,,,,,,21235219.0,2870681637.0,14664555.0,,,58.29,88820528.0,9501619.0,,9405209575.0,73921.0,,,,,,,,,,,,257260123.0,,,,,,6184378.0,15574585.0,356337.0,,,,,151.18,,1439256.0,1009502.0,,,137694.0,,13047807.0,,201950716.0,,,18762291.0,60245345.0,,1657209812.0,28136000.0,,666406.0,,1439256.0,67159655.0,,,,4625366.0,,1362261000.0,,,,,,5685120.0,,36.0,,-96676.0,3012017.0,,,,13044.0,,,776484.0,4862315.0,23694.0,21647.0,,454616.0,-34338487.0,,335702,,997398.0,124072041.0,20884939.0,,,,74377053.0,,,13118891.0,,66.87,44817135.0,852661000.0,,801232.0,,332631.0,,358052036.0,,,,,,,,1857811472.0,,8643672.0,,16941409.0,,19527227.0,,,3264554.0,322374.0,,3823858.0,122711000.0,,,1664178115.0,,14363629.0,46561041.0,,,,101359.0,,7314528.0,,,14454262.0,33155.0,,,221349899.0,6115973.0,,,,373.31,577908.0,,,624447.0,,,,3175350.0,,3378600.0,,16775572.0,,11590,,,5780078.0,,27703685.0,,2576324.0,-1190537.0,,-91303277.0,365025.0,53095040.0,,,,105914.0,,,,,124072041.0,,1071758941.0,4503998.0,,,12195290.0,,,,618206000.0,611.0,58.61,,966505.0,,,1827596.0,,,,,251167.0,,,,,NASSAU,-2266311.0,,,27362.0,,663.0,,,,,804.0,,,,327822.0,3596531.0,Y,2.0,,7995224.0,17728662.0,,,23066882.0,,,,,,1439256.0,,,NORTHWELL HEALTHCARE INC,,2539532.0,2033031.0,2033343.0,,,-501193569.0,,,,,,,,1388516.0,,,,2512101350.0,13309295.0,,,,,1537990.0,,18846600.0,819055.0,,,1237536.0,2142566.0,,,,,N,,356337.0,,13276138.0,2022,Acute Care Hospitals,NORTH SHORE UNIVERSITY HOSPITAL (330106)
78979,NORTH SHORE UNIVERSITY HOSPITAL (330106),General Short Term (Acute Care Hospitals),Voluntary Nonprofit-Other,-73.703029,40.779269,,3852.0,,,,,25443181.0,,,,164684791.0,,190384067.0,215763687.0,,44975524.0,,62200.0,10009230.0,,,,8430.0,,,,,,,1309727.0,,,,65789.0,,,,594650111.0,421899.0,,,,,,33075733.0,,,,,336015.0,,,,230863000.0,183179.0,21492522.0,,,,,389177.0,,,,,,185285.0,,,41777177.0,,,,,13538766.0,,,14873.0,,,,9791.0,,259598.0,,38644837.0,,26786351.0,,,60866.0,,1684234.0,,64857214.0,,,,,,,,,,,1909413529.0,,329074.0,,85434797.0,,,,,16256.0,,,11500.0,,3677315.0,,,-1811650.0,,,,,40.0,23725.0,,1917684.0,,,183179.0,,N,,,-187795925.0,,,,3064801.0,3000475.0,,4718.0,,33183637.0,12069359.0,,,,,,8224468.0,,,,,,,,-1239369431.0,126343569.0,7192.0,,-15681031.0,,118345.0,,,,329074.0,,2338098.0,,,,,,9704737.0,52970555.0,,,,,35.96,2844193.0,,,,,,,,,,T,94959629.0,-14463654.0,,,,49683733.0,,276.19,171.0,,,,4.0,,1254016000.0,,3069600.0,32158428.0,,,,5778921.0,667707.0,143083232.0,12123176.0,,,,,,,92788809.0,,,33488443.0,,11160688.0,,107383.0,,,,,35.48,106699591.0,91375189.0,12081.0,,520701.0,,,431358.0,,,81216373.0,330106,,425272961.0,11243.0,3880.0,20923831.0,,-186794694.0,,,718765995.0,,,,,,8085104.0,,238.61,,,,General Short Term,3922858.0,343580.0,10009230.0,,,2594548.0,,,,147208054.0,,,147784.0,,,,3241.0,25480232.0,,,,,7411500.0,3477266000.0,,,,17389923.0,-12961374.0,172112606.0,,,,,199052922.0,,N,18248820.0,,,,,,,,80237523.0,2844193.0,,,,,,,,,,,244678000.0,239955000.0,6363036.0,,2325410.0,92890648.0,,,,,,,,66057.0,,,-6978012.0,440060165.0,,,NY,,,,,,,6287.0,,3639224076.0,,,336015.0,3454232.0,,,442650.0,905708.0,283552275.0,,20272607.0,,2477703.0,631959.0,,,,7118000681.0,88331690.0,,,,114283.0,,31.3,,,,,,,718149.0,,35572.0,,5299307.0,,,7120513.0,41362143.0,,90154623.0,,,,,4384293.0,32226185.0,,,,,,,,22779316.0,28048810.0,89590123.0,36382768.0,,,,,,292492885.0,,72082497.0,1860549.0,,,,,,,788165.0,207906.0,,5919178.0,,,,16531.0,-5260499.0,,,68005657.0,,,,,48.55,2399854645.0,,,,3455.0,,,,2944000.0,3882231.0,,,,,,,122021467.0,75831274.0,,,,,3497595.0,,,,,,142520200.0,2457675.0,,,-5071863.0,30.05,,8506.0,,337148,712442000.0,,,,,,,10827856.0,541153.0,,,2724594.0,,,52.87,33S106,,,36382768.0,,,,,,,1230900000.0,403695542.0,,,218392.0,N,25443181.0,292338.0,,,,,,75633270.0,,,,104057223.0,,4488960.0,,84999087.0,221461.0,,,505705.0,,,637223.0,1411234.0,,6744507.0,,,,20923831.0,531322.0,,,,211494111.0,,568761.0,,,913241.0,19107852.0,,,301364.0,,18315.0,,,40683574.0,60114.0,,,,,,,,1563.0,56.1,1052.0,2930597.0,,831953398.0,,28087193.0,,,14600.0,,,,,5012676.0,,,,1731123.0,,,,9184268.0,,,,3646188.0,3157820.0,,9358478.0,,412512.0,39558105.0,,256.0,,,,,668.0,,,,,53451558.0,,-84257.0,,,,,,64727960.0,,,10234591.0,312814838.0,1710459.0,,,,2.0,,,,,27158002.0,,,,,25699276.0,,,,795760.0,,1230900000.0,253404046.0,,14254530.0,300594.0,95384.0,,,,,,,30233811.0,,454286.0,,,222807693.0,,14870951.0,,,,345473852.0,56.96,2637908.0,,,,,,-160770.0,,,,,,660444.0,,,,,,,,1,,,,1867836.0,,,,,,-9808682.0,,,,88329.0,,,611.0,173082000.0,,,19314.0,,17342789.0,1499341.0,,,18615.0,,47.0,10151702.0,40591521.0,481741.0,,,,32660499.0,,,,,391128748.0,,,,,7193178.0,38515619.0,,,17555758.0,,,,,4798535.0,,,,,,,334021482.0,972 BRUSH HOLLOW RD,782.0,,2423853.0,7944506.0,2472085.0,,,,,,831953398.0,,,,3990837.0,,13910919.0,,312076413.0,,43.85,,,,24450441.0,2544579.0,,,,,11331505.0,-3241591.0,494150.0,,,14600.0,,86126.0,,60866.0,,,,30189349.0,,,29703.0,,3093029.0,,,73805685.0,,,,,572400.0,,,,4110567.0,,,147544069.0,210722579.0,,10359792062.0,659754.0,P,,1052.0,207906.0,,,,,3603000.0,36600673.0,,6058566.0,28048810.0,,1988.0,,183179.0,,2770659.0,,12069359.0,,7118000681.0,2468051.0,,,45491477.0,36382768.0,,,,,252600557.0,,,,NY,,,,,,,,,,1224900815.0,82473.0,,,,94688344.0,,,121373057.0,,82473.0,,20587.0,,1684234.0,,,16978301.0,5277885.0,,NORTH SHORE UNIVERSITY HOSPITAL,1417076.0,,284.0,265858.0,,,31838731.0,,300 COMMUNITY DRIVE,,1470454.0,,3730.0,356981330.0,,15736.0,883389.0,33244701.0,,,,,43987.0,,,,,32654192.0,625707.0,3469928.0,,,14247200.0,,3902505.0,11724287.0,,,5274575.0,,,,,361962770.0,268616.0,,,,62527255.0,,,,3730.0,,67696.0,,14207455.0,,,,-380923812.0,16948811.0,72527289.0,417427.0,118842000.0,,78949705.0,,,,,,620618497.0,637465.0,1706742.0,,52970555.0,22740310.0,,,,,,,,,,,,,,,402545458.0,8098002.0,,,,192850928.0,,503020.0,,25408849.0,,,,,,83035.0,32877.0,64350149.0,85015542.0,1742791.0,,,5298179.0,,,,4718.0,174834739.0,103394254.0,4728132.0,14791602.0,16060677.0,620618497.0,2024-06-18 00:00:00,,2468051.0,,266218701.0,,,,,,1917684.0,85434797.0,,,671412.0,,412512.0,,19764.0,,5704934.0,,,71550037.0,,,361962770.0,,768717.0,,,,22872560.0,,,,,,,1042892.0,,22959848.0,477624.0,,,308239.0,3434278.0,,,,188388.0,908000.0,,,,,,7374557.0,,,62945900.0,,,,,,1.0,,,157118395.0,,,13246609.0,,43965746.0,3363064.0,90021.0,,,F,65161944.0,52318646.0,41.07,,,1563.0,,,83035.0,,,,2023-12-31,2325410.0,,,9782091.0,6554.0,,,13001,,,,60524710.0,18736076.0,,,22872560.0,56.39,,14870951.0,1415284882.0,,292492885.0,,,77441963.0,,,952997.0,,,,,1038.0,93045119.0,174802197.0,7959937417.0,,103394254.0,,,,,,,-13333789.0,382091.0,283226.0,,,,,2995136.0,-14957279.0,,65.0,,1684234.0,147004.0,,,20004.0,,,916025.0,,72414258.0,1411234.0,,,,,,33400,,,454291.0,72657815.0,39135418.0,,,,,21625719.0,481.0,729.0,,127445.0,,,,145776.0,,,93045119.0,10547484.0,,,,,,20671906.0,,285430.0,,,,,,25308.0,,-427585.0,,,,,3327000.0,398889.0,4181330.0,2023-01-01 00:00:00,,,,2074654000.0,,,,126343569.0,180998391.0,,-1474851650.0,,,-7718240.0,,,,,,,637465.0,,,108552962.0,49506138.0,56587113.0,235500.0,,38747197.0,,1001.0,,2513.0,,217419.0,,,4216902.0,,,,,,54462724.0,,,,,,,28.78,18917.0,25905.0,13379.0,,,,,2698818.0,,35065187.0,208635.0,,,20002.0,179224625.0,29481450.0,,,,,,Y,,,,,,14669139.0,,27828874.0,,,,-1055041476.0,7315.0,,11748.0,,106699591.0,1977638763.0,,,,,,5376569.0,376810000.0,,,115922376.0,,,,,,14600.0,,,,19107852.0,,8754601.0,,3682441.0,,5493830.0,,546270.0,,,,-3229299.0,,,,,12723889.0,1137846.0,,33928.0,,,,,,,180563000.0,,,,,103.68,,,,,,,,61082313.0,77353111.0,,,179128481.0,,,33563839.0,,,252888981.0,170250.0,,441685.0,19542718.0,,,1294704.0,,,,,,,52967.0,,522.0,,1292625.0,,,,,,8571472.0,,,,,04/04/2008,,147208054.0,,,3368353.0,,,93400.0,,,,,Y,,,21947712.0,,55.54,,,,,,,,,,,65255461.0,,,,,56.33,,,,,3314507.0,12275599.0,,14376287.0,,78949705.0,,,-248563294.0,613495.0,6873866.0,,12370.0,,,1529290.0,,64.73,85337087.0,1909413529.0,,,312.0,1909413529.0,90154623.0,,300594.0,,1014848.0,,39149384.0,,,,,64727960.0,,,,,62945900.0,,19890771.0,,157026257.0,19151472.0,,,,,,190339807.0,3241791381.0,514887.0,143439908.0,,,1963008552.0,,,,,394422.0,31092347.0,,,15329667.0,,,,,MANHASSET,,174802197.0,,,,67.23,,,04/14/2023,,Y,,7315.0,,,,531.87,,76228.0,,,,,19890771.0,,19473784.0,-1966245.0,,,,,,6756723.0,,,,,,,,,,184181000.0,63024807.0,,1264749.0,12303.0,,478811.0,43855.0,,122021467.0,,,,-3229299.0,9778493.0,,,,,21702850.0,,,204.43,,,242.0,123093282.0,,16948811.0,,11748.0,15822.0,90427153.0,,5475.0,,6993973.0,,732477.0,,,3469928.0,,83253.0,52318646.0,629.0,,,,559982.0,,,,,16978301.0,,137000.0,,2944000.0,,2.0,,-23262372.0,271187655.0,,9697230.0,,10030,1089750.0,,550820.0,123030.0,13478449.0,25699276.0,,,,179685603.0,,3335603.0,-10849.0,24259159.0,,,19449.0,,,,,,,319747.0,,,,,,61770406.0,,316352316.0,,,,137879.0,19107852.0,,,,7073000.0,372592605.0,1406799.0,,,11500.0,,,,,,,6808205.0,,,,,,,,5198.0,189795972.0,,,,N,,3191686.0,,,14110.49,,02/21/2019,,,,,51.0,,NSUH PSYCHIATRIC EXEMPT UNIT,9791.0,39439726.0,273067.0,187214.0,,361962770.0,522.0,,,572400.0,26786351.0,,,,147208054.0,61.0,,,,27158002.0,147544069.0,,,,,,,,,165205.0,73.52,,33244701.0,,,265.87,24259159.0,,,2094737.0,,,,,,,,18443552.0,12644.0,,,,,,707051000.0,,768717.0,9.0,,754351.0,897199.0,,,21492522.0,,,15329667.0,-3160169.0,,4943581.0,,3882231.0,,58134880.0,4007644.0,,,,,,206306.0,,74024923.0,,68005657.0,65161944.0,,,,,82473.0,,183179.0,45860929.0,,,,223015.0,,,,,423664.0,,4320012.0,,75633270.0,,27172479.0,14141.0,-4677.0,,,,3225000.0,17928850.0,,,,,,,,25947366.0,9516589.0,,,,32929842.0,119236.0,,,4884901.0,48497730.0,,9513896.0,,16455.0,,21362594.0,,,,14669139.0,80341001.0,,,222607328.0,,916173048.0,,15112324.0,,,,,,,,377537.0,,,13379.0,1252666.0,,,,,,,,56.33,,,,,119236.0,,,,776039,15054991.0,-5166362.0,,,,4750031.0,,668.0,32226185.0,,,,,,,2649600.0,,-3160169.0,331616753.0,,,,9258885.0,,,,,,,,,,6334508.0,,,,,,110091208.0,,,,,,-3.0,,,961.0,,,442610.0,,,,,,,,,5693763.0,2708864.0,,,,13833192.0,,14414915.0,,,,34.72,94097537.0,358354418.0,,,,,,,,637465.0,,,,14506034.0,12644.0,,32600865.0,58012220.0,41777177.0,,,,1.0,,Y,3651.0,,,,,,,,,,,270271712.0,,2926419.0,,343580.0,3347256.0,26479506.0,107836567.0,,111716728.0,,19198415.0,,,,,11032.0,HB2348,208777.0,,,,-1474851650.0,,19028374.0,5778921.0,,,,365.0,,4114512.0,1390212.0,,,8098002.0,-26423019.0,216208.0,-157486.0,,64350149.0,,,,,,57644.0,,,3015340.0,101669644.0,3303532.0,,,,1212035.0,16978301.0,,,71604472.0,,,N,136669.0,3017984.0,419240408.0,16256.0,,,35467922.0,371.13,,,,,,172112606.0,,,,,,-130529000.0,372592605.0,,,4239594.0,,,-2363300.0,,,1633973.0,,121550214.0,246645602.0,223015.0,,,,,,,,,,3838814.0,550365.0,56040.0,952997.0,,9514000.0,6331665.0,-2208715.0,67627117.0,N,,,-42731.0,33,,,965104.0,,,,2948089.0,,48368.0,17509061.0,1487501.0,,,,1447948103.0,,,17389923.0,,,2810136.0,,,14918.55,,,,,7847494.0,41117913.0,20671906.0,,,,45092.0,,14131342.0,21931.0,,2613156.0,411682373.0,,-52629.0,179795.0,,26.27,3880.0,49836163.0,,,,,283285.0,,,,52735249.0,09/14/2021,,,,,,,2865636.0,367480.0,2621.0,,,,,,,,,,,,,1600312.0,,,,4239594.0,,,,,,,175332.0,,,8754601.0,5380,,119220.0,,175332.0,,,,,,,,16375702.0,,,,,,,,,,53451558.0,,,-37726976.0,372413195.0,,,,359409539.0,,171.0,,,128094.0,,2616397.0,,17062811.0,,,,,2060636921.0,,,,-13656268.0,,1190280000.0,15.0,481769.0,33.8,32356024.0,,,,-60320412.0,,,,,,,,5919178.0,,,110065303.0,,,25206693.0,,755984000.0,49836163.0,,5358529.0,,,,,,,,667707.0,817001.0,73819122.0,16553417.0,2395715.0,3028734.0,,1268723478.0,4181330.0,,14992238.0,,,,,33928.0,48335355.0,3163498.0,,,,4181330.0,,Y,3134208.0,4802360.0,,,,,,398889.0,7228047.0,,398889.0,9676.0,,,22082.0,,873878.0,,,,-3271877.0,322352.0,,,39737320.0,10234591.0,,,,,N,3882231.0,48368.0,,19151472.0,1001.0,,2164021160.0,,,4972261.0,,72.0,,,,,2754342.0,,,74024923.0,,1034958000.0,,,,,495958.0,,30458.0,,,3285.0,745204.0,549403.0,336720.0,33819948.0,6864177.0,,,-30410.0,Y,35004,11552889.0,,,,,586258.0,172471439.0,,14414915.0,,805183.0,,,,6976.0,,14421129.0,,,,2930597.0,2096543.0,,23990969.0,,81579963.0,,,,,129362.0,85522771.0,85337543.0,,,,,,7192.0,,101459808.0,6808376.0,,425272961.0,60524710.0,16018600.0,,261296.0,153525349.0,,73805685.0,52.21,,,31057345.0,64727960.0,1805035.0,,,,20894478.0,,,20251.0,,,709870.0,,,39135418.0,6044.0,,,,,5358529.0,952465.0,,,,546210.0,,WESTBURY,91375189.0,,,406712.0,,,,,637465.0,1841540508.0,6294766.0,,,,47662.0,147208054.0,,13538766.0,,,,,,,,41616.0,,9646963.0,,33150899.0,129362.0,838.0,,,,842.0,-1140688.0,58445997.0,92890648.0,6083610.0,,,,,,,21834044.0,3241791381.0,14849322.0,,,63.93,80341001.0,7859753.0,,10359792062.0,98931.0,,,,,,,,,,,,252888981.0,,83035.0,,,,6208445.0,15015342.0,302246.0,,,,,54.52,,1491893.0,3020481.0,,,137000.0,,12276931.0,,200511962.0,,,22740310.0,62682042.0,,1797717845.0,28151000.0,,640547.0,,1491893.0,76940939.0,,,,4079962.0,,1362212000.0,,,,,,10304280.0,183118.0,,,-76098.0,3259641.0,,,,13044.0,,,952465.0,4903213.0,,27739.0,,453537.0,-39439726.0,,335702,,1001321.0,140674293.0,19964314.0,,,,90022740.0,,,19510399.0,,63.25,,992350000.0,,866036.0,,478811.0,,361962770.0,,,,,,,,1976374014.0,,9228129.0,,16572960.0,,21662232.0,,456.0,3191686.0,338456.0,,4398485.0,134797000.0,,,1729459281.0,,15329667.0,36600673.0,,,,97301.0,,8853802.0,,6976.0,19606333.0,18315.0,,,222607328.0,6706413.0,,,,371.13,589925.0,,,413986.0,,,,3436692.0,,3069600.0,,16300912.0,,11590,,,6058566.0,,,,3043898.0,-1428576.0,,-108133024.0,446280.0,40683574.0,,,,105514.0,,,,,140674293.0,,1411840870.0,5493830.0,,,13833192.0,,,,655161000.0,611.0,60.23,,910202.0,,,2196643.0,,,,,241430.0,,,,,NASSAU,-2092879.0,,,25905.0,,,,,,,2513.0,,,,235180.0,2920367.0,Y,2.0,,9089651.0,18444514.0,,,25699276.0,,,,,,1491893.0,,,NORTHWELL HEALTHCARE INC,,2547748.0,2305834.0,718149.0,,,-527962897.0,,,-1655973.0,,,,,1060361.0,,,,2690137722.0,14191153.0,,,,,1875652.0,,18248820.0,849654.0,,,1225831.0,2325410.0,,,,,N,,302246.0,,13246609.0,2023,Acute Care Hospitals,NORTH SHORE UNIVERSITY HOSPITAL (330106)
