,Curated Name and Num,Hospital type (modified),S2_1_C1_21,Lon,Lat,D3_IRF_C2_68,S2_1_C1_126,S2_1_C2_115,D3_IRF_C2_62,C_1_C6_9930,E_B_HOS_C1_17,S10_C1_12,D_5_HOS_C4_53,B_1_C22_89,E_B_HOS_C1_4001,D_5_HOS_C6_72,A_C2_30,D_4_HOS_C11_91,D3_HOS_C2_76,A_C2_33,D3_IPF_C2_93,E_B_HOS_C1_6,B_1_C26_30,S2_1_C1_38,S2_1_C2_1402,D_1_HOS_C7_34,D_4_SNF_C11_76,D_5_HOS_C6_95,C_1_C6_63,D_5_HOS_C6_9201,S4_HHA3_C5_33,D_4_HOS_C3_69,B_1_C21_89,D_4_IPF_C11_70,D1_HOS_C1_50,D_4_SNF_C11_73,D3_SNF_C3_74,A_C6_4201,D3_SNF_C2_58,S5_C1_11,E_B_HOS_C1_40,G_C1THRU4_2,D_4_HOS_C4_50,B_1_C22_75,C_1_C5_98,D1_IRF_C1_48,A_C6_31,A8_C2_1,D_5_HOS_C7_76,S4_HHA3_C5_38,S2_1_C1_108,D_1_HOS_C7_40,S3_2_C2_29,D_4_HOS_C10_62,D_5_HOS_C4_63,S4_HHA1_C4_36,A_C2_94,D_4_IPF_C11_57,S3_1_C7_11,A_C6_8,S4_HHA1_C2_35,S3_1_C9_14,B_2_C26_9930,A7_3_C5_3,S2_1_C2_1604,B_2_C26_42,S3_1_C2_17,B_1_C26_69,S10_C1_22,D_4_HOS_C12_72,D_4_IRF_C11_68,D_5_HOS_C6_74,S3_1_C8_24,A_C1_73,A_C1_54,B_1_C21_112,C_1_C5_9920,S3_1_C2_14,B_1_C22_32,A_C6_108,D_4_HOS_C12_93,D_5_HOS_C2_55,A_C1_4501,B_1_C22_64,B_1_C26_57,D_4_IRF_C11_50,A8_C2_19,D_4_IPF_C11_200,A_C2_100,B_2_C26_45,A_C2_65,G_C1THRU4_40,S3_2_C2_22,B_1_C21_30,D_4_HOS_C11_51,D_4_IRF_C11_98,S5_C4_1,D_4_SNF_C11_59,B_1_C21_99,D_4_HOS_C4_200,S3_1_C8_5,D_4_IPF_C4_200,C_1_C6_98,D_5_HOS_C6_64,S3_2_C6_43,C_1_C6_60,B_1_C0_67,B_1_C22_65,A_C2_13,S3_2_C6_39,S3_1_C9_20,A_C2_90,S3_2_C5_30,B_1_C0_88,B_1_C22_112,S3_1_C6_8,S2_1_C2_130,A_C2_16,D_4_HOS_C11_66,D3_IPF_C2_63,CENSUS,D_4_IRF_C13_76,B_1_C0_99,B_1_C0_75,D_5_HOS_C6_57,S2_1_C2_140,S3_2_C2_15,A_C2_21,D_5_HOS_C2_76,D_5_HOS_C3_51,B_1_C0_2,A_C2_34,B_1_C26_34,B_1_C26_94,A_C1_32,D_4_HOS_C11_54,D_4_SNF_C11_68,S3_1_C3_24,A_C1_42,D3_IRF_C2_34,B_1_C22_106,C_1_C5_9940,D_5_HOS_C4_70,D_4_HOS_C1_73,D_4_HOS_C10_76,D3_HOS_C2_35,B_2_C26_115,D_5_HOS_C4_9201,D_4_HOS_C3_73,D3_IPF_C2_32,A_C6_98,B_1_C0_72,D_3_HOS_C3_200,B_2_C26_193,B_1_C22_52,D_5_HOS_C6_98,D_5_HOS_C6_93,D_5_HOS_C7_66,D_4_HOS_C12_75,A_C1_9910,D4_PANCREAS_C1_69,C_1_C7_89,B_1_C0_9930,A_C6_93,D3_IRF_C2_35,D3_HOS_C3_60,D_5_HOS_C4_52,S2_1_C1_142,B_1_C0_76,D3_HOS_C2_55,E_A_HOS_C1_59,B_1_C22_101,A_C1_16,D_4_IPF_C13_58,S3_1_C8_8,S2_1_C2_3801,A_C1_95,A_C1_9920,A_C6_76,S10_C2_21,D3_HOS_C3_54,D3_SNF_C2_32,C_1_C6_101,S3_1_C15_1,A_C2_190,G_C1THRU4_46,S5_C3_2,D_4_SNF_C11_55,S2_1_C1_145,D3_SNF_C2_98,B_2_C26_35,S3_1_C2_20,C_1_C5_93,D_5_HOS_C7_72,D_4_IRF_C11_63,D3_IRF_C2_93,B_1_C0_70,D_4_HOS_C10_91,C_1_C5_4201,B_2_C26_9920,A7_1_C2_10,B_1_C26_68,C_1_C5_72,B_1_C21_55,A7_1_C3_4,C_1_C5_112,A_C6_34,C_1_C7_70,B_1_C0_9910,A_C6_14,C_1_C7_51,C_1_C6_74,D_5_HOS_C4_73,S2_1_C2_13,S3_1_C8_11,S3_2_C4_38,C_1_C3_202,C_1_C5_9930,S3_1_C13_17,A7_1_C5_2,S5_C5_1,S2_1_C2_3601,C_1_C5_9910,D1_HOS_C1_56,B_1_C21_68,D_4_HOS_C4_53,D_5_HOS_C4_62,S3_1_C15_14,B_2_C26_70,S3_1_C7_26,D_4_HOS_C4_88,S3_1_C3_12,D_4_HOS_C12_57,S3_2_C3_2551,C_1_C6_32,A7_3_C5_2,D_4_HOS_C10_68,D3_IPF_C3_60,S3_3_C5_3,S3_2_C6_33,C_1_C5_54,C_1_C6_95,C_1_C7_62,C_1_C7_59,S3_1_C8_22,C_1_C6_50,A_C1_115,A_C6_63,B_2_C26_72,D_5_HOS_C4_91,D_4_HOS_C3_75,S3_1_C7_14,S2_1_C2_1515,S10_C2_22,D_4_HOS_C10_9201,D3_HOS_C2_96,B_1_C0_20,G_C1THRU4_3,A_C2_106,A_C1_14,D_4_HOS_C10_6250,G_C1THRU4_8,D3_IRF_C2_73,S4_HHA1_C5_37,C_1_C7_55,B_1_C0_69,S3_1_C9_26,B_1_C0_111,A_C6_97,S3_2_C4_24,C_1_C6_68,D_4_HOS_C3_74,D3_IRF_C2_61,A_C6_5,D_4_HOS_C3_97,D_4_IPF_C11_56,D3_IRF_C3_9201,A_C6_65,D_4_HOS_C3_89,C_1_C6_6250,S2_1_C2_1507,C_1_C7_116,B_2_C26_6250,D3_IPF_C3_55,A_C2_193,S2_1_C1_11801,C_1_C5_89,D_4_HOS_C3_63,D_5_HOS_C6_61,D_4_HOS_C3_57,S3_2_C6_3,D3_IRF_C2_98,B_2_C26_95,A_C2_46,A_C1_18,S3_1_C8_17,D_4_SNF_C11_69,S3_2_C6_10,B_2_C26_74,S3_2_C6_34,A_C6_88,D3_IRF_C2_55,D_4_IPF_C11_51,C_1_C7_69,D_5_HOS_C4_51,S2_1_C1_143,S3_2_C4_6,D3_HOS_C2_53,A8_C2_20,C_1_C5_6250,D_4_IRF_C11_76,B_1_C0_194,A_C1_65,D_4_HOS_C2_67,B_1_C0_4501,D_4_HOS_C4_55,D3_IPF_C3_98,A7_3_C11_3,D_5_HOS_C7_91,D_4_IRF_C11_74,D_4_HOS_C13_98,A_C6_45,S3_1_C2_1801,S3_2_C4_11,S3_3_C4_3,S4_HHA1_C4_38,S4_HHA1_C4_37,D3_HOS_C3_52,S3_2_C5_42,D3_SNF_C2_50,A_C1_21,B_1_C0_90,B_1_C22_51,C_1_C5_63,D3_HOS_C2_68,C_1_C5_44,D_4_IRF_C11_57,D3_SNF_C2_76,D_4_IPF_C13_57,A_C1_69,A7_1_C3_10,D_3_HOS_C9_33,D_5_HOS_C3_71,D3_HOS_C3_62,S3_2_C2_25,B_1_C22_107,S3_2_C2_36,D_4_HOS_C12_62,S3_2_C6_1401,B_1_C0_112,D_4_IPF_C13_72,D3_IRF_C3_50,D3_IRF_C3_94,A7_3_C10_3,S3_3_C5_2,D_4_HOS_C4_59,A7_1_C1_3,B_1_C26_9920,D_4_HOS_C3_93,D_4_HOS_C12_9201,D_5_HOS_C4_98,S3_2_C3_1401,D_4_IPF_C11_58,D_5_HOS_C4_6250,A_C1_72,S3_2_C5_33,D_5_HOS_C2_71,A_C2_59,B_1_C26_115,D_4_HOS_C3_66,C_1_C6_4501,D_4_HOS_C13_68,S4_HHA3_C1_38,S2_1_C1_105,A_C1_57,S10_C1_23,A7_1_C7_1,D1_HOS_C1_37,S3_2_C5_35,D3_HOS_C2_60,D3_IPF_C3_71,D_4_IPF_C13_59,S3_1_C12_17,S3_1_C9_27,S3_2_C2_30,A_C1_4,S3_2_C2_2,S4_HHA1_C2_38,B_1_C0_4201,D_4_SNF_C11_60,B_1_C0_41,S3_1_C11_14,A_C1_66,S3_3_C5_6,A_C1_76,C_1_C6_34,S4_HHA1_C1_35,D3_IRF_C2_71,D3_HOS_C2_9201,A7_3_C7_2,D3_IRF_C3_57,A8_C2_14,S3_2_C2_2553,A_C1_63,G_C1THRU4_48,S3_2_C6_38,B_1_C21_107,S3_2_C4_9,A_C6_99,C_1_C6_56,D3_SNF_C2_93,E_B_HOS_C1_30,D_4_HOS_C12_200,D3_IRF_C2_72,S3_3_C4_6,S2_1_C2_5,S3_1_C3_18,B_2_C26_56,S3_1_C10_19,D_4_HOS_C13_200,S3_1_C3_17,S5_C4_2,A_C6_90,S2_1_C4_3,A8_C2_18,D_4_HOS_C12_67,D1_SNF_C1_74,A_C1_97,B_1_C26_88,G_C1THRU4_4,D3_HOS_C2_34,S3_2_C4_10,G_C1THRU4_50,S4_HHA2_C5_33,D_5_HOS_C5_68,B_1_C0_54,C_1_C6_54,D3_SNF_C3_73,S2_1_C2_1508,D_4_HOS_C2_53,G_C1THRU4_17,C_1_C7_53,A_C1_96,D3_IPF_C2_41,A_C6_32,D_5_HOS_C7_51,C_1_C6_66,G_C1THRU4_35,A_C2_11,A_C6_62,S3_2_C6_30,E_B_HOS_C1_2,S3_1_C2_18,B_1_C0_65,D3_SNF_C3_70,B_1_C26_54,A_C1_99,S2_1_C3_2,S2_1_C1_37,A_C6_72,S2_1_C2_1524,D_4_HOS_C13_53,A_C1_194,B_1_C26_96,B_1_C21_75,B_1_C22_54,B_1_C22_72,B_2_C26_4501,C_1_C5_32,D_4_HOS_C13_72,D_4_HOS_C13_74,A7_3_C6_1,S3_3_C5_7,D_4_HOS_C11_75,D3_IRF_C3_91,A_C2_75,S3_3_C2_5,S10_C1_26,D_5_HOS_C4_67,D_5_HOS_C7_59,B_1_C22_41,A_C6_6,S4_HHA2_C1_36,D3_IPF_C3_69,A7_1_C1_10,D_4_HOS_C13_58,A_C1_193,D_5_HOS_C3_64,S3_1_C15_18,A_C2_101,A_C6_12,D_4_HOS_C12_54,A_C2_10,B_1_C26_89,S4_HHA3_C4_35,D_4_HOS_C2_94,D_5_HOS_C5_75,S3_2_C6_41,D_4_HOS_C11_71,D_4_IPF_C11_73,D_4_IRF_C13_93,S3_1_C6_22,B_2_C26_192,S3_1_C5_13,S3_1_C14_14,D3_IRF_C2_9201,B_1_C22_94,B_1_C21_91,C_1_C5_55,D3_IRF_C3_72,E_B_HOS_C1_26,D3_SNF_C3_94,D_1_HOS_C6_41,S3_1_C4_1,S5_C2_10,S2_1_C1_115,A_C6_54,D3_HOS_C2_50,B_2_C26_100,D_5_HOS_C6_68,S3_2_C4_32,B_1_C22_55,D_4_IRF_C13_50,D_5_HOS_C3_200,S3_1_C6_15,B_1_C0_7,B_2_C26_57,A_C6_13,C_1_C6_107,D_4_HOS_C2_56,C_1_C7_105,S2_1_C2_1606,D1_IPF_C1_53,D_4_HOS_C11_60,S3_1_C3_14,D3_HOS_C2_67,D_4_SNF_C11_200,D3_HOS_C2_30,D3_SNF_C2_64,D1_HOS_C1_48,D4_KIDNEY_C1_69,C_1_C7_107,D_3_HOS_C8_200,S3_1_C13_18,D3_SNF_C3_64,A_C2_3,D3_IRF_C2_51,C_1_C5_31,D_5_HOS_C5_52,A_C6_20,D_5_HOS_C6_94,B_1_C21_71,D_4_IPF_C13_65,S10_C3_23,A_C6_110,D3_SNF_C2_35,B_1_C21_88,S3_3_C6_2,A_C2_9910,B_1_C0_108,C_1_C5_115,B_1_C21_116,D_5_HOS_C7_58,A_C2_114,B_1_C26_59,B_1_C21_67,B_1_C22_46,B_2_C26_112,B_2_C26_101,D_4_IRF_C13_70,D1_HOS_C1_55,B_1_C22_42,S3_1_C9_19,D3_HOS_C2_51,S3_2_C6_31,A_C1_19,C_1_C6_90,S3_1_C8_10,S3_1_C6_26,S3_1_C7_1,D3_HOS_C2_56,S2_1_C2_1502,S3_1_C14_18,D_5_HOS_C6_97,D3_HOS_C3_75,B_1_C21_69,D_1_HOS_C6_40,D3_HOS_C3_69,S3_1_C6_2,S3_2_C4_12,B_2_C26_93,S3_2_C6_4,A_C6_107,D3_IPF_C2_62,B_1_C26_108,A_C6_51,S3_2_C4_3,D_4_HOS_C11_90,A_C2_52,A8_C2_16,D_5_HOS_C5_59,A_C2_70,B_1_C0_73,A_C1_91,C_1_C7_117,D_4_IRF_C11_66,A_C1_33,S3_2_C5_38,A7_1_C3_5,A_C1_75,B_1_C26_6250,B_1_C26_70,D3_HOS_C3_94,D_4_IRF_C11_60,D_5_HOS_C5_64,B_2_C26_194,D3_HOS_C2_61,B_2_C26_105,S3_2_C4_1401,E_B_HOS_C1_41,A_C2_17,D_4_HOS_C11_70,S5_C1_6,B_2_C26_71,S3_3_C4_5,S4_HHA1_C1_33,B_2_C26_43,S3_1_C6_9,A_C2_40,D_4_IPF_C13_62,D3_SNF_C3_75,S3_2_C2_2551,D_1_HOS_C4_32,S3_1_C6_5,S3_1_C14_16,D1_IRF_C1_49,D_4_SNF_C11_62,C_1_C5_111,D3_IPF_C3_53,D_5_HOS_C3_55,C_1_C6_46,D_5_HOS_C3_72,D3_HOS_C2_74,S10_C1_10,A_C2_22,S3_2_C5_28,D_5_HOS_C4_57,B_2_C26_65,D_5_HOS_C6_66,S2_1_C2_11801,A_C1_107,C_1_C6_30,D_4_HOS_C3_70,C_1_C5_40,S2_1_C1_86,S2_1_C1_128,S4_HHA2_C4_36,C_1_C7_60,S2_1_C2_1809,S2_1_C1_27,S2_1_C1_22,D_4_IPF_C13_52,S2_1_C5_24,C_1_C5_68,D_5_HOS_C2_200,D3_SNF_C2_55,S3_1_C5_7,D3_IPF_C3_65,A_C1_55,C_1_C6_110,A_C2_63,A_C1_190,C_1_C6_65,B_1_C21_46,S10_C1_14,A_C2_23,C_1_C6_62,B_1_C26_55,C_1_C5_108,S3_3_C2_3,A_C2_74,S5_C2_2,D_5_HOS_C5_6250,D_5_HOS_C2_65,D_5_HOS_C3_54,S3_1_C6_16,S3_1_C10_1801,B_1_C26_35,B_1_C22_71,A7_1_C1_8,E_B_HOS_C1_5,B_1_C26_65,B_2_C26_50,S3_1_C7_32,S3_1_C8_21,S3_1_C3_16,S3_1_C3_21,S3_2_C2_37,S5_C1_9,D_4_HOS_C2_71,A_C1_50,A_C6_16,D3_IPF_C3_57,G3_C1_5,A_C1_110,S3_2_C4_43,S3_1_C7_16,S4_HHA3_C2_37,A_C2_44,S3_2_C3_2553,B_1_C21_94,D_5_HOS_C5_69,B_1_C21_32,B_1_C21_40,D_5_HOS_C5_54,D1_HOS_C1_51,C_1_C7_71,A_C1_114,E_B_HOS_C1_31,C_1_C6_58,A_C1_43,B_1_C26_200,D_4_HOS_C3_56,D3_HOS_C3_63,D_5_HOS_C2_63,S3_3_C6_6,C_1_C7_106,D3_SNF_C3_91,S3_2_C4_17,B_1_C21_34,D_4_HOS_C11_72,D3_SNF_C2_73,D_1_HOS_C4_200,D3_SNF_C3_50,S2_1_C2_1803,B_1_C26_9940,D3_HOS_C3_57,D1_SNF_C1_37,D3_IPF_C3_90,G_C1THRU4_39,D_4_IRF_C11_9201,D_5_HOS_C6_62,S2_1_C2_1517,S3_2_C4_1402,A_C1_52,S3_1_C3_10,D_4_HOS_C2_55,D_5_HOS_C6_54,A_C2_5,D_4_HOS_C12_70,D3_IPF_C2_60,S3_1_C6_12,C_1_C6_4201,D3_HOS_C3_61,D3_SNF_C3_66,A_C1_11,B_1_C21_44,S5_C1_1,D_4_IRF_C11_70,D_4_HOS_C10_50,D_4_HOS_C12_90,D3_IPF_C2_91,D_4_SNF_C11_67,S4_HHA2_C3_35,C_1_C7_112,D_4_HOS_C4_76,S3_2_C2_17,D_4_HOS_C4_90,C_1_C7_9910,D_4_IPF_C11_53,D_4_HOS_C2_68,E_B_HOS_C1_12,D3_SNF_C3_71,S3_1_C4_7,D3_IPF_C2_34,B_1_C26_192,D_1_HOS_C4_35,D_4_IRF_C3_200,B_1_C22_93,C_1_C5_99,C_1_C6_43,A_C6_95,S3_2_C4_29,B_1_C22_67,D_1_HOS_C4_41,C_1_C7_65,S10_C1_15,A_C6_70,B_1_C0_116,S4_HHA2_C5_38,D_4_HOS_C10_67,B_1_C0_101,B_2_C26_62,E_B_HOS_C101_8,E_B_HOS_C1_18,D3_SNF_C3_62,S3_2_C6_37,C_1_C5_100,S3_1_C13_1,D_4_HOS_C10_66,B_1_C21_54,D3_HOS_C3_71,A_C1_31,S2_1_C1_129,C_1_C7_74,D_5_HOS_C6_56,C_1_C5_202,D_4_IPF_C13_50,D_5_HOS_C2_58,B_2_C26_75,E_B_HOS_C1_32,B_1_C0_105,D3_SNF_C2_60,D_4_HOS_C12_59,D3_HOS_C2_70,S2_1_C2_38,B_2_C26_97,D_4_HOS_C10_65,D3_IRF_C3_54,D_4_HOS_C13_66,D_5_HOS_C2_93,D_4_IPF_C13_91,D3_IRF_C3_62,S4_HHA3_C4_38,B_1_C22_59,B_1_C22_91,A_C1_70,A_C6_111,D3_IPF_C3_66,B_1_C26_45,A_C1_67,S3_1_C7_5,A7_1_C7_5,S3_2_C4_8,S2_1_C2_4,S3_1_C5_14,D_4_SNF_C11_93,D3_HOS_C2_43,D_4_IRF_C13_58,D_5_HOS_C4_65,B_1_C0_56,B_1_C26_9910,D_5_HOS_C5_96,S3_3_C4_7,E_B_HOS_C1_14,A_C2_7,A_C2_117,S2_1_C1_56,C_1_C6_89,D3_IPF_C2_33,S3_2_C5_2,A_C6_73,D_5_HOS_C6_59,S3_2_C3_1402,A_C2_111,D3_IRF_C3_90,E_B_HOS_C1_23,C_1_C5_96,D_5_HOS_C2_64,B_1_C0_33,S3_1_C6_32,D_4_IPF_C11_69,C_1_C5_88,A_C1_10,B_1_C0_46,B_1_C21_57,D_4_IPF_C11_67,D3_IPF_C2_65,S3_2_C4_23,S3_2_C5_6,A_C2_96,B_1_C26_112,D_5_HOS_C3_53,B_1_C21_117,D_4_HOS_C2_52,B_1_C22_190,D3_HOS_C3_6250,C_1_C7_202,D_4_HOS_C4_89,D_4_IRF_C11_75,A_C1_41,D_5_HOS_C5_9201,D_4_HOS_C3_52,S2_1_C1_26,S10_C3_21,B_1_C26_201,D3_SNF_C3_56,S5_C6_2,D3_IRF_C2_56,S3_2_C4_13,S2_1_C1_141,B_1_C21_190,D_4_HOS_C10_75,D_5_HOS_C2_74,S2_1_C2_10,D_4_HOS_C3_76,D_5_HOS_C3_66,S3_2_C4_19,RPT_REC_NUM,S3_2_C2_32,C_1_C7_98,G_C1THRU4_13,C_1_C5_71,S3_2_C2_11,S3_3_C6_5,D3_IPF_C2_69,D_5_HOS_C2_56,D3_IPF_C2_64,B_2_C26_200,B_1_C22_110,D_5_HOS_C7_62,S3_2_C2_19,A_C6_194,D3_SNF_C2_72,C_1_C2_67,A_C2_112,D_4_HOS_C10_64,B_1_C22_60,D3_IRF_C3_93,A_C1_44,D_1_HOS_C6_30,S4_HHA2_C1_33,B_1_C21_108,S4_HHA3_C1_36,S2_1_C1_24,S3_1_C7_22,C_1_C7_76,S2_1_C2_1513,B_1_C26_74,S10_C1_11,S3_1_C8_20,B_1_C0_45,D_5_HOS_C4_55,D_4_IPF_C13_74,S3_1_C4_9,B_1_C26_46,S2_1_C6_24,A_C6_106,D_4_HOS_C12_71,S10_C2_23,A_C1_22,A_C2_50,D_4_HOS_C3_58,D3_IPF_C3_96,G_C1THRU4_38,D3_SNF_C3_69,D_5_HOS_C5_57,S3_1_C8_16,A_C6_193,B_1_C26_101,A7_3_C10_2,D3_SNF_C3_98,S3_2_C4_42,D3_SNF_C2_68,S4_HHA2_C3_36,G_C1THRU4_51,S4_HHA1_C5_34,S3_1_C8_32,D_4_IRF_C11_200,D_4_HOS_C10_70,B_1_C21_53,D_4_IRF_C13_52,B_2_C26_9201,A7_1_C3_6,A_C6_9930,S3_2_C4_1601,D_4_SNF_C11_75,S3_1_C5_10,D3_SNF_C3_54,D_5_HOS_C6_76,S4_HHA3_C2_34,S3_1_C11_27,S10_C1_3,D_5_HOS_C7_60,D_4_SNF_C13_200,C_1_C7_9930,A_C6_7,S3_1_C2_7,D_1_HOS_C7_41,S3_1_C6_14,S4_HHA3_C1_33,A7_3_C5_1,A8_C2_2,S3_2_C2_9,C_1_C6_115,S3_2_C4_35,D_4_HOS_C10_71,D3_IPF_C3_94,S2_1_C2_1807,D3_HOS_C2_90,D3_IRF_C2_67,E_B_HOS_C1_29,D4_LIVER_C1_69,S2_1_C2_1506,B_1_C0_34,D3_IPF_C3_91,S2_1_C2_1201,S2_1_C3_24,S5_C2_8,D3_IPF_C2_75,D3_IRF_C2_33,A7_1_C3_7,C_1_C5_110,A8_C2_25,S3_2_C4_4,S4_HHA1_C3_38,S4_HHA3_C4_33,S10_C1_17,A_C1_108,C_1_C7_63,G_C1THRU4_41,S4_HHA3_C3_36,S2_1_C1_93,B_1_C22_105,C_1_C6_111,FI_NUM,B_1_C22_63,B_1_C21_33,S3_1_C4_14,S3_2_C5_13,A_C2_54,S3_2_C5_10,B_1_C0_19,D3_HOS_C2_64,D_4_HOS_C2_75,B_2_C26_69,D_4_HOS_C10_53,S2_1_C2_1806,D3_IRF_C2_54,S3_1_C7_8,D3_HOS_C3_53,D_4_HOS_C12_76,D_5_HOS_C6_58,D3_SNF_C3_55,D_5_HOS_C7_200,S3_2_C2_2552,B_1_C0_11,D3_IPF_C3_62,C_1_C5_76,S3_2_C5_4,S3_2_C3_2552,A_C2_31,S3_1_C10_18,D_5_HOS_C6_200,D1_HOS_C5_46,D3_IPF_C3_75,S2_1_C1_134,C_1_C7_96,D_4_IRF_C11_69,S3_2_C6_16,B_1_C0_40,B_1_C22_111,D_5_HOS_C2_59,S3_1_C5_17,D_5_HOS_C5_72,D3_SNF_C2_40,B_1_C21_63,B_1_C0_1,C_1_C8_202,D_5_HOS_C7_75,S3_1_C11_19,S4_HHA3_C2_35,A_C6_101,D_5_HOS_C4_54,D_4_HOS_C12_94,D1_HOS_C1_41,S3_1_C8_25,A_C6_9920,S3_1_C3_2001,E_B_HOS_C1_7,A_C2_9,D3_IPF_C2_90,D3_IRF_C3_76,A_C2_105,D_4_HOS_C10_54,D_4_HOS_C12_6250,S3_1_C7_6,A_C2_192,S3_2_C2_7,D3_SNF_C3_76,D_5_HOS_C7_63,D1_IRF_C1_53,A_C1_9930,D3_IPF_C3_52,D1_IPF_C1_27,S3_2_C5_11,D3_HOS_C3_91,D3_IRF_C2_74,S3_1_C3_8,D_5_HOS_C2_73,D_1_HOS_C4_30,D_4_HOS_C10_63,S3_2_C3_2201,D3_SNF_C2_57,A7_1_C3_2,A8_C2_3,D_5_HOS_C6_51,D_4_IPF_C11_93,S3_2_C2_21,S5_C1_13,S2_1_C2_9,D3_IPF_C2_56,S3_1_C9_18,D_5_HOS_C5_93,D_5_HOS_C2_6250,B_2_C26_59,A7_3_C7_3,D_5_HOS_C4_50,S3_1_C7_10,A_C2_69,D_4_HOS_C11_57,S3_1_C6_25,S2_1_C2_126,A7_3_C11_1,D_4_HOS_C4_58,S3_1_C6_29,S3_1_C7_2001,S3_2_C6_5,D_4_IRF_C13_57,A7_1_C1_5,B_1_C0_14,S3_3_C4_4,E_B_HOS_C1_38,S3_2_C5_1,D_4_IRF_C13_60,S3_2_C4_37,D_5_HOS_C4_60,A_C1_7,S3_2_C2_10,B_1_C21_74,S3_2_C5_29,C_1_C5_91,C_1_C5_65,D_5_HOS_C3_56,C_1_C5_117,D3_IRF_C2_69,D3_SNF_C3_59,C_1_C5_61,B_1_C21_105,S4_HHA3_C5_35,A_C1_58,D_4_HOS_C11_62,B_1_C22_57,B_2_C26_94,PRVDR_NUM,B_1_C0_13,S3_2_C4_16,D3_SNF_C3_96,D1_IRF_C1_27,S3_1_C4_10,B_1_C0_43,D_4_HOS_C13_67,A_C6_41,D_4_IPF_C11_71,D3_IRF_C2_59,D_3_HOS_C9_34,D_4_IPF_C11_9201,D_5_HOS_C3_9201,E_B_HOS_C1_11,D3_HOS_C2_63,S5_C2_6,A7_1_C1_1,A7_1_C5_6,D_5_HOS_C7_55,E_B_HOS_C101_4,S3_2_C5_12,A7_1_C2_8,D_3_HOS_C9_44,D_5_HOS_C3_60,S3_1_C7_15,B_1_C21_95,C_1_C6_100,S3_3_C6_3,D3_IPF_C2_52,B_1_C21_62,A8_C2_31,B_2_C0_202,E_B_HOS_C1_21,S3_1_C6_24,C_1_C6_108,B_2_C26_68,S3_2_C4_41,D_5_HOS_C5_67,D_4_HOS_C10_59,D3_SNF_C3_57,D_4_IRF_C13_200,S5_C1_21,S3_2_C2_31,D_4_HOS_C11_74,E_A_HOS_C1_7093,A8_C2_24,D_5_HOS_C2_90,D_5_HOS_C5_71,A_C6_116,C_1_C7_64,D_4_HOS_C1_76,C_1_C5_45,S2_1_C1_144,D3_HOS_C3_76,D1_IPF_C1_51,A_C6_55,B_2_C26_52,S3_1_C6_1,S2_1_C2_1521,B_1_C0_21,D_4_IPF_C11_63,A_C2_62,S3_2_C2_35,S3_1_C2_24,S3_1_C10_20,D_4_IPF_C11_76,D_4_HOS_C11_65,D3_IRF_C2_31,D3_IRF_C3_68,B_1_C26_40,D_4_IPF_C11_74,D_4_HOS_C2_88,D3_HOS_C3_9201,E_B_HOS_C1_1,S4_HHA2_C5_35,S3_2_C2_3,S3_2_C2_2201,S2_1_C1_131,B_2_C26_98,E_B_HOS_C1_44,A_C6_10,D3_SNF_C2_94,S2_1_C2_1608,A8_C2_22,B_1_C21_31,S3_1_C10_2001,S3_1_C7_12,A8_C2_26,B_1_C26_95,C_1_C6_94,D_4_HOS_C13_51,D_4_IPF_C11_72,S3_2_C6_29,S2_1_C1_47,S3_2_C2_40,D_5_HOS_C7_69,S4_HHA1_C5_33,B_1_C22_117,B_1_C0_6,B_1_C0_42,D_4_HOS_C11_63,S3_2_C6_7,D_4_IPF_C13_68,S4_HHA1_C4_35,B_1_C22_194,A_C2_72,D_4_HOS_C2_200,S2_1_C1_48,B_2_C26_9910,A_C6_9910,S3_1_C11_25,D_4_HOS_C3_9201,D_4_IRF_C11_54,D_5_HOS_C7_68,S4_HHA1_C2_37,S3_2_C2_41,B_1_C0_22,D_4_SNF_C11_54,S3_1_C6_11,S3_2_C3_2550,S3_2_C4_25,C_1_C5_42,D_5_HOS_C4_71,B_1_C26_4201,D1_IPF_C1_50,E_B_HOS_C1_10,S3_1_C5_1,A8_C2_33,D_4_IPF_C13_75,D3_SNF_C2_59,A_C6_35,A_C2_1,B_1_C22_95,D_4_IRF_C11_64,A_C6_9940,A_C2_64,S4_HHA1_C3_34,S4_HHA1_C5_35,B_1_C26_194,D_1_HOS_C4_42,D_5_HOS_C6_71,D_4_HOS_C13_69,S10_C1_19,S3_2_C3_23,D_4_IPF_C11_52,B_1_C0_191,B_1_C26_98,S2_1_C2_1510,S3_1_C5_12,S5_C2_21,B_1_C22_109,S2_1_C4_24,D3_HOS_C3_93,D_5_HOS_C3_61,D_4_HOS_C12_56,S2_1_C2_1805,D_5_HOS_C7_9201,B_1_C0_53,D3_IRF_C2_200,MSA,C_1_C2_66,D_4_HOS_C4_93,D3_HOS_C2_98,D3_HOS_C3_98,D_4_HOS_C2_70,G3_C1_4,S3_2_C4_2,S3_2_C2_28,A_C6_52,C_1_C7_90,S3_1_C3_9,S3_1_C8_1801,B_1_C22_88,S3_1_C8_13,D_5_HOS_C6_69,C_1_C7_94,S2_1_C2_16,D1_IRF_C1_37,B_1_C0_9920,C_1_C6_42,D_4_HOS_C3_88,S3_1_C8_9,S2_1_C2_1511,A_C2_14,S4_HHA3_C2_33,S2_1_C2_1801,S2_1_C1_132,S10_C1_18,D3_IRF_C2_60,A8_C2_4,A_C6_191,A_C2_2,A_C1_100,B_1_C0_192,B_1_C0_57,S3_1_C6_17,S3_1_C12_14,A_C2_71,D_4_HOS_C10_98,A_C1_105,D_4_IRF_C13_65,D_5_HOS_C3_58,B_2_C26_55,D3_SNF_C3_52,A_C6_71,E_B_HOS_C1_20,S2_1_C2_1601,A_C6_9201,B_1_C22_43,A_C2_4,A7_1_C2_3,D_4_HOS_C12_58,B_1_C22_50,B_2_C26_58,D_1_HOS_C6_31,D_5_HOS_C5_90,G_C1THRU4_31,D_4_HOS_C2_76,C_1_C6_69,C_1_C5_105,B_1_C26_4501,D_5_HOS_C5_66,D_4_HOS_C12_68,A_C2_35,D_4_HOS_C1_91,D_5_HOS_C5_56,A_C6_30,D3_SNF_C2_56,B_1_C26_56,S2_1_C2_7,D_5_HOS_C3_93,A7_1_C2_2,S3_2_C5_9,A7_1_C2_6,D3_SNF_C2_30,C_1_C6_106,D_5_HOS_C6_63,A_C6_15,S4_HHA1_C1_34,C_1_C5_74,D_4_HOS_C2_9201,C_1_C6_67,D3_SNF_C2_90,S3_3_C2_4,S3_2_C6_15,S3_1_C8_1,B_1_C0_62,C_1_C5_9201,S2_1_C1_60,D1_IRF_C1_50,D3_SNF_C2_53,B_1_C21_51,D_4_IPF_C13_53,S3_3_C2_1,B_1_C21_70,S3_2_C6_32,D_5_HOS_C4_59,C_1_C6_61,D_5_HOS_C7_56,A8_C2_17,B_1_C21_42,D_4_IPF_C13_56,D_1_HOS_C7_200,D_4_HOS_C2_59,S3_1_C2_32,D3_IPF_C3_59,B_1_C21_52,D_4_HOS_C11_58,B_1_C22_40,D_5_HOS_C2_67,S5_C3_1,S3_2_C4_18,S10_C1_20,S10_C1_9,S2_1_C3_11801,D_5_HOS_C2_52,D_4_IRF_C11_72,D_5_HOS_C4_90,C_1_C5_101,B_1_C22_66,D_4_IPF_C1_200,D_1_HOS_C4_4201,FY_END_DT,C_1_C6_71,S3_3_C2_6,C_1_C6_76,D_4_IRF_C11_73,D_4_HOS_C3_62,B_1_C22_69,S4_HHA2_C2_38,B_1_C0_16,D_4_HOS_C13_55,D_5_HOS_C3_6250,D3_SNF_C2_69,S3_2_C6_13,A_C1_45,A_C1_40,D3_IPF_C2_31,B_1_C21_9201,D3_SNF_C3_65,D3_IRF_C3_66,E_A_HOS_C1_72,D_4_SNF_C11_74,D_4_HOS_C11_200,B_1_C22_44,D_4_IRF_C11_71,S3_1_C2_10,E_B_HOS_C1_16,C_1_C5_53,D_4_HOS_C12_98,C_1_C6_105,D_5_HOS_C2_62,D1_HOS_C1_49,D3_IRF_C3_59,D_4_HOS_C4_51,D_1_HOS_C4_31,B_1_C26_53,C_1_C5_59,D_4_HOS_C12_55,S3_2_C4_30,S2_1_C1_5,C_1_C5_43,D_5_HOS_C2_50,B_1_C22_191,B_2_C26_53,C_1_C5_116,B_1_C26_90,D_4_HOS_C1_50,S3_1_C3_11,D3_IRF_C3_98,E_B_HOS_C1_4,B_2_C26_9940,D_5_HOS_C3_50,A_C6_43,B_2_C26_96,B_2_C26_40,D_4_IPF_C6_200,B_1_C21_50,E_B_HOS_C101_2,S4_HHA3_C1_35,S3_2_C4_27,C_1_C7_9201,E_B_HOS_C1_9,D_4_IRF_C11_91,S3_2_C4_36,A_C6_18,A7_1_C3_8,D_1_HOS_C4_40,S3_1_C11_26,C_1_C6_64,D_4_HOS_C10_51,D1_IRF_C1_52,G_C1THRU4_6,S2_1_C2_1802,B_1_C0_15,B_2_C26_54,S3_1_C7_19,A_C1_68,D_4_SNF_C11_9201,D_4_IRF_C11_55,D1_IPF_C1_41,A_C6_89,D_4_SNF_C11_51,S4_HHA1_C2_33,S3_2_C5_32,B_1_C0_12,D3_IPF_C2_94,S3_1_C11_21,S2_1_C1_3,D_4_HOS_C11_73,REGION,D3_HOS_C3_55,C_1_C7_54,S3_2_C3_25,S2_1_C1_36,S4_HHA2_C5_36,A_C6_113,S3_1_C5_9,D3_HOS_C2_59,D_4_HOS_C4_69,B_1_C22_115,D_4_HOS_C12_64,D_4_IRF_C4_200,A_C2_91,D3_IPF_C3_200,S3_1_C2_21,D_5_HOS_C2_53,S3_2_C6_35,B_1_C21_45,B_1_C26_117,S3_2_C2_42,C_1_C6_72,A_C2_53,A8_C2_23,S2_1_C7_3,S4_HHA1_C1_36,C_1_C6_53,S3_1_C9_22,A_C2_9940,D_4_HOS_C3_6250,A7_1_C7_10,G_C1THRU4_47,S4_HHA2_C4_34,A_C2_61,A8_C2_9,S3_2_C6_1,S3_2_C6_9,C_1_C7_52,D_1_HOS_C7_33,D3_HOS_C2_91,C_1_C6_73,C_1_C7_67,S10_C1_21,B_1_C22_74,B_2_C26_99,D_4_HOS_C3_53,S2_1_C1_85,B_2_C26_88,S10_C1_2,S3_3_C6_7,D_4_HOS_C3_54,D_5_HOS_C7_71,A_C6_22,S5_C3_3,D_4_HOS_C10_96,S2_1_C2_142,S3_1_C3_20,D_4_HOS_C2_93,D3_IPF_C2_9201,S4_HHA3_C5_37,A_C2_113,D4_INTESTINE_C1_69,S3_1_C6_10,S3_2_C5_43,D3_IRF_C3_64,B_1_C26_111,D_5_HOS_C5_65,S3_2_C4_40,D_4_SNF_C11_58,D_4_HOS_C4_70,D3_SNF_C3_68,D1_IRF_C1_41,E_B_HOS_C101_3,S2_1_C2_1522,B_1_C21_193,D_4_HOS_C2_66,A_C6_74,S5_C1_3,A_C1_111,A_C2_20,B_1_C0_71,G3_C1_28,B_1_C26_62,D_4_HOS_C10_56,S5_C1_5,D3_IRF_C2_75,D_5_HOS_C7_54,A_C6_4,A_C6_11,D_3_HOS_C2_200,S2_1_C1_2,D3_IRF_C3_58,D_4_HOS_C10_97,D_5_HOS_C7_52,S3_1_C2_16,C_1_C7_50,D_3_HOS_C9_31,S5_C3_6,D_5_HOS_C5_62,S10_C1_30,S2_1_C3_3,S3_2_C2_16,S4_HHA2_C4_35,B_1_C22_56,G3_C1_26,E_B_HOS_C101_6,D3_IPF_C2_40,B_1_C26_9930,D_5_HOS_C3_74,S3_2_C4_1602,D_4_HOS_C12_69,D_4_HOS_C2_62,D_5_HOS_C5_60,G3_C1_25,S4_HHA1_C5_36,D3_SNF_C3_58,D_4_HOS_C13_93,B_1_C21_56,S3_1_C7_1801,S3_1_C7_7,D_4_IPF_C13_93,D3_HOS_C2_94,D3_IPF_C2_59,D_3_HOS_C9_200,D_5_HOS_C6_53,D1_HOS_C5_44,A_C1_101,D3_IRF_C2_57,S2_1_C2_1512,A8_C2_50,D_4_HOS_C3_60,B_1_C21_93,S2_1_C1_127,D3_IPF_C2_200,D_4_SNF_C11_57,C_1_C5_94,D_4_HOS_C4_75,C_1_C7_109,D_4_HOS_C10_93,A_C1_71,S2_1_C2_1603,D3_SNF_C3_51,D_5_HOS_C4_200,S5_C2_5,A_C1_53,A_C1_62,S3_2_C2_38,C_1_C7_58,B_1_C0_68,D_4_IRF_C13_74,D3_IPF_C3_64,D3_HOS_C3_73,D3_IPF_C2_98,E_B_HOS_C1_28,A_C2_110,S4_HHA1_C3_33,A_C1_191,A_C1_15,D3_IPF_C2_51,A_C6_40,A_C6_66,A7_1_C2_4,D_5_HOS_C5_51,D_4_IRF_C2_200,S5_C1_7,D_4_HOS_C11_53,A_C6_6250,D3_HOS_C3_74,D3_SNF_C3_60,G_C1THRU4_12,C_1_C5_56,C_1_C5_64,B_1_C21_35,D_3_HOS_C9_30,D3_IRF_C3_73,A_C6_69,S3_2_C6_42,D_4_HOS_C13_63,S3_1_C8_6,A7_1_C7_6,A_C1_109,D_4_HOS_C4_66,S5_C5_2,B_1_C22_45,D3_SNF_C2_202,D1_HOS_C1_52,D4_ISLET_C1_69,S3_3_C4_1,S4_HHA3_C5_34,B_1_C0_74,S3_1_C4_11,S3_2_C6_1402,D_4_HOS_C2_51,D3_IPF_C2_53,D_4_HOS_C1_53,D_5_HOS_C7_73,A_C6_19,D3_SNF_C2_74,S3_2_C2_27,D_4_IRF_C13_63,C_1_C6_9910,D3_SNF_C3_90,S2_1_C2_12,B_2_C26_31,D_4_HOS_C2_74,A_C1_13,D_4_HOS_C2_50,D_5_HOS_C3_70,D_4_HOS_C10_72,D_4_HOS_C13_65,D_5_HOS_C3_90,S3_2_C4_31,D_5_HOS_C4_74,B_1_C26_33,D3_IRF_C2_91,B_1_C0_89,C_1_C6_116,S3_1_C7_13,A_C6_100,C_1_C7_100,A_C2_8,D3_HOS_C2_75,D3_IPF_C3_72,A7_1_C1_6,B_1_C21_66,S3_1_C10_25,A7_1_C5_5,A7_1_C3_1,A_C2_97,B_2_C26_106,D3_SNF_C3_67,D3_IPF_C2_66,D3_IRF_C3_200,D1_SNF_C1_84,B_1_C0_110,B_2_C26_110,D_1_HOS_C7_32,S3_1_C11_24,S3_1_C3_7,D3_HOS_C3_70,D_4_IRF_C11_67,B_2_C26_44,D_4_IPF_C11_91,S5_C2_1,G_C1THRU4_45,S3_1_C8_19,S3_2_C4_2552,S3_2_C6_11,E_B_HOS_C1_13,A_C6_42,B_1_C0_8,D3_IPF_C2_72,D_4_IRF_C6_200,A8_C2_28,S10_C1_6,A_C2_89,S3_2_C4_2551,G_C1THRU4_49,G2_C1_28,D3_IRF_C2_66,S2_1_C2_36,B_1_C22_68,D3_HOS_C3_96,A7_1_C7_3,D_4_HOS_C12_97,D_4_SNF_C11_90,D_4_HOS_C13_76,S4_HHA3_C3_33,C_1_C5_109,D_4_HOS_C11_68,G2_C2_28,D_4_IPF_C11_68,D3_IRF_C2_58,B_1_C22_35,D3_HOS_C2_32,D_4_HOS_C12_50,D_5_HOS_C4_76,B_1_C26_109,A_C1_192,B_1_C26_91,C_1_C7_115,A_C6_56,D_4_HOS_C10_69,D_4_IRF_C13_53,D_4_IRF_C13_64,D_4_HOS_C4_67,D_3_HOS_C9_32,S3_1_C5_16,C_1_C7_75,C_1_C6_9920,B_1_C0_93,A8_C2_11,D_4_IPF_C13_90,S3_2_C4_21,ST_CTY_CD,S10_C1_13,B_1_C26_64,D_4_HOS_C3_51,D3_IPF_C2_58,G_C1THRU4_11,D_4_HOS_C11_76,G3_C1_1,D_5_HOS_C3_52,D3_SNF_C2_63,D3_HOS_C3_90,B_2_C26_34,UTIL_CODE,S2_1_C1_3601,D3_HOS_C3_97,S5_C6_1,B_1_C26_100,B_1_C22_90,E_B_HOS_C1_27,S4_HHA3_C5_36,A_C1_56,B_1_C22_34,D_4_SNF_C11_66,S2_1_C2_1808,D_4_HOS_C3_71,S3_2_C2_20,S3_1_C10_26,D_4_HOS_C13_9201,A7_1_C7_4,D_4_HOS_C13_73,S2_1_C2_1519,B_2_C26_117,D_4_HOS_C2_90,S4_HHA1_C3_36,B_1_C26_106,S3_3_C2_2,S4_HHA2_C1_34,B_1_C26_58,S2_1_C2_143,B_1_C0_5,D_5_HOS_C7_94,S3_1_C10_21,S3_2_C4_2201,D_4_HOS_C13_64,B_1_C21_72,A_C6_114,C_1_C6_88,D_4_IPF_C13_9201,D_4_IRF_C11_90,D_4_HOS_C11_64,D3_IPF_C2_71,A_C6_1,D_5_HOS_C7_50,D_4_HOS_C2_72,D_4_IRF_C11_59,D_5_HOS_C4_66,A7_1_C2_7,D_1_HOS_C6_200,D_4_HOS_C12_73,A7_3_C15_1,D_4_HOS_C13_57,D_5_HOS_C5_76,C_1_C7_66,D3_SNF_C3_93,A7_1_C3_3,D_4_HOS_C2_63,S10_C1_27,B_1_C21_192,A_C2_200,S3_1_C15_16,D_4_IPF_C11_75,E_B_HOS_C101_5,S2_1_C2_14,C_1_C6_91,G_C1THRU4_52,S2_1_C2_1804,S3_2_C5_16,A7_1_C5_4,S4_HHA2_C5_34,C_1_C6_9201,C_1_C5_34,B_2_C26_73,A_C2_115,A_C1_12,D_4_IPF_C11_64,D_5_HOS_C5_200,A7_3_C9_3,B_1_C26_31,D_4_IRF_C11_58,D3_IPF_C2_54,S3_2_C4_2553,A_C1_94,D_5_HOS_C4_72,D3_IPF_C2_73,S2_1_C2_1503,A_C6_68,S3_2_C4_7,B_2_C26_4201,B_1_C0_10,D3_IRF_C3_69,B_1_C26_42,S4_HHA3_C1_34,D3_HOS_C2_40,D_5_HOS_C3_65,S2_1_C2_1202,A_C6_50,C_1_C7_9940,C_1_C5_60,D_4_SNF_C11_56,D_4_HOS_C13_70,D3_IPF_C2_55,S5_C1_10,A_C6_9,S3_1_C3_1,B_1_C26_32,C_1_C7_61,S3_1_C8_26,D_4_IPF_C11_66,C_1_C5_201,A_C2_15,S2_1_C1_116,C_1_C7_110,D_5_HOS_C3_95,D3_HOS_C2_73,C_1_C6_70,S3_1_C9_21,B_1_C26_71,D_4_HOS_C3_64,S5_C4_6,E_B_HOS_C1_36,E_B_HOS_C1_15,E_B_HOS_C1_35,B_2_C26_66,D_4_IRF_C11_62,D_4_IRF_C13_73,D_5_HOS_C2_96,E_B_HOS_C1_34,B_1_C21_106,D_4_HOS_C2_60,D_5_HOS_C7_53,A7_3_C7_1,D_4_HOS_C11_69,S3_2_C4_2550,S4_HHA1_C4_34,D3_HOS_C3_64,B_2_C26_89,S4_HHA2_C2_37,A_C1_17,S3_1_C13_16,D_4_HOS_C13_50,D_4_IPF_C13_51,D3_HOS_C3_51,A_C6_192,D3_HOS_C2_33,D3_HOS_C3_72,A_C2_9930,D_3_HOS_C9_40,S3_1_C2_9,D3_IRF_C2_63,S3_1_C10_24,B_1_C26_61,S3_2_C2_5,C_1_C5_57,D_4_HOS_C4_91,D_5_HOS_C2_9201,G_C1THRU4_53,G_C1THRU4_9,D_5_HOS_C5_53,S2_1_C1_106,B_1_C21_41,D_4_IPF_C2_200,B_1_C0_106,D_3_HOS_C9_41,S3_1_C15_17,D3_SNF_C2_71,A8_C2_30,A_C6_17,D1_SNF_C1_85,S3_1_C5_8,D_5_HOS_C6_55,D_5_HOS_C5_50,D_4_IRF_C13_62,S2_1_C2_1605,S4_HHA2_C2_35,S10_C2_20,D_4_HOS_C13_90,D_5_HOS_C2_69,D3_SNF_C2_31,G_C1THRU4_37,D3_SNF_C2_65,FI_CREAT_DT,D_4_HOS_C11_59,D_4_HOS_C12_51,D_4_HOS_C11_67,A_C1_51,A_C2_18,S3_1_C2_1,B_1_C21_76,B_1_C22_53,S4_HHA1_C5_38,B_1_C26_190,C_1_C7_111,D_5_HOS_C7_93,D_4_IRF_C13_69,B_1_C21_100,B_2_C26_91,B_1_C22_58,D3_HOS_C3_59,A_C2_45,B_1_C21_98,S3_1_C15_21,D_5_HOS_C3_96,D_4_HOS_C3_55,D_4_HOS_C13_62,D_4_SNF_C11_71,D_4_HOS_C4_65,D_4_HOS_C2_58,A_C1_6250,S5_C6_4,D3_IPF_C2_42,D3_SNF_C3_9201,D_1_HOS_C7_35,A_C1_20,D_4_IRF_C13_59,A7_1_C1_4,C_1_C7_88,S3_2_C2_18,D1_IPF_C1_49,S3_2_C6_12,S3_2_C2_26,A_C2_4501,D_4_IRF_C13_90,D3_IPF_C2_74,S3_1_C11_20,D_5_HOS_C7_74,D3_IRF_C3_74,A_C1_117,D_5_HOS_C7_90,S3_3_C6_1,D_5_HOS_C4_69,S3_2_C2_4,E_B_HOS_C1_43,D_4_IPF_C13_70,B_1_C26_191,C_1_C5_62,D_4_HOS_C2_73,C_1_C5_4501,A7_1_C1_7,B_1_C0_100,S3_2_C2_14,D_4_IRF_C13_75,S3_3_C6_4,S4_HHA2_C4_37,D3_HOS_C3_58,D3_IRF_C2_65,B_1_C0_109,B_1_C0_9,C_1_C7_68,A8_C2_27,A_C1_93,S2_1_C2_1505,A_C2_56,D3_HOS_C3_66,A_C2_194,S5_C1_8,A_C2_57,C_1_C6_31,S3_2_C4_33,S3_2_C2_13,A_C1_74,G_C1THRU4_19,A_C1_98,D_4_HOS_C4_73,D_4_HOS_C4_68,B_2_C26_111,S3_1_C8_28,S5_C2_9,C_1_C5_30,S3_1_C10_27,C_1_C6_41,G_C1THRU4_25,S3_2_C4_28,C_1_C7_97,B_1_C21_64,D3_SNF_C2_62,B_1_C26_202,S3_1_C2_8,D3_HOS_C2_42,D3_HOS_C3_68,C_1_C5_90,C_1_C7_6250,G_C1THRU4_36,C_1_C5_69,D_5_HOS_C3_73,C_1_C7_95,G3_C1_2,D_4_HOS_C4_54,D3_IRF_C3_53,S3_2_C2_23,S3_2_C5_41,S4_HHA2_C4_33,A_C6_53,D_4_SNF_C13_73,D_4_IPF_C11_65,D_5_HOS_C6_6250,D_5_HOS_C7_57,D_5_HOS_C6_67,S3_2_C6_8,D3_HOS_C2_57,C_1_C7_93,G_C1THRU4_34,D_4_HOS_C12_60,S5_C1_12,S4_HHA2_C2_33,C_1_C5_41,D_4_HOS_C3_67,S4_HHA2_C3_38,D_5_HOS_C7_65,C_1_C5_66,D3_HOS_C2_69,D3_SNF_C2_91,A_C6_4501,D_5_HOS_C6_96,S4_HHA3_C3_38,S3_1_C2_12,C_1_C6_44,D_4_HOS_C3_68,B_1_C21_90,D3_IPF_C2_50,D3_IPF_C3_70,A_C1_106,G_C1THRU4_44,D_4_HOS_C4_56,D_5_HOS_C7_67,B_2_C26_64,C_1_C6_55,C_1_C7_9920,S2_1_C2_15,S3_1_C13_14,B_1_C22_192,B_2_C26_109,S4_HHA3_C3_35,S3_1_C5_19,A_C6_109,D3_IRF_C2_40,C_1_C5_75,D_5_HOS_C6_52,S3_1_C7_2,S3_1_C8_18,D3_IPF_C2_67,S10_C1_16,B_1_C26_66,G_C1THRU4_54,D_5_HOS_C6_73,B_1_C26_110,D_4_HOS_C4_57,S3_1_C7_9,S2_1_C2_1001,B_2_C26_30,D3_SNF_C2_41,D3_HOS_C3_50,B_1_C22_108,B_1_C26_105,S3_1_C7_25,A7_3_C11_2,S3_2_C4_15,A_C2_73,C_1_C7_91,D1_HOS_C1_54,D3_IRF_C2_41,D_4_HOS_C6_200,D_4_IPF_C13_200,D_5_HOS_C2_97,D_4_IRF_C13_56,B_1_C0_94,D_4_HOS_C12_66,D3_HOS_C2_65,S3_1_C2_19,B_2_C26_90,S2_1_C2_132,C_1_C6_75,D_5_HOS_C4_68,A_C6_58,C_1_C6_40,D_4_HOS_C1_200,C_1_C6_112,D3_IRF_C3_61,S2_1_C2_1518,C_1_C6_51,D3_IPF_C3_9201,B_1_C26_107,S5_C1_15,B_1_C21_115,A_C6_46,D_1_HOS_C6_34,S3_2_C2_6,S2_1_C1_125,D3_SNF_C2_9201,E_B_HOS_C101_7,D_4_IPF_C13_60,D_4_IRF_C11_53,S3_2_C6_6,C_1_C7_72,D1_IPF_C1_48,S3_2_C5_36,B_1_C0_52,D_4_HOS_C3_200,D3_IPF_C2_96,A_C6_117,A_C6_2,B_1_C21_101,D_5_HOS_C3_91,A8_C2_5,B_1_C0_44,D3_IPF_C3_63,C_1_C5_97,C_1_C5_73,S3_2_C4_22,D_4_IPF_C13_64,D_4_HOS_C10_90,D_5_HOS_C3_59,D_4_IRF_C13_71,S3_2_C2_1,S3_2_C6_27,S4_HHA2_C4_38,S10_C3_20,S3_1_C2_11,A_C2_107,S3_1_C7_24,A_C2_19,A_C6_91,A_C2_66,B_1_C22_99,A7_1_C6_7,D_4_IRF_C13_66,D_5_HOS_C3_94,B_1_C0_9201,S5_C4_3,B_2_C26_191,B_1_C0_17,D_4_HOS_C10_60,S5_C1_2,S10_C1_31,D_3_HOS_C9_35,S2_1_C1_35,D_4_IRF_C13_51,C_1_C6_57,B_1_C0_18,D_4_HOS_C13_56,D1_HOS_C1_53,E_B_HOS_C1_3,C_1_C2_68,A_C6_190,A7_3_C10_1,B_1_C21_43,D3_HOS_C3_65,B_1_C0_58,A_C6_96,D3_HOS_C2_58,D_4_HOS_C3_94,D_5_HOS_C3_68,B_2_C26_116,D_4_IRF_C13_91,D_5_HOS_C7_6250,D_5_HOS_C4_96,D_1_HOS_C7_30,A7_1_C5_10,C_1_C6_52,D_5_HOS_C2_60,C_1_C5_67,D3_IPF_C2_35,G_C1THRU4_1,S3_2_C5_14,A_C2_60,D3_HOS_C2_54,S3_1_C10_22,S3_1_C12_1,C_1_C5_70,A_C2_98,D_4_SNF_C11_65,S3_1_C8_12,D_4_HOS_C10_52,A_C2_4201,D3_IPF_C3_67,D_5_HOS_C7_98,C_1_C5_51,G_C1THRU4_15,D_4_HOS_C3_65,D_4_HOS_C10_73,D_5_HOS_C5_97,D_4_IRF_C13_54,B_1_C21_58,D_5_HOS_C2_91,A_C2_109,D_4_IPF_C11_59,D3_SNF_C2_96,D3_SNF_C3_200,D4_LUNG_C1_69,G3_C1_29,A_C6_3,D_5_HOS_C3_69,D3_HOS_C2_6250,D_4_IRF_C13_55,A_C1_46,D_5_HOS_C5_70,B_1_C0_63,A_C6_115,A_C2_12,C_1_C6_99,S5_C2_7,D_4_HOS_C12_91,A7_3_C9_2,B_2_C26_76,B_1_C22_33,B_1_C26_75,S2_1_C2_24,S3_2_C2_24,D_4_HOS_C11_50,B_2_C26_46,A7_3_C6_3,D3_SNF_C2_51,S2_1_C2_2,D_5_HOS_C3_97,A_C6_105,B_1_C0_4,D_4_IPF_C3_200,B_1_C26_52,S3_2_C5_26,B_1_C21_59,D_5_HOS_C2_68,A_C2_191,B_1_C0_190,A_C1_200,E_B_HOS_C1_19,D_5_HOS_C6_60,D_4_HOS_C2_97,D_4_HOS_C3_90,D3_IRF_C2_76,D_1_HOS_C4_43,B_1_C21_21,S3_1_C10_14,S3_1_C11_22,D3_IPF_C3_50,S3_1_C12_16,S2_1_C4_2,D3_HOS_C2_72,S4_HHA2_C3_33,S4_HHA1_C1_38,D_5_HOS_C5_74,A_C2_51,D3_SNF_C3_63,B_2_C26_190,D_5_HOS_C5_58,D1_HOS_C1_57,C_1_C6_93,S3_2_C4_20,A7_1_C5_1,B_1_C26_43,A8_C2_6,E_B_HOS_C1_8,D3_IPF_C3_54,S2_1_C1_1,B_1_C21_73,S3_2_C5_15,C_1_C7_108,D_4_HOS_C12_52,A_C2_9920,D_4_HOS_C11_9201,D_4_SNF_C11_91,A7_3_C6_2,B_1_C22_30,E_B_HOS_C1_24,D_4_SNF_C11_53,S3_2_C2_8,A7_1_C5_8,S3_2_C6_2,B_1_C0_6250,D3_IPF_C3_68,S3_2_C4_5,E_B_HOS_C1_42,S3_1_C8_15,S3_2_C2_2550,B_2_C26_33,C_1_C5_46,A_C2_88,S3_2_C6_40,D3_IRF_C3_67,B_1_C22_73,A7_1_C1_2,D_5_HOS_C3_67,STATE,D3_SNF_C3_72,D3_SNF_C2_70,S3_1_C8_14,A7_1_C2_5,B_1_C22_31,E_A_HOS_C1_7094,D_4_HOS_C3_50,S3_2_C5_31,A_C2_116,D_4_IRF_C13_72,D_4_HOS_C11_56,D_5_HOS_C3_62,B_1_C26_41,D_3_HOS_C6_200,D_4_HOS_C2_91,S3_2_C4_14,D_4_HOS_C3_91,D_5_HOS_C3_76,S2_1_C2_1509,D_4_SNF_C11_70,D_4_HOS_C10_57,S4_HHA3_C4_37,A_C6_33,B_1_C0_23,D_5_HOS_C7_64,D_4_HOS_C3_98,D4_HEART_C1_69,S2_1_C2_1504,S3_1_C4_12,S2_1_C1_140,D_5_HOS_C6_70,B_2_C26_60,S3_2_C4_34,A_C1_112,D3_IPF_C2_76,B_1_C26_44,D3_IPF_C3_51,S3_2_C3_24,B_1_C0_31,D_5_HOS_C5_55,D3_IPF_C2_68,D_5_HOS_C4_58,B_1_C26_76,G_C1THRU4_27,S3_1_C8_2001,C_1_C7_56,A_C2_6,D_4_IPF_C11_90,S2_1_C2_1516,D3_SNF_C2_67,S3_2_C5_27,B_1_C26_73,B_2_C26_63,S3_1_C4_8,C_1_C5_200,B_1_C0_107,B_1_C0_200,B_1_C22_9201,D_4_HOS_C4_52,S3_2_C4_39,S3_1_C9_24,C_1_C5_106,D_5_HOS_C3_63,D3_IRF_C2_52,D_4_HOS_C2_98,B_1_C0_95,D3_IRF_C3_52,D_5_HOS_C4_64,A_C1_88,C_1_C5_52,D_4_SNF_C11_64,D3_IRF_C3_56,S3_1_C14_17,S3_2_C5_37,S3_2_C2_43,S4_HHA2_C3_34,D_1_HOS_C6_33,C_1_C7_101,D_4_HOS_C4_71,S3_2_C5_5,A_C1_8,S3_2_C2_39,S3_1_C14_1,S3_3_C5_4,D3_IPF_C2_57,S3_2_C5_34,B_1_C0_91,S10_C1_2701,A_C6_60,A_C2_41,D_4_HOS_C11_55,B_1_C0_96,D_4_HOS_C12_74,S3_2_C2_1402,B_2_C26_201,D_5_HOS_C5_73,E_B_HOS_C1_39,B_1_C0_35,C_1_C5_95,S3_2_C6_14,B_1_C26_60,A_C2_99,S3_2_C5_8,B_2_C26_67,D_5_HOS_C2_51,G3_C1_3,A_C2_55,C_1_C6_9940,D_4_HOS_C12_63,D_4_IRF_C11_56,A_C1_64,C_1_C2_65,B_1_C0_98,D_4_HOS_C4_72,D3_HOS_C2_62,D3_SNF_C2_52,B_1_C0_97,A_C1_9,D3_IRF_C3_55,D_5_HOS_C2_75,S3_2_C2_1401,A8_C2_15,D_5_HOS_C6_75,B_1_C0_115,D_5_HOS_C4_75,A8_C2_21,B_1_C26_116,D_4_HOS_C13_75,A_C1_34,S3_1_C5_11,D_4_HOS_C13_59,D3_HOS_C2_41,B_2_C26_41,A8_C2_10,S2_1_C2_1,D_4_HOS_C10_58,A_C6_64,D_4_IPF_C11_62,D_4_HOS_C3_96,D_4_IPF_C11_55,D_4_HOS_C11_94,D_4_HOS_C13_52,D_5_HOS_C4_94,D_4_HOS_C12_65,D_4_HOS_C4_74,A_C6_200,E_A_HOS_C1_7099,S3_1_C7_17,D3_IRF_C2_90,A_C2_42,S2_1_C3_143,S3_2_C5_39,B_1_C22_76,D_4_HOS_C13_54,D_4_IRF_C13_68,S2_1_C2_1602,D_5_HOS_C7_96,D_4_IPF_C11_60,D3_IRF_C3_71,A_C1_6,C_1_C6_96,A_C6_21,S2_1_C2_1607,B_1_C26_63,D_4_HOS_C3_72,A_C6_44,A_C6_61,D3_SNF_C2_34,D_5_HOS_C3_98,A_C6_67,S2_1_C1_3801,B_1_C0_30,D3_HOS_C2_71,D_4_IPF_C11_54,A_C1_116,S3_1_C5_20,B_2_C26_107,C_1_C6_202,D3_IPF_C3_56,B_2_C26_32,E_B_HOS_C1_25,D_4_HOS_C12_53,D_4_HOS_C13_97,D3_HOS_C2_31,D_5_HOS_C6_50,D1_HOS_C5_43,S3_3_C5_1,S3_2_C5_3,G_C1THRU4_30,B_1_C22_116,D_5_HOS_C5_63,D_4_HOS_C10_55,D3_HOS_C2_52,S2_1_C2_127,D3_HOS_C3_56,A7_3_C9_1,S3_1_C2_27,D_4_IRF_C11_52,B_1_C26_72,C_1_C5_107,D3_SNF_C2_54,D_4_SNF_C11_63,D_4_HOS_C4_60,D_3_HOS_C5_200,D_4_IPF_C13_71,B_1_C0_59,A_C2_67,S2_1_C2_1501,D_5_HOS_C4_93,D3_SNF_C2_66,S3_2_C6_36,A7_1_C7_7,E_B_HOS_C1_3998,B_1_C22_98,D_5_HOS_C5_91,S3_1_C6_7,D_5_HOS_C2_66,A_C1_30,A_C2_76,C_1_C5_35,S3_2_C6_28,S3_2_C4_26,A_C1_90,D_4_HOS_C13_71,D3_HOS_C3_67,S3_2_C2_33,D_5_HOS_C4_56,A_C1_23,D_4_IPF_C11_50,D3_IRF_C3_60,D1_HOS_C1_27,D3_HOS_C3_200,D1_HOS_C1_62,S4_HHA3_C4_34,A8_C2_29,D_5_HOS_C2_72,G_C1THRU4_7,A7_3_C15_3,C_1_C6_33,D_4_IRF_C11_65,S5_C2_3,S4_HHA1_C2_34,C_1_C5_58,S3_1_C3_32,D_4_IPF_C13_66,D1_HOS_C1_58,FY_BGN_DT,A7_1_C5_7,B_1_C21_65,A_C6_59,C_1_C5_50,A_C6_94,C_1_C7_57,C_1_C6_35,A_C1_89,G_C1THRU4_23,D_4_HOS_C2_69,S2_1_C2_128,D1_HOS_C1_26,S2_1_C2_129,S3_2_C2_34,A_C2_68,A_C2_32,D3_IRF_C2_50,C_1_C6_45,D3_IRF_C2_64,D_1_HOS_C4_33,D_4_SNF_C11_72,B_1_C21_191,B_1_C26_9201,A8_C2_13,C_1_C6_109,A7_1_C5_3,D_4_HOS_C2_64,D_4_IPF_C13_54,D3_IPF_C2_70,D_4_HOS_C2_54,S3_2_C2_12,S3_2_C6_26,C_1_C7_73,S2_1_C1_4,S4_HHA1_C4_33,S4_HHA3_C4_36,D_5_HOS_C3_75,B_1_C21_194,B_2_C26_202,A_C6_23,E_B_HOS_C1_33,S10_C3_22,A_C2_43,D1_IPF_C1_37,B_1_C0_55,D1_IPF_C1_52,D_4_IPF_C13_69,D3_IRF_C2_94,B_1_C0_66,D_1_HOS_C7_31,D3_IRF_C2_32,D1_IRF_C1_51,A_C1_59,D_4_SNF_C11_50,S2_1_C2_18,B_1_C0_117,D3_IPF_C3_93,S3_1_C7_18,S2_1_C2_1401,A_C6_75,S4_HHA2_C2_34,D_5_HOS_C2_70,S4_HHA2_C5_37,B_1_C26_97,A7_1_C7_8,B_1_C21_109,D_4_HOS_C2_57,D_4_IPF_C13_73,A8_C2_12,S3_1_C13_2,B_1_C26_193,B_1_C26_51,B_1_C0_9940,A_C1_9940,C_1_C5_33,D_4_HOS_C11_52,B_1_C0_60,D3_HOS_C2_66,C_1_C6_117,D3_IRF_C2_53,D_4_HOS_C13_60,B_1_C0_50,D_4_IRF_C11_51,D_4_IPF_C13_55,D3_IRF_C3_65,A_C6_57,S3_2_C3_22,D_4_HOS_C4_64,D_1_HOS_C4_34,D_4_SNF_C11_52,A_C1_60,D3_IPF_C3_73,E_B_HOS_C1_37,B_1_C0_61,B_1_C26_93,B_1_C22_62,B_1_C26_50,D_5_HOS_C7_70,D_4_HOS_C12_96,D1_HOS_C5_45,S3_1_C2_2001,S3_1_C3_19,D_4_HOS_C11_93,S4_HHA2_C1_38,S3_2_C3_14,D_5_HOS_C2_54,D_5_HOS_C6_65,D_4_IPF_C13_67,A_C6_112,B_1_C0_193,S3_3_C4_2,D_5_HOS_C5_98,D3_SNF_C2_75,A_C2_58,B_2_C26_51,D3_IPF_C3_58,C_1_C6_59,D3_IPF_C3_74,D_4_IPF_C13_76,B_2_C26_108,D3_SNF_C3_53,RPT_STUS_CD,D1_HOS_C1_63,B_1_C21_60,A_C2_95,B_1_C22_193,S4_HHA3_C2_38,S2_1_C2_1523,S2_1_C2_1520,A7_1_C7_2,A_C1_4201,B_1_C0_51,D_1_HOS_C6_32,D_5_HOS_C6_90,B_1_C26_67,D_5_HOS_C2_94,E_B_HOS_C1_22,D_4_HOS_C11_98,A_C1_5,S5_C4_4,B_1_C0_64,B_1_C26_99,D3_IRF_C3_51,S5_C1_14,A7_3_C15_2,S3_1_C7_20,D_4_IRF_C11_93,A7_1_C2_1,A_C2_6250,S2_1_C2_1514,A_C2_108,S3_1_C8_7,D3_IRF_C2_70,A_C2_93,D_4_HOS_C2_65,S4_HHA1_C3_35,S3_1_C3_1801,A8_C2_8,B_1_C22_100,C_1_C6_97,A_C1_9201,D_1_HOS_C6_35,S10_C1_1,S3_2_C5_7,D3_IRF_C3_63,A_C1_35,C_1_C7_99,D_5_HOS_C2_98,D_4_HOS_C13_91,D_5_HOS_C2_57,D3_HOS_C2_97,D3_IRF_C3_70,S4_HHA3_C3_34,D_5_HOS_C3_57,D3_IPF_C3_76,D3_IRF_C2_96,D3_IRF_C3_96,D3_HOS_C2_93,D3_IRF_C3_75,A7_1_C4_7,S4_HHA2_C1_35,A8_C2_7,TRNSMTL_NUM,S2_1_C2_8,B_1_C0_32,S3_2_C5_40,D_5_HOS_C6_91,D_4_HOS_C3_59,S3_2_C4_1,D_4_IPF_C13_63,S3_1_C6_19,S2_1_C2_17,B_1_C22_70,FFY,Hospital Type (From CMS Hospitals Data Archive),Name and Num
,Curated Name and Num,Hospital type (modified),Type of Control of Hospital (See Table I),Lon,Lat,Speech Pathology,"Medicare certified kidney 
transplant center cert date","If Line 32, Col 1 is yes, enter the method used: (A, B, or E only)",Whole Blood & Packed Red Blood Cells,OOT,Ratio of line 15 to line 16,Stand-alone CHIP -- Costs minus net revenue (0 min),Anesthesiology,FQHC,Sequestration adjustment,Impl. Dev. Charged to Patients,Adults and Pediatrics,Emergency,Other Ancillary,Burn Intensive Care Unit,Other Outpatient Services,Line 2 times line 5,Adults and Pediatrics,MDH status beginning date (MM/DD/YY),Hospice 3 Provider Number,Surgical Intensive Care Unit,Other Ancillary,Ambulance Services,"Blood Storing, Processing, Trans",Observation Beds (Distinct Unit),Total Visits,Electrocardiology,FQHC,Electroencephalography,Pass through Cost for Program Inpatient Routine,Drugs Charged to Patients,Renal Dialysis,Subprovider II,MRI,"Number of patients on transplant 
list",Subtotal,Temporary Investments,Operating Room,ASC (Non Distinct Part),Other Reimbursable,Program Inpatient Ancillary Service Cost,Intensive Care Unit,Investment Income-New Bldgs & Fixtures,Other Ancillary,Total Non Routine Medical  Supply Charges,Is this a rural hospital qualifying for an exception to the certified registered nurse anesthetist the CRNA fee schedule? (Y/N),Subprovider-IPF,Maintenance and Repairs,Whole Blood & Packed Red Blood Cells,"Blood Storing, Processing, Trans",PEP Episodes:  Total Number of Episodes,Home Program Dialysis,CT Scan,Surgical Intensive Care Unit,Laundry and Linen Service,With Outliers:  Total Charges,Total Hospital Interns & Residents,OOT,Total,FQHC 5 Provider Number,Subprovider I,IRF,Electrocardiology,Payments received from patients for amounts previously written off as charity care,Impl. Dev. Charged to Patients,Speech Pathology,Renal Dialysis,Hospice,Drugs Charged to Patients,Radiology-Diagnostic,Other Organ Acquisition,OPT,Total Hospital,Coronary Care Unit,Lung  Acquisition,Other Outpatient Services,Radiology-Therapeutic,ICF,Intravenous Therapy,CT Scan,Operating Room,Nursing School,Total,Int & Res (non approved teaching program,NF,Respiratory Therapy,Notes and Loans Payable (short term),Physician Part A,Adults and Pediatrics,Recovery Room,Other Reimbursable,"Number of patients in program at 
end of cost reporting period",Cardiac Catheterization,CMHC,Total Other Medical Education,Hospital Adlts & Ped Swing Bed SNF,Total Other Medical Education,Other Reimbursable,Intravenous Therapy,Other General Service,Laboratory,Occupational Therapy,Respiratory Therapy,Nursing Administration,Central Services and Supply,NF,Clinic,Operation of Plant,RHC,Other Organ Acquisition,Intensive Care Unit,Medicare Certified Pancreas TC term date,Medical Records and Medical Rec. Library,Physical Therapy,"Blood Storing, Processing, Trans",Census Division Code,Other Ancillary,CMHC,ASC (Non Distinct Part),CT Scan,FI/Contractor's Name,Home Office:  Physician Part A,Interns & Res Salary and Fringe Benefits,Other Ancillary,Recovery Room,New Capital Equipment,Surgical Intensive Care Unit,Surgical Intensive Care Unit,Home Program Dialysis,Coronary Care Unit,Radiology-Diagnostic,Speech Pathology,Hospice,Subprovider I,Surgical Intensive Care Unit,Heart Acquisition,OSP,Electroencephalography,Drugs Charged to Patients,Other Ancillary,Other Special Care Unit,ASC (Distinct Part),Observation Beds (Distinct Unit),Drugs Charged to Patients,Coronary Care Unit,Other Reimbursable,Impl. Dev. Charged to Patients,Total Other Medical Education Cost,Nonpaid Workers,Delivery Room and Labor Room,Other Reimbursable,Other Outpatient Services,Physical Therapy,ASC (Non Distinct Part),CORF,Organ Procurement,FQHC,OOT,Other Outpatient Services,Other Special Care Unit,Laboratory,Delivery Room and Labor Room,Home Office Street,Other Ancillary,Radiology-Therapeutic,IPPS Payment amount (unadjusted),HHA,Medical Records and Medical Rec. Library,MRI,Intensive Care Unit,MDH status ending date (MM/DD/YY),Ambulance Services,OPT,Other Ancillary,Cost of patients approved for charity care and uninsured discounts,Radiology-Diagnostic,Coronary Care Unit,HHA,Total discharges,"Gift, Flower, Coffee Shop, Canteen",Mortgage Payable,"Number of Times per week 
Patient receives Dialysis",Radiology-Therapeutic,"If this Hospital is claiming cost for renal services on Worksheet A, are they inpatient services only? (Y/N)",Other Reimbursable,Other Special Care Unit,NF,Other Outpatient Services,Impl. Dev. Charged to Patients,"Blood Storing, Processing, Trans",Other Outpatient Services,Electroencephalography,Emergency,Subprovider II,OPT,Total,Speech Pathology,Impl. Dev. Charged to Patients,Radiology-Therapeutic,Building Improvements,Other Organ Acquisition,Surgical Intensive Care Unit,Electroencephalography,CORF,Central Services and Supply,Recovery Room,Renal Dialysis,Drugs Charged to Patients,ASC 1 Provider Number,Surgical Intensive Care Unit,Nursing Administration,Total Costs,OOT,Title XVIII discharges,Land Improvements,"Number of patients in program at 
end of cost reporting period",Ending Date of SCH status,CORF,Target Amount,Speech Pathology,Anesthesiology,Whole Blood & Packed Red Blood Cells,Total discharges,Electroencephalography,RHC/FQHC Combined,RHC,Other Special Care,CT Scan,Interns & Residents,Coronary Care Unit,New Cap Related Csts Movable Equipment,Speech Pathology,Laboratory,Subtotal Salaries,Housekeeping under Contract,Radiology-Diagnostic,Ambulance Services,Whole Blood & Packed Red Blood Cells,Cardiac Catheterization,HHA,Operating Room,ASC (Distinct Part),"Blood Storing, Processing, Trans",Impl. Dev. Charged to Patients,Emergency,ASC (Non Distinct Part),Total Hospital,RHC 16 Provider Number,Payments received from patients for amounts previously written off as charity care,Observation Beds (Distinct Unit),Durable Medical Equipment Rented,Nursing School,Notes Receivable,Heart Acquisition,Central Services and Supply,Blood Clotting Factors for Hemoph.,Prepaid expenses,Drugs Charged to Patients,Total Number of Outlier Episodes,Radiology-Therapeutic,Electrocardiology,RHC/FQHC Combined,Islet Acquisition,Durable Medical Equipment Sold,Wage Related Costs RHC/FQHC,Speech Pathology,Renal Dialysis,PBP Clinical Lab Services Program Only,Administrative and General,Durable Medical Equipment Sold,Radioisotope,Observation Beds (Distinct Unit),Respiratory Therapy,FQHC,Blood Clotting Factors for Hemoph.,RHC 8 Provider Number,Hospice,Blood Clotting Factors for Hemoph.,Radiology-Therapeutic,Nonpaid Workers,Premiums,FQHC,"Blood Storing, Processing, Trans",PBP Clinical Lab Services Program Only,CT Scan,Non-Physician Anesthetist Part B,Other Reimbursable,Ambulance Services,OLTC,Other General Service,IRF,Electrocardiology,Excluded Area Salaries,Renal Dialysis,Dietary,RHC,Radiology-Therapeutic,Recovery Room,Electrocardiology,Recovery Room,City,Non-Physician Part B,Anesthesiology,Vending Machines,Blood Clotting Factors for Hemoph.,Other Ancillary,Other Nonreimbursable,Respiratory Therapy,Occupational Therapy,ICF,Radiology-Therapeutic,Other Reimbursable,Total,Emergency,Renal Dialysis,Other Reimbursable,NF,Subprovider 2,Contract Labor,Subtotal Salaries,PEP:  Total Non Routine Med Supply Chgs,PEP:  Total Number of Outlier Episodes,Delivery Room and Labor Room,Social Service,Operating Room,Interns & Res Salary and Fringe Benefits,Clinic,Recovery Room,"Blood Storing, Processing, Trans",Speech Pathology,SNF,CT Scan,Other Ancillary,CT Scan,Electrocardiology,Total,Burn Intensive Care Unit,Medical Supplies Charged to Patients,Whole Blood & Packed Red Blood Cells,Interns & Residents,Liver Acquisition,Cafeteria,Whole Blood & Packed Red Blood Cells,Home Office Salaries,Other Organ Acquisition,Impl. Dev. Charged to Patients,Operating Room,Home Program Dialysis,Total,Excluded Area Salaries,Cardiac Catheterization,Buildings and Fixtures,OPT,Other Outpatient Services,Observation Beds (Distinct Unit),Other Reimbursable,Home Office Salaries,MRI,Blood Clotting Factors for Hemoph.,Impl. Dev. Charged to Patients,Housekeeping under Contract,Medical Supplies Charged to Patients,Cardiac Catheterization,ASC (Distinct Part),Physical Therapy,ICF,Speech Pathology,Without Outliers:  Non Routine Med Sup Chgs,Does the hospital qualify as RPCH/CAH? (Y/N),CT Scan,Cost of charity care (uninsured patients + patients w/ coverage not accepted by provider),Land,net of Swing Bed and Private Room Diff,Dietary under Contract,Laboratory,Medical Supplies Charged to Patients,Cardiac Catheterization,Title V discharges,Total Facility FTEs,Operation of Plant,Employee Benefits,Non-Physician Anesthetist Part A,With Outliers:  Non Routine Med Sup Chgs,Subprovider II,Laboratory,Subprovider-IRF,Total Hospital Interns & Residents,Physical Therapy,Total,Other Ancillary,Surgical Intensive Care Unit,Without Outliers:  Total Charges,Medical Supplies Charged to Patients,Observation Beds (Distinct Unit),New Cap Related Csts Movable Equipment,CT Scan,Cafeteria employees and guests,Interns & Residents,"Blood Storing, Processing, Trans",Unsecured Loans,Nursing Administration,Liver Acquisition,SNF,CMHC,Radioisotope,Other Outpatient Services,Subtotal,Total,Impl. Dev. Charged to Patients,Total,IRF Provider Number,Subprovider 1,Radioisotope,SNF,Total,IRF,"Number of Times per week
 Patient receives Dialysis",Clinic,Hospital Type,Sale of medical records and abstracts,Occupational Therapy,Total Program General Inp. Rtn Service,Durable Medical Equipment Sold,RHC,Accounts Receivable,Surgical Intensive Care Unit,Excluded Area Salaries,Total Long-term Liabilities,Total Visits,Speech Pathology,Radiology-Diagnostic,Radiology-Diagnostic,Drugs Charged to Patients,RHC 9 Provider Number,Anesthesiology,Leasehold Improvements,Anesthesiology,Durable Medical Equipment Rented,Subprovider-IRF,Coronary Care Unit,Recovery Room,Physical Therapy,Total Other Assets,Cafeteria,Whole Blood & Packed Red Blood Cells,Operation of Plant,Medical and Other Services reimbursed by OPPS,Subprovider 1,Respiratory Therapy,Electroencephalography,Radiology-Diagnostic,CMHC,Hospital Zip Code,Number of periods hospital was in MDH status,Impl. Dev. Charged to Patients,RHC 25 Provider Number,Anesthesiology,Other Nonreimbursable,Durable Medical Equipment Rented,ASC (Non Distinct Part),Radiology-Diagnostic,Impl. Dev. Charged to Patients,ICF,Coronary Care Unit,Impl. Dev. Charged to Patients,Renal Dialysis,New Cap Related Csts Bldg & Fixtures,Total Overhead Costs,ASC (Non Distinct Part),Emergency,ASC (Non Distinct Part),Subtotal Wage Related Csts,Total Bad Debt expense,Occupational Therapy,Cardiac Catheterization,Subprovider-IRF,Maintenance and Repairs,W/Out Outliers:  Number of Episodes,Electrocardiology,Total,MRI,Nonpaid Workers,Intravenous Therapy,Total discharges,HHA,Maintenance of Personnel,Radiology-Diagnostic,Dietary,FQHC,PEP Episodes:  Total Charges:,Home Program Dialysis,ASC (Non Distinct Part),Medical Records & Med Records Library,Medical Supplies Charged to Patients,Drugs Charged to Patients,Other Outpatient Services,HHA,Physicians' Private Office,Nursery,Title XIX discharges,Observation Beds (Distinct Unit),Home Program Dialysis,Emergency,Radiology-Therapeutic,Impl. Dev. Charged to Patients,Deductibles and coinsurance related to line 24,Home Program Dialysis,Subprovider-IRF,Hospital Adults & Pediatrics,"Percentage of patients re-using
dialyzers",Is this hospital an All-Inclusive rate provider? (Y/N),Radiology-Diagnostic,Operating Room,Int & Res (non approved teaching program,Speech Pathology,Housekeeping,Radiology-Therapeutic,Operating Room,Total,RPCH/CAH Visits,Operation of Plant,CT Scan,Nursing Administration,Liver Acquisition,Radioisotope,Kidney Acquisition,FQHC 7 Provider Number,"Anesthetist, and Medical Education Costs",Laboratory,Total Hospital,Occupational Therapy,Total,Adults and Pediatrics,Intravenous Therapy,Program Inpatient Ancillary Service Cost,Organ Procurement,Liver Acquisition,Total Inpatient Program Days,Title XVIII discharges,Intravenous Therapy,Other Capital,Recovery Room,Intensive Care Unit,Delivery Room and Labor Room,Nursing School,Home Program Dialysis,Medical Supplies Charged to Patients,Respiratory Therapy,Cost of charity care,Intestinal Acquisition,Other Special Care Unit,RHC,Excluded Area Salaries,CORF,Lung  Acquisition,ASC (Distinct Part),Hospice,MRI,Utilization Review SNF,Cardiac Catheterization,Occupational Therapy,OLTC,Other Organ Acquisition,HHA,Electroencephalography,Target Amount per Discharge,Subprovider I,SNF,Recovery Room,Laundry and Linen Service,Nonphysician Anesthetists,Clinic,Burn Intensive Care Unit,RHC/FQHC Combined,Hospital Adults & Pediatrics,Radioisotope,RHC 3 Provider Number,Title XIX discharges,Durable Medical Equipment Sold,ASC (Non Distinct Part),Electrocardiology,Subprovider-IPF,Electrocardiology,HMO,Management and Administrative Services,Other Outpatient Services,Physician-Part A,Liver Acquisition,Whole Blood & Packed Red Blood Cells,Lung  Acquisition,Recovery Room,Non-Physician Anesthetist Part B,Clinic,Delivery Room and Labor Room,Sale of medical and surgical supplies to,Cardiac Catheterization,Electroencephalography,Drugs Charged to Patients,Emergency,Other Special Purpose,Physical Therapy,Burn Intensive Care Unit,Nursing Administration,Fixed Equipment,ASC (Non Distinct Part),Blood Clotting Factors for Hemoph.,Electroencephalography,Home Program Dialysis,Laboratory,Intravenous Therapy,Other Nonreimbursable,PBP Clinical Lab Services Program Only,Kidney Acquisition,Home Office Salaries,Interim payments,Social Service,Electroencephalography,Number of stations,Medical Supplies Charged to Patients,Subtotal Wage Related Csts,Without Outliers:  Total Visits,Nursery,Coronary Care Unit,Subprovider-IPF,Whole Blood & Packed Red Blood Cells,ASC (Non Distinct Part),Interns & Residents,Coronary Intensive Care Unit,Hospital Adults & Ped Swing Bed SNF,Title XIX discharges,Total Program Inpatient Costs,Whole Blood & Packed Red Blood Cells,Islet Acquisition,Anesthesiology,Radiology-Therapeutic,OLTC,Impl. Dev. Charged to Patients,Renal Dialysis,Stand-alone CHIP Charges (Gross Revenue),Interns & Res Other Program Costs,Administrative and General under Contract,CT Scan,Respiratory Therapy,Physical Therapy,Paid Losses,Liver Acquisition,Adults & Pediatrics,Electroencephalography,Subprovider-IPF,Have you established a new subprovider excluded unit under 42 CFR 413.40(f)(1)(I)?(Y/N),"Medical certified liver 
transplant center cert date",PEP Episodes:  Total Number of Episodes,Laboratory,Renal 10 Provider Number,Urban (1) or Rural (2),"Does the facility qualify and is it receiving payments for 
disproportionate share? (Y/N)",Delivery Room and Labor Room,Medicaid HMO Days,Speech Pathology,Total,Radiology-Therapeutic,Total Hospital,Respiratory Therapy,Radiology-Therapeutic,Intestinal Acquisition,"Blood Storing, Processing, Trans","Gift, Flower, Coffee Shop, Canteen",Respiratory Therapy,OLTC,Total charges to state or local government programs for indigent care (not Medicaid or CHIP),Paramedical Education,Whole Blood & Packed Red Blood Cells,Radiology-Therapeutic,Lung  Acquisition,Subtotal Salaries,Renal Dialysis,"Number of Times per week
 Patient receives Dialysis",Blood Clotting Factors for Hemoph.,Respiratory Therapy,Radiology-Diagnostic,IPF,Total Subprovider II Interns & Residents,Other Special Care Unit,Medical Supplies Charged to Patients,Subtotal,Payment to cost ratio,Respiratory Therapy,Operating Room,Labor and Delivery Days -  Title XIX,OLTC,IPF,OLTC,Maintenance of Personnel,Average times dialyzers re-used,Medical Supplies Charged to Patients,Operating Room,Medical Records and Medical Rec. Library,CT Scan,Net Income from Service to Patients,Intestinal Acquisition,Other General Service,IPF,With Outliers:  Number of Episodes,SNF,Interns & Residents,Home Program Dialysis,Electrocardiology,Coronary Care Unit,Subprovider-IPF,Radiology-Diagnostic,Pass Through Cost for  Program Ancillary,Medical Supplies Charged to Patients,Utilization Review SNF,Primary payer payments,MRI,Nursery,Cross Foot Adjustments,Radioisotope,"Blood Storing, Processing, Trans","Blood Storing, Processing, Trans",Total,Heart Acquisition,Emergency,Wage Related Costs Core,Surgical Intensive Care Unit,Impl. Dev. Charged to Patients,Drugs Charged to Patients,Total,Operating Room,Renal 4 Provider Number,OSP,CT Scan,net of Swing Bed and Private Room Diff,Clinic,Payroll taxes payable,Observation Beds (Distinct Unit),Whole Blood & Packed Red Blood Cells,RHC 18 Provider Number,Related Salaries,Delivery Room and Labor Room,Burn Intensive Care Unit,Radiology-Therapeutic,Radiology-Diagnostic,Administrative and General,Electroencephalography,Laboratory,Other Special Care,Subprovider II,PBP Clinical Lab Services Program Only,Physical Therapy,Cafeteria,SNF,"Number of patients in program at 
end of cost reporting period",Electroencephalography,Operating Room,Clinic,Emergency,Occupational Therapy,Total Charges:  LUPA Episodes,Other Organ Acquisition,Other Ancillary,Wage Related Costs Core,Clinic,CORF,Anesthesiology,Speech Pathology,Ancillary service charges,Medical Supplies Charged to Patients,Total Hospital,Surgical Intensive Care Unit,Physicians' Private Office,Other Special Care Unit,Total Allied Health,Other Outpatient Services,CMHC,Nursery,Ambulance Services,Admin & Gen Under Contract,Occupational Therapy,Subprovider-IRF,Respiratory Therapy,Total costs for patients covered by a state or local government program,Electroencephalography,Hospice,Total Non Routine Medical  Supply Charges,Occupational Therapy,HHA,Whole Blood & Packed Red Blood Cells,Transitional corridor payment,Total customary charges,Whole Blood & Packed Red Blood Cells,Maintenance of Personnel,Int & Res (non approved teaching program,Title XVIII discharges,Physical Therapy,Radiology-Diagnostic,Medical Supplies Charged to Patients,Intensive Care Unit,"Medical certified lung
transplant center cert date",Renal Dialysis,Radioisotope,Total,Operating Room,MRI,ASC (Non Distinct Part),Subtotal,Kidney Acquisition,Laboratory,Cardiac Catheterization,Electroencephalography,MDH status ending date (MM/DD/YY),Durable Medical Equipment Sold,Respiratory Therapy,Radiology-Diagnostic,Physical Therapy,Other Outpatient Services,Emergency,Whole Blood & Packed Red Blood Cells,PEP:  Total Non Routine Med Supply Chgs,Cardiac Catheterization,Emergency,Electroencephalography,Islet Acquisition,Physical Therapy,NF,Occupational Therapy,Hospital Adlts & Ped Swing Bed SNF,Fixed Equipment,Home Office Personnel,IPF Provider Number,Total Hospital,Other Outpatient Services,Nursery,MRI,Respiratory Therapy,Radioisotope,CORF,Durable Medical Equipment Rented,Total Overhead Costs,Total reasonable charges,Operation of Plant,Other Special Purpose,"Is this a teaching hospital or
affiliated with a teaching hospital? (Y/N)",FQHC,Burn Intensive Care Unit,Non-Physician Anesthetist Part A,Drugs Charged to Patients,Cardiac Catheterization,Related Salaries,Islet Acquisition,Clinic,Cost of physicians svcs in a teaching hospita,Durable Medical Equipment Rented,Intravenous Therapy,Burn Intensive Care Unit,Labor and Delivery Days Title 18,Electrocardiology,RHC,Dietary,OLTC,CT Scan,Occupational Therapy,Respiratory Therapy,Physician Part B,Non-Physician Part B,Durable Medical Equipment Rented,Other Organ Acquisition,Anesthesiology,Other Special Purpose,Delivery Room and Labor Room,"Gift, Flower, Coffee Shop, Canteen",Blood Clotting Factors for Hemoph.,Total,FQHC,ASC (Non Distinct Part),Subprovider-IRF,Observation Beds (Distinct Unit),Delivery Room and Labor Room,Urban/Rural Indicator at beginning,Cost of patients approved for charity care and uninsured discounts,Negative Cost Centers,Radioisotope,"Number of Times per week
 Patient receives Dialysis",Radioisotope,Contract Labor:  Physician Part A,Home Office Name,"Gift, Flower, Coffee Shop, Canteen",ASC (Non Distinct Part),Renal Dialysis,NF Provider Number,Other Ancillary,Physical Therapy,Excluded Areas,Report Record Number,Housekeeping,Other Reimbursable,Land Improvements,Medical Supplies Charged to Patients,Contract Labor,Subtotal Wage Related Csts,Electrocardiology,Radioisotope,Intravenous Therapy,Cross Foot Adjustments,Intestinal Acquisition,Whole Blood & Packed Red Blood Cells,Excluded Areas,Other Nonreimbursable,Impl. Dev. Charged to Patients,Occupational Therapy,Other Organ Acquisition,Intravenous Therapy,Laboratory,Other Outpatient Services,SNF,Adults & Pediatrics,Without Outliers:  Total Visits,Lung  Acquisition,W/Out Outliers:  Number of Episodes,In State Medicaid paid days,HHA,Other Ancillary,RHC 14 Provider Number,Renal Dialysis,Stand-alone CHIP cost,NF,NF,Radiology-Therapeutic,Renal Dialysis,Coronary Care Unit,OLTC,Other Medicaid Days,Heart Acquisition,Medical Supplies Charged to Patients,Cost of charity care (patients covered by public program + patients w/ coverage accepted by provider),Interns & Res Other Program Costs,Operating Room,MRI,Durable Medical Equipment Rented,"Salaries, Wages, and Fees Payable",Electrocardiology,CT Scan,IPF,Nonpaid Workers,HHA,New Cap Related Csts Movable Equipment,Other Reimbursable,Social Service,Speech Pathology,LUPA Episodes:  Total Number of Episodes,Total Liabilities,Total Other Charges,Labor and Delivery Days -  Title XIX,Total,Electroencephalography,Anesthesiology,Delivery Room and Labor Room,Observation Beds (Distinct Unit),Movable Equipment,OOT,Teaching Physician Salaries,ASC (Non Distinct Part),Burn Intensive Care Unit,Radiology-Diagnostic,Other Ancillary,With Outliers:  Other Charges,Total Facility FTEs,Received DSH or supplemental payments from Medicaid? (Y/N),Laboratory,Total,OOT,Operation of Plant,Total,Subprovider-IRF,Total Hospital,Without Outliers:  Total Visits,New Cap Related Csts Bldg & Fixtures,Investment Income-New Movable Equip,SNF,ASC (Distinct Part),Dietary under contract,Medical Supplies Charged to Patients,Home Program Dialysis,Renal 8 Provider Number,Clinic,Occupational Therapy,ESRD DME costs,Organ Procurement,RHC 7 Provider Number,Surgical Intensive Care Unit,Emergency,HHA 2 Provider Number,Out of State Medicaid paid days,Utilization,ASC (Non Distinct Part),Burn Intensive Care Unit,Donations,Intestinal Acquisition,Utilization Review-physicians compens,Physician-Part A,LUPA:  Total Non Routine Med Sup Chgs,PEP Episodes:  Total Visits,Private grants or donations or endowment income restricted to funding charity care,Lung  Acquisition,"Blood Storing, Processing, Trans",Deferred Income,LUPA Episodes:  Total Number of Episodes,Does the facility operate an ICF/MR facility for purposes of Title XIX? (Y/N),Kidney Acquisition,Islet Acquisition,Fiscal Intermediary Number,"Blood Storing, Processing, Trans",Burn Intensive Care Unit,Total Hospital,Contract Labor:  Physician Part A,Radiology-Diagnostic,Excluded Area Salaries,Nonphysician Anesthetists,Intravenous Therapy,ASC (Non Distinct Part),Electrocardiology,Anesthesiology,Renal 7 Provider Number,Radiology-Diagnostic,Intensive Care Unit,Anesthesiology,Other Ancillary,MRI,Radiology-Therapeutic,Total,Interns & Residents,Cafeteria,Whole Blood & Packed Red Blood Cells,Other Ancillary,Physician-Part A,Interns & Residents,Intensive Care Unit,Total Subprovider I Interns & Residents,Total,Surgical Intensive Care Unit Program Cost,ASC (Non Distinct Part),"If an Organ Procurement Organization, enter the OPO number",Durable Medical Equipment Rented,Electrocardiology,Teaching Physician Salaries,Subprovider-IPF,Islet Acquisition,Cardiac Catheterization,IRF,Impl. Dev. Charged to Patients,Subprovider-IPF,"Blood Storing, Processing, Trans",New Capital Buildings and Fixtures,Total Charges,ASC (Non Distinct Part),SNF,With Outliers:  Total Charges,HHA,Radiology-Diagnostic,Home Program Dialysis,Total Program General Inpatient Routine,Outpatient Rehab Provider,OPT,ICF,"Sum of lines 3,4 divided by line 6",Housekeeping,Clinic,Other Ancillary,Kidney Acquisition,Radiology-Diagnostic,Blood Clotting Factors for Hemoph.,Hospital Adlts & Ped Swing Bed NF,Physicians' Private Office,Interns & Residents,Other Ancillary,"Blood Storing, Processing, Trans","Anesthetist, and Medical Education Costs",OOT,Delivery Room and Labor Room,net of Swing Bed Cost,Contract Labor,Emergency,Renal Dialysis,Intensive Care Unit,Drugs Charged to Patients,Adults & Pediatrics,"Blood Storing, Processing, Trans",Physician Part A Teaching,CT Scan,Land Improvements,Investment Income-Other,Recovery Room,Other Outpatient Services,Non-Physician Anesthetist Part B,"Net costs of Epoietin furnished to
all maintenance dialysis patients
by the provider",SNF Provider Number,Radioisotope,Total Subprovider I Interns & Residents,Other Outpatient Services,Blood Clotting Factors for Hemoph.,Cardiac Catheterization,Total,Operating Room,Burn Intensive Care Unit,Electrocardiology,CT Scan,CMHC,Medicare Certified Kidney TC term date,New Cap Related Csts Bldg & Fixtures,MRI,Ambulance Trips,ICF,Physician-Part B,CT Scan,Fixed Equipment,Central Services and Supply,Subtotal Other Wages and Related Csts,MSP-LCC reconciliation amount,Total Salaries,Laboratory,Maintenance of Personnel,Laboratory,Operation of Plant,Excluded Area Salaries,Renal Dialysis,Admin & Gen Under Contract,Emergency,Respiratory Therapy,Radioisotope,Other Special Purpose,Electrocardiology,Cardiac Catheterization,PBP Clinical Lab Services Program Only,Kidney Acquisition,Total Charges,MRI,Whole Blood & Packed Red Blood Cells,CT Scan,Home Program Dialysis,Hospital Provider Number,Nursing Administration,Teaching Physician Salaries,Durable Medical Equipment Rented,net of Swing Bed Cost,Burn Intensive Care Unit,Nursery,Occupational Therapy,Subprovider-IRF,Medical Supplies Charged to Patients,Cardiac Catheterization,Surgical Intensive Care Unit,Observation Beds (Distinct Unit),Observation Beds (Distinct Unit),Total cost,"Blood Storing, Processing, Trans",Number of stations,Land,Movable Equipment,Radiology-Therapeutic,Outlier payments,Management and Administrative Services,Subtotal,SNF,Laboratory,RPCH/CAH Visits,Ambulance Services,Int & Res (non approved teaching program,Subtotal Salaries,Delivery Room and Labor Room,Whole Blood & Packed Red Blood Cells,Adj for Speech therapy in excess of lim,Total Directly Assigned New Cap Rel Csts,Lesser of cost or charges,Hospice,Lung  Acquisition,Speech Pathology,Medical Records & Med Records Library,Occupational Therapy,Cardiac Catheterization,CT Scan,Total,MCP Physician Payment Method (Y/N),Laundry and Linen Service,Renal Dialysis,HVBP payment adjustment amount,Adj for Physical therapy costs in excess,Clinic,Medical Supplies Charged to Patients,Hospice,Intravenous Therapy,Other Ancillary,NF,Are provider based physicians' costs included in Worksheet A? (Y/N),Other Ancillary,Pass Through Cost for  Program Ancillary,Radiology-Therapeutic,Delivery Room and Labor Room,Hospital Adults & Pediatrics,RHC 22 Provider Number,Interns & Res Salary and Fringe Benefits,"Blood Storing, Processing, Trans",Whole Blood & Packed Red Blood Cells,Dietary under contract,Hospice,NF,Other Ancillary,Respiratory Therapy,Intensive Care Unit,Speech Pathology,Subprovider-IPF,Renal Dialysis,RHC,Observation Beds (Distinct Unit),Medical and Other Services,Total Charges,Non-Physician Anesthetist Part B,Physician Part A,certification date,Other Reimbursable,Protested amounts,Dietary,Home Program Dialysis,FQHC 9 Provider Number,Interest expense on Medicare Overpaymts,Intensive Care Unit,ICF,Other Special Care,Depreciation-New Bldgs & Fixtures,Ambulance Services,Home Program Dialysis,Recovery Room,Impl. Dev. Charged to Patients,Admin & Gen Under Contract,"Is this a New Hospital under
42 CFR 412.300 PPS capital
(Y/N)",Pharmacy,Electrocardiology,Total Visits,Other Special Purpose,Maintenance and Repairs,Subprovider I,"Blood Storing, Processing, Trans",Interns & Residents,Speech Pathology,PEP Episodes:  Total Charges:,Other Nonreimbursable,Impl. Dev. Charged to Patients,Total Nursing School,Does the hospital elect a fully prospective payment method for capital costs? (Y/N),CORF,CORF,Outpatient Rehab Provider,Observation Beds (Distinct Unit),Radiology-Diagnostic,Speech Pathology,With Outliers:  Number of Episodes,Medical Records & Med Records Library,Interns & Res Other Program Costs,Radiology-Diagnostic,Surgical Intensive Care Unit,Interns & Residents,Interns & Residents,Subprovider I,Medical Supplies Charged to Patients,Subprovider II,Pass through Cost for Program Inpatient,Organ acquisition,Hospital Adults & Pediatrics,Other Adjustments (Summed),ASC (Non Distinct Part),Cardiac Catheterization,Other Special Care Unit,New Capital Buildings and Fixtures,Ambulance Services,Intravenous Therapy,OSP,Intravenous Therapy,LUPA Episodes:  Other Charges,Total Charges,Other Nonreimbursable,Subprovider I,Medical Supplies Charged to Patients,Electrocardiology,Total unreimbursed cost for Medicaid and CHIP and state and local indigent care programs,Physician Part B,Delivery Room and Labor Room,Research,Other Reimbursable,RHC 11 Provider Number,Other Special Care,Initial Physician Payment Method (Y/N),Pancreas Acquisition,Out of State Medicaid eligible days,Other Outpatient Services,PBP Clinical Lab Services Program Only,Radioisotope,Renal 6 Provider Number,Observation Beds (Distinct Unit),Anesthesiology,TOTAL,Geographic MSA,Physical Therapy,Other Outpatient Services,Other Reimbursable,Other Reimbursable,Electroencephalography,Total Operating Expense,Non-Physician Anesthetist Part A,Administrative & General under contract,Delivery Room and Labor Room,Clinic,Coronary Care Unit,Subprovider 2,RHC,Nursery,Electrocardiology,Home Program Dialysis,FQHC 1 Provider Number,net of Swing Bed and Private Room Diff,OPT,Subprovider I,RHC,Coronary Care Unit,RHC 12 Provider Number,Central Services and Supply,With Outliers:  Total Visits,Renal 2 Provider Number,certification date,Government grants or appropriations or transfers for support of hospital operations,Laboratory,"Trade, Quantity, and Time Discounts",Research,New Capital Equipment,Int & Res (non approved teaching program,Physicians' Private Office,CT Scan,IRF,Title V discharges,Medical Supplies Charged to Patients,Other Reimbursable,Kidney Acquisition,Respiratory Therapy,MRI,Radiology-Therapeutic,Delivery Room and Labor Room,Medical Supplies Charged to Patients,Excess of reasonable cost over reasonable charges,FQHC 2 Provider Number,Observation Beds (Distinct Unit),Nursery,Employee Benefits,Buildings and Fixtures,MRI,Operating Room,MRI,Intensive Care Unit,Clinic,Investments,Other Ancillary,Electrocardiology,Kidney Acquisition,ICF,Physical Therapy,Speech Pathology,Other Special Care Unit,Emergency,Radioisotope,Adults and Pediatrics,Radioisotope,Radioisotope,Swing Bed SNF Provider Number,Other Outpatient Services,Land Improvements,SNF,Movable Equipment,Adults and Pediatrics,Heart Acquisition,"Blood Storing, Processing, Trans",Pharmacy,Without Outliers:  Other Charges,Renal Dialysis,Observation Beds (Distinct Unit),Occupational Therapy,Clinic,Subtotal Other Wages and Related Csts,Home Office:  Physician Part A,Hospital Adults & Pediatrics,Whole Blood & Packed Red Blood Cells,Observation Beds (Distinct Unit),or allied health costs?,Pass through Cost for Program Inpatient,Anesthesiology,Recovery Room,Anesthesiology,Net Salaries,Electroencephalography,Housekeeping,Cardiac Catheterization,PBP Clinical Lab Services Program Only,Radioisotope,Sale of drugs to other than patients,Subprovider I,Radioisotope,Total,Cardiac Catheterization,Labor and Delivery,Cardiac Catheterization,Delivery Room and Labor Room,MRI,Subprovider-IPF,Occupational Therapy,"Number of patients in program at 
end of cost reporting period",Wage Related Costs Other,Charity care charges and uninsured discounts for the entire facility,Net Revenue from stand-alone SCHIP,Self Insurance,Delivery Room and Labor Room,Impl. Dev. Charged to Patients,Clinic,HHA,Physical Therapy,Total Nonphysician Anesthetist Cost,Subprovider II,Fiscal Year End Date,Medical Supplies Charged to Patients,Total,Other Ancillary,Drugs Charged to Patients,Whole Blood & Packed Red Blood Cells,Electrocardiology,With Outliers:  Non Routine Med Sup Chgs,Medical Records and Medical Rec. Library,Radiology-Therapeutic,Blood Clotting Factors for Hemoph.,Electrocardiology,Contract Labor:  Physician Part A,NF,Subprovider-IPF,Intensive Care Unit,Observation Beds (Distinct Unit),Respiratory Therapy,Physical Therapy,IPPS Interim payment,Renal Dialysis,Total,SNF,Medical Supplies Charged to Patients,Burn Intensive Care Unit,Amounts expected under 42 CFR,Anesthesiology,Other Reimbursable,Kidney Acquisition,Whole Blood & Packed Red Blood Cells,Total Program Inpatient Costs,Cardiac Catheterization,Recovery Room,Intensive Care Unit,Anesthesiology,Cardiac Catheterization,Radiology-Therapeutic,Operation of Plant,IRF Provider Number,Nursery,Operating Room,Research,Anesthesiology,Hospice,Clinic,Operating Room,Surgical Intensive Care Unit,Other Reimbursable,Outlier payments,OSP,Operating Room,Nursery,Durable Medical Equipment Rented,Subprovider-IPF,Total Outpatient Program Pass Thru Cost,Operating Room,Medical and Other Services reimbursed by OPPS,Without Outliers:  Total Charges,Administrative and General,Observation Beds (Distinct Unit),Ancillary service other pass through costs,Emergency,Cafeteria,Other General Service,Subtotal,Subprovider-IPF,RHC/FQHC Combined,Intravenous Therapy,Recovery Room,Total Program Excludable Costs,Less: Allowances for uncollectible notes and accounts receivable,Renal 3 Provider Number,Pharmacy,Radiology-Diagnostic,SNF,Speech Pathology,Observation Beds (Distinct Unit),Radiology-Therapeutic,Total Program General Inpatient Routine,FQHC,Recovery Room,With Outliers:  Total Visits,Housekeeping,Maintenance of Personnel,Home Program Dialysis,OLTC,Hospital Name,Drugs Charged to Patients,CMS Region Code,Radiology-Therapeutic,Radiology-Diagnostic,Interns & Residents,Beginning Date of SCH status,Total Number of Episodes,Interest Expense,Coronary Care Unit,Cardiac Catheterization,Electrocardiology,ASC (Distinct Part),Intravenous Therapy,Total Other Medical Education,Emergency,TOTAL,OLTC,Anesthesiology,Dietary under Contract,NF,Other Special Purpose,Social Service,Impl. Dev. Charged to Patients,Anesthesiology,Adj for Respiratory therapy costs in excess,Hospital Title 18 Payment System (P/T/O),W/Out Outliers:  Number of Episodes,Anesthesiology,HHA,OSP,Blood Clotting Factors for Hemoph.,Total,Notes Payable,PEP Episodes:  Other Charges,PBP Clinical Lab Services Program Only,Parking Lot,Total Salaries,SNF,Delivery Room and Labor Room,Burn Intensive Care Unit,Emergency,Drugs Charged to Patients,Occupational Therapy,Cost of patients approved for charity care and uninsured discounts,Renal Dialysis,CMHC,Anesthesiology,Is this a New Hospital under 42 CFR 413.40(f)(1)(I) (TEFRA)? (Y/N),RHC,Net Revenue from Medicaid,Total Overhead Costs,Radiology-Diagnostic,Medical Supplies Charged to Patients,Interns & Res Other Program Costs,"Average patient dialysis time 
including setup",Durable Medical Equipment Rented,Home Office PO Box,NF,Other Outpatient Services,Observation Beds (Distinct Unit),Total Number of Outlier Episodes,Interest Expense,Organ Procurement,Burn Intensive Care Unit,Other General Service,Intravenous Therapy,Islet Acquisition,Respiratory Therapy,Pharmacy,MRI,Electroencephalography,Speech Pathology,Total Program General Inpatient Routine,OPPS payments,RHC 23 Provider Number,Nonpaid Workers,Physical Therapy,Renal Dialysis,"Average patient dialysis time 
including setup",Islet Acquisition,Nursing School,Medical Supplies Charged to Patients,Total Other Expenses,Whole Blood & Packed Red Blood Cells,Radioisotope,"Number of days in year dialysis 
furnished",ASC (Non Distinct Part),Radiology-Diagnostic,Employee Benefits,Cafeteria,Total Allied Health Cost,Hospital City,MRI,Durable Medical Equipment Sold,Delivery Room and Labor Room,IPF,Operating Room,Intensive Care Unit,Number of stations,Whole Blood & Packed Red Blood Cells,Cost of Uncompensated Care,Provider's actual MSA or CBSA,Teaching Physician Salaries,PEP Episodes:  Total Charges:,Radioisotope,Total Income,Line 2 times line 5,Subprovider-IPF,OOT,Renal Dialysis,Teaching Physician Salaries,Electrocardiology,Whole Blood & Packed Red Blood Cells,Laboratory,Total Other Income,Total Number of Episodes,MRI,Other Outpatient Services,Radioisotope,Subprovider 2,Total Adults & Peds,Other Outpatient Services,Home Program Dialysis,Cardiac Catheterization,Total,Anesthesiology,Coronary Care Unit Program Cost,HHA,CT Scan,RHC 13 Provider Number,Total,Laboratory,Other Outpatient Services,"Medicare certified heart
transplant center cert date",TOTAL,CT Scan,Home Program Dialysis,ASC (Non Distinct Part),Pancreas Acquisition,Other Outpatient Services,Medical Supplies Charged to Patients,FQHC 4 Provider Number,Recovery Room,Total,"Number of days in year dialysis 
furnished",Anesthesiology,Whole Blood & Packed Red Blood Cells,Nursing Administration,MRI,Speech Pathology,Renal Dialysis,Intravenous Therapy,Drugs Charged to Patients,Other Reimbursable,interns and residents,Intestinal Acquisition,LUPA Episodes:  Total Visits,Research,Pharmacy,Recovery Room,Subprovider-IPF,Physical Therapy,Building Improvements,Recovery Room,Total Nursing School,"Treatment capacity per day per
station",Anesthesiology,Blood Clotting Factors for Hemoph.,Renal Dialysis,Laboratory,Land,Radioisotope,Intravenous Therapy,Other Special Care Unit,Adults & Pediatrics,Drugs Charged to Patients,Electrocardiology,Social Service,"Blood Storing, Processing, Trans",Hospital Adlts & Ped Swing Bed NF,Movable Equipment,Pancreas Acquisition,Physical Therapy,"Number of days in year dialysis 
furnished",NF,TOTAL,Total Program Excludable Costs,Organ Procurement,Net Salaries,Total Other Charges,Renal Dialysis,Surgical Intensive Care Unit,Related Salaries,Recovery Room,Anesthesiology,Anesthesiology,Drugs Charged to Patients,Nonphysician Anesthetists,Renal Dialysis,Administrative and General,"Blood Storing, Processing, Trans",CORF,Clinic,HHA 1 Provider Number,Intensive Care Unit,Renal Dialysis,Nursing Administration,Operating Room,Electroencephalography,Impl. Dev. Charged to Patients,Respiratory Therapy,Clinic,Laundry and Linen Service,Renal Dialysis,Burn Intensive Care Unit,Emergency,FQHC,Hospice,Nursery,Int & Res (non approved teaching program,Int & Res (non approved teaching program,Laundry and Linen Service,ASC (Non Distinct Part),Impl. Dev. Charged to Patients,Movable Equipment,Physical Therapy,Outpatient Rehab Provider,Fixed Equipment,Land,Durable Medical Equipment Sold,Heart Acquisition,Occupational Therapy,Physical Therapy,TOTAL,Program Ancillary Services,Intestinal Acquisition,Intestinal Acquisition,Coronary Intensive Care Unit,Hospice,Total Hospital,Electroencephalography,Occupational Therapy,SNF,Emergency,"Number of patients in program at 
end of cost reporting period",Total Current Liabilities,SNF,Interns & Residents,Contract Labor,Organ acquisition charges,Subprovider I,Laundry and Linen Service,Impl. Dev. Charged to Patients,Total Outpatient Program Pass Thru Cost,Non-physician Anesthetist,Medicaid charges,FQHC,Interns & Residents,Other Long-term Liabilities,Inpatient Revenue,Physical Therapy,Ending Date of SCH status,Speech Pathology,Durable Medical Equipment Rented,Buildings and Fixtures,Durable Medical Equipment Sold,Clinic,Other Ancillary,LUPA Episodes:  Total Visits,Pancreas Acquisition,Speech Pathology,Outpatient Revenue,Speech Pathology,MRI,Other Special Care Unit,Coronary Care Unit,Operating Room,Other Ancillary,Pancreas Acquisition,Physicians' Private Office,Emergency,ASC (Distinct Part),Radioisotope,Electrocardiology,Anesthesiology,Intravenous Therapy,Occupational Therapy,Coronary Care Unit,IPF,ASC (Non Distinct Part),OPT,Other Outpatient Services,"Sale of scrap, waste, etc.",Clinic,Non-Physician Anesthetist Part B,SSA State County Code,Net revenue from state/local govt indigent care (not Medicaid or CHIP),Intravenous Therapy,Recovery Room,MRI,Total Current Assets,Other Ancillary,Gross Revenue,Delivery Room and Labor Room,"Blood Storing, Processing, Trans",Clinic,Surgical Intensive Care Unit,Utilization Code (L/N/F),Beginning Date of SCH status,Durable Medical Equipment Sold,"Number of patients in program at 
end of cost reporting period",Int & Res (non approved teaching program,Clinic,Subtotal,Total Number of Episodes,Radioisotope,Surgical Intensive Care Unit,Physical Therapy,Renal 9 Provider Number,Medical Supplies Charged to Patients,Non-Physician Anesthetist Part A,RHC/FQHC Combined,Observation Beds (Distinct Unit),Building Improvements,Drugs Charged to Patients,RHC 20 Provider Number,Other Special Purpose,Clinic,LUPA Episodes:  Total Number of Episodes,Heart Acquisition,Excluded Area Salaries,Without Outliers:  Other Charges,MRI,State,Administrative and General,Home Program Dialysis,OLTC,Physician Part A Teaching,Intravenous Therapy,Impl. Dev. Charged to Patients,Utilization Review SNF,RHC,Observation Beds (Distinct Unit),Clinic,Intravenous Therapy,Medical Supplies Charged to Patients,New Capital Buildings and Fixtures,Operating Room,Impl. Dev. Charged to Patients,Cardiac Catheterization,Physical Therapy,Purchase,Total,Drugs Charged to Patients,New Cap Related Csts Bldg & Fixtures,CT Scan,Other Ancillary,Physical Therapy,Other Outpatient Services,Buildings and Fixtures,"Blood Storing, Processing, Trans",Medicare reimbursable bad debts for the entire hospital complex,Physicians' Private Office,Total Salaries,Total discharges,ASC (Non Distinct Part),Payment to cost ratio,Hospice 1 Provider Number,Emergency,General Fund Balance,Renal 5 Provider Number,Teaching Physician Salaries,Building Improvements,Total Other Charges,Observation Beds (Distinct Unit),Surgical Intensive Care Unit,Drugs Charged to Patients,ASC (Distinct Part),Maintenance of Personnel,Intravenous Therapy,Total,Total,Intensive Care Unit,MRI,Radiology-Diagnostic,Interns & Residents,Home Program Dialysis,Impl. Dev. Charged to Patients,Drugs Charged to Patients,RHC 4 Provider Number,Speech Pathology,Interns & Residents,Subprovider II,Dietary,Electrocardiology,Subprovider I,Without Outliers:  Other Charges,Subprovider-IPF,Respiratory Therapy,HHA 3 Provider Number,Operating Room,OSP,Laboratory,Radioisotope,Electroencephalography,Radiology-Therapeutic,"Percentage of patients re-using
dialyzers",Housekeeping,Hospital Adults & Pediatrics,Coronary Care Unit,PBP Clinical Lab Services Program Only,RHC/FQHC Combined,Physical Therapy,Less Observation Beds,Pharmacy,Is this hospital classified as a referral center? (Y/N),Intestinal Acquisition,Ambulance Services,Drugs Charged to Patients,Electroencephalography,OLTC,Medical Supplies Charged to Patients,Intravenous Therapy,Number of stations,Allowable bad debts for dual eligibles beneficiaries,Aggregate amount collected from patients,Adjusted reimburseable bad debts,Physical Therapy,Whole Blood & Packed Red Blood Cells,Drugs Charged to Patients,Durable Medical Equipment Rented,Allowable bad debts,Heart Acquisition,Laboratory,Anesthesiology,New Cap Related Csts Bldg & Fixtures,Electrocardiology,Interns & Residents,PEP Episodes:  Other Charges,Intravenous Therapy,FQHC,With Outliers:  Number of Episodes,Social Service,Title XVIII discharges,Operating Room,Recovery Room,Recovery Room,Physicians' Private Office,Burn Intensive Care Unit,Impl. Dev. Charged to Patients,OOT,Subprovider-IPF,Coronary Care Unit,"Blood Storing, Processing, Trans",Hospice,PBP Clinical Lab Services Program Only,Physician-Part B,CT Scan,Emergency,Observation Beds (Distinct Unit),Total Fund Balances,Other Current Assets,Anesthesiology,"If this facility qualifies as a RPCH/CAH, has it elected the all inclusive payment for outpatient service? (Y/N)",Subprovider-IRF,Total Nursing School,Heart Acquisition,Subprovider-IRF,Total discharges,Medical Supplies Charged to Patients,Adj for Occupational therapy in excess of li,Social Service,Utilization Review - Physician Compen,Intensive Care Unit,Radiology-Therapeutic,Operating Room,Whole Blood & Packed Red Blood Cells,FQHC 6 Provider Number,With Outliers:  Total Charges,Charity care charges and uninsured discounts for the entire facility,Clinic,Electrocardiology,Intensive Care Unit,Accounts Payable,Respiratory Therapy,Fiscal Intermediary/MAC Create Date,Cardiac Catheterization,Recovery Room,Occupational Therapy,Recovery Room,Other General Service,Hospital Adults & Pediatrics,Other Ancillary,Anesthesiology,Total Non Routine Medical  Supply Charges,"Gift, Flower, Coffee Shop, Canteen",Islet Acquisition,Other Outpatient Services,Electrocardiology,Int & Res (non approved teaching program,Emergency,MRI,Cardiac Catheterization,NF,Other Reimbursable,Total discharges,Durable Medical Equipment Rented,Radiology-Therapeutic,Whole Blood & Packed Red Blood Cells,Medical Supplies Charged to Patients,Respiratory Therapy,MRI,Blood Clotting Factors for Hemoph.,CAPD exchanges per day,Subprovider I,Observation Beds (Distinct Unit),Other Special Care Unit,Nursing School,Cardiac Catheterization,Building Improvements,RHC,Wage Related Costs Other,Total Program Inpatient Costs,Management and Administrative Services,Employee Benefits,ICF,Clinic,Renal Dialysis,NF,Renal Dialysis,Renal Dialysis,Other Special Purpose,Clinic,Net Salaries,Electrocardiology,Physician-Part A,Balance due provider/program,Electroencephalography,Research,Whole Blood & Packed Red Blood Cells,Drugs Charged to Patients,ICF,Begin Balance,Int & Res (non approved teaching program,Home Office Salaries & Wage Related Csts,ASC (Non Distinct Part),Subtotal Other Wages and Related Csts,PEP:  Total Number of Outlier Episodes,MRI,Respiratory Therapy,Pancreas Acquisition,Housekeeping,Speech Pathology,Depreciation-New Movable Equipment,Other Outpatient Services,RHC 6 Provider Number,Radioisotope,Physical Therapy,Other Nonreimbursable,Utilization,CT Scan,Intensive Care Unit,Housekeeping under contract,Contract Labor: Pysician Part A,Renal Dialysis,Fixed Equipment,Other Reimbursable,Drugs Charged to Patients,Speech Pathology,Islet Acquisition,Medicaid Observation Days,Average times dialyzers re-used,Adults & Pediatrics,Total Facility FTEs,Subprovider-IRF,Minor Equipment Depreciable,Administrative & General under contract,Durable Medical Equipment Sold,Intravenous Therapy,Whole Blood & Packed Red Blood Cells,Total,Intensive Care Unit,Subprovider I,Speech Pathology,Clinic,Blood Clotting Factors for Hemoph.,Total Assets,Electrocardiology,Drugs Charged to Patients,Ambulance Services,Less Contractual Allowance and Discounts on Patients' Accounts,Radiology-Diagnostic,Anesthesiology,Physician Part B,Medical Records & Med Records Library,PEP Episodes:  Total Visits,Anesthesiology,Drugs Charged to Patients,Respiratory Therapy,Blood Clotting Factors for Hemoph.,CT Scan,Occupational Therapy,Home Office Personnel,CT Scan,Other Outpatient Services,Other Assets,Laboratory,"Number of patients transplanted 
during fiscal year",With Outliers:  Total Visits,Subprovider-IRF,Occupational Therapy,LUPA:  Total Non Routine Med Sup Chgs,Respiratory Therapy,Physical Therapy,Electrocardiology,Emergency,ICF,Durable Medical Equipment Rented,LUPA:  Total Non Routine Med Sup Chgs,Other Special Care,SNF,Speech Pathology,Clinic,Operating Room,Electroencephalography,Heart Acquisition,Other Current Liabilities,Radioisotope,Occupational Therapy,Intravenous Therapy,Radiology-Therapeutic,OPT,RHC 1 Provider Number,Title XVIII discharges,Physicians' Private Office,Pancreas Acquisition,Total Charges:  LUPA Episodes,SNF,Pancreas Acquisition,Subprovider-IRF,ASC (Non Distinct Part),Delivery Room and Labor Room,HMO,Subprovider 1,Occupational Therapy,State or local govt (not Medicaid or CHIP) -- Costs minus net revenue (0 min),Physical Therapy,Total Liabilities and Fund Balances,Drugs Charged to Patients,Intestinal Acquisition,CT Scan,Coronary Care Unit,ICF Provider Number,Adults & Pediatrics,Subprovider-IRF,Operating Room,Lung  Acquisition,Kidney Acquisition,Outpatient Rehab Provider,New Cap Related Csts Movable Equipment,Home Office:  Physician Part A,Drugs Charged to Patients,Emergency,Program Discharges,Subprovider-IRF,Total Outpatient Program Pass Thru Cost,Total,Durable Medical Equipment Sold,Radioisotope,Home Program Dialysis,Physical Therapy,Respiratory Therapy,SNF,Clinic,Medicare Certified Islet TC term date,ASC (Non Distinct Part),Speech Pathology,MRI,Subprovider-IPF,Total,Other Organ Acquisition,PBP Clinical Lab Services Program Only,RHC 19 Provider Number,Recovery Room,Observation Beds (Distinct Unit),Liver Acquisition,Number of EPO units furnished for Line 13,ASC (Distinct Part),OLTC,Surgical Intensive Care Unit,Non-Physician Part B,"Does this facility operate 
transplant center? (Y/N)",Observation Beds (Distinct Unit),"Sum of lines 3,4 divided by line 6",Laboratory,Anesthesiology,Non-Physician Part B,Impl. Dev. Charged to Patients,Program Inpatient Ancillary Service Cost,Cafeteria,Delivery Room and Labor Room,Total Allied Health,Durable Medical Equipment Rented,Other Special Purpose,New Capital Equipment,HHA,Emergency,Refunds and Rebates of Expenses,SNF,"Blood Storing, Processing, Trans",Durable Medical Equipment Sold,Drugs Charged to Patients,Physician Part A,Intravenous Therapy,Clinic,Cardiac Catheterization,Medical Supplies Charged to Patients,Total Salaries,Administrative and General,PEP:  Total Non Routine Med Supply Chgs,Charity care charges and uninsured discounts for the entire facility,Surgical Intensive Care Unit,Liver Acquisition,Hospice,Nonphysician Anesthetists,Emergency,Physical Therapy,CMHC,Ending Balance,Physical Therapy,Home Program Dialysis,Observation Beds (Distinct Unit),"Average patient dialysis time 
including setup",Research,Social Service,Laboratory,Number of Times per week Patient receives Dialysis,Total unreimbursed and uncompensated care,Other Special Care Unit,"If (SCH), enter the # of periods.",Recovery Room,CT Scan,Other General Service,Radioisotope,"Anesthetist, and Medical Education Costs",OPPS payments,Speech Pathology,"Gift, Flower, Coffee Shop, Canteen",New Cap Related Csts Bldg & Fixtures,Nursery,Respiratory Therapy,MRI,Durable Medical Equipment Rented,MRI,Home Program Dialysis,Speech Pathology,Hospice,Emergency,Blood Clotting Factors for Hemoph.,Durable Medical Equipment Rented,Adults & Pediatrics,Total,Delivery Room and Labor Room,Laboratory,Occupational Therapy,Other Special Care Unit,Cash on Hand and in Banks,Home Office Salaries & Wage Related Csts,Laboratory,Radiology-Diagnostic,HHA,Title V discharges,Electroencephalography,Other Reimbursable,Respiratory Therapy,Other Special Care,Delivery Room and Labor Room,Subprovider II,Occupational Therapy,Other Reimbursable,Recovery Room,Buildings,Respiratory Therapy,Drugs Charged to Patients,Durable Medical Equipment Sold,Radiology-Diagnostic,MRI,Emergency,Pancreas Acquisition,Cardiac Catheterization,Durable Medical Equipment Rented,TOTAL,Organ Procurement,Net Income,Other Capital,Electrocardiology,Blood Clotting Factors for Hemoph.,Radiology-Therapeutic,OLTC,Electroencephalography,"Blood Storing, Processing, Trans",ASC (Distinct Part),Maintenance of Personnel,CMHC,"Treatment capacity per day per
station",Emergency,New Cap Related Csts Movable Equipment,Other Ancillary,Burn Intensive Care Unit,ASC (Non Distinct Part),In State Medicaid eligible days,Wage Related Costs RHC/FQHC,Operating Room,OLTC,Total,Recovery Room,Hospital State,Durable Medical Equipment Sold,Kidney Acquisition,Employee Benefits,Total Allied Health,Delivery Room and Labor Room,Employee Benefits,Cardiac Catheterization,Speech Pathology,Research,"Gift, Flower, Coffee Shop, Canteen",Total Salaries,Excess of customary charges,Laboratory,Durable Medical Equipment Sold,Clinic,Other Ancillary,Nursery,Interns & Res Salary and Fringe Benefits,Total Hospital Interns & Residents,HHA,Operating Room,Title V discharges,Hospital County,Impl. Dev. Charged to Patients,LUPA Episodes:  Total Visits,Without Outliers:  Non Routine Med Sup Chgs,Renal Dialysis,Recovery Room,"Blood Storing, Processing, Trans","Gift, Flower, Coffee Shop, Canteen",MRI,Operating Cost and Target Amount,Other Outpatient Services,Non-Physician Anesthetist Part A,Land,Nursery,Rental of Provider space by suppliers,Transitional corridor payment,Radiology-Diagnostic,Hospital Street Address,Drugs Charged to Patients,Home Office:  Physician Part A,Lung  Acquisition,Delivery Room and Labor Room,OPT,Observation Beds (Distinct Unit),Emergency,New Cap Related Csts Movable Equipment,Adults and Pediatrics,Total prospective payment,Anesthesiology,Home Office Personnel,Subtotal,Non-Physician Anesthetist Part A,Blood Clotting Factors for Hemoph.,Speech Pathology,Physician-Part B,Tentative settlement,CAH Visits,Interns & Residents,Burn Intensive Care Unit,OLTC,RHC,Pharmacy,Occupational Therapy,Drugs Charged to Patients,Land Improvements,Occupational Therapy,SSA State Code,Impl. Dev. Charged to Patients,Electroencephalography,Total Hospital,Fixed Equipment,Intensive Care Unit,HRR adjustment amount ,Operating Room,Laundry and Linen Service,Hospice,Impl. Dev. Charged to Patients,Radioisotope,Whole Blood & Packed Red Blood Cells,Subprovider-IRF,Total Patient Days,Emergency,Home Office Salaries & Wage Related Csts,Emergency,Other Ancillary,RHC 10 Provider Number,Electroencephalography,CT Scan,PEP:  Total Number of Outlier Episodes,Burn Intensive Care Unit,Paramedical Education,Intravenous Therapy,Other Reimbursable,Organ Procurement,RHC 5 Provider Number,Other Special Care,"Are there any related organization or how office costs as defined in HCFA Pub. 15-I, chapter 10? (Y/N)",Electroencephalography,Laboratory,Dietary,Other Organ Acquisition,Other Ancillary,SNF,Recovery Room,Wage Related Costs RHC/FQHC,Intensive Care Unit,Radiology-Therapeutic,Speech Pathology,MRI,Other Ancillary,Health Information Technology Designated Assets,ICF,Radioisotope,Maintenance and Repairs,Clinic,RHC 17 Provider Number,Occupational Therapy,Administrative and General,Drugs Charged to Patients,"Blood Storing, Processing, Trans",Intensive Care Unit,Subtotal,Liver Acquisition,Total,Observation Beds (Distinct Unit),Delivery Room and Labor Room,Central Services and Supply,Hospice,Heart Acquisition,"Blood Storing, Processing, Trans",Delivery Room and Labor Room,Other Reimbursable,Ambulance Services,Delivery Room and Labor Room,Intravenous Therapy,RHC,Delivery Room and Labor Room,Intravenous Therapy,Radioisotope,Title XIX discharges,Maintenance of Personnel,Other General Service,LUPA Episodes:  Other Charges,Burn Intensive Care Unit,HHA,Medical Supplies Charged to Patients,Physician-Part B,Laundry and Linen Service,Central Services and Supply,Title XIX discharges,Subtotal Other Wages and Related Csts,CT Scan,Dietary,Emergency,Medicare allowable bad debts for the entire hospital complex,Laboratory,Subprovider-IRF,Radiology-Therapeutic,Durable Medical Equipment Rented,Renal Dialysis,Related  Salaries,Negative Cost Centers,Drugs Charged to Patients,Other adjustments,Other Special Care Unit,Ambulance Services,Home Office Salaries & Wage Related Csts,Laboratory,CMHC,Home Office Personnel,Occupational Therapy,Recovery Room,Net Patient Revenue,Radiology-Therapeutic,OSP,"Blood Storing, Processing, Trans",Radioisotope,Intravenous Therapy,Respiratory Therapy,Other Reimbursable,Impl. Dev. Charged to Patients,Whole Blood & Packed Red Blood Cells,Delivery Room and Labor Room,Durable Medical Equipment Sold,Housekeeping,Radiology-Therapeutic,ASC (Non Distinct Part),Home Office Salaries,Rental of quarters to employee and oths,ASC (Non Distinct Part),ASC (Distinct Part),ASC (Non Distinct Part),"Income from imposition of interest, finance",Hospice,ASC (Non Distinct Part),Surgical Intensive Care Unit,Surgical Intensive Care Unit,Cardiac Catheterization,Subprovider-IRF,Subprovider-IRF,Provider-based physician adjustment,Hospital PO Box,MRI,Intravenous Therapy,Whole Blood & Packed Red Blood Cells,Durable Medical Equipment Rented,Radiology-Therapeutic,Home Program Dialysis,Delivery Room and Labor Room,Home Program Dialysis,Respiratory Therapy,Renal Dialysis,Total Salaries,HAC reduction adjustment amount,IRF,Clinic,Subprovider I,Zip Code,Central Services and Supply,Other Ancillary,Radiology-Diagnostic,Speech Pathology,FQHC 3 Provider Number,Durable Medical Equipment Rented,Laboratory,Medical Supplies Charged to Patients,Maintenance and Repairs,Durable Medical Equipment Rented,Interns & Res Salary and Fringe Benefits,FQHC 8 Provider Number,"Blood Storing, Processing, Trans",Impl. Dev. Charged to Patients,SNF,PBP Clinical Lab Services Program Only,Surgical Intensive Care Unit,Other Reimbursable,Occupational Therapy,MDH status beginning date  (MM/DD/YY),Adults and Pediatrics,Medical Supplies Charged to Patients,Radiology-Diagnostic,Hospice,NF,Liver Acquisition,Total,Radioisotope,Coronary Care Unit,Deductibles and coinsurance,Anesthesiology,Durable Medical Equipment Sold,Intensive Care Unit,Operating Room,Intensive Care Unit Program Cost,Net Salaries,Non-Physician Anesthetist Part B,Total Fixed Assets,Hospice,"Blood Storing, Processing, Trans",Radiology-Therapeutic,Delivery Room and Labor Room,Medicare Certified Heart TC term date,Radioisotope,New Cap Related Csts Bldg & Fixtures,Total Facility,Delivery Room and Labor Room,Impl. Dev. Charged to Patients,Liver Acquisition,Radiology-Diagnostic,"Blood Storing, Processing, Trans",Laboratory,Total Costs,Medical Supplies Charged to Patients,Cardiac Catheterization,Occupational Therapy,RHC 2 Provider Number,Other Outpatient Services,Physical Therapy,Cafeteria,Assets,Partial or full credits from manufacturers,Other Reimbursable,Emergency,Total Adults & Peds,Physical Therapy,Adults and Pediatrics,Other Ancillary,Other Special Care Unit,Administrative and General under Contract,Employee Benefits,Clinic,Medical Supplies Charged to Patients,Occupational Therapy,Housekeeping under contract,Radioisotope,Paramedical Education,Operating Room,Laboratory,net of Swing Bed Cost,TOTAL,Relief Payment,PEP Episodes:  Other Charges,Physicians' Assistant,Impl. Dev. Charged to Patients,Inventory,Total,Burn Intensive Care Unit,Respiratory Therapy,"Average patient dialysis time 
including setup",With Outliers:  Other Charges,MRI,Labor and Delivery,Physical Therapy,Bonus Payment,Fiscal Year Begin Date,Disp. And Retirement,Respiratory Therapy,Cardiac Catheterization,Operating Room,Home Program Dialysis,CT Scan,Other Special Care Unit,FQHC,Major Movable Equipment,Electrocardiology,Medicare Certified Liver TC term date,Total Swing Bed Cost,Medicare Certified Lung TC term date,Dietary,Speech Pathology,Coronary Care Unit,Operating Room,NF,Intravenous Therapy,Burn Intensive Care Unit,Impl. Dev. Charged to Patients,Research,Observation Beds (Distinct Unit),Laundry and Linen Service,Pancreas Acquisition,Buildings and Fixtures,Intravenous Therapy,Radiology-Diagnostic,Electroencephalography,Radiology-Diagnostic,Management and Administrative Services,Employee Benefits,Drugs Charged to Patients,IPF Provider Number,PEP Episodes:  Total Visits,PEP Episodes:  Total Number of Episodes,ASC (Non Distinct Part),Other Nonreimbursable,Total,Paramedical Education,Component rate ESRD,Payments received from patients for amounts previously written off as charity care,Nursery,net of Swing Bed and Private Room Diff,Radiology-Therapeutic,Total Program Excludable Costs,Electrocardiology,Home Program Dialysis,Physical Therapy,Intensive Care Unit,Coronary Care Unit,Pass Through Cost for  Program Ancillary,Cardiac Catheterization,Operating Room,Renal 1 Provider Number,Other Special Purpose,Other Outpatient Services,Subprovider 1,Hospice 2 Provider Number,ASC (Non Distinct Part),With Outliers:  Other Charges,Electroencephalography,Total Number of Outlier Episodes,Durable Medical Equipment Sold,Subtotal,Pancreas Acquisition,CT Scan,Drugs Charged to Patients,Related Organization Transactions,Title XVIII discharges,Nonpaid Workers,Recovery Room,OSP,OSP,Burn Intensive Care Unit,Delivery Room and Labor Room,Laboratory,Physical Therapy,Other Special Purpose,Anesthesiology,Laboratory,Operating Room,Recovery Room,Radiology-Therapeutic,Respiratory Therapy,CT Scan,Physician Part A,Intravenous Therapy,Surgical Intensive Care Unit,Delivery Room and Labor Room,Laboratory,Drugs Charged to Patients,Subtotal,PBP Clinical Lab Services Program Only,Other Outpatient Services,Whole Blood & Packed Red Blood Cells,Operating Room,Electroencephalography,Durable Medical Equipment Rented,Burn Intensive Care Unit Program Cost,ICF,SNF,Other Outpatient Services,Without Outliers:  Non Routine Med Sup Chgs,Home Office Salaries & Wage Related Csts,Radiology-Diagnostic,Respiratory Therapy,Occupational Therapy,Other Organ Acquisition,Nonpaid Workers,Excluded Area Salaries,Other Reimbursable,ASC (Non Distinct Part),MRI,Recovery Room,MRI,Cardiac Catheterization,Renal Dialysis,Other Ancillary,Lung  Acquisition,Anesthesiology,Report Status Code,Allowable Inpatient Cost Plus Incentive Pt,Laboratory,Ambulance Services,Nonpaid Workers,With Outliers:  Non Routine Med Sup Chgs,RHC 24 Provider Number,RHC 21 Provider Number,Land Improvements,Subprovider II,Recovery Room,Coronary Intensive Care Unit,Clinic,Occupational Therapy,Home Program Dialysis,Interns and residents,Other Reimbursable,Administrative and General,CAPD exchanges per day,Intravenous Therapy,CMHC,Recovery Room,"Epoietin amount form worksheet A
for home dialysis program",New Cap Related Csts Movable Equipment,NF,Other Outpatient Services,Land,Blood Clotting Factors for Hemoph.,RHC 15 Provider Number,Lung  Acquisition,Total Adults & Pediatrics,Electroencephalography,Other Outpatient Services,Respiratory Therapy,Total Charges:  LUPA Episodes,Subprovider 2,Television and Radio Service,Int & Res (non approved teaching program,Durable Medical Equipment Sold,Observation Beds (Distinct Unit),Other Special Care Unit,Cost To Charge Ratio,Interns & Residents,"Blood Storing, Processing, Trans",Other Special Care Unit,CMHC,Other Reimbursable,Emergency,CT Scan,Durable Medical Equipment Sold,Electroencephalography,LUPA Episodes:  Other Charges,CT Scan,Other Ancillary,Durable Medical Equipment Rented,Durable Medical Equipment Rented,Other Outpatient Services,ASC (Non Distinct Part),Total,Without Outliers:  Total Charges,Telephone Services,NOT IN THIS FILE,Swing Bed NF Provider Number,Coronary Care Unit,Pharmacy,Emergency,Cardiac Catheterization,Total Salaries,"Blood Storing, Processing, Trans",SNF,CMHC 1 Provider Number,Electroencephalography,FFY,Hospital Type (From CMS Hospitals Data Archive),Name and Num
,Curated Name and Num,Hospital type (modified),,Lon,Lat,INPATIENT ANCILLARY SERVICE COST APPORTIONMENT,,,INPATIENT ANCILLARY SERVICE COST APPORTIONMENT,COMPUTATION OF RATIO OF COST TO CHARGES,CALCULATION OF REIMBURSEMENT SETTLEMENT,S-10 DATA,APPORTIONMENT OF MEDICAL AND OTHER HEALTH SERVICES,COST ALLOCATION,CALCULATION OF REIMBURSEMENT SETTLEMENT,APPORTIONMENT OF MEDICAL AND OTHER HEALTH SERVICES,TRIAL BALANCE OF EXPENSE ACCOUNTS,APPORTIONMENT OF INPATIENT/OUTPATIENT ANCILLARY SERVICE OTHER PASS THROUGH COSTS,INPATIENT ANCILLARY SERVICE COST APPORTIONMENT,TRIAL BALANCE OF EXPENSE ACCOUNTS,INPATIENT ANCILLARY SERVICE COST APPORTIONMENT,CALCULATION OF REIMBURSEMENT SETTLEMENT,COST ALLOCATION,,,APPORTIONMENT OF INPATIENT ROUTINE SERVICE CAPITAL COSTS,APPORTIONMENT OF INPATIENT/OUTPATIENT ANCILLARY SERVICE OTHER PASS THROUGH COSTS,APPORTIONMENT OF MEDICAL AND OTHER HEALTH SERVICES,COMPUTATION OF RATIO OF COST TO CHARGES,APPORTIONMENT OF MEDICAL AND OTHER HEALTH SERVICES,HHA STATISTICAL DATA,APPORTIONMENT OF INPATIENT/OUTPATIENT ANCILLARY SERVICE OTHER PASS THROUGH COSTS,COST ALLOCATION,APPORTIONMENT OF INPATIENT/OUTPATIENT ANCILLARY SERVICE OTHER PASS THROUGH COSTS,COMPUTATION OF INPATIENT OPERATING COSTS,APPORTIONMENT OF INPATIENT/OUTPATIENT ANCILLARY SERVICE OTHER PASS THROUGH COSTS,INPATIENT ANCILLARY SERVICE COST APPORTIONMENT,TRIAL BALANCE OF EXPENSE ACCOUNTS,INPATIENT ANCILLARY SERVICE COST APPORTIONMENT,RENAL STATISTICAL DATA,CALCULATION OF REIMBURSEMENT SETTLEMENT,BALANCE SHEET,APPORTIONMENT OF INPATIENT/OUTPATIENT ANCILLARY SERVICE OTHER PASS THROUGH COSTS,COST ALLOCATION,COMPUTATION OF RATIO OF COST TO CHARGES,COMPUTATION OF INPATIENT OPERATING COSTS,TRIAL BALANCE OF EXPENSE ACCOUNTS,ADJUSTMENTS,APPORTIONMENT OF MEDICAL AND OTHER HEALTH SERVICES,HHA STATISTICAL DATA,,APPORTIONMENT OF INPATIENT ROUTINE SERVICE CAPITAL COSTS,HOSPITAL WAGE INDEX DATA,APPORTIONMENT OF INPATIENT/OUTPATIENT ANCILLARY SERVICE OTHER PASS THROUGH COSTS,APPORTIONMENT OF MEDICAL AND OTHER HEALTH SERVICES,HHA STATISTICAL DATA,TRIAL BALANCE OF EXPENSE ACCOUNTS,APPORTIONMENT OF INPATIENT/OUTPATIENT ANCILLARY SERVICE OTHER PASS THROUGH COSTS,Medicaid Inpatient Days/Outpatient Visits,TRIAL BALANCE OF EXPENSE ACCOUNTS,HHA STATISTICAL DATA,Total Inpatient Days/Outpatient Visits,ALLOCATION OF NEW CAPITAL COSTS,RECONCILIATION OF CAPITAL COST CENTERS,,ALLOCATION OF NEW CAPITAL COSTS,NUMBER OF BEDS,COST ALLOCATION,S-10 DATA,APPORTIONMENT OF INPATIENT/OUTPATIENT ANCILLARY SERVICE OTHER PASS THROUGH COSTS,APPORTIONMENT OF INPATIENT/OUTPATIENT ANCILLARY SERVICE OTHER PASS THROUGH COSTS,APPORTIONMENT OF MEDICAL AND OTHER HEALTH SERVICES,Total Inpatient Days/Outpatient Visits,TRIAL BALANCE OF EXPENSE ACCOUNTS,TRIAL BALANCE OF EXPENSE ACCOUNTS,COST ALLOCATION,COMPUTATION OF RATIO OF COST TO CHARGES,NUMBER OF BEDS,COST ALLOCATION,TRIAL BALANCE OF EXPENSE ACCOUNTS,APPORTIONMENT OF INPATIENT/OUTPATIENT ANCILLARY SERVICE OTHER PASS THROUGH COSTS,APPORTIONMENT OF MEDICAL AND OTHER HEALTH SERVICES,TRIAL BALANCE OF EXPENSE ACCOUNTS,COST ALLOCATION,COST ALLOCATION,APPORTIONMENT OF INPATIENT/OUTPATIENT ANCILLARY SERVICE OTHER PASS THROUGH COSTS,ADJUSTMENTS,APPORTIONMENT OF INPATIENT/OUTPATIENT ANCILLARY SERVICE OTHER PASS THROUGH COSTS,TRIAL BALANCE OF EXPENSE ACCOUNTS,ALLOCATION OF NEW CAPITAL COSTS,TRIAL BALANCE OF EXPENSE ACCOUNTS,BALANCE SHEET,HOSPITAL WAGE INDEX DATA,COST ALLOCATION,APPORTIONMENT OF INPATIENT/OUTPATIENT ANCILLARY SERVICE OTHER PASS THROUGH COSTS,APPORTIONMENT OF INPATIENT/OUTPATIENT ANCILLARY SERVICE OTHER PASS THROUGH COSTS,RENAL STATISTICAL DATA,APPORTIONMENT OF INPATIENT/OUTPATIENT ANCILLARY SERVICE OTHER PASS THROUGH COSTS,COST ALLOCATION,APPORTIONMENT OF INPATIENT/OUTPATIENT ANCILLARY SERVICE OTHER PASS THROUGH COSTS,Total Inpatient Days/Outpatient Visits,APPORTIONMENT OF INPATIENT/OUTPATIENT ANCILLARY SERVICE OTHER PASS THROUGH COSTS,COMPUTATION OF RATIO OF COST TO CHARGES,APPORTIONMENT OF MEDICAL AND OTHER HEALTH SERVICES,HOSPITAL WAGE INDEX DATA,COMPUTATION OF RATIO OF COST TO CHARGES,COST ALLOCATION,COST ALLOCATION,TRIAL BALANCE OF EXPENSE ACCOUNTS,HOSPITAL WAGE INDEX DATA,Total Inpatient Days/Outpatient Visits,TRIAL BALANCE OF EXPENSE ACCOUNTS,HOSPITAL WAGE INDEX DATA,COST ALLOCATION,COST ALLOCATION,Medicare Inpatient Days/Outpatient Visits,,TRIAL BALANCE OF EXPENSE ACCOUNTS,APPORTIONMENT OF INPATIENT/OUTPATIENT ANCILLARY SERVICE OTHER PASS THROUGH COSTS,INPATIENT ANCILLARY SERVICE COST APPORTIONMENT,HOSPITAL IDENTIFICATION INFORMATION,APPORTIONMENT OF INPATIENT/OUTPATIENT ANCILLARY SERVICE OTHER PASS THROUGH COSTS,COST ALLOCATION,COST ALLOCATION,APPORTIONMENT OF MEDICAL AND OTHER HEALTH SERVICES,,HOSPITAL WAGE INDEX DATA,TRIAL BALANCE OF EXPENSE ACCOUNTS,APPORTIONMENT OF MEDICAL AND OTHER HEALTH SERVICES,APPORTIONMENT OF MEDICAL AND OTHER HEALTH SERVICES,COST ALLOCATION,TRIAL BALANCE OF EXPENSE ACCOUNTS,COST ALLOCATION,COST ALLOCATION,TRIAL BALANCE OF EXPENSE ACCOUNTS,APPORTIONMENT OF INPATIENT/OUTPATIENT ANCILLARY SERVICE OTHER PASS THROUGH COSTS,APPORTIONMENT OF INPATIENT/OUTPATIENT ANCILLARY SERVICE OTHER PASS THROUGH COSTS,BED DAYS AVAILABLE,TRIAL BALANCE OF EXPENSE ACCOUNTS,INPATIENT ANCILLARY SERVICE COST APPORTIONMENT,COST ALLOCATION,COMPUTATION OF RATIO OF COST TO CHARGES,APPORTIONMENT OF MEDICAL AND OTHER HEALTH SERVICES,APPORTIONMENT OF INPATIENT/OUTPATIENT ANCILLARY SERVICE OTHER PASS THROUGH COSTS,APPORTIONMENT OF INPATIENT/OUTPATIENT ANCILLARY SERVICE OTHER PASS THROUGH COSTS,INPATIENT ANCILLARY SERVICE COST APPORTIONMENT,ALLOCATION OF NEW CAPITAL COSTS,APPORTIONMENT OF MEDICAL AND OTHER HEALTH SERVICES,APPORTIONMENT OF INPATIENT/OUTPATIENT ANCILLARY SERVICE OTHER PASS THROUGH COSTS,INPATIENT ANCILLARY SERVICE COST APPORTIONMENT,TRIAL BALANCE OF EXPENSE ACCOUNTS,COST ALLOCATION,APPORTIONMENT OF INPATIENT ROUTINE SERVICE OTHER PASS THROUGH COSTS,ALLOCATION OF NEW CAPITAL COSTS,COST ALLOCATION,APPORTIONMENT OF MEDICAL AND OTHER HEALTH SERVICES,APPORTIONMENT OF MEDICAL AND OTHER HEALTH SERVICES,APPORTIONMENT OF MEDICAL AND OTHER HEALTH SERVICES,APPORTIONMENT OF INPATIENT/OUTPATIENT ANCILLARY SERVICE OTHER PASS THROUGH COSTS,TRIAL BALANCE OF EXPENSE ACCOUNTS,,COMPUTATION OF RATIO OF COST TO CHARGES,COST ALLOCATION,TRIAL BALANCE OF EXPENSE ACCOUNTS,INPATIENT ANCILLARY SERVICE COST APPORTIONMENT,INPATIENT ANCILLARY SERVICE COST APPORTIONMENT,APPORTIONMENT OF MEDICAL AND OTHER HEALTH SERVICES,,COST ALLOCATION,INPATIENT ANCILLARY SERVICE COST APPORTIONMENT,CALCULATION OF REIMBURSEMENT SETTLEMENT (PPS),COST ALLOCATION,TRIAL BALANCE OF EXPENSE ACCOUNTS,APPORTIONMENT OF INPATIENT/OUTPATIENT ANCILLARY SERVICE OTHER PASS THROUGH COSTS,Total Inpatient Days/Outpatient Visits,,TRIAL BALANCE OF EXPENSE ACCOUNTS,TRIAL BALANCE OF EXPENSE ACCOUNTS,TRIAL BALANCE OF EXPENSE ACCOUNTS,S-10 DATA,INPATIENT ANCILLARY SERVICE COST APPORTIONMENT,INPATIENT ANCILLARY SERVICE COST APPORTIONMENT,COMPUTATION OF RATIO OF COST TO CHARGES,Total Inpatient Days/Outpatient Visits,TRIAL BALANCE OF EXPENSE ACCOUNTS,BALANCE SHEET,RENAL STATISTICAL DATA,APPORTIONMENT OF INPATIENT/OUTPATIENT ANCILLARY SERVICE OTHER PASS THROUGH COSTS,,INPATIENT ANCILLARY SERVICE COST APPORTIONMENT,ALLOCATION OF NEW CAPITAL COSTS,NUMBER OF BEDS,COMPUTATION OF RATIO OF COST TO CHARGES,APPORTIONMENT OF MEDICAL AND OTHER HEALTH SERVICES,APPORTIONMENT OF INPATIENT/OUTPATIENT ANCILLARY SERVICE OTHER PASS THROUGH COSTS,INPATIENT ANCILLARY SERVICE COST APPORTIONMENT,COST ALLOCATION,APPORTIONMENT OF INPATIENT/OUTPATIENT ANCILLARY SERVICE OTHER PASS THROUGH COSTS,COMPUTATION OF RATIO OF COST TO CHARGES,ALLOCATION OF NEW CAPITAL COSTS,ANALYSIS OF CHANGES IN NEW CAPITAL BALANCES,COST ALLOCATION,COMPUTATION OF RATIO OF COST TO CHARGES,COST ALLOCATION,ANALYSIS OF CHANGES IN NEW CAPITAL BALANCES,COMPUTATION OF RATIO OF COST TO CHARGES,TRIAL BALANCE OF EXPENSE ACCOUNTS,COMPUTATION OF RATIO OF COST TO CHARGES,COST ALLOCATION,TRIAL BALANCE OF EXPENSE ACCOUNTS,COMPUTATION OF RATIO OF COST TO CHARGES,COMPUTATION OF RATIO OF COST TO CHARGES,APPORTIONMENT OF MEDICAL AND OTHER HEALTH SERVICES,,Total Inpatient Days/Outpatient Visits,HOSPITAL WAGE INDEX DATA,COMPUTATION OF RATIO OF COST TO CHARGES,COMPUTATION OF RATIO OF COST TO CHARGES,Total Inpatient Days/Outpatient Visits,ANALYSIS OF CHANGES IN NEW CAPITAL BALANCES,RENAL STATISTICAL DATA,,COMPUTATION OF RATIO OF COST TO CHARGES,COMPUTATION OF INPATIENT OPERATING COSTS,COST ALLOCATION,APPORTIONMENT OF INPATIENT/OUTPATIENT ANCILLARY SERVICE OTHER PASS THROUGH COSTS,APPORTIONMENT OF MEDICAL AND OTHER HEALTH SERVICES,Total Inpatient Days/Outpatient Visits,ALLOCATION OF NEW CAPITAL COSTS,Medicaid Inpatient Days/Outpatient Visits,APPORTIONMENT OF INPATIENT/OUTPATIENT ANCILLARY SERVICE OTHER PASS THROUGH COSTS,BED DAYS AVAILABLE,APPORTIONMENT OF INPATIENT/OUTPATIENT ANCILLARY SERVICE OTHER PASS THROUGH COSTS,HOSPITAL WAGE INDEX DATA,COMPUTATION OF RATIO OF COST TO CHARGES,RECONCILIATION OF CAPITAL COST CENTERS,APPORTIONMENT OF INPATIENT/OUTPATIENT ANCILLARY SERVICE OTHER PASS THROUGH COSTS,INPATIENT ANCILLARY SERVICE COST APPORTIONMENT,HOSPITAL WAGE INDEX DATA,HOSPITAL WAGE INDEX DATA,COMPUTATION OF RATIO OF COST TO CHARGES,COMPUTATION OF RATIO OF COST TO CHARGES,COMPUTATION OF RATIO OF COST TO CHARGES,COMPUTATION OF RATIO OF COST TO CHARGES,Total Inpatient Days/Outpatient Visits,COMPUTATION OF RATIO OF COST TO CHARGES,TRIAL BALANCE OF EXPENSE ACCOUNTS,TRIAL BALANCE OF EXPENSE ACCOUNTS,ALLOCATION OF NEW CAPITAL COSTS,APPORTIONMENT OF MEDICAL AND OTHER HEALTH SERVICES,APPORTIONMENT OF INPATIENT/OUTPATIENT ANCILLARY SERVICE OTHER PASS THROUGH COSTS,Medicaid Inpatient Days/Outpatient Visits,,S-10 DATA,APPORTIONMENT OF INPATIENT/OUTPATIENT ANCILLARY SERVICE OTHER PASS THROUGH COSTS,INPATIENT ANCILLARY SERVICE COST APPORTIONMENT,COST ALLOCATION,BALANCE SHEET,TRIAL BALANCE OF EXPENSE ACCOUNTS,TRIAL BALANCE OF EXPENSE ACCOUNTS,APPORTIONMENT OF INPATIENT/OUTPATIENT ANCILLARY SERVICE OTHER PASS THROUGH COSTS,BALANCE SHEET,INPATIENT ANCILLARY SERVICE COST APPORTIONMENT,HHA STATISTICAL DATA,COMPUTATION OF RATIO OF COST TO CHARGES,COST ALLOCATION,Total Inpatient Days/Outpatient Visits,COST ALLOCATION,TRIAL BALANCE OF EXPENSE ACCOUNTS,HOSPITAL WAGE INDEX DATA,COMPUTATION OF RATIO OF COST TO CHARGES,APPORTIONMENT OF INPATIENT/OUTPATIENT ANCILLARY SERVICE OTHER PASS THROUGH COSTS,INPATIENT ANCILLARY SERVICE COST APPORTIONMENT,TRIAL BALANCE OF EXPENSE ACCOUNTS,APPORTIONMENT OF INPATIENT/OUTPATIENT ANCILLARY SERVICE OTHER PASS THROUGH COSTS,APPORTIONMENT OF INPATIENT/OUTPATIENT ANCILLARY SERVICE OTHER PASS THROUGH COSTS,INPATIENT ANCILLARY SERVICE COST APPORTIONMENT,TRIAL BALANCE OF EXPENSE ACCOUNTS,APPORTIONMENT OF INPATIENT/OUTPATIENT ANCILLARY SERVICE OTHER PASS THROUGH COSTS,COMPUTATION OF RATIO OF COST TO CHARGES,,COMPUTATION OF RATIO OF COST TO CHARGES,ALLOCATION OF NEW CAPITAL COSTS,INPATIENT ANCILLARY SERVICE COST APPORTIONMENT,TRIAL BALANCE OF EXPENSE ACCOUNTS,,COMPUTATION OF RATIO OF COST TO CHARGES,APPORTIONMENT OF INPATIENT/OUTPATIENT ANCILLARY SERVICE OTHER PASS THROUGH COSTS,APPORTIONMENT OF MEDICAL AND OTHER HEALTH SERVICES,APPORTIONMENT OF INPATIENT/OUTPATIENT ANCILLARY SERVICE OTHER PASS THROUGH COSTS,HOSPITAL WAGE INDEX DATA,INPATIENT ANCILLARY SERVICE COST APPORTIONMENT,ALLOCATION OF NEW CAPITAL COSTS,TRIAL BALANCE OF EXPENSE ACCOUNTS,TRIAL BALANCE OF EXPENSE ACCOUNTS,Total Inpatient Days/Outpatient Visits,APPORTIONMENT OF INPATIENT/OUTPATIENT ANCILLARY SERVICE OTHER PASS THROUGH COSTS,HOSPITAL WAGE INDEX DATA,ALLOCATION OF NEW CAPITAL COSTS,HOSPITAL WAGE INDEX DATA,TRIAL BALANCE OF EXPENSE ACCOUNTS,INPATIENT ANCILLARY SERVICE COST APPORTIONMENT,APPORTIONMENT OF INPATIENT/OUTPATIENT ANCILLARY SERVICE OTHER PASS THROUGH COSTS,COMPUTATION OF RATIO OF COST TO CHARGES,APPORTIONMENT OF MEDICAL AND OTHER HEALTH SERVICES,,HOSPITAL WAGE INDEX DATA,INPATIENT ANCILLARY SERVICE COST APPORTIONMENT,ADJUSTMENTS,COMPUTATION OF RATIO OF COST TO CHARGES,APPORTIONMENT OF INPATIENT/OUTPATIENT ANCILLARY SERVICE OTHER PASS THROUGH COSTS,COST ALLOCATION,TRIAL BALANCE OF EXPENSE ACCOUNTS,APPORTIONMENT OF INPATIENT/OUTPATIENT ANCILLARY SERVICE OTHER PASS THROUGH COSTS,COST ALLOCATION,APPORTIONMENT OF INPATIENT/OUTPATIENT ANCILLARY SERVICE OTHER PASS THROUGH COSTS,INPATIENT ANCILLARY SERVICE COST APPORTIONMENT,RECONCILIATION OF CAPITAL COST CENTERS,APPORTIONMENT OF MEDICAL AND OTHER HEALTH SERVICES,APPORTIONMENT OF INPATIENT/OUTPATIENT ANCILLARY SERVICE OTHER PASS THROUGH COSTS,APPORTIONMENT OF INPATIENT/OUTPATIENT ANCILLARY SERVICE OTHER PASS THROUGH COSTS,TRIAL BALANCE OF EXPENSE ACCOUNTS,NUMBER OF BEDS,HOSPITAL WAGE INDEX DATA,HOSPITAL WAGE INDEX DATA,HHA STATISTICAL DATA,HHA STATISTICAL DATA,INPATIENT ANCILLARY SERVICE COST APPORTIONMENT,HOSPITAL WAGE INDEX DATA,INPATIENT ANCILLARY SERVICE COST APPORTIONMENT,TRIAL BALANCE OF EXPENSE ACCOUNTS,COST ALLOCATION,COST ALLOCATION,COMPUTATION OF RATIO OF COST TO CHARGES,INPATIENT ANCILLARY SERVICE COST APPORTIONMENT,COMPUTATION OF RATIO OF COST TO CHARGES,APPORTIONMENT OF INPATIENT/OUTPATIENT ANCILLARY SERVICE OTHER PASS THROUGH COSTS,INPATIENT ANCILLARY SERVICE COST APPORTIONMENT,APPORTIONMENT OF INPATIENT/OUTPATIENT ANCILLARY SERVICE OTHER PASS THROUGH COSTS,TRIAL BALANCE OF EXPENSE ACCOUNTS,ANALYSIS OF CHANGES IN NEW CAPITAL BALANCES,APPORTIONMENT OF INPATIENT ROUTINE SERVICE OTHER PASS THROUGH COSTS,APPORTIONMENT OF MEDICAL AND OTHER HEALTH SERVICES,INPATIENT ANCILLARY SERVICE COST APPORTIONMENT,HOSPITAL WAGE INDEX DATA,COST ALLOCATION,HOSPITAL WAGE INDEX DATA,APPORTIONMENT OF INPATIENT/OUTPATIENT ANCILLARY SERVICE OTHER PASS THROUGH COSTS,HOSPITAL WAGE INDEX DATA,COST ALLOCATION,APPORTIONMENT OF INPATIENT/OUTPATIENT ANCILLARY SERVICE OTHER PASS THROUGH COSTS,INPATIENT ANCILLARY SERVICE COST APPORTIONMENT,INPATIENT ANCILLARY SERVICE COST APPORTIONMENT,RECONCILIATION OF CAPITAL COST CENTERS,HOSPITAL WAGE INDEX DATA,APPORTIONMENT OF INPATIENT/OUTPATIENT ANCILLARY SERVICE OTHER PASS THROUGH COSTS,ANALYSIS OF CHANGES IN NEW CAPITAL BALANCES,COST ALLOCATION,APPORTIONMENT OF INPATIENT/OUTPATIENT ANCILLARY SERVICE OTHER PASS THROUGH COSTS,APPORTIONMENT OF INPATIENT/OUTPATIENT ANCILLARY SERVICE OTHER PASS THROUGH COSTS,APPORTIONMENT OF MEDICAL AND OTHER HEALTH SERVICES,HOSPITAL WAGE INDEX DATA,APPORTIONMENT OF INPATIENT/OUTPATIENT ANCILLARY SERVICE OTHER PASS THROUGH COSTS,APPORTIONMENT OF MEDICAL AND OTHER HEALTH SERVICES,TRIAL BALANCE OF EXPENSE ACCOUNTS,HOSPITAL WAGE INDEX DATA,APPORTIONMENT OF MEDICAL AND OTHER HEALTH SERVICES,TRIAL BALANCE OF EXPENSE ACCOUNTS,COST ALLOCATION,APPORTIONMENT OF INPATIENT/OUTPATIENT ANCILLARY SERVICE OTHER PASS THROUGH COSTS,COMPUTATION OF RATIO OF COST TO CHARGES,APPORTIONMENT OF INPATIENT/OUTPATIENT ANCILLARY SERVICE OTHER PASS THROUGH COSTS,HHA STATISTICAL DATA,,TRIAL BALANCE OF EXPENSE ACCOUNTS,S-10 DATA,ANALYSIS OF CHANGES IN NEW CAPITAL BALANCES,COMPUTATION OF INPATIENT OPERATING COSTS,HOSPITAL WAGE INDEX DATA,INPATIENT ANCILLARY SERVICE COST APPORTIONMENT,INPATIENT ANCILLARY SERVICE COST APPORTIONMENT,APPORTIONMENT OF INPATIENT/OUTPATIENT ANCILLARY SERVICE OTHER PASS THROUGH COSTS,Total Inpatient Days/Outpatient Visits,Total Inpatient Days/Outpatient Visits,HOSPITAL WAGE INDEX DATA,TRIAL BALANCE OF EXPENSE ACCOUNTS,HOSPITAL WAGE INDEX DATA,HHA STATISTICAL DATA,COST ALLOCATION,APPORTIONMENT OF INPATIENT/OUTPATIENT ANCILLARY SERVICE OTHER PASS THROUGH COSTS,COST ALLOCATION,Total Inpatient Days/Outpatient Visits,TRIAL BALANCE OF EXPENSE ACCOUNTS,HOSPITAL WAGE INDEX DATA,TRIAL BALANCE OF EXPENSE ACCOUNTS,COMPUTATION OF RATIO OF COST TO CHARGES,HHA STATISTICAL DATA,INPATIENT ANCILLARY SERVICE COST APPORTIONMENT,INPATIENT ANCILLARY SERVICE COST APPORTIONMENT,RECONCILIATION OF CAPITAL COST CENTERS,INPATIENT ANCILLARY SERVICE COST APPORTIONMENT,ADJUSTMENTS,HOSPITAL WAGE INDEX DATA,TRIAL BALANCE OF EXPENSE ACCOUNTS,BALANCE SHEET,HOSPITAL WAGE INDEX DATA,COST ALLOCATION,HOSPITAL WAGE INDEX DATA,TRIAL BALANCE OF EXPENSE ACCOUNTS,COMPUTATION OF RATIO OF COST TO CHARGES,INPATIENT ANCILLARY SERVICE COST APPORTIONMENT,CALCULATION OF REIMBURSEMENT SETTLEMENT,APPORTIONMENT OF INPATIENT/OUTPATIENT ANCILLARY SERVICE OTHER PASS THROUGH COSTS,INPATIENT ANCILLARY SERVICE COST APPORTIONMENT,HOSPITAL WAGE INDEX DATA,,BED DAYS AVAILABLE,ALLOCATION OF NEW CAPITAL COSTS,Total Inpatient Days/Outpatient Visits,APPORTIONMENT OF INPATIENT/OUTPATIENT ANCILLARY SERVICE OTHER PASS THROUGH COSTS,BED DAYS AVAILABLE,RENAL STATISTICAL DATA,TRIAL BALANCE OF EXPENSE ACCOUNTS,,ADJUSTMENTS,APPORTIONMENT OF INPATIENT/OUTPATIENT ANCILLARY SERVICE OTHER PASS THROUGH COSTS,COMPUTATION OF INPATIENT OPERATING COSTS,TRIAL BALANCE OF EXPENSE ACCOUNTS,COST ALLOCATION,BALANCE SHEET,INPATIENT ANCILLARY SERVICE COST APPORTIONMENT,HOSPITAL WAGE INDEX DATA,BALANCE SHEET,HHA STATISTICAL DATA,APPORTIONMENT OF MEDICAL AND OTHER HEALTH SERVICES,COST ALLOCATION,COMPUTATION OF RATIO OF COST TO CHARGES,INPATIENT ANCILLARY SERVICE COST APPORTIONMENT,,APPORTIONMENT OF INPATIENT/OUTPATIENT ANCILLARY SERVICE OTHER PASS THROUGH COSTS,BALANCE SHEET,COMPUTATION OF RATIO OF COST TO CHARGES,TRIAL BALANCE OF EXPENSE ACCOUNTS,INPATIENT ANCILLARY SERVICE COST APPORTIONMENT,TRIAL BALANCE OF EXPENSE ACCOUNTS,APPORTIONMENT OF MEDICAL AND OTHER HEALTH SERVICES,COMPUTATION OF RATIO OF COST TO CHARGES,BALANCE SHEET,TRIAL BALANCE OF EXPENSE ACCOUNTS,TRIAL BALANCE OF EXPENSE ACCOUNTS,HOSPITAL WAGE INDEX DATA,CALCULATION OF REIMBURSEMENT SETTLEMENT,NUMBER OF BEDS,COST ALLOCATION,INPATIENT ANCILLARY SERVICE COST APPORTIONMENT,COST ALLOCATION,TRIAL BALANCE OF EXPENSE ACCOUNTS,,,TRIAL BALANCE OF EXPENSE ACCOUNTS,,APPORTIONMENT OF INPATIENT/OUTPATIENT ANCILLARY SERVICE OTHER PASS THROUGH COSTS,TRIAL BALANCE OF EXPENSE ACCOUNTS,COST ALLOCATION,COST ALLOCATION,COST ALLOCATION,COST ALLOCATION,ALLOCATION OF NEW CAPITAL COSTS,COMPUTATION OF RATIO OF COST TO CHARGES,APPORTIONMENT OF INPATIENT/OUTPATIENT ANCILLARY SERVICE OTHER PASS THROUGH COSTS,APPORTIONMENT OF INPATIENT/OUTPATIENT ANCILLARY SERVICE OTHER PASS THROUGH COSTS,RECONCILIATION OF CAPITAL COST CENTERS,HOSPITAL WAGE INDEX DATA,APPORTIONMENT OF INPATIENT/OUTPATIENT ANCILLARY SERVICE OTHER PASS THROUGH COSTS,INPATIENT ANCILLARY SERVICE COST APPORTIONMENT,TRIAL BALANCE OF EXPENSE ACCOUNTS,HOSPITAL WAGE INDEX DATA,S-10 DATA,APPORTIONMENT OF MEDICAL AND OTHER HEALTH SERVICES,APPORTIONMENT OF MEDICAL AND OTHER HEALTH SERVICES,COST ALLOCATION,TRIAL BALANCE OF EXPENSE ACCOUNTS,HHA STATISTICAL DATA,INPATIENT ANCILLARY SERVICE COST APPORTIONMENT,ANALYSIS OF CHANGES IN NEW CAPITAL BALANCES,APPORTIONMENT OF INPATIENT/OUTPATIENT ANCILLARY SERVICE OTHER PASS THROUGH COSTS,TRIAL BALANCE OF EXPENSE ACCOUNTS,APPORTIONMENT OF MEDICAL AND OTHER HEALTH SERVICES,Total Inpatient Days/Outpatient Visits,TRIAL BALANCE OF EXPENSE ACCOUNTS,TRIAL BALANCE OF EXPENSE ACCOUNTS,APPORTIONMENT OF INPATIENT/OUTPATIENT ANCILLARY SERVICE OTHER PASS THROUGH COSTS,TRIAL BALANCE OF EXPENSE ACCOUNTS,COST ALLOCATION,HHA STATISTICAL DATA,APPORTIONMENT OF INPATIENT/OUTPATIENT ANCILLARY SERVICE OTHER PASS THROUGH COSTS,APPORTIONMENT OF MEDICAL AND OTHER HEALTH SERVICES,HOSPITAL WAGE INDEX DATA,APPORTIONMENT OF INPATIENT/OUTPATIENT ANCILLARY SERVICE OTHER PASS THROUGH COSTS,APPORTIONMENT OF INPATIENT/OUTPATIENT ANCILLARY SERVICE OTHER PASS THROUGH COSTS,APPORTIONMENT OF INPATIENT/OUTPATIENT ANCILLARY SERVICE OTHER PASS THROUGH COSTS,Medicare Inpatient Days/Outpatient Visits,ALLOCATION OF NEW CAPITAL COSTS,BED DAYS AVAILABLE,Total Inpatient Days/Outpatient Visits,INPATIENT ANCILLARY SERVICE COST APPORTIONMENT,COST ALLOCATION,COST ALLOCATION,COMPUTATION OF RATIO OF COST TO CHARGES,INPATIENT ANCILLARY SERVICE COST APPORTIONMENT,CALCULATION OF REIMBURSEMENT SETTLEMENT,INPATIENT ANCILLARY SERVICE COST APPORTIONMENT,APPORTIONMENT OF INPATIENT ROUTINE SERVICE CAPITAL COSTS,BED DAYS AVAILABLE,RENAL STATISTICAL DATA,,TRIAL BALANCE OF EXPENSE ACCOUNTS,INPATIENT ANCILLARY SERVICE COST APPORTIONMENT,ALLOCATION OF NEW CAPITAL COSTS,APPORTIONMENT OF MEDICAL AND OTHER HEALTH SERVICES,HOSPITAL WAGE INDEX DATA,COST ALLOCATION,APPORTIONMENT OF INPATIENT/OUTPATIENT ANCILLARY SERVICE OTHER PASS THROUGH COSTS,APPORTIONMENT OF MEDICAL AND OTHER HEALTH SERVICES,Medicare Inpatient Days/Outpatient Visits,COST ALLOCATION,ALLOCATION OF NEW CAPITAL COSTS,TRIAL BALANCE OF EXPENSE ACCOUNTS,COMPUTATION OF RATIO OF COST TO CHARGES,APPORTIONMENT OF INPATIENT/OUTPATIENT ANCILLARY SERVICE OTHER PASS THROUGH COSTS,COMPUTATION OF RATIO OF COST TO CHARGES,,COMPUTATION OF INPATIENT OPERATING COSTS,APPORTIONMENT OF INPATIENT/OUTPATIENT ANCILLARY SERVICE OTHER PASS THROUGH COSTS,BED DAYS AVAILABLE,INPATIENT ANCILLARY SERVICE COST APPORTIONMENT,APPORTIONMENT OF INPATIENT/OUTPATIENT ANCILLARY SERVICE OTHER PASS THROUGH COSTS,INPATIENT ANCILLARY SERVICE COST APPORTIONMENT,INPATIENT ANCILLARY SERVICE COST APPORTIONMENT,COMPUTATION OF INPATIENT OPERATING COSTS,,COMPUTATION OF RATIO OF COST TO CHARGES,APPORTIONMENT OF INPATIENT ROUTINE SERVICE OTHER PASS THROUGH COSTS,Total Inpatient Days/Outpatient Visits,INPATIENT ANCILLARY SERVICE COST APPORTIONMENT,TRIAL BALANCE OF EXPENSE ACCOUNTS,INPATIENT ANCILLARY SERVICE COST APPORTIONMENT,COMPUTATION OF RATIO OF COST TO CHARGES,APPORTIONMENT OF MEDICAL AND OTHER HEALTH SERVICES,TRIAL BALANCE OF EXPENSE ACCOUNTS,APPORTIONMENT OF MEDICAL AND OTHER HEALTH SERVICES,COST ALLOCATION,APPORTIONMENT OF INPATIENT/OUTPATIENT ANCILLARY SERVICE OTHER PASS THROUGH COSTS,S-10 DATA,TRIAL BALANCE OF EXPENSE ACCOUNTS,INPATIENT ANCILLARY SERVICE COST APPORTIONMENT,COST ALLOCATION,HOSPITAL WAGE INDEX DATA,TRIAL BALANCE OF EXPENSE ACCOUNTS,COST ALLOCATION,COMPUTATION OF RATIO OF COST TO CHARGES,COST ALLOCATION,APPORTIONMENT OF MEDICAL AND OTHER HEALTH SERVICES,TRIAL BALANCE OF EXPENSE ACCOUNTS,COST ALLOCATION,COST ALLOCATION,COST ALLOCATION,ALLOCATION OF NEW CAPITAL COSTS,ALLOCATION OF NEW CAPITAL COSTS,APPORTIONMENT OF INPATIENT/OUTPATIENT ANCILLARY SERVICE OTHER PASS THROUGH COSTS,COMPUTATION OF INPATIENT OPERATING COSTS,COST ALLOCATION,Total Inpatient Days/Outpatient Visits,INPATIENT ANCILLARY SERVICE COST APPORTIONMENT,HOSPITAL WAGE INDEX DATA,TRIAL BALANCE OF EXPENSE ACCOUNTS,COMPUTATION OF RATIO OF COST TO CHARGES,Total Inpatient Days/Outpatient Visits,Medicare Inpatient Days/Outpatient Visits,Medicaid Inpatient Days/Outpatient Visits,INPATIENT ANCILLARY SERVICE COST APPORTIONMENT,,Total Inpatient Days/Outpatient Visits,APPORTIONMENT OF MEDICAL AND OTHER HEALTH SERVICES,INPATIENT ANCILLARY SERVICE COST APPORTIONMENT,COST ALLOCATION,APPORTIONMENT OF INPATIENT ROUTINE SERVICE CAPITAL COSTS,INPATIENT ANCILLARY SERVICE COST APPORTIONMENT,Medicare Inpatient Days/Outpatient Visits,HOSPITAL WAGE INDEX DATA,ALLOCATION OF NEW CAPITAL COSTS,HOSPITAL WAGE INDEX DATA,TRIAL BALANCE OF EXPENSE ACCOUNTS,INPATIENT ANCILLARY SERVICE COST APPORTIONMENT,COST ALLOCATION,TRIAL BALANCE OF EXPENSE ACCOUNTS,HOSPITAL WAGE INDEX DATA,APPORTIONMENT OF INPATIENT/OUTPATIENT ANCILLARY SERVICE OTHER PASS THROUGH COSTS,TRIAL BALANCE OF EXPENSE ACCOUNTS,ADJUSTMENTS,APPORTIONMENT OF MEDICAL AND OTHER HEALTH SERVICES,TRIAL BALANCE OF EXPENSE ACCOUNTS,COST ALLOCATION,TRIAL BALANCE OF EXPENSE ACCOUNTS,COMPUTATION OF RATIO OF COST TO CHARGES,APPORTIONMENT OF INPATIENT/OUTPATIENT ANCILLARY SERVICE OTHER PASS THROUGH COSTS,TRIAL BALANCE OF EXPENSE ACCOUNTS,HOSPITAL WAGE INDEX DATA,ANALYSIS OF CHANGES IN NEW CAPITAL BALANCES,TRIAL BALANCE OF EXPENSE ACCOUNTS,COST ALLOCATION,COST ALLOCATION,INPATIENT ANCILLARY SERVICE COST APPORTIONMENT,APPORTIONMENT OF INPATIENT/OUTPATIENT ANCILLARY SERVICE OTHER PASS THROUGH COSTS,APPORTIONMENT OF MEDICAL AND OTHER HEALTH SERVICES,ALLOCATION OF NEW CAPITAL COSTS,INPATIENT ANCILLARY SERVICE COST APPORTIONMENT,ALLOCATION OF NEW CAPITAL COSTS,HOSPITAL WAGE INDEX DATA,CALCULATION OF REIMBURSEMENT SETTLEMENT,TRIAL BALANCE OF EXPENSE ACCOUNTS,APPORTIONMENT OF INPATIENT/OUTPATIENT ANCILLARY SERVICE OTHER PASS THROUGH COSTS,RENAL STATISTICAL DATA,ALLOCATION OF NEW CAPITAL COSTS,HOSPITAL WAGE INDEX DATA,HHA STATISTICAL DATA,ALLOCATION OF NEW CAPITAL COSTS,Medicare Inpatient Days/Outpatient Visits,TRIAL BALANCE OF EXPENSE ACCOUNTS,APPORTIONMENT OF INPATIENT/OUTPATIENT ANCILLARY SERVICE OTHER PASS THROUGH COSTS,INPATIENT ANCILLARY SERVICE COST APPORTIONMENT,HOSPITAL WAGE INDEX DATA,APPORTIONMENT OF INPATIENT ROUTINE SERVICE CAPITAL COSTS,Medicare Inpatient Days/Outpatient Visits,Total Inpatient Days/Outpatient Visits,COMPUTATION OF INPATIENT OPERATING COSTS,APPORTIONMENT OF INPATIENT/OUTPATIENT ANCILLARY SERVICE OTHER PASS THROUGH COSTS,COMPUTATION OF RATIO OF COST TO CHARGES,INPATIENT ANCILLARY SERVICE COST APPORTIONMENT,APPORTIONMENT OF MEDICAL AND OTHER HEALTH SERVICES,COMPUTATION OF RATIO OF COST TO CHARGES,APPORTIONMENT OF MEDICAL AND OTHER HEALTH SERVICES,INPATIENT ANCILLARY SERVICE COST APPORTIONMENT,S-10 DATA,TRIAL BALANCE OF EXPENSE ACCOUNTS,HOSPITAL WAGE INDEX DATA,APPORTIONMENT OF MEDICAL AND OTHER HEALTH SERVICES,ALLOCATION OF NEW CAPITAL COSTS,APPORTIONMENT OF MEDICAL AND OTHER HEALTH SERVICES,,TRIAL BALANCE OF EXPENSE ACCOUNTS,COMPUTATION OF RATIO OF COST TO CHARGES,APPORTIONMENT OF INPATIENT/OUTPATIENT ANCILLARY SERVICE OTHER PASS THROUGH COSTS,COMPUTATION OF RATIO OF COST TO CHARGES,,,HHA STATISTICAL DATA,COMPUTATION OF RATIO OF COST TO CHARGES,,,,APPORTIONMENT OF INPATIENT/OUTPATIENT ANCILLARY SERVICE OTHER PASS THROUGH COSTS,,COMPUTATION OF RATIO OF COST TO CHARGES,APPORTIONMENT OF MEDICAL AND OTHER HEALTH SERVICES,INPATIENT ANCILLARY SERVICE COST APPORTIONMENT,BED DAYS AVAILABLE,INPATIENT ANCILLARY SERVICE COST APPORTIONMENT,TRIAL BALANCE OF EXPENSE ACCOUNTS,COMPUTATION OF RATIO OF COST TO CHARGES,TRIAL BALANCE OF EXPENSE ACCOUNTS,TRIAL BALANCE OF EXPENSE ACCOUNTS,COMPUTATION OF RATIO OF COST TO CHARGES,COST ALLOCATION,S-10 DATA,TRIAL BALANCE OF EXPENSE ACCOUNTS,COMPUTATION OF RATIO OF COST TO CHARGES,COST ALLOCATION,COMPUTATION OF RATIO OF COST TO CHARGES,HOSPITAL WAGE INDEX DATA,TRIAL BALANCE OF EXPENSE ACCOUNTS,RENAL STATISTICAL DATA,APPORTIONMENT OF MEDICAL AND OTHER HEALTH SERVICES,APPORTIONMENT OF MEDICAL AND OTHER HEALTH SERVICES,APPORTIONMENT OF MEDICAL AND OTHER HEALTH SERVICES,Medicare Inpatient Days/Outpatient Visits,Total Inpatient Days/Outpatient Visits,COST ALLOCATION,COST ALLOCATION,ANALYSIS OF CHANGES IN NEW CAPITAL BALANCES,CALCULATION OF REIMBURSEMENT SETTLEMENT,COST ALLOCATION,ALLOCATION OF NEW CAPITAL COSTS,Medicaid Inpatient Days/Outpatient Visits,Total Inpatient Days/Outpatient Visits,BED DAYS AVAILABLE,BED DAYS AVAILABLE,HOSPITAL WAGE INDEX DATA,RENAL STATISTICAL DATA,APPORTIONMENT OF INPATIENT/OUTPATIENT ANCILLARY SERVICE OTHER PASS THROUGH COSTS,TRIAL BALANCE OF EXPENSE ACCOUNTS,TRIAL BALANCE OF EXPENSE ACCOUNTS,INPATIENT ANCILLARY SERVICE COST APPORTIONMENT,STATEMENT OF REVENUES AND EXPENSES,TRIAL BALANCE OF EXPENSE ACCOUNTS,HOSPITAL WAGE INDEX DATA,Medicaid Inpatient Days/Outpatient Visits,HHA STATISTICAL DATA,TRIAL BALANCE OF EXPENSE ACCOUNTS,HOSPITAL WAGE INDEX DATA,COST ALLOCATION,APPORTIONMENT OF MEDICAL AND OTHER HEALTH SERVICES,COST ALLOCATION,COST ALLOCATION,APPORTIONMENT OF MEDICAL AND OTHER HEALTH SERVICES,COMPUTATION OF INPATIENT OPERATING COSTS,COMPUTATION OF RATIO OF COST TO CHARGES,TRIAL BALANCE OF EXPENSE ACCOUNTS,CALCULATION OF REIMBURSEMENT SETTLEMENT,COMPUTATION OF RATIO OF COST TO CHARGES,TRIAL BALANCE OF EXPENSE ACCOUNTS,COST ALLOCATION,APPORTIONMENT OF INPATIENT/OUTPATIENT ANCILLARY SERVICE OTHER PASS THROUGH COSTS,INPATIENT ANCILLARY SERVICE COST APPORTIONMENT,APPORTIONMENT OF MEDICAL AND OTHER HEALTH SERVICES,HOSPITAL WAGE INDEX DATA,COMPUTATION OF RATIO OF COST TO CHARGES,INPATIENT ANCILLARY SERVICE COST APPORTIONMENT,HOSPITAL WAGE INDEX DATA,COST ALLOCATION,APPORTIONMENT OF INPATIENT/OUTPATIENT ANCILLARY SERVICE OTHER PASS THROUGH COSTS,INPATIENT ANCILLARY SERVICE COST APPORTIONMENT,APPORTIONMENT OF INPATIENT ROUTINE SERVICE CAPITAL COSTS,INPATIENT ANCILLARY SERVICE COST APPORTIONMENT,,COST ALLOCATION,INPATIENT ANCILLARY SERVICE COST APPORTIONMENT,COMPUTATION OF INPATIENT OPERATING COSTS,INPATIENT ANCILLARY SERVICE COST APPORTIONMENT,BALANCE SHEET,APPORTIONMENT OF INPATIENT/OUTPATIENT ANCILLARY SERVICE OTHER PASS THROUGH COSTS,APPORTIONMENT OF MEDICAL AND OTHER HEALTH SERVICES,,HOSPITAL WAGE INDEX DATA,TRIAL BALANCE OF EXPENSE ACCOUNTS,BED DAYS AVAILABLE,APPORTIONMENT OF INPATIENT/OUTPATIENT ANCILLARY SERVICE OTHER PASS THROUGH COSTS,APPORTIONMENT OF MEDICAL AND OTHER HEALTH SERVICES,TRIAL BALANCE OF EXPENSE ACCOUNTS,APPORTIONMENT OF INPATIENT/OUTPATIENT ANCILLARY SERVICE OTHER PASS THROUGH COSTS,INPATIENT ANCILLARY SERVICE COST APPORTIONMENT,Medicare Inpatient Days/Outpatient Visits,COMPUTATION OF RATIO OF COST TO CHARGES,INPATIENT ANCILLARY SERVICE COST APPORTIONMENT,INPATIENT ANCILLARY SERVICE COST APPORTIONMENT,TRIAL BALANCE OF EXPENSE ACCOUNTS,COST ALLOCATION,RENAL STATISTICAL DATA,APPORTIONMENT OF INPATIENT/OUTPATIENT ANCILLARY SERVICE OTHER PASS THROUGH COSTS,APPORTIONMENT OF INPATIENT/OUTPATIENT ANCILLARY SERVICE OTHER PASS THROUGH COSTS,APPORTIONMENT OF INPATIENT/OUTPATIENT ANCILLARY SERVICE OTHER PASS THROUGH COSTS,INPATIENT ANCILLARY SERVICE COST APPORTIONMENT,APPORTIONMENT OF INPATIENT/OUTPATIENT ANCILLARY SERVICE OTHER PASS THROUGH COSTS,HHA STATISTICAL DATA,COMPUTATION OF RATIO OF COST TO CHARGES,APPORTIONMENT OF INPATIENT/OUTPATIENT ANCILLARY SERVICE OTHER PASS THROUGH COSTS,HOSPITAL WAGE INDEX DATA,APPORTIONMENT OF INPATIENT/OUTPATIENT ANCILLARY SERVICE OTHER PASS THROUGH COSTS,COMPUTATION OF RATIO OF COST TO CHARGES,APPORTIONMENT OF INPATIENT/OUTPATIENT ANCILLARY SERVICE OTHER PASS THROUGH COSTS,APPORTIONMENT OF INPATIENT/OUTPATIENT ANCILLARY SERVICE OTHER PASS THROUGH COSTS,CALCULATION OF REIMBURSEMENT SETTLEMENT,INPATIENT ANCILLARY SERVICE COST APPORTIONMENT,BED DAYS AVAILABLE,INPATIENT ANCILLARY SERVICE COST APPORTIONMENT,COST ALLOCATION,APPORTIONMENT OF INPATIENT ROUTINE SERVICE CAPITAL COSTS,APPORTIONMENT OF INPATIENT/OUTPATIENT ANCILLARY SERVICE OTHER PASS THROUGH COSTS,COST ALLOCATION,COMPUTATION OF RATIO OF COST TO CHARGES,COMPUTATION OF RATIO OF COST TO CHARGES,TRIAL BALANCE OF EXPENSE ACCOUNTS,HOSPITAL WAGE INDEX DATA,COST ALLOCATION,APPORTIONMENT OF INPATIENT ROUTINE SERVICE CAPITAL COSTS,COMPUTATION OF RATIO OF COST TO CHARGES,S-10 DATA,TRIAL BALANCE OF EXPENSE ACCOUNTS,COST ALLOCATION,HHA STATISTICAL DATA,APPORTIONMENT OF INPATIENT/OUTPATIENT ANCILLARY SERVICE OTHER PASS THROUGH COSTS,COST ALLOCATION,ALLOCATION OF NEW CAPITAL COSTS,CALCULATION OF REIMBURSEMENT SETTLEMENT,CALCULATION OF REIMBURSEMENT SETTLEMENT,INPATIENT ANCILLARY SERVICE COST APPORTIONMENT,HOSPITAL WAGE INDEX DATA,COMPUTATION OF RATIO OF COST TO CHARGES,Total Inpatient Days/Outpatient Visits,APPORTIONMENT OF INPATIENT/OUTPATIENT ANCILLARY SERVICE OTHER PASS THROUGH COSTS,COST ALLOCATION,INPATIENT ANCILLARY SERVICE COST APPORTIONMENT,TRIAL BALANCE OF EXPENSE ACCOUNTS,,COMPUTATION OF RATIO OF COST TO CHARGES,APPORTIONMENT OF MEDICAL AND OTHER HEALTH SERVICES,COMPUTATION OF RATIO OF COST TO CHARGES,APPORTIONMENT OF INPATIENT/OUTPATIENT ANCILLARY SERVICE OTHER PASS THROUGH COSTS,APPORTIONMENT OF MEDICAL AND OTHER HEALTH SERVICES,ALLOCATION OF NEW CAPITAL COSTS,CALCULATION OF REIMBURSEMENT SETTLEMENT,COST ALLOCATION,INPATIENT ANCILLARY SERVICE COST APPORTIONMENT,APPORTIONMENT OF INPATIENT/OUTPATIENT ANCILLARY SERVICE OTHER PASS THROUGH COSTS,INPATIENT ANCILLARY SERVICE COST APPORTIONMENT,,ALLOCATION OF NEW CAPITAL COSTS,APPORTIONMENT OF INPATIENT/OUTPATIENT ANCILLARY SERVICE OTHER PASS THROUGH COSTS,INPATIENT ANCILLARY SERVICE COST APPORTIONMENT,APPORTIONMENT OF INPATIENT/OUTPATIENT ANCILLARY SERVICE OTHER PASS THROUGH COSTS,APPORTIONMENT OF MEDICAL AND OTHER HEALTH SERVICES,APPORTIONMENT OF INPATIENT/OUTPATIENT ANCILLARY SERVICE OTHER PASS THROUGH COSTS,INPATIENT ANCILLARY SERVICE COST APPORTIONMENT,HHA STATISTICAL DATA,COST ALLOCATION,COST ALLOCATION,TRIAL BALANCE OF EXPENSE ACCOUNTS,TRIAL BALANCE OF EXPENSE ACCOUNTS,INPATIENT ANCILLARY SERVICE COST APPORTIONMENT,COST ALLOCATION,TRIAL BALANCE OF EXPENSE ACCOUNTS,Medicaid Inpatient Days/Outpatient Visits,ANALYSIS OF CHANGES IN NEW CAPITAL BALANCES,HOSPITAL WAGE INDEX DATA,,BED DAYS AVAILABLE,APPORTIONMENT OF INPATIENT/OUTPATIENT ANCILLARY SERVICE OTHER PASS THROUGH COSTS,INPATIENT ANCILLARY SERVICE COST APPORTIONMENT,APPORTIONMENT OF INPATIENT/OUTPATIENT ANCILLARY SERVICE OTHER PASS THROUGH COSTS,APPORTIONMENT OF MEDICAL AND OTHER HEALTH SERVICES,COST ALLOCATION,COST ALLOCATION,APPORTIONMENT OF MEDICAL AND OTHER HEALTH SERVICES,HOSPITAL WAGE INDEX DATA,CALCULATION OF REIMBURSEMENT SETTLEMENT,TRIAL BALANCE OF EXPENSE ACCOUNTS,TRIAL BALANCE OF EXPENSE ACCOUNTS,,COMPUTATION OF RATIO OF COST TO CHARGES,INPATIENT ANCILLARY SERVICE COST APPORTIONMENT,HOSPITAL WAGE INDEX DATA,TRIAL BALANCE OF EXPENSE ACCOUNTS,APPORTIONMENT OF MEDICAL AND OTHER HEALTH SERVICES,HOSPITAL WAGE INDEX DATA,TRIAL BALANCE OF EXPENSE ACCOUNTS,INPATIENT ANCILLARY SERVICE COST APPORTIONMENT,CALCULATION OF REIMBURSEMENT SETTLEMENT,COMPUTATION OF RATIO OF COST TO CHARGES,APPORTIONMENT OF MEDICAL AND OTHER HEALTH SERVICES,COST ALLOCATION,Medicare Inpatient Days/Outpatient Visits,APPORTIONMENT OF INPATIENT/OUTPATIENT ANCILLARY SERVICE OTHER PASS THROUGH COSTS,COMPUTATION OF RATIO OF COST TO CHARGES,TRIAL BALANCE OF EXPENSE ACCOUNTS,COST ALLOCATION,COST ALLOCATION,APPORTIONMENT OF INPATIENT/OUTPATIENT ANCILLARY SERVICE OTHER PASS THROUGH COSTS,INPATIENT ANCILLARY SERVICE COST APPORTIONMENT,HOSPITAL WAGE INDEX DATA,HOSPITAL WAGE INDEX DATA,TRIAL BALANCE OF EXPENSE ACCOUNTS,COST ALLOCATION,APPORTIONMENT OF MEDICAL AND OTHER HEALTH SERVICES,COST ALLOCATION,APPORTIONMENT OF INPATIENT/OUTPATIENT ANCILLARY SERVICE OTHER PASS THROUGH COSTS,COST ALLOCATION,INPATIENT ANCILLARY SERVICE COST APPORTIONMENT,COMPUTATION OF RATIO OF COST TO CHARGES,APPORTIONMENT OF INPATIENT/OUTPATIENT ANCILLARY SERVICE OTHER PASS THROUGH COSTS,APPORTIONMENT OF INPATIENT/OUTPATIENT ANCILLARY SERVICE OTHER PASS THROUGH COSTS,TRIAL BALANCE OF EXPENSE ACCOUNTS,APPORTIONMENT OF MEDICAL AND OTHER HEALTH SERVICES,APPORTIONMENT OF INPATIENT/OUTPATIENT ANCILLARY SERVICE OTHER PASS THROUGH COSTS,,S-10 DATA,COST ALLOCATION,INPATIENT ANCILLARY SERVICE COST APPORTIONMENT,RENAL STATISTICAL DATA,INPATIENT ANCILLARY SERVICE COST APPORTIONMENT,HOSPITAL WAGE INDEX DATA,,COST ALLOCATION,APPORTIONMENT OF INPATIENT/OUTPATIENT ANCILLARY SERVICE OTHER PASS THROUGH COSTS,APPORTIONMENT OF MEDICAL AND OTHER HEALTH SERVICES,,APPORTIONMENT OF INPATIENT/OUTPATIENT ANCILLARY SERVICE OTHER PASS THROUGH COSTS,APPORTIONMENT OF MEDICAL AND OTHER HEALTH SERVICES,HOSPITAL WAGE INDEX DATA,HOSPITAL IDENTIFICATION INFORMATION,HOSPITAL WAGE INDEX DATA,COMPUTATION OF RATIO OF COST TO CHARGES,BALANCE SHEET,COMPUTATION OF RATIO OF COST TO CHARGES,HOSPITAL WAGE INDEX DATA,HOSPITAL WAGE INDEX DATA,INPATIENT ANCILLARY SERVICE COST APPORTIONMENT,APPORTIONMENT OF MEDICAL AND OTHER HEALTH SERVICES,INPATIENT ANCILLARY SERVICE COST APPORTIONMENT,ALLOCATION OF NEW CAPITAL COSTS,COST ALLOCATION,APPORTIONMENT OF MEDICAL AND OTHER HEALTH SERVICES,HOSPITAL WAGE INDEX DATA,TRIAL BALANCE OF EXPENSE ACCOUNTS,INPATIENT ANCILLARY SERVICE COST APPORTIONMENT,COMPUTATION OF RATIO OF COST TO CHARGES,TRIAL BALANCE OF EXPENSE ACCOUNTS,APPORTIONMENT OF INPATIENT/OUTPATIENT ANCILLARY SERVICE OTHER PASS THROUGH COSTS,COST ALLOCATION,INPATIENT ANCILLARY SERVICE COST APPORTIONMENT,TRIAL BALANCE OF EXPENSE ACCOUNTS,APPORTIONMENT OF INPATIENT ROUTINE SERVICE CAPITAL COSTS,HHA STATISTICAL DATA,COST ALLOCATION,HHA STATISTICAL DATA,,Medicaid Inpatient Days/Outpatient Visits,COMPUTATION OF RATIO OF COST TO CHARGES,,COST ALLOCATION,S-10 DATA,Total Inpatient Days/Outpatient Visits,COST ALLOCATION,APPORTIONMENT OF MEDICAL AND OTHER HEALTH SERVICES,APPORTIONMENT OF INPATIENT/OUTPATIENT ANCILLARY SERVICE OTHER PASS THROUGH COSTS,BED DAYS AVAILABLE,COST ALLOCATION,,TRIAL BALANCE OF EXPENSE ACCOUNTS,APPORTIONMENT OF INPATIENT/OUTPATIENT ANCILLARY SERVICE OTHER PASS THROUGH COSTS,S-10 DATA,TRIAL BALANCE OF EXPENSE ACCOUNTS,TRIAL BALANCE OF EXPENSE ACCOUNTS,APPORTIONMENT OF INPATIENT/OUTPATIENT ANCILLARY SERVICE OTHER PASS THROUGH COSTS,INPATIENT ANCILLARY SERVICE COST APPORTIONMENT,BALANCE SHEET,INPATIENT ANCILLARY SERVICE COST APPORTIONMENT,APPORTIONMENT OF MEDICAL AND OTHER HEALTH SERVICES,Total Inpatient Days/Outpatient Visits,TRIAL BALANCE OF EXPENSE ACCOUNTS,COST ALLOCATION,RECONCILIATION OF CAPITAL COST CENTERS,INPATIENT ANCILLARY SERVICE COST APPORTIONMENT,HOSPITAL WAGE INDEX DATA,INPATIENT ANCILLARY SERVICE COST APPORTIONMENT,HHA STATISTICAL DATA,BALANCE SHEET,HHA STATISTICAL DATA,Total Inpatient Days/Outpatient Visits,APPORTIONMENT OF INPATIENT/OUTPATIENT ANCILLARY SERVICE OTHER PASS THROUGH COSTS,APPORTIONMENT OF INPATIENT/OUTPATIENT ANCILLARY SERVICE OTHER PASS THROUGH COSTS,COST ALLOCATION,APPORTIONMENT OF INPATIENT/OUTPATIENT ANCILLARY SERVICE OTHER PASS THROUGH COSTS,ALLOCATION OF NEW CAPITAL COSTS,ANALYSIS OF CHANGES IN NEW CAPITAL BALANCES,TRIAL BALANCE OF EXPENSE ACCOUNTS,HOSPITAL WAGE INDEX DATA,APPORTIONMENT OF INPATIENT/OUTPATIENT ANCILLARY SERVICE OTHER PASS THROUGH COSTS,BED DAYS AVAILABLE,INPATIENT ANCILLARY SERVICE COST APPORTIONMENT,APPORTIONMENT OF MEDICAL AND OTHER HEALTH SERVICES,HHA STATISTICAL DATA,Total Inpatient Days/Outpatient Visits,S-10 DATA,APPORTIONMENT OF MEDICAL AND OTHER HEALTH SERVICES,APPORTIONMENT OF INPATIENT/OUTPATIENT ANCILLARY SERVICE OTHER PASS THROUGH COSTS,COMPUTATION OF RATIO OF COST TO CHARGES,TRIAL BALANCE OF EXPENSE ACCOUNTS,NUMBER OF BEDS,APPORTIONMENT OF INPATIENT ROUTINE SERVICE CAPITAL COSTS,Medicare Inpatient Days/Outpatient Visits,HHA STATISTICAL DATA,RECONCILIATION OF CAPITAL COST CENTERS,ADJUSTMENTS,HOSPITAL WAGE INDEX DATA,COMPUTATION OF RATIO OF COST TO CHARGES,HOSPITAL WAGE INDEX DATA,APPORTIONMENT OF INPATIENT/OUTPATIENT ANCILLARY SERVICE OTHER PASS THROUGH COSTS,INPATIENT ANCILLARY SERVICE COST APPORTIONMENT,,INPATIENT ANCILLARY SERVICE COST APPORTIONMENT,INPATIENT ANCILLARY SERVICE COST APPORTIONMENT,CALCULATION OF REIMBURSEMENT SETTLEMENT,,,COST ALLOCATION,INPATIENT ANCILLARY SERVICE COST APPORTIONMENT,,,RENAL STATISTICAL DATA,INPATIENT ANCILLARY SERVICE COST APPORTIONMENT,INPATIENT ANCILLARY SERVICE COST APPORTIONMENT,ANALYSIS OF CHANGES IN NEW CAPITAL BALANCES,COMPUTATION OF RATIO OF COST TO CHARGES,ADJUSTMENTS,HOSPITAL WAGE INDEX DATA,HHA STATISTICAL DATA,HHA STATISTICAL DATA,S-10 DATA,TRIAL BALANCE OF EXPENSE ACCOUNTS,COMPUTATION OF RATIO OF COST TO CHARGES,BALANCE SHEET,HHA STATISTICAL DATA,,COST ALLOCATION,COMPUTATION OF RATIO OF COST TO CHARGES,HOSPITAL IDENTIFICATION INFORMATION,COST ALLOCATION,COST ALLOCATION,BED DAYS AVAILABLE,HOSPITAL WAGE INDEX DATA,TRIAL BALANCE OF EXPENSE ACCOUNTS,HOSPITAL WAGE INDEX DATA,COST ALLOCATION,INPATIENT ANCILLARY SERVICE COST APPORTIONMENT,APPORTIONMENT OF INPATIENT/OUTPATIENT ANCILLARY SERVICE OTHER PASS THROUGH COSTS,ALLOCATION OF NEW CAPITAL COSTS,APPORTIONMENT OF INPATIENT/OUTPATIENT ANCILLARY SERVICE OTHER PASS THROUGH COSTS,,INPATIENT ANCILLARY SERVICE COST APPORTIONMENT,Medicaid Inpatient Days/Outpatient Visits,INPATIENT ANCILLARY SERVICE COST APPORTIONMENT,APPORTIONMENT OF INPATIENT/OUTPATIENT ANCILLARY SERVICE OTHER PASS THROUGH COSTS,APPORTIONMENT OF MEDICAL AND OTHER HEALTH SERVICES,INPATIENT ANCILLARY SERVICE COST APPORTIONMENT,APPORTIONMENT OF MEDICAL AND OTHER HEALTH SERVICES,HOSPITAL WAGE INDEX DATA,COST ALLOCATION,INPATIENT ANCILLARY SERVICE COST APPORTIONMENT,COMPUTATION OF RATIO OF COST TO CHARGES,HOSPITAL WAGE INDEX DATA,HOSPITAL WAGE INDEX DATA,TRIAL BALANCE OF EXPENSE ACCOUNTS,Total Inpatient Days/Outpatient Visits,APPORTIONMENT OF MEDICAL AND OTHER HEALTH SERVICES,COMPUTATION OF INPATIENT OPERATING COSTS,INPATIENT ANCILLARY SERVICE COST APPORTIONMENT,,COMPUTATION OF RATIO OF COST TO CHARGES,APPORTIONMENT OF INPATIENT/OUTPATIENT ANCILLARY SERVICE OTHER PASS THROUGH COSTS,HOSPITAL WAGE INDEX DATA,COST ALLOCATION,COST ALLOCATION,APPORTIONMENT OF MEDICAL AND OTHER HEALTH SERVICES,BED DAYS AVAILABLE,APPORTIONMENT OF MEDICAL AND OTHER HEALTH SERVICES,INPATIENT ANCILLARY SERVICE COST APPORTIONMENT,COST ALLOCATION,COST ALLOCATION,COMPUTATION OF RATIO OF COST TO CHARGES,APPORTIONMENT OF MEDICAL AND OTHER HEALTH SERVICES,Total Inpatient Days/Outpatient Visits,HHA STATISTICAL DATA,TRIAL BALANCE OF EXPENSE ACCOUNTS,APPORTIONMENT OF MEDICAL AND OTHER HEALTH SERVICES,APPORTIONMENT OF INPATIENT/OUTPATIENT ANCILLARY SERVICE OTHER PASS THROUGH COSTS,COMPUTATION OF INPATIENT OPERATING COSTS,Total Inpatient Days/Outpatient Visits,TRIAL BALANCE OF EXPENSE ACCOUNTS,BED DAYS AVAILABLE,CALCULATION OF REIMBURSEMENT SETTLEMENT,TRIAL BALANCE OF EXPENSE ACCOUNTS,INPATIENT ANCILLARY SERVICE COST APPORTIONMENT,INPATIENT ANCILLARY SERVICE COST APPORTIONMENT,TRIAL BALANCE OF EXPENSE ACCOUNTS,APPORTIONMENT OF INPATIENT/OUTPATIENT ANCILLARY SERVICE OTHER PASS THROUGH COSTS,APPORTIONMENT OF INPATIENT/OUTPATIENT ANCILLARY SERVICE OTHER PASS THROUGH COSTS,Medicaid Inpatient Days/Outpatient Visits,TRIAL BALANCE OF EXPENSE ACCOUNTS,HOSPITAL WAGE INDEX DATA,INPATIENT ANCILLARY SERVICE COST APPORTIONMENT,APPORTIONMENT OF MEDICAL AND OTHER HEALTH SERVICES,COMPUTATION OF INPATIENT OPERATING COSTS,TRIAL BALANCE OF EXPENSE ACCOUNTS,INPATIENT ANCILLARY SERVICE COST APPORTIONMENT,COMPUTATION OF INPATIENT OPERATING COSTS,HOSPITAL WAGE INDEX DATA,INPATIENT ANCILLARY SERVICE COST APPORTIONMENT,INPATIENT ANCILLARY SERVICE COST APPORTIONMENT,BED DAYS AVAILABLE,APPORTIONMENT OF MEDICAL AND OTHER HEALTH SERVICES,APPORTIONMENT OF INPATIENT ROUTINE SERVICE CAPITAL COSTS,APPORTIONMENT OF INPATIENT/OUTPATIENT ANCILLARY SERVICE OTHER PASS THROUGH COSTS,HOSPITAL WAGE INDEX DATA,INPATIENT ANCILLARY SERVICE COST APPORTIONMENT,ANALYSIS OF CHANGES IN NEW CAPITAL BALANCES,ADJUSTMENTS,APPORTIONMENT OF MEDICAL AND OTHER HEALTH SERVICES,APPORTIONMENT OF INPATIENT/OUTPATIENT ANCILLARY SERVICE OTHER PASS THROUGH COSTS,HOSPITAL WAGE INDEX DATA,RENAL STATISTICAL DATA,,INPATIENT ANCILLARY SERVICE COST APPORTIONMENT,Total Inpatient Days/Outpatient Visits,APPORTIONMENT OF MEDICAL AND OTHER HEALTH SERVICES,APPORTIONMENT OF MEDICAL AND OTHER HEALTH SERVICES,ALLOCATION OF NEW CAPITAL COSTS,RECONCILIATION OF CAPITAL COST CENTERS,APPORTIONMENT OF MEDICAL AND OTHER HEALTH SERVICES,Medicaid Inpatient Days/Outpatient Visits,TRIAL BALANCE OF EXPENSE ACCOUNTS,APPORTIONMENT OF INPATIENT/OUTPATIENT ANCILLARY SERVICE OTHER PASS THROUGH COSTS,Medicare Inpatient Days/Outpatient Visits,,RECONCILIATION OF CAPITAL COST CENTERS,APPORTIONMENT OF INPATIENT/OUTPATIENT ANCILLARY SERVICE OTHER PASS THROUGH COSTS,Medicare Inpatient Days/Outpatient Visits,Medicaid Inpatient Days/Outpatient Visits,HOSPITAL WAGE INDEX DATA,APPORTIONMENT OF INPATIENT/OUTPATIENT ANCILLARY SERVICE OTHER PASS THROUGH COSTS,ANALYSIS OF CHANGES IN NEW CAPITAL BALANCES,COST ALLOCATION,HOSPITAL WAGE INDEX DATA,CALCULATION OF REIMBURSEMENT SETTLEMENT,HOSPITAL WAGE INDEX DATA,APPORTIONMENT OF INPATIENT/OUTPATIENT ANCILLARY SERVICE OTHER PASS THROUGH COSTS,HOSPITAL WAGE INDEX DATA,APPORTIONMENT OF MEDICAL AND OTHER HEALTH SERVICES,TRIAL BALANCE OF EXPENSE ACCOUNTS,HOSPITAL WAGE INDEX DATA,COST ALLOCATION,HOSPITAL WAGE INDEX DATA,COMPUTATION OF RATIO OF COST TO CHARGES,COMPUTATION OF RATIO OF COST TO CHARGES,APPORTIONMENT OF MEDICAL AND OTHER HEALTH SERVICES,COMPUTATION OF RATIO OF COST TO CHARGES,INPATIENT ANCILLARY SERVICE COST APPORTIONMENT,INPATIENT ANCILLARY SERVICE COST APPORTIONMENT,COMPUTATION OF RATIO OF COST TO CHARGES,COST ALLOCATION,HHA STATISTICAL DATA,TRIAL BALANCE OF EXPENSE ACCOUNTS,APPORTIONMENT OF INPATIENT/OUTPATIENT ANCILLARY SERVICE OTHER PASS THROUGH COSTS,COST ALLOCATION,ALLOCATION OF NEW CAPITAL COSTS,HOSPITAL IDENTIFICATION INFORMATION,COST ALLOCATION,HOSPITAL WAGE INDEX DATA,INPATIENT ANCILLARY SERVICE COST APPORTIONMENT,COMPUTATION OF INPATIENT OPERATING COSTS,BED DAYS AVAILABLE,COST ALLOCATION,APPORTIONMENT OF INPATIENT/OUTPATIENT ANCILLARY SERVICE OTHER PASS THROUGH COSTS,TRIAL BALANCE OF EXPENSE ACCOUNTS,APPORTIONMENT OF INPATIENT/OUTPATIENT ANCILLARY SERVICE OTHER PASS THROUGH COSTS,INPATIENT ANCILLARY SERVICE COST APPORTIONMENT,APPORTIONMENT OF INPATIENT ROUTINE SERVICE OTHER PASS THROUGH COSTS,APPORTIONMENT OF INPATIENT/OUTPATIENT ANCILLARY SERVICE OTHER PASS THROUGH COSTS,APPORTIONMENT OF MEDICAL AND OTHER HEALTH SERVICES,CALCULATION OF REIMBURSEMENT SETTLEMENT,INPATIENT ANCILLARY SERVICE COST APPORTIONMENT,RENAL STATISTICAL DATA,ANALYSIS OF CHANGES IN NEW CAPITAL BALANCES,ANALYSIS OF CHANGES IN NEW CAPITAL BALANCES,APPORTIONMENT OF MEDICAL AND OTHER HEALTH SERVICES,CALCULATION OF REIMBURSEMENT SETTLEMENT,HOSPITAL WAGE INDEX DATA,ANALYSIS OF CHANGES IN NEW CAPITAL BALANCES,APPORTIONMENT OF INPATIENT ROUTINE SERVICE OTHER PASS THROUGH COSTS,APPORTIONMENT OF MEDICAL AND OTHER HEALTH SERVICES,Medicaid Inpatient Days/Outpatient Visits,COST ALLOCATION,COMPUTATION OF RATIO OF COST TO CHARGES,HOSPITAL WAGE INDEX DATA,INPATIENT ANCILLARY SERVICE COST APPORTIONMENT,COST ALLOCATION,ADJUSTMENTS,ALLOCATION OF NEW CAPITAL COSTS,CALCULATION OF REIMBURSEMENT SETTLEMENT,Medicare Inpatient Days/Outpatient Visits,COMPUTATION OF RATIO OF COST TO CHARGES,ALLOCATION OF NEW CAPITAL COSTS,HOSPITAL WAGE INDEX DATA,APPORTIONMENT OF MEDICAL AND OTHER HEALTH SERVICES,APPORTIONMENT OF INPATIENT/OUTPATIENT ANCILLARY SERVICE OTHER PASS THROUGH COSTS,INPATIENT ANCILLARY SERVICE COST APPORTIONMENT,APPORTIONMENT OF INPATIENT/OUTPATIENT ANCILLARY SERVICE OTHER PASS THROUGH COSTS,RENAL STATISTICAL DATA,HOSPITAL WAGE INDEX DATA,APPORTIONMENT OF INPATIENT/OUTPATIENT ANCILLARY SERVICE OTHER PASS THROUGH COSTS,CALCULATION OF REIMBURSEMENT SETTLEMENT (PPS),ADJUSTMENTS,APPORTIONMENT OF MEDICAL AND OTHER HEALTH SERVICES,APPORTIONMENT OF MEDICAL AND OTHER HEALTH SERVICES,TRIAL BALANCE OF EXPENSE ACCOUNTS,COMPUTATION OF RATIO OF COST TO CHARGES,APPORTIONMENT OF INPATIENT/OUTPATIENT ANCILLARY SERVICE OTHER PASS THROUGH COSTS,COMPUTATION OF RATIO OF COST TO CHARGES,,INPATIENT ANCILLARY SERVICE COST APPORTIONMENT,COMPUTATION OF INPATIENT OPERATING COSTS,TRIAL BALANCE OF EXPENSE ACCOUNTS,ALLOCATION OF NEW CAPITAL COSTS,Medicare Inpatient Days/Outpatient Visits,,COST ALLOCATION,APPORTIONMENT OF INPATIENT/OUTPATIENT ANCILLARY SERVICE OTHER PASS THROUGH COSTS,TRIAL BALANCE OF EXPENSE ACCOUNTS,HOSPITAL WAGE INDEX DATA,NUMBER OF BEDS,Total Inpatient Days/Outpatient Visits,APPORTIONMENT OF INPATIENT/OUTPATIENT ANCILLARY SERVICE OTHER PASS THROUGH COSTS,APPORTIONMENT OF INPATIENT/OUTPATIENT ANCILLARY SERVICE OTHER PASS THROUGH COSTS,INPATIENT ANCILLARY SERVICE COST APPORTIONMENT,INPATIENT ANCILLARY SERVICE COST APPORTIONMENT,COST ALLOCATION,APPORTIONMENT OF INPATIENT/OUTPATIENT ANCILLARY SERVICE OTHER PASS THROUGH COSTS,APPORTIONMENT OF INPATIENT/OUTPATIENT ANCILLARY SERVICE OTHER PASS THROUGH COSTS,INPATIENT ANCILLARY SERVICE COST APPORTIONMENT,CALCULATION OF REIMBURSEMENT SETTLEMENT,HHA STATISTICAL DATA,HOSPITAL WAGE INDEX DATA,HOSPITAL WAGE INDEX DATA,,ALLOCATION OF NEW CAPITAL COSTS,CALCULATION OF REIMBURSEMENT SETTLEMENT,TRIAL BALANCE OF EXPENSE ACCOUNTS,INPATIENT ANCILLARY SERVICE COST APPORTIONMENT,,ADJUSTMENTS,COST ALLOCATION,Total Inpatient Days/Outpatient Visits,Medicaid Inpatient Days/Outpatient Visits,ADJUSTMENTS,COST ALLOCATION,COMPUTATION OF RATIO OF COST TO CHARGES,APPORTIONMENT OF INPATIENT/OUTPATIENT ANCILLARY SERVICE OTHER PASS THROUGH COSTS,APPORTIONMENT OF INPATIENT/OUTPATIENT ANCILLARY SERVICE OTHER PASS THROUGH COSTS,HOSPITAL WAGE INDEX DATA,,HOSPITAL WAGE INDEX DATA,APPORTIONMENT OF MEDICAL AND OTHER HEALTH SERVICES,HHA STATISTICAL DATA,COST ALLOCATION,COST ALLOCATION,COST ALLOCATION,APPORTIONMENT OF INPATIENT/OUTPATIENT ANCILLARY SERVICE OTHER PASS THROUGH COSTS,HOSPITAL WAGE INDEX DATA,APPORTIONMENT OF INPATIENT/OUTPATIENT ANCILLARY SERVICE OTHER PASS THROUGH COSTS,HHA STATISTICAL DATA,COST ALLOCATION,TRIAL BALANCE OF EXPENSE ACCOUNTS,APPORTIONMENT OF INPATIENT/OUTPATIENT ANCILLARY SERVICE OTHER PASS THROUGH COSTS,,ALLOCATION OF NEW CAPITAL COSTS,TRIAL BALANCE OF EXPENSE ACCOUNTS,Total Inpatient Days/Outpatient Visits,APPORTIONMENT OF INPATIENT/OUTPATIENT ANCILLARY SERVICE OTHER PASS THROUGH COSTS,APPORTIONMENT OF INPATIENT/OUTPATIENT ANCILLARY SERVICE OTHER PASS THROUGH COSTS,APPORTIONMENT OF MEDICAL AND OTHER HEALTH SERVICES,HHA STATISTICAL DATA,HOSPITAL WAGE INDEX DATA,COST ALLOCATION,APPORTIONMENT OF INPATIENT/OUTPATIENT ANCILLARY SERVICE OTHER PASS THROUGH COSTS,Medicare Inpatient Days/Outpatient Visits,HOSPITAL WAGE INDEX DATA,HOSPITAL WAGE INDEX DATA,COMPUTATION OF RATIO OF COST TO CHARGES,APPORTIONMENT OF MEDICAL AND OTHER HEALTH SERVICES,COST ALLOCATION,COMPUTATION OF INPATIENT OPERATING COSTS,CALCULATION OF REIMBURSEMENT SETTLEMENT,BED DAYS AVAILABLE,ADJUSTMENTS,APPORTIONMENT OF INPATIENT/OUTPATIENT ANCILLARY SERVICE OTHER PASS THROUGH COSTS,INPATIENT ANCILLARY SERVICE COST APPORTIONMENT,TRIAL BALANCE OF EXPENSE ACCOUNTS,TRIAL BALANCE OF EXPENSE ACCOUNTS,COST ALLOCATION,APPORTIONMENT OF INPATIENT/OUTPATIENT ANCILLARY SERVICE OTHER PASS THROUGH COSTS,TRIAL BALANCE OF EXPENSE ACCOUNTS,TRIAL BALANCE OF EXPENSE ACCOUNTS,HHA STATISTICAL DATA,HHA STATISTICAL DATA,COST ALLOCATION,APPORTIONMENT OF INPATIENT ROUTINE SERVICE CAPITAL COSTS,APPORTIONMENT OF MEDICAL AND OTHER HEALTH SERVICES,APPORTIONMENT OF INPATIENT/OUTPATIENT ANCILLARY SERVICE OTHER PASS THROUGH COSTS,S-10 DATA,HOSPITAL WAGE INDEX DATA,APPORTIONMENT OF INPATIENT/OUTPATIENT ANCILLARY SERVICE OTHER PASS THROUGH COSTS,COST ALLOCATION,COST ALLOCATION,,BED DAYS AVAILABLE,RENAL STATISTICAL DATA,COST ALLOCATION,,INPATIENT ANCILLARY SERVICE COST APPORTIONMENT,APPORTIONMENT OF MEDICAL AND OTHER HEALTH SERVICES,APPORTIONMENT OF INPATIENT/OUTPATIENT ANCILLARY SERVICE OTHER PASS THROUGH COSTS,,APPORTIONMENT OF MEDICAL AND OTHER HEALTH SERVICES,COST ALLOCATION,INPATIENT ANCILLARY SERVICE COST APPORTIONMENT,HOSPITAL IDENTIFICATION INFORMATION,COMPUTATION OF RATIO OF COST TO CHARGES,APPORTIONMENT OF INPATIENT/OUTPATIENT ANCILLARY SERVICE OTHER PASS THROUGH COSTS,INPATIENT ANCILLARY SERVICE COST APPORTIONMENT,INPATIENT ANCILLARY SERVICE COST APPORTIONMENT,APPORTIONMENT OF INPATIENT/OUTPATIENT ANCILLARY SERVICE OTHER PASS THROUGH COSTS,STATEMENT OF REVENUES AND EXPENSES,HOSPITAL WAGE INDEX DATA,HOSPITAL WAGE INDEX DATA,TRIAL BALANCE OF EXPENSE ACCOUNTS,COMPUTATION OF RATIO OF COST TO CHARGES,BED DAYS AVAILABLE,Total Inpatient Days/Outpatient Visits,COST ALLOCATION,Total Inpatient Days/Outpatient Visits,APPORTIONMENT OF MEDICAL AND OTHER HEALTH SERVICES,COMPUTATION OF RATIO OF COST TO CHARGES,,COMPUTATION OF INPATIENT OPERATING COSTS,COST ALLOCATION,COMPUTATION OF RATIO OF COST TO CHARGES,APPORTIONMENT OF INPATIENT/OUTPATIENT ANCILLARY SERVICE OTHER PASS THROUGH COSTS,Total Inpatient Days/Outpatient Visits,,TRIAL BALANCE OF EXPENSE ACCOUNTS,HHA STATISTICAL DATA,,,S-10 DATA,INPATIENT ANCILLARY SERVICE COST APPORTIONMENT,ADJUSTMENTS,TRIAL BALANCE OF EXPENSE ACCOUNTS,TRIAL BALANCE OF EXPENSE ACCOUNTS,TRIAL BALANCE OF EXPENSE ACCOUNTS,COST ALLOCATION,COST ALLOCATION,Medicare Inpatient Days/Outpatient Visits,Total Inpatient Days/Outpatient Visits,TRIAL BALANCE OF EXPENSE ACCOUNTS,APPORTIONMENT OF INPATIENT/OUTPATIENT ANCILLARY SERVICE OTHER PASS THROUGH COSTS,TRIAL BALANCE OF EXPENSE ACCOUNTS,APPORTIONMENT OF INPATIENT/OUTPATIENT ANCILLARY SERVICE OTHER PASS THROUGH COSTS,APPORTIONMENT OF MEDICAL AND OTHER HEALTH SERVICES,ALLOCATION OF NEW CAPITAL COSTS,INPATIENT ANCILLARY SERVICE COST APPORTIONMENT,TRIAL BALANCE OF EXPENSE ACCOUNTS,CALCULATION OF REIMBURSEMENT SETTLEMENT,,TRIAL BALANCE OF EXPENSE ACCOUNTS,COST ALLOCATION,TRIAL BALANCE OF EXPENSE ACCOUNTS,ANALYSIS OF CHANGES IN NEW CAPITAL BALANCES,APPORTIONMENT OF INPATIENT/OUTPATIENT ANCILLARY SERVICE OTHER PASS THROUGH COSTS,COST ALLOCATION,ALLOCATION OF NEW CAPITAL COSTS,APPORTIONMENT OF INPATIENT ROUTINE SERVICE CAPITAL COSTS,APPORTIONMENT OF MEDICAL AND OTHER HEALTH SERVICES,BALANCE SHEET,APPORTIONMENT OF INPATIENT/OUTPATIENT ANCILLARY SERVICE OTHER PASS THROUGH COSTS,COMPUTATION OF RATIO OF COST TO CHARGES,COMPUTATION OF RATIO OF COST TO CHARGES,COST ALLOCATION,APPORTIONMENT OF MEDICAL AND OTHER HEALTH SERVICES,APPORTIONMENT OF INPATIENT/OUTPATIENT ANCILLARY SERVICE OTHER PASS THROUGH COSTS,TRIAL BALANCE OF EXPENSE ACCOUNTS,APPORTIONMENT OF INPATIENT/OUTPATIENT ANCILLARY SERVICE OTHER PASS THROUGH COSTS,APPORTIONMENT OF MEDICAL AND OTHER HEALTH SERVICES,TRIAL BALANCE OF EXPENSE ACCOUNTS,INPATIENT ANCILLARY SERVICE COST APPORTIONMENT,COST ALLOCATION,,APPORTIONMENT OF MEDICAL AND OTHER HEALTH SERVICES,ANALYSIS OF CHANGES IN NEW CAPITAL BALANCES,HOSPITAL WAGE INDEX DATA,ANALYSIS OF CHANGES IN NEW CAPITAL BALANCES,INPATIENT ANCILLARY SERVICE COST APPORTIONMENT,COMPUTATION OF RATIO OF COST TO CHARGES,APPORTIONMENT OF MEDICAL AND OTHER HEALTH SERVICES,TRIAL BALANCE OF EXPENSE ACCOUNTS,HHA STATISTICAL DATA,COMPUTATION OF RATIO OF COST TO CHARGES,APPORTIONMENT OF INPATIENT/OUTPATIENT ANCILLARY SERVICE OTHER PASS THROUGH COSTS,COMPUTATION OF RATIO OF COST TO CHARGES,INPATIENT ANCILLARY SERVICE COST APPORTIONMENT,HOSPITAL WAGE INDEX DATA,HOSPITAL WAGE INDEX DATA,Total Inpatient Days/Outpatient Visits,COST ALLOCATION,COMPUTATION OF RATIO OF COST TO CHARGES,,COMPUTATION OF INPATIENT OPERATING COSTS,INPATIENT ANCILLARY SERVICE COST APPORTIONMENT,COST ALLOCATION,APPORTIONMENT OF INPATIENT/OUTPATIENT ANCILLARY SERVICE OTHER PASS THROUGH COSTS,HOSPITAL WAGE INDEX DATA,COST ALLOCATION,HOSPITAL WAGE INDEX DATA,APPORTIONMENT OF MEDICAL AND OTHER HEALTH SERVICES,COMPUTATION OF RATIO OF COST TO CHARGES,APPORTIONMENT OF MEDICAL AND OTHER HEALTH SERVICES,ADJUSTMENTS,COST ALLOCATION,APPORTIONMENT OF INPATIENT/OUTPATIENT ANCILLARY SERVICE OTHER PASS THROUGH COSTS,APPORTIONMENT OF INPATIENT ROUTINE SERVICE CAPITAL COSTS,APPORTIONMENT OF INPATIENT/OUTPATIENT ANCILLARY SERVICE OTHER PASS THROUGH COSTS,NUMBER OF BEDS,INPATIENT ANCILLARY SERVICE COST APPORTIONMENT,COST ALLOCATION,APPORTIONMENT OF INPATIENT/OUTPATIENT ANCILLARY SERVICE OTHER PASS THROUGH COSTS,COST ALLOCATION,APPORTIONMENT OF MEDICAL AND OTHER HEALTH SERVICES,RENAL STATISTICAL DATA,HOSPITAL WAGE INDEX DATA,S-10 DATA,S-10 DATA,,APPORTIONMENT OF MEDICAL AND OTHER HEALTH SERVICES,APPORTIONMENT OF INPATIENT/OUTPATIENT ANCILLARY SERVICE OTHER PASS THROUGH COSTS,APPORTIONMENT OF MEDICAL AND OTHER HEALTH SERVICES,COMPUTATION OF RATIO OF COST TO CHARGES,COST ALLOCATION,APPORTIONMENT OF INPATIENT/OUTPATIENT ANCILLARY SERVICE OTHER PASS THROUGH COSTS,APPORTIONMENT OF INPATIENT ROUTINE SERVICE CAPITAL COSTS,HOSPITAL IDENTIFICATION INFORMATION,COMPUTATION OF RATIO OF COST TO CHARGES,HOSPITAL WAGE INDEX DATA,COMPUTATION OF RATIO OF COST TO CHARGES,APPORTIONMENT OF INPATIENT/OUTPATIENT ANCILLARY SERVICE OTHER PASS THROUGH COSTS,APPORTIONMENT OF INPATIENT/OUTPATIENT ANCILLARY SERVICE OTHER PASS THROUGH COSTS,COST ALLOCATION,HHA STATISTICAL DATA,COST ALLOCATION,APPORTIONMENT OF INPATIENT/OUTPATIENT ANCILLARY SERVICE OTHER PASS THROUGH COSTS,APPORTIONMENT OF MEDICAL AND OTHER HEALTH SERVICES,INPATIENT ANCILLARY SERVICE COST APPORTIONMENT,HOSPITAL WAGE INDEX DATA,TRIAL BALANCE OF EXPENSE ACCOUNTS,TRIAL BALANCE OF EXPENSE ACCOUNTS,INPATIENT ANCILLARY SERVICE COST APPORTIONMENT,COST ALLOCATION,INPATIENT ANCILLARY SERVICE COST APPORTIONMENT,INPATIENT ANCILLARY SERVICE COST APPORTIONMENT,CALCULATION OF REIMBURSEMENT SETTLEMENT (PPS),APPORTIONMENT OF INPATIENT/OUTPATIENT ANCILLARY SERVICE OTHER PASS THROUGH COSTS,APPORTIONMENT OF INPATIENT/OUTPATIENT ANCILLARY SERVICE OTHER PASS THROUGH COSTS,COST ALLOCATION,APPORTIONMENT OF INPATIENT/OUTPATIENT ANCILLARY SERVICE OTHER PASS THROUGH COSTS,NUMBER OF BEDS,CALCULATION OF REIMBURSEMENT SETTLEMENT,COMPUTATION OF RATIO OF COST TO CHARGES,APPORTIONMENT OF INPATIENT/OUTPATIENT ANCILLARY SERVICE OTHER PASS THROUGH COSTS,COMPUTATION OF RATIO OF COST TO CHARGES,APPORTIONMENT OF MEDICAL AND OTHER HEALTH SERVICES,COMPUTATION OF INPATIENT OPERATING COSTS,INPATIENT ANCILLARY SERVICE COST APPORTIONMENT,APPORTIONMENT OF INPATIENT/OUTPATIENT ANCILLARY SERVICE OTHER PASS THROUGH COSTS,APPORTIONMENT OF INPATIENT ROUTINE SERVICE CAPITAL COSTS,COST ALLOCATION,COMPUTATION OF RATIO OF COST TO CHARGES,APPORTIONMENT OF INPATIENT/OUTPATIENT ANCILLARY SERVICE OTHER PASS THROUGH COSTS,HOSPITAL WAGE INDEX DATA,,COMPUTATION OF RATIO OF COST TO CHARGES,APPORTIONMENT OF MEDICAL AND OTHER HEALTH SERVICES,COST ALLOCATION,ALLOCATION OF NEW CAPITAL COSTS,COMPUTATION OF RATIO OF COST TO CHARGES,COST ALLOCATION,APPORTIONMENT OF INPATIENT/OUTPATIENT ANCILLARY SERVICE OTHER PASS THROUGH COSTS,BED DAYS AVAILABLE,INPATIENT ANCILLARY SERVICE COST APPORTIONMENT,CALCULATION OF REIMBURSEMENT SETTLEMENT,ALLOCATION OF NEW CAPITAL COSTS,APPORTIONMENT OF MEDICAL AND OTHER HEALTH SERVICES,TRIAL BALANCE OF EXPENSE ACCOUNTS,ALLOCATION OF NEW CAPITAL COSTS,ALLOCATION OF NEW CAPITAL COSTS,APPORTIONMENT OF INPATIENT/OUTPATIENT ANCILLARY SERVICE OTHER PASS THROUGH COSTS,COST ALLOCATION,CALCULATION OF REIMBURSEMENT SETTLEMENT,HHA STATISTICAL DATA,HOSPITAL WAGE INDEX DATA,COMPUTATION OF RATIO OF COST TO CHARGES,CALCULATION OF REIMBURSEMENT SETTLEMENT,APPORTIONMENT OF INPATIENT/OUTPATIENT ANCILLARY SERVICE OTHER PASS THROUGH COSTS,HOSPITAL WAGE INDEX DATA,TRIAL BALANCE OF EXPENSE ACCOUNTS,ANALYSIS OF CHANGES IN NEW CAPITAL BALANCES,APPORTIONMENT OF INPATIENT ROUTINE SERVICE CAPITAL COSTS,Total Inpatient Days/Outpatient Visits,COMPUTATION OF RATIO OF COST TO CHARGES,APPORTIONMENT OF INPATIENT/OUTPATIENT ANCILLARY SERVICE OTHER PASS THROUGH COSTS,COMPUTATION OF INPATIENT OPERATING COSTS,BALANCE SHEET,,COST ALLOCATION,ALLOCATION OF NEW CAPITAL COSTS,Medicaid Inpatient Days/Outpatient Visits,TRIAL BALANCE OF EXPENSE ACCOUNTS,APPORTIONMENT OF INPATIENT/OUTPATIENT ANCILLARY SERVICE OTHER PASS THROUGH COSTS,APPORTIONMENT OF INPATIENT/OUTPATIENT ANCILLARY SERVICE OTHER PASS THROUGH COSTS,COMPUTATION OF INPATIENT OPERATING COSTS,TRIAL BALANCE OF EXPENSE ACCOUNTS,APPORTIONMENT OF INPATIENT/OUTPATIENT ANCILLARY SERVICE OTHER PASS THROUGH COSTS,HHA STATISTICAL DATA,HOSPITAL WAGE INDEX DATA,COST ALLOCATION,INPATIENT ANCILLARY SERVICE COST APPORTIONMENT,Total Inpatient Days/Outpatient Visits,,APPORTIONMENT OF INPATIENT/OUTPATIENT ANCILLARY SERVICE OTHER PASS THROUGH COSTS,HOSPITAL IDENTIFICATION INFORMATION,INPATIENT ANCILLARY SERVICE COST APPORTIONMENT,COMPUTATION OF RATIO OF COST TO CHARGES,HOSPITAL WAGE INDEX DATA,,HHA STATISTICAL DATA,TRIAL BALANCE OF EXPENSE ACCOUNTS,BED DAYS AVAILABLE,INPATIENT ANCILLARY SERVICE COST APPORTIONMENT,APPORTIONMENT OF INPATIENT/OUTPATIENT ANCILLARY SERVICE OTHER PASS THROUGH COSTS,COST ALLOCATION,APPORTIONMENT OF INPATIENT/OUTPATIENT ANCILLARY SERVICE OTHER PASS THROUGH COSTS,APPORTIONMENT OF INPATIENT/OUTPATIENT ANCILLARY SERVICE OTHER PASS THROUGH COSTS,TRIAL BALANCE OF EXPENSE ACCOUNTS,INPATIENT ANCILLARY SERVICE COST APPORTIONMENT,NUMBER OF BEDS,APPORTIONMENT OF MEDICAL AND OTHER HEALTH SERVICES,HOSPITAL WAGE INDEX DATA,COST ALLOCATION,COST ALLOCATION,HOSPITAL WAGE INDEX DATA,COMPUTATION OF RATIO OF COST TO CHARGES,TRIAL BALANCE OF EXPENSE ACCOUNTS,ADJUSTMENTS,,HHA STATISTICAL DATA,COMPUTATION OF RATIO OF COST TO CHARGES,Total Inpatient Days/Outpatient Visits,TRIAL BALANCE OF EXPENSE ACCOUNTS,APPORTIONMENT OF INPATIENT/OUTPATIENT ANCILLARY SERVICE OTHER PASS THROUGH COSTS,ANALYSIS OF CHANGES IN NEW CAPITAL BALANCES,BALANCE SHEET,HHA STATISTICAL DATA,TRIAL BALANCE OF EXPENSE ACCOUNTS,ADJUSTMENTS,HOSPITAL WAGE INDEX DATA,HOSPITAL WAGE INDEX DATA,COMPUTATION OF RATIO OF COST TO CHARGES,APPORTIONMENT OF INPATIENT ROUTINE SERVICE CAPITAL COSTS,INPATIENT ANCILLARY SERVICE COST APPORTIONMENT,COMPUTATION OF RATIO OF COST TO CHARGES,COMPUTATION OF RATIO OF COST TO CHARGES,S-10 DATA,COST ALLOCATION,ALLOCATION OF NEW CAPITAL COSTS,APPORTIONMENT OF INPATIENT/OUTPATIENT ANCILLARY SERVICE OTHER PASS THROUGH COSTS,,ALLOCATION OF NEW CAPITAL COSTS,S-10 DATA,HOSPITAL WAGE INDEX DATA,APPORTIONMENT OF INPATIENT/OUTPATIENT ANCILLARY SERVICE OTHER PASS THROUGH COSTS,APPORTIONMENT OF MEDICAL AND OTHER HEALTH SERVICES,TRIAL BALANCE OF EXPENSE ACCOUNTS,RENAL STATISTICAL DATA,APPORTIONMENT OF INPATIENT/OUTPATIENT ANCILLARY SERVICE OTHER PASS THROUGH COSTS,,BED DAYS AVAILABLE,APPORTIONMENT OF INPATIENT/OUTPATIENT ANCILLARY SERVICE OTHER PASS THROUGH COSTS,INPATIENT ANCILLARY SERVICE COST APPORTIONMENT,HHA STATISTICAL DATA,TRIAL BALANCE OF EXPENSE ACCOUNTS,,Medicare Inpatient Days/Outpatient Visits,HOSPITAL WAGE INDEX DATA,INPATIENT ANCILLARY SERVICE COST APPORTIONMENT,COST ALLOCATION,APPORTIONMENT OF MEDICAL AND OTHER HEALTH SERVICES,HOSPITAL WAGE INDEX DATA,APPORTIONMENT OF INPATIENT/OUTPATIENT ANCILLARY SERVICE OTHER PASS THROUGH COSTS,APPORTIONMENT OF INPATIENT/OUTPATIENT ANCILLARY SERVICE OTHER PASS THROUGH COSTS,INPATIENT ANCILLARY SERVICE COST APPORTIONMENT,COMPUTATION OF INPATIENT OPERATING COSTS,CALCULATION OF REIMBURSEMENT SETTLEMENT,,COST ALLOCATION,APPORTIONMENT OF INPATIENT/OUTPATIENT ANCILLARY SERVICE OTHER PASS THROUGH COSTS,TRIAL BALANCE OF EXPENSE ACCOUNTS,RENAL STATISTICAL DATA,TRIAL BALANCE OF EXPENSE ACCOUNTS,TRIAL BALANCE OF EXPENSE ACCOUNTS,COST ALLOCATION,STATEMENT OF REVENUES AND EXPENSES,COST ALLOCATION,APPORTIONMENT OF INPATIENT/OUTPATIENT ANCILLARY SERVICE OTHER PASS THROUGH COSTS,RENAL STATISTICAL DATA,INPATIENT ANCILLARY SERVICE COST APPORTIONMENT,APPORTIONMENT OF MEDICAL AND OTHER HEALTH SERVICES,TRIAL BALANCE OF EXPENSE ACCOUNTS,TRIAL BALANCE OF EXPENSE ACCOUNTS,APPORTIONMENT OF INPATIENT ROUTINE SERVICE OTHER PASS THROUGH COSTS,,INPATIENT ANCILLARY SERVICE COST APPORTIONMENT,APPORTIONMENT OF INPATIENT/OUTPATIENT ANCILLARY SERVICE OTHER PASS THROUGH COSTS,APPORTIONMENT OF MEDICAL AND OTHER HEALTH SERVICES,NUMBER OF BEDS,COMPUTATION OF RATIO OF COST TO CHARGES,APPORTIONMENT OF INPATIENT ROUTINE SERVICE OTHER PASS THROUGH COSTS,RENAL STATISTICAL DATA,APPORTIONMENT OF MEDICAL AND OTHER HEALTH SERVICES,S-10 DATA,,HOSPITAL WAGE INDEX DATA,HHA STATISTICAL DATA,COST ALLOCATION,STATEMENT OF REVENUES AND EXPENSES,CALCULATION OF REIMBURSEMENT SETTLEMENT,INPATIENT ANCILLARY SERVICE COST APPORTIONMENT,COST ALLOCATION,APPORTIONMENT OF MEDICAL AND OTHER HEALTH SERVICES,HOSPITAL WAGE INDEX DATA,APPORTIONMENT OF INPATIENT/OUTPATIENT ANCILLARY SERVICE OTHER PASS THROUGH COSTS,APPORTIONMENT OF INPATIENT/OUTPATIENT ANCILLARY SERVICE OTHER PASS THROUGH COSTS,APPORTIONMENT OF MEDICAL AND OTHER HEALTH SERVICES,STATEMENT OF REVENUES AND EXPENSES,HHA STATISTICAL DATA,INPATIENT ANCILLARY SERVICE COST APPORTIONMENT,APPORTIONMENT OF INPATIENT/OUTPATIENT ANCILLARY SERVICE OTHER PASS THROUGH COSTS,COST ALLOCATION,Medicaid Inpatient Days/Outpatient Visits,Medicaid Inpatient Days/Outpatient Visits,APPORTIONMENT OF INPATIENT/OUTPATIENT ANCILLARY SERVICE OTHER PASS THROUGH COSTS,INPATIENT ANCILLARY SERVICE COST APPORTIONMENT,INPATIENT ANCILLARY SERVICE COST APPORTIONMENT,APPORTIONMENT OF INPATIENT ROUTINE SERVICE OTHER PASS THROUGH COSTS,APPORTIONMENT OF MEDICAL AND OTHER HEALTH SERVICES,COMPUTATION OF INPATIENT OPERATING COSTS,TRIAL BALANCE OF EXPENSE ACCOUNTS,INPATIENT ANCILLARY SERVICE COST APPORTIONMENT,,ADJUSTMENTS,APPORTIONMENT OF INPATIENT/OUTPATIENT ANCILLARY SERVICE OTHER PASS THROUGH COSTS,COST ALLOCATION,,INPATIENT ANCILLARY SERVICE COST APPORTIONMENT,APPORTIONMENT OF INPATIENT/OUTPATIENT ANCILLARY SERVICE OTHER PASS THROUGH COSTS,COMPUTATION OF RATIO OF COST TO CHARGES,APPORTIONMENT OF INPATIENT/OUTPATIENT ANCILLARY SERVICE OTHER PASS THROUGH COSTS,COMPUTATION OF RATIO OF COST TO CHARGES,APPORTIONMENT OF INPATIENT/OUTPATIENT ANCILLARY SERVICE OTHER PASS THROUGH COSTS,TRIAL BALANCE OF EXPENSE ACCOUNTS,,INPATIENT ANCILLARY SERVICE COST APPORTIONMENT,APPORTIONMENT OF MEDICAL AND OTHER HEALTH SERVICES,RENAL STATISTICAL DATA,TRIAL BALANCE OF EXPENSE ACCOUNTS,TRIAL BALANCE OF EXPENSE ACCOUNTS,HOSPITAL WAGE INDEX DATA,COMPUTATION OF RATIO OF COST TO CHARGES,COST ALLOCATION,APPORTIONMENT OF INPATIENT/OUTPATIENT ANCILLARY SERVICE OTHER PASS THROUGH COSTS,INPATIENT ANCILLARY SERVICE COST APPORTIONMENT,INPATIENT ANCILLARY SERVICE COST APPORTIONMENT,INPATIENT ANCILLARY SERVICE COST APPORTIONMENT,CALCULATION OF REIMBURSEMENT SETTLEMENT,TRIAL BALANCE OF EXPENSE ACCOUNTS,HHA STATISTICAL DATA,TRIAL BALANCE OF EXPENSE ACCOUNTS,TRIAL BALANCE OF EXPENSE ACCOUNTS,INPATIENT ANCILLARY SERVICE COST APPORTIONMENT,TRIAL BALANCE OF EXPENSE ACCOUNTS,TRIAL BALANCE OF EXPENSE ACCOUNTS,ANALYSIS OF CHANGES IN NEW CAPITAL BALANCES,APPORTIONMENT OF MEDICAL AND OTHER HEALTH SERVICES,APPORTIONMENT OF INPATIENT/OUTPATIENT ANCILLARY SERVICE OTHER PASS THROUGH COSTS,RENAL STATISTICAL DATA,APPORTIONMENT OF INPATIENT/OUTPATIENT ANCILLARY SERVICE OTHER PASS THROUGH COSTS,TRIAL BALANCE OF EXPENSE ACCOUNTS,INPATIENT ANCILLARY SERVICE COST APPORTIONMENT,INPATIENT ANCILLARY SERVICE COST APPORTIONMENT,BALANCE SHEET,COMPUTATION OF RATIO OF COST TO CHARGES,COMPUTATION OF RATIO OF COST TO CHARGES,COST ALLOCATION,APPORTIONMENT OF INPATIENT ROUTINE SERVICE OTHER PASS THROUGH COSTS,INPATIENT ANCILLARY SERVICE COST APPORTIONMENT,TRIAL BALANCE OF EXPENSE ACCOUNTS,HOSPITAL WAGE INDEX DATA,APPORTIONMENT OF INPATIENT/OUTPATIENT ANCILLARY SERVICE OTHER PASS THROUGH COSTS,Total Inpatient Days/Outpatient Visits,ANALYSIS OF CHANGES IN NEW CAPITAL BALANCES,TRIAL BALANCE OF EXPENSE ACCOUNTS,APPORTIONMENT OF INPATIENT/OUTPATIENT ANCILLARY SERVICE OTHER PASS THROUGH COSTS,RENAL STATISTICAL DATA,COST ALLOCATION,INPATIENT ANCILLARY SERVICE COST APPORTIONMENT,COMPUTATION OF INPATIENT OPERATING COSTS,,HOSPITAL WAGE INDEX DATA,HHA STATISTICAL DATA,COST ALLOCATION,BED DAYS AVAILABLE,HOSPITAL WAGE INDEX DATA,APPORTIONMENT OF INPATIENT/OUTPATIENT ANCILLARY SERVICE OTHER PASS THROUGH COSTS,INPATIENT ANCILLARY SERVICE COST APPORTIONMENT,APPORTIONMENT OF INPATIENT/OUTPATIENT ANCILLARY SERVICE OTHER PASS THROUGH COSTS,APPORTIONMENT OF MEDICAL AND OTHER HEALTH SERVICES,TRIAL BALANCE OF EXPENSE ACCOUNTS,INPATIENT ANCILLARY SERVICE COST APPORTIONMENT,HOSPITAL WAGE INDEX DATA,APPORTIONMENT OF INPATIENT/OUTPATIENT ANCILLARY SERVICE OTHER PASS THROUGH COSTS,COMPUTATION OF RATIO OF COST TO CHARGES,INPATIENT ANCILLARY SERVICE COST APPORTIONMENT,,ALLOCATION OF NEW CAPITAL COSTS,APPORTIONMENT OF INPATIENT/OUTPATIENT ANCILLARY SERVICE OTHER PASS THROUGH COSTS,TRIAL BALANCE OF EXPENSE ACCOUNTS,APPORTIONMENT OF INPATIENT/OUTPATIENT ANCILLARY SERVICE OTHER PASS THROUGH COSTS,APPORTIONMENT OF MEDICAL AND OTHER HEALTH SERVICES,APPORTIONMENT OF INPATIENT/OUTPATIENT ANCILLARY SERVICE OTHER PASS THROUGH COSTS,APPORTIONMENT OF INPATIENT/OUTPATIENT ANCILLARY SERVICE OTHER PASS THROUGH COSTS,APPORTIONMENT OF MEDICAL AND OTHER HEALTH SERVICES,HOSPITAL WAGE INDEX DATA,APPORTIONMENT OF MEDICAL AND OTHER HEALTH SERVICES,COST ALLOCATION,INPATIENT ANCILLARY SERVICE COST APPORTIONMENT,COST ALLOCATION,COMPUTATION OF RATIO OF COST TO CHARGES,Medicaid Inpatient Days/Outpatient Visits,TRIAL BALANCE OF EXPENSE ACCOUNTS,COMPUTATION OF RATIO OF COST TO CHARGES,TRIAL BALANCE OF EXPENSE ACCOUNTS,INPATIENT ANCILLARY SERVICE COST APPORTIONMENT,INPATIENT ANCILLARY SERVICE COST APPORTIONMENT,ANALYSIS OF CHANGES IN NEW CAPITAL BALANCES,COST ALLOCATION,Total Inpatient Days/Outpatient Visits,ANALYSIS OF CHANGES IN NEW CAPITAL BALANCES,ANALYSIS OF CHANGES IN NEW CAPITAL BALANCES,TRIAL BALANCE OF EXPENSE ACCOUNTS,ALLOCATION OF NEW CAPITAL COSTS,INPATIENT ANCILLARY SERVICE COST APPORTIONMENT,INPATIENT ANCILLARY SERVICE COST APPORTIONMENT,INPATIENT ANCILLARY SERVICE COST APPORTIONMENT,COMPUTATION OF INPATIENT OPERATING COSTS,COST ALLOCATION,ALLOCATION OF NEW CAPITAL COSTS,APPORTIONMENT OF INPATIENT ROUTINE SERVICE CAPITAL COSTS,Total Inpatient Days/Outpatient Visits,BED DAYS AVAILABLE,INPATIENT ANCILLARY SERVICE COST APPORTIONMENT,APPORTIONMENT OF INPATIENT/OUTPATIENT ANCILLARY SERVICE OTHER PASS THROUGH COSTS,ALLOCATION OF NEW CAPITAL COSTS,APPORTIONMENT OF INPATIENT/OUTPATIENT ANCILLARY SERVICE OTHER PASS THROUGH COSTS,RENAL STATISTICAL DATA,BALANCE SHEET,Total Inpatient Days/Outpatient Visits,HOSPITAL WAGE INDEX DATA,HOSPITAL WAGE INDEX DATA,CALCULATION OF REIMBURSEMENT SETTLEMENT,TRIAL BALANCE OF EXPENSE ACCOUNTS,COST ALLOCATION,INPATIENT ANCILLARY SERVICE COST APPORTIONMENT,APPORTIONMENT OF INPATIENT/OUTPATIENT ANCILLARY SERVICE OTHER PASS THROUGH COSTS,ADJUSTMENTS,S-10 DATA,TRIAL BALANCE OF EXPENSE ACCOUNTS,HOSPITAL WAGE INDEX DATA,BALANCE SHEET,STATEMENT OF PATIENT REVENUES AND OPERATING EXPENSES,INPATIENT ANCILLARY SERVICE COST APPORTIONMENT,,COST ALLOCATION,INPATIENT ANCILLARY SERVICE COST APPORTIONMENT,ANALYSIS OF CHANGES IN NEW CAPITAL BALANCES,APPORTIONMENT OF INPATIENT/OUTPATIENT ANCILLARY SERVICE OTHER PASS THROUGH COSTS,APPORTIONMENT OF INPATIENT/OUTPATIENT ANCILLARY SERVICE OTHER PASS THROUGH COSTS,APPORTIONMENT OF INPATIENT/OUTPATIENT ANCILLARY SERVICE OTHER PASS THROUGH COSTS,HHA STATISTICAL DATA,COMPUTATION OF RATIO OF COST TO CHARGES,APPORTIONMENT OF INPATIENT/OUTPATIENT ANCILLARY SERVICE OTHER PASS THROUGH COSTS,STATEMENT OF PATIENT REVENUES AND OPERATING EXPENSES,APPORTIONMENT OF INPATIENT/OUTPATIENT ANCILLARY SERVICE OTHER PASS THROUGH COSTS,INPATIENT ANCILLARY SERVICE COST APPORTIONMENT,COST ALLOCATION,INPATIENT ANCILLARY SERVICE COST APPORTIONMENT,APPORTIONMENT OF INPATIENT/OUTPATIENT ANCILLARY SERVICE OTHER PASS THROUGH COSTS,APPORTIONMENT OF MEDICAL AND OTHER HEALTH SERVICES,COST ALLOCATION,TRIAL BALANCE OF EXPENSE ACCOUNTS,COST ALLOCATION,COMPUTATION OF RATIO OF COST TO CHARGES,TRIAL BALANCE OF EXPENSE ACCOUNTS,APPORTIONMENT OF INPATIENT/OUTPATIENT ANCILLARY SERVICE OTHER PASS THROUGH COSTS,APPORTIONMENT OF INPATIENT/OUTPATIENT ANCILLARY SERVICE OTHER PASS THROUGH COSTS,APPORTIONMENT OF INPATIENT/OUTPATIENT ANCILLARY SERVICE OTHER PASS THROUGH COSTS,APPORTIONMENT OF INPATIENT/OUTPATIENT ANCILLARY SERVICE OTHER PASS THROUGH COSTS,APPORTIONMENT OF INPATIENT ROUTINE SERVICE OTHER PASS THROUGH COSTS,BED DAYS AVAILABLE,COMPUTATION OF RATIO OF COST TO CHARGES,COMPUTATION OF RATIO OF COST TO CHARGES,COST ALLOCATION,ADJUSTMENTS,APPORTIONMENT OF INPATIENT/OUTPATIENT ANCILLARY SERVICE OTHER PASS THROUGH COSTS,HOSPITAL WAGE INDEX DATA,HOSPITAL IDENTIFICATION INFORMATION,S-10 DATA,COST ALLOCATION,APPORTIONMENT OF INPATIENT/OUTPATIENT ANCILLARY SERVICE OTHER PASS THROUGH COSTS,INPATIENT ANCILLARY SERVICE COST APPORTIONMENT,BALANCE SHEET,APPORTIONMENT OF INPATIENT/OUTPATIENT ANCILLARY SERVICE OTHER PASS THROUGH COSTS,STATEMENT OF REVENUES AND EXPENSES,APPORTIONMENT OF MEDICAL AND OTHER HEALTH SERVICES,INPATIENT ANCILLARY SERVICE COST APPORTIONMENT,INPATIENT ANCILLARY SERVICE COST APPORTIONMENT,ALLOCATION OF NEW CAPITAL COSTS,HOSPITAL IDENTIFICATION INFORMATION,,INPATIENT ANCILLARY SERVICE COST APPORTIONMENT,RENAL STATISTICAL DATA,COST ALLOCATION,COST ALLOCATION,CALCULATION OF REIMBURSEMENT SETTLEMENT,HHA STATISTICAL DATA,TRIAL BALANCE OF EXPENSE ACCOUNTS,COST ALLOCATION,APPORTIONMENT OF INPATIENT/OUTPATIENT ANCILLARY SERVICE OTHER PASS THROUGH COSTS,,APPORTIONMENT OF INPATIENT/OUTPATIENT ANCILLARY SERVICE OTHER PASS THROUGH COSTS,HOSPITAL WAGE INDEX DATA,Total Inpatient Days/Outpatient Visits,APPORTIONMENT OF INPATIENT/OUTPATIENT ANCILLARY SERVICE OTHER PASS THROUGH COSTS,ANALYSIS OF CHANGES IN NEW CAPITAL BALANCES,APPORTIONMENT OF INPATIENT/OUTPATIENT ANCILLARY SERVICE OTHER PASS THROUGH COSTS,,ALLOCATION OF NEW CAPITAL COSTS,APPORTIONMENT OF INPATIENT/OUTPATIENT ANCILLARY SERVICE OTHER PASS THROUGH COSTS,HHA STATISTICAL DATA,COST ALLOCATION,HOSPITAL WAGE INDEX DATA,HHA STATISTICAL DATA,COST ALLOCATION,,COST ALLOCATION,APPORTIONMENT OF MEDICAL AND OTHER HEALTH SERVICES,Total Inpatient Days/Outpatient Visits,HOSPITAL WAGE INDEX DATA,APPORTIONMENT OF INPATIENT/OUTPATIENT ANCILLARY SERVICE OTHER PASS THROUGH COSTS,COST ALLOCATION,TRIAL BALANCE OF EXPENSE ACCOUNTS,COMPUTATION OF RATIO OF COST TO CHARGES,APPORTIONMENT OF INPATIENT/OUTPATIENT ANCILLARY SERVICE OTHER PASS THROUGH COSTS,APPORTIONMENT OF INPATIENT/OUTPATIENT ANCILLARY SERVICE OTHER PASS THROUGH COSTS,APPORTIONMENT OF INPATIENT/OUTPATIENT ANCILLARY SERVICE OTHER PASS THROUGH COSTS,INPATIENT ANCILLARY SERVICE COST APPORTIONMENT,TRIAL BALANCE OF EXPENSE ACCOUNTS,APPORTIONMENT OF MEDICAL AND OTHER HEALTH SERVICES,APPORTIONMENT OF INPATIENT/OUTPATIENT ANCILLARY SERVICE OTHER PASS THROUGH COSTS,APPORTIONMENT OF INPATIENT/OUTPATIENT ANCILLARY SERVICE OTHER PASS THROUGH COSTS,APPORTIONMENT OF MEDICAL AND OTHER HEALTH SERVICES,ANALYSIS OF CHANGES IN NEW CAPITAL BALANCES,APPORTIONMENT OF INPATIENT ROUTINE SERVICE CAPITAL COSTS,APPORTIONMENT OF INPATIENT/OUTPATIENT ANCILLARY SERVICE OTHER PASS THROUGH COSTS,RECONCILIATION OF CAPITAL COST CENTERS,APPORTIONMENT OF INPATIENT/OUTPATIENT ANCILLARY SERVICE OTHER PASS THROUGH COSTS,APPORTIONMENT OF MEDICAL AND OTHER HEALTH SERVICES,COMPUTATION OF RATIO OF COST TO CHARGES,INPATIENT ANCILLARY SERVICE COST APPORTIONMENT,ANALYSIS OF CHANGES IN NEW CAPITAL BALANCES,APPORTIONMENT OF INPATIENT/OUTPATIENT ANCILLARY SERVICE OTHER PASS THROUGH COSTS,S-10 DATA,COST ALLOCATION,TRIAL BALANCE OF EXPENSE ACCOUNTS,Total Inpatient Days/Outpatient Visits,APPORTIONMENT OF INPATIENT/OUTPATIENT ANCILLARY SERVICE OTHER PASS THROUGH COSTS,CALCULATION OF REIMBURSEMENT SETTLEMENT,,COMPUTATION OF RATIO OF COST TO CHARGES,BALANCE SHEET,,HOSPITAL WAGE INDEX DATA,ANALYSIS OF CHANGES IN NEW CAPITAL BALANCES,HHA STATISTICAL DATA,COMPUTATION OF RATIO OF COST TO CHARGES,COMPUTATION OF RATIO OF COST TO CHARGES,ALLOCATION OF NEW CAPITAL COSTS,TRIAL BALANCE OF EXPENSE ACCOUNTS,TRIAL BALANCE OF EXPENSE ACCOUNTS,APPORTIONMENT OF INPATIENT/OUTPATIENT ANCILLARY SERVICE OTHER PASS THROUGH COSTS,APPORTIONMENT OF MEDICAL AND OTHER HEALTH SERVICES,RECONCILIATION OF CAPITAL COST CENTERS,COST ALLOCATION,APPORTIONMENT OF INPATIENT/OUTPATIENT ANCILLARY SERVICE OTHER PASS THROUGH COSTS,INPATIENT ANCILLARY SERVICE COST APPORTIONMENT,HOSPITAL WAGE INDEX DATA,TRIAL BALANCE OF EXPENSE ACCOUNTS,APPORTIONMENT OF MEDICAL AND OTHER HEALTH SERVICES,INPATIENT ANCILLARY SERVICE COST APPORTIONMENT,,TRIAL BALANCE OF EXPENSE ACCOUNTS,HOSPITAL WAGE INDEX DATA,ALLOCATION OF NEW CAPITAL COSTS,COST ALLOCATION,INPATIENT ANCILLARY SERVICE COST APPORTIONMENT,COST ALLOCATION,HHA STATISTICAL DATA,INPATIENT ANCILLARY SERVICE COST APPORTIONMENT,APPORTIONMENT OF MEDICAL AND OTHER HEALTH SERVICES,,TRIAL BALANCE OF EXPENSE ACCOUNTS,COMPUTATION OF RATIO OF COST TO CHARGES,COMPUTATION OF RATIO OF COST TO CHARGES,APPORTIONMENT OF INPATIENT/OUTPATIENT ANCILLARY SERVICE OTHER PASS THROUGH COSTS,APPORTIONMENT OF INPATIENT/OUTPATIENT ANCILLARY SERVICE OTHER PASS THROUGH COSTS,INPATIENT ANCILLARY SERVICE COST APPORTIONMENT,RENAL STATISTICAL DATA,TRIAL BALANCE OF EXPENSE ACCOUNTS,BED DAYS AVAILABLE,COST ALLOCATION,COMPUTATION OF RATIO OF COST TO CHARGES,Total Inpatient Days/Outpatient Visits,APPORTIONMENT OF INPATIENT/OUTPATIENT ANCILLARY SERVICE OTHER PASS THROUGH COSTS,COMPUTATION OF RATIO OF COST TO CHARGES,TRIAL BALANCE OF EXPENSE ACCOUNTS,,COMPUTATION OF RATIO OF COST TO CHARGES,APPORTIONMENT OF MEDICAL AND OTHER HEALTH SERVICES,INPATIENT ANCILLARY SERVICE COST APPORTIONMENT,COMPUTATION OF RATIO OF COST TO CHARGES,Total Inpatient Days/Outpatient Visits,COST ALLOCATION,APPORTIONMENT OF INPATIENT/OUTPATIENT ANCILLARY SERVICE OTHER PASS THROUGH COSTS,RENAL STATISTICAL DATA,CALCULATION OF REIMBURSEMENT SETTLEMENT,CALCULATION OF REIMBURSEMENT SETTLEMENT,CALCULATION OF REIMBURSEMENT SETTLEMENT,ALLOCATION OF NEW CAPITAL COSTS,APPORTIONMENT OF INPATIENT/OUTPATIENT ANCILLARY SERVICE OTHER PASS THROUGH COSTS,APPORTIONMENT OF INPATIENT/OUTPATIENT ANCILLARY SERVICE OTHER PASS THROUGH COSTS,APPORTIONMENT OF MEDICAL AND OTHER HEALTH SERVICES,CALCULATION OF REIMBURSEMENT SETTLEMENT,COST ALLOCATION,APPORTIONMENT OF INPATIENT/OUTPATIENT ANCILLARY SERVICE OTHER PASS THROUGH COSTS,APPORTIONMENT OF MEDICAL AND OTHER HEALTH SERVICES,RECONCILIATION OF CAPITAL COST CENTERS,APPORTIONMENT OF INPATIENT/OUTPATIENT ANCILLARY SERVICE OTHER PASS THROUGH COSTS,HOSPITAL WAGE INDEX DATA,HHA STATISTICAL DATA,INPATIENT ANCILLARY SERVICE COST APPORTIONMENT,ALLOCATION OF NEW CAPITAL COSTS,HHA STATISTICAL DATA,TRIAL BALANCE OF EXPENSE ACCOUNTS,Total Inpatient Days/Outpatient Visits,APPORTIONMENT OF INPATIENT/OUTPATIENT ANCILLARY SERVICE OTHER PASS THROUGH COSTS,APPORTIONMENT OF INPATIENT/OUTPATIENT ANCILLARY SERVICE OTHER PASS THROUGH COSTS,INPATIENT ANCILLARY SERVICE COST APPORTIONMENT,TRIAL BALANCE OF EXPENSE ACCOUNTS,INPATIENT ANCILLARY SERVICE COST APPORTIONMENT,INPATIENT ANCILLARY SERVICE COST APPORTIONMENT,TRIAL BALANCE OF EXPENSE ACCOUNTS,APPORTIONMENT OF INPATIENT ROUTINE SERVICE OTHER PASS THROUGH COSTS,NUMBER OF BEDS,INPATIENT ANCILLARY SERVICE COST APPORTIONMENT,Total Inpatient Days/Outpatient Visits,COST ALLOCATION,HOSPITAL WAGE INDEX DATA,COMPUTATION OF RATIO OF COST TO CHARGES,APPORTIONMENT OF INPATIENT/OUTPATIENT ANCILLARY SERVICE OTHER PASS THROUGH COSTS,APPORTIONMENT OF MEDICAL AND OTHER HEALTH SERVICES,BALANCE SHEET,BALANCE SHEET,APPORTIONMENT OF MEDICAL AND OTHER HEALTH SERVICES,,COST ALLOCATION,APPORTIONMENT OF INPATIENT/OUTPATIENT ANCILLARY SERVICE OTHER PASS THROUGH COSTS,COST ALLOCATION,APPORTIONMENT OF INPATIENT ROUTINE SERVICE OTHER PASS THROUGH COSTS,Total Inpatient Days/Outpatient Visits,INPATIENT ANCILLARY SERVICE COST APPORTIONMENT,ADJUSTMENTS,TRIAL BALANCE OF EXPENSE ACCOUNTS,COMPUTATION OF INPATIENT OPERATING COSTS,BED DAYS AVAILABLE,APPORTIONMENT OF MEDICAL AND OTHER HEALTH SERVICES,APPORTIONMENT OF MEDICAL AND OTHER HEALTH SERVICES,APPORTIONMENT OF INPATIENT/OUTPATIENT ANCILLARY SERVICE OTHER PASS THROUGH COSTS,,HHA STATISTICAL DATA,S-10 DATA,APPORTIONMENT OF INPATIENT/OUTPATIENT ANCILLARY SERVICE OTHER PASS THROUGH COSTS,APPORTIONMENT OF MEDICAL AND OTHER HEALTH SERVICES,INPATIENT ANCILLARY SERVICE COST APPORTIONMENT,BALANCE SHEET,INPATIENT ANCILLARY SERVICE COST APPORTIONMENT,HOSPITAL IDENTIFICATION INFORMATION,APPORTIONMENT OF INPATIENT/OUTPATIENT ANCILLARY SERVICE OTHER PASS THROUGH COSTS,APPORTIONMENT OF INPATIENT/OUTPATIENT ANCILLARY SERVICE OTHER PASS THROUGH COSTS,APPORTIONMENT OF INPATIENT/OUTPATIENT ANCILLARY SERVICE OTHER PASS THROUGH COSTS,TRIAL BALANCE OF EXPENSE ACCOUNTS,TRIAL BALANCE OF EXPENSE ACCOUNTS,NUMBER OF BEDS,COST ALLOCATION,COST ALLOCATION,HHA STATISTICAL DATA,COST ALLOCATION,COMPUTATION OF RATIO OF COST TO CHARGES,APPORTIONMENT OF MEDICAL AND OTHER HEALTH SERVICES,APPORTIONMENT OF INPATIENT/OUTPATIENT ANCILLARY SERVICE OTHER PASS THROUGH COSTS,COST ALLOCATION,ALLOCATION OF NEW CAPITAL COSTS,COST ALLOCATION,INPATIENT ANCILLARY SERVICE COST APPORTIONMENT,TRIAL BALANCE OF EXPENSE ACCOUNTS,COST ALLOCATION,Total Inpatient Days/Outpatient Visits,APPORTIONMENT OF MEDICAL AND OTHER HEALTH SERVICES,APPORTIONMENT OF INPATIENT/OUTPATIENT ANCILLARY SERVICE OTHER PASS THROUGH COSTS,APPORTIONMENT OF INPATIENT/OUTPATIENT ANCILLARY SERVICE OTHER PASS THROUGH COSTS,APPORTIONMENT OF INPATIENT/OUTPATIENT ANCILLARY SERVICE OTHER PASS THROUGH COSTS,APPORTIONMENT OF INPATIENT/OUTPATIENT ANCILLARY SERVICE OTHER PASS THROUGH COSTS,APPORTIONMENT OF INPATIENT/OUTPATIENT ANCILLARY SERVICE OTHER PASS THROUGH COSTS,TRIAL BALANCE OF EXPENSE ACCOUNTS,RENAL STATISTICAL DATA,INPATIENT ANCILLARY SERVICE COST APPORTIONMENT,INPATIENT ANCILLARY SERVICE COST APPORTIONMENT,APPORTIONMENT OF INPATIENT ROUTINE SERVICE CAPITAL COSTS,TRIAL BALANCE OF EXPENSE ACCOUNTS,APPORTIONMENT OF INPATIENT/OUTPATIENT ANCILLARY SERVICE OTHER PASS THROUGH COSTS,ANALYSIS OF CHANGES IN NEW CAPITAL BALANCES,COMPUTATION OF RATIO OF COST TO CHARGES,HOSPITAL WAGE INDEX DATA,COMPUTATION OF INPATIENT OPERATING COSTS,HOSPITAL WAGE INDEX DATA,HOSPITAL WAGE INDEX DATA,TRIAL BALANCE OF EXPENSE ACCOUNTS,APPORTIONMENT OF INPATIENT/OUTPATIENT ANCILLARY SERVICE OTHER PASS THROUGH COSTS,INPATIENT ANCILLARY SERVICE COST APPORTIONMENT,Total Inpatient Days/Outpatient Visits,APPORTIONMENT OF MEDICAL AND OTHER HEALTH SERVICES,INPATIENT ANCILLARY SERVICE COST APPORTIONMENT,TRIAL BALANCE OF EXPENSE ACCOUNTS,APPORTIONMENT OF MEDICAL AND OTHER HEALTH SERVICES,HOSPITAL WAGE INDEX DATA,APPORTIONMENT OF MEDICAL AND OTHER HEALTH SERVICES,HOSPITAL WAGE INDEX DATA,CALCULATION OF REIMBURSEMENT SETTLEMENT,APPORTIONMENT OF INPATIENT/OUTPATIENT ANCILLARY SERVICE OTHER PASS THROUGH COSTS,COST ALLOCATION,COMPUTATION OF RATIO OF COST TO CHARGES,APPORTIONMENT OF INPATIENT/OUTPATIENT ANCILLARY SERVICE OTHER PASS THROUGH COSTS,COMPUTATION OF RATIO OF COST TO CHARGES,ANALYSIS OF CHANGES IN NEW CAPITAL BALANCES,COST ALLOCATION,HOSPITAL WAGE INDEX DATA,APPORTIONMENT OF INPATIENT/OUTPATIENT ANCILLARY SERVICE OTHER PASS THROUGH COSTS,HOSPITAL WAGE INDEX DATA,HHA STATISTICAL DATA,INPATIENT ANCILLARY SERVICE COST APPORTIONMENT,INPATIENT ANCILLARY SERVICE COST APPORTIONMENT,COST ALLOCATION,COST ALLOCATION,COMPUTATION OF RATIO OF COST TO CHARGES,ADJUSTMENTS,TRIAL BALANCE OF EXPENSE ACCOUNTS,,TRIAL BALANCE OF EXPENSE ACCOUNTS,INPATIENT ANCILLARY SERVICE COST APPORTIONMENT,TRIAL BALANCE OF EXPENSE ACCOUNTS,RENAL STATISTICAL DATA,TRIAL BALANCE OF EXPENSE ACCOUNTS,COMPUTATION OF RATIO OF COST TO CHARGES,HOSPITAL WAGE INDEX DATA,HOSPITAL WAGE INDEX DATA,TRIAL BALANCE OF EXPENSE ACCOUNTS,BALANCE SHEET,TRIAL BALANCE OF EXPENSE ACCOUNTS,APPORTIONMENT OF INPATIENT/OUTPATIENT ANCILLARY SERVICE OTHER PASS THROUGH COSTS,APPORTIONMENT OF INPATIENT/OUTPATIENT ANCILLARY SERVICE OTHER PASS THROUGH COSTS,ALLOCATION OF NEW CAPITAL COSTS,Total Inpatient Days/Outpatient Visits,RENAL STATISTICAL DATA,COMPUTATION OF RATIO OF COST TO CHARGES,Total Inpatient Days/Outpatient Visits,COMPUTATION OF RATIO OF COST TO CHARGES,BALANCE SHEET,HOSPITAL WAGE INDEX DATA,COMPUTATION OF RATIO OF COST TO CHARGES,COST ALLOCATION,INPATIENT ANCILLARY SERVICE COST APPORTIONMENT,COST ALLOCATION,NUMBER OF BEDS,INPATIENT ANCILLARY SERVICE COST APPORTIONMENT,INPATIENT ANCILLARY SERVICE COST APPORTIONMENT,COMPUTATION OF RATIO OF COST TO CHARGES,COMPUTATION OF RATIO OF COST TO CHARGES,BALANCE SHEET,COMPUTATION OF RATIO OF COST TO CHARGES,APPORTIONMENT OF MEDICAL AND OTHER HEALTH SERVICES,COMPUTATION OF RATIO OF COST TO CHARGES,STATEMENT OF REVENUES AND EXPENSES,APPORTIONMENT OF INPATIENT/OUTPATIENT ANCILLARY SERVICE OTHER PASS THROUGH COSTS,INPATIENT ANCILLARY SERVICE COST APPORTIONMENT,HOSPITAL WAGE INDEX DATA,HOSPITAL WAGE INDEX DATA,HHA STATISTICAL DATA,TRIAL BALANCE OF EXPENSE ACCOUNTS,APPORTIONMENT OF INPATIENT/OUTPATIENT ANCILLARY SERVICE OTHER PASS THROUGH COSTS,APPORTIONMENT OF INPATIENT/OUTPATIENT ANCILLARY SERVICE OTHER PASS THROUGH COSTS,APPORTIONMENT OF MEDICAL AND OTHER HEALTH SERVICES,APPORTIONMENT OF MEDICAL AND OTHER HEALTH SERVICES,APPORTIONMENT OF MEDICAL AND OTHER HEALTH SERVICES,HOSPITAL WAGE INDEX DATA,INPATIENT ANCILLARY SERVICE COST APPORTIONMENT,COMPUTATION OF RATIO OF COST TO CHARGES,BALANCE SHEET,APPORTIONMENT OF INPATIENT/OUTPATIENT ANCILLARY SERVICE OTHER PASS THROUGH COSTS,RENAL STATISTICAL DATA,HHA STATISTICAL DATA,COMPUTATION OF RATIO OF COST TO CHARGES,APPORTIONMENT OF INPATIENT/OUTPATIENT ANCILLARY SERVICE OTHER PASS THROUGH COSTS,HHA STATISTICAL DATA,APPORTIONMENT OF MEDICAL AND OTHER HEALTH SERVICES,COMPUTATION OF RATIO OF COST TO CHARGES,INPATIENT ANCILLARY SERVICE COST APPORTIONMENT,INPATIENT ANCILLARY SERVICE COST APPORTIONMENT,TRIAL BALANCE OF EXPENSE ACCOUNTS,APPORTIONMENT OF MEDICAL AND OTHER HEALTH SERVICES,HHA STATISTICAL DATA,NUMBER OF BEDS,COMPUTATION OF RATIO OF COST TO CHARGES,APPORTIONMENT OF INPATIENT/OUTPATIENT ANCILLARY SERVICE OTHER PASS THROUGH COSTS,COST ALLOCATION,INPATIENT ANCILLARY SERVICE COST APPORTIONMENT,INPATIENT ANCILLARY SERVICE COST APPORTIONMENT,TRIAL BALANCE OF EXPENSE ACCOUNTS,BALANCE SHEET,APPORTIONMENT OF INPATIENT/OUTPATIENT ANCILLARY SERVICE OTHER PASS THROUGH COSTS,APPORTIONMENT OF MEDICAL AND OTHER HEALTH SERVICES,ALLOCATION OF NEW CAPITAL COSTS,COMPUTATION OF RATIO OF COST TO CHARGES,COMPUTATION OF RATIO OF COST TO CHARGES,,Total Inpatient Days/Outpatient Visits,COST ALLOCATION,ALLOCATION OF NEW CAPITAL COSTS,HHA STATISTICAL DATA,BED DAYS AVAILABLE,TRIAL BALANCE OF EXPENSE ACCOUNTS,INPATIENT ANCILLARY SERVICE COST APPORTIONMENT,COMPUTATION OF RATIO OF COST TO CHARGES,APPORTIONMENT OF MEDICAL AND OTHER HEALTH SERVICES,Medicaid Inpatient Days/Outpatient Visits,Total Inpatient Days/Outpatient Visits,INPATIENT ANCILLARY SERVICE COST APPORTIONMENT,S-10 DATA,COST ALLOCATION,BALANCE SHEET,APPORTIONMENT OF MEDICAL AND OTHER HEALTH SERVICES,COST ALLOCATION,APPORTIONMENT OF INPATIENT/OUTPATIENT ANCILLARY SERVICE OTHER PASS THROUGH COSTS,Medicaid Inpatient Days/Outpatient Visits,,ALLOCATION OF NEW CAPITAL COSTS,INPATIENT ANCILLARY SERVICE COST APPORTIONMENT,INPATIENT ANCILLARY SERVICE COST APPORTIONMENT,COST ALLOCATION,COST ALLOCATION,Medicaid Inpatient Days/Outpatient Visits,RECONCILIATION OF CAPITAL COST CENTERS,HOSPITAL WAGE INDEX DATA,TRIAL BALANCE OF EXPENSE ACCOUNTS,COMPUTATION OF RATIO OF COST TO CHARGES,COMPUTATION OF INPATIENT OPERATING COSTS,INPATIENT ANCILLARY SERVICE COST APPORTIONMENT,APPORTIONMENT OF INPATIENT/OUTPATIENT ANCILLARY SERVICE OTHER PASS THROUGH COSTS,APPORTIONMENT OF INPATIENT/OUTPATIENT ANCILLARY SERVICE OTHER PASS THROUGH COSTS,APPORTIONMENT OF MEDICAL AND OTHER HEALTH SERVICES,APPORTIONMENT OF INPATIENT/OUTPATIENT ANCILLARY SERVICE OTHER PASS THROUGH COSTS,COST ALLOCATION,APPORTIONMENT OF INPATIENT/OUTPATIENT ANCILLARY SERVICE OTHER PASS THROUGH COSTS,INPATIENT ANCILLARY SERVICE COST APPORTIONMENT,NUMBER OF BEDS,ALLOCATION OF NEW CAPITAL COSTS,,COMPUTATION OF RATIO OF COST TO CHARGES,APPORTIONMENT OF MEDICAL AND OTHER HEALTH SERVICES,TRIAL BALANCE OF EXPENSE ACCOUNTS,COMPUTATION OF RATIO OF COST TO CHARGES,APPORTIONMENT OF INPATIENT/OUTPATIENT ANCILLARY SERVICE OTHER PASS THROUGH COSTS,COMPUTATION OF RATIO OF COST TO CHARGES,INPATIENT ANCILLARY SERVICE COST APPORTIONMENT,,COMPUTATION OF RATIO OF COST TO CHARGES,INPATIENT ANCILLARY SERVICE COST APPORTIONMENT,COST ALLOCATION,RENAL STATISTICAL DATA,COST ALLOCATION,TRIAL BALANCE OF EXPENSE ACCOUNTS,APPORTIONMENT OF INPATIENT ROUTINE SERVICE CAPITAL COSTS,HOSPITAL WAGE INDEX DATA,,INPATIENT ANCILLARY SERVICE COST APPORTIONMENT,CALCULATION OF REIMBURSEMENT SETTLEMENT,APPORTIONMENT OF INPATIENT/OUTPATIENT ANCILLARY SERVICE OTHER PASS THROUGH COSTS,APPORTIONMENT OF INPATIENT/OUTPATIENT ANCILLARY SERVICE OTHER PASS THROUGH COSTS,HOSPITAL WAGE INDEX DATA,COMPUTATION OF RATIO OF COST TO CHARGES,COMPUTATION OF INPATIENT OPERATING COSTS,HOSPITAL WAGE INDEX DATA,COST ALLOCATION,APPORTIONMENT OF INPATIENT/OUTPATIENT ANCILLARY SERVICE OTHER PASS THROUGH COSTS,INPATIENT ANCILLARY SERVICE COST APPORTIONMENT,TRIAL BALANCE OF EXPENSE ACCOUNTS,TRIAL BALANCE OF EXPENSE ACCOUNTS,COST ALLOCATION,APPORTIONMENT OF MEDICAL AND OTHER HEALTH SERVICES,ADJUSTMENTS,COST ALLOCATION,INPATIENT ANCILLARY SERVICE COST APPORTIONMENT,COMPUTATION OF RATIO OF COST TO CHARGES,COMPUTATION OF RATIO OF COST TO CHARGES,HOSPITAL WAGE INDEX DATA,APPORTIONMENT OF INPATIENT/OUTPATIENT ANCILLARY SERVICE OTHER PASS THROUGH COSTS,APPORTIONMENT OF INPATIENT/OUTPATIENT ANCILLARY SERVICE OTHER PASS THROUGH COSTS,APPORTIONMENT OF MEDICAL AND OTHER HEALTH SERVICES,APPORTIONMENT OF INPATIENT/OUTPATIENT ANCILLARY SERVICE OTHER PASS THROUGH COSTS,HOSPITAL WAGE INDEX DATA,HOSPITAL WAGE INDEX DATA,HHA STATISTICAL DATA,S-10 DATA,NUMBER OF BEDS,TRIAL BALANCE OF EXPENSE ACCOUNTS,Medicaid Inpatient Days/Outpatient Visits,TRIAL BALANCE OF EXPENSE ACCOUNTS,TRIAL BALANCE OF EXPENSE ACCOUNTS,TRIAL BALANCE OF EXPENSE ACCOUNTS,COST ALLOCATION,ANALYSIS OF CHANGES IN NEW CAPITAL BALANCES,APPORTIONMENT OF INPATIENT/OUTPATIENT ANCILLARY SERVICE OTHER PASS THROUGH COSTS,APPORTIONMENT OF MEDICAL AND OTHER HEALTH SERVICES,COST ALLOCATION,RENAL STATISTICAL DATA,ALLOCATION OF NEW CAPITAL COSTS,COST ALLOCATION,APPORTIONMENT OF INPATIENT/OUTPATIENT ANCILLARY SERVICE OTHER PASS THROUGH COSTS,RENAL STATISTICAL DATA,S-10 DATA,APPORTIONMENT OF INPATIENT ROUTINE SERVICE OTHER PASS THROUGH COSTS,,APPORTIONMENT OF INPATIENT/OUTPATIENT ANCILLARY SERVICE OTHER PASS THROUGH COSTS,COMPUTATION OF RATIO OF COST TO CHARGES,COST ALLOCATION,APPORTIONMENT OF INPATIENT/OUTPATIENT ANCILLARY SERVICE OTHER PASS THROUGH COSTS,COMPUTATION OF INPATIENT OPERATING COSTS,CALCULATION OF REIMBURSEMENT SETTLEMENT,COMPUTATION OF RATIO OF COST TO CHARGES,TRIAL BALANCE OF EXPENSE ACCOUNTS,RECONCILIATION OF CAPITAL COST CENTERS,COST ALLOCATION,INPATIENT ANCILLARY SERVICE COST APPORTIONMENT,COST ALLOCATION,TRIAL BALANCE OF EXPENSE ACCOUNTS,INPATIENT ANCILLARY SERVICE COST APPORTIONMENT,APPORTIONMENT OF INPATIENT/OUTPATIENT ANCILLARY SERVICE OTHER PASS THROUGH COSTS,APPORTIONMENT OF MEDICAL AND OTHER HEALTH SERVICES,ALLOCATION OF NEW CAPITAL COSTS,APPORTIONMENT OF INPATIENT/OUTPATIENT ANCILLARY SERVICE OTHER PASS THROUGH COSTS,APPORTIONMENT OF MEDICAL AND OTHER HEALTH SERVICES,APPORTIONMENT OF MEDICAL AND OTHER HEALTH SERVICES,APPORTIONMENT OF INPATIENT ROUTINE SERVICE CAPITAL COSTS,ANALYSIS OF CHANGES IN NEW CAPITAL BALANCES,COMPUTATION OF RATIO OF COST TO CHARGES,APPORTIONMENT OF MEDICAL AND OTHER HEALTH SERVICES,COMPUTATION OF RATIO OF COST TO CHARGES,INPATIENT ANCILLARY SERVICE COST APPORTIONMENT,BALANCE SHEET,HOSPITAL WAGE INDEX DATA,TRIAL BALANCE OF EXPENSE ACCOUNTS,INPATIENT ANCILLARY SERVICE COST APPORTIONMENT,Total Inpatient Days/Outpatient Visits,Total Inpatient Days/Outpatient Visits,COMPUTATION OF RATIO OF COST TO CHARGES,TRIAL BALANCE OF EXPENSE ACCOUNTS,APPORTIONMENT OF INPATIENT/OUTPATIENT ANCILLARY SERVICE OTHER PASS THROUGH COSTS,Total Inpatient Days/Outpatient Visits,APPORTIONMENT OF INPATIENT/OUTPATIENT ANCILLARY SERVICE OTHER PASS THROUGH COSTS,TRIAL BALANCE OF EXPENSE ACCOUNTS,INPATIENT ANCILLARY SERVICE COST APPORTIONMENT,APPORTIONMENT OF MEDICAL AND OTHER HEALTH SERVICES,COMPUTATION OF RATIO OF COST TO CHARGES,BALANCE SHEET,APPORTIONMENT OF INPATIENT/OUTPATIENT ANCILLARY SERVICE OTHER PASS THROUGH COSTS,APPORTIONMENT OF INPATIENT/OUTPATIENT ANCILLARY SERVICE OTHER PASS THROUGH COSTS,APPORTIONMENT OF MEDICAL AND OTHER HEALTH SERVICES,APPORTIONMENT OF INPATIENT/OUTPATIENT ANCILLARY SERVICE OTHER PASS THROUGH COSTS,COST ALLOCATION,APPORTIONMENT OF MEDICAL AND OTHER HEALTH SERVICES,TRIAL BALANCE OF EXPENSE ACCOUNTS,APPORTIONMENT OF INPATIENT/OUTPATIENT ANCILLARY SERVICE OTHER PASS THROUGH COSTS,INPATIENT ANCILLARY SERVICE COST APPORTIONMENT,INPATIENT ANCILLARY SERVICE COST APPORTIONMENT,,STATEMENT OF REVENUES AND EXPENSES,TRIAL BALANCE OF EXPENSE ACCOUNTS,APPORTIONMENT OF MEDICAL AND OTHER HEALTH SERVICES,INPATIENT ANCILLARY SERVICE COST APPORTIONMENT,APPORTIONMENT OF INPATIENT/OUTPATIENT ANCILLARY SERVICE OTHER PASS THROUGH COSTS,TRIAL BALANCE OF EXPENSE ACCOUNTS,APPORTIONMENT OF MEDICAL AND OTHER HEALTH SERVICES,COST ALLOCATION,TRIAL BALANCE OF EXPENSE ACCOUNTS,TRIAL BALANCE OF EXPENSE ACCOUNTS,COMPUTATION OF RATIO OF COST TO CHARGES,RENAL STATISTICAL DATA,APPORTIONMENT OF INPATIENT/OUTPATIENT ANCILLARY SERVICE OTHER PASS THROUGH COSTS,RECONCILIATION OF CAPITAL COST CENTERS,ALLOCATION OF NEW CAPITAL COSTS,COST ALLOCATION,COST ALLOCATION,,HOSPITAL WAGE INDEX DATA,APPORTIONMENT OF INPATIENT/OUTPATIENT ANCILLARY SERVICE OTHER PASS THROUGH COSTS,ALLOCATION OF NEW CAPITAL COSTS,RECONCILIATION OF CAPITAL COST CENTERS,INPATIENT ANCILLARY SERVICE COST APPORTIONMENT,,APPORTIONMENT OF MEDICAL AND OTHER HEALTH SERVICES,TRIAL BALANCE OF EXPENSE ACCOUNTS,COST ALLOCATION,APPORTIONMENT OF INPATIENT/OUTPATIENT ANCILLARY SERVICE OTHER PASS THROUGH COSTS,COST ALLOCATION,HOSPITAL WAGE INDEX DATA,COST ALLOCATION,APPORTIONMENT OF MEDICAL AND OTHER HEALTH SERVICES,TRIAL BALANCE OF EXPENSE ACCOUNTS,COST ALLOCATION,TRIAL BALANCE OF EXPENSE ACCOUNTS,CALCULATION OF REIMBURSEMENT SETTLEMENT,APPORTIONMENT OF MEDICAL AND OTHER HEALTH SERVICES,APPORTIONMENT OF INPATIENT/OUTPATIENT ANCILLARY SERVICE OTHER PASS THROUGH COSTS,APPORTIONMENT OF INPATIENT/OUTPATIENT ANCILLARY SERVICE OTHER PASS THROUGH COSTS,INPATIENT ANCILLARY SERVICE COST APPORTIONMENT,APPORTIONMENT OF INPATIENT ROUTINE SERVICE CAPITAL COSTS,COST ALLOCATION,Total Inpatient Days/Outpatient Visits,Total Inpatient Days/Outpatient Visits,INPATIENT ANCILLARY SERVICE COST APPORTIONMENT,Total Inpatient Days/Outpatient Visits,,INPATIENT ANCILLARY SERVICE COST APPORTIONMENT,HHA STATISTICAL DATA,HHA STATISTICAL DATA,APPORTIONMENT OF MEDICAL AND OTHER HEALTH SERVICES,TRIAL BALANCE OF EXPENSE ACCOUNTS,INPATIENT ANCILLARY SERVICE COST APPORTIONMENT,ALLOCATION OF NEW CAPITAL COSTS,APPORTIONMENT OF MEDICAL AND OTHER HEALTH SERVICES,COMPUTATION OF INPATIENT OPERATING COSTS,COMPUTATION OF RATIO OF COST TO CHARGES,HOSPITAL WAGE INDEX DATA,ANALYSIS OF CHANGES IN NEW CAPITAL BALANCES,COST ALLOCATION,ADJUSTMENTS,CALCULATION OF REIMBURSEMENT SETTLEMENT,INPATIENT ANCILLARY SERVICE COST APPORTIONMENT,,COST ALLOCATION,HOSPITAL WAGE INDEX DATA,COMPUTATION OF RATIO OF COST TO CHARGES,APPORTIONMENT OF INPATIENT/OUTPATIENT ANCILLARY SERVICE OTHER PASS THROUGH COSTS,TRIAL BALANCE OF EXPENSE ACCOUNTS,APPORTIONMENT OF INPATIENT/OUTPATIENT ANCILLARY SERVICE OTHER PASS THROUGH COSTS,APPORTIONMENT OF INPATIENT/OUTPATIENT ANCILLARY SERVICE OTHER PASS THROUGH COSTS,RECONCILIATION OF CAPITAL COST CENTERS,COST ALLOCATION,CALCULATION OF REIMBURSEMENT SETTLEMENT,APPORTIONMENT OF INPATIENT/OUTPATIENT ANCILLARY SERVICE OTHER PASS THROUGH COSTS,HOSPITAL WAGE INDEX DATA,ANALYSIS OF CHANGES IN NEW CAPITAL BALANCES,HOSPITAL WAGE INDEX DATA,COST ALLOCATION,INPATIENT ANCILLARY SERVICE COST APPORTIONMENT,HOSPITAL WAGE INDEX DATA,CALCULATION OF REIMBURSEMENT SETTLEMENT,Total Inpatient Days/Outpatient Visits,HOSPITAL WAGE INDEX DATA,ALLOCATION OF NEW CAPITAL COSTS,COMPUTATION OF RATIO OF COST TO CHARGES,TRIAL BALANCE OF EXPENSE ACCOUNTS,HOSPITAL WAGE INDEX DATA,INPATIENT ANCILLARY SERVICE COST APPORTIONMENT,COST ALLOCATION,ANALYSIS OF CHANGES IN NEW CAPITAL BALANCES,APPORTIONMENT OF MEDICAL AND OTHER HEALTH SERVICES,HOSPITAL IDENTIFICATION INFORMATION,INPATIENT ANCILLARY SERVICE COST APPORTIONMENT,INPATIENT ANCILLARY SERVICE COST APPORTIONMENT,Total Inpatient Days/Outpatient Visits,ANALYSIS OF CHANGES IN NEW CAPITAL BALANCES,COST ALLOCATION,CALCULATION OF REIMBURSEMENT SETTLEMENT (PPS),APPORTIONMENT OF INPATIENT/OUTPATIENT ANCILLARY SERVICE OTHER PASS THROUGH COSTS,HOSPITAL WAGE INDEX DATA,TRIAL BALANCE OF EXPENSE ACCOUNTS,APPORTIONMENT OF INPATIENT/OUTPATIENT ANCILLARY SERVICE OTHER PASS THROUGH COSTS,APPORTIONMENT OF INPATIENT/OUTPATIENT ANCILLARY SERVICE OTHER PASS THROUGH COSTS,APPORTIONMENT OF MEDICAL AND OTHER HEALTH SERVICES,COST ALLOCATION,APPORTIONMENT OF INPATIENT ROUTINE SERVICE OTHER PASS THROUGH COSTS,APPORTIONMENT OF INPATIENT/OUTPATIENT ANCILLARY SERVICE OTHER PASS THROUGH COSTS,HOSPITAL WAGE INDEX DATA,APPORTIONMENT OF INPATIENT/OUTPATIENT ANCILLARY SERVICE OTHER PASS THROUGH COSTS,APPORTIONMENT OF MEDICAL AND OTHER HEALTH SERVICES,,APPORTIONMENT OF INPATIENT/OUTPATIENT ANCILLARY SERVICE OTHER PASS THROUGH COSTS,APPORTIONMENT OF INPATIENT/OUTPATIENT ANCILLARY SERVICE OTHER PASS THROUGH COSTS,HHA STATISTICAL DATA,TRIAL BALANCE OF EXPENSE ACCOUNTS,COST ALLOCATION,APPORTIONMENT OF MEDICAL AND OTHER HEALTH SERVICES,APPORTIONMENT OF INPATIENT/OUTPATIENT ANCILLARY SERVICE OTHER PASS THROUGH COSTS,,,BED DAYS AVAILABLE,,APPORTIONMENT OF MEDICAL AND OTHER HEALTH SERVICES,ALLOCATION OF NEW CAPITAL COSTS,HOSPITAL WAGE INDEX DATA,TRIAL BALANCE OF EXPENSE ACCOUNTS,INPATIENT ANCILLARY SERVICE COST APPORTIONMENT,COST ALLOCATION,INPATIENT ANCILLARY SERVICE COST APPORTIONMENT,HOSPITAL WAGE INDEX DATA,COST ALLOCATION,APPORTIONMENT OF MEDICAL AND OTHER HEALTH SERVICES,INPATIENT ANCILLARY SERVICE COST APPORTIONMENT,APPORTIONMENT OF MEDICAL AND OTHER HEALTH SERVICES,COST ALLOCATION,BALANCE SHEET,Total Inpatient Days/Outpatient Visits,COMPUTATION OF RATIO OF COST TO CHARGES,TRIAL BALANCE OF EXPENSE ACCOUNTS,APPORTIONMENT OF INPATIENT/OUTPATIENT ANCILLARY SERVICE OTHER PASS THROUGH COSTS,,INPATIENT ANCILLARY SERVICE COST APPORTIONMENT,HOSPITAL WAGE INDEX DATA,COST ALLOCATION,ALLOCATION OF NEW CAPITAL COSTS,BED DAYS AVAILABLE,COMPUTATION OF RATIO OF COST TO CHARGES,COST ALLOCATION,COST ALLOCATION,COST ALLOCATION,APPORTIONMENT OF INPATIENT/OUTPATIENT ANCILLARY SERVICE OTHER PASS THROUGH COSTS,HOSPITAL WAGE INDEX DATA,Total Inpatient Days/Outpatient Visits,COMPUTATION OF RATIO OF COST TO CHARGES,APPORTIONMENT OF MEDICAL AND OTHER HEALTH SERVICES,INPATIENT ANCILLARY SERVICE COST APPORTIONMENT,APPORTIONMENT OF INPATIENT/OUTPATIENT ANCILLARY SERVICE OTHER PASS THROUGH COSTS,COST ALLOCATION,INPATIENT ANCILLARY SERVICE COST APPORTIONMENT,APPORTIONMENT OF MEDICAL AND OTHER HEALTH SERVICES,TRIAL BALANCE OF EXPENSE ACCOUNTS,COMPUTATION OF RATIO OF COST TO CHARGES,APPORTIONMENT OF INPATIENT/OUTPATIENT ANCILLARY SERVICE OTHER PASS THROUGH COSTS,INPATIENT ANCILLARY SERVICE COST APPORTIONMENT,Total Inpatient Days/Outpatient Visits,HOSPITAL WAGE INDEX DATA,HOSPITAL WAGE INDEX DATA,HHA STATISTICAL DATA,APPORTIONMENT OF INPATIENT ROUTINE SERVICE CAPITAL COSTS,COMPUTATION OF RATIO OF COST TO CHARGES,APPORTIONMENT OF INPATIENT/OUTPATIENT ANCILLARY SERVICE OTHER PASS THROUGH COSTS,HOSPITAL WAGE INDEX DATA,TRIAL BALANCE OF EXPENSE ACCOUNTS,HOSPITAL WAGE INDEX DATA,Total Inpatient Days/Outpatient Visits,HOSPITAL WAGE INDEX DATA,INPATIENT ANCILLARY SERVICE COST APPORTIONMENT,HOSPITAL WAGE INDEX DATA,COST ALLOCATION,S-10 DATA,TRIAL BALANCE OF EXPENSE ACCOUNTS,TRIAL BALANCE OF EXPENSE ACCOUNTS,APPORTIONMENT OF INPATIENT/OUTPATIENT ANCILLARY SERVICE OTHER PASS THROUGH COSTS,COST ALLOCATION,APPORTIONMENT OF INPATIENT/OUTPATIENT ANCILLARY SERVICE OTHER PASS THROUGH COSTS,HOSPITAL WAGE INDEX DATA,ALLOCATION OF NEW CAPITAL COSTS,APPORTIONMENT OF MEDICAL AND OTHER HEALTH SERVICES,CALCULATION OF REIMBURSEMENT SETTLEMENT,COST ALLOCATION,COMPUTATION OF RATIO OF COST TO CHARGES,HOSPITAL WAGE INDEX DATA,COST ALLOCATION,TRIAL BALANCE OF EXPENSE ACCOUNTS,HOSPITAL WAGE INDEX DATA,ALLOCATION OF NEW CAPITAL COSTS,APPORTIONMENT OF MEDICAL AND OTHER HEALTH SERVICES,STATEMENT OF REVENUES AND EXPENSES,TRIAL BALANCE OF EXPENSE ACCOUNTS,COMPUTATION OF RATIO OF COST TO CHARGES,APPORTIONMENT OF INPATIENT/OUTPATIENT ANCILLARY SERVICE OTHER PASS THROUGH COSTS,APPORTIONMENT OF INPATIENT/OUTPATIENT ANCILLARY SERVICE OTHER PASS THROUGH COSTS,TRIAL BALANCE OF EXPENSE ACCOUNTS,COMPUTATION OF RATIO OF COST TO CHARGES,COST ALLOCATION,APPORTIONMENT OF INPATIENT/OUTPATIENT ANCILLARY SERVICE OTHER PASS THROUGH COSTS,INPATIENT ANCILLARY SERVICE COST APPORTIONMENT,INPATIENT ANCILLARY SERVICE COST APPORTIONMENT,COST ALLOCATION,TRIAL BALANCE OF EXPENSE ACCOUNTS,INPATIENT ANCILLARY SERVICE COST APPORTIONMENT,APPORTIONMENT OF MEDICAL AND OTHER HEALTH SERVICES,HOSPITAL WAGE INDEX DATA,ADJUSTMENTS,APPORTIONMENT OF MEDICAL AND OTHER HEALTH SERVICES,COST ALLOCATION,APPORTIONMENT OF MEDICAL AND OTHER HEALTH SERVICES,ADJUSTMENTS,COST ALLOCATION,APPORTIONMENT OF INPATIENT/OUTPATIENT ANCILLARY SERVICE OTHER PASS THROUGH COSTS,TRIAL BALANCE OF EXPENSE ACCOUNTS,BED DAYS AVAILABLE,APPORTIONMENT OF INPATIENT/OUTPATIENT ANCILLARY SERVICE OTHER PASS THROUGH COSTS,INPATIENT ANCILLARY SERVICE COST APPORTIONMENT,ALLOCATION OF NEW CAPITAL COSTS,ADJUSTMENTS,,APPORTIONMENT OF INPATIENT/OUTPATIENT ANCILLARY SERVICE OTHER PASS THROUGH COSTS,TRIAL BALANCE OF EXPENSE ACCOUNTS,APPORTIONMENT OF INPATIENT/OUTPATIENT ANCILLARY SERVICE OTHER PASS THROUGH COSTS,APPORTIONMENT OF INPATIENT/OUTPATIENT ANCILLARY SERVICE OTHER PASS THROUGH COSTS,APPORTIONMENT OF INPATIENT/OUTPATIENT ANCILLARY SERVICE OTHER PASS THROUGH COSTS,APPORTIONMENT OF INPATIENT/OUTPATIENT ANCILLARY SERVICE OTHER PASS THROUGH COSTS,APPORTIONMENT OF INPATIENT/OUTPATIENT ANCILLARY SERVICE OTHER PASS THROUGH COSTS,APPORTIONMENT OF MEDICAL AND OTHER HEALTH SERVICES,APPORTIONMENT OF INPATIENT/OUTPATIENT ANCILLARY SERVICE OTHER PASS THROUGH COSTS,APPORTIONMENT OF INPATIENT/OUTPATIENT ANCILLARY SERVICE OTHER PASS THROUGH COSTS,TRIAL BALANCE OF EXPENSE ACCOUNTS,CALCULATION OF REIMBURSEMENT SETTLEMENT (PPS),Medicaid Inpatient Days/Outpatient Visits,INPATIENT ANCILLARY SERVICE COST APPORTIONMENT,TRIAL BALANCE OF EXPENSE ACCOUNTS,,HOSPITAL WAGE INDEX DATA,COST ALLOCATION,APPORTIONMENT OF INPATIENT/OUTPATIENT ANCILLARY SERVICE OTHER PASS THROUGH COSTS,APPORTIONMENT OF INPATIENT/OUTPATIENT ANCILLARY SERVICE OTHER PASS THROUGH COSTS,,APPORTIONMENT OF MEDICAL AND OTHER HEALTH SERVICES,APPORTIONMENT OF INPATIENT/OUTPATIENT ANCILLARY SERVICE OTHER PASS THROUGH COSTS,INPATIENT ANCILLARY SERVICE COST APPORTIONMENT,TRIAL BALANCE OF EXPENSE ACCOUNTS,COMPUTATION OF RATIO OF COST TO CHARGES,TRIAL BALANCE OF EXPENSE ACCOUNTS,,COST ALLOCATION,APPORTIONMENT OF INPATIENT/OUTPATIENT ANCILLARY SERVICE OTHER PASS THROUGH COSTS,TRIAL BALANCE OF EXPENSE ACCOUNTS,TRIAL BALANCE OF EXPENSE ACCOUNTS,INPATIENT ANCILLARY SERVICE COST APPORTIONMENT,APPORTIONMENT OF MEDICAL AND OTHER HEALTH SERVICES,TRIAL BALANCE OF EXPENSE ACCOUNTS,,COST ALLOCATION,INPATIENT ANCILLARY SERVICE COST APPORTIONMENT,APPORTIONMENT OF INPATIENT/OUTPATIENT ANCILLARY SERVICE OTHER PASS THROUGH COSTS,TRIAL BALANCE OF EXPENSE ACCOUNTS,BED DAYS AVAILABLE,ALLOCATION OF NEW CAPITAL COSTS,COMPUTATION OF RATIO OF COST TO CHARGES,INPATIENT ANCILLARY SERVICE COST APPORTIONMENT,ALLOCATION OF NEW CAPITAL COSTS,CALCULATION OF REIMBURSEMENT SETTLEMENT,APPORTIONMENT OF INPATIENT/OUTPATIENT ANCILLARY SERVICE OTHER PASS THROUGH COSTS,APPORTIONMENT OF INPATIENT/OUTPATIENT ANCILLARY SERVICE OTHER PASS THROUGH COSTS,INPATIENT ANCILLARY SERVICE COST APPORTIONMENT,APPORTIONMENT OF MEDICAL AND OTHER HEALTH SERVICES,COMPUTATION OF INPATIENT OPERATING COSTS,HOSPITAL WAGE INDEX DATA,HOSPITAL WAGE INDEX DATA,BALANCE SHEET,COST ALLOCATION,APPORTIONMENT OF MEDICAL AND OTHER HEALTH SERVICES,APPORTIONMENT OF INPATIENT/OUTPATIENT ANCILLARY SERVICE OTHER PASS THROUGH COSTS,INPATIENT ANCILLARY SERVICE COST APPORTIONMENT,,INPATIENT ANCILLARY SERVICE COST APPORTIONMENT,RECONCILIATION OF CAPITAL COST CENTERS,NUMBER OF BEDS,APPORTIONMENT OF INPATIENT/OUTPATIENT ANCILLARY SERVICE OTHER PASS THROUGH COSTS,COST ALLOCATION,COMPUTATION OF RATIO OF COST TO CHARGES,INPATIENT ANCILLARY SERVICE COST APPORTIONMENT,APPORTIONMENT OF INPATIENT/OUTPATIENT ANCILLARY SERVICE OTHER PASS THROUGH COSTS,APPORTIONMENT OF INPATIENT/OUTPATIENT ANCILLARY SERVICE OTHER PASS THROUGH COSTS,APPORTIONMENT OF INPATIENT ROUTINE SERVICE OTHER PASS THROUGH COSTS,APPORTIONMENT OF INPATIENT/OUTPATIENT ANCILLARY SERVICE OTHER PASS THROUGH COSTS,COST ALLOCATION,TRIAL BALANCE OF EXPENSE ACCOUNTS,,APPORTIONMENT OF MEDICAL AND OTHER HEALTH SERVICES,INPATIENT ANCILLARY SERVICE COST APPORTIONMENT,HOSPITAL WAGE INDEX DATA,ANALYSIS OF CHANGES IN NEW CAPITAL BALANCES,CALCULATION OF REIMBURSEMENT SETTLEMENT,COST ALLOCATION,APPORTIONMENT OF MEDICAL AND OTHER HEALTH SERVICES,Medicare Inpatient Days/Outpatient Visits,APPORTIONMENT OF MEDICAL AND OTHER HEALTH SERVICES,TRIAL BALANCE OF EXPENSE ACCOUNTS,TRIAL BALANCE OF EXPENSE ACCOUNTS,COMPUTATION OF RATIO OF COST TO CHARGES,HOSPITAL WAGE INDEX DATA,HOSPITAL WAGE INDEX DATA,TRIAL BALANCE OF EXPENSE ACCOUNTS,APPORTIONMENT OF INPATIENT/OUTPATIENT ANCILLARY SERVICE OTHER PASS THROUGH COSTS,INPATIENT ANCILLARY SERVICE COST APPORTIONMENT,HOSPITAL WAGE INDEX DATA,APPORTIONMENT OF MEDICAL AND OTHER HEALTH SERVICES,TRIAL BALANCE OF EXPENSE ACCOUNTS,APPORTIONMENT OF INPATIENT/OUTPATIENT ANCILLARY SERVICE OTHER PASS THROUGH COSTS,INPATIENT ANCILLARY SERVICE COST APPORTIONMENT,COMPUTATION OF INPATIENT OPERATING COSTS,INPATIENT ANCILLARY SERVICE COST APPORTIONMENT,COMPUTATION OF INPATIENT OPERATING COSTS,HHA STATISTICAL DATA,ADJUSTMENTS,APPORTIONMENT OF MEDICAL AND OTHER HEALTH SERVICES,BALANCE SHEET,RECONCILIATION OF CAPITAL COST CENTERS,COMPUTATION OF RATIO OF COST TO CHARGES,APPORTIONMENT OF INPATIENT/OUTPATIENT ANCILLARY SERVICE OTHER PASS THROUGH COSTS,RENAL STATISTICAL DATA,HHA STATISTICAL DATA,COMPUTATION OF RATIO OF COST TO CHARGES,BED DAYS AVAILABLE,APPORTIONMENT OF INPATIENT/OUTPATIENT ANCILLARY SERVICE OTHER PASS THROUGH COSTS,COMPUTATION OF INPATIENT OPERATING COSTS,HOSPITAL IDENTIFICATION INFORMATION,ANALYSIS OF CHANGES IN NEW CAPITAL BALANCES,COST ALLOCATION,TRIAL BALANCE OF EXPENSE ACCOUNTS,COMPUTATION OF RATIO OF COST TO CHARGES,TRIAL BALANCE OF EXPENSE ACCOUNTS,COMPUTATION OF RATIO OF COST TO CHARGES,COMPUTATION OF RATIO OF COST TO CHARGES,TRIAL BALANCE OF EXPENSE ACCOUNTS,BALANCE SHEET,APPORTIONMENT OF INPATIENT/OUTPATIENT ANCILLARY SERVICE OTHER PASS THROUGH COSTS,,COMPUTATION OF INPATIENT OPERATING COSTS,,HOSPITAL WAGE INDEX DATA,TRIAL BALANCE OF EXPENSE ACCOUNTS,TRIAL BALANCE OF EXPENSE ACCOUNTS,INPATIENT ANCILLARY SERVICE COST APPORTIONMENT,COMPUTATION OF RATIO OF COST TO CHARGES,INPATIENT ANCILLARY SERVICE COST APPORTIONMENT,APPORTIONMENT OF INPATIENT ROUTINE SERVICE CAPITAL COSTS,APPORTIONMENT OF INPATIENT/OUTPATIENT ANCILLARY SERVICE OTHER PASS THROUGH COSTS,COST ALLOCATION,COST ALLOCATION,ADJUSTMENTS,COMPUTATION OF RATIO OF COST TO CHARGES,ANALYSIS OF CHANGES IN NEW CAPITAL BALANCES,APPORTIONMENT OF INPATIENT/OUTPATIENT ANCILLARY SERVICE OTHER PASS THROUGH COSTS,APPORTIONMENT OF INPATIENT/OUTPATIENT ANCILLARY SERVICE OTHER PASS THROUGH COSTS,INPATIENT ANCILLARY SERVICE COST APPORTIONMENT,APPORTIONMENT OF INPATIENT/OUTPATIENT ANCILLARY SERVICE OTHER PASS THROUGH COSTS,HOSPITAL WAGE INDEX DATA,HOSPITAL WAGE INDEX DATA,COMPUTATION OF RATIO OF COST TO CHARGES,,HHA STATISTICAL DATA,HHA STATISTICAL DATA,APPORTIONMENT OF MEDICAL AND OTHER HEALTH SERVICES,COST ALLOCATION,ALLOCATION OF NEW CAPITAL COSTS,TRIAL BALANCE OF EXPENSE ACCOUNTS,CALCULATION OF REIMBURSEMENT SETTLEMENT,S-10 DATA,TRIAL BALANCE OF EXPENSE ACCOUNTS,COMPUTATION OF INPATIENT OPERATING COSTS,COST ALLOCATION,COMPUTATION OF INPATIENT OPERATING COSTS,APPORTIONMENT OF INPATIENT/OUTPATIENT ANCILLARY SERVICE OTHER PASS THROUGH COSTS,INPATIENT ANCILLARY SERVICE COST APPORTIONMENT,COST ALLOCATION,APPORTIONMENT OF INPATIENT ROUTINE SERVICE CAPITAL COSTS,INPATIENT ANCILLARY SERVICE COST APPORTIONMENT,COMPUTATION OF INPATIENT OPERATING COSTS,TRIAL BALANCE OF EXPENSE ACCOUNTS,APPORTIONMENT OF INPATIENT/OUTPATIENT ANCILLARY SERVICE OTHER PASS THROUGH COSTS,,COST ALLOCATION,INPATIENT ANCILLARY SERVICE COST APPORTIONMENT,Medicaid Inpatient Days/Outpatient Visits,,TRIAL BALANCE OF EXPENSE ACCOUNTS,HHA STATISTICAL DATA,APPORTIONMENT OF MEDICAL AND OTHER HEALTH SERVICES,HHA STATISTICAL DATA,COST ALLOCATION,ANALYSIS OF CHANGES IN NEW CAPITAL BALANCES,COST ALLOCATION,APPORTIONMENT OF INPATIENT/OUTPATIENT ANCILLARY SERVICE OTHER PASS THROUGH COSTS,APPORTIONMENT OF INPATIENT/OUTPATIENT ANCILLARY SERVICE OTHER PASS THROUGH COSTS,ADJUSTMENTS,Total Inpatient Days/Outpatient Visits,COST ALLOCATION,COST ALLOCATION,COST ALLOCATION,TRIAL BALANCE OF EXPENSE ACCOUNTS,COMPUTATION OF RATIO OF COST TO CHARGES,APPORTIONMENT OF INPATIENT/OUTPATIENT ANCILLARY SERVICE OTHER PASS THROUGH COSTS,COST ALLOCATION,INPATIENT ANCILLARY SERVICE COST APPORTIONMENT,COMPUTATION OF RATIO OF COST TO CHARGES,INPATIENT ANCILLARY SERVICE COST APPORTIONMENT,APPORTIONMENT OF INPATIENT/OUTPATIENT ANCILLARY SERVICE OTHER PASS THROUGH COSTS,COST ALLOCATION,APPORTIONMENT OF INPATIENT/OUTPATIENT ANCILLARY SERVICE OTHER PASS THROUGH COSTS,APPORTIONMENT OF INPATIENT/OUTPATIENT ANCILLARY SERVICE OTHER PASS THROUGH COSTS,INPATIENT ANCILLARY SERVICE COST APPORTIONMENT,TRIAL BALANCE OF EXPENSE ACCOUNTS,HOSPITAL WAGE INDEX DATA,APPORTIONMENT OF INPATIENT/OUTPATIENT ANCILLARY SERVICE OTHER PASS THROUGH COSTS,APPORTIONMENT OF INPATIENT ROUTINE SERVICE CAPITAL COSTS,APPORTIONMENT OF INPATIENT/OUTPATIENT ANCILLARY SERVICE OTHER PASS THROUGH COSTS,TRIAL BALANCE OF EXPENSE ACCOUNTS,INPATIENT ANCILLARY SERVICE COST APPORTIONMENT,CALCULATION OF REIMBURSEMENT SETTLEMENT,COST ALLOCATION,COST ALLOCATION,COST ALLOCATION,COST ALLOCATION,APPORTIONMENT OF MEDICAL AND OTHER HEALTH SERVICES,APPORTIONMENT OF INPATIENT/OUTPATIENT ANCILLARY SERVICE OTHER PASS THROUGH COSTS,COMPUTATION OF INPATIENT OPERATING COSTS,NUMBER OF BEDS,BED DAYS AVAILABLE,APPORTIONMENT OF INPATIENT/OUTPATIENT ANCILLARY SERVICE OTHER PASS THROUGH COSTS,HHA STATISTICAL DATA,HOSPITAL WAGE INDEX DATA,APPORTIONMENT OF MEDICAL AND OTHER HEALTH SERVICES,APPORTIONMENT OF MEDICAL AND OTHER HEALTH SERVICES,APPORTIONMENT OF INPATIENT/OUTPATIENT ANCILLARY SERVICE OTHER PASS THROUGH COSTS,TRIAL BALANCE OF EXPENSE ACCOUNTS,COST ALLOCATION,HOSPITAL WAGE INDEX DATA,APPORTIONMENT OF MEDICAL AND OTHER HEALTH SERVICES,INPATIENT ANCILLARY SERVICE COST APPORTIONMENT,TRIAL BALANCE OF EXPENSE ACCOUNTS,ALLOCATION OF NEW CAPITAL COSTS,INPATIENT ANCILLARY SERVICE COST APPORTIONMENT,COMPUTATION OF RATIO OF COST TO CHARGES,INPATIENT ANCILLARY SERVICE COST APPORTIONMENT,APPORTIONMENT OF INPATIENT/OUTPATIENT ANCILLARY SERVICE OTHER PASS THROUGH COSTS,ALLOCATION OF NEW CAPITAL COSTS,INPATIENT ANCILLARY SERVICE COST APPORTIONMENT,HOSPITAL IDENTIFICATION INFORMATION,COMPUTATION OF INPATIENT OPERATING COSTS,COST ALLOCATION,TRIAL BALANCE OF EXPENSE ACCOUNTS,COST ALLOCATION,HHA STATISTICAL DATA,,,ANALYSIS OF CHANGES IN NEW CAPITAL BALANCES,TRIAL BALANCE OF EXPENSE ACCOUNTS,COST ALLOCATION,APPORTIONMENT OF INPATIENT ROUTINE SERVICE CAPITAL COSTS,APPORTIONMENT OF MEDICAL AND OTHER HEALTH SERVICES,COST ALLOCATION,APPORTIONMENT OF MEDICAL AND OTHER HEALTH SERVICES,CALCULATION OF REIMBURSEMENT SETTLEMENT,APPORTIONMENT OF INPATIENT/OUTPATIENT ANCILLARY SERVICE OTHER PASS THROUGH COSTS,TRIAL BALANCE OF EXPENSE ACCOUNTS,RENAL STATISTICAL DATA,COST ALLOCATION,COST ALLOCATION,INPATIENT ANCILLARY SERVICE COST APPORTIONMENT,RENAL STATISTICAL DATA,RECONCILIATION OF CAPITAL COST CENTERS,Medicaid Inpatient Days/Outpatient Visits,APPORTIONMENT OF INPATIENT/OUTPATIENT ANCILLARY SERVICE OTHER PASS THROUGH COSTS,ANALYSIS OF CHANGES IN NEW CAPITAL BALANCES,TRIAL BALANCE OF EXPENSE ACCOUNTS,,TRIAL BALANCE OF EXPENSE ACCOUNTS,Total Inpatient Days/Outpatient Visits,INPATIENT ANCILLARY SERVICE COST APPORTIONMENT,TRIAL BALANCE OF EXPENSE ACCOUNTS,APPORTIONMENT OF INPATIENT/OUTPATIENT ANCILLARY SERVICE OTHER PASS THROUGH COSTS,HHA STATISTICAL DATA,BED DAYS AVAILABLE,ADJUSTMENTS,COST ALLOCATION,COMPUTATION OF RATIO OF COST TO CHARGES,TRIAL BALANCE OF EXPENSE ACCOUNTS,APPORTIONMENT OF INPATIENT ROUTINE SERVICE CAPITAL COSTS,S-10 DATA,HOSPITAL WAGE INDEX DATA,INPATIENT ANCILLARY SERVICE COST APPORTIONMENT,TRIAL BALANCE OF EXPENSE ACCOUNTS,COMPUTATION OF RATIO OF COST TO CHARGES,APPORTIONMENT OF MEDICAL AND OTHER HEALTH SERVICES,APPORTIONMENT OF INPATIENT/OUTPATIENT ANCILLARY SERVICE OTHER PASS THROUGH COSTS,APPORTIONMENT OF MEDICAL AND OTHER HEALTH SERVICES,INPATIENT ANCILLARY SERVICE COST APPORTIONMENT,INPATIENT ANCILLARY SERVICE COST APPORTIONMENT,HHA STATISTICAL DATA,APPORTIONMENT OF MEDICAL AND OTHER HEALTH SERVICES,INPATIENT ANCILLARY SERVICE COST APPORTIONMENT,INPATIENT ANCILLARY SERVICE COST APPORTIONMENT,INPATIENT ANCILLARY SERVICE COST APPORTIONMENT,INPATIENT ANCILLARY SERVICE COST APPORTIONMENT,INPATIENT ANCILLARY SERVICE COST APPORTIONMENT,ANALYSIS OF CHANGES IN NEW CAPITAL BALANCES,HHA STATISTICAL DATA,ADJUSTMENTS,HOSPITAL IDENTIFICATION INFORMATION,,COST ALLOCATION,HOSPITAL WAGE INDEX DATA,APPORTIONMENT OF MEDICAL AND OTHER HEALTH SERVICES,APPORTIONMENT OF INPATIENT/OUTPATIENT ANCILLARY SERVICE OTHER PASS THROUGH COSTS,HOSPITAL WAGE INDEX DATA,APPORTIONMENT OF INPATIENT/OUTPATIENT ANCILLARY SERVICE OTHER PASS THROUGH COSTS,Medicare Inpatient Days/Outpatient Visits,,COST ALLOCATION,FFY,Hospital Type (From CMS Hospitals Data Archive),Name and Num
,Curated Name and Num,Hospital type (modified),Type of Control of Hospital (See Table I) (S2_1_C1_21),Lon,Lat,Speech Pathology (D3_IRF_C2_68),"Medicare certified kidney 
transplant center cert date (S2_1_C1_126)","If Line 32, Col 1 is yes, enter the method used: (A, B, or E only) (S2_1_C2_115)",Whole Blood & Packed Red Blood Cells (D3_IRF_C2_62),OOT (C_1_C6_9930),Ratio of line 15 to line 16 (E_B_HOS_C1_17),Stand-alone CHIP -- Costs minus net revenue (0 min) (S10_C1_12),"COST REIMBURSED SERVICES NOT SUBJECT TO DEDUCTIBLES AND COINSURANCE - CHARGES, Anesthesiology (D_5_HOS_C4_53)",FQHC (B_1_C22_89),Sequestration adjustment (E_B_HOS_C1_4001),"COST SERVICES SUBJECT TO DEDUCTIBLES AND COINSURANCE - COST, Impl. Dev. Charged to Patients (D_5_HOS_C6_72)",Adults and Pediatrics (A_C2_30),Emergency (D_4_HOS_C11_91),Other Ancillary (D3_HOS_C2_76),Burn Intensive Care Unit (A_C2_33),Other Outpatient Services (D3_IPF_C2_93),Line 2 times line 5 (E_B_HOS_C1_6),Adults and Pediatrics (B_1_C26_30),MDH status beginning date (MM/DD/YY) (S2_1_C1_38),Hospice 3 Provider Number (S2_1_C2_1402),Surgical Intensive Care Unit (D_1_HOS_C7_34),Other Ancillary (D_4_SNF_C11_76),"COST SERVICES SUBJECT TO DEDUCTIBLES AND COINSURANCE - COST, Ambulance Services (D_5_HOS_C6_95)","Blood Storing, Processing, Trans (C_1_C6_63)","COST SERVICES SUBJECT TO DEDUCTIBLES AND COINSURANCE - COST, Observation Beds (Distinct Unit) (D_5_HOS_C6_9201)","HHA III, Total Visits (S4_HHA3_C5_33)",Electrocardiology (D_4_HOS_C3_69),FQHC (B_1_C21_89),Electroencephalography (D_4_IPF_C11_70),Pass through Cost for Program Inpatient Routine (D1_HOS_C1_50),Drugs Charged to Patients (D_4_SNF_C11_73),Renal Dialysis (D3_SNF_C3_74),Subprovider II (A_C6_4201),MRI (D3_SNF_C2_58),"Number of patients on transplant 
list (S5_C1_11)",Subtotal (E_B_HOS_C1_40),Temporary Investments (G_C1THRU4_2),Operating Room (D_4_HOS_C4_50),ASC (Non Distinct Part) (B_1_C22_75),Other Reimbursable (C_1_C5_98),Program Inpatient Ancillary Service Cost (D1_IRF_C1_48),Intensive Care Unit (A_C6_31),Investment Income-New Bldgs & Fixtures (A8_C2_1),"COST SERVICES NOT SUBJECT TO DEDUCTIBLES AND COINSURANCE - COST, Other Ancillary (D_5_HOS_C7_76)","HHA III, Total Non Routine Medical  Supply Charges (S4_HHA3_C5_38)",Is this a rural hospital qualifying for an exception to the certified registered nurse anesthetist the CRNA fee schedule? (Y/N) (S2_1_C1_108),Subprovider-IPF (D_1_HOS_C7_40),"AMOUNT REPORTED, Maintenance and Repairs (S3_2_C2_29)",Whole Blood & Packed Red Blood Cells (D_4_HOS_C10_62),"COST REIMBURSED SERVICES NOT SUBJECT TO DEDUCTIBLES AND COINSURANCE - CHARGES, Blood Storing, Processing, Trans (D_5_HOS_C4_63)","HHA I, PEP Episodes:  Total Number of Episodes (S4_HHA1_C4_36)",Home Program Dialysis (A_C2_94),CT Scan (D_4_IPF_C11_57),Surgical Intensive Care Unit (S3_1_C7_11),Laundry and Linen Service (A_C6_8),"HHA I, With Outliers:  Total Charges (S4_HHA1_C2_35)",Total Hospital Interns & Residents (S3_1_C9_14),OOT (B_2_C26_9930),"Insurance, Total (A7_3_C5_3)",FQHC 5 Provider Number (S2_1_C2_1604),"TOTAL CAPITAL COSTS AFTER COST ALLOCATION, Subprovider I (B_2_C26_42)",IRF (S3_1_C2_17),Electrocardiology (B_1_C26_69),Payments received from patients for amounts previously written off as charity care (S10_C1_22),Impl. Dev. Charged to Patients (D_4_HOS_C12_72),Speech Pathology (D_4_IRF_C11_68),"COST SERVICES SUBJECT TO DEDUCTIBLES AND COINSURANCE - COST, Renal Dialysis (D_5_HOS_C6_74)",Hospice (S3_1_C8_24),Drugs Charged to Patients (A_C1_73),Radiology-Diagnostic (A_C1_54),Other Organ Acquisition (B_1_C21_112),OPT (C_1_C5_9920),Total Hospital (S3_1_C2_14),"Allocation of Interns & Residents Program Costs, Coronary Care Unit (B_1_C22_32)",Lung  Acquisition (A_C6_108),Other Outpatient Services (D_4_HOS_C12_93),"PPS REIMBURSED SERVICES -  CHARGES, Radiology-Therapeutic (D_5_HOS_C2_55)",ICF (A_C1_4501),"Allocation of Interns & Residents Program Costs, Intravenous Therapy (B_1_C22_64)",CT Scan (B_1_C26_57),Operating Room (D_4_IRF_C11_50),Nursing School (A8_C2_19),Total (D_4_IPF_C11_200),Int & Res (non approved teaching program (A_C2_100),"TOTAL CAPITAL COSTS AFTER COST ALLOCATION, NF (B_2_C26_45)",Respiratory Therapy (A_C2_65),Notes and Loans Payable (short term) (G_C1THRU4_40),"AMOUNT REPORTED, Physician Part A (S3_2_C2_22)","Allocation of Interns & Residents Salary and Fringes, Adults and Pediatrics (B_1_C21_30)",Recovery Room (D_4_HOS_C11_51),Other Reimbursable (D_4_IRF_C11_98),"Number of patients in program at 
end of cost reporting period (S5_C4_1)",Cardiac Catheterization (D_4_SNF_C11_59),CMHC (B_1_C21_99),Total Other Medical Education (D_4_HOS_C4_200),Hospital Adlts & Ped Swing Bed SNF (S3_1_C8_5),Total Other Medical Education (D_4_IPF_C4_200),Other Reimbursable (C_1_C6_98),"COST SERVICES SUBJECT TO DEDUCTIBLES AND COINSURANCE - COST, Intravenous Therapy (D_5_HOS_C6_64)","AVERAGE HOURLY WAGE, Other General Service (S3_2_C6_43)","Total Inpatient Charges, Laboratory (C_1_C6_60)","Net Expense for Cost Allocation, Occupational Therapy (B_1_C0_67)","Allocation of Interns & Residents Program Costs, Respiratory Therapy (B_1_C22_65)",Nursing Administration (A_C2_13),"AVERAGE HOURLY WAGE, Central Services and Supply (S3_2_C6_39)",NF (S3_1_C9_20),Clinic (A_C2_90),"PAID HOURS RELATED TO SALARIES, Operation of Plant (S3_2_C5_30)","Net Expense for Cost Allocation, RHC (B_1_C0_88)",Other Organ Acquisition (B_1_C22_112),Intensive Care Unit (S3_1_C6_8),Medicare Certified Pancreas TC term date (S2_1_C2_130),Medical Records and Medical Rec. Library (A_C2_16),Physical Therapy (D_4_HOS_C11_66),"Blood Storing, Processing, Trans (D3_IPF_C2_63)",Census Division Code (CENSUS),Other Ancillary (D_4_IRF_C13_76),"Net Expense for Cost Allocation, CMHC (B_1_C0_99)","Net Expense for Cost Allocation, ASC (Non Distinct Part) (B_1_C0_75)","COST SERVICES SUBJECT TO DEDUCTIBLES AND COINSURANCE - COST, CT Scan (D_5_HOS_C6_57)",FI/Contractor's Name (S2_1_C2_140),"AMOUNT REPORTED, Home Office:  Physician Part A (S3_2_C2_15)",Interns & Res Salary and Fringe Benefits (A_C2_21),"PPS REIMBURSED SERVICES -  CHARGES, Other Ancillary (D_5_HOS_C2_76)","COST REIMBURSED SERVICES SUBJECT TO DEDUCTIBLES  AND COINSURANCE - CHARGES, Recovery Room (D_5_HOS_C3_51)","Net Expense for Cost Allocation, New Capital Equipment (B_1_C0_2)",Surgical Intensive Care Unit (A_C2_34),Surgical Intensive Care Unit (B_1_C26_34),Home Program Dialysis (B_1_C26_94),Coronary Care Unit (A_C1_32),Radiology-Diagnostic (D_4_HOS_C11_54),Speech Pathology (D_4_SNF_C11_68),Hospice (S3_1_C3_24),Subprovider I (A_C1_42),Surgical Intensive Care Unit (D3_IRF_C2_34),Heart Acquisition (B_1_C22_106),OSP (C_1_C5_9940),"COST REIMBURSED SERVICES NOT SUBJECT TO DEDUCTIBLES AND COINSURANCE - CHARGES, Electroencephalography (D_5_HOS_C4_70)",Drugs Charged to Patients (D_4_HOS_C1_73),Other Ancillary (D_4_HOS_C10_76),Other Special Care Unit (D3_HOS_C2_35),ASC (Distinct Part) (B_2_C26_115),"COST REIMBURSED SERVICES NOT SUBJECT TO DEDUCTIBLES AND COINSURANCE - CHARGES, Observation Beds (Distinct Unit) (D_5_HOS_C4_9201)",Drugs Charged to Patients (D_4_HOS_C3_73),Coronary Care Unit (D3_IPF_C2_32),Other Reimbursable (A_C6_98),"Net Expense for Cost Allocation, Impl. Dev. Charged to Patients (B_1_C0_72)",Total Other Medical Education Cost (D_3_HOS_C3_200),Nonpaid Workers (B_2_C26_193),"Allocation of Interns & Residents Program Costs, Delivery Room and Labor Room (B_1_C22_52)","COST SERVICES SUBJECT TO DEDUCTIBLES AND COINSURANCE - COST, Other Reimbursable (D_5_HOS_C6_98)","COST SERVICES SUBJECT TO DEDUCTIBLES AND COINSURANCE - COST, Other Outpatient Services (D_5_HOS_C6_93)","COST SERVICES NOT SUBJECT TO DEDUCTIBLES AND COINSURANCE - COST, Physical Therapy (D_5_HOS_C7_66)",ASC (Non Distinct Part) (D_4_HOS_C12_75),CORF (A_C1_9910),Organ Procurement (D4_PANCREAS_C1_69),FQHC (C_1_C7_89),"Net Expense for Cost Allocation, OOT (B_1_C0_9930)",Other Outpatient Services (A_C6_93),Other Special Care Unit (D3_IRF_C2_35),Laboratory (D3_HOS_C3_60),"COST REIMBURSED SERVICES NOT SUBJECT TO DEDUCTIBLES AND COINSURANCE - CHARGES, Delivery Room and Labor Room (D_5_HOS_C4_52)",Home Office Street (S2_1_C1_142),"Net Expense for Cost Allocation, Other Ancillary (B_1_C0_76)",Radiology-Therapeutic (D3_HOS_C2_55),IPPS Payment amount (unadjusted) (E_A_HOS_C1_59),HHA (B_1_C22_101),Medical Records and Medical Rec. Library (A_C1_16),MRI (D_4_IPF_C13_58),Intensive Care Unit (S3_1_C8_8),MDH status ending date (MM/DD/YY) (S2_1_C2_3801),Ambulance Services (A_C1_95),OPT (A_C1_9920),Other Ancillary (A_C6_76),Cost of patients approved for charity care and uninsured discounts (S10_C2_21),Radiology-Diagnostic (D3_HOS_C3_54),Coronary Care Unit (D3_SNF_C2_32),HHA (C_1_C6_101),Total discharges (S3_1_C15_1),"Gift, Flower, Coffee Shop, Canteen (A_C2_190)",Mortgage Payable (G_C1THRU4_46),"Number of Times per week 
Patient receives Dialysis (S5_C3_2)",Radiology-Therapeutic (D_4_SNF_C11_55),"If this Hospital is claiming cost for renal services on Worksheet A, are they inpatient services only? (Y/N) (S2_1_C1_145)",Other Reimbursable (D3_SNF_C2_98),"TOTAL CAPITAL COSTS AFTER COST ALLOCATION, Other Special Care Unit (B_2_C26_35)",NF (S3_1_C2_20),Other Outpatient Services (C_1_C5_93),"COST SERVICES NOT SUBJECT TO DEDUCTIBLES AND COINSURANCE - COST, Impl. Dev. Charged to Patients (D_5_HOS_C7_72)","Blood Storing, Processing, Trans (D_4_IRF_C11_63)",Other Outpatient Services (D3_IRF_C2_93),"Net Expense for Cost Allocation, Electroencephalography (B_1_C0_70)",Emergency (D_4_HOS_C10_91),Subprovider II (C_1_C5_4201),OPT (B_2_C26_9920),"Purchases, Total (A7_1_C2_10)",Speech Pathology (B_1_C26_68),Impl. Dev. Charged to Patients (C_1_C5_72),"Allocation of Interns & Residents Salary and Fringes, Radiology-Therapeutic (B_1_C21_55)","Donations, Building Improvements (A7_1_C3_4)",Other Organ Acquisition (C_1_C5_112),Surgical Intensive Care Unit (A_C6_34),Electroencephalography (C_1_C7_70),"Net Expense for Cost Allocation, CORF (B_1_C0_9910)",Central Services and Supply (A_C6_14),"Total Outpatient Charges, Recovery Room (C_1_C7_51)",Renal Dialysis (C_1_C6_74),"COST REIMBURSED SERVICES NOT SUBJECT TO DEDUCTIBLES AND COINSURANCE - CHARGES, Drugs Charged to Patients (D_5_HOS_C4_73)",ASC 1 Provider Number (S2_1_C2_13),Surgical Intensive Care Unit (S3_1_C8_11),"ADJUSTED SALARIES, Nursing Administration (S3_2_C4_38)",Total Costs (C_1_C3_202),OOT (C_1_C5_9930),Title XVIII discharges (S3_1_C13_17),"Disposals and Retirements, Land Improvements (A7_1_C5_2)","Number of patients in program at 
end of cost reporting period (S5_C5_1)",Ending Date of SCH status (S2_1_C2_3601),CORF (C_1_C5_9910),Target Amount (D1_HOS_C1_56),"Allocation of Interns & Residents Salary and Fringes, Speech Pathology (B_1_C21_68)",Anesthesiology (D_4_HOS_C4_53),"COST REIMBURSED SERVICES NOT SUBJECT TO DEDUCTIBLES AND COINSURANCE - CHARGES, Whole Blood & Packed Red Blood Cells (D_5_HOS_C4_62)",Total discharges (S3_1_C15_14),Electroencephalography (B_2_C26_70),RHC/FQHC Combined (S3_1_C7_26),RHC (D_4_HOS_C4_88),Other Special Care (S3_1_C3_12),CT Scan (D_4_HOS_C12_57),"AMOUNT REPORTED, Interns & Residents (S3_2_C3_2551)","Total Inpatient Charges, Coronary Care Unit (C_1_C6_32)","Insurance, New Cap Related Csts Movable Equipment (A7_3_C5_2)",Speech Pathology (D_4_HOS_C10_68),Laboratory (D3_IPF_C3_60),"PAID HOURS RELATED TO SALARIES, Subtotal Salaries (S3_3_C5_3)","AVERAGE HOURLY WAGE, Housekeeping under Contract (S3_2_C6_33)",Radiology-Diagnostic (C_1_C5_54),Ambulance Services (C_1_C6_95),"Total Outpatient Charges, Whole Blood & Packed Red Blood Cells (C_1_C7_62)","Total Outpatient Charges, Cardiac Catheterization (C_1_C7_59)",HHA (S3_1_C8_22),"Total Inpatient Charges, Operating Room (C_1_C6_50)",ASC (Distinct Part) (A_C1_115),"Blood Storing, Processing, Trans (A_C6_63)",Impl. Dev. Charged to Patients (B_2_C26_72),"COST REIMBURSED SERVICES NOT SUBJECT TO DEDUCTIBLES AND COINSURANCE - CHARGES, Emergency (D_5_HOS_C4_91)",ASC (Non Distinct Part) (D_4_HOS_C3_75),Total Hospital (S3_1_C7_14),RHC 16 Provider Number (S2_1_C2_1515),Payments received from patients for amounts previously written off as charity care (S10_C2_22),Observation Beds (Distinct Unit) (D_4_HOS_C10_9201),Durable Medical Equipment Rented (D3_HOS_C2_96),"Net Expense for Cost Allocation, Nursing School (B_1_C0_20)",Notes Receivable (G_C1THRU4_3),Heart Acquisition (A_C2_106),Central Services and Supply (A_C1_14),Blood Clotting Factors for Hemoph. (D_4_HOS_C10_6250),Prepaid expenses (G_C1THRU4_8),Drugs Charged to Patients (D3_IRF_C2_73),"HHA I, Total Number of Outlier Episodes (S4_HHA1_C5_37)","Total Outpatient Charges, Radiology-Therapeutic (C_1_C7_55)","Net Expense for Cost Allocation, Electrocardiology (B_1_C0_69)",RHC/FQHC Combined (S3_1_C9_26),"Net Expense for Cost Allocation, Islet Acquisition (B_1_C0_111)",Durable Medical Equipment Sold (A_C6_97),"ADJUSTED SALARIES, Wage Related Costs RHC/FQHC (S3_2_C4_24)",Speech Pathology (C_1_C6_68),Renal Dialysis (D_4_HOS_C3_74),PBP Clinical Lab Services Program Only (D3_IRF_C2_61),Administrative and General (A_C6_5),Durable Medical Equipment Sold (D_4_HOS_C3_97),Radioisotope (D_4_IPF_C11_56),Observation Beds (Distinct Unit) (D3_IRF_C3_9201),Respiratory Therapy (A_C6_65),FQHC (D_4_HOS_C3_89),"Total Inpatient Charges, Blood Clotting Factors for Hemoph. (C_1_C6_6250)",RHC 8 Provider Number (S2_1_C2_1507),Hospice (C_1_C7_116),"TOTAL CAPITAL COSTS AFTER COST ALLOCATION, Blood Clotting Factors for Hemoph. (B_2_C26_6250)",Radiology-Therapeutic (D3_IPF_C3_55),Nonpaid Workers (A_C2_193),Premiums (S2_1_C1_11801),FQHC (C_1_C5_89),"Blood Storing, Processing, Trans (D_4_HOS_C3_63)","COST SERVICES SUBJECT TO DEDUCTIBLES AND COINSURANCE - COST, PBP Clinical Lab Services Program Only (D_5_HOS_C6_61)",CT Scan (D_4_HOS_C3_57),"AVERAGE HOURLY WAGE, Non-Physician Anesthetist Part B (S3_2_C6_3)",Other Reimbursable (D3_IRF_C2_98),Ambulance Services (B_2_C26_95),OLTC (A_C2_46),Other General Service (A_C1_18),IRF (S3_1_C8_17),Electrocardiology (D_4_SNF_C11_69),"AVERAGE HOURLY WAGE, Excluded Area Salaries (S3_2_C6_10)",Renal Dialysis (B_2_C26_74),"AVERAGE HOURLY WAGE, Dietary (S3_2_C6_34)",RHC (A_C6_88),Radiology-Therapeutic (D3_IRF_C2_55),Recovery Room (D_4_IPF_C11_51),Electrocardiology (C_1_C7_69),"COST REIMBURSED SERVICES NOT SUBJECT TO DEDUCTIBLES AND COINSURANCE - CHARGES, Recovery Room (D_5_HOS_C4_51)",City (S2_1_C1_143),"ADJUSTED SALARIES, Non-Physician Part B (S3_2_C4_6)",Anesthesiology (D3_HOS_C2_53),Vending Machines (A8_C2_20),Blood Clotting Factors for Hemoph. (C_1_C5_6250),Other Ancillary (D_4_IRF_C11_76),"Net Expense for Cost Allocation, Other Nonreimbursable (B_1_C0_194)",Respiratory Therapy (A_C1_65),Occupational Therapy (D_4_HOS_C2_67),"Net Expense for Cost Allocation, ICF (B_1_C0_4501)",Radiology-Therapeutic (D_4_HOS_C4_55),Other Reimbursable (D3_IPF_C3_98),"Interest, Total (A7_3_C11_3)","COST SERVICES NOT SUBJECT TO DEDUCTIBLES AND COINSURANCE - COST, Emergency (D_5_HOS_C7_91)",Renal Dialysis (D_4_IRF_C11_74),Other Reimbursable (D_4_HOS_C13_98),NF (A_C6_45),Subprovider 2 (S3_1_C2_1801),"ADJUSTED SALARIES, Contract Labor (S3_2_C4_11)","ADJUSTED SALARIES, Subtotal Salaries (S3_3_C4_3)","HHA I, PEP:  Total Non Routine Med Supply Chgs (S4_HHA1_C4_38)","HHA I, PEP:  Total Number of Outlier Episodes (S4_HHA1_C4_37)",Delivery Room and Labor Room (D3_HOS_C3_52),"PAID HOURS RELATED TO SALARIES, Social Service (S3_2_C5_42)",Operating Room (D3_SNF_C2_50),Interns & Res Salary and Fringe Benefits (A_C1_21),"Net Expense for Cost Allocation, Clinic (B_1_C0_90)","Allocation of Interns & Residents Program Costs, Recovery Room (B_1_C22_51)","Blood Storing, Processing, Trans (C_1_C5_63)",Speech Pathology (D3_HOS_C2_68),SNF (C_1_C5_44),CT Scan (D_4_IRF_C11_57),Other Ancillary (D3_SNF_C2_76),CT Scan (D_4_IPF_C13_57),Electrocardiology (A_C1_69),"Donations, Total (A7_1_C3_10)",Burn Intensive Care Unit (D_3_HOS_C9_33),"COST REIMBURSED SERVICES SUBJECT TO DEDUCTIBLES  AND COINSURANCE - CHARGES, Medical Supplies Charged to Patients (D_5_HOS_C3_71)",Whole Blood & Packed Red Blood Cells (D3_HOS_C3_62),"AMOUNT REPORTED, Interns & Residents (S3_2_C2_25)",Liver Acquisition (B_1_C22_107),"AMOUNT REPORTED, Cafeteria (S3_2_C2_36)",Whole Blood & Packed Red Blood Cells (D_4_HOS_C12_62),"AVERAGE HOURLY WAGE, Home Office Salaries (S3_2_C6_1401)","Net Expense for Cost Allocation, Other Organ Acquisition (B_1_C0_112)",Impl. Dev. Charged to Patients (D_4_IPF_C13_72),Operating Room (D3_IRF_C3_50),Home Program Dialysis (D3_IRF_C3_94),"Lease, Total (A7_3_C10_3)","PAID HOURS RELATED TO SALARIES, Excluded Area Salaries (S3_3_C5_2)",Cardiac Catheterization (D_4_HOS_C4_59),"Beginning Balances, Buildings and Fixtures (A7_1_C1_3)",OPT (B_1_C26_9920),Other Outpatient Services (D_4_HOS_C3_93),Observation Beds (Distinct Unit) (D_4_HOS_C12_9201),"COST REIMBURSED SERVICES NOT SUBJECT TO DEDUCTIBLES AND COINSURANCE - CHARGES, Other Reimbursable (D_5_HOS_C4_98)","AMOUNT REPORTED, Home Office Salaries (S3_2_C3_1401)",MRI (D_4_IPF_C11_58),"COST REIMBURSED SERVICES NOT SUBJECT TO DEDUCTIBLES AND COINSURANCE - CHARGES, Blood Clotting Factors for Hemoph. (D_5_HOS_C4_6250)",Impl. Dev. Charged to Patients (A_C1_72),"PAID HOURS RELATED TO SALARIES, Housekeeping under Contract (S3_2_C5_33)","PPS REIMBURSED SERVICES -  CHARGES, Medical Supplies Charged to Patients (D_5_HOS_C2_71)",Cardiac Catheterization (A_C2_59),ASC (Distinct Part) (B_1_C26_115),Physical Therapy (D_4_HOS_C3_66),"Total Inpatient Charges, ICF (C_1_C6_4501)",Speech Pathology (D_4_HOS_C13_68),"HHA III, Without Outliers:  Non Routine Med Sup Chgs (S4_HHA3_C1_38)",Does the hospital qualify as RPCH/CAH? (Y/N) (S2_1_C1_105),CT Scan (A_C1_57),Cost of charity care (uninsured patients + patients w/ coverage not accepted by provider) (S10_C1_23),"Disposals and Retirements, Land (A7_1_C7_1)","General Inpatient Routine Service Cost, net of Swing Bed and Private Room Diff (D1_HOS_C1_37)","PAID HOURS RELATED TO SALARIES, Dietary under Contract (S3_2_C5_35)",Laboratory (D3_HOS_C2_60),Medical Supplies Charged to Patients (D3_IPF_C3_71),Cardiac Catheterization (D_4_IPF_C13_59),Title V discharges (S3_1_C12_17),Total Facility FTEs (S3_1_C9_27),"AMOUNT REPORTED, Operation of Plant (S3_2_C2_30)",Employee Benefits (A_C1_4),"AMOUNT REPORTED, Non-Physician Anesthetist Part A (S3_2_C2_2)","HHA I, With Outliers:  Non Routine Med Sup Chgs (S4_HHA1_C2_38)","Net Expense for Cost Allocation, Subprovider II (B_1_C0_4201)",Laboratory (D_4_SNF_C11_60),"Net Expense for Cost Allocation, Subprovider-IRF (B_1_C0_41)",Total Hospital Interns & Residents (S3_1_C11_14),Physical Therapy (A_C1_66),"PAID HOURS RELATED TO SALARIES, Total (S3_3_C5_6)",Other Ancillary (A_C1_76),"Total Inpatient Charges, Surgical Intensive Care Unit (C_1_C6_34)","HHA I, Without Outliers:  Total Charges (S4_HHA1_C1_35)",Medical Supplies Charged to Patients (D3_IRF_C2_71),Observation Beds (Distinct Unit) (D3_HOS_C2_9201),"Other Capital Related Costs, New Cap Related Csts Movable Equipment (A7_3_C7_2)",CT Scan (D3_IRF_C3_57),Cafeteria employees and guests (A8_C2_14),"AMOUNT REPORTED, Interns & Residents (S3_2_C2_2553)","Blood Storing, Processing, Trans (A_C1_63)",Unsecured Loans (G_C1THRU4_48),"AVERAGE HOURLY WAGE, Nursing Administration (S3_2_C6_38)",Liver Acquisition (B_1_C21_107),"ADJUSTED SALARIES, SNF (S3_2_C4_9)",CMHC (A_C6_99),"Total Inpatient Charges, Radioisotope (C_1_C6_56)",Other Outpatient Services (D3_SNF_C2_93),Subtotal (E_B_HOS_C1_30),Total (D_4_HOS_C12_200),Impl. Dev. Charged to Patients (D3_IRF_C2_72),"ADJUSTED SALARIES, Total (S3_3_C4_6)",IRF Provider Number (S2_1_C2_5),Subprovider 1 (S3_1_C3_18),"TOTAL CAPITAL COSTS AFTER COST ALLOCATION, Radioisotope (B_2_C26_56)",SNF (S3_1_C10_19),Total (D_4_HOS_C13_200),IRF (S3_1_C3_17),"Number of Times per week
 Patient receives Dialysis (S5_C4_2)",Clinic (A_C6_90),Hospital Type (S2_1_C4_3),Sale of medical records and abstracts (A8_C2_18),Occupational Therapy (D_4_HOS_C12_67),Total Program General Inp. Rtn Service (D1_SNF_C1_74),Durable Medical Equipment Sold (A_C1_97),RHC (B_1_C26_88),Accounts Receivable (G_C1THRU4_4),Surgical Intensive Care Unit (D3_HOS_C2_34),"ADJUSTED SALARIES, Excluded Area Salaries (S3_2_C4_10)",Total Long-term Liabilities (G_C1THRU4_50),"HHA II, Total Visits (S4_HHA2_C5_33)","PPS SERVICES COST, Speech Pathology (D_5_HOS_C5_68)","Net Expense for Cost Allocation, Radiology-Diagnostic (B_1_C0_54)","Total Inpatient Charges, Radiology-Diagnostic (C_1_C6_54)",Drugs Charged to Patients (D3_SNF_C3_73),RHC 9 Provider Number (S2_1_C2_1508),Anesthesiology (D_4_HOS_C2_53),Leasehold Improvements (G_C1THRU4_17),"Total Outpatient Charges, Anesthesiology (C_1_C7_53)",Durable Medical Equipment Rented (A_C1_96),Subprovider-IRF (D3_IPF_C2_41),Coronary Care Unit (A_C6_32),"COST SERVICES NOT SUBJECT TO DEDUCTIBLES AND COINSURANCE - COST, Recovery Room (D_5_HOS_C7_51)",Physical Therapy (C_1_C6_66),Total Other Assets (G_C1THRU4_35),Cafeteria (A_C2_11),Whole Blood & Packed Red Blood Cells (A_C6_62),"AVERAGE HOURLY WAGE, Operation of Plant (S3_2_C6_30)",Medical and Other Services reimbursed by OPPS (E_B_HOS_C1_2),Subprovider 1 (S3_1_C2_18),"Net Expense for Cost Allocation, Respiratory Therapy (B_1_C0_65)",Electroencephalography (D3_SNF_C3_70),Radiology-Diagnostic (B_1_C26_54),CMHC (A_C1_99),Hospital Zip Code (S2_1_C3_2),Number of periods hospital was in MDH status (S2_1_C1_37),Impl. Dev. Charged to Patients (A_C6_72),RHC 25 Provider Number (S2_1_C2_1524),Anesthesiology (D_4_HOS_C13_53),Other Nonreimbursable (A_C1_194),Durable Medical Equipment Rented (B_1_C26_96),ASC (Non Distinct Part) (B_1_C21_75),"Allocation of Interns & Residents Program Costs, Radiology-Diagnostic (B_1_C22_54)","Allocation of Interns & Residents Program Costs, Impl. Dev. Charged to Patients (B_1_C22_72)","TOTAL CAPITAL COSTS AFTER COST ALLOCATION, ICF (B_2_C26_4501)",Coronary Care Unit (C_1_C5_32),Impl. Dev. Charged to Patients (D_4_HOS_C13_72),Renal Dialysis (D_4_HOS_C13_74),"Taxes, New Cap Related Csts Bldg & Fixtures (A7_3_C6_1)","PAID HOURS RELATED TO SALARIES, Total Overhead Costs (S3_3_C5_7)",ASC (Non Distinct Part) (D_4_HOS_C11_75),Emergency (D3_IRF_C3_91),ASC (Non Distinct Part) (A_C2_75),"AMOUNT REPORTED, Subtotal Wage Related Csts (S3_3_C2_5)",Total Bad Debt expense (S10_C1_26),"COST REIMBURSED SERVICES NOT SUBJECT TO DEDUCTIBLES AND COINSURANCE - CHARGES, Occupational Therapy (D_5_HOS_C4_67)","COST SERVICES NOT SUBJECT TO DEDUCTIBLES AND COINSURANCE - COST, Cardiac Catheterization (D_5_HOS_C7_59)","Allocation of Interns & Residents Program Costs, Subprovider-IRF (B_1_C22_41)",Maintenance and Repairs (A_C6_6),"HHA II, W/Out Outliers:  Number of Episodes (S4_HHA2_C1_36)",Electrocardiology (D3_IPF_C3_69),"Beginning Balances, Total (A7_1_C1_10)",MRI (D_4_HOS_C13_58),Nonpaid Workers (A_C1_193),"COST REIMBURSED SERVICES SUBJECT TO DEDUCTIBLES  AND COINSURANCE - CHARGES, Intravenous Therapy (D_5_HOS_C3_64)",Total discharges (S3_1_C15_18),HHA (A_C2_101),Maintenance of Personnel (A_C6_12),Radiology-Diagnostic (D_4_HOS_C12_54),Dietary (A_C2_10),FQHC (B_1_C26_89),"HHA III, PEP Episodes:  Total Charges: (S4_HHA3_C4_35)",Home Program Dialysis (D_4_HOS_C2_94),"PPS SERVICES COST, ASC (Non Distinct Part) (D_5_HOS_C5_75)","AVERAGE HOURLY WAGE, Medical Records & Med Records Library (S3_2_C6_41)",Medical Supplies Charged to Patients (D_4_HOS_C11_71),Drugs Charged to Patients (D_4_IPF_C11_73),Other Outpatient Services (D_4_IRF_C13_93),HHA (S3_1_C6_22),Physicians' Private Office (B_2_C26_192),Nursery (S3_1_C5_13),Title XIX discharges (S3_1_C14_14),Observation Beds (Distinct Unit) (D3_IRF_C2_9201),Home Program Dialysis (B_1_C22_94),Emergency (B_1_C21_91),Radiology-Therapeutic (C_1_C5_55),Impl. Dev. Charged to Patients (D3_IRF_C3_72),Deductibles and coinsurance related to line 24 (E_B_HOS_C1_26),Home Program Dialysis (D3_SNF_C3_94),Subprovider-IRF (D_1_HOS_C6_41),Hospital Adults & Pediatrics (S3_1_C4_1),"Percentage of patients re-using
dialyzers (S5_C2_10)",Is this hospital an All-Inclusive rate provider? (Y/N) (S2_1_C1_115),Radiology-Diagnostic (A_C6_54),Operating Room (D3_HOS_C2_50),Int & Res (non approved teaching program (B_2_C26_100),"COST SERVICES SUBJECT TO DEDUCTIBLES AND COINSURANCE - COST, Speech Pathology (D_5_HOS_C6_68)","ADJUSTED SALARIES, Housekeeping (S3_2_C4_32)","Allocation of Interns & Residents Program Costs, Radiology-Therapeutic (B_1_C22_55)",Operating Room (D_4_IRF_C13_50),"COST REIMBURSED SERVICES SUBJECT TO DEDUCTIBLES  AND COINSURANCE - CHARGES, Total (D_5_HOS_C3_200)",RPCH/CAH Visits (S3_1_C6_15),"Net Expense for Cost Allocation, Operation of Plant (B_1_C0_7)","TOTAL CAPITAL COSTS AFTER COST ALLOCATION, CT Scan (B_2_C26_57)",Nursing Administration (A_C6_13),Liver Acquisition (C_1_C6_107),Radioisotope (D_4_HOS_C2_56),Kidney Acquisition (C_1_C7_105),FQHC 7 Provider Number (S2_1_C2_1606),"Total Program Inpatient Operating Cost excluding Capital Related, Nonphysician, Anesthetist, and Medical Education Costs (D1_IPF_C1_53)",Laboratory (D_4_HOS_C11_60),Total Hospital (S3_1_C3_14),Occupational Therapy (D3_HOS_C2_67),Total (D_4_SNF_C11_200),Adults and Pediatrics (D3_HOS_C2_30),Intravenous Therapy (D3_SNF_C2_64),Program Inpatient Ancillary Service Cost (D1_HOS_C1_48),Organ Procurement (D4_KIDNEY_C1_69),Liver Acquisition (C_1_C7_107),Total Inpatient Program Days (D_3_HOS_C8_200),Title XVIII discharges (S3_1_C13_18),Intravenous Therapy (D3_SNF_C3_64),Other Capital (A_C2_3),Recovery Room (D3_IRF_C2_51),Intensive Care Unit (C_1_C5_31),"PPS SERVICES COST, Delivery Room and Labor Room (D_5_HOS_C5_52)",Nursing School (A_C6_20),"COST SERVICES SUBJECT TO DEDUCTIBLES AND COINSURANCE - COST, Home Program Dialysis (D_5_HOS_C6_94)","Allocation of Interns & Residents Salary and Fringes, Medical Supplies Charged to Patients (B_1_C21_71)",Respiratory Therapy (D_4_IPF_C13_65),Cost of charity care (S10_C3_23),Intestinal Acquisition (A_C6_110),Other Special Care Unit (D3_SNF_C2_35),RHC (B_1_C21_88),"AVERAGE HOURLY WAGE, Excluded Area Salaries (S3_3_C6_2)",CORF (A_C2_9910),"Net Expense for Cost Allocation, Lung  Acquisition (B_1_C0_108)",ASC (Distinct Part) (C_1_C5_115),Hospice (B_1_C21_116),"COST SERVICES NOT SUBJECT TO DEDUCTIBLES AND COINSURANCE - COST, MRI (D_5_HOS_C7_58)",Utilization Review SNF (A_C2_114),Cardiac Catheterization (B_1_C26_59),"Allocation of Interns & Residents Salary and Fringes, Occupational Therapy (B_1_C21_67)","Allocation of Interns & Residents Program Costs, OLTC (B_1_C22_46)",Other Organ Acquisition (B_2_C26_112),HHA (B_2_C26_101),Electroencephalography (D_4_IRF_C13_70),Target Amount per Discharge (D1_HOS_C1_55),"Allocation of Interns & Residents Program Costs, Subprovider I (B_1_C22_42)",SNF (S3_1_C9_19),Recovery Room (D3_HOS_C2_51),"AVERAGE HOURLY WAGE, Laundry and Linen Service (S3_2_C6_31)",Nonphysician Anesthetists (A_C1_19),Clinic (C_1_C6_90),Burn Intensive Care Unit (S3_1_C8_10),RHC/FQHC Combined (S3_1_C6_26),Hospital Adults & Pediatrics (S3_1_C7_1),Radioisotope (D3_HOS_C2_56),RHC 3 Provider Number (S2_1_C2_1502),Title XIX discharges (S3_1_C14_18),"COST SERVICES SUBJECT TO DEDUCTIBLES AND COINSURANCE - COST, Durable Medical Equipment Sold (D_5_HOS_C6_97)",ASC (Non Distinct Part) (D3_HOS_C3_75),"Allocation of Interns & Residents Salary and Fringes, Electrocardiology (B_1_C21_69)",Subprovider-IPF (D_1_HOS_C6_40),Electrocardiology (D3_HOS_C3_69),HMO (S3_1_C6_2),"ADJUSTED SALARIES, Management and Administrative Services (S3_2_C4_12)",Other Outpatient Services (B_2_C26_93),"AVERAGE HOURLY WAGE, Physician-Part A (S3_2_C6_4)",Liver Acquisition (A_C6_107),Whole Blood & Packed Red Blood Cells (D3_IPF_C2_62),Lung  Acquisition (B_1_C26_108),Recovery Room (A_C6_51),"ADJUSTED SALARIES, Non-Physician Anesthetist Part B (S3_2_C4_3)",Clinic (D_4_HOS_C11_90),Delivery Room and Labor Room (A_C2_52),Sale of medical and surgical supplies to (A8_C2_16),"PPS SERVICES COST, Cardiac Catheterization (D_5_HOS_C5_59)",Electroencephalography (A_C2_70),"Net Expense for Cost Allocation, Drugs Charged to Patients (B_1_C0_73)",Emergency (A_C1_91),Other Special Purpose (C_1_C7_117),Physical Therapy (D_4_IRF_C11_66),Burn Intensive Care Unit (A_C1_33),"PAID HOURS RELATED TO SALARIES, Nursing Administration (S3_2_C5_38)","Donations, Fixed Equipment (A7_1_C3_5)",ASC (Non Distinct Part) (A_C1_75),Blood Clotting Factors for Hemoph. (B_1_C26_6250),Electroencephalography (B_1_C26_70),Home Program Dialysis (D3_HOS_C3_94),Laboratory (D_4_IRF_C11_60),"PPS SERVICES COST, Intravenous Therapy (D_5_HOS_C5_64)",Other Nonreimbursable (B_2_C26_194),PBP Clinical Lab Services Program Only (D3_HOS_C2_61),Kidney Acquisition (B_2_C26_105),"ADJUSTED SALARIES, Home Office Salaries (S3_2_C4_1401)",Interim payments (E_B_HOS_C1_41),Social Service (A_C2_17),Electroencephalography (D_4_HOS_C11_70),Number of stations (S5_C1_6),Medical Supplies Charged to Patients (B_2_C26_71),"ADJUSTED SALARIES, Subtotal Wage Related Csts (S3_3_C4_5)","HHA I, Without Outliers:  Total Visits (S4_HHA1_C1_33)","TOTAL CAPITAL COSTS AFTER COST ALLOCATION, Nursery (B_2_C26_43)",Coronary Care Unit (S3_1_C6_9),Subprovider-IPF (A_C2_40),Whole Blood & Packed Red Blood Cells (D_4_IPF_C13_62),ASC (Non Distinct Part) (D3_SNF_C3_75),"AMOUNT REPORTED, Interns & Residents (S3_2_C2_2551)",Coronary Intensive Care Unit (D_1_HOS_C4_32),Hospital Adults & Ped Swing Bed SNF (S3_1_C6_5),Title XIX discharges (S3_1_C14_16),Total Program Inpatient Costs (D1_IRF_C1_49),Whole Blood & Packed Red Blood Cells (D_4_SNF_C11_62),Islet Acquisition (C_1_C5_111),Anesthesiology (D3_IPF_C3_53),"COST REIMBURSED SERVICES SUBJECT TO DEDUCTIBLES  AND COINSURANCE - CHARGES, Radiology-Therapeutic (D_5_HOS_C3_55)","Total Inpatient Charges, OLTC (C_1_C6_46)","COST REIMBURSED SERVICES SUBJECT TO DEDUCTIBLES  AND COINSURANCE - CHARGES, Impl. Dev. Charged to Patients (D_5_HOS_C3_72)",Renal Dialysis (D3_HOS_C2_74),Stand-alone CHIP Charges (Gross Revenue) (S10_C1_10),Interns & Res Other Program Costs (A_C2_22),"PAID HOURS RELATED TO SALARIES, Administrative and General under Contract (S3_2_C5_28)","COST REIMBURSED SERVICES NOT SUBJECT TO DEDUCTIBLES AND COINSURANCE - CHARGES, CT Scan (D_5_HOS_C4_57)",Respiratory Therapy (B_2_C26_65),"COST SERVICES SUBJECT TO DEDUCTIBLES AND COINSURANCE - COST, Physical Therapy (D_5_HOS_C6_66)",Paid Losses (S2_1_C2_11801),Liver Acquisition (A_C1_107),"Total Inpatient Charges, Adults & Pediatrics (C_1_C6_30)",Electroencephalography (D_4_HOS_C3_70),Subprovider-IPF (C_1_C5_40),Have you established a new subprovider excluded unit under 42 CFR 413.40(f)(1)(I)?(Y/N) (S2_1_C1_86),"Medical certified liver 
transplant center cert date (S2_1_C1_128)","HHA II, PEP Episodes:  Total Number of Episodes (S4_HHA2_C4_36)","Total Outpatient Charges, Laboratory (C_1_C7_60)",Renal 10 Provider Number (S2_1_C2_1809),Urban (1) or Rural (2) (S2_1_C1_27),"Does the facility qualify and is it receiving payments for 
disproportionate share? (Y/N) (S2_1_C1_22)",Delivery Room and Labor Room (D_4_IPF_C13_52),Medicaid HMO Days (S2_1_C5_24),Speech Pathology (C_1_C5_68),"PPS REIMBURSED SERVICES -  CHARGES, Total (D_5_HOS_C2_200)",Radiology-Therapeutic (D3_SNF_C2_55),Total Hospital (S3_1_C5_7),Respiratory Therapy (D3_IPF_C3_65),Radiology-Therapeutic (A_C1_55),Intestinal Acquisition (C_1_C6_110),"Blood Storing, Processing, Trans (A_C2_63)","Gift, Flower, Coffee Shop, Canteen (A_C1_190)",Respiratory Therapy (C_1_C6_65),"Allocation of Interns & Residents Salary and Fringes, OLTC (B_1_C21_46)",Total charges to state or local government programs for indigent care (not Medicaid or CHIP) (S10_C1_14),Paramedical Education (A_C2_23),"Total Inpatient Charges, Whole Blood & Packed Red Blood Cells (C_1_C6_62)",Radiology-Therapeutic (B_1_C26_55),Lung  Acquisition (C_1_C5_108),"AMOUNT REPORTED, Subtotal Salaries (S3_3_C2_3)",Renal Dialysis (A_C2_74),"Number of Times per week
 Patient receives Dialysis (S5_C2_2)","PPS SERVICES COST, Blood Clotting Factors for Hemoph. (D_5_HOS_C5_6250)","PPS REIMBURSED SERVICES -  CHARGES, Respiratory Therapy (D_5_HOS_C2_65)","COST REIMBURSED SERVICES SUBJECT TO DEDUCTIBLES  AND COINSURANCE - CHARGES, Radiology-Diagnostic (D_5_HOS_C3_54)",IPF (S3_1_C6_16),Total Subprovider II Interns & Residents (S3_1_C10_1801),Other Special Care Unit (B_1_C26_35),"Allocation of Interns & Residents Program Costs, Medical Supplies Charged to Patients (B_1_C22_71)","Beginning Balances, Subtotal (A7_1_C1_8)",Payment to cost ratio (E_B_HOS_C1_5),Respiratory Therapy (B_1_C26_65),"TOTAL CAPITAL COSTS AFTER COST ALLOCATION, Operating Room (B_2_C26_50)",Labor and Delivery Days -  Title XIX (S3_1_C7_32),OLTC (S3_1_C8_21),IPF (S3_1_C3_16),OLTC (S3_1_C3_21),"AMOUNT REPORTED, Maintenance of Personnel (S3_2_C2_37)",Average times dialyzers re-used (S5_C1_9),Medical Supplies Charged to Patients (D_4_HOS_C2_71),Operating Room (A_C1_50),Medical Records and Medical Rec. Library (A_C6_16),CT Scan (D3_IPF_C3_57),Net Income from Service to Patients (G3_C1_5),Intestinal Acquisition (A_C1_110),"ADJUSTED SALARIES, Other General Service (S3_2_C4_43)",IPF (S3_1_C7_16),"HHA III, With Outliers:  Number of Episodes (S4_HHA3_C2_37)",SNF (A_C2_44),"AMOUNT REPORTED, Interns & Residents (S3_2_C3_2553)",Home Program Dialysis (B_1_C21_94),"PPS SERVICES COST, Electrocardiology (D_5_HOS_C5_69)","Allocation of Interns & Residents Salary and Fringes, Coronary Care Unit (B_1_C21_32)","Allocation of Interns & Residents Salary and Fringes, Subprovider-IPF (B_1_C21_40)","PPS SERVICES COST, Radiology-Diagnostic (D_5_HOS_C5_54)",Pass Through Cost for  Program Ancillary (D1_HOS_C1_51),Medical Supplies Charged to Patients (C_1_C7_71),Utilization Review SNF (A_C1_114),Primary payer payments (E_B_HOS_C1_31),"Total Inpatient Charges, MRI (C_1_C6_58)",Nursery (A_C1_43),Cross Foot Adjustments (B_1_C26_200),Radioisotope (D_4_HOS_C3_56),"Blood Storing, Processing, Trans (D3_HOS_C3_63)","PPS REIMBURSED SERVICES -  CHARGES, Blood Storing, Processing, Trans (D_5_HOS_C2_63)","AVERAGE HOURLY WAGE, Total (S3_3_C6_6)",Heart Acquisition (C_1_C7_106),Emergency (D3_SNF_C3_91),"ADJUSTED SALARIES, Wage Related Costs Core (S3_2_C4_17)","Allocation of Interns & Residents Salary and Fringes, Surgical Intensive Care Unit (B_1_C21_34)",Impl. Dev. Charged to Patients (D_4_HOS_C11_72),Drugs Charged to Patients (D3_SNF_C2_73),Total (D_1_HOS_C4_200),Operating Room (D3_SNF_C3_50),Renal 4 Provider Number (S2_1_C2_1803),OSP (B_1_C26_9940),CT Scan (D3_HOS_C3_57),"General Inpatient Routine Service Cost, net of Swing Bed and Private Room Diff (D1_SNF_C1_37)",Clinic (D3_IPF_C3_90),Payroll taxes payable (G_C1THRU4_39),Observation Beds (Distinct Unit) (D_4_IRF_C11_9201),"COST SERVICES SUBJECT TO DEDUCTIBLES AND COINSURANCE - COST, Whole Blood & Packed Red Blood Cells (D_5_HOS_C6_62)",RHC 18 Provider Number (S2_1_C2_1517),"ADJUSTED SALARIES, Related Salaries (S3_2_C4_1402)",Delivery Room and Labor Room (A_C1_52),Burn Intensive Care Unit (S3_1_C3_10),Radiology-Therapeutic (D_4_HOS_C2_55),"COST SERVICES SUBJECT TO DEDUCTIBLES AND COINSURANCE - COST, Radiology-Diagnostic (D_5_HOS_C6_54)",Administrative and General (A_C2_5),Electroencephalography (D_4_HOS_C12_70),Laboratory (D3_IPF_C2_60),Other Special Care (S3_1_C6_12),"Total Inpatient Charges, Subprovider II (C_1_C6_4201)",PBP Clinical Lab Services Program Only (D3_HOS_C3_61),Physical Therapy (D3_SNF_C3_66),Cafeteria (A_C1_11),"Allocation of Interns & Residents Salary and Fringes, SNF (B_1_C21_44)","Number of patients in program at 
end of cost reporting period (S5_C1_1)",Electroencephalography (D_4_IRF_C11_70),Operating Room (D_4_HOS_C10_50),Clinic (D_4_HOS_C12_90),Emergency (D3_IPF_C2_91),Occupational Therapy (D_4_SNF_C11_67),"HHA II, Total Charges:  LUPA Episodes (S4_HHA2_C3_35)",Other Organ Acquisition (C_1_C7_112),Other Ancillary (D_4_HOS_C4_76),"AMOUNT REPORTED, Wage Related Costs Core (S3_2_C2_17)",Clinic (D_4_HOS_C4_90),CORF (C_1_C7_9910),Anesthesiology (D_4_IPF_C11_53),Speech Pathology (D_4_HOS_C2_68),Ancillary service charges (E_B_HOS_C1_12),Medical Supplies Charged to Patients (D3_SNF_C3_71),Total Hospital (S3_1_C4_7),Surgical Intensive Care Unit (D3_IPF_C2_34),Physicians' Private Office (B_1_C26_192),Other Special Care Unit (D_1_HOS_C4_35),Total Allied Health (D_4_IRF_C3_200),Other Outpatient Services (B_1_C22_93),CMHC (C_1_C5_99),"Total Inpatient Charges, Nursery (C_1_C6_43)",Ambulance Services (A_C6_95),"ADJUSTED SALARIES, Admin & Gen Under Contract (S3_2_C4_29)","Allocation of Interns & Residents Program Costs, Occupational Therapy (B_1_C22_67)",Subprovider-IRF (D_1_HOS_C4_41),Respiratory Therapy (C_1_C7_65),Total costs for patients covered by a state or local government program (S10_C1_15),Electroencephalography (A_C6_70),"Net Expense for Cost Allocation, Hospice (B_1_C0_116)","HHA II, Total Non Routine Medical  Supply Charges (S4_HHA2_C5_38)",Occupational Therapy (D_4_HOS_C10_67),"Net Expense for Cost Allocation, HHA (B_1_C0_101)","TOTAL CAPITAL COSTS AFTER COST ALLOCATION, Whole Blood & Packed Red Blood Cells (B_2_C26_62)",Transitional corridor payment (E_B_HOS_C101_8),Total customary charges (E_B_HOS_C1_18),Whole Blood & Packed Red Blood Cells (D3_SNF_C3_62),"AVERAGE HOURLY WAGE, Maintenance of Personnel (S3_2_C6_37)",Int & Res (non approved teaching program (C_1_C5_100),Title XVIII discharges (S3_1_C13_1),Physical Therapy (D_4_HOS_C10_66),"Allocation of Interns & Residents Salary and Fringes, Radiology-Diagnostic (B_1_C21_54)",Medical Supplies Charged to Patients (D3_HOS_C3_71),Intensive Care Unit (A_C1_31),"Medical certified lung
transplant center cert date (S2_1_C1_129)",Renal Dialysis (C_1_C7_74),"COST SERVICES SUBJECT TO DEDUCTIBLES AND COINSURANCE - COST, Radioisotope (D_5_HOS_C6_56)",Total (C_1_C5_202),Operating Room (D_4_IPF_C13_50),"PPS REIMBURSED SERVICES -  CHARGES, MRI (D_5_HOS_C2_58)",ASC (Non Distinct Part) (B_2_C26_75),Subtotal (E_B_HOS_C1_32),"Net Expense for Cost Allocation, Kidney Acquisition (B_1_C0_105)",Laboratory (D3_SNF_C2_60),Cardiac Catheterization (D_4_HOS_C12_59),Electroencephalography (D3_HOS_C2_70),MDH status ending date (MM/DD/YY) (S2_1_C2_38),Durable Medical Equipment Sold (B_2_C26_97),Respiratory Therapy (D_4_HOS_C10_65),Radiology-Diagnostic (D3_IRF_C3_54),Physical Therapy (D_4_HOS_C13_66),"PPS REIMBURSED SERVICES -  CHARGES, Other Outpatient Services (D_5_HOS_C2_93)",Emergency (D_4_IPF_C13_91),Whole Blood & Packed Red Blood Cells (D3_IRF_C3_62),"HHA III, PEP:  Total Non Routine Med Supply Chgs (S4_HHA3_C4_38)","Allocation of Interns & Residents Program Costs, Cardiac Catheterization (B_1_C22_59)",Emergency (B_1_C22_91),Electroencephalography (A_C1_70),Islet Acquisition (A_C6_111),Physical Therapy (D3_IPF_C3_66),NF (B_1_C26_45),Occupational Therapy (A_C1_67),Hospital Adlts & Ped Swing Bed SNF (S3_1_C7_5),"Disposals and Retirements, Fixed Equipment (A7_1_C7_5)","ADJUSTED SALARIES, Home Office Personnel (S3_2_C4_8)",IPF Provider Number (S2_1_C2_4),Total Hospital (S3_1_C5_14),Other Outpatient Services (D_4_SNF_C11_93),Nursery (D3_HOS_C2_43),MRI (D_4_IRF_C13_58),"COST REIMBURSED SERVICES NOT SUBJECT TO DEDUCTIBLES AND COINSURANCE - CHARGES, Respiratory Therapy (D_5_HOS_C4_65)","Net Expense for Cost Allocation, Radioisotope (B_1_C0_56)",CORF (B_1_C26_9910),"PPS SERVICES COST, Durable Medical Equipment Rented (D_5_HOS_C5_96)","ADJUSTED SALARIES, Total Overhead Costs (S3_3_C4_7)",Total reasonable charges (E_B_HOS_C1_14),Operation of Plant (A_C2_7),Other Special Purpose (A_C2_117),"Is this a teaching hospital or
affiliated with a teaching hospital? (Y/N) (S2_1_C1_56)",FQHC (C_1_C6_89),Burn Intensive Care Unit (D3_IPF_C2_33),"PAID HOURS RELATED TO SALARIES, Non-Physician Anesthetist Part A (S3_2_C5_2)",Drugs Charged to Patients (A_C6_73),"COST SERVICES SUBJECT TO DEDUCTIBLES AND COINSURANCE - COST, Cardiac Catheterization (D_5_HOS_C6_59)","AMOUNT REPORTED, Related Salaries (S3_2_C3_1402)",Islet Acquisition (A_C2_111),Clinic (D3_IRF_C3_90),Cost of physicians svcs in a teaching hospita (E_B_HOS_C1_23),Durable Medical Equipment Rented (C_1_C5_96),"PPS REIMBURSED SERVICES -  CHARGES, Intravenous Therapy (D_5_HOS_C2_64)","Net Expense for Cost Allocation, Burn Intensive Care Unit (B_1_C0_33)",Labor and Delivery Days Title 18 (S3_1_C6_32),Electrocardiology (D_4_IPF_C11_69),RHC (C_1_C5_88),Dietary (A_C1_10),"Net Expense for Cost Allocation, OLTC (B_1_C0_46)","Allocation of Interns & Residents Salary and Fringes, CT Scan (B_1_C21_57)",Occupational Therapy (D_4_IPF_C11_67),Respiratory Therapy (D3_IPF_C2_65),"ADJUSTED SALARIES, Physician Part B (S3_2_C4_23)","PAID HOURS RELATED TO SALARIES, Non-Physician Part B (S3_2_C5_6)",Durable Medical Equipment Rented (A_C2_96),Other Organ Acquisition (B_1_C26_112),"COST REIMBURSED SERVICES SUBJECT TO DEDUCTIBLES  AND COINSURANCE - CHARGES, Anesthesiology (D_5_HOS_C3_53)",Other Special Purpose (B_1_C21_117),Delivery Room and Labor Room (D_4_HOS_C2_52),"Gift, Flower, Coffee Shop, Canteen (B_1_C22_190)",Blood Clotting Factors for Hemoph. (D3_HOS_C3_6250),Total (C_1_C7_202),FQHC (D_4_HOS_C4_89),ASC (Non Distinct Part) (D_4_IRF_C11_75),Subprovider-IRF (A_C1_41),"PPS SERVICES COST, Observation Beds (Distinct Unit) (D_5_HOS_C5_9201)",Delivery Room and Labor Room (D_4_HOS_C3_52),Urban/Rural Indicator at beginning (S2_1_C1_26),Cost of patients approved for charity care and uninsured discounts (S10_C3_21),Negative Cost Centers (B_1_C26_201),Radioisotope (D3_SNF_C3_56),"Number of Times per week
 Patient receives Dialysis (S5_C6_2)",Radioisotope (D3_IRF_C2_56),"ADJUSTED SALARIES, Contract Labor:  Physician Part A (S3_2_C4_13)",Home Office Name (S2_1_C1_141),"Gift, Flower, Coffee Shop, Canteen (B_1_C21_190)",ASC (Non Distinct Part) (D_4_HOS_C10_75),"PPS REIMBURSED SERVICES -  CHARGES, Renal Dialysis (D_5_HOS_C2_74)",NF Provider Number (S2_1_C2_10),Other Ancillary (D_4_HOS_C3_76),"COST REIMBURSED SERVICES SUBJECT TO DEDUCTIBLES  AND COINSURANCE - CHARGES, Physical Therapy (D_5_HOS_C3_66)","ADJUSTED SALARIES, Excluded Areas (S3_2_C4_19)",Report Record Number (RPT_REC_NUM),"AMOUNT REPORTED, Housekeeping (S3_2_C2_32)",Other Reimbursable (C_1_C7_98),Land Improvements (G_C1THRU4_13),Medical Supplies Charged to Patients (C_1_C5_71),"AMOUNT REPORTED, Contract Labor (S3_2_C2_11)","AVERAGE HOURLY WAGE, Subtotal Wage Related Csts (S3_3_C6_5)",Electrocardiology (D3_IPF_C2_69),"PPS REIMBURSED SERVICES -  CHARGES, Radioisotope (D_5_HOS_C2_56)",Intravenous Therapy (D3_IPF_C2_64),Cross Foot Adjustments (B_2_C26_200),Intestinal Acquisition (B_1_C22_110),"COST SERVICES NOT SUBJECT TO DEDUCTIBLES AND COINSURANCE - COST, Whole Blood & Packed Red Blood Cells (D_5_HOS_C7_62)","AMOUNT REPORTED, Excluded Areas (S3_2_C2_19)",Other Nonreimbursable (A_C6_194),Impl. Dev. Charged to Patients (D3_SNF_C2_72),Occupational Therapy (C_1_C2_67),Other Organ Acquisition (A_C2_112),Intravenous Therapy (D_4_HOS_C10_64),"Allocation of Interns & Residents Program Costs, Laboratory (B_1_C22_60)",Other Outpatient Services (D3_IRF_C3_93),SNF (A_C1_44),Adults & Pediatrics (D_1_HOS_C6_30),"HHA II, Without Outliers:  Total Visits (S4_HHA2_C1_33)",Lung  Acquisition (B_1_C21_108),"HHA III, W/Out Outliers:  Number of Episodes (S4_HHA3_C1_36)",In State Medicaid paid days (S2_1_C1_24),HHA (S3_1_C7_22),Other Ancillary (C_1_C7_76),RHC 14 Provider Number (S2_1_C2_1513),Renal Dialysis (B_1_C26_74),Stand-alone CHIP cost (S10_C1_11),NF (S3_1_C8_20),"Net Expense for Cost Allocation, NF (B_1_C0_45)","COST REIMBURSED SERVICES NOT SUBJECT TO DEDUCTIBLES AND COINSURANCE - CHARGES, Radiology-Therapeutic (D_5_HOS_C4_55)",Renal Dialysis (D_4_IPF_C13_74),Coronary Care Unit (S3_1_C4_9),OLTC (B_1_C26_46),Other Medicaid Days (S2_1_C6_24),Heart Acquisition (A_C6_106),Medical Supplies Charged to Patients (D_4_HOS_C12_71),Cost of charity care (patients covered by public program + patients w/ coverage accepted by provider) (S10_C2_23),Interns & Res Other Program Costs (A_C1_22),Operating Room (A_C2_50),MRI (D_4_HOS_C3_58),Durable Medical Equipment Rented (D3_IPF_C3_96),"Salaries, Wages, and Fees Payable (G_C1THRU4_38)",Electrocardiology (D3_SNF_C3_69),"PPS SERVICES COST, CT Scan (D_5_HOS_C5_57)",IPF (S3_1_C8_16),Nonpaid Workers (A_C6_193),HHA (B_1_C26_101),"Lease, New Cap Related Csts Movable Equipment (A7_3_C10_2)",Other Reimbursable (D3_SNF_C3_98),"ADJUSTED SALARIES, Social Service (S3_2_C4_42)",Speech Pathology (D3_SNF_C2_68),"HHA II, LUPA Episodes:  Total Number of Episodes (S4_HHA2_C3_36)",Total Liabilities (G_C1THRU4_51),"HHA I, Total Other Charges (S4_HHA1_C5_34)",Labor and Delivery Days -  Title XIX (S3_1_C8_32),Total (D_4_IRF_C11_200),Electroencephalography (D_4_HOS_C10_70),"Allocation of Interns & Residents Salary and Fringes, Anesthesiology (B_1_C21_53)",Delivery Room and Labor Room (D_4_IRF_C13_52),Observation Beds (Distinct Unit) (B_2_C26_9201),"Donations, Movable Equipment (A7_1_C3_6)",OOT (A_C6_9930),"ADJUSTED SALARIES, Teaching Physician Salaries (S3_2_C4_1601)",ASC (Non Distinct Part) (D_4_SNF_C11_75),Burn Intensive Care Unit (S3_1_C5_10),Radiology-Diagnostic (D3_SNF_C3_54),"COST SERVICES SUBJECT TO DEDUCTIBLES AND COINSURANCE - COST, Other Ancillary (D_5_HOS_C6_76)","HHA III, With Outliers:  Other Charges (S4_HHA3_C2_34)",Total Facility FTEs (S3_1_C11_27),Received DSH or supplemental payments from Medicaid? (Y/N) (S10_C1_3),"COST SERVICES NOT SUBJECT TO DEDUCTIBLES AND COINSURANCE - COST, Laboratory (D_5_HOS_C7_60)",Total (D_4_SNF_C13_200),OOT (C_1_C7_9930),Operation of Plant (A_C6_7),Total (S3_1_C2_7),Subprovider-IRF (D_1_HOS_C7_41),Total Hospital (S3_1_C6_14),"HHA III, Without Outliers:  Total Visits (S4_HHA3_C1_33)","Insurance, New Cap Related Csts Bldg & Fixtures (A7_3_C5_1)",Investment Income-New Movable Equip (A8_C2_2),"AMOUNT REPORTED, SNF (S3_2_C2_9)",ASC (Distinct Part) (C_1_C6_115),"ADJUSTED SALARIES, Dietary under contract (S3_2_C4_35)",Medical Supplies Charged to Patients (D_4_HOS_C10_71),Home Program Dialysis (D3_IPF_C3_94),Renal 8 Provider Number (S2_1_C2_1807),Clinic (D3_HOS_C2_90),Occupational Therapy (D3_IRF_C2_67),ESRD DME costs (E_B_HOS_C1_29),Organ Procurement (D4_LIVER_C1_69),RHC 7 Provider Number (S2_1_C2_1506),"Net Expense for Cost Allocation, Surgical Intensive Care Unit (B_1_C0_34)",Emergency (D3_IPF_C3_91),HHA 2 Provider Number (S2_1_C2_1201),Out of State Medicaid paid days (S2_1_C3_24),Utilization (S5_C2_8),ASC (Non Distinct Part) (D3_IPF_C2_75),Burn Intensive Care Unit (D3_IRF_C2_33),"Fully Depreciated Assets, Donations (A7_1_C3_7)",Intestinal Acquisition (C_1_C5_110),Utilization Review-physicians compens (A8_C2_25),"ADJUSTED SALARIES, Physician-Part A (S3_2_C4_4)","HHA I, LUPA:  Total Non Routine Med Sup Chgs (S4_HHA1_C3_38)","HHA III, PEP Episodes:  Total Visits (S4_HHA3_C4_33)",Private grants or donations or endowment income restricted to funding charity care (S10_C1_17),Lung  Acquisition (A_C1_108),"Blood Storing, Processing, Trans (C_1_C7_63)",Deferred Income (G_C1THRU4_41),"HHA III, LUPA Episodes:  Total Number of Episodes (S4_HHA3_C3_36)",Does the facility operate an ICF/MR facility for purposes of Title XIX? (Y/N) (S2_1_C1_93),Kidney Acquisition (B_1_C22_105),Islet Acquisition (C_1_C6_111),Fiscal Intermediary Number (FI_NUM),"Allocation of Interns & Residents Program Costs, Blood Storing, Processing, Trans (B_1_C22_63)","Allocation of Interns & Residents Salary and Fringes, Burn Intensive Care Unit (B_1_C21_33)",Total Hospital (S3_1_C4_14),"PAID HOURS RELATED TO SALARIES, Contract Labor:  Physician Part A (S3_2_C5_13)",Radiology-Diagnostic (A_C2_54),"PAID HOURS RELATED TO SALARIES, Excluded Area Salaries (S3_2_C5_10)","Net Expense for Cost Allocation, Nonphysician Anesthetists (B_1_C0_19)",Intravenous Therapy (D3_HOS_C2_64),ASC (Non Distinct Part) (D_4_HOS_C2_75),Electrocardiology (B_2_C26_69),Anesthesiology (D_4_HOS_C10_53),Renal 7 Provider Number (S2_1_C2_1806),Radiology-Diagnostic (D3_IRF_C2_54),Intensive Care Unit (S3_1_C7_8),Anesthesiology (D3_HOS_C3_53),Other Ancillary (D_4_HOS_C12_76),"COST SERVICES SUBJECT TO DEDUCTIBLES AND COINSURANCE - COST, MRI (D_5_HOS_C6_58)",Radiology-Therapeutic (D3_SNF_C3_55),"COST SERVICES NOT SUBJECT TO DEDUCTIBLES AND COINSURANCE - COST, Total (D_5_HOS_C7_200)","AMOUNT REPORTED, Interns & Residents (S3_2_C2_2552)","Net Expense for Cost Allocation, Cafeteria (B_1_C0_11)",Whole Blood & Packed Red Blood Cells (D3_IPF_C3_62),Other Ancillary (C_1_C5_76),"PAID HOURS RELATED TO SALARIES, Physician-Part A (S3_2_C5_4)","AMOUNT REPORTED, Interns & Residents (S3_2_C3_2552)",Intensive Care Unit (A_C2_31),Total Subprovider I Interns & Residents (S3_1_C10_18),"COST SERVICES SUBJECT TO DEDUCTIBLES AND COINSURANCE - COST, Total (D_5_HOS_C6_200)",Surgical Intensive Care Unit Program Cost (D1_HOS_C5_46),ASC (Non Distinct Part) (D3_IPF_C3_75),"If an Organ Procurement Organization, enter the OPO number (S2_1_C1_134)",Durable Medical Equipment Rented (C_1_C7_96),Electrocardiology (D_4_IRF_C11_69),"AVERAGE HOURLY WAGE, Teaching Physician Salaries (S3_2_C6_16)","Net Expense for Cost Allocation, Subprovider-IPF (B_1_C0_40)",Islet Acquisition (B_1_C22_111),"PPS REIMBURSED SERVICES -  CHARGES, Cardiac Catheterization (D_5_HOS_C2_59)",IRF (S3_1_C5_17),"PPS SERVICES COST, Impl. Dev. Charged to Patients (D_5_HOS_C5_72)",Subprovider-IPF (D3_SNF_C2_40),"Allocation of Interns & Residents Salary and Fringes, Blood Storing, Processing, Trans (B_1_C21_63)","Net Expense for Cost Allocation, New Capital Buildings and Fixtures (B_1_C0_1)",Total Charges (C_1_C8_202),"COST SERVICES NOT SUBJECT TO DEDUCTIBLES AND COINSURANCE - COST, ASC (Non Distinct Part) (D_5_HOS_C7_75)",SNF (S3_1_C11_19),"HHA III, With Outliers:  Total Charges (S4_HHA3_C2_35)",HHA (A_C6_101),"COST REIMBURSED SERVICES NOT SUBJECT TO DEDUCTIBLES AND COINSURANCE - CHARGES, Radiology-Diagnostic (D_5_HOS_C4_54)",Home Program Dialysis (D_4_HOS_C12_94),Total Program General Inpatient Routine (D1_HOS_C1_41),Outpatient Rehab Provider (S3_1_C8_25),OPT (A_C6_9920),ICF (S3_1_C3_2001),"Sum of lines 3,4 divided by line 6 (E_B_HOS_C1_7)",Housekeeping (A_C2_9),Clinic (D3_IPF_C2_90),Other Ancillary (D3_IRF_C3_76),Kidney Acquisition (A_C2_105),Radiology-Diagnostic (D_4_HOS_C10_54),Blood Clotting Factors for Hemoph. (D_4_HOS_C12_6250),Hospital Adlts & Ped Swing Bed NF (S3_1_C7_6),Physicians' Private Office (A_C2_192),"AMOUNT REPORTED, Interns & Residents (S3_2_C2_7)",Other Ancillary (D3_SNF_C3_76),"COST SERVICES NOT SUBJECT TO DEDUCTIBLES AND COINSURANCE - COST, Blood Storing, Processing, Trans (D_5_HOS_C7_63)","Total Program Inpatient Operating Cost excluding Capital Related, Nonphysician, Anesthetist, and Medical Education Costs (D1_IRF_C1_53)",OOT (A_C1_9930),Delivery Room and Labor Room (D3_IPF_C3_52),"General Inpatient Routine Service Cost, net of Swing Bed Cost (D1_IPF_C1_27)","PAID HOURS RELATED TO SALARIES, Contract Labor (S3_2_C5_11)",Emergency (D3_HOS_C3_91),Renal Dialysis (D3_IRF_C2_74),Intensive Care Unit (S3_1_C3_8),"PPS REIMBURSED SERVICES -  CHARGES, Drugs Charged to Patients (D_5_HOS_C2_73)",Adults & Pediatrics (D_1_HOS_C4_30),"Blood Storing, Processing, Trans (D_4_HOS_C10_63)","AMOUNT REPORTED, Physician Part A Teaching (S3_2_C3_2201)",CT Scan (D3_SNF_C2_57),"Donations, Land Improvements (A7_1_C3_2)",Investment Income-Other (A8_C2_3),"COST SERVICES SUBJECT TO DEDUCTIBLES AND COINSURANCE - COST, Recovery Room (D_5_HOS_C6_51)",Other Outpatient Services (D_4_IPF_C11_93),"AMOUNT REPORTED, Non-Physician Anesthetist Part B (S3_2_C2_21)","Net costs of Epoietin furnished to
all maintenance dialysis patients
by the provider (S5_C1_13)",SNF Provider Number (S2_1_C2_9),Radioisotope (D3_IPF_C2_56),Total Subprovider I Interns & Residents (S3_1_C9_18),"PPS SERVICES COST, Other Outpatient Services (D_5_HOS_C5_93)","PPS REIMBURSED SERVICES -  CHARGES, Blood Clotting Factors for Hemoph. (D_5_HOS_C2_6250)","TOTAL CAPITAL COSTS AFTER COST ALLOCATION, Cardiac Catheterization (B_2_C26_59)","Other Capital Related Costs, Total (A7_3_C7_3)","COST REIMBURSED SERVICES NOT SUBJECT TO DEDUCTIBLES AND COINSURANCE - CHARGES, Operating Room (D_5_HOS_C4_50)",Burn Intensive Care Unit (S3_1_C7_10),Electrocardiology (A_C2_69),CT Scan (D_4_HOS_C11_57),CMHC (S3_1_C6_25),Medicare Certified Kidney TC term date (S2_1_C2_126),"Interest, New Cap Related Csts Bldg & Fixtures (A7_3_C11_1)",MRI (D_4_HOS_C4_58),Ambulance Trips (S3_1_C6_29),ICF (S3_1_C7_2001),"AVERAGE HOURLY WAGE, Physician-Part B (S3_2_C6_5)",CT Scan (D_4_IRF_C13_57),"Beginning Balances, Fixed Equipment (A7_1_C1_5)","Net Expense for Cost Allocation, Central Services and Supply (B_1_C0_14)","ADJUSTED SALARIES, Subtotal Other Wages and Related Csts (S3_3_C4_4)",MSP-LCC reconciliation amount (E_B_HOS_C1_38),"PAID HOURS RELATED TO SALARIES, Total Salaries (S3_2_C5_1)",Laboratory (D_4_IRF_C13_60),"ADJUSTED SALARIES, Maintenance of Personnel (S3_2_C4_37)","COST REIMBURSED SERVICES NOT SUBJECT TO DEDUCTIBLES AND COINSURANCE - CHARGES, Laboratory (D_5_HOS_C4_60)",Operation of Plant (A_C1_7),"AMOUNT REPORTED, Excluded Area Salaries (S3_2_C2_10)",Renal Dialysis (B_1_C21_74),"PAID HOURS RELATED TO SALARIES, Admin & Gen Under Contract (S3_2_C5_29)",Emergency (C_1_C5_91),Respiratory Therapy (C_1_C5_65),"COST REIMBURSED SERVICES SUBJECT TO DEDUCTIBLES  AND COINSURANCE - CHARGES, Radioisotope (D_5_HOS_C3_56)",Other Special Purpose (C_1_C5_117),Electrocardiology (D3_IRF_C2_69),Cardiac Catheterization (D3_SNF_C3_59),PBP Clinical Lab Services Program Only (C_1_C5_61),Kidney Acquisition (B_1_C21_105),"HHA III, Total Charges (S4_HHA3_C5_35)",MRI (A_C1_58),Whole Blood & Packed Red Blood Cells (D_4_HOS_C11_62),"Allocation of Interns & Residents Program Costs, CT Scan (B_1_C22_57)",Home Program Dialysis (B_2_C26_94),Hospital Provider Number (PRVDR_NUM),"Net Expense for Cost Allocation, Nursing Administration (B_1_C0_13)","ADJUSTED SALARIES, Teaching Physician Salaries (S3_2_C4_16)",Durable Medical Equipment Rented (D3_SNF_C3_96),"General Inpatient Routine Service Cost, net of Swing Bed Cost (D1_IRF_C1_27)",Burn Intensive Care Unit (S3_1_C4_10),"Net Expense for Cost Allocation, Nursery (B_1_C0_43)",Occupational Therapy (D_4_HOS_C13_67),Subprovider-IRF (A_C6_41),Medical Supplies Charged to Patients (D_4_IPF_C11_71),Cardiac Catheterization (D3_IRF_C2_59),Surgical Intensive Care Unit (D_3_HOS_C9_34),Observation Beds (Distinct Unit) (D_4_IPF_C11_9201),"COST REIMBURSED SERVICES SUBJECT TO DEDUCTIBLES  AND COINSURANCE - CHARGES, Observation Beds (Distinct Unit) (D_5_HOS_C3_9201)",Total cost (E_B_HOS_C1_11),"Blood Storing, Processing, Trans (D3_HOS_C2_63)",Number of stations (S5_C2_6),"Beginning Balances, Land (A7_1_C1_1)","Disposals and Retirements, Movable Equipment (A7_1_C5_6)","COST SERVICES NOT SUBJECT TO DEDUCTIBLES AND COINSURANCE - COST, Radiology-Therapeutic (D_5_HOS_C7_55)",Outlier payments (E_B_HOS_C101_4),"PAID HOURS RELATED TO SALARIES, Management and Administrative Services (S3_2_C5_12)","Purchases, Subtotal (A7_1_C2_8)",SNF (D_3_HOS_C9_44),"COST REIMBURSED SERVICES SUBJECT TO DEDUCTIBLES  AND COINSURANCE - CHARGES, Laboratory (D_5_HOS_C3_60)",RPCH/CAH Visits (S3_1_C7_15),Ambulance Services (B_1_C21_95),Int & Res (non approved teaching program (C_1_C6_100),"AVERAGE HOURLY WAGE, Subtotal Salaries (S3_3_C6_3)",Delivery Room and Labor Room (D3_IPF_C2_52),"Allocation of Interns & Residents Salary and Fringes, Whole Blood & Packed Red Blood Cells (B_1_C21_62)",Adj for Speech therapy in excess of lim (A8_C2_31),"TOTAL CAPITAL COSTS AFTER COST ALLOCATION, Total Directly Assigned New Cap Rel Csts (B_2_C0_202)",Lesser of cost or charges (E_B_HOS_C1_21),Hospice (S3_1_C6_24),Lung  Acquisition (C_1_C6_108),Speech Pathology (B_2_C26_68),"ADJUSTED SALARIES, Medical Records & Med Records Library (S3_2_C4_41)","PPS SERVICES COST, Occupational Therapy (D_5_HOS_C5_67)",Cardiac Catheterization (D_4_HOS_C10_59),CT Scan (D3_SNF_C3_57),Total (D_4_IRF_C13_200),MCP Physician Payment Method (Y/N) (S5_C1_21),"AMOUNT REPORTED, Laundry and Linen Service (S3_2_C2_31)",Renal Dialysis (D_4_HOS_C11_74),HVBP payment adjustment amount (E_A_HOS_C1_7093),Adj for Physical therapy costs in excess (A8_C2_24),"PPS REIMBURSED SERVICES -  CHARGES, Clinic (D_5_HOS_C2_90)","PPS SERVICES COST, Medical Supplies Charged to Patients (D_5_HOS_C5_71)",Hospice (A_C6_116),Intravenous Therapy (C_1_C7_64),Other Ancillary (D_4_HOS_C1_76),NF (C_1_C5_45),Are provider based physicians' costs included in Worksheet A? (Y/N) (S2_1_C1_144),Other Ancillary (D3_HOS_C3_76),Pass Through Cost for  Program Ancillary (D1_IPF_C1_51),Radiology-Therapeutic (A_C6_55),"TOTAL CAPITAL COSTS AFTER COST ALLOCATION, Delivery Room and Labor Room (B_2_C26_52)",Hospital Adults & Pediatrics (S3_1_C6_1),RHC 22 Provider Number (S2_1_C2_1521),"Net Expense for Cost Allocation, Interns & Res Salary and Fringe Benefits (B_1_C0_21)","Blood Storing, Processing, Trans (D_4_IPF_C11_63)",Whole Blood & Packed Red Blood Cells (A_C2_62),"AMOUNT REPORTED, Dietary under contract (S3_2_C2_35)",Hospice (S3_1_C2_24),NF (S3_1_C10_20),Other Ancillary (D_4_IPF_C11_76),Respiratory Therapy (D_4_HOS_C11_65),Intensive Care Unit (D3_IRF_C2_31),Speech Pathology (D3_IRF_C3_68),Subprovider-IPF (B_1_C26_40),Renal Dialysis (D_4_IPF_C11_74),RHC (D_4_HOS_C2_88),Observation Beds (Distinct Unit) (D3_HOS_C3_9201),Medical and Other Services (E_B_HOS_C1_1),"HHA II, Total Charges (S4_HHA2_C5_35)","AMOUNT REPORTED, Non-Physician Anesthetist Part B (S3_2_C2_3)","AMOUNT REPORTED, Physician Part A (S3_2_C2_2201)",certification date (S2_1_C1_131),Other Reimbursable (B_2_C26_98),Protested amounts (E_B_HOS_C1_44),Dietary (A_C6_10),Home Program Dialysis (D3_SNF_C2_94),FQHC 9 Provider Number (S2_1_C2_1608),Interest expense on Medicare Overpaymts (A8_C2_22),"Allocation of Interns & Residents Salary and Fringes, Intensive Care Unit (B_1_C21_31)",ICF (S3_1_C10_2001),Other Special Care (S3_1_C7_12),Depreciation-New Bldgs & Fixtures (A8_C2_26),Ambulance Services (B_1_C26_95),Home Program Dialysis (C_1_C6_94),Recovery Room (D_4_HOS_C13_51),Impl. Dev. Charged to Patients (D_4_IPF_C11_72),"AVERAGE HOURLY WAGE, Admin & Gen Under Contract (S3_2_C6_29)","Is this a New Hospital under
42 CFR 412.300 PPS capital
(Y/N) (S2_1_C1_47)","AMOUNT REPORTED, Pharmacy (S3_2_C2_40)","COST SERVICES NOT SUBJECT TO DEDUCTIBLES AND COINSURANCE - COST, Electrocardiology (D_5_HOS_C7_69)","HHA I, Total Visits (S4_HHA1_C5_33)",Other Special Purpose (B_1_C22_117),"Net Expense for Cost Allocation, Maintenance and Repairs (B_1_C0_6)","Net Expense for Cost Allocation, Subprovider I (B_1_C0_42)","Blood Storing, Processing, Trans (D_4_HOS_C11_63)","AVERAGE HOURLY WAGE, Interns & Residents (S3_2_C6_7)",Speech Pathology (D_4_IPF_C13_68),"HHA I, PEP Episodes:  Total Charges: (S4_HHA1_C4_35)",Other Nonreimbursable (B_1_C22_194),Impl. Dev. Charged to Patients (A_C2_72),Total Nursing School (D_4_HOS_C2_200),Does the hospital elect a fully prospective payment method for capital costs? (Y/N) (S2_1_C1_48),CORF (B_2_C26_9910),CORF (A_C6_9910),Outpatient Rehab Provider (S3_1_C11_25),Observation Beds (Distinct Unit) (D_4_HOS_C3_9201),Radiology-Diagnostic (D_4_IRF_C11_54),"COST SERVICES NOT SUBJECT TO DEDUCTIBLES AND COINSURANCE - COST, Speech Pathology (D_5_HOS_C7_68)","HHA I, With Outliers:  Number of Episodes (S4_HHA1_C2_37)","AMOUNT REPORTED, Medical Records & Med Records Library (S3_2_C2_41)","Net Expense for Cost Allocation, Interns & Res Other Program Costs (B_1_C0_22)",Radiology-Diagnostic (D_4_SNF_C11_54),Surgical Intensive Care Unit (S3_1_C6_11),"AMOUNT REPORTED, Interns & Residents (S3_2_C3_2550)","ADJUSTED SALARIES, Interns & Residents (S3_2_C4_25)",Subprovider I (C_1_C5_42),"COST REIMBURSED SERVICES NOT SUBJECT TO DEDUCTIBLES AND COINSURANCE - CHARGES, Medical Supplies Charged to Patients (D_5_HOS_C4_71)",Subprovider II (B_1_C26_4201),Pass through Cost for Program Inpatient (D1_IPF_C1_50),Organ acquisition (E_B_HOS_C1_10),Hospital Adults & Pediatrics (S3_1_C5_1),Other Adjustments (Summed) (A8_C2_33),ASC (Non Distinct Part) (D_4_IPF_C13_75),Cardiac Catheterization (D3_SNF_C2_59),Other Special Care Unit (A_C6_35),New Capital Buildings and Fixtures (A_C2_1),Ambulance Services (B_1_C22_95),Intravenous Therapy (D_4_IRF_C11_64),OSP (A_C6_9940),Intravenous Therapy (A_C2_64),"HHA I, LUPA Episodes:  Other Charges (S4_HHA1_C3_34)","HHA I, Total Charges (S4_HHA1_C5_35)",Other Nonreimbursable (B_1_C26_194),Subprovider I (D_1_HOS_C4_42),"COST SERVICES SUBJECT TO DEDUCTIBLES AND COINSURANCE - COST, Medical Supplies Charged to Patients (D_5_HOS_C6_71)",Electrocardiology (D_4_HOS_C13_69),Total unreimbursed cost for Medicaid and CHIP and state and local indigent care programs (S10_C1_19),"AMOUNT REPORTED, Physician Part B (S3_2_C3_23)",Delivery Room and Labor Room (D_4_IPF_C11_52),"Net Expense for Cost Allocation, Research (B_1_C0_191)",Other Reimbursable (B_1_C26_98),RHC 11 Provider Number (S2_1_C2_1510),Other Special Care (S3_1_C5_12),Initial Physician Payment Method (Y/N) (S5_C2_21),Pancreas Acquisition (B_1_C22_109),Out of State Medicaid eligible days (S2_1_C4_24),Other Outpatient Services (D3_HOS_C3_93),"COST REIMBURSED SERVICES SUBJECT TO DEDUCTIBLES  AND COINSURANCE - CHARGES, PBP Clinical Lab Services Program Only (D_5_HOS_C3_61)",Radioisotope (D_4_HOS_C12_56),Renal 6 Provider Number (S2_1_C2_1805),"COST SERVICES NOT SUBJECT TO DEDUCTIBLES AND COINSURANCE - COST, Observation Beds (Distinct Unit) (D_5_HOS_C7_9201)","Net Expense for Cost Allocation, Anesthesiology (B_1_C0_53)",TOTAL (D3_IRF_C2_200),Geographic MSA (MSA),Physical Therapy (C_1_C2_66),Other Outpatient Services (D_4_HOS_C4_93),Other Reimbursable (D3_HOS_C2_98),Other Reimbursable (D3_HOS_C3_98),Electroencephalography (D_4_HOS_C2_70),Total Operating Expense (G3_C1_4),"ADJUSTED SALARIES, Non-Physician Anesthetist Part A (S3_2_C4_2)","AMOUNT REPORTED, Administrative & General under contract (S3_2_C2_28)",Delivery Room and Labor Room (A_C6_52),Clinic (C_1_C7_90),Coronary Care Unit (S3_1_C3_9),Subprovider 2 (S3_1_C8_1801),RHC (B_1_C22_88),Nursery (S3_1_C8_13),"COST SERVICES SUBJECT TO DEDUCTIBLES AND COINSURANCE - COST, Electrocardiology (D_5_HOS_C6_69)",Home Program Dialysis (C_1_C7_94),FQHC 1 Provider Number (S2_1_C2_16),"General Inpatient Routine Service Cost, net of Swing Bed and Private Room Diff (D1_IRF_C1_37)","Net Expense for Cost Allocation, OPT (B_1_C0_9920)","Total Inpatient Charges, Subprovider I (C_1_C6_42)",RHC (D_4_HOS_C3_88),Coronary Care Unit (S3_1_C8_9),RHC 12 Provider Number (S2_1_C2_1511),Central Services and Supply (A_C2_14),"HHA III, With Outliers:  Total Visits (S4_HHA3_C2_33)",Renal 2 Provider Number (S2_1_C2_1801),certification date (S2_1_C1_132),Government grants or appropriations or transfers for support of hospital operations (S10_C1_18),Laboratory (D3_IRF_C2_60),"Trade, Quantity, and Time Discounts (A8_C2_4)",Research (A_C6_191),New Capital Equipment (A_C2_2),Int & Res (non approved teaching program (A_C1_100),"Net Expense for Cost Allocation, Physicians' Private Office (B_1_C0_192)","Net Expense for Cost Allocation, CT Scan (B_1_C0_57)",IRF (S3_1_C6_17),Title V discharges (S3_1_C12_14),Medical Supplies Charged to Patients (A_C2_71),Other Reimbursable (D_4_HOS_C10_98),Kidney Acquisition (A_C1_105),Respiratory Therapy (D_4_IRF_C13_65),"COST REIMBURSED SERVICES SUBJECT TO DEDUCTIBLES  AND COINSURANCE - CHARGES, MRI (D_5_HOS_C3_58)","TOTAL CAPITAL COSTS AFTER COST ALLOCATION, Radiology-Therapeutic (B_2_C26_55)",Delivery Room and Labor Room (D3_SNF_C3_52),Medical Supplies Charged to Patients (A_C6_71),Excess of reasonable cost over reasonable charges (E_B_HOS_C1_20),FQHC 2 Provider Number (S2_1_C2_1601),Observation Beds (Distinct Unit) (A_C6_9201),"Allocation of Interns & Residents Program Costs, Nursery (B_1_C22_43)",Employee Benefits (A_C2_4),"Purchases, Buildings and Fixtures (A7_1_C2_3)",MRI (D_4_HOS_C12_58),"Allocation of Interns & Residents Program Costs, Operating Room (B_1_C22_50)","TOTAL CAPITAL COSTS AFTER COST ALLOCATION, MRI (B_2_C26_58)",Intensive Care Unit (D_1_HOS_C6_31),"PPS SERVICES COST, Clinic (D_5_HOS_C5_90)",Investments (G_C1THRU4_31),Other Ancillary (D_4_HOS_C2_76),Electrocardiology (C_1_C6_69),Kidney Acquisition (C_1_C5_105),ICF (B_1_C26_4501),"PPS SERVICES COST, Physical Therapy (D_5_HOS_C5_66)",Speech Pathology (D_4_HOS_C12_68),Other Special Care Unit (A_C2_35),Emergency (D_4_HOS_C1_91),"PPS SERVICES COST, Radioisotope (D_5_HOS_C5_56)",Adults and Pediatrics (A_C6_30),Radioisotope (D3_SNF_C2_56),Radioisotope (B_1_C26_56),Swing Bed SNF Provider Number (S2_1_C2_7),"COST REIMBURSED SERVICES SUBJECT TO DEDUCTIBLES  AND COINSURANCE - CHARGES, Other Outpatient Services (D_5_HOS_C3_93)","Purchases, Land Improvements (A7_1_C2_2)","PAID HOURS RELATED TO SALARIES, SNF (S3_2_C5_9)","Purchases, Movable Equipment (A7_1_C2_6)",Adults and Pediatrics (D3_SNF_C2_30),Heart Acquisition (C_1_C6_106),"COST SERVICES SUBJECT TO DEDUCTIBLES AND COINSURANCE - COST, Blood Storing, Processing, Trans (D_5_HOS_C6_63)",Pharmacy (A_C6_15),"HHA I, Without Outliers:  Other Charges (S4_HHA1_C1_34)",Renal Dialysis (C_1_C5_74),Observation Beds (Distinct Unit) (D_4_HOS_C2_9201),Occupational Therapy (C_1_C6_67),Clinic (D3_SNF_C2_90),"AMOUNT REPORTED, Subtotal Other Wages and Related Csts (S3_3_C2_4)","AVERAGE HOURLY WAGE, Home Office:  Physician Part A (S3_2_C6_15)",Hospital Adults & Pediatrics (S3_1_C8_1),"Net Expense for Cost Allocation, Whole Blood & Packed Red Blood Cells (B_1_C0_62)",Observation Beds (Distinct Unit) (C_1_C5_9201),or allied health costs? (S2_1_C1_60),Pass through Cost for Program Inpatient (D1_IRF_C1_50),Anesthesiology (D3_SNF_C2_53),"Allocation of Interns & Residents Salary and Fringes, Recovery Room (B_1_C21_51)",Anesthesiology (D_4_IPF_C13_53),"AMOUNT REPORTED, Net Salaries (S3_3_C2_1)","Allocation of Interns & Residents Salary and Fringes, Electroencephalography (B_1_C21_70)","AVERAGE HOURLY WAGE, Housekeeping (S3_2_C6_32)","COST REIMBURSED SERVICES NOT SUBJECT TO DEDUCTIBLES AND COINSURANCE - CHARGES, Cardiac Catheterization (D_5_HOS_C4_59)","Total Inpatient Charges, PBP Clinical Lab Services Program Only (C_1_C6_61)","COST SERVICES NOT SUBJECT TO DEDUCTIBLES AND COINSURANCE - COST, Radioisotope (D_5_HOS_C7_56)",Sale of drugs to other than patients (A8_C2_17),"Allocation of Interns & Residents Salary and Fringes, Subprovider I (B_1_C21_42)",Radioisotope (D_4_IPF_C13_56),Total (D_1_HOS_C7_200),Cardiac Catheterization (D_4_HOS_C2_59),Labor and Delivery (S3_1_C2_32),Cardiac Catheterization (D3_IPF_C3_59),"Allocation of Interns & Residents Salary and Fringes, Delivery Room and Labor Room (B_1_C21_52)",MRI (D_4_HOS_C11_58),"Allocation of Interns & Residents Program Costs, Subprovider-IPF (B_1_C22_40)","PPS REIMBURSED SERVICES -  CHARGES, Occupational Therapy (D_5_HOS_C2_67)","Number of patients in program at 
end of cost reporting period (S5_C3_1)","ADJUSTED SALARIES, Wage Related Costs Other (S3_2_C4_18)",Charity care charges and uninsured discounts for the entire facility (S10_C1_20),Net Revenue from stand-alone SCHIP (S10_C1_9),Self Insurance (S2_1_C3_11801),"PPS REIMBURSED SERVICES -  CHARGES, Delivery Room and Labor Room (D_5_HOS_C2_52)",Impl. Dev. Charged to Patients (D_4_IRF_C11_72),"COST REIMBURSED SERVICES NOT SUBJECT TO DEDUCTIBLES AND COINSURANCE - CHARGES, Clinic (D_5_HOS_C4_90)",HHA (C_1_C5_101),"Allocation of Interns & Residents Program Costs, Physical Therapy (B_1_C22_66)",Total Nonphysician Anesthetist Cost (D_4_IPF_C1_200),Subprovider II (D_1_HOS_C4_4201),Fiscal Year End Date (FY_END_DT),Medical Supplies Charged to Patients (C_1_C6_71),"AMOUNT REPORTED, Total (S3_3_C2_6)",Other Ancillary (C_1_C6_76),Drugs Charged to Patients (D_4_IRF_C11_73),Whole Blood & Packed Red Blood Cells (D_4_HOS_C3_62),"Allocation of Interns & Residents Program Costs, Electrocardiology (B_1_C22_69)","HHA II, With Outliers:  Non Routine Med Sup Chgs (S4_HHA2_C2_38)","Net Expense for Cost Allocation, Medical Records and Medical Rec. Library (B_1_C0_16)",Radiology-Therapeutic (D_4_HOS_C13_55),"COST REIMBURSED SERVICES SUBJECT TO DEDUCTIBLES  AND COINSURANCE - CHARGES, Blood Clotting Factors for Hemoph. (D_5_HOS_C3_6250)",Electrocardiology (D3_SNF_C2_69),"AVERAGE HOURLY WAGE, Contract Labor:  Physician Part A (S3_2_C6_13)",NF (A_C1_45),Subprovider-IPF (A_C1_40),Intensive Care Unit (D3_IPF_C2_31),Observation Beds (Distinct Unit) (B_1_C21_9201),Respiratory Therapy (D3_SNF_C3_65),Physical Therapy (D3_IRF_C3_66),IPPS Interim payment (E_A_HOS_C1_72),Renal Dialysis (D_4_SNF_C11_74),Total (D_4_HOS_C11_200),"Allocation of Interns & Residents Program Costs, SNF (B_1_C22_44)",Medical Supplies Charged to Patients (D_4_IRF_C11_71),Burn Intensive Care Unit (S3_1_C2_10),Amounts expected under 42 CFR (E_B_HOS_C1_16),Anesthesiology (C_1_C5_53),Other Reimbursable (D_4_HOS_C12_98),Kidney Acquisition (C_1_C6_105),"PPS REIMBURSED SERVICES -  CHARGES, Whole Blood & Packed Red Blood Cells (D_5_HOS_C2_62)",Total Program Inpatient Costs (D1_HOS_C1_49),Cardiac Catheterization (D3_IRF_C3_59),Recovery Room (D_4_HOS_C4_51),Intensive Care Unit (D_1_HOS_C4_31),Anesthesiology (B_1_C26_53),Cardiac Catheterization (C_1_C5_59),Radiology-Therapeutic (D_4_HOS_C12_55),"ADJUSTED SALARIES, Operation of Plant (S3_2_C4_30)",IRF Provider Number (S2_1_C1_5),Nursery (C_1_C5_43),"PPS REIMBURSED SERVICES -  CHARGES, Operating Room (D_5_HOS_C2_50)",Research (B_1_C22_191),"TOTAL CAPITAL COSTS AFTER COST ALLOCATION, Anesthesiology (B_2_C26_53)",Hospice (C_1_C5_116),Clinic (B_1_C26_90),Operating Room (D_4_HOS_C1_50),Surgical Intensive Care Unit (S3_1_C3_11),Other Reimbursable (D3_IRF_C3_98),Outlier payments (E_B_HOS_C1_4),OSP (B_2_C26_9940),"COST REIMBURSED SERVICES SUBJECT TO DEDUCTIBLES  AND COINSURANCE - CHARGES, Operating Room (D_5_HOS_C3_50)",Nursery (A_C6_43),Durable Medical Equipment Rented (B_2_C26_96),"TOTAL CAPITAL COSTS AFTER COST ALLOCATION, Subprovider-IPF (B_2_C26_40)",Total Outpatient Program Pass Thru Cost (D_4_IPF_C6_200),"Allocation of Interns & Residents Salary and Fringes, Operating Room (B_1_C21_50)",Medical and Other Services reimbursed by OPPS (E_B_HOS_C101_2),"HHA III, Without Outliers:  Total Charges (S4_HHA3_C1_35)","ADJUSTED SALARIES, Administrative and General (S3_2_C4_27)",Observation Beds (Distinct Unit) (C_1_C7_9201),Ancillary service other pass through costs (E_B_HOS_C1_9),Emergency (D_4_IRF_C11_91),"ADJUSTED SALARIES, Cafeteria (S3_2_C4_36)",Other General Service (A_C6_18),"Donations, Subtotal (A7_1_C3_8)",Subprovider-IPF (D_1_HOS_C4_40),RHC/FQHC Combined (S3_1_C11_26),Intravenous Therapy (C_1_C6_64),Recovery Room (D_4_HOS_C10_51),Total Program Excludable Costs (D1_IRF_C1_52),Less: Allowances for uncollectible notes and accounts receivable (G_C1THRU4_6),Renal 3 Provider Number (S2_1_C2_1802),"Net Expense for Cost Allocation, Pharmacy (B_1_C0_15)","TOTAL CAPITAL COSTS AFTER COST ALLOCATION, Radiology-Diagnostic (B_2_C26_54)",SNF (S3_1_C7_19),Speech Pathology (A_C1_68),Observation Beds (Distinct Unit) (D_4_SNF_C11_9201),Radiology-Therapeutic (D_4_IRF_C11_55),Total Program General Inpatient Routine (D1_IPF_C1_41),FQHC (A_C6_89),Recovery Room (D_4_SNF_C11_51),"HHA I, With Outliers:  Total Visits (S4_HHA1_C2_33)","PAID HOURS RELATED TO SALARIES, Housekeeping (S3_2_C5_32)","Net Expense for Cost Allocation, Maintenance of Personnel (B_1_C0_12)",Home Program Dialysis (D3_IPF_C2_94),OLTC (S3_1_C11_21),Hospital Name (S2_1_C1_3),Drugs Charged to Patients (D_4_HOS_C11_73),CMS Region Code (REGION),Radiology-Therapeutic (D3_HOS_C3_55),"Total Outpatient Charges, Radiology-Diagnostic (C_1_C7_54)","AMOUNT REPORTED, Interns & Residents (S3_2_C3_25)",Beginning Date of SCH status (S2_1_C1_36),"HHA II, Total Number of Episodes (S4_HHA2_C5_36)",Interest Expense (A_C6_113),Coronary Care Unit (S3_1_C5_9),Cardiac Catheterization (D3_HOS_C2_59),Electrocardiology (D_4_HOS_C4_69),ASC (Distinct Part) (B_1_C22_115),Intravenous Therapy (D_4_HOS_C12_64),Total Other Medical Education (D_4_IRF_C4_200),Emergency (A_C2_91),TOTAL (D3_IPF_C3_200),OLTC (S3_1_C2_21),"PPS REIMBURSED SERVICES -  CHARGES, Anesthesiology (D_5_HOS_C2_53)","AVERAGE HOURLY WAGE, Dietary under Contract (S3_2_C6_35)","Allocation of Interns & Residents Salary and Fringes, NF (B_1_C21_45)",Other Special Purpose (B_1_C26_117),"AMOUNT REPORTED, Social Service (S3_2_C2_42)",Impl. Dev. Charged to Patients (C_1_C6_72),Anesthesiology (A_C2_53),Adj for Respiratory therapy costs in excess (A8_C2_23),Hospital Title 18 Payment System (P/T/O) (S2_1_C7_3),"HHA I, W/Out Outliers:  Number of Episodes (S4_HHA1_C1_36)","Total Inpatient Charges, Anesthesiology (C_1_C6_53)",HHA (S3_1_C9_22),OSP (A_C2_9940),Blood Clotting Factors for Hemoph. (D_4_HOS_C3_6250),"Fully Depreciated Assets, Total (A7_1_C7_10)",Notes Payable (G_C1THRU4_47),"HHA II, PEP Episodes:  Other Charges (S4_HHA2_C4_34)",PBP Clinical Lab Services Program Only (A_C2_61),Parking Lot (A8_C2_9),"AVERAGE HOURLY WAGE, Total Salaries (S3_2_C6_1)","AVERAGE HOURLY WAGE, SNF (S3_2_C6_9)","Total Outpatient Charges, Delivery Room and Labor Room (C_1_C7_52)",Burn Intensive Care Unit (D_1_HOS_C7_33),Emergency (D3_HOS_C2_91),Drugs Charged to Patients (C_1_C6_73),Occupational Therapy (C_1_C7_67),Cost of patients approved for charity care and uninsured discounts (S10_C1_21),Renal Dialysis (B_1_C22_74),CMHC (B_2_C26_99),Anesthesiology (D_4_HOS_C3_53),Is this a New Hospital under 42 CFR 413.40(f)(1)(I) (TEFRA)? (Y/N) (S2_1_C1_85),RHC (B_2_C26_88),Net Revenue from Medicaid (S10_C1_2),"AVERAGE HOURLY WAGE, Total Overhead Costs (S3_3_C6_7)",Radiology-Diagnostic (D_4_HOS_C3_54),"COST SERVICES NOT SUBJECT TO DEDUCTIBLES AND COINSURANCE - COST, Medical Supplies Charged to Patients (D_5_HOS_C7_71)",Interns & Res Other Program Costs (A_C6_22),"Average patient dialysis time 
including setup (S5_C3_3)",Durable Medical Equipment Rented (D_4_HOS_C10_96),Home Office PO Box (S2_1_C2_142),NF (S3_1_C3_20),Other Outpatient Services (D_4_HOS_C2_93),Observation Beds (Distinct Unit) (D3_IPF_C2_9201),"HHA III, Total Number of Outlier Episodes (S4_HHA3_C5_37)",Interest Expense (A_C2_113),Organ Procurement (D4_INTESTINE_C1_69),Burn Intensive Care Unit (S3_1_C6_10),"PAID HOURS RELATED TO SALARIES, Other General Service (S3_2_C5_43)",Intravenous Therapy (D3_IRF_C3_64),Islet Acquisition (B_1_C26_111),"PPS SERVICES COST, Respiratory Therapy (D_5_HOS_C5_65)","ADJUSTED SALARIES, Pharmacy (S3_2_C4_40)",MRI (D_4_SNF_C11_58),Electroencephalography (D_4_HOS_C4_70),Speech Pathology (D3_SNF_C3_68),Total Program General Inpatient Routine (D1_IRF_C1_41),OPPS payments (E_B_HOS_C101_3),RHC 23 Provider Number (S2_1_C2_1522),Nonpaid Workers (B_1_C21_193),Physical Therapy (D_4_HOS_C2_66),Renal Dialysis (A_C6_74),"Average patient dialysis time 
including setup (S5_C1_3)",Islet Acquisition (A_C1_111),Nursing School (A_C2_20),"Net Expense for Cost Allocation, Medical Supplies Charged to Patients (B_1_C0_71)",Total Other Expenses (G3_C1_28),Whole Blood & Packed Red Blood Cells (B_1_C26_62),Radioisotope (D_4_HOS_C10_56),"Number of days in year dialysis 
furnished (S5_C1_5)",ASC (Non Distinct Part) (D3_IRF_C2_75),"COST SERVICES NOT SUBJECT TO DEDUCTIBLES AND COINSURANCE - COST, Radiology-Diagnostic (D_5_HOS_C7_54)",Employee Benefits (A_C6_4),Cafeteria (A_C6_11),Total Allied Health Cost (D_3_HOS_C2_200),Hospital City (S2_1_C1_2),MRI (D3_IRF_C3_58),Durable Medical Equipment Sold (D_4_HOS_C10_97),"COST SERVICES NOT SUBJECT TO DEDUCTIBLES AND COINSURANCE - COST, Delivery Room and Labor Room (D_5_HOS_C7_52)",IPF (S3_1_C2_16),"Total Outpatient Charges, Operating Room (C_1_C7_50)",Intensive Care Unit (D_3_HOS_C9_31),Number of stations (S5_C3_6),"PPS SERVICES COST, Whole Blood & Packed Red Blood Cells (D_5_HOS_C5_62)",Cost of Uncompensated Care (S10_C1_30),Provider's actual MSA or CBSA (S2_1_C3_3),"AMOUNT REPORTED, Teaching Physician Salaries (S3_2_C2_16)","HHA II, PEP Episodes:  Total Charges: (S4_HHA2_C4_35)","Allocation of Interns & Residents Program Costs, Radioisotope (B_1_C22_56)",Total Income (G3_C1_26),Line 2 times line 5 (E_B_HOS_C101_6),Subprovider-IPF (D3_IPF_C2_40),OOT (B_1_C26_9930),"COST REIMBURSED SERVICES SUBJECT TO DEDUCTIBLES  AND COINSURANCE - CHARGES, Renal Dialysis (D_5_HOS_C3_74)","ADJUSTED SALARIES, Teaching Physician Salaries (S3_2_C4_1602)",Electrocardiology (D_4_HOS_C12_69),Whole Blood & Packed Red Blood Cells (D_4_HOS_C2_62),"PPS SERVICES COST, Laboratory (D_5_HOS_C5_60)",Total Other Income (G3_C1_25),"HHA I, Total Number of Episodes (S4_HHA1_C5_36)",MRI (D3_SNF_C3_58),Other Outpatient Services (D_4_HOS_C13_93),"Allocation of Interns & Residents Salary and Fringes, Radioisotope (B_1_C21_56)",Subprovider 2 (S3_1_C7_1801),Total Adults & Peds (S3_1_C7_7),Other Outpatient Services (D_4_IPF_C13_93),Home Program Dialysis (D3_HOS_C2_94),Cardiac Catheterization (D3_IPF_C2_59),Total (D_3_HOS_C9_200),"COST SERVICES SUBJECT TO DEDUCTIBLES AND COINSURANCE - COST, Anesthesiology (D_5_HOS_C6_53)",Coronary Care Unit Program Cost (D1_HOS_C5_44),HHA (A_C1_101),CT Scan (D3_IRF_C2_57),RHC 13 Provider Number (S2_1_C2_1512),Total (A8_C2_50),Laboratory (D_4_HOS_C3_60),Other Outpatient Services (B_1_C21_93),"Medicare certified heart
transplant center cert date (S2_1_C1_127)",TOTAL (D3_IPF_C2_200),CT Scan (D_4_SNF_C11_57),Home Program Dialysis (C_1_C5_94),ASC (Non Distinct Part) (D_4_HOS_C4_75),Pancreas Acquisition (C_1_C7_109),Other Outpatient Services (D_4_HOS_C10_93),Medical Supplies Charged to Patients (A_C1_71),FQHC 4 Provider Number (S2_1_C2_1603),Recovery Room (D3_SNF_C3_51),"COST REIMBURSED SERVICES NOT SUBJECT TO DEDUCTIBLES AND COINSURANCE - CHARGES, Total (D_5_HOS_C4_200)","Number of days in year dialysis 
furnished (S5_C2_5)",Anesthesiology (A_C1_53),Whole Blood & Packed Red Blood Cells (A_C1_62),"AMOUNT REPORTED, Nursing Administration (S3_2_C2_38)","Total Outpatient Charges, MRI (C_1_C7_58)","Net Expense for Cost Allocation, Speech Pathology (B_1_C0_68)",Renal Dialysis (D_4_IRF_C13_74),Intravenous Therapy (D3_IPF_C3_64),Drugs Charged to Patients (D3_HOS_C3_73),Other Reimbursable (D3_IPF_C2_98),interns and residents (E_B_HOS_C1_28),Intestinal Acquisition (A_C2_110),"HHA I, LUPA Episodes:  Total Visits (S4_HHA1_C3_33)",Research (A_C1_191),Pharmacy (A_C1_15),Recovery Room (D3_IPF_C2_51),Subprovider-IPF (A_C6_40),Physical Therapy (A_C6_66),"Purchases, Building Improvements (A7_1_C2_4)","PPS SERVICES COST, Recovery Room (D_5_HOS_C5_51)",Total Nursing School (D_4_IRF_C2_200),"Treatment capacity per day per
station (S5_C1_7)",Anesthesiology (D_4_HOS_C11_53),Blood Clotting Factors for Hemoph. (A_C6_6250),Renal Dialysis (D3_HOS_C3_74),Laboratory (D3_SNF_C3_60),Land (G_C1THRU4_12),Radioisotope (C_1_C5_56),Intravenous Therapy (C_1_C5_64),"Allocation of Interns & Residents Salary and Fringes, Other Special Care Unit (B_1_C21_35)",Adults & Pediatrics (D_3_HOS_C9_30),Drugs Charged to Patients (D3_IRF_C3_73),Electrocardiology (A_C6_69),"AVERAGE HOURLY WAGE, Social Service (S3_2_C6_42)","Blood Storing, Processing, Trans (D_4_HOS_C13_63)",Hospital Adlts & Ped Swing Bed NF (S3_1_C8_6),"Disposals and Retirements, Movable Equipment (A7_1_C7_6)",Pancreas Acquisition (A_C1_109),Physical Therapy (D_4_HOS_C4_66),"Number of days in year dialysis 
furnished (S5_C5_2)","Allocation of Interns & Residents Program Costs, NF (B_1_C22_45)",TOTAL (D3_SNF_C2_202),Total Program Excludable Costs (D1_HOS_C1_52),Organ Procurement (D4_ISLET_C1_69),"ADJUSTED SALARIES, Net Salaries (S3_3_C4_1)","HHA III, Total Other Charges (S4_HHA3_C5_34)","Net Expense for Cost Allocation, Renal Dialysis (B_1_C0_74)",Surgical Intensive Care Unit (S3_1_C4_11),"AVERAGE HOURLY WAGE, Related Salaries (S3_2_C6_1402)",Recovery Room (D_4_HOS_C2_51),Anesthesiology (D3_IPF_C2_53),Anesthesiology (D_4_HOS_C1_53),"COST SERVICES NOT SUBJECT TO DEDUCTIBLES AND COINSURANCE - COST, Drugs Charged to Patients (D_5_HOS_C7_73)",Nonphysician Anesthetists (A_C6_19),Renal Dialysis (D3_SNF_C2_74),"AMOUNT REPORTED, Administrative and General (S3_2_C2_27)","Blood Storing, Processing, Trans (D_4_IRF_C13_63)",CORF (C_1_C6_9910),Clinic (D3_SNF_C3_90),HHA 1 Provider Number (S2_1_C2_12),"TOTAL CAPITAL COSTS AFTER COST ALLOCATION, Intensive Care Unit (B_2_C26_31)",Renal Dialysis (D_4_HOS_C2_74),Nursing Administration (A_C1_13),Operating Room (D_4_HOS_C2_50),"COST REIMBURSED SERVICES SUBJECT TO DEDUCTIBLES  AND COINSURANCE - CHARGES, Electroencephalography (D_5_HOS_C3_70)",Impl. Dev. Charged to Patients (D_4_HOS_C10_72),Respiratory Therapy (D_4_HOS_C13_65),"COST REIMBURSED SERVICES SUBJECT TO DEDUCTIBLES  AND COINSURANCE - CHARGES, Clinic (D_5_HOS_C3_90)","ADJUSTED SALARIES, Laundry and Linen Service (S3_2_C4_31)","COST REIMBURSED SERVICES NOT SUBJECT TO DEDUCTIBLES AND COINSURANCE - CHARGES, Renal Dialysis (D_5_HOS_C4_74)",Burn Intensive Care Unit (B_1_C26_33),Emergency (D3_IRF_C2_91),"Net Expense for Cost Allocation, FQHC (B_1_C0_89)",Hospice (C_1_C6_116),Nursery (S3_1_C7_13),Int & Res (non approved teaching program (A_C6_100),Int & Res (non approved teaching program (C_1_C7_100),Laundry and Linen Service (A_C2_8),ASC (Non Distinct Part) (D3_HOS_C2_75),Impl. Dev. Charged to Patients (D3_IPF_C3_72),"Beginning Balances, Movable Equipment (A7_1_C1_6)","Allocation of Interns & Residents Salary and Fringes, Physical Therapy (B_1_C21_66)",Outpatient Rehab Provider (S3_1_C10_25),"Disposals and Retirements, Fixed Equipment (A7_1_C5_5)","Donations, Land (A7_1_C3_1)",Durable Medical Equipment Sold (A_C2_97),Heart Acquisition (B_2_C26_106),Occupational Therapy (D3_SNF_C3_67),Physical Therapy (D3_IPF_C2_66),TOTAL (D3_IRF_C3_200),Program Ancillary Services (D1_SNF_C1_84),"Net Expense for Cost Allocation, Intestinal Acquisition (B_1_C0_110)",Intestinal Acquisition (B_2_C26_110),Coronary Intensive Care Unit (D_1_HOS_C7_32),Hospice (S3_1_C11_24),Total Hospital (S3_1_C3_7),Electroencephalography (D3_HOS_C3_70),Occupational Therapy (D_4_IRF_C11_67),"TOTAL CAPITAL COSTS AFTER COST ALLOCATION, SNF (B_2_C26_44)",Emergency (D_4_IPF_C11_91),"Number of patients in program at 
end of cost reporting period (S5_C2_1)",Total Current Liabilities (G_C1THRU4_45),SNF (S3_1_C8_19),"ADJUSTED SALARIES, Interns & Residents (S3_2_C4_2552)","AVERAGE HOURLY WAGE, Contract Labor (S3_2_C6_11)",Organ acquisition charges (E_B_HOS_C1_13),Subprovider I (A_C6_42),"Net Expense for Cost Allocation, Laundry and Linen Service (B_1_C0_8)",Impl. Dev. Charged to Patients (D3_IPF_C2_72),Total Outpatient Program Pass Thru Cost (D_4_IRF_C6_200),Non-physician Anesthetist (A8_C2_28),Medicaid charges (S10_C1_6),FQHC (A_C2_89),"ADJUSTED SALARIES, Interns & Residents (S3_2_C4_2551)",Other Long-term Liabilities (G_C1THRU4_49),Inpatient Revenue (G2_C1_28),Physical Therapy (D3_IRF_C2_66),Ending Date of SCH status (S2_1_C2_36),"Allocation of Interns & Residents Program Costs, Speech Pathology (B_1_C22_68)",Durable Medical Equipment Rented (D3_HOS_C3_96),"Disposals and Retirements, Buildings and Fixtures (A7_1_C7_3)",Durable Medical Equipment Sold (D_4_HOS_C12_97),Clinic (D_4_SNF_C11_90),Other Ancillary (D_4_HOS_C13_76),"HHA III, LUPA Episodes:  Total Visits (S4_HHA3_C3_33)",Pancreas Acquisition (C_1_C5_109),Speech Pathology (D_4_HOS_C11_68),Outpatient Revenue (G2_C2_28),Speech Pathology (D_4_IPF_C11_68),MRI (D3_IRF_C2_58),"Allocation of Interns & Residents Program Costs, Other Special Care Unit (B_1_C22_35)",Coronary Care Unit (D3_HOS_C2_32),Operating Room (D_4_HOS_C12_50),"COST REIMBURSED SERVICES NOT SUBJECT TO DEDUCTIBLES AND COINSURANCE - CHARGES, Other Ancillary (D_5_HOS_C4_76)",Pancreas Acquisition (B_1_C26_109),Physicians' Private Office (A_C1_192),Emergency (B_1_C26_91),ASC (Distinct Part) (C_1_C7_115),Radioisotope (A_C6_56),Electrocardiology (D_4_HOS_C10_69),Anesthesiology (D_4_IRF_C13_53),Intravenous Therapy (D_4_IRF_C13_64),Occupational Therapy (D_4_HOS_C4_67),Coronary Care Unit (D_3_HOS_C9_32),IPF (S3_1_C5_16),ASC (Non Distinct Part) (C_1_C7_75),OPT (C_1_C6_9920),"Net Expense for Cost Allocation, Other Outpatient Services (B_1_C0_93)","Sale of scrap, waste, etc. (A8_C2_11)",Clinic (D_4_IPF_C13_90),"ADJUSTED SALARIES, Non-Physician Anesthetist Part B (S3_2_C4_21)",SSA State County Code (ST_CTY_CD),Net revenue from state/local govt indigent care (not Medicaid or CHIP) (S10_C1_13),Intravenous Therapy (B_1_C26_64),Recovery Room (D_4_HOS_C3_51),MRI (D3_IPF_C2_58),Total Current Assets (G_C1THRU4_11),Other Ancillary (D_4_HOS_C11_76),Gross Revenue (G3_C1_1),"COST REIMBURSED SERVICES SUBJECT TO DEDUCTIBLES  AND COINSURANCE - CHARGES, Delivery Room and Labor Room (D_5_HOS_C3_52)","Blood Storing, Processing, Trans (D3_SNF_C2_63)",Clinic (D3_HOS_C3_90),"TOTAL CAPITAL COSTS AFTER COST ALLOCATION, Surgical Intensive Care Unit (B_2_C26_34)",Utilization Code (L/N/F) (UTIL_CODE),Beginning Date of SCH status (S2_1_C1_3601),Durable Medical Equipment Sold (D3_HOS_C3_97),"Number of patients in program at 
end of cost reporting period (S5_C6_1)",Int & Res (non approved teaching program (B_1_C26_100),Clinic (B_1_C22_90),Subtotal (E_B_HOS_C1_27),"HHA III, Total Number of Episodes (S4_HHA3_C5_36)",Radioisotope (A_C1_56),"Allocation of Interns & Residents Program Costs, Surgical Intensive Care Unit (B_1_C22_34)",Physical Therapy (D_4_SNF_C11_66),Renal 9 Provider Number (S2_1_C2_1808),Medical Supplies Charged to Patients (D_4_HOS_C3_71),"AMOUNT REPORTED, Non-Physician Anesthetist Part A (S3_2_C2_20)",RHC/FQHC Combined (S3_1_C10_26),Observation Beds (Distinct Unit) (D_4_HOS_C13_9201),"Disposals and Retirements, Building Improvements (A7_1_C7_4)",Drugs Charged to Patients (D_4_HOS_C13_73),RHC 20 Provider Number (S2_1_C2_1519),Other Special Purpose (B_2_C26_117),Clinic (D_4_HOS_C2_90),"HHA I, LUPA Episodes:  Total Number of Episodes (S4_HHA1_C3_36)",Heart Acquisition (B_1_C26_106),"AMOUNT REPORTED, Excluded Area Salaries (S3_3_C2_2)","HHA II, Without Outliers:  Other Charges (S4_HHA2_C1_34)",MRI (B_1_C26_58),State (S2_1_C2_143),"Net Expense for Cost Allocation, Administrative and General (B_1_C0_5)","COST SERVICES NOT SUBJECT TO DEDUCTIBLES AND COINSURANCE - COST, Home Program Dialysis (D_5_HOS_C7_94)",OLTC (S3_1_C10_21),"ADJUSTED SALARIES, Physician Part A Teaching (S3_2_C4_2201)",Intravenous Therapy (D_4_HOS_C13_64),"Allocation of Interns & Residents Salary and Fringes, Impl. Dev. Charged to Patients (B_1_C21_72)",Utilization Review SNF (A_C6_114),RHC (C_1_C6_88),Observation Beds (Distinct Unit) (D_4_IPF_C13_9201),Clinic (D_4_IRF_C11_90),Intravenous Therapy (D_4_HOS_C11_64),Medical Supplies Charged to Patients (D3_IPF_C2_71),New Capital Buildings and Fixtures (A_C6_1),"COST SERVICES NOT SUBJECT TO DEDUCTIBLES AND COINSURANCE - COST, Operating Room (D_5_HOS_C7_50)",Impl. Dev. Charged to Patients (D_4_HOS_C2_72),Cardiac Catheterization (D_4_IRF_C11_59),"COST REIMBURSED SERVICES NOT SUBJECT TO DEDUCTIBLES AND COINSURANCE - CHARGES, Physical Therapy (D_5_HOS_C4_66)","Fully Depreciated Assets, Purchase (A7_1_C2_7)",Total (D_1_HOS_C6_200),Drugs Charged to Patients (D_4_HOS_C12_73),"Total, New Cap Related Csts Bldg & Fixtures (A7_3_C15_1)",CT Scan (D_4_HOS_C13_57),"PPS SERVICES COST, Other Ancillary (D_5_HOS_C5_76)",Physical Therapy (C_1_C7_66),Other Outpatient Services (D3_SNF_C3_93),"Donations, Buildings and Fixtures (A7_1_C3_3)","Blood Storing, Processing, Trans (D_4_HOS_C2_63)",Medicare reimbursable bad debts for the entire hospital complex (S10_C1_27),Physicians' Private Office (B_1_C21_192),Total Salaries (A_C2_200),Total discharges (S3_1_C15_16),ASC (Non Distinct Part) (D_4_IPF_C11_75),Payment to cost ratio (E_B_HOS_C101_5),Hospice 1 Provider Number (S2_1_C2_14),Emergency (C_1_C6_91),General Fund Balance (G_C1THRU4_52),Renal 5 Provider Number (S2_1_C2_1804),"PAID HOURS RELATED TO SALARIES, Teaching Physician Salaries (S3_2_C5_16)","Disposals and Retirements, Building Improvements (A7_1_C5_4)","HHA II, Total Other Charges (S4_HHA2_C5_34)",Observation Beds (Distinct Unit) (C_1_C6_9201),Surgical Intensive Care Unit (C_1_C5_34),Drugs Charged to Patients (B_2_C26_73),ASC (Distinct Part) (A_C2_115),Maintenance of Personnel (A_C1_12),Intravenous Therapy (D_4_IPF_C11_64),"PPS SERVICES COST, Total (D_5_HOS_C5_200)","Depreciation, Total (A7_3_C9_3)",Intensive Care Unit (B_1_C26_31),MRI (D_4_IRF_C11_58),Radiology-Diagnostic (D3_IPF_C2_54),"ADJUSTED SALARIES, Interns & Residents (S3_2_C4_2553)",Home Program Dialysis (A_C1_94),"COST REIMBURSED SERVICES NOT SUBJECT TO DEDUCTIBLES AND COINSURANCE - CHARGES, Impl. Dev. Charged to Patients (D_5_HOS_C4_72)",Drugs Charged to Patients (D3_IPF_C2_73),RHC 4 Provider Number (S2_1_C2_1503),Speech Pathology (A_C6_68),"ADJUSTED SALARIES, Interns & Residents (S3_2_C4_7)","TOTAL CAPITAL COSTS AFTER COST ALLOCATION, Subprovider II (B_2_C26_4201)","Net Expense for Cost Allocation, Dietary (B_1_C0_10)",Electrocardiology (D3_IRF_C3_69),Subprovider I (B_1_C26_42),"HHA III, Without Outliers:  Other Charges (S4_HHA3_C1_34)",Subprovider-IPF (D3_HOS_C2_40),"COST REIMBURSED SERVICES SUBJECT TO DEDUCTIBLES  AND COINSURANCE - CHARGES, Respiratory Therapy (D_5_HOS_C3_65)",HHA 3 Provider Number (S2_1_C2_1202),Operating Room (A_C6_50),OSP (C_1_C7_9940),Laboratory (C_1_C5_60),Radioisotope (D_4_SNF_C11_56),Electroencephalography (D_4_HOS_C13_70),Radiology-Therapeutic (D3_IPF_C2_55),"Percentage of patients re-using
dialyzers (S5_C1_10)",Housekeeping (A_C6_9),Hospital Adults & Pediatrics (S3_1_C3_1),Coronary Care Unit (B_1_C26_32),"Total Outpatient Charges, PBP Clinical Lab Services Program Only (C_1_C7_61)",RHC/FQHC Combined (S3_1_C8_26),Physical Therapy (D_4_IPF_C11_66),Less Observation Beds (C_1_C5_201),Pharmacy (A_C2_15),Is this hospital classified as a referral center? (Y/N) (S2_1_C1_116),Intestinal Acquisition (C_1_C7_110),"COST REIMBURSED SERVICES SUBJECT TO DEDUCTIBLES  AND COINSURANCE - CHARGES, Ambulance Services (D_5_HOS_C3_95)",Drugs Charged to Patients (D3_HOS_C2_73),Electroencephalography (C_1_C6_70),OLTC (S3_1_C9_21),Medical Supplies Charged to Patients (B_1_C26_71),Intravenous Therapy (D_4_HOS_C3_64),Number of stations (S5_C4_6),Allowable bad debts for dual eligibles beneficiaries (E_B_HOS_C1_36),Aggregate amount collected from patients (E_B_HOS_C1_15),Adjusted reimburseable bad debts (E_B_HOS_C1_35),Physical Therapy (B_2_C26_66),Whole Blood & Packed Red Blood Cells (D_4_IRF_C11_62),Drugs Charged to Patients (D_4_IRF_C13_73),"PPS REIMBURSED SERVICES -  CHARGES, Durable Medical Equipment Rented (D_5_HOS_C2_96)",Allowable bad debts (E_B_HOS_C1_34),Heart Acquisition (B_1_C21_106),Laboratory (D_4_HOS_C2_60),"COST SERVICES NOT SUBJECT TO DEDUCTIBLES AND COINSURANCE - COST, Anesthesiology (D_5_HOS_C7_53)","Other Capital Related Costs, New Cap Related Csts Bldg & Fixtures (A7_3_C7_1)",Electrocardiology (D_4_HOS_C11_69),"ADJUSTED SALARIES, Interns & Residents (S3_2_C4_2550)","HHA I, PEP Episodes:  Other Charges (S4_HHA1_C4_34)",Intravenous Therapy (D3_HOS_C3_64),FQHC (B_2_C26_89),"HHA II, With Outliers:  Number of Episodes (S4_HHA2_C2_37)",Social Service (A_C1_17),Title XVIII discharges (S3_1_C13_16),Operating Room (D_4_HOS_C13_50),Recovery Room (D_4_IPF_C13_51),Recovery Room (D3_HOS_C3_51),Physicians' Private Office (A_C6_192),Burn Intensive Care Unit (D3_HOS_C2_33),Impl. Dev. Charged to Patients (D3_HOS_C3_72),OOT (A_C2_9930),Subprovider-IPF (D_3_HOS_C9_40),Coronary Care Unit (S3_1_C2_9),"Blood Storing, Processing, Trans (D3_IRF_C2_63)",Hospice (S3_1_C10_24),PBP Clinical Lab Services Program Only (B_1_C26_61),"AMOUNT REPORTED, Physician-Part B (S3_2_C2_5)",CT Scan (C_1_C5_57),Emergency (D_4_HOS_C4_91),"PPS REIMBURSED SERVICES -  CHARGES, Observation Beds (Distinct Unit) (D_5_HOS_C2_9201)",Total Fund Balances (G_C1THRU4_53),Other Current Assets (G_C1THRU4_9),"PPS SERVICES COST, Anesthesiology (D_5_HOS_C5_53)","If this facility qualifies as a RPCH/CAH, has it elected the all inclusive payment for outpatient service? (Y/N) (S2_1_C1_106)","Allocation of Interns & Residents Salary and Fringes, Subprovider-IRF (B_1_C21_41)",Total Nursing School (D_4_IPF_C2_200),"Net Expense for Cost Allocation, Heart Acquisition (B_1_C0_106)",Subprovider-IRF (D_3_HOS_C9_41),Total discharges (S3_1_C15_17),Medical Supplies Charged to Patients (D3_SNF_C2_71),Adj for Occupational therapy in excess of li (A8_C2_30),Social Service (A_C6_17),Utilization Review - Physician Compen (D1_SNF_C1_85),Intensive Care Unit (S3_1_C5_8),"COST SERVICES SUBJECT TO DEDUCTIBLES AND COINSURANCE - COST, Radiology-Therapeutic (D_5_HOS_C6_55)","PPS SERVICES COST, Operating Room (D_5_HOS_C5_50)",Whole Blood & Packed Red Blood Cells (D_4_IRF_C13_62),FQHC 6 Provider Number (S2_1_C2_1605),"HHA II, With Outliers:  Total Charges (S4_HHA2_C2_35)",Charity care charges and uninsured discounts for the entire facility (S10_C2_20),Clinic (D_4_HOS_C13_90),"PPS REIMBURSED SERVICES -  CHARGES, Electrocardiology (D_5_HOS_C2_69)",Intensive Care Unit (D3_SNF_C2_31),Accounts Payable (G_C1THRU4_37),Respiratory Therapy (D3_SNF_C2_65),Fiscal Intermediary/MAC Create Date (FI_CREAT_DT),Cardiac Catheterization (D_4_HOS_C11_59),Recovery Room (D_4_HOS_C12_51),Occupational Therapy (D_4_HOS_C11_67),Recovery Room (A_C1_51),Other General Service (A_C2_18),Hospital Adults & Pediatrics (S3_1_C2_1),Other Ancillary (B_1_C21_76),"Allocation of Interns & Residents Program Costs, Anesthesiology (B_1_C22_53)","HHA I, Total Non Routine Medical  Supply Charges (S4_HHA1_C5_38)","Gift, Flower, Coffee Shop, Canteen (B_1_C26_190)",Islet Acquisition (C_1_C7_111),"COST SERVICES NOT SUBJECT TO DEDUCTIBLES AND COINSURANCE - COST, Other Outpatient Services (D_5_HOS_C7_93)",Electrocardiology (D_4_IRF_C13_69),Int & Res (non approved teaching program (B_1_C21_100),Emergency (B_2_C26_91),"Allocation of Interns & Residents Program Costs, MRI (B_1_C22_58)",Cardiac Catheterization (D3_HOS_C3_59),NF (A_C2_45),Other Reimbursable (B_1_C21_98),Total discharges (S3_1_C15_21),"COST REIMBURSED SERVICES SUBJECT TO DEDUCTIBLES  AND COINSURANCE - CHARGES, Durable Medical Equipment Rented (D_5_HOS_C3_96)",Radiology-Therapeutic (D_4_HOS_C3_55),Whole Blood & Packed Red Blood Cells (D_4_HOS_C13_62),Medical Supplies Charged to Patients (D_4_SNF_C11_71),Respiratory Therapy (D_4_HOS_C4_65),MRI (D_4_HOS_C2_58),Blood Clotting Factors for Hemoph. (A_C1_6250),CAPD exchanges per day (S5_C6_4),Subprovider I (D3_IPF_C2_42),Observation Beds (Distinct Unit) (D3_SNF_C3_9201),Other Special Care Unit (D_1_HOS_C7_35),Nursing School (A_C1_20),Cardiac Catheterization (D_4_IRF_C13_59),"Beginning Balances, Building Improvements (A7_1_C1_4)",RHC (C_1_C7_88),"AMOUNT REPORTED, Wage Related Costs Other (S3_2_C2_18)",Total Program Inpatient Costs (D1_IPF_C1_49),"AVERAGE HOURLY WAGE, Management and Administrative Services (S3_2_C6_12)","AMOUNT REPORTED, Employee Benefits (S3_2_C2_26)",ICF (A_C2_4501),Clinic (D_4_IRF_C13_90),Renal Dialysis (D3_IPF_C2_74),NF (S3_1_C11_20),"COST SERVICES NOT SUBJECT TO DEDUCTIBLES AND COINSURANCE - COST, Renal Dialysis (D_5_HOS_C7_74)",Renal Dialysis (D3_IRF_C3_74),Other Special Purpose (A_C1_117),"COST SERVICES NOT SUBJECT TO DEDUCTIBLES AND COINSURANCE - COST, Clinic (D_5_HOS_C7_90)","AVERAGE HOURLY WAGE, Net Salaries (S3_3_C6_1)","COST REIMBURSED SERVICES NOT SUBJECT TO DEDUCTIBLES AND COINSURANCE - CHARGES, Electrocardiology (D_5_HOS_C4_69)","AMOUNT REPORTED, Physician-Part A (S3_2_C2_4)",Balance due provider/program (E_B_HOS_C1_43),Electroencephalography (D_4_IPF_C13_70),Research (B_1_C26_191),Whole Blood & Packed Red Blood Cells (C_1_C5_62),Drugs Charged to Patients (D_4_HOS_C2_73),ICF (C_1_C5_4501),"Fully Depreciated Assets, Begin Balance (A7_1_C1_7)","Net Expense for Cost Allocation, Int & Res (non approved teaching program (B_1_C0_100)","AMOUNT REPORTED, Home Office Salaries & Wage Related Csts (S3_2_C2_14)",ASC (Non Distinct Part) (D_4_IRF_C13_75),"AVERAGE HOURLY WAGE, Subtotal Other Wages and Related Csts (S3_3_C6_4)","HHA II, PEP:  Total Number of Outlier Episodes (S4_HHA2_C4_37)",MRI (D3_HOS_C3_58),Respiratory Therapy (D3_IRF_C2_65),"Net Expense for Cost Allocation, Pancreas Acquisition (B_1_C0_109)","Net Expense for Cost Allocation, Housekeeping (B_1_C0_9)",Speech Pathology (C_1_C7_68),Depreciation-New Movable Equipment (A8_C2_27),Other Outpatient Services (A_C1_93),RHC 6 Provider Number (S2_1_C2_1505),Radioisotope (A_C2_56),Physical Therapy (D3_HOS_C3_66),Other Nonreimbursable (A_C2_194),Utilization (S5_C1_8),CT Scan (A_C2_57),"Total Inpatient Charges, Intensive Care Unit (C_1_C6_31)","ADJUSTED SALARIES, Housekeeping under contract (S3_2_C4_33)","AMOUNT REPORTED, Contract Labor: Pysician Part A (S3_2_C2_13)",Renal Dialysis (A_C1_74),Fixed Equipment (G_C1THRU4_19),Other Reimbursable (A_C1_98),Drugs Charged to Patients (D_4_HOS_C4_73),Speech Pathology (D_4_HOS_C4_68),Islet Acquisition (B_2_C26_111),Medicaid Observation Days (S3_1_C8_28),Average times dialyzers re-used (S5_C2_9),Adults & Pediatrics (C_1_C5_30),Total Facility FTEs (S3_1_C10_27),"Total Inpatient Charges, Subprovider-IRF (C_1_C6_41)",Minor Equipment Depreciable (G_C1THRU4_25),"ADJUSTED SALARIES, Administrative & General under contract (S3_2_C4_28)",Durable Medical Equipment Sold (C_1_C7_97),"Allocation of Interns & Residents Salary and Fringes, Intravenous Therapy (B_1_C21_64)",Whole Blood & Packed Red Blood Cells (D3_SNF_C2_62),Total (B_1_C26_202),Intensive Care Unit (S3_1_C2_8),Subprovider I (D3_HOS_C2_42),Speech Pathology (D3_HOS_C3_68),Clinic (C_1_C5_90),"Total Outpatient Charges, Blood Clotting Factors for Hemoph. (C_1_C7_6250)",Total Assets (G_C1THRU4_36),Electrocardiology (C_1_C5_69),"COST REIMBURSED SERVICES SUBJECT TO DEDUCTIBLES  AND COINSURANCE - CHARGES, Drugs Charged to Patients (D_5_HOS_C3_73)",Ambulance Services (C_1_C7_95),Less Contractual Allowance and Discounts on Patients' Accounts (G3_C1_2),Radiology-Diagnostic (D_4_HOS_C4_54),Anesthesiology (D3_IRF_C3_53),"AMOUNT REPORTED, Physician Part B (S3_2_C2_23)","PAID HOURS RELATED TO SALARIES, Medical Records & Med Records Library (S3_2_C5_41)","HHA II, PEP Episodes:  Total Visits (S4_HHA2_C4_33)",Anesthesiology (A_C6_53),Drugs Charged to Patients (D_4_SNF_C13_73),Respiratory Therapy (D_4_IPF_C11_65),"COST SERVICES SUBJECT TO DEDUCTIBLES AND COINSURANCE - COST, Blood Clotting Factors for Hemoph. (D_5_HOS_C6_6250)","COST SERVICES NOT SUBJECT TO DEDUCTIBLES AND COINSURANCE - COST, CT Scan (D_5_HOS_C7_57)","COST SERVICES SUBJECT TO DEDUCTIBLES AND COINSURANCE - COST, Occupational Therapy (D_5_HOS_C6_67)","AVERAGE HOURLY WAGE, Home Office Personnel (S3_2_C6_8)",CT Scan (D3_HOS_C2_57),Other Outpatient Services (C_1_C7_93),Other Assets (G_C1THRU4_34),Laboratory (D_4_HOS_C12_60),"Number of patients transplanted 
during fiscal year (S5_C1_12)","HHA II, With Outliers:  Total Visits (S4_HHA2_C2_33)",Subprovider-IRF (C_1_C5_41),Occupational Therapy (D_4_HOS_C3_67),"HHA II, LUPA:  Total Non Routine Med Sup Chgs (S4_HHA2_C3_38)","COST SERVICES NOT SUBJECT TO DEDUCTIBLES AND COINSURANCE - COST, Respiratory Therapy (D_5_HOS_C7_65)",Physical Therapy (C_1_C5_66),Electrocardiology (D3_HOS_C2_69),Emergency (D3_SNF_C2_91),ICF (A_C6_4501),"COST SERVICES SUBJECT TO DEDUCTIBLES AND COINSURANCE - COST, Durable Medical Equipment Rented (D_5_HOS_C6_96)","HHA III, LUPA:  Total Non Routine Med Sup Chgs (S4_HHA3_C3_38)",Other Special Care (S3_1_C2_12),"Total Inpatient Charges, SNF (C_1_C6_44)",Speech Pathology (D_4_HOS_C3_68),Clinic (B_1_C21_90),Operating Room (D3_IPF_C2_50),Electroencephalography (D3_IPF_C3_70),Heart Acquisition (A_C1_106),Other Current Liabilities (G_C1THRU4_44),Radioisotope (D_4_HOS_C4_56),"COST SERVICES NOT SUBJECT TO DEDUCTIBLES AND COINSURANCE - COST, Occupational Therapy (D_5_HOS_C7_67)",Intravenous Therapy (B_2_C26_64),"Total Inpatient Charges, Radiology-Therapeutic (C_1_C6_55)",OPT (C_1_C7_9920),RHC 1 Provider Number (S2_1_C2_15),Title XVIII discharges (S3_1_C13_14),Physicians' Private Office (B_1_C22_192),Pancreas Acquisition (B_2_C26_109),"HHA III, Total Charges:  LUPA Episodes (S4_HHA3_C3_35)",SNF (S3_1_C5_19),Pancreas Acquisition (A_C6_109),Subprovider-IRF (D3_IRF_C2_40),ASC (Non Distinct Part) (C_1_C5_75),"COST SERVICES SUBJECT TO DEDUCTIBLES AND COINSURANCE - COST, Delivery Room and Labor Room (D_5_HOS_C6_52)",HMO (S3_1_C7_2),Subprovider 1 (S3_1_C8_18),Occupational Therapy (D3_IPF_C2_67),State or local govt (not Medicaid or CHIP) -- Costs minus net revenue (0 min) (S10_C1_16),Physical Therapy (B_1_C26_66),Total Liabilities and Fund Balances (G_C1THRU4_54),"COST SERVICES SUBJECT TO DEDUCTIBLES AND COINSURANCE - COST, Drugs Charged to Patients (D_5_HOS_C6_73)",Intestinal Acquisition (B_1_C26_110),CT Scan (D_4_HOS_C4_57),Coronary Care Unit (S3_1_C7_9),ICF Provider Number (S2_1_C2_1001),"TOTAL CAPITAL COSTS AFTER COST ALLOCATION, Adults & Pediatrics (B_2_C26_30)",Subprovider-IRF (D3_SNF_C2_41),Operating Room (D3_HOS_C3_50),Lung  Acquisition (B_1_C22_108),Kidney Acquisition (B_1_C26_105),Outpatient Rehab Provider (S3_1_C7_25),"Interest, New Cap Related Csts Movable Equipment (A7_3_C11_2)","ADJUSTED SALARIES, Home Office:  Physician Part A (S3_2_C4_15)",Drugs Charged to Patients (A_C2_73),Emergency (C_1_C7_91),Program Discharges (D1_HOS_C1_54),Subprovider-IRF (D3_IRF_C2_41),Total Outpatient Program Pass Thru Cost (D_4_HOS_C6_200),Total (D_4_IPF_C13_200),"PPS REIMBURSED SERVICES -  CHARGES, Durable Medical Equipment Sold (D_5_HOS_C2_97)",Radioisotope (D_4_IRF_C13_56),"Net Expense for Cost Allocation, Home Program Dialysis (B_1_C0_94)",Physical Therapy (D_4_HOS_C12_66),Respiratory Therapy (D3_HOS_C2_65),SNF (S3_1_C2_19),Clinic (B_2_C26_90),Medicare Certified Islet TC term date (S2_1_C2_132),ASC (Non Distinct Part) (C_1_C6_75),"COST REIMBURSED SERVICES NOT SUBJECT TO DEDUCTIBLES AND COINSURANCE - CHARGES, Speech Pathology (D_5_HOS_C4_68)",MRI (A_C6_58),"Total Inpatient Charges, Subprovider-IPF (C_1_C6_40)",Total (D_4_HOS_C1_200),Other Organ Acquisition (C_1_C6_112),PBP Clinical Lab Services Program Only (D3_IRF_C3_61),RHC 19 Provider Number (S2_1_C2_1518),"Total Inpatient Charges, Recovery Room (C_1_C6_51)",Observation Beds (Distinct Unit) (D3_IPF_C3_9201),Liver Acquisition (B_1_C26_107),Number of EPO units furnished for Line 13 (S5_C1_15),ASC (Distinct Part) (B_1_C21_115),OLTC (A_C6_46),Surgical Intensive Care Unit (D_1_HOS_C6_34),"AMOUNT REPORTED, Non-Physician Part B (S3_2_C2_6)","Does this facility operate 
transplant center? (Y/N) (S2_1_C1_125)",Observation Beds (Distinct Unit) (D3_SNF_C2_9201),"Sum of lines 3,4 divided by line 6 (E_B_HOS_C101_7)",Laboratory (D_4_IPF_C13_60),Anesthesiology (D_4_IRF_C11_53),"AVERAGE HOURLY WAGE, Non-Physician Part B (S3_2_C6_6)",Impl. Dev. Charged to Patients (C_1_C7_72),Program Inpatient Ancillary Service Cost (D1_IPF_C1_48),"PAID HOURS RELATED TO SALARIES, Cafeteria (S3_2_C5_36)","Net Expense for Cost Allocation, Delivery Room and Labor Room (B_1_C0_52)",Total Allied Health (D_4_HOS_C3_200),Durable Medical Equipment Rented (D3_IPF_C2_96),Other Special Purpose (A_C6_117),New Capital Equipment (A_C6_2),HHA (B_1_C21_101),"COST REIMBURSED SERVICES SUBJECT TO DEDUCTIBLES  AND COINSURANCE - CHARGES, Emergency (D_5_HOS_C3_91)",Refunds and Rebates of Expenses (A8_C2_5),"Net Expense for Cost Allocation, SNF (B_1_C0_44)","Blood Storing, Processing, Trans (D3_IPF_C3_63)",Durable Medical Equipment Sold (C_1_C5_97),Drugs Charged to Patients (C_1_C5_73),"ADJUSTED SALARIES, Physician Part A (S3_2_C4_22)",Intravenous Therapy (D_4_IPF_C13_64),Clinic (D_4_HOS_C10_90),"COST REIMBURSED SERVICES SUBJECT TO DEDUCTIBLES  AND COINSURANCE - CHARGES, Cardiac Catheterization (D_5_HOS_C3_59)",Medical Supplies Charged to Patients (D_4_IRF_C13_71),"AMOUNT REPORTED, Total Salaries (S3_2_C2_1)","AVERAGE HOURLY WAGE, Administrative and General (S3_2_C6_27)","HHA II, PEP:  Total Non Routine Med Supply Chgs (S4_HHA2_C4_38)",Charity care charges and uninsured discounts for the entire facility (S10_C3_20),Surgical Intensive Care Unit (S3_1_C2_11),Liver Acquisition (A_C2_107),Hospice (S3_1_C7_24),Nonphysician Anesthetists (A_C2_19),Emergency (A_C6_91),Physical Therapy (A_C2_66),CMHC (B_1_C22_99),"Fully Depreciated Assets, Ending Balance (A7_1_C6_7)",Physical Therapy (D_4_IRF_C13_66),"COST REIMBURSED SERVICES SUBJECT TO DEDUCTIBLES  AND COINSURANCE - CHARGES, Home Program Dialysis (D_5_HOS_C3_94)","Net Expense for Cost Allocation, Observation Beds (Distinct Unit) (B_1_C0_9201)","Average patient dialysis time 
including setup (S5_C4_3)",Research (B_2_C26_191),"Net Expense for Cost Allocation, Social Service (B_1_C0_17)",Laboratory (D_4_HOS_C10_60),Number of Times per week Patient receives Dialysis (S5_C1_2),Total unreimbursed and uncompensated care (S10_C1_31),Other Special Care Unit (D_3_HOS_C9_35),"If (SCH), enter the # of periods. (S2_1_C1_35)",Recovery Room (D_4_IRF_C13_51),"Total Inpatient Charges, CT Scan (C_1_C6_57)","Net Expense for Cost Allocation, Other General Service (B_1_C0_18)",Radioisotope (D_4_HOS_C13_56),"Total Program Inpatient Operating Cost excluding Capital Related, Nonphysician, Anesthetist, and Medical Education Costs (D1_HOS_C1_53)",OPPS payments (E_B_HOS_C1_3),Speech Pathology (C_1_C2_68),"Gift, Flower, Coffee Shop, Canteen (A_C6_190)","Lease, New Cap Related Csts Bldg & Fixtures (A7_3_C10_1)","Allocation of Interns & Residents Salary and Fringes, Nursery (B_1_C21_43)",Respiratory Therapy (D3_HOS_C3_65),"Net Expense for Cost Allocation, MRI (B_1_C0_58)",Durable Medical Equipment Rented (A_C6_96),MRI (D3_HOS_C2_58),Home Program Dialysis (D_4_HOS_C3_94),"COST REIMBURSED SERVICES SUBJECT TO DEDUCTIBLES  AND COINSURANCE - CHARGES, Speech Pathology (D_5_HOS_C3_68)",Hospice (B_2_C26_116),Emergency (D_4_IRF_C13_91),"COST SERVICES NOT SUBJECT TO DEDUCTIBLES AND COINSURANCE - COST, Blood Clotting Factors for Hemoph. (D_5_HOS_C7_6250)","COST REIMBURSED SERVICES NOT SUBJECT TO DEDUCTIBLES AND COINSURANCE - CHARGES, Durable Medical Equipment Rented (D_5_HOS_C4_96)",Adults & Pediatrics (D_1_HOS_C7_30),"Disposals and Retirements, Total (A7_1_C5_10)","Total Inpatient Charges, Delivery Room and Labor Room (C_1_C6_52)","PPS REIMBURSED SERVICES -  CHARGES, Laboratory (D_5_HOS_C2_60)",Occupational Therapy (C_1_C5_67),Other Special Care Unit (D3_IPF_C2_35),Cash on Hand and in Banks (G_C1THRU4_1),"PAID HOURS RELATED TO SALARIES, Home Office Salaries & Wage Related Csts (S3_2_C5_14)",Laboratory (A_C2_60),Radiology-Diagnostic (D3_HOS_C2_54),HHA (S3_1_C10_22),Title V discharges (S3_1_C12_1),Electroencephalography (C_1_C5_70),Other Reimbursable (A_C2_98),Respiratory Therapy (D_4_SNF_C11_65),Other Special Care (S3_1_C8_12),Delivery Room and Labor Room (D_4_HOS_C10_52),Subprovider II (A_C2_4201),Occupational Therapy (D3_IPF_C3_67),"COST SERVICES NOT SUBJECT TO DEDUCTIBLES AND COINSURANCE - COST, Other Reimbursable (D_5_HOS_C7_98)",Recovery Room (C_1_C5_51),Buildings (G_C1THRU4_15),Respiratory Therapy (D_4_HOS_C3_65),Drugs Charged to Patients (D_4_HOS_C10_73),"PPS SERVICES COST, Durable Medical Equipment Sold (D_5_HOS_C5_97)",Radiology-Diagnostic (D_4_IRF_C13_54),"Allocation of Interns & Residents Salary and Fringes, MRI (B_1_C21_58)","PPS REIMBURSED SERVICES -  CHARGES, Emergency (D_5_HOS_C2_91)",Pancreas Acquisition (A_C2_109),Cardiac Catheterization (D_4_IPF_C11_59),Durable Medical Equipment Rented (D3_SNF_C2_96),TOTAL (D3_SNF_C3_200),Organ Procurement (D4_LUNG_C1_69),Net Income (G3_C1_29),Other Capital (A_C6_3),"COST REIMBURSED SERVICES SUBJECT TO DEDUCTIBLES  AND COINSURANCE - CHARGES, Electrocardiology (D_5_HOS_C3_69)",Blood Clotting Factors for Hemoph. (D3_HOS_C2_6250),Radiology-Therapeutic (D_4_IRF_C13_55),OLTC (A_C1_46),"PPS SERVICES COST, Electroencephalography (D_5_HOS_C5_70)","Net Expense for Cost Allocation, Blood Storing, Processing, Trans (B_1_C0_63)",ASC (Distinct Part) (A_C6_115),Maintenance of Personnel (A_C2_12),CMHC (C_1_C6_99),"Treatment capacity per day per
station (S5_C2_7)",Emergency (D_4_HOS_C12_91),"Depreciation, New Cap Related Csts Movable Equipment (A7_3_C9_2)",Other Ancillary (B_2_C26_76),"Allocation of Interns & Residents Program Costs, Burn Intensive Care Unit (B_1_C22_33)",ASC (Non Distinct Part) (B_1_C26_75),In State Medicaid eligible days (S2_1_C2_24),"AMOUNT REPORTED, Wage Related Costs RHC/FQHC (S3_2_C2_24)",Operating Room (D_4_HOS_C11_50),"TOTAL CAPITAL COSTS AFTER COST ALLOCATION, OLTC (B_2_C26_46)","Taxes, Total (A7_3_C6_3)",Recovery Room (D3_SNF_C2_51),Hospital State (S2_1_C2_2),"COST REIMBURSED SERVICES SUBJECT TO DEDUCTIBLES  AND COINSURANCE - CHARGES, Durable Medical Equipment Sold (D_5_HOS_C3_97)",Kidney Acquisition (A_C6_105),"Net Expense for Cost Allocation, Employee Benefits (B_1_C0_4)",Total Allied Health (D_4_IPF_C3_200),Delivery Room and Labor Room (B_1_C26_52),"PAID HOURS RELATED TO SALARIES, Employee Benefits (S3_2_C5_26)","Allocation of Interns & Residents Salary and Fringes, Cardiac Catheterization (B_1_C21_59)","PPS REIMBURSED SERVICES -  CHARGES, Speech Pathology (D_5_HOS_C2_68)",Research (A_C2_191),"Net Expense for Cost Allocation, Gift, Flower, Coffee Shop, Canteen (B_1_C0_190)",Total Salaries (A_C1_200),Excess of customary charges (E_B_HOS_C1_19),"COST SERVICES SUBJECT TO DEDUCTIBLES AND COINSURANCE - COST, Laboratory (D_5_HOS_C6_60)",Durable Medical Equipment Sold (D_4_HOS_C2_97),Clinic (D_4_HOS_C3_90),Other Ancillary (D3_IRF_C2_76),Nursery (D_1_HOS_C4_43),"Allocation of Interns & Residents Salary and Fringes, Interns & Res Salary and Fringe Benefits (B_1_C21_21)",Total Hospital Interns & Residents (S3_1_C10_14),HHA (S3_1_C11_22),Operating Room (D3_IPF_C3_50),Title V discharges (S3_1_C12_16),Hospital County (S2_1_C4_2),Impl. Dev. Charged to Patients (D3_HOS_C2_72),"HHA II, LUPA Episodes:  Total Visits (S4_HHA2_C3_33)","HHA I, Without Outliers:  Non Routine Med Sup Chgs (S4_HHA1_C1_38)","PPS SERVICES COST, Renal Dialysis (D_5_HOS_C5_74)",Recovery Room (A_C2_51),"Blood Storing, Processing, Trans (D3_SNF_C3_63)","Gift, Flower, Coffee Shop, Canteen (B_2_C26_190)","PPS SERVICES COST, MRI (D_5_HOS_C5_58)","Difference between Adjusted Inpatient, Operating Cost and Target Amount (D1_HOS_C1_57)",Other Outpatient Services (C_1_C6_93),"ADJUSTED SALARIES, Non-Physician Anesthetist Part A (S3_2_C4_20)","Disposals and Retirements, Land (A7_1_C5_1)",Nursery (B_1_C26_43),Rental of Provider space by suppliers (A8_C2_6),Transitional corridor payment (E_B_HOS_C1_8),Radiology-Diagnostic (D3_IPF_C3_54),Hospital Street Address (S2_1_C1_1),Drugs Charged to Patients (B_1_C21_73),"PAID HOURS RELATED TO SALARIES, Home Office:  Physician Part A (S3_2_C5_15)",Lung  Acquisition (C_1_C7_108),Delivery Room and Labor Room (D_4_HOS_C12_52),OPT (A_C2_9920),Observation Beds (Distinct Unit) (D_4_HOS_C11_9201),Emergency (D_4_SNF_C11_91),"Taxes, New Cap Related Csts Movable Equipment (A7_3_C6_2)","Allocation of Interns & Residents Program Costs, Adults and Pediatrics (B_1_C22_30)",Total prospective payment (E_B_HOS_C1_24),Anesthesiology (D_4_SNF_C11_53),"AMOUNT REPORTED, Home Office Personnel (S3_2_C2_8)","Disposals and Retirements, Subtotal (A7_1_C5_8)","AVERAGE HOURLY WAGE, Non-Physician Anesthetist Part A (S3_2_C6_2)","Net Expense for Cost Allocation, Blood Clotting Factors for Hemoph. (B_1_C0_6250)",Speech Pathology (D3_IPF_C3_68),"ADJUSTED SALARIES, Physician-Part B (S3_2_C4_5)",Tentative settlement (E_B_HOS_C1_42),CAH Visits (S3_1_C8_15),"AMOUNT REPORTED, Interns & Residents (S3_2_C2_2550)","TOTAL CAPITAL COSTS AFTER COST ALLOCATION, Burn Intensive Care Unit (B_2_C26_33)",OLTC (C_1_C5_46),RHC (A_C2_88),"AVERAGE HOURLY WAGE, Pharmacy (S3_2_C6_40)",Occupational Therapy (D3_IRF_C3_67),Drugs Charged to Patients (B_1_C22_73),"Beginning Balances, Land Improvements (A7_1_C1_2)","COST REIMBURSED SERVICES SUBJECT TO DEDUCTIBLES  AND COINSURANCE - CHARGES, Occupational Therapy (D_5_HOS_C3_67)",SSA State Code (STATE),Impl. Dev. Charged to Patients (D3_SNF_C3_72),Electroencephalography (D3_SNF_C2_70),Total Hospital (S3_1_C8_14),"Purchases, Fixed Equipment (A7_1_C2_5)","Allocation of Interns & Residents Program Costs, Intensive Care Unit (B_1_C22_31)",HRR adjustment amount  (E_A_HOS_C1_7094),Operating Room (D_4_HOS_C3_50),"PAID HOURS RELATED TO SALARIES, Laundry and Linen Service (S3_2_C5_31)",Hospice (A_C2_116),Impl. Dev. Charged to Patients (D_4_IRF_C13_72),Radioisotope (D_4_HOS_C11_56),"COST REIMBURSED SERVICES SUBJECT TO DEDUCTIBLES  AND COINSURANCE - CHARGES, Whole Blood & Packed Red Blood Cells (D_5_HOS_C3_62)",Subprovider-IRF (B_1_C26_41),Total Patient Days (D_3_HOS_C6_200),Emergency (D_4_HOS_C2_91),"ADJUSTED SALARIES, Home Office Salaries & Wage Related Csts (S3_2_C4_14)",Emergency (D_4_HOS_C3_91),"COST REIMBURSED SERVICES SUBJECT TO DEDUCTIBLES  AND COINSURANCE - CHARGES, Other Ancillary (D_5_HOS_C3_76)",RHC 10 Provider Number (S2_1_C2_1509),Electroencephalography (D_4_SNF_C11_70),CT Scan (D_4_HOS_C10_57),"HHA III, PEP:  Total Number of Outlier Episodes (S4_HHA3_C4_37)",Burn Intensive Care Unit (A_C6_33),"Net Expense for Cost Allocation, Paramedical Education (B_1_C0_23)","COST SERVICES NOT SUBJECT TO DEDUCTIBLES AND COINSURANCE - COST, Intravenous Therapy (D_5_HOS_C7_64)",Other Reimbursable (D_4_HOS_C3_98),Organ Procurement (D4_HEART_C1_69),RHC 5 Provider Number (S2_1_C2_1504),Other Special Care (S3_1_C4_12),"Are there any related organization or how office costs as defined in HCFA Pub. 15-I, chapter 10? (Y/N) (S2_1_C1_140)","COST SERVICES SUBJECT TO DEDUCTIBLES AND COINSURANCE - COST, Electroencephalography (D_5_HOS_C6_70)","TOTAL CAPITAL COSTS AFTER COST ALLOCATION, Laboratory (B_2_C26_60)","ADJUSTED SALARIES, Dietary (S3_2_C4_34)",Other Organ Acquisition (A_C1_112),Other Ancillary (D3_IPF_C2_76),SNF (B_1_C26_44),Recovery Room (D3_IPF_C3_51),"AMOUNT REPORTED, Wage Related Costs RHC/FQHC (S3_2_C3_24)","Net Expense for Cost Allocation, Intensive Care Unit (B_1_C0_31)","PPS SERVICES COST, Radiology-Therapeutic (D_5_HOS_C5_55)",Speech Pathology (D3_IPF_C2_68),"COST REIMBURSED SERVICES NOT SUBJECT TO DEDUCTIBLES AND COINSURANCE - CHARGES, MRI (D_5_HOS_C4_58)",Other Ancillary (B_1_C26_76),Health Information Technology Designated Assets (G_C1THRU4_27),ICF (S3_1_C8_2001),"Total Outpatient Charges, Radioisotope (C_1_C7_56)",Maintenance and Repairs (A_C2_6),Clinic (D_4_IPF_C11_90),RHC 17 Provider Number (S2_1_C2_1516),Occupational Therapy (D3_SNF_C2_67),"PAID HOURS RELATED TO SALARIES, Administrative and General (S3_2_C5_27)",Drugs Charged to Patients (B_1_C26_73),"Blood Storing, Processing, Trans (B_2_C26_63)",Intensive Care Unit (S3_1_C4_8),Subtotal (C_1_C5_200),"Net Expense for Cost Allocation, Liver Acquisition (B_1_C0_107)","Net Expense for Cost Allocation, Total (B_1_C0_200)",Observation Beds (Distinct Unit) (B_1_C22_9201),Delivery Room and Labor Room (D_4_HOS_C4_52),"ADJUSTED SALARIES, Central Services and Supply (S3_2_C4_39)",Hospice (S3_1_C9_24),Heart Acquisition (C_1_C5_106),"COST REIMBURSED SERVICES SUBJECT TO DEDUCTIBLES  AND COINSURANCE - CHARGES, Blood Storing, Processing, Trans (D_5_HOS_C3_63)",Delivery Room and Labor Room (D3_IRF_C2_52),Other Reimbursable (D_4_HOS_C2_98),"Net Expense for Cost Allocation, Ambulance Services (B_1_C0_95)",Delivery Room and Labor Room (D3_IRF_C3_52),"COST REIMBURSED SERVICES NOT SUBJECT TO DEDUCTIBLES AND COINSURANCE - CHARGES, Intravenous Therapy (D_5_HOS_C4_64)",RHC (A_C1_88),Delivery Room and Labor Room (C_1_C5_52),Intravenous Therapy (D_4_SNF_C11_64),Radioisotope (D3_IRF_C3_56),Title XIX discharges (S3_1_C14_17),"PAID HOURS RELATED TO SALARIES, Maintenance of Personnel (S3_2_C5_37)","AMOUNT REPORTED, Other General Service (S3_2_C2_43)","HHA II, LUPA Episodes:  Other Charges (S4_HHA2_C3_34)",Burn Intensive Care Unit (D_1_HOS_C6_33),HHA (C_1_C7_101),Medical Supplies Charged to Patients (D_4_HOS_C4_71),"PAID HOURS RELATED TO SALARIES, Physician-Part B (S3_2_C5_5)",Laundry and Linen Service (A_C1_8),"AMOUNT REPORTED, Central Services and Supply (S3_2_C2_39)",Title XIX discharges (S3_1_C14_1),"PAID HOURS RELATED TO SALARIES, Subtotal Other Wages and Related Csts (S3_3_C5_4)",CT Scan (D3_IPF_C2_57),"PAID HOURS RELATED TO SALARIES, Dietary (S3_2_C5_34)","Net Expense for Cost Allocation, Emergency (B_1_C0_91)",Medicare allowable bad debts for the entire hospital complex (S10_C1_2701),Laboratory (A_C6_60),Subprovider-IRF (A_C2_41),Radiology-Therapeutic (D_4_HOS_C11_55),"Net Expense for Cost Allocation, Durable Medical Equipment Rented (B_1_C0_96)",Renal Dialysis (D_4_HOS_C12_74),"AMOUNT REPORTED, Related  Salaries (S3_2_C2_1402)",Negative Cost Centers (B_2_C26_201),"PPS SERVICES COST, Drugs Charged to Patients (D_5_HOS_C5_73)",Other adjustments (E_B_HOS_C1_39),"Net Expense for Cost Allocation, Other Special Care Unit (B_1_C0_35)",Ambulance Services (C_1_C5_95),"AVERAGE HOURLY WAGE, Home Office Salaries & Wage Related Csts (S3_2_C6_14)",Laboratory (B_1_C26_60),CMHC (A_C2_99),"PAID HOURS RELATED TO SALARIES, Home Office Personnel (S3_2_C5_8)",Occupational Therapy (B_2_C26_67),"PPS REIMBURSED SERVICES -  CHARGES, Recovery Room (D_5_HOS_C2_51)",Net Patient Revenue (G3_C1_3),Radiology-Therapeutic (A_C2_55),OSP (C_1_C6_9940),"Blood Storing, Processing, Trans (D_4_HOS_C12_63)",Radioisotope (D_4_IRF_C11_56),Intravenous Therapy (A_C1_64),Respiratory Therapy (C_1_C2_65),"Net Expense for Cost Allocation, Other Reimbursable (B_1_C0_98)",Impl. Dev. Charged to Patients (D_4_HOS_C4_72),Whole Blood & Packed Red Blood Cells (D3_HOS_C2_62),Delivery Room and Labor Room (D3_SNF_C2_52),"Net Expense for Cost Allocation, Durable Medical Equipment Sold (B_1_C0_97)",Housekeeping (A_C1_9),Radiology-Therapeutic (D3_IRF_C3_55),"PPS REIMBURSED SERVICES -  CHARGES, ASC (Non Distinct Part) (D_5_HOS_C2_75)","AMOUNT REPORTED, Home Office Salaries (S3_2_C2_1401)",Rental of quarters to employee and oths (A8_C2_15),"COST SERVICES SUBJECT TO DEDUCTIBLES AND COINSURANCE - COST, ASC (Non Distinct Part) (D_5_HOS_C6_75)","Net Expense for Cost Allocation, ASC (Distinct Part) (B_1_C0_115)","COST REIMBURSED SERVICES NOT SUBJECT TO DEDUCTIBLES AND COINSURANCE - CHARGES, ASC (Non Distinct Part) (D_5_HOS_C4_75)","Income from imposition of interest, finance (A8_C2_21)",Hospice (B_1_C26_116),ASC (Non Distinct Part) (D_4_HOS_C13_75),Surgical Intensive Care Unit (A_C1_34),Surgical Intensive Care Unit (S3_1_C5_11),Cardiac Catheterization (D_4_HOS_C13_59),Subprovider-IRF (D3_HOS_C2_41),"TOTAL CAPITAL COSTS AFTER COST ALLOCATION, Subprovider-IRF (B_2_C26_41)",Provider-based physician adjustment (A8_C2_10),Hospital PO Box (S2_1_C2_1),MRI (D_4_HOS_C10_58),Intravenous Therapy (A_C6_64),Whole Blood & Packed Red Blood Cells (D_4_IPF_C11_62),Durable Medical Equipment Rented (D_4_HOS_C3_96),Radiology-Therapeutic (D_4_IPF_C11_55),Home Program Dialysis (D_4_HOS_C11_94),Delivery Room and Labor Room (D_4_HOS_C13_52),"COST REIMBURSED SERVICES NOT SUBJECT TO DEDUCTIBLES AND COINSURANCE - CHARGES, Home Program Dialysis (D_5_HOS_C4_94)",Respiratory Therapy (D_4_HOS_C12_65),Renal Dialysis (D_4_HOS_C4_74),Total Salaries (A_C6_200),HAC reduction adjustment amount (E_A_HOS_C1_7099),IRF (S3_1_C7_17),Clinic (D3_IRF_C2_90),Subprovider I (A_C2_42),Zip Code (S2_1_C3_143),"PAID HOURS RELATED TO SALARIES, Central Services and Supply (S3_2_C5_39)",Other Ancillary (B_1_C22_76),Radiology-Diagnostic (D_4_HOS_C13_54),Speech Pathology (D_4_IRF_C13_68),FQHC 3 Provider Number (S2_1_C2_1602),"COST SERVICES NOT SUBJECT TO DEDUCTIBLES AND COINSURANCE - COST, Durable Medical Equipment Rented (D_5_HOS_C7_96)",Laboratory (D_4_IPF_C11_60),Medical Supplies Charged to Patients (D3_IRF_C3_71),Maintenance and Repairs (A_C1_6),Durable Medical Equipment Rented (C_1_C6_96),Interns & Res Salary and Fringe Benefits (A_C6_21),FQHC 8 Provider Number (S2_1_C2_1607),"Blood Storing, Processing, Trans (B_1_C26_63)",Impl. Dev. Charged to Patients (D_4_HOS_C3_72),SNF (A_C6_44),PBP Clinical Lab Services Program Only (A_C6_61),Surgical Intensive Care Unit (D3_SNF_C2_34),"COST REIMBURSED SERVICES SUBJECT TO DEDUCTIBLES  AND COINSURANCE - CHARGES, Other Reimbursable (D_5_HOS_C3_98)",Occupational Therapy (A_C6_67),MDH status beginning date  (MM/DD/YY) (S2_1_C1_3801),"Net Expense for Cost Allocation, Adults and Pediatrics (B_1_C0_30)",Medical Supplies Charged to Patients (D3_HOS_C2_71),Radiology-Diagnostic (D_4_IPF_C11_54),Hospice (A_C1_116),NF (S3_1_C5_20),Liver Acquisition (B_2_C26_107),Total (C_1_C6_202),Radioisotope (D3_IPF_C3_56),"TOTAL CAPITAL COSTS AFTER COST ALLOCATION, Coronary Care Unit (B_2_C26_32)",Deductibles and coinsurance (E_B_HOS_C1_25),Anesthesiology (D_4_HOS_C12_53),Durable Medical Equipment Sold (D_4_HOS_C13_97),Intensive Care Unit (D3_HOS_C2_31),"COST SERVICES SUBJECT TO DEDUCTIBLES AND COINSURANCE - COST, Operating Room (D_5_HOS_C6_50)",Intensive Care Unit Program Cost (D1_HOS_C5_43),"PAID HOURS RELATED TO SALARIES, Net Salaries (S3_3_C5_1)","PAID HOURS RELATED TO SALARIES, Non-Physician Anesthetist Part B (S3_2_C5_3)",Total Fixed Assets (G_C1THRU4_30),Hospice (B_1_C22_116),"PPS SERVICES COST, Blood Storing, Processing, Trans (D_5_HOS_C5_63)",Radiology-Therapeutic (D_4_HOS_C10_55),Delivery Room and Labor Room (D3_HOS_C2_52),Medicare Certified Heart TC term date (S2_1_C2_127),Radioisotope (D3_HOS_C3_56),"Depreciation, New Cap Related Csts Bldg & Fixtures (A7_3_C9_1)",Total Facility (S3_1_C2_27),Delivery Room and Labor Room (D_4_IRF_C11_52),Impl. Dev. Charged to Patients (B_1_C26_72),Liver Acquisition (C_1_C5_107),Radiology-Diagnostic (D3_SNF_C2_54),"Blood Storing, Processing, Trans (D_4_SNF_C11_63)",Laboratory (D_4_HOS_C4_60),Total Costs (D_3_HOS_C5_200),Medical Supplies Charged to Patients (D_4_IPF_C13_71),"Net Expense for Cost Allocation, Cardiac Catheterization (B_1_C0_59)",Occupational Therapy (A_C2_67),RHC 2 Provider Number (S2_1_C2_1501),"COST REIMBURSED SERVICES NOT SUBJECT TO DEDUCTIBLES AND COINSURANCE - CHARGES, Other Outpatient Services (D_5_HOS_C4_93)",Physical Therapy (D3_SNF_C2_66),"AVERAGE HOURLY WAGE, Cafeteria (S3_2_C6_36)","Fully Depreciated Assets, Assets (A7_1_C7_7)",Partial or full credits from manufacturers (E_B_HOS_C1_3998),Other Reimbursable (B_1_C22_98),"PPS SERVICES COST, Emergency (D_5_HOS_C5_91)",Total Adults & Peds (S3_1_C6_7),"PPS REIMBURSED SERVICES -  CHARGES, Physical Therapy (D_5_HOS_C2_66)",Adults and Pediatrics (A_C1_30),Other Ancillary (A_C2_76),Other Special Care Unit (C_1_C5_35),"AVERAGE HOURLY WAGE, Administrative and General under Contract (S3_2_C6_28)","ADJUSTED SALARIES, Employee Benefits (S3_2_C4_26)",Clinic (A_C1_90),Medical Supplies Charged to Patients (D_4_HOS_C13_71),Occupational Therapy (D3_HOS_C3_67),"AMOUNT REPORTED, Housekeeping under contract (S3_2_C2_33)","COST REIMBURSED SERVICES NOT SUBJECT TO DEDUCTIBLES AND COINSURANCE - CHARGES, Radioisotope (D_5_HOS_C4_56)",Paramedical Education (A_C1_23),Operating Room (D_4_IPF_C11_50),Laboratory (D3_IRF_C3_60),"General Inpatient Routine Service Cost, net of Swing Bed Cost (D1_HOS_C1_27)",TOTAL (D3_HOS_C3_200),Relief Payment (D1_HOS_C1_62),"HHA III, PEP Episodes:  Other Charges (S4_HHA3_C4_34)",Physicians' Assistant (A8_C2_29),"PPS REIMBURSED SERVICES -  CHARGES, Impl. Dev. Charged to Patients (D_5_HOS_C2_72)",Inventory (G_C1THRU4_7),"Total, Total (A7_3_C15_3)","Total Inpatient Charges, Burn Intensive Care Unit (C_1_C6_33)",Respiratory Therapy (D_4_IRF_C11_65),"Average patient dialysis time 
including setup (S5_C2_3)","HHA I, With Outliers:  Other Charges (S4_HHA1_C2_34)",MRI (C_1_C5_58),Labor and Delivery (S3_1_C3_32),Physical Therapy (D_4_IPF_C13_66),Bonus Payment (D1_HOS_C1_58),Fiscal Year Begin Date (FY_BGN_DT),"Fully Depreciated Assets, Disp. And Retirement (A7_1_C5_7)","Allocation of Interns & Residents Salary and Fringes, Respiratory Therapy (B_1_C21_65)",Cardiac Catheterization (A_C6_59),Operating Room (C_1_C5_50),Home Program Dialysis (A_C6_94),"Total Outpatient Charges, CT Scan (C_1_C7_57)","Total Inpatient Charges, Other Special Care Unit (C_1_C6_35)",FQHC (A_C1_89),Major Movable Equipment (G_C1THRU4_23),Electrocardiology (D_4_HOS_C2_69),Medicare Certified Liver TC term date (S2_1_C2_128),Total Swing Bed Cost (D1_HOS_C1_26),Medicare Certified Lung TC term date (S2_1_C2_129),"AMOUNT REPORTED, Dietary (S3_2_C2_34)",Speech Pathology (A_C2_68),Coronary Care Unit (A_C2_32),Operating Room (D3_IRF_C2_50),"Total Inpatient Charges, NF (C_1_C6_45)",Intravenous Therapy (D3_IRF_C2_64),Burn Intensive Care Unit (D_1_HOS_C4_33),Impl. Dev. Charged to Patients (D_4_SNF_C11_72),Research (B_1_C21_191),Observation Beds (Distinct Unit) (B_1_C26_9201),Laundry and Linen Service (A8_C2_13),Pancreas Acquisition (C_1_C6_109),"Disposals and Retirements, Buildings and Fixtures (A7_1_C5_3)",Intravenous Therapy (D_4_HOS_C2_64),Radiology-Diagnostic (D_4_IPF_C13_54),Electroencephalography (D3_IPF_C2_70),Radiology-Diagnostic (D_4_HOS_C2_54),"AMOUNT REPORTED, Management and Administrative Services (S3_2_C2_12)","AVERAGE HOURLY WAGE, Employee Benefits (S3_2_C6_26)",Drugs Charged to Patients (C_1_C7_73),IPF Provider Number (S2_1_C1_4),"HHA I, PEP Episodes:  Total Visits (S4_HHA1_C4_33)","HHA III, PEP Episodes:  Total Number of Episodes (S4_HHA3_C4_36)","COST REIMBURSED SERVICES SUBJECT TO DEDUCTIBLES  AND COINSURANCE - CHARGES, ASC (Non Distinct Part) (D_5_HOS_C3_75)",Other Nonreimbursable (B_1_C21_194),Total (B_2_C26_202),Paramedical Education (A_C6_23),Component rate ESRD (E_B_HOS_C1_33),Payments received from patients for amounts previously written off as charity care (S10_C3_22),Nursery (A_C2_43),"General Inpatient Routine Service Cost, net of Swing Bed and Private Room Diff (D1_IPF_C1_37)","Net Expense for Cost Allocation, Radiology-Therapeutic (B_1_C0_55)",Total Program Excludable Costs (D1_IPF_C1_52),Electrocardiology (D_4_IPF_C13_69),Home Program Dialysis (D3_IRF_C2_94),"Net Expense for Cost Allocation, Physical Therapy (B_1_C0_66)",Intensive Care Unit (D_1_HOS_C7_31),Coronary Care Unit (D3_IRF_C2_32),Pass Through Cost for  Program Ancillary (D1_IRF_C1_51),Cardiac Catheterization (A_C1_59),Operating Room (D_4_SNF_C11_50),Renal 1 Provider Number (S2_1_C2_18),"Net Expense for Cost Allocation, Other Special Purpose (B_1_C0_117)",Other Outpatient Services (D3_IPF_C3_93),Subprovider 1 (S3_1_C7_18),Hospice 2 Provider Number (S2_1_C2_1401),ASC (Non Distinct Part) (A_C6_75),"HHA II, With Outliers:  Other Charges (S4_HHA2_C2_34)","PPS REIMBURSED SERVICES -  CHARGES, Electroencephalography (D_5_HOS_C2_70)","HHA II, Total Number of Outlier Episodes (S4_HHA2_C5_37)",Durable Medical Equipment Sold (B_1_C26_97),"Fully Depreciated Assets, Subtotal (A7_1_C7_8)",Pancreas Acquisition (B_1_C21_109),CT Scan (D_4_HOS_C2_57),Drugs Charged to Patients (D_4_IPF_C13_73),Related Organization Transactions (A8_C2_12),Title XVIII discharges (S3_1_C13_2),Nonpaid Workers (B_1_C26_193),Recovery Room (B_1_C26_51),"Net Expense for Cost Allocation, OSP (B_1_C0_9940)",OSP (A_C1_9940),Burn Intensive Care Unit (C_1_C5_33),Delivery Room and Labor Room (D_4_HOS_C11_52),"Net Expense for Cost Allocation, Laboratory (B_1_C0_60)",Physical Therapy (D3_HOS_C2_66),Other Special Purpose (C_1_C6_117),Anesthesiology (D3_IRF_C2_53),Laboratory (D_4_HOS_C13_60),"Net Expense for Cost Allocation, Operating Room (B_1_C0_50)",Recovery Room (D_4_IRF_C11_51),Radiology-Therapeutic (D_4_IPF_C13_55),Respiratory Therapy (D3_IRF_C3_65),CT Scan (A_C6_57),"AMOUNT REPORTED, Physician Part A (S3_2_C3_22)",Intravenous Therapy (D_4_HOS_C4_64),Surgical Intensive Care Unit (D_1_HOS_C4_34),Delivery Room and Labor Room (D_4_SNF_C11_52),Laboratory (A_C1_60),Drugs Charged to Patients (D3_IPF_C3_73),Subtotal (E_B_HOS_C1_37),"Net Expense for Cost Allocation, PBP Clinical Lab Services Program Only (B_1_C0_61)",Other Outpatient Services (B_1_C26_93),"Allocation of Interns & Residents Program Costs, Whole Blood & Packed Red Blood Cells (B_1_C22_62)",Operating Room (B_1_C26_50),"COST SERVICES NOT SUBJECT TO DEDUCTIBLES AND COINSURANCE - COST, Electroencephalography (D_5_HOS_C7_70)",Durable Medical Equipment Rented (D_4_HOS_C12_96),Burn Intensive Care Unit Program Cost (D1_HOS_C5_45),ICF (S3_1_C2_2001),SNF (S3_1_C3_19),Other Outpatient Services (D_4_HOS_C11_93),"HHA II, Without Outliers:  Non Routine Med Sup Chgs (S4_HHA2_C1_38)","AMOUNT REPORTED, Home Office Salaries & Wage Related Csts (S3_2_C3_14)","PPS REIMBURSED SERVICES -  CHARGES, Radiology-Diagnostic (D_5_HOS_C2_54)","COST SERVICES SUBJECT TO DEDUCTIBLES AND COINSURANCE - COST, Respiratory Therapy (D_5_HOS_C6_65)",Occupational Therapy (D_4_IPF_C13_67),Other Organ Acquisition (A_C6_112),"Net Expense for Cost Allocation, Nonpaid Workers (B_1_C0_193)","ADJUSTED SALARIES, Excluded Area Salaries (S3_3_C4_2)","PPS SERVICES COST, Other Reimbursable (D_5_HOS_C5_98)",ASC (Non Distinct Part) (D3_SNF_C2_75),MRI (A_C2_58),"TOTAL CAPITAL COSTS AFTER COST ALLOCATION, Recovery Room (B_2_C26_51)",MRI (D3_IPF_C3_58),"Total Inpatient Charges, Cardiac Catheterization (C_1_C6_59)",Renal Dialysis (D3_IPF_C3_74),Other Ancillary (D_4_IPF_C13_76),Lung  Acquisition (B_2_C26_108),Anesthesiology (D3_SNF_C3_53),Report Status Code (RPT_STUS_CD),Allowable Inpatient Cost Plus Incentive Pt (D1_HOS_C1_63),"Allocation of Interns & Residents Salary and Fringes, Laboratory (B_1_C21_60)",Ambulance Services (A_C2_95),Nonpaid Workers (B_1_C22_193),"HHA III, With Outliers:  Non Routine Med Sup Chgs (S4_HHA3_C2_38)",RHC 24 Provider Number (S2_1_C2_1523),RHC 21 Provider Number (S2_1_C2_1520),"Disposals and Retirements, Land Improvements (A7_1_C7_2)",Subprovider II (A_C1_4201),"Net Expense for Cost Allocation, Recovery Room (B_1_C0_51)",Coronary Intensive Care Unit (D_1_HOS_C6_32),"COST SERVICES SUBJECT TO DEDUCTIBLES AND COINSURANCE - COST, Clinic (D_5_HOS_C6_90)",Occupational Therapy (B_1_C26_67),"PPS REIMBURSED SERVICES -  CHARGES, Home Program Dialysis (D_5_HOS_C2_94)",Interns and residents (E_B_HOS_C1_22),Other Reimbursable (D_4_HOS_C11_98),Administrative and General (A_C1_5),CAPD exchanges per day (S5_C4_4),"Net Expense for Cost Allocation, Intravenous Therapy (B_1_C0_64)",CMHC (B_1_C26_99),Recovery Room (D3_IRF_C3_51),"Epoietin amount form worksheet A
for home dialysis program (S5_C1_14)","Total, New Cap Related Csts Movable Equipment (A7_3_C15_2)",NF (S3_1_C7_20),Other Outpatient Services (D_4_IRF_C11_93),"Purchases, Land (A7_1_C2_1)",Blood Clotting Factors for Hemoph. (A_C2_6250),RHC 15 Provider Number (S2_1_C2_1514),Lung  Acquisition (A_C2_108),Total Adults & Pediatrics (S3_1_C8_7),Electroencephalography (D3_IRF_C2_70),Other Outpatient Services (A_C2_93),Respiratory Therapy (D_4_HOS_C2_65),"HHA I, Total Charges:  LUPA Episodes (S4_HHA1_C3_35)",Subprovider 2 (S3_1_C3_1801),Television and Radio Service (A8_C2_8),Int & Res (non approved teaching program (B_1_C22_100),Durable Medical Equipment Sold (C_1_C6_97),Observation Beds (Distinct Unit) (A_C1_9201),Other Special Care Unit (D_1_HOS_C6_35),Cost To Charge Ratio (S10_C1_1),"PAID HOURS RELATED TO SALARIES, Interns & Residents (S3_2_C5_7)","Blood Storing, Processing, Trans (D3_IRF_C3_63)",Other Special Care Unit (A_C1_35),CMHC (C_1_C7_99),"PPS REIMBURSED SERVICES -  CHARGES, Other Reimbursable (D_5_HOS_C2_98)",Emergency (D_4_HOS_C13_91),"PPS REIMBURSED SERVICES -  CHARGES, CT Scan (D_5_HOS_C2_57)",Durable Medical Equipment Sold (D3_HOS_C2_97),Electroencephalography (D3_IRF_C3_70),"HHA III, LUPA Episodes:  Other Charges (S4_HHA3_C3_34)","COST REIMBURSED SERVICES SUBJECT TO DEDUCTIBLES  AND COINSURANCE - CHARGES, CT Scan (D_5_HOS_C3_57)",Other Ancillary (D3_IPF_C3_76),Durable Medical Equipment Rented (D3_IRF_C2_96),Durable Medical Equipment Rented (D3_IRF_C3_96),Other Outpatient Services (D3_HOS_C2_93),ASC (Non Distinct Part) (D3_IRF_C3_75),"Fully Depreciated Assets, Total (A7_1_C4_7)","HHA II, Without Outliers:  Total Charges (S4_HHA2_C1_35)",Telephone Services (A8_C2_7),NOT IN THIS FILE (TRNSMTL_NUM),Swing Bed NF Provider Number (S2_1_C2_8),"Net Expense for Cost Allocation, Coronary Care Unit (B_1_C0_32)","PAID HOURS RELATED TO SALARIES, Pharmacy (S3_2_C5_40)","COST SERVICES SUBJECT TO DEDUCTIBLES AND COINSURANCE - COST, Emergency (D_5_HOS_C6_91)",Cardiac Catheterization (D_4_HOS_C3_59),"ADJUSTED SALARIES, Total Salaries (S3_2_C4_1)","Blood Storing, Processing, Trans (D_4_IPF_C13_63)",SNF (S3_1_C6_19),CMHC 1 Provider Number (S2_1_C2_17),"Allocation of Interns & Residents Program Costs, Electroencephalography (B_1_C22_70)",FFY,Hospital Type (From CMS Hospitals Data Archive),Name and Num
4558,NORTH SHORE UNIVERSITY HOSPITAL (330106),General Short Term (Acute Care Hospitals),Voluntary Nonprofit-Other,-73.703029,40.779269,,04/04/2008,,,,,,,,,,8321918.0,,46789.0,,,36388142.0,267113593.0,,,485630.0,,,58436412.0,,,,,,12705193.0,,,,,60.0,35980399.0,452392553.0,,2896575.0,22636758.0,,-199701.0,-10146424.0,,,N,319264.0,848482.0,,,,,,95.0,,5032535.0,325.1,,,,,,35285715.0,1159751.0,14389765.0,,,,,17785281.0,,,777.0,1078169.0,,,10298790.0,,,7361155.0,,,,,,1375189.0,7500000.0,25746940.0,9201530.0,,,,,,,,,,,,221322786.0,,,457941.0,23.53,,2133806.0,420323.0,,,2691.0,,5748097.0,,,2.0,,,10922576.0,,,,5078.0,920410.0,,42510726.0,919897.0,14646902.0,443259.0,7731219.0,,,,,,,,,,46789.0,,,,,,,72804265.0,,,466671.0,,,,56213055.0,,,,,-2334051.0,,14689514.0,,,1056665.0,3431146.0,298843783.0,,6017303.0,,6913.0,,16565042.0,,,2650029.0,6084535.0,,,50039.0,,,,,N,,994405.0,,2384118.0,,,,1635607.0,37762013.0,,,104690749.0,1732933.0,88159340.0,25038.0,,,,173855.0,,,19073964.0,5941763.0,,,16929.0,8109694.0,1082804569.0,,,212029.0,,,,,,,,50039.0,108046.0,,,18615.0,18458297.0,,42776116.0,,,100752.0,13953981.0,,51558026.0,,,,259845.0,222610311.0,,,1617492.0,,,13878.0,,439289.0,,,,,,2891554.0,,,,,46153515.0,16580302.0,,,,,2969439.0,,,-39778217.0,,,,,,,,,,,,,,,,,,,2577321.0,,267053244.0,,,43.13,592844.0,29.54,,,,57181526.0,,,,,-30114.0,,,18942839.0,5857912.0,,,,,12946170.0,,,,,,1629359.0,553536831.0,,,10357.0,68330.0,,22847315.0,7268862.0,,15715083.0,,35634830.0,,,,13796284.0,,,,,3597032.0,,1692420.0,,,,,,,20063536.0,2032195.0,,429829687.0,,,,,,,,,,,,,,,,,N,2271185.0,16645328.0,,267113593.0,,90914806.0,,,,328.34,10905815.0,6558637.0,,,,,,,7292268.0,13977717.0,554705.0,165898946.0,21511435.0,,,,,-4033228.0,,2742271.0,,62.41,,13011538.0,,3227456.0,,35798336.0,205214743.0,,740614670.0,,,587783.0,428.0,3521.0,,7.0,-380710.0,General Short Term,,,17857989.0,,,171144706.0,86962259.0,67296087.0,530790402.0,,,26423354.0,98282590.0,1045937.0,,,11291676.0,,,,,,21951214.0,205736001.0,907528.0,,25.95,47566199.0,,7233101.0,7075.0,51558026.0,,10030,,,,,5792626.0,,2253436.0,2767839.0,,,16322136.0,,,,7217227.0,,,5466236.0,185448480.0,28282592.0,,,,,,13207.0,655545899.0,,,,,8967732.0,,24897441.0,7373995.0,,,,11875682.0,28.41,,,,,2127440.0,,2117.0,,,3355116.0,6065866.0,,9768630.0,,,,,N,-260876.0,63977879.0,,,11976974.0,32185.0,,,,32804886.0,807557.0,-34.0,,,,,3792915.0,,285267.0,,,501984245.0,,121150750.0,2276228.0,,154786.0,,,,,14928819.0,,,,,,18856068.0,,,,39.52,,,,,,,,,,,1307422.0,,,,,14116258.0,23.78,,,,,10245.0,2084578.0,,,,,2140765.0,4875.0,8282217.0,40271.0,,70055.0,218.28,,,,,,,1253170.0,,,260128.0,37033541.0,16078953.0,,,,129943.0,,7433831.0,,2646743.0,,,,699912.0,,78506.0,,35877070.0,22447.0,,36.0,,185448480.0,110439.0,352109.0,2267.0,61583.0,,,,3944.0,,210.0,,,,,,,,548442.0,48630897.0,1542109.0,20292.0,,618050.0,,,,1291366580.0,,12053738.0,,,,150536678.0,,1.0,Y,,12514.0,1732933.0,205214743.0,,,4570.0,2045229.0,,8367099.0,,18068673.0,,,,,6065866.0,,561358643.0,2523572.0,,,7752.0,,4875.0,,16171942.0,,655545899.0,0.765,11789637.0,7932389.0,,,16790.0,,,,,30842820.0,,5679.0,-272169719.0,,,4038.0,,532471.0,,,2300802.0,838779.0,463206.0,7149584.0,6796334.0,,,13687.0,34907210.0,3773238.0,,,3161938.0,137055.0,52.99,,,159701540.0,425649.0,,1167750.0,380421.0,,,,1297643.0,35634830.0,,,,,,,7622799.0,,,,137642726.0,86789.0,610780.0,,,,3543731.0,1692420.0,,192.0,,63977879.0,3746134.0,470902.0,,,,,159701540.0,,,,,,,,,4943951.0,11120.0,,,,49699556.0,-5746854.0,848482.0,,,68044.0,,,,,,32300361.0,,,,,,,16826.0,7562163.0,2153284.0,,5226989.0,,30516448.0,,1082804569.0,,12010924.0,1436140.0,35784649.0,2165649.0,2192490.0,,1061919.0,,,7269809.0,,,,,,,,4312679.0,1412445.0,,41374.0,,,,,,33S106,,,,,,4397983.0,,,145044020.0,,24079576.0,,Y,,,,-51226.0,,,,,,,,,,,,8648170.0,,250382.0,,7030.0,47108902.0,,,,,,,,,1188743633.0,,,,,,1.0,20455108.0,,,7.0,,,,,,1418.0,,,,16885882.0,533354,11976974.0,,1993726.0,,1629359.0,33.5,85484.0,5522433.0,,2363189.0,,,16885882.0,,18485.0,,,,2639102.0,,13011538.0,95190.0,,,,13878.0,32158.0,3956390.0,,16305574.0,12321999.0,,,,,,,104.0,,,2210740.0,5326722.0,73640609.0,,,105015396.0,,1073165.0,15579.0,,48552917.0,9627244.0,,2657381.0,83635.0,,935043779.0,,2370.0,,1061919.0,,,,,,,,,75431.0,,,,Y,,,,-1959963.0,617.0,,109356.0,,,-2806478.0,13011538.0,,,,,,,,,,,6064526.0,80950.0,,,,,,,,,24034164.0,,,,,12885997.0,,,N,,,13201,,,,,13639904.0,1560254.0,,,,4158997.0,,,,447.0,,920410.0,,,,,1702826.0,,2121736.0,110108.0,,873186.0,,,,,,,,,4806517.0,,,,5215038.0,,,43612717.0,4273469901.0,,,,-502236.0,,,109674110.0,,,,,2479271.0,,,1317738.0,20587708.0,,,,22847315.0,,,,,,12053738.0,23736.0,6491441.0,,21150.0,6759299.0,231838.0,14350331.0,,,,,,,,402692.0,335702,819.0,,,,,,,,26805950.0,,,,10032742.0,,13403.0,,199.2,,72906598.0,6082243.0,1629359.0,419.0,17369138.0,,,,10905815.0,59560605.0,625955.0,25483.0,36259314.0,11789637.0,,,,,,,,1876060.0,,321841.0,21319.0,330106,8567601.0,,,,,3848626.0,,,,,,,,,14350331.0,,4631276.0,15866072.0,,,,104690749.0,,,,,,39.67,,,,,,,,69551.0,6017303.0,,,,,X,2374809.0,,,,3746134.0,,,,,,Y,24194.0,23094.0,,1321793.0,95190.0,,22579727.0,,,,,,,,,,12053738.0,,,,,,,,,693501.0,,-35182.0,,,,2441222.0,,2704.0,,27908206.0,,,,33.3,N,8233946.0,,144224.0,,3721842.0,,,35.37,,789115.0,,,,N,,,,,,,,6017303.0,35104886.0,,9208.0,,3597032.0,,,,319264.0,,,-263163603.0,,,,47217092.0,,,,,,28070405.0,26533730.0,,,,,,,11788643.0,22636758.0,,,,,84.0,,,5522433.0,,,,,5380,,,,,,1660769666.0,,4457707.0,,35707028.0,5475.0,,,13173.0,,4180437.0,,,,,,3944.0,,2520899.0,,,,522077.0,,,,43759612.0,,,3883811.0,,,,,779835.0,,,929753.0,,,,,,,165120974.0,44367840.0,12010924.0,6855229.0,1165904.0,2691.0,2396876.0,,,100678585.0,3002876.0,,45279.0,,757561.0,,942751.0,-1340337.0,,8172783.0,,,29842.0,471941.0,40127910.0,,,,,,16305574.0,,,,1629359.0,,231838.0,,,Y,,,,,633930786.0,87634.0,23.57,,,,-51226.0,,,13895219.0,,,,363054.0,,28981.0,,,,70270817.0,21152510.0,,,,,48552917.0,289658.0,,,2011-12-31,,748436482.0,146858.0,,,2751747.0,,11748974.0,,,,,,4805258.0,,,120.0,,283850743.0,,,,,,,,,,,253966556.0,,,6913.0,,,10298790.0,10905815.0,,8167019.0,13304723.0,144828.0,,,19249921.0,,14600.0,,,,,,,1020261.0,15889.0,5333133.0,,,69155087.0,,3521.0,,1692420.0,-326300453.0,,15579.0,,,14116258.0,,,,9053313.0,8032857.0,11135.0,928478.0,,,3771885.0,,,26035.0,508111.0,,,,NORTH SHORE UNIVERSITY HOSPITAL,,2.0,404570.0,115516768.0,,,,-500347.0,,,,,,,2681262.0,363388.0,,,,,,2657381.0,200260628.0,,,P,,,,,,,,,,-1959503.0,46.15,27.57,4865765.0,,37762013.0,54677203.0,,17805079.0,39164.0,,,N,,96552917.0,20.1,,,-5156912.0,4.3,,,,,,,13446517.0,,,3531067.0,,,5039.0,8098449.0,,,48779.0,,,,,,-1731521.0,4.3,,,,5668000.0,,2084578.0,314.0,,,-6966226.0,-4033228.0,873884.0,MANHASSET,,,,46.0,122407565.0,,,,25882104.0,35004,,,852880.0,107075704.0,,15462162.0,,,,10705717.0,,1458681.0,379245423.0,,,,663512.0,,10245.0,,,,358866.0,,9381911.0,23834865.0,,,-445757910.0,,,,1655197.0,,443259.0,,,,,,,,,,,8109694.0,64523098.0,1027965.0,,,21960058.0,,3488470.0,,3711.0,2394426.0,8233946.0,73576.0,-60324.0,,,,,3.0,,,245285.0,368621.0,4631276.0,8172783.0,,388092.0,358866.0,,-1177154.0,38.89,,,,,,,,9664415.0,19501527.0,,633844456.0,,10875767.0,,,,,,,,,70879973.0,,,,337148,1235111.0,,8109694.0,,,68056104.0,,,2374809.0,,,,,,334.0,,,1732787.0,,,137545919.0,225344.0,,1145144.0,,,,,69712.0,,5096393.0,,,813853.0,,225427.0,755051.0,,2454049.0,,,404253377.0,80925.0,,68.65,,,4107596.0,,,,438287278.0,,,530790402.0,3087646641.0,,,,,,,,,,,,1324490497.0,,,498854.0,21406094.0,13304723.0,,,,36259314.0,,,38398132.0,,,,,,101362777.0,,793945.0,,,,33400,,,,27682.0,850312279.0,,4412137138.0,,,,892762.0,F,,,35.0,,3170140.0,32309866.0,,1043732.0,547131.0,,,,,,,,,,,,,,72572143.0,,7220776.0,,168020962.0,,,,,,,,,,,,-12590154.0,,,,,,154786.0,6759299.0,43612717.0,,475932.0,304111.0,,,,553129.0,,859218796.0,1151.0,,,,88568766.0,543096840.0,,,168.0,,,14646902.0,1757333.0,,,,47569720.0,64804673.0,14928819.0,,109445.0,,,,47796.0,,,22933645.0,,12850795.0,,,,,,,-1069004.0,,60993698.0,,,,,,225427.0,16322136.0,,,,,970987.0,N,,,24517585.0,3548576.0,,,,,,,196169.0,410718.0,,,,280242.0,,,,,,,,,,,2657381.0,287.0,,,3924898.0,,,24664417.0,,,15.0,,,,119282407.0,7361155.0,,,39177776.0,143254050.0,,,,,,,,,,,,,,3905695.0,,,,10458795.0,3521.0,10705717.0,,123969150.0,184.0,2014-04-25 00:00:00,,,,7681125.0,109766462.0,617.0,,,,219101.0,,,,,2340794.0,209198.0,,,,,,,,,,,,,,,,,,8456506.0,,,4135273.0,,6558637.0,,,,,,,,,39.65,,24034164.0,103329.0,,15671819.0,,,,,,,,68.65,,803789.0,,,14456245.0,1787.0,,2983980.0,,3357251.0,4488136.0,11945395.0,,1612626.0,64342384.0,,,8290183.0,91926611.0,5388553.0,,,,,,267113593.0,8902.8,,942571.0,4457707.0,,,,1130173170.0,54.0,,,19249921.0,,1535218949.0,35285715.0,,131660348.0,3023537191.0,,,47108902.0,211782.0,,,,,,,,,22319285.0,2346583.0,205736001.0,13182809.0,19.0,,,,,,13208504.0,38398132.0,,,,,51.0,49127226.0,,2466262.0,51798.0,1773.0,,26615219.0,,,,5290971.0,,,16826.0,,,,,,,21414145.0,,24367.0,,,,13208504.0,17900554.0,,,,53.0,,26114745.0,,18781154.0,,3002876.0,,2913428.0,,40252083.0,122358538.0,,,15889.0,,,,681279.0,76291.0,7269809.0,249.0,2391925.0,,,,,50927436.0,,,,,34532450.0,,,42613.0,,,9208.0,,Y,,,,,,42995681.0,363388.0,74517.0,8875969.0,15889.0,,,-4162314.0,,,,13423669.0,,,55269185.0,25746940.0,,,,,801550870.0,51.8,,80729612.0,40.0,,,,-337422.0,847962.0,,,,,,,405429.0,2679828.0,90914806.0,3.0,25882104.0,,,,58319545.0,11019154.0,,234465029.0,42074975.0,,,10436292.0,,4725688.0,3282290.0,,11068270.0,,,,,,,10722202.0,26636246.0,30733342.0,13182809.0,,,83520970.0,,51937030.0,20587708.0,312.9,,2646743.0,11372393.0,,11120.0,22872.0,,,,14904791.0,539790394.0,,24517585.0,,,162748.0,14495641.0,,,,5096393.0,,101407704.0,,,,,,61709.0,11109370.0,,,,,14495641.0,32765740.0,274815.0,,21414145.0,11665.0,,,,,,NY,,30394.0,164713385.0,15889.0,16120219.0,165358.0,,,1424512.0,,801550870.0,,,,15889.0,,13173.0,36029944.0,8096.1,,15206.0,,NASSAU,68056104.0,,,634.0,477496.0,,91559.0,872245.0,,184527.0,,,8167019.0,,,34460.0,300 COMMUNITY DRIVE,,,,,,,,,575706.0,42078496.0,,,26636246.0,,,,119282407.0,,,,,,,44.1,,,2175913.0,,33,6699.0,9951.0,283917.0,20165157.0,3137957.0,,,99849.0,,,,,,380421.0,,,,,,,22319285.0,,,823318.0,,,,,,Y,,3492447.0,8648170.0,,,35634830.0,20457.0,,6941241.0,1214341.0,,,2121736.0,,,44647060.0,2873360.0,,,,1335156.0,55269185.0,482205.0,,1082804569.0,,1215011756.0,,,3543092.0,,,,,,15873176.0,,,,16120219.0,,,,,,,,,,598796.0,2374809.0,2891554.0,2117.0,23736.0,97680.0,292762.0,18421408.0,,-28536600.0,,,,1418.0,,,6054209.0,,7974888.0,27908206.0,,60993698.0,,,,,1388599947.0,566359.0,,137055.0,,,,16760946.0,,,,,11976974.0,,56213055.0,,,,,,,,,5147043.0,,,,,-163567334.0,,11068270.0,,,,,,,,7752.0,,-445757910.0,,,,,,150596.0,,,,,,,,848482.0,,-357196.0,,15715083.0,,-120340.0,,,,,,108947697.0,,,,,,3084726268.0,140.0,1415908.0,,,,25419737.0,,5793023.0,15986176.0,,479170669.0,,30199.0,3431146.0,22872.0,,355865.0,32038933.0,1072.0,,88159340.0,,221007.0,,,873884.0,,,,,,5970913.0,22.71,,,,2491859.0,95190.0,76291.0,103017016.0,304000.0,16171942.0,219.68,6558637.0,5780182.0,,,,,,,,267113593.0,121150750.0,,,,14389765.0,,86123443.0,,,,,7220776.0,,,,2011-01-01 00:00:00,,,,101282312.0,,68290856.0,105928719.0,,158029849.0,,,,,8648170.0,99487.0,569456.0,,,,,,112672.0,,,,9412833.0,,,2493.0,,,39.66,7028814.0,NSUH PSYCHIATRIC EXEMPT UNIT,4039.0,,,,86123443.0,,,1599040.0,75388.0,12053738.0,2611588.0,342358.0,,,8140230.0,324642.0,,,,,333550,,,,,-99722.0,,86789.0,,,,,,,,,,14904791.0,,,,,38907996.0,7562163.0,,,,58588902.0,,,,,,,16929.0,,15523733.0,42810.0,35980818.0,,2384118.0,,101282312.0,,,,,90885.0,,,,24897441.0,,,,,80307625.0,,,1420678.0,679047.0,2010.0,,,,,,5,,2053131.0,5246195.0,,,,,,,8158621.0,2267.0,,,,,,70879973.0,,,,,116308.0,42510726.0,,,,,,,231838.0,,144016.0,,737320.0,,,,,,,0.253378,648455.0,,7217327.0,,,,18458297.0,,,,,,,,,,,,,C,,8296557.0,183658.0,,,801550870.0,,40555.0,,112645.0,2011,Acute Care Hospitals,NORTH SHORE UNIVERSITY HOSPITAL (330106)
9862,NORTH SHORE UNIVERSITY HOSPITAL (330106),General Short Term (Acute Care Hospitals),Voluntary Nonprofit-Other,-73.703029,40.779269,,04/04/2008,,,,,,,,,305345.0,7097461.0,,122731.0,,,,257889268.0,,,778165.0,,,34575263.0,,,,,,11003263.0,,,,,60.0,36973713.0,651932000.0,,2998809.0,27594731.0,,-210756.0,-9572942.0,,,N,272405.0,1081011.0,,,266.0,,,106.0,,5164035.0,330.9,,,,,,36143181.0,827582.0,10929562.0,,,,,20340628.0,,,781.0,1103957.0,,3015424.0,12534767.0,,,9202769.0,,,,,,1244871.0,7500000.0,7588999.0,9339000.0,,,,,,,,,,,,259261315.0,,,482522.0,24.83,,1911180.0,425050.0,,,2303.0,,6021392.0,,117.0,2.0,,,11675259.0,,,,,1563235.0,,47083028.0,2081711.0,32558685.0,208912.0,3191096.0,,,,,,,,,,122731.0,,,,,,,66626168.0,,,494309.0,,,,20539975.0,,,,,-2403833.0,,12186120.0,,,922802.0,2436866.0,278915942.0,,6465767.0,,5851.0,,18524211.0,,,13969142.0,7615872.0,,,47887.0,,,,,N,,918570.0,,2721012.0,,,,1681008.0,30198576.0,,,94654971.0,1882741.0,81928933.0,13266.0,,,,4034650.0,,,35294463.0,3968900.0,24687.0,,15345.0,8087120.0,1138466652.0,,,240587.0,,,,,,,,47887.0,141804.0,,,18666.0,35382422.0,,42640085.0,,409571.0,97372.0,12159323.0,,60431671.0,,,,248999.0,219462016.0,,,1511015.0,,,11116.0,,1054036.0,,,,,,3258933.0,,,,490.0,47931123.0,16682708.0,,,,,2133379.0,,,-25542997.0,,,,,,,,,,,,34537743.0,,,,,,,2855560.0,,285450960.0,,,41.19,540047.0,25.37,,,,71963672.0,,,,,-33256.0,,,16571549.0,6089574.0,,,,,11303280.0,,,,,,1417931.0,535593702.0,2083.0,,9778.0,97976.0,,23672522.0,7498773.0,,16289686.0,409571.0,38683593.0,,,,13669526.0,,,,,5678848.0,,1375867.0,,,,,,,15238268.0,2146338.0,,557045220.0,,,1489250.0,,,,,,,,,,,,,,N,2640704.0,13706456.0,,257889268.0,,90842013.0,,,,333.5,10878401.0,8853993.0,,56472.0,,,,,8391567.0,12183518.0,556546.0,161576331.0,20827715.0,,,,,-2499004.0,,3065677.0,,53.21,,13812208.0,,9405362.0,,36866632.0,255165452.0,,724481233.0,,,587768.0,450.71,198.0,,7.0,-402818.0,General Short Term,,,19664307.0,,,256379179.0,63154394.0,68260458.0,719748573.0,,,29640669.0,81878813.0,653151.0,,,9007045.0,,,,-1774.0,,33271429.0,326065322.0,106600.0,,25.59,54681396.0,,7334445.0,4857.0,60431671.0,,10030,,,,,5078078.0,,2414344.0,2685747.0,,,8501267.0,,,,4187559.0,,,3999894.0,187469600.0,23604861.0,,,,,,5463.0,728667218.0,,,,,7462000.0,,33354645.0,7421448.0,,,,5228615.0,29.36,,,,142269.0,2593569.0,,1970.0,,,3276610.0,6281200.0,,10339657.0,,,,,N,-260919.0,61786515.0,,,13039170.0,16477.0,,833526.0,,30819756.0,789653.0,,,,,,3520235.0,,285666.0,,,528475110.0,,112529263.0,2978336.0,,147092.0,,,,,20298748.0,,,,,,26621562.0,,,,38.24,,,,,,,,,,,1490096.0,,,,,11601915.0,24.33,,213802.0,,,8592.0,3070122.0,,,,247285.0,2069438.0,4267.0,7734371.0,40777.0,,81092.0,215.72,,,,,,10.0,1384618.0,,,309598.0,36679574.0,17328861.0,,,,151996.0,,7745523.0,,2840938.0,,,,1913903.0,,83560.0,,36949916.0,17327.0,,36.0,,187469600.0,108029.0,360649.0,1689.0,73829.0,,,,3879.0,,218.0,,,,,,,821118.0,160234.0,104870564.0,1708356.0,34520.0,,599566.0,,1185180.0,,1374903844.0,,12397661.0,,,,164934683.0,,1.0,Y,,22156.0,1882741.0,255165452.0,,,33313.0,2179427.0,,8287186.0,,59357030.0,,1341774.0,,,6281200.0,,544142349.0,2510345.0,,,138510.0,,4267.0,,16199046.0,,728667218.0,,12546248.0,8459247.0,,,16836.0,,,,,34050289.0,,4951.0,-321067360.0,,,3723.0,,611537.0,,,3347960.0,888797.0,650016.0,8359255.0,6470758.0,,,29313.0,36743901.0,4166479.0,,,5460265.0,994114.0,59.46,,757.0,179880601.0,451031.0,,1109998.0,373125.0,,,,1461693.0,38683593.0,,,,,,,8043997.0,,,,121423840.0,1143682.0,694052.0,,,,3850535.0,1375867.0,,192.0,,61786515.0,4620723.0,360085.0,,,,,179880601.0,,,,,,,,,5570871.0,10174.0,,1631220.0,,53612420.0,-5244445.0,1081011.0,,,1027797.0,313526.0,-27462.0,,,,29941195.0,,,858213.0,,,,15560.0,10476424.0,2162298.0,,7323411.0,,30083917.0,,1138466652.0,,19766631.0,1480770.0,36837319.0,2365876.0,2946990.0,,1214997.0,,,29223765.0,,,3015424.0,,,,,4069812.0,1472899.0,,57585.0,,,,,,33S106,,,,,,4849112.0,,,177137910.0,858213.0,21351547.0,,Y,,,,-2470286.0,,,,,,,,,,,,9646527.0,,238781.0,,160332.0,38968997.0,,,,,,,,,1531101447.0,,,,189474.0,,1.0,28503180.0,,,7.0,,,,,971429.0,14394.0,,,,25167515.0,545904,13039170.0,55583667.0,2065104.0,,1417931.0,35.0,80098.0,5811388.0,,2394664.0,,,25167515.0,,5574.0,,,,3311872.0,,13812208.0,87496.0,,,,11116.0,18546.0,4047328.0,,14531086.0,24504580.0,,,,,,,178.0,,,12915106.0,7773814.0,32734193.0,,,116362000.0,947.0,1531068.0,15408.0,,46463254.0,9293443.0,,3153624.0,166857.0,,1125668573.0,,1799.0,,1214997.0,,,218970.0,,,,,,74140.0,,,,Y,,,,-1188016.0,621.0,,99917.0,,,-2696989.0,13812208.0,,,,,,201806.0,,,,,16457289.0,61176.0,,,,204.0,,,,,24538651.0,4986.0,,,,3504604.0,,,N,,,13001,,,,,10676788.0,1657403.0,,,,3943442.0,,,,215.0,,1563235.0,,,14526.0,,2097670.0,,1991368.0,113750.0,,962862.0,,312394.0,,52.0,,,,,4787473.0,,,,4064322.0,,,41479731.0,4872218748.0,,,,,,,100630025.0,,,,,2429534.0,,,1467011.0,26937767.0,,,,23672522.0,,,,,,12397661.0,24195.0,5130527.0,,19764.0,6202872.0,224230.0,12764280.0,,,,,,,,640440.0,335702,5888.0,,673775.0,,,,,,4323011.0,,,,8227517.0,,15603.0,,67.28,,15230055.0,6857839.0,1417931.0,-1191.0,18139965.0,,,,10878401.0,59944851.0,504094.0,30795.0,38973075.0,12546248.0,,,,,,,,2554865.0,,296585.0,29129.0,330106,8569642.0,,,,,4170426.0,,,,,,,,326920.0,12764280.0,,5206276.0,12599705.0,,,,94654971.0,,,,,,44.05,,,,,326920.0,,,90008.0,6465767.0,,,,,X,2517882.0,,-91216.0,,4620723.0,,,,,,Y,55703.0,23390.0,,1304087.0,87496.0,,23862112.0,,,,,,,,,,12397661.0,,,,326920.0,,,8344171.0,,777157.0,,-95916.0,,,,2467407.0,,1769.0,,33493612.0,,,,35.1,N,8977610.0,,142269.0,,4006757.0,,,36.74,,693690.0,,66626168.0,,N,,,,,,,490.0,6465767.0,35087828.0,,8429.0,,5911888.0,,,,272405.0,,,-261812924.0,,,,51233692.0,,,,,,27421185.0,25497528.0,,,,396280.0,,,12793355.0,27594731.0,,,,,202.0,,,5811388.0,,,,,5380,,,,,,1730131126.0,,9166018.0,,39993604.0,5490.0,,,13830.0,,4697869.0,,,,,,3879.0,,2371344.0,,,,4213.0,,,,47278649.0,,,4424630.0,,,,,699495.0,,,884120.0,,,,,,,178387635.0,49103889.0,19766631.0,6854420.0,953767.0,2303.0,2294106.0,131721001.0,,113847107.0,3281623.0,,,,601361.0,,1731677.0,-1173799.0,,9075381.0,,,318060.0,488935.0,31994973.0,,,,,,14531086.0,,,,1417931.0,,224230.0,,1258780.0,Y,,,,,617899408.0,,22.15,,,,-2438837.0,,,12426413.0,,,,397969.0,,41817.0,,,,62200319.0,46243379.0,17343436.0,,,,46463254.0,65908.0,,,2012-12-31,,733029880.0,340250.0,,,2570408.0,,12471934.0,,,4304.0,,,4713644.0,,,,,261336857.0,,10.0,,,,,,,,,242023120.0,,,5851.0,,,12534767.0,10878401.0,,9147798.0,31275120.0,181247.0,,,20573201.0,,14640.0,,,,,,,983714.0,1297.0,5518501.0,,,89613869.0,9893891.0,198.0,,1375867.0,-341209885.0,,15408.0,,,11601915.0,,-61441179.0,,9706267.0,10083889.0,10433.0,946552.0,,,3433314.0,,,26909.0,588804.0,,,,NORTH SHORE UNIVERSITY HOSPITAL,,2.0,283690.0,158751032.0,233040.0,,,-1500176.0,,,,,,,2429883.0,382716.0,,,,,,3153624.0,185865987.0,,,P,7384.0,,,,,,209081250.0,,,-1188016.0,47.63,28.25,4798651.0,,30198576.0,75952325.0,,14534038.0,32430.0,,,N,,102692366.0,42.3,,,-7351979.0,4.3,,,,,,,12803456.0,,,,,,28778.0,8842122.0,,,146699.0,,,,,,-2527144.0,4.3,,,,5508000.0,,3070122.0,314.0,,,-6552116.0,-2499004.0,235372.0,MANHASSET,,,,46.0,133303902.0,,,,31961417.0,35004,,,873280.0,148639330.0,,14751790.0,,,,17401721.0,,4145769.0,469706690.0,9043.0,,,703078.0,,8592.0,,,,91871.0,,3701629.0,22916063.0,,,-453627887.0,,1313297.0,,1986354.0,,208912.0,,,,,,,24687.0,,,,8087120.0,103792964.0,1086549.0,,,14058228.0,,3908545.0,,3764.0,2335072.0,8977610.0,203086.0,,,,1693362.0,,3.0,,,68375.0,413592.0,5621276.0,9075381.0,,371438.0,91871.0,,-1309829.0,32.19,,,,,,,,12737598.0,17474021.0,,617666368.0,,9275994.0,,,,,,14526.0,,,91656893.0,,,,337148,1368899.0,,8087120.0,,,59789357.0,,382.0,2517882.0,,,,,,353.0,,,1749194.0,971429.0,,148884957.0,53063.0,,813562.0,,,,,123168.0,,5146751.0,,,486010.0,,227106.0,437669.0,,2444238.0,,,405920000.0,84408.0,,58.6,,,4267076.0,,,,542022789.0,,,510667323.0,3341117301.0,,,,,,,,,,,,1531101447.0,,,461356.0,16666480.0,31275120.0,,,,38973075.0,,,40552204.0,,,,,,88425735.0,,906201.0,,,,33400,89828.0,,,19554.0,1046655000.0,,4872218748.0,,,85201.0,1416675.0,F,,,,,3493118.0,32958087.0,,1179367.0,560217.0,,,,,,,,,,,,1393.0,,73757059.0,,9177186.0,,186696618.0,,,8344171.0,,,,,,,,,-17424220.0,,,,,11907863.0,147092.0,6202872.0,41479731.0,,709498.0,276016.0,,,,752251.0,,866119374.0,1168.0,,,,90078479.0,656292017.0,,,,,,32558685.0,1744849.0,,,,54681594.0,72866366.0,20298748.0,,122847.0,,,,28353.0,,,23905562.0,,13857852.0,,,,,,,-1170237.0,,62545754.0,,,,,,227106.0,8501267.0,,,,,864416.0,N,,,23891283.0,3851972.0,,,,,,,135203.0,456095.0,,,,193147.0,,,,,,,,,,,3153624.0,249.0,,,2427155.0,,,22233569.0,,,15.0,,,,207667365.0,9202769.0,,1489250.0,57748346.0,72615000.0,,,,,,,,,,,,,,10128135.0,,,,59782774.0,198.0,17401721.0,,98231000.0,,2014-12-15 00:00:00,,8094348.0,,8411527.0,116490858.0,621.0,,,181549.0,614939.0,,,,,2247070.0,181247.0,,,,,,,,,,,,,,,,,,,,,3816030.0,,8853993.0,,,,,,,,,43.18,,24538651.0,23797.0,,16970994.0,,,,,,,,58.6,,779927.0,,,15468704.0,8068.0,,3102463.0,,3669745.0,4898084.0,10393226.0,,1783926.0,112188442.0,,,8074165.0,67850389.0,5678288.0,,,,,,257889268.0,9235.5,,450365.0,9166018.0,,,,1187120984.0,54.0,,360091.0,20573201.0,,1859356001.0,36143181.0,11578.0,139695430.0,3463154982.0,,,38968997.0,220241.0,,,,,,,,,33779181.0,11277345.0,194344321.0,21395299.0,19.0,,,,,,15684575.0,40552204.0,4455.0,,,,51.0,52739719.0,,2812313.0,71251.0,1012.0,,17043000.0,,,,6023688.0,,,15560.0,,,,,,,23183113.0,,33198.0,,,223698.0,15684575.0,19647065.0,6813.0,,,81.0,,23824670.0,,20008945.0,,3281623.0,,3075763.0,,41064503.0,139319459.0,,,1297.0,,,,664410.0,,29223765.0,249.0,2354735.0,,2646202.0,,,54059507.0,,,,,44692587.0,,,4655.0,,,8429.0,,Y,,,,,,34452824.0,382716.0,61278.0,9428615.0,1297.0,,,-3271384.0,,448.0,,14219849.0,50.0,,56262673.0,7588999.0,,201806.0,,,864011752.0,57.78,,121983093.0,40.0,,,,-605332.0,1123484.0,,11907863.0,,,404599.0,,429221.0,3170951.0,90842013.0,3.0,32357697.0,,,,88367507.0,19088563.0,,224549099.0,43134850.0,,,5944825.0,,6071880.0,4336373.0,,11943573.0,,,,,,,9296450.0,52758869.0,31178302.0,21395299.0,,,58943000.0,,50896080.0,26937767.0,286.83,,2840938.0,14746149.0,,10174.0,20393.0,,,,16733524.0,571269856.0,,23891283.0,,,145922.0,19497370.0,,,,5146751.0,,143131330.0,,,,,,411979.0,11352863.0,,,,,19497370.0,37408656.0,263840.0,,23183113.0,10662.0,,,,,,NY,,30394.0,180689512.0,1297.0,17250525.0,182094.0,,,955101.0,,864011752.0,531293.0,,,1297.0,,13830.0,38602976.0,8432.93,,23074.0,,NASSAU,59789357.0,,118008.0,6142.0,460326.0,,237338.0,1290781.0,,,,,9147798.0,,,36376.0,300 COMMUNITY DRIVE,,,,,,,,,600804.0,43135048.0,,,52758869.0,,,90.0,207667365.0,,,,,,,48.51,,,2300710.0,,33,2073.0,13482.0,273309.0,340186.0,3064717.0,-425853.0,,103505.0,,,,,,373125.0,,,,,,,33779181.0,,,148657.0,,,,,,Y,,3365501.0,9646527.0,,,38683593.0,42486.0,,9525272.0,1459247.0,102.0,,1991368.0,11907862.0,,21051021.0,2925746.0,,,,1550871.0,56262673.0,468433.0,,1138466652.0,,1276503239.0,,,4416539.0,,,,,,19244589.0,,,,17250525.0,,,,,,,,78991391.0,,3086494.0,2517882.0,3258933.0,1970.0,24195.0,114409.0,380263.0,19153412.0,,-28896450.0,,,,14394.0,,,3649925.0,,7719769.0,33493612.0,,62545754.0,,,,8094348.0,1409063766.0,435253.0,,994114.0,,,,20424437.0,,,,,13039170.0,,20539975.0,,,,,,,,,14375578.0,,,,,-173385919.0,,11943573.0,,,,,,,,138510.0,,-453627887.0,,,,,,177884.0,,,,,,,,1081011.0,,-43450.0,,16289686.0,,-203896.0,,,,,,99984581.0,,,,,,3341117301.0,1755.0,1116186.0,164224.0,,,43850439.0,,7266098.0,14305661.0,,486635679.0,,425259.0,2436866.0,20393.0,,914835.0,35457710.0,1076.0,,81928933.0,,250098.0,,,235372.0,,,,,,8235840.0,22.45,,,,3312467.0,87496.0,,95529789.0,163112.0,16199046.0,265.53,8853993.0,6121257.0,,,,,,,,257889268.0,112529263.0,,,,10929562.0,,88562759.0,,,,,9177186.0,,,,2012-01-01 00:00:00,,,,114239834.0,,124303032.0,106281337.0,,152143037.0,,,,,9646527.0,139997.0,270241.0,,,,,,145922.0,1258780.0,,,39105015.0,,,2808.0,,,48.62,19663309.0,NSUH PSYCHIATRIC EXEMPT UNIT,3567.0,,,,88562759.0,,,1881618.0,3947.0,12397661.0,2614680.0,295795.0,,,9515051.0,350767.0,,,,,333550,,,,,-70158.0,,1143682.0,,,,,,,,,,16733524.0,,,,,38287393.0,10476424.0,,,,65494378.0,,,,,,,15345.0,,16301315.0,16684.0,36972522.0,,2721012.0,,114239834.0,,,,,91134.0,,,,33354645.0,,,,,82072666.0,,,1781508.0,755193.0,1277.0,,,,,,5,,2666391.0,6150652.0,,,,,,,8871853.0,1689.0,160.0,,,,,91656893.0,,,,,214142.0,47083028.0,,,990000.0,,,,224230.0,,207571.0,,735745.0,,,,,393109.0,,0.233665,650604.0,,7118408.0,,,,35382422.0,,,,,,,,,,11907863.0,,,C,,3459563.0,182282.0,76.0,,864011752.0,,42908.0,,,2012,Acute Care Hospitals,NORTH SHORE UNIVERSITY HOSPITAL (330106)
17079,NORTH SHORE UNIVERSITY HOSPITAL (330106),General Short Term (Acute Care Hospitals),Voluntary Nonprofit-Other,-73.703029,40.779269,,04/04/2008,,,,,34791.0,,,621652.0,297962.0,7768737.0,,44105.0,,,,256154872.0,,,854392.0,,,41796849.0,,,,,,10743235.0,,,,,60.0,41169037.0,704639000.0,,2842320.0,29719001.0,,-212051.0,-11266735.0,,,N,321501.0,1287077.0,,,258.0,,,561.0,,5918421.0,331.43,,,,,,36767855.0,997522.0,14566005.0,,,,,22461765.0,,,729.0,1046348.0,,3534717.0,9973917.0,,,11487279.0,,,,,,1114656.0,7500000.0,6873419.0,8585227.0,,,,,,,,,,,,227983050.0,,,643975.0,18.18,,2403309.0,389744.0,,,2317.0,,5113693.0,,6.0,2.0,,,11866443.0,,,,,2714954.0,,52621934.0,2421717.0,36391958.0,1716560.0,3257013.0,,,,,,,,,,44105.0,,,,,,,72224312.0,,,468514.0,,,,25035536.0,,,,,-2215814.0,,10852251.0,,,904831.0,2202658.0,280951422.0,,6521737.0,,5165.0,,20485709.0,,,2090604.0,7551487.0,,,47283.0,,,,,N,,936474.0,,2875898.0,,,,1800197.0,29996172.0,,,150472018.0,2023035.0,90039089.0,12160.0,,,,42759.0,,,36752246.0,7364680.0,27594.0,,15590.0,8218445.0,1159441822.0,,,694906.0,,,,,,,,47283.0,191400.0,,,18615.0,48957919.0,,44883624.0,,1091521.0,81110.0,15622649.37,,67700234.0,,,,232104.0,246802286.0,,,1802791.0,,,10034.0,,399890.0,319900.0,,,,,3246536.0,,,,643.0,39037325.0,15763640.0,,,,,2626975.0,,,-9656031.0,,,,,,,,,,,,18896076.0,,,,,,,3412233.0,,351097129.0,,,47.56,490384.0,29.0,,,,103934381.0,,,,,-38874.0,,,15004611.0,5596250.0,,,,,13136788.0,,,,,,1256830.0,635871606.0,5866.0,22.0,23195.0,80849.0,,23544940.0,8113526.0,,16616788.0,1091521.0,37647833.0,,,,12384786.0,,,,,5810038.0,,1378031.0,,,,,,,14596063.0,2053659.0,,643305248.0,,,2391200.0,,,,,,,,,,,,,,N,2690466.0,17783005.0,,256154872.0,,80587548.0,,,,332.9,10461551.0,9943430.0,,135450.0,,,-1188033.0,,8316552.0,15641277.37,559053.0,205972929.0,19189856.0,,319900.0,,,-2419238.0,,2989325.0,,66.11,,13794411.0,,8266342.0,,40698488.0,306641167.0,,838511452.0,,,593063.0,459.3,118.0,,7.0,-1543070.0,General Short Term,,,19996714.0,,,261325000.0,71372796.0,73129705.0,631895867.0,,,34324882.0,76254503.0,428626.0,,,8779331.0,,,,,,39011671.0,345635973.0,68624.0,,27.52,58430740.0,,6748837.0,5521.0,67700234.0,,10030,,,,,5580425.0,,2213189.0,2545593.0,,,8782738.0,,,,4198411.37,,,3952780.0,201321312.0,21984929.0,,,,,,7815.0,844186315.0,,,,,5783683.0,,41453448.0,7154573.0,,,,5610814.0,30.43,,,,139534.0,3252147.0,,1941.0,,,3015773.0,6425317.0,,10974406.0,,,,,N,-179034.0,66720173.0,,,12765770.0,15617.0,,813607.0,,33644029.0,975681.0,,,,4219369.0,,4097118.0,,270052.0,,,507789512.0,,110949351.0,2824331.0,,141441.0,,,,,19856786.0,748.0,,,,,19473719.0,,,,42.33,,,,,,,,,,,1763539.0,,,,,12968646.0,24.04,,175754.0,,,7763.0,2965718.0,,,,345030.0,1909179.0,4931.0,8335824.0,39895.0,,85008.0,234.1,,,,,,4.0,1670925.0,,,368351.0,37770371.0,18499998.0,,,,124317.0,,8019598.0,,3041872.0,,,,2191330.0,,87119.0,,39887439.0,23436.0,,34.0,,201321312.0,100989.0,377507.0,1794.0,55418.0,,,,3798.0,,200.0,,,,,,,791754.0,536004.0,7136635.0,2252117.0,60430.37,,539382.0,,775747.0,,1336706837.0,,12354375.0,,,,187400650.0,,1.0,Y,,23602.0,2023035.0,306641167.0,,,27071.0,2212938.0,,8514824.0,,77592452.0,,799360.0,,,6425317.0,,641864402.0,2836883.0,,,242009.0,,4931.0,,16900025.0,,850569384.0,,11842013.0,9057032.0,,,16790.0,,,,,32951489.0,,6305.0,-361276409.0,,,3260.0,,616554.0,,,2714223.0,814745.0,595858.0,10708072.0,6375392.0,,,20149.0,34823426.0,4268520.0,,,5147800.0,1507773.0,53.61,,207.0,194447893.0,413453.0,,792368.0,356810.0,,,,1733197.0,37647833.0,,,,,,,8812445.0,,,,128290942.0,40633.0,570601.0,,,,3646966.0,1378031.0,,196.0,,66720173.0,3291373.0,400667.0,,,,,194447893.0,,,,,,,,,6470312.0,9531.0,,1546097.0,,55500221.0,-5158835.0,1287077.0,,,1777667.0,174777.0,-102588.0,,,,28315214.0,,,841201.0,,,,14894.0,11292418.0,1982142.0,,8465873.0,,21860043.0,,1159441822.0,,24765017.0,1660535.0,40678339.0,2218974.0,2264003.0,,2582409.0,,,40139770.0,,,3534717.0,,,,,3873050.0,1620891.0,,44188.0,,,,,,33S106,,,,,,4974979.0,,,190511254.0,841201.0,22989983.0,,Y,,,,-307932.0,,,,,,,,,,,,9589696.0,,218887.0,,181439.0,38546138.0,,,,,,,,,1757896992.0,,,,223395.0,,1.0,20871131.0,,,7.0,,61704.0,,,1539530.0,1112732.0,,,,24098373.0,572883,12690768.0,61927791.0,1507188.0,,1256830.0,31.66,120572.0,6155473.0,,2367204.0,,,24098373.0,,10350.0,,,,3139045.0,,13622124.0,80316.0,,,,10034.0,,4419591.0,,13520862.0,1560397.0,,,,,,,,,,1690714.0,,29372406.0,,,110555000.0,13198.0,2054225.0,14916.0,,42504249.0,9632673.0,,3229536.0,332103.0,,1065111867.0,,1901.0,,2582409.0,,,220967.0,,,,,,65578.0,,,,Y,,,,,576.0,,92787.0,,,-3211803.0,13622124.0,,,,,,83230.0,,,,,18242393.0,67597.0,,,,22.0,,,,,30294665.0,10743.0,,,,5219560.0,,,N,,,10001,,,,344.0,11973607.0,1537542.0,,,,3849444.0,,,,699.0,,2714954.0,,,14927.0,,2046455.0,,1819416.0,129410.0,,1060245.0,,304409.0,,5.0,,,,,4601537.0,,,,5481654.0,,,38660179.0,5302829137.0,,,,,,,97424914.0,,,,,2635621.0,,,1301046.0,26055754.0,,,,23544940.0,,,,,,12354375.0,18284.0,5060714.0,,19493.0,6568022.0,211171.0,14565467.0,,,,,,,,,335702,4917.0,,610499.0,,,,,,4487815.0,,,,8145242.0,,15408.0,,210.74,,14756679.0,6410000.0,1318534.0,-623.0,19245818.0,,,,10461551.0,61676279.0,462094.0,37375.0,39987132.0,11842013.0,,,,,,,,2620993.0,,281109.0,73861.0,330106,8862420.0,,,,,4269532.0,,-1188033.0,,,,,,319336.0,14565467.0,,6196276.0,19922259.0,,,,150700891.0,,13114.0,,,,40.7,,,,,319336.0,,,110825.0,6876879.0,,,,,X,2399207.0,,-343592.0,,3291373.0,,,,,,Y,17438.0,21491.0,,1277289.0,80316.0,,23241155.0,,,,,,,,,,12354375.0,,,29886.0,319336.0,,,8233775.0,,1000728.0,,-65532.0,,,,2273990.0,,623.0,,35747504.0,,,,34.44,N,9307616.0,,139534.0,,4502805.0,,,35.9,,630611.0,,72224312.0,,N,,,,,,,621.0,6521737.0,33259953.0,,8360.0,,5810038.0,,,,321501.0,,,-266750906.0,,,,52030680.0,,,,,,26451759.0,24259327.0,,,,17655433.0,,,15537509.0,29719001.0,,,,,110.0,,,6155473.0,,,,,5380,,,,,,1784140171.0,,13626711.0,,54974348.0,5475.0,,,14322.0,,5116580.0,,,,,,3798.0,,3027387.0,,,,658.0,,,,53488908.0,,,4009894.0,,,,,915022.0,,,840374.0,,,,,-102022.0,,119067697.0,116244149.0,24765017.0,6512346.0,826512.0,2317.0,1168833.0,,,197880342.0,3060611.0,,,,680410.0,,1882744.0,-1158134.0,,9370629.0,,,140740.0,516117.0,26070758.0,,,,,,13520862.0,,,,1318534.0,,211171.0,,1408478.0,Y,,,,,717162805.0,,24.09,,,,-307932.0,,,12222856.0,,6.0,,364811.0,,54315.0,,,,85894675.0,1525606.0,26248207.0,1388.0,,,42504249.0,62469.0,,,2013-12-31,,844504248.0,182287.0,,,2451891.0,,11990572.0,,,100845.0,179.37,,4522173.0,,,,,254799866.0,,4.0,,,,,,,,,239932318.0,,,5165.0,,,9973917.0,10727407.0,,9433562.0,35012257.0,171788.0,,,21201939.0,,14600.0,,265217.0,,,,,972528.0,1466.0,5070877.0,,,97459751.0,14724242.0,118.0,,1403712.0,-389898107.0,,14916.0,,,12968646.0,,-64676000.0,,9955576.0,10253334.0,9802.0,993169.0,,,4084150.0,,,31070.0,529868.0,,,,NORTH SHORE UNIVERSITY HOSPITAL,,2.0,312068.0,185882999.0,,,,-1494588.0,,,,,,,2262652.0,355960.0,,,,,,3218129.0,198179297.0,,,P,6871.0,,,,,,,,,-1188033.0,48.57,26.73,3599426.0,,29996172.0,79424774.0,,18780527.0,42122.0,,,N,,100773031.0,45.38,,,-12590188.0,4.3,,,,,,,10974864.0,,,,,,36108.0,9103722.0,,,255502.0,,,,,,-2295850.0,4.5,,,,7373000.0,,2965718.0,313.0,,,-4808012.0,-2419238.0,334403.0,MANHASSET,,,,46.0,154275173.0,,,,24122497.0,35004,,,843326.0,138974852.0,,22051475.0,,,,23113436.0,,4063849.0,500251261.0,8444.0,,,656660.0,,7763.0,,,,126899.0,,4148553.0,22249179.0,,,-491292140.0,,1203877.0,,2016320.0,,1716560.0,,,,,,,27594.0,,,,7860722.0,129761687.0,1223486.0,,,11653541.0,,4181365.0,,4155.0,2297486.0,9307616.0,207498.0,,,,1834063.0,,3.0,,,247983.0,321823.0,5621276.0,9370629.0,,340491.0,126899.0,,-1179496.0,39.95,,,,,,,,13141492.0,17118627.0,,722795722.0,,7914262.0,,,,,,14927.0,,,96178008.0,,,,337148,1356733.0,,7860722.0,,,66423015.0,,270.0,2430251.0,,,,,,320.0,,,1532817.0,1539530.0,747.0,172025135.0,48642.0,,652557.0,,,,,114123.0,,4741316.0,,,510644.0,,211869.0,864903.0,,2419308.0,,,433216000.0,82317.0,,68.74,,,3963068.0,1985.0,,,640470216.0,,,631895867.0,3544932145.0,,,,,,,,,,,,1753677623.0,,,437280.0,18835321.0,35012257.0,,,,39987132.0,,,68682256.0,,,,,,102770377.0,,1228977.0,,,,33400,226370.0,,,18669.0,1042756000.0,,5298609768.0,,,29587.0,1593355.0,F,,,59.0,,3310833.0,36517123.0,,1327886.0,530983.0,,,,,,,,,,,,1315.0,,75298403.0,,10846314.0,,210023549.0,,,8233775.0,,,,,,,,,-18987706.0,,,,,7237931.0,141441.0,6568022.0,38660179.0,,1073395.0,215822.0,,,,723263.0,,855296840.0,1109.0,,,,93642823.0,801401522.0,,,,,351890.0,36391958.0,1814602.0,,,,58430858.0,76355315.0,19856786.0,,103708.0,,,,23215.0,,,23802377.0,,14151634.0,,,,,,,-1150975.0,,60662342.0,,,,,,211869.0,8782738.0,,,,,871867.0,N,,,21543011.0,9039606.0,,,,,617303.0,,490075.0,469589.0,,,,753961.0,,,,,,,,,,,3218129.0,256.0,,,2548858.0,,,24997106.0,,,15.0,,,,166575586.0,11487279.0,,2391200.0,66645046.0,122676000.0,,,,,,,,,,,,,,9650849.0,,,,9561594.0,118.0,23113436.0,,107849000.0,,2016-03-24 00:00:00,,9331754.0,,8485843.0,149602309.0,576.0,,,379459.0,611043.0,,,,,2242388.0,171788.0,,,,,,,,,,,,,,,,,,,,,4440110.0,,9943430.0,,,,,,,,,40.89,,30294665.0,138597.0,,20331723.0,,,,11907863.0,,,,70.78,,699503.0,,,15401391.0,2580.0,,3049306.0,,3647093.0,4372379.0,9245948.0,,1319428.0,118117448.0,,61704.0,7770955.0,65697182.0,5626285.0,,,,,,256154872.0,9837.6,,436357.0,13626711.0,,,,1209926194.0,47.0,,839756.0,21201939.0,,1952791479.0,36767855.0,8219.0,151573099.0,3875746006.0,,,38546138.0,225954.0,,,,,,,,,41306915.0,13383434.0,345635973.0,25189480.0,11.0,,,,,,15188719.0,68682256.0,1224.0,,,,51.0,55474897.0,,2578000.0,106743.0,3041.0,,207312000.0,,,,6314212.0,,,14894.0,,,,,,,23952916.0,,35587.0,,,,15188719.0,19633044.0,4446.0,,,68.0,,23307667.0,,18390882.0,,3060611.0,,4991546.0,,39973129.0,143370707.0,,,1466.0,,,,2340875.0,,40139770.0,249.0,2422717.0,,4107816.0,,,69014884.0,,,,,49113782.0,,,,,,8360.0,,Y,,,,,,41075222.0,355960.0,61010.0,10483370.0,1466.0,,,-3397237.0,,250.0,,14204093.0,2.0,,56948056.0,6873419.0,,83230.0,,,928843331.0,58.73,,95456269.0,40.0,,,,-1393319.0,1141192.0,,19145794.0,,,389143.0,,516507.0,3252972.0,80587548.0,3.0,41777930.0,,,,106552410.0,54224387.0,,222813691.0,47065209.0,,,4963390.0,,5988854.0,4643260.0,,10614456.0,,,,,,,8864477.0,44216026.0,29820756.0,25189480.0,,,18792000.0,,48710658.0,26055754.0,237.9,,3041872.0,16537752.0,,9531.0,43028.0,,,,16876084.0,654273659.0,,21543011.0,,,133764.0,21682124.0,,,,4741316.0,,131601852.0,,,,,,13609.0,11532977.0,,,,,21682124.0,41180784.0,175941.0,,23952916.0,11875.0,,,,,,NY,,-224805.0,126138402.0,1466.0,18015622.0,206238.0,,,527954.0,,928843331.0,521865.0,1864.0,,1466.0,,14322.0,35471819.0,9079.4,,29423.0,,NASSAU,66423015.0,,227400.0,514808.0,450017.0,,224529.0,1632039.0,,,,,9433562.0,,,30422.0,300 COMMUNITY DRIVE,,,,1388.0,,,,,782585.0,47330544.0,,,44774868.0,,,2160.0,166575586.0,521349.0,,,,,,48.11,,,2378183.0,,33,3895.0,16483.0,259577.0,1007313.0,2920403.0,-1642571.0,,101093.0,,,,,-1188033.0,356810.0,,,,,,,41306915.0,,,223907.0,,,,,,Y,,3145429.0,10055950.0,,,37647833.0,40782.0,,9127680.0,1413085.0,2808.0,,1819416.0,11907863.0,,22370138.0,3215728.0,,,,1659502.0,56948056.0,495278.0,,1159441822.0,,1292848031.0,,,3382613.0,,,,,,21529402.0,,,,18015622.0,,,,,,,,75137010.0,,790413.0,2399207.0,3246536.0,1941.0,18628.0,150267.0,346743.0,19380851.0,,-28689514.0,,,,1112732.0,,,3552926.0,,7872760.0,35747504.0,,60662342.0,,,,9331754.0,1422863762.0,440883.0,,1507773.0,,,,22237671.0,,,,,12690768.0,,25035536.0,,,,,,,,,15773241.0,,,,,-206108619.0,,10614456.0,,,,,,,,242009.0,,-491292140.0,,,,,,186074.0,,,,,,,,1287077.0,,-561222.0,,16616788.0,,-206872.0,,,,,,98968183.0,,,,,,3544932145.0,1504.0,1081054.0,158351.0,,,42167852.0,,7894668.0,17676308.37,,564399506.0,,532885.0,2202658.0,43028.0,,907109.0,35174531.0,1024.0,,90039089.0,,205201.0,,,334403.0,,,,,,9418915.0,23.01,,,,3658035.0,80316.0,,91696734.0,163246.0,16900025.0,225.49,9943430.0,6800855.0,,,,,,,,256154872.0,110949351.0,,,,14566005.0,,91282113.0,,,,,10846314.0,1901.0,,,2013-01-01 00:00:00,,,,110553859.0,,167221978.0,121953322.0,,161604805.0,,,,,9589696.0,137707.0,327211.0,,,,,,133764.0,1408478.0,,,23505146.0,,,9080.0,,,48.21,25850788.0,NSUH PSYCHIATRIC EXEMPT UNIT,3320.0,,,,91282113.0,,,1397412.0,1012.0,12354375.0,2653821.0,342992.0,,,9457744.0,386823.0,,,,,333550,,,,,-105935.0,,40633.0,,,,,,,,6368.0,,16876084.0,,,,,35580945.0,11292418.0,,,,61470652.0,,,,,,,15590.0,,15543906.0,12558.0,41168414.0,,2875898.0,,110553859.0,,,,,90885.0,,,,41453448.0,,,,,86924116.0,,,2022267.0,808325.0,1230.0,,,,,,5,,2444236.0,6389243.0,,,,,,,8935860.0,1794.0,95.0,,,,,96178008.0,,,,,,52621934.0,,,,,,,211171.0,,387796.0,,712871.0,,,,,472412.0,,0.218646,662981.0,,7178089.0,,,,48957919.0,,,,,,,,,,7237931.0,,,G,,3593982.0,189214.0,42.0,,934733685.0,,43723.0,,,2013,Acute Care Hospitals,NORTH SHORE UNIVERSITY HOSPITAL (330106)
26139,NORTH SHORE UNIVERSITY HOSPITAL (330106),General Short Term (Acute Care Hospitals),Voluntary Nonprofit-Other,-73.703029,40.779269,,04/04/2008,,,,,489598.0,,,1034840.0,170276.0,7342052.0,,10223.0,,,,253952942.0,,,671083.0,,,59549253.0,,,,,,12689127.0,2700.0,,,,60.0,51742006.0,793094000.0,,3736566.0,,,-10102.0,-8166219.0,,,N,331179.0,1397452.0,,,311.0,756634.0,,229.0,,5699000.0,327.82,,,,,,36447089.0,1018519.0,26306879.0,,,1151.0,,24697016.0,,,768.0,1383149.0,,4746630.0,702803.0,,,10619167.0,,,29.0,,,1459601.0,21200000.0,7464190.0,9207296.0,,,,,,,,,,,,236533038.0,,,703591.0,24.63,,2772676.0,408207.0,,,3661.0,,5160947.0,,4.0,2.0,,,6984630.0,,,,,2962391.0,,60245192.0,2345550.0,34933200.0,2173869.0,3581342.0,,,,,,,,,,10223.0,,,,274598.0,,,78748733.0,,,619320.0,,,,2337049.0,,,,,-2977096.0,,11309799.0,,,560068.0,1542970.0,287595095.0,,5051798.0,,10115.0,,23461555.0,,-107427.0,20174230.0,5425068.0,,,46931.0,10032.0,,,,N,,1041753.0,,2978664.0,,,,1867961.0,32887880.0,,,56516132.0,2203487.0,99909148.0,12293.0,,,-599.0,105274.0,,-165.0,42844238.0,3193840.0,212593.0,,15918.0,9045722.0,1175554792.0,,,118272.0,,,,,,,,46931.0,226347.0,,,18615.0,58670611.0,,45701011.0,,1413865.0,60467.0,13901083.0,,71887490.0,,,,251732.0,277666873.0,,,2576029.0,,,10693.0,,2066677.0,105700.0,,,,,3545228.0,,,,595.0,410355.0,16117905.0,,,,,3192981.0,,,-21328130.0,,,,,,,,,,13284.0,,27156030.0,,,,,,,4239573.0,,386678113.0,,,42.77,887687.0,24.5,,,,112228522.0,,,,,,,,11604044.0,5563930.0,,,,,18260714.0,,,,,,868713.0,635390601.0,8972.0,24.0,24341.0,102561.0,,23716128.0,6498897.0,,17868385.0,1413865.0,38845383.0,,,,13458994.0,,,,,5964315.0,,1387839.0,,,,,,,17639511.0,2326469.0,,555521340.0,,42606.0,2224250.0,,,,,,,,,,,,,,N,2826753.0,12382862.0,,253952942.0,,80862881.0,,,,327.82,10383048.0,10413158.0,,153672.0,,,,,9400829.0,13913996.0,428597.0,198821041.0,21655040.0,,105700.0,,,-2614214.0,,3120912.0,,52.45,,14405196.0,,10066656.0,,51081140.0,386102354.0,,831578212.0,,,819723.0,457.65,20280.0,,,-1681930.0,General Short Term,,,20479972.0,,,299692000.0,72260015.0,77545542.0,713200000.0,,1113.0,36310974.0,82911015.0,484130.0,,,492000.0,,838543.0,,,,41068266.0,393560000.0,33271.0,,25.44,71148464.0,,7023531.0,112.0,71887490.0,,10030,,,,,7012523.0,5037488.0,2224994.0,3344331.0,,,9253276.0,,,,4761879.0,,,2051446.0,195318898.0,17454630.0,,,,,,5438.0,812466516.0,,,,,7051241.0,,47394386.0,7676564.0,,,,340302.0,28.12,,29.0,,147597.0,1479727.0,,1673.0,,,3024026.0,2392044.0,,12287189.0,,,,,N,-379252.0,76773794.0,,,12653284.0,20644.0,,506335.0,,29840905.0,919681.0,-94168.0,,,,,3764239.0,,269679.0,,2700.0,573469989.0,,115170835.0,3942067.0,,142735.0,,,,,20723709.0,466.0,,,,,30490415.0,,,,39.52,,,,,,,,,,,2146963.0,,,,,14643056.0,25.19,,267585.0,,,8462.0,3457650.0,,,,547664.0,1917674.0,4228.0,7673126.0,42851.0,,107115.0,233.23,,,,,,,1676217.0,,,333047.0,25043419.0,20596206.0,,,,172464.0,,4933184.0,,3214478.0,,,,2256297.0,,143720.0,,49367776.0,27622.0,,34.0,,195318898.0,110146.0,504744.0,1417.0,57228.0,,,,3785.0,,183.0,,,,,,,485081.0,1011468.0,7190257.0,1887288.0,59620.0,,529121.0,,4701354.0,,1464500456.0,,13686900.0,,,,199964509.0,,1.0,Y,,22828.0,2203487.0,386102354.0,,,19557.0,50030.0,,9091971.0,,44319879.0,,271827.0,13789.0,,2392044.0,,649069847.0,3939060.0,,,178004.0,,4228.0,,17642786.0,,781143370.0,,11442736.0,10396888.0,492.0,,16790.0,,,,,37477801.0,,3333.0,-433858908.0,,,3589.0,,625326.0,,,4849590.0,823617.0,,11393927.0,7401590.0,,,31341.0,43961711.0,5546896.0,,,6813890.0,1909278.0,59.77,,10363.0,187854708.0,417955.0,,1119976.0,360713.0,,,,1543014.0,38845383.0,55891.0,,,,,,9923309.0,,,,121484786.0,137724.0,452514.0,,,,3890075.0,1387839.0,,242.0,,76773794.0,2798408.0,404866.0,,,,,187854708.0,,,,,718928.0,,,,4232730.0,9863.0,,2023113.0,,58645116.0,-7249533.0,1397452.0,,,1110675.0,55782.0,-119617.0,,,,30936680.0,,,718928.0,,,,14445.0,11693550.0,1991431.0,,7650627.0,,31822433.0,,1175554792.0,,30588231.0,1747594.0,51049799.0,3400687.0,1240386.0,,4194917.0,,,21769945.0,,,4746630.0,,,,,5078427.0,1728193.0,,17503.0,,,,,,33S106,,,,,,5704862.0,,,211262939.0,718928.0,20439491.0,,Y,,,,-456248.0,,,,,,5037488.0,,,,,,9510428.0,,221270.0,,77646.0,62078780.0,,2653955.0,,,,,,,1922458127.0,,,,200498.0,,1.0,33575611.0,,,7.0,,,,,3761117.0,1824.0,,,,29465502.0,685252,12653284.0,,1632000.0,,868713.0,30.74,110138.0,6944541.0,,3337575.0,,,29465502.0,,5468.0,,,,4128803.0,,14405196.0,84370.0,,,,11185.0,6964.0,10861632.0,,20394338.0,1475534.0,,,,,,,259.0,,,18107553.0,,32301659.0,,,122299000.0,,1875817.0,15080.0,,47420186.0,9140774.0,,3414765.0,408057.0,,1074677000.0,,2492.0,,4194917.0,,,239914.0,,,,,,40858.0,,,,Y,,,,-981634.0,615.0,,95471.0,,,-2327941.0,14405196.0,,,,,,55255.0,,,,,18045134.0,67951.0,,,,7.0,,,,,34762119.0,15228.0,,,,5893068.0,,,N,,,13001,,,,,12413705.0,1812950.0,,,,4440565.0,,,,657.0,,2962391.0,,,91897.0,,2042211.0,,1302463.0,149048.0,,990883.0,,179058.0,,1.0,,13673433.0,,,5520217.0,,,,9234372.0,,,44066803.0,5728458821.0,,,,,,,101912210.0,,,,,3128823.0,39813.0,,2182266.0,20489050.0,,,,23716128.0,,,,,,13686900.0,12913.0,5519737.0,,17155.0,8411573.0,210239.0,24955649.0,,162.0,,,,,,,335702,,,752977.0,,,,,,4122879.0,,,,9233616.0,,16319.0,,75.3,,15165360.0,6375306.0,868713.0,-1057.0,20124825.0,,,,10383048.0,64216606.0,467126.0,38537.0,43193272.0,11442736.0,,,,,,,,2803027.0,,371593.0,135245.0,330106,9655145.0,,,,,5555268.0,,,,,,,,270955.0,24955649.0,,6196276.0,15677809.0,,,,127928604.0,,1360.0,,,,45.71,,,,,270955.0,,,134566.0,5051798.0,,,5.0,,X,2495063.0,,-262790.0,,2798408.0,,,,,,Y,3389.0,27843.0,,1564651.0,84370.0,,22780205.0,,,,,,,,,,13686900.0,,,9528.0,270955.0,,,8330197.0,,,,-114042.0,,,,2274166.0,,1005.0,,39418020.0,,,,36.26,N,9845427.0,,147597.0,,4875868.0,,,36.71,,819905.0,,78748733.0,,N,,,,,,,571.0,5051798.0,46073181.0,,6023.0,,5964315.0,,,,331179.0,,,-379785877.0,,,,50294454.0,,,,,,28907140.0,19189459.0,,,,3663074.0,,,17279411.0,,,,,,191.0,,,6944541.0,,,,,5380,,,,,,1929249913.0,,12531387.0,,46521468.0,5475.0,,,14084.0,,7987131.0,,,,,,3785.0,,2830243.0,,,,,,,,60332651.0,,,4677650.0,,,,,1093134.0,,,827734.0,,,,,-102023.0,,139842983.0,90812507.0,30588231.0,9104009.0,845665.0,3661.0,1083461.0,205789000.0,,210209807.0,4679025.0,,,1620.0,906222.0,,2350255.0,-843611.0,,12079585.0,,,237026.0,513519.0,23837629.0,,,,-16343733.0,,20394338.0,,,,868713.0,,210149.0,,1359811.0,Y,,,,,727691649.0,,22.16,,,,-456248.0,,,14455034.0,,7.0,,368784.0,,,,,,65304737.0,985936.0,11002696.0,713.0,,,47420186.0,82576.0,,,2014-12-31,,845257458.0,62538.0,,,3220465.0,,10212745.0,,,,,,5462989.0,,,,,261894581.0,,67580.0,,,,,,,,,241265801.0,,,10115.0,,,702803.0,10383048.0,,11487426.0,63084973.0,227084.0,,,18863917.0,,14600.0,,257626.0,,,,419582.0,1181155.0,317204.0,5421119.0,,,119734891.0,13917973.0,20280.0,,1387839.0,-486382599.0,,15080.0,,,14643056.0,,-58074000.0,,21179780.0,11739059.0,8995.0,946613.0,,,3837417.0,,,29590.0,570995.0,,,,NORTH SHORE UNIVERSITY HOSPITAL,67580.0,2.0,698902.0,242118785.0,,,,-1179397.0,,,,,,,2530332.0,285844.0,,,,,,3414765.0,221487949.0,,,P,7491.0,,,,,,168252000.0,,,-981634.0,50.17,28.05,884948.0,,32887880.0,87448492.0,,13401381.0,36963.0,,,N,,118726350.0,44.37,,,,,,,,,,,11549508.0,,,,,,44834.0,9698876.0,,,280373.0,,,,,,-2303128.0,4.5,,,,4815000.0,,3457650.0,313.0,,,-6039210.0,-2614214.0,215376.0,MANHASSET,,,,46.0,162427709.0,19403.0,,,34294695.0,35004,,,1094133.0,89676731.0,,22364055.0,,,,42501328.0,,7782477.0,523535639.0,9179.0,,,651518.0,,8462.0,,,,83152.0,,3464168.0,23893348.0,,,-608112614.0,,1204693.0,,1431621.0,,2173869.0,,,,,,,212593.0,,,,9045722.0,180443172.0,1352614.0,,,12116488.0,,5113688.0,,3677.0,1999264.0,9845427.0,37375.0,,-165.0,,3712712.0,,3.0,,,589104.0,165733.0,5621000.0,12079585.0,,344198.0,48091.0,,-1355593.0,33.29,,,,,,,,12950947.0,20090717.0,,727341339.0,,11703888.0,,,,,,91897.0,,,119742052.0,,,,337148,1647629.0,,9045722.0,,,72435545.0,,,2495063.0,,,,,,290.0,,,1398494.0,3761117.0,,183275524.0,49171.0,,454369.0,,,,,44967.0,,4873568.0,,,474227.0,,213834.0,974542.0,,2879030.0,,,361477000.0,81629.0,,67.27,,,3893557.0,,,,693084237.0,,,544948000.0,3806000694.0,,,,,,,,,,,,1922458127.0,,,578033.0,17002357.0,63084973.0,,,,43193272.0,,,68554293.0,,,,15658.0,,104839397.0,,1085131.0,,,,33400,62400.0,,,13756.0,1156055000.0,,5728458821.0,,,18334.0,1773632.0,F,,,69.0,,4355887.0,45967452.0,,1366388.0,701897.0,,,,,,,,20280.0,,,,1377.0,,78621802.0,,10768235.0,,218955769.0,,,8330197.0,,,,,,,,,-14790621.0,,,,,11842697.0,142735.0,8411573.0,44066803.0,,336962.0,333815.0,,,,998264.0,,919621554.0,986.0,,,,95413049.0,834478000.0,,,,,1167250.0,34933200.0,1950558.0,,,,71168744.0,77488527.0,20723709.0,,63333.0,,288896.0,,11997.0,,,24066438.0,,13837635.0,,,,,,,-2776298.0,,69032362.0,,,29327.0,,-173.0,213834.0,9253276.0,,,,108713.0,11492389.0,N,,,28030036.0,13731448.0,,,,,855228.0,,691150.0,611844.0,,,,1063307.0,,,,,,,,,,,3414765.0,228.0,,,2850783.0,,,25426687.0,,,15.0,,,,234657526.0,10619167.0,,2224250.0,72052000.0,68373000.0,,,,,,,,,,,,,,17058871.0,,,,20174230.0,,42501328.0,,110713000.0,,2021-01-11 00:00:00,,19070354.0,,10231590.0,179760266.0,615.0,,,486630.0,655051.0,,,,,2828386.0,227084.0,,,,,,,,,,,,5.0,,,,,,,,,4123261.0,,10413158.0,,,,,,,,,44.82,,34762119.0,129135.0,,23058105.0,,,,19145794.0,,,,67.27,,689457.0,,,15781934.0,13993.0,,3772465.0,,4338474.0,4551609.0,20446356.0,,1850897.0,119722478.0,,,8697600.0,67145000.0,,,,,90.0,,253952942.0,10310.92,,347000.0,12531387.0,,,,1222690137.0,47.0,,971455.0,18863917.0,,2000840000.0,36447089.0,19894.0,157022582.0,4233067816.0,,,62078780.0,179663.0,,,,,,,,,48261404.0,15709166.0,187771000.0,40261852.0,14.0,,,,,,16115370.0,68554293.0,61744.0,,,,51.0,54121941.0,,2593778.0,24932.0,3841.0,,107265000.0,,,,4870572.0,,,14445.0,,,,,,,15969485.0,,28997.0,,,,16115370.0,19633000.0,8600.0,,,50.0,,27073485.0,,20760478.0,,4679025.0,,9027098.0,,27639634.0,161942927.0,,,317255.0,,,,2184949.0,,21769945.0,249.0,2694266.0,,4832170.0,,,82170971.0,,,,,57615012.0,,,,,,6023.0,,Y,,,,,,63133124.0,285844.0,59615.0,11599526.0,317255.0,,,-2393132.0,,,,14914217.0,1.0,,49225626.0,7464190.0,,55255.0,,,1009628358.0,57.25,,85478967.0,40.0,,,,-1378636.0,460821.0,,30988491.0,,,420674.0,,803334.0,3442387.0,80862881.0,3.0,37957769.0,,,,122092089.0,20326337.0,,221175084.0,57802796.0,,,8498737.0,,5483261.0,5151981.0,,14367876.0,,,,,,,10864325.0,30865316.0,30434401.0,40261852.0,,,3020000.0,,56067765.0,20489050.0,255.9,,3214478.0,,,9863.0,37243.0,,,,19557935.0,558405000.0,,28030036.0,,,135221.0,24866932.0,,,,4873568.0,,84861731.0,,,,,,31995.0,12212883.0,,,,,24866932.0,44454027.0,116253.0,,15969485.0,5719.0,,,,,,NY,,-254582.0,144216931.0,317204.0,20469063.0,240991.0,,1620.0,241558.0,10032.0,1009628358.0,447973.0,182.0,,,,14084.0,35944108.0,9528.73,,6742.0,,NASSAU,72435545.0,,308758.0,1062.0,426427.0,,259013.0,1467807.0,,,,,11487426.0,,,18609.0,300 COMMUNITY DRIVE,,,,713.0,,,,,728546.0,58080702.0,,,30865316.0,,,104.0,234657526.0,1210255.0,,,,,,46.92,,,1839076.0,,33,1919.0,483.0,263914.0,1198745.0,3819142.0,-1461571.0,,99047.0,,,,,,360713.0,,,,,,,48261404.0,,,345340.0,,,,,,Y,,3796229.0,9510428.0,,,38845383.0,7276.0,,9758358.0,318341.0,152.0,,1302463.0,11908000.0,,25626113.0,3481927.0,,,,2091399.0,49225626.0,685024.0,,1175663505.0,,1321137298.0,,,3545228.0,,,,,,22439989.0,,,,20469063.0,,,,,,,,84142291.0,,3116195.0,2495063.0,3545228.0,1673.0,12913.0,104262.0,388142.0,21747902.0,1535791.0,-32453018.0,,,3492498.0,1824.0,,,3636054.0,2468.0,8768254.0,39418020.0,,69032362.0,,,,19070354.0,1495391005.0,367934.0,,1909278.0,,,,,,,,,12653284.0,,2337049.0,,,,,,,,,15700183.0,,,,,-213709504.0,,14367876.0,,,,,,,,178004.0,,-608112614.0,663930.0,,,,,143945.0,,,,,,,,1397452.0,,-1286233.0,,17868385.0,,-116305.0,,,,,,100004277.0,,,,,,3806000694.0,,1266728.0,97016.0,,,43922754.0,,7500693.0,16227552.0,,451225000.0,,521309.0,1542970.0,37243.0,,1170179.0,33034500.0,1063.0,,99909148.0,,120670.0,,,215376.0,,,,,,9994001.0,23.28,,2468.0,,4173542.0,84370.0,,94632786.0,59462.0,17642786.0,210.19,10413158.0,5433476.0,,,,,166354.0,,,253952942.0,115170835.0,,,,26306879.0,,104311995.0,,,,,10768235.0,2555.0,,,2014-01-01 00:00:00,,,,119006432.0,,210050240.0,129465106.0,,174817000.0,,,,,9510428.0,406001.0,345409.0,,,,,,135221.0,1359811.0,,,14614866.0,,,16532.0,,,43.21,26429154.0,NSUH PSYCHIATRIC EXEMPT UNIT,4184.0,,,,104311995.0,,,3085196.0,8372.0,13686900.0,417964.0,359022.0,,,9861485.0,596340.0,,,,,333550,,,,,,,137724.0,,,,,,,,6627.0,,19557935.0,,,,,42395444.0,11693550.0,,,,67003162.0,,,,,,,15918.0,,18787328.0,5186.0,51740949.0,,2978664.0,,119006432.0,,,,,90885.0,,,,47394386.0,,,,,91950738.0,,,2348954.0,1037911.0,660.0,,,,,,4,,2458557.0,6408173.0,,,,,,,10658017.0,1417.0,,,,,,119742052.0,,,,,,60245192.0,,,,,,,210149.0,,289762.0,,733195.0,,-70977.0,,,508944.0,,0.205213,655636.0,,7862032.0,,,,58670611.0,,,,,,,,,,11842697.0,,,J,,3926751.0,206693.0,,,1009628358.0,,43036.0,,,2014,Acute Care Hospitals,NORTH SHORE UNIVERSITY HOSPITAL (330106)
31913,NORTH SHORE UNIVERSITY HOSPITAL (330106),General Short Term (Acute Care Hospitals),Voluntary Nonprofit-Other,-73.703029,40.779269,,04/04/2008,,,,,276011.0,,,1126716.0,283701.0,7278407.0,,47265.0,,,,280252475.0,,,592896.0,,,65459357.0,,,,,,14175058.0,2524.0,,,,40.0,56335788.0,750927000.0,,3911278.0,,,-2002.0,-7941086.0,,,N,441580.0,1442009.0,,,286.0,864384.0,,1371.0,,8058717.0,331.82,,,,,,42538719.0,2002357.0,28783375.0,,,1199.0,,28379663.0,,,766.0,1439866.0,,,606456.0,,,11692187.0,,,143.0,,,1360933.0,17010000.0,4732013.0,9167348.0,,,,,,,,,,,,299652518.0,,,1006610.0,25.48,,2722899.0,407163.0,,,4219.0,,2601897.0,,6639.0,2.0,,,7100570.0,,,,,3473181.0,,56852347.0,2643358.0,37540115.0,1710337.0,3969770.0,,,,,,,,,,47265.0,,,,244099.0,,,91440563.0,,,644716.0,,,,2378764.0,,,,,-2985814.0,,12105009.0,,,365313.0,1645402.0,301807571.0,,3096136.0,,10404.0,,25442898.0,,-130856.0,18222097.0,5949729.0,,,48909.0,17918.0,126296000.0,,,N,,1120092.0,,3383558.0,,,,1970651.0,29281670.0,,,55139293.0,2386841.0,118752122.0,12985.0,,,-1932.0,71833.0,,,45360139.0,4033107.0,323631.0,,17327.0,12281765.0,1300757735.0,,,512003.0,,,,,,,,48909.0,212374.0,,,18615.0,59575536.0,,49567968.0,,1303145.0,74494.0,12952929.0,,84207496.0,,,,288989.0,305276149.0,,,2803659.0,,,12348.0,,1646013.0,,,,,,3482295.0,,,,767.0,832613.0,18226290.0,,,,,3375571.0,,,-45120117.0,,,,,,,,,,,,19446114.0,,,,,,,4032095.0,,404492091.0,,,45.96,835948.0,25.39,,,,141167508.0,,,,,,,,13502895.0,5732814.0,,,,,117224.0,,,,,,1535845.0,631836221.0,9864.0,20.0,17262.0,98263.0,,24871254.0,5956844.0,,19019795.0,1303145.0,43255295.0,,,,16469657.0,,,,,6621080.0,,1480333.0,,,,,,,19289435.0,2373742.0,,591629655.0,,33265.0,1958950.0,,,,,,,,,,,,,,N,3351626.0,10075928.0,,280252475.0,,100724765.0,,,,331.82,10424261.0,10952306.0,,191111.0,,,,,9838989.0,12970245.0,229129.0,220362246.0,26446323.0,,,,,-2813559.0,,3270481.0,,54.03,,16165899.0,,9804045.0,,55413500.0,413655461.0,,822440226.0,,,791179.0,447.86,17633.0,,,-1806628.0,General Short Term,,,23572222.0,,,353999000.0,73711207.0,85503906.0,676329000.0,,1720.0,42743140.0,85168144.0,512202.0,,,525000.0,,,,,,47458229.0,396043000.0,17462.0,,25.6,79602835.0,,7093747.0,,84207496.0,,10030,,,,,8328414.0,,2363254.0,3502957.0,,,10465334.0,,,,4712430.0,,,2103006.0,189068160.0,12394612.0,,,,,,4662.0,838117170.0,,,,,8909607.0,,48159165.0,8338381.0,,,,320833.0,27.8,,143.0,,164169.0,1628282.0,,1772.0,,,3220258.0,2417847.0,,12232427.0,,,,,N,-574739.0,79920511.0,,,13192431.0,21490.0,,814256.0,,30671032.0,967540.0,-111513.0,,,,,4961680.0,,275898.0,,2524.0,637946865.0,,122369211.0,3480998.0,,150012.0,,,,,23473043.0,,,,,,26652012.0,,,,42.83,,,,,,,,,,,2165629.0,,,,,14856664.0,22.63,,150570.0,,,9162.0,3520267.0,,,,519186.0,2038630.0,4930.0,8138530.0,47255.0,,109943.0,243.96,,,,,,,1526638.0,,,322791.0,29582546.0,22599898.0,,,,227323.0,,4997880.0,,3504352.0,,,,2757233.0,,143617.0,,54259172.0,28131.0,,34.0,,189068160.0,118507.0,513888.0,1323.0,79209.0,,,,3910.0,,174.0,,,,,,,788237.0,1440551.0,8279701.0,1708390.0,46532.0,,599718.0,,1301736.0,,1687555113.0,,15144081.0,,,,211676699.0,,1.0,Y,,28867.0,2386841.0,413655461.0,,,28991.0,71945.0,,9507663.0,,55083627.0,,274330.0,27215.0,,2417847.0,,644997817.0,4801679.0,,,239264.0,3204.0,4930.0,,18116183.0,,838117170.0,,12083325.0,10507066.0,,,,,,,,41611321.0,,4787.0,-559534013.0,,,2332.0,,690075.0,,,5782564.0,869989.0,636261.0,12846865.0,7260710.0,,,15129.0,41081061.0,5617907.0,,,6342129.0,2064521.0,63.41,,,184336147.0,441487.0,,1255892.0,378055.0,,,,1611571.0,43255295.0,1243.0,,,,,,10236931.0,,,1281.0,184809962.0,65665.0,649975.0,,,,4755076.0,1480333.0,,207.0,,79920511.0,8248058.0,398116.0,,,,,184336147.0,,,,,1137887.0,,,,4585440.0,9316.0,,2127563.0,,63754264.0,-5853551.0,1442009.0,,,1253151.0,56645.0,-125040.0,,,,37049516.0,,,1137887.0,,,,14751.0,11894003.0,2116540.0,,8612865.0,,33060547.0,,1300757735.0,,32647841.0,1532198.0,55398371.0,4021724.0,2876972.0,,5643699.0,,,25276342.0,,,,,,,,5329652.0,1897688.0,,26993.0,,,,,,33S106,,,,,,6237135.0,,,223955019.0,1137887.0,21254334.0,,Y,,,,-32120.0,,,,,,,,,,,,9857543.0,,233728.0,,135164.0,68774923.0,,,,,,,,,2043827672.0,,,,202608.0,,1.0,30300382.0,,,7.0,,,,,3849415.0,12012.0,,,,33075110.0,685016,13192431.0,,1567000.0,,1535845.0,29.92,125855.0,8059689.0,,3430591.0,,,33075110.0,,10231.0,,,,4319597.0,,16165899.0,88710.0,,,,12348.0,,9958433.0,,21837916.0,1709626.0,,,,,,,221.0,,,16576084.0,,38023191.0,,,126913000.0,1324.0,2085203.0,14640.0,,58723254.0,8841558.0,,3533058.0,600992.0,,1042474000.0,,2274.0,,5643699.0,,,278657.0,,,,,,91666.0,,,,Y,,,,-1000734.0,613.0,,99991.0,,,-11740723.0,16165899.0,,,,,,24271.0,,,,,19166818.0,77925.0,,,,,,,,,37218783.0,21188.0,,,,6047680.0,,,N,,,13001,,,,,16227173.0,1860484.0,,,,4955046.0,,,,866.0,,3473181.0,,,131989.0,,2248102.0,,972874.0,152560.0,,1238786.0,,294219.0,,,,,,,6141681.0,,,,10359655.0,,,54752673.0,6299555504.0,,,,-112100.0,,,110049191.0,,,,,2941132.0,680.0,,2911386.0,22356651.0,,,,24871254.0,,,,,,15144081.0,17316.0,5731418.0,,17155.0,8772600.0,225910.0,23843933.0,,,,,,,,,335702,,,,,,,,,3887865.0,,,,133911.0,,16181.0,,63.41,,15909575.0,5089345.0,1535845.0,-82.0,20798139.0,,,,10424261.0,72627903.0,493427.0,39559.0,48445181.0,12083325.0,,,,,,,,3419307.0,,386830.0,109231.0,330106,13176862.0,,,,,5625144.0,,,,,,,,426208.0,23843933.0,,6196276.0,23092317.0,,,,55139293.0,,230.0,,,,48.78,,,,,426208.0,,,91145.0,3096136.0,,,,,X,1255903.0,,-268876.0,,8248058.0,,,,,,Y,9422.0,20250.0,,1758681.0,88710.0,,23392342.0,,,,,,,,,,15144081.0,,,,426208.0,,,5490353.0,,,,-99005.0,,,,2428178.0,,499.0,,45389346.0,,,,36.45,N,10447728.0,,164169.0,,4609051.0,,,37.76,,859350.0,,91440563.0,,N,,,,,,,747.0,3096136.0,47057076.0,,5739.0,,6621080.0,,,,441580.0,,,-434906472.0,,,,62516532.0,,,,,,36420770.0,35902097.0,,,,9107267.0,,,18862608.0,,,,,,207.0,,,8059689.0,,,,,5380,,,,,,2177386677.0,,10006921.0,,52630314.0,5475.0,,,13805.0,,7478634.0,,,,,,3910.0,,1607050.0,,,,,,,,66999768.0,,,5221732.0,,,,,1052233.0,,,930101.0,,,,,-102022.0,,158242802.0,21635089.0,32647841.0,9563288.0,730140.0,4219.0,3285893.0,,,254711683.0,5584472.0,,2793.0,2439.0,749344.0,,2483948.0,-1125701.0,,11880703.0,,,162956.0,513258.0,25713065.0,,,,-41667129.0,,21837916.0,,,,1535845.0,,225741.0,,1389778.0,Y,,,,,733791619.0,,22.89,,,,-32120.0,,,16228258.0,,6.0,,389547.0,,45281.0,,,,58495017.0,1433615.0,25963566.0,,,,58723254.0,85962.0,,,2015-12-31,,835601822.0,113955.0,,,3374014.0,,5523017.0,,,48528.0,,,6062472.0,,,,,276735301.0,,60001.0,,,,,,,,,257912175.0,,,10404.0,,,606456.0,10424261.0,,11953190.0,69205939.0,236396.0,,,18595052.0,,14600.0,,241939.0,,,,,1311257.0,277364.0,5778285.0,,,132645913.0,12270097.0,17633.0,,1480333.0,-522834775.0,,14640.0,,,14856664.0,,-69215000.0,,22565484.0,12405762.0,7070.0,1054434.0,,,5099740.0,,,37201.0,576279.0,,,,NORTH SHORE UNIVERSITY HOSPITAL,59971.0,2.0,684412.0,255679380.0,,,,-241377.0,,,,,,,3221377.0,323770.0,,,,,,3533058.0,255029701.0,,,P,8120.0,,,,,,,,,-1000734.0,52.01,31.5,426711.0,,29281670.0,91135192.0,,12078285.0,35116.0,,,N,,150823454.0,47.52,,,,,,,,,,,7848817.0,,,,,,51318.0,10304145.0,,,423730.0,,,,,,-2516241.0,4.0,,,,2480009.0,,3520267.0,314.0,,,-6860743.0,-2813559.0,293227.0,MANHASSET,,,,,175785049.0,7721.0,,,29528046.0,35004,,,1160489.0,39732358.0,,26578251.0,,,,53172244.0,,7690944.0,599266371.0,10171.0,,,701185.0,,9162.0,,,,112209.0,,3541089.0,28487888.0,,,-704987439.0,,1285506.0,,1870248.0,,1710337.0,,,,,,,323631.0,,,,12281765.0,199133569.0,1463171.0,,,12168366.0,,5354061.0,,4622.0,2819630.0,10447728.0,90325.0,,,,3898932.0,,3.0,,,848087.0,327966.0,5621000.0,11880703.0,,363577.0,82500.0,,-1953049.0,35.96,,,,,,,,17954511.0,21435768.0,,733506026.0,,13051011.0,,,,,,131989.0,,,132645913.0,,,,337148,1973051.0,,12281765.0,,,80868326.0,,,1255903.0,,,,,,206.0,,,2890098.0,3849415.0,938.0,191435344.0,51940.0,,3460820.0,,,,,73413.0,,6115646.0,,,499737.0,,220053.0,1140168.0,,3163142.0,,,366145000.0,82743.0,,88.7,,,4146001.0,2607.0,,,871664538.0,,,550033000.0,4255727826.0,,,,,,,,,,,,2043827672.0,,,601735.0,16689330.0,69205939.0,,,,48445181.0,,,77020716.0,,,,21988.0,,114724106.0,,1253386.0,,,,33400,60000.0,,,20535.0,1145866000.0,,6299555498.0,,,6875.0,1790022.0,F,,,69.0,,4577484.0,50059439.0,,1417372.0,730678.0,,,,,,,,17633.0,,,,1765.0,,88793802.0,,11713630.0,,272975732.0,,,5490353.0,,,,,,,,,-14787160.0,,,,,6391626.0,150012.0,8772600.0,54752673.0,,281269.0,398939.0,,,,1434569.0,,1095647421.0,1033.0,,,,94185146.0,859325000.0,,,,,1167250.0,37540115.0,1508352.0,,,,79620468.0,86301908.0,23473043.0,,79634.0,,264361.0,,71064.0,,,25156847.0,,14533053.0,,,,,,,-2955254.0,,72351575.0,,,,,,220053.0,10465334.0,,,,209653.0,12272824.0,N,,,29836200.0,17274260.0,,,,,974831.0,,937335.0,679743.0,,,,1442054.0,,,,,,,,,,,3533058.0,253.0,,,2907211.0,,,29105966.0,,,15.0,,,,295630305.0,11692187.0,,1958950.0,70066000.0,106714000.0,,,,,,,,,,,,,,19574969.0,,,,18222097.0,,53172244.0,,120011000.0,,2021-01-12 00:00:00,,19924633.0,,10360964.0,202444229.0,613.0,,,500711.0,756079.0,,,,,2869212.0,236396.0,,,,,,,,,,,,5.0,,,,,,,,,5423510.0,,10952306.0,,,12401.0,,,,,,47.86,,37218783.0,148462.0,,26001639.0,,,,30988491.0,,,,88.7,,639267.0,,,16133563.0,9775.0,,3951382.0,,4819763.0,4373199.0,46548852.0,92.0,1870106.0,126019735.0,,,9083697.0,72464000.0,,,,,169.0,,280252475.0,10638.51,,311000.0,10006921.0,,,,1368002990.0,47.0,,918784.0,18595052.0,,1999298000.0,42538719.0,22585.0,165457000.0,4681702834.0,,,68774923.0,111379.0,,,,,,,,,46043561.0,14761054.0,396043000.0,41981823.0,16.0,,,,,,17596170.0,77020716.0,,,,,51.0,54734385.0,,2765786.0,60893.0,678.0,,,,,,4980164.0,,,14751.0,,,,,,,16162992.0,,35214.0,,,,17596170.0,27433000.0,9211.0,,,244.0,,30992450.0,,22605596.0,,5584472.0,,-16687.0,,32446253.0,153319849.0,,,277521.0,,,,2470919.0,7597.0,25276342.0,249.0,2984748.0,,5113971.0,,,79035308.0,,,,,59336811.0,,,,,,5739.0,,Y,,,,,,74912674.0,323770.0,62611.0,11763569.0,277521.0,,,-11762678.0,,,,16746731.0,1766.0,,49526406.0,4732013.0,,24271.0,,,1081739256.0,61.97,,76717114.0,40.0,,,,-1379123.0,443891.0,,37380117.0,,,391334.0,,867940.0,3561189.0,100724765.0,3.0,38635313.0,,,,120044572.0,23155188.0,,236476407.0,61763733.0,,,10447877.0,,5421371.0,5621827.0,,13109670.0,,,,,,,12170125.0,39157951.0,29972817.0,41981823.0,,,3441000.0,,57106589.0,22356651.0,280.57,,3504352.0,,,9316.0,24168.0,,,,20487538.0,584210000.0,,29836200.0,,,142834.0,24315709.0,,,,6115646.0,,37252349.0,,,,,,13266.0,12778144.0,,,,,24315709.0,48032518.0,73087.0,,16162992.0,5919.0,,,,,,NY,,-227965.0,162334365.0,277364.0,21712355.0,208177.0,,2439.0,971975.0,17918.0,1081739256.0,711679.0,26.0,,,,13805.0,38253546.0,9835.37,,17224.0,,NASSAU,80868326.0,,278548.0,7072.0,373505.0,,311895.0,1592007.0,,,,,11953190.0,,,27126.0,300 COMMUNITY DRIVE,,,,,,,,,652412.0,62023305.0,,,39157951.0,,,1983.0,295630305.0,801438.0,,,,,,48.05,,,1957829.0,,33,3682.0,,280503.0,1236557.0,4018730.0,-906689.0,,55490.0,,,,,,378055.0,,,,,,,46043561.0,,,360834.0,,,,,,Y,,4106804.0,9857543.0,,,43255295.0,17675.0,,10960564.0,252258.0,2813.0,,972874.0,11908000.0,,28745391.0,3262078.0,,,,2140380.0,49526406.0,690807.0,,1300967388.0,,1472399238.0,,,3482295.0,,,,,,25939533.0,,,,21712355.0,,,,,,,,94358807.0,,4662058.0,1255903.0,3482295.0,1772.0,17316.0,136777.0,388180.0,24442152.0,2207030.0,-33930448.0,,,,12012.0,,,3577808.0,625.0,8805327.0,45389346.0,,72351575.0,,,,19924633.0,1617852664.0,194410.0,,2064521.0,,,,,,,,,13192431.0,,2378764.0,,,,,,,,,16525392.0,,,,,-246474993.0,,13109670.0,,,,,,,,239264.0,,-704987439.0,2756529.0,,,,,136650.0,,,,,,,,1442009.0,,-1764505.0,,19019795.0,,-109243.0,,,,,,108266432.0,,,,,,4255727832.0,,1476941.0,157647.0,,,50050074.0,,9518739.0,15326671.0,,457389000.0,,549132.0,1645402.0,24168.0,,1084925.0,38269390.0,1015.0,,118752122.0,,229283.0,,,293227.0,,,,,,12932613.0,23.64,,625.0,,4759411.0,88710.0,7597.0,103224641.0,31415.0,18116183.0,215.05,10952306.0,5421088.0,,,,,170007.0,,,280252475.0,122369211.0,,,,28783375.0,,111605020.0,,,,,11713630.0,2190.0,,,2015-01-01 00:00:00,,,,136068520.0,,214006731.0,124334213.0,,177558000.0,,,,,9857543.0,408737.0,399528.0,,,,,,142834.0,1389778.0,,,12092811.0,,,3357.0,,,52.61,30300989.0,NSUH PSYCHIATRIC EXEMPT UNIT,3839.0,,,,111605020.0,,,3648370.0,7237.0,15144081.0,266355.0,461830.0,,,10282880.0,800091.0,,,,,333550,,,,,-316.0,,65665.0,,,,,,,,6927.0,,20487538.0,,,,,42736573.0,11894003.0,,,,76591472.0,,,,,,,17327.0,,19597288.0,28983.0,56335706.0,,3383558.0,,136068520.0,,,,,90885.0,,,,48159165.0,,,,,101669805.0,,,2202520.0,1060576.0,1001.0,,7301.0,,,,4,,2609967.0,6169829.0,,,,,,,10734469.0,1323.0,,,,,,132645913.0,,,,,,56852347.0,,,,,,,225741.0,,303807.0,,1056380.0,,,,,490316.0,,0.206484,666276.0,,8055983.0,,,,59575536.0,,,,,,,,,,6391626.0,,-77752.0,J,,4369298.0,214444.0,,,1081739256.0,,45091.0,,,2015,Acute Care Hospitals,NORTH SHORE UNIVERSITY HOSPITAL (330106)
37798,NORTH SHORE UNIVERSITY HOSPITAL (330106),General Short Term (Acute Care Hospitals),Voluntary Nonprofit-Other,-73.703029,40.779269,,04/04/2008,,,,,8940781.0,,,1183902.0,330846.0,7927154.0,,16375.0,,,,294839697.0,,,350393.0,,,76897282.0,,,,,,9357263.0,2357.0,,,,40.0,59195123.0,708247000.0,,4686985.0,,,-111343.0,-7803361.0,,,N,236587.0,1550505.0,,,341.0,950301.0,,1218.0,,9521370.0,336.5,,,,,,42909646.0,637445.0,32142492.0,,,1317.0,,31364006.0,,,756.0,1724228.0,,,811014.0,,,14030220.0,,,71.0,,,1364978.0,7500000.0,4631985.0,9571426.0,,,,,,,,,,,,352100172.0,,,836870.0,25.56,,1863251.0,428954.0,,,4070.0,,3910029.0,,,2.0,,,7578750.0,,,,,5657197.0,,36474220.0,2933202.0,42877691.0,2166550.0,5414642.0,,,,,,,,,,16375.0,,,,283457.0,,,99153803.0,,,777116.0,,,,2697388.0,,,,,-3210270.0,,13624557.0,,,361581.0,887146.0,332977215.0,,1387358.0,,10330.0,,28567119.0,,-81799.0,10631979.0,4889633.0,,,50179.0,9812.0,,,,N,,699479.0,,3606559.0,,,,1966579.0,33073967.0,,,68208907.0,2209003.0,131978471.0,14591.0,,,-6326.0,110522.0,,,40199224.0,4852019.0,161992.0,,17420.0,10970111.0,1396844406.0,,,264920.0,,,,,,,,50179.0,140917.0,,,18666.0,66202918.0,,53938943.0,,1228012.0,69482.0,13824782.83,,86978736.0,,,,326279.0,297579862.0,,-2004188.0,1654480.0,556.0,,11436.0,,353360.0,225750.0,,,,,3348612.0,,,,942.0,1251989.0,17586932.0,,,,,4242473.0,,,-28903056.0,,,,,,,,,,,,16569644.0,,,,,,,2833190.0,,475127160.0,,,45.65,459471.0,25.0,,,,157830919.0,,,,,,,,11571952.0,5913759.0,,,,,,114.0,,,,,1109003.0,664060010.0,8617.0,38.0,35286.0,98848.0,,25218427.0,5722363.0,,23054378.0,1228012.0,43756548.0,,,,18777938.0,,,,,7458813.0,,1676883.0,,,,,,,22423490.0,2577036.0,,584682609.0,,39793.0,2077436.0,,,,,,,,,,,,,,N,4080147.0,5167689.0,,294839697.0,,120910393.0,,,,336.5,11336978.0,11942765.0,,239771.0,,,,,10156823.0,13837860.83,148685.0,243158546.0,29921664.0,,225750.0,,,-3354551.0,,3695339.0,,53.33,,16346764.0,,10127299.0,,58545497.0,438672841.0,,859502061.0,,,524639.0,460.24,20568.0,,,-2043007.0,General Short Term,,,23494786.0,,,395518000.0,76063427.0,93680384.0,668680000.0,,135.0,43537361.0,96884998.0,588619.0,,,674000.0,,,,-54369.0,,60042104.0,520571000.0,6880.0,,26.43,80467347.0,,7278737.0,,86978736.0,,10030,,,,,7217454.0,,2815984.0,4177002.0,,,12853415.0,,,,4562243.83,,,2336343.0,194333048.0,23082356.0,,,,,,5392.0,815655501.0,,,,,9988952.0,,53664502.0,8132660.0,,,,405509.0,29.81,,71.0,,182180.0,1083057.0,,1860.0,,,3822735.0,2544044.0,,12475144.0,,,,,N,-537875.0,99339316.0,,,13674612.0,24285.0,,951774.0,,32272811.0,603257.0,-245120.0,,,,,4217352.0,,283006.0,,2357.0,683363435.0,,144028481.0,4686335.0,,151042.0,,,,,24155124.0,,,,,,15446308.0,,,,42.7,,,,,,,,,,,1247612.0,,,,,15774007.0,22.46,,27902.0,,,8408.0,3439754.0,,,,23104.0,2422038.0,4166.0,7801459.0,48132.0,,65417.0,243.7,,,,,,,1652069.0,,,218260.0,44439045.0,24596234.0,,,,205709.0,,5243241.0,,3624432.0,,,,1332984.0,,72853.0,,59713844.0,23730.0,,34.0,,194333048.0,129439.0,323618.0,1332.0,71328.0,,,,3836.0,,125.0,,,,,,,942970.0,1793834.0,52461988.0,1733099.0,26346.83,,411933.0,,10115252.0,,1813483030.0,,14644737.0,,,,215085259.0,,1.0,Y,,28491.0,2209003.0,438672841.0,,,26164.0,296552.0,,13533960.0,,88211720.0,,,16351.0,,2544044.0,,678002728.0,4493901.0,,,328402.0,,4166.0,,19342179.0,,815655501.0,,13065229.0,6858574.0,247.0,,16836.0,,,,,45602163.0,,3646.0,-557827800.0,,,2462.0,,726483.0,,,5756936.0,1035932.0,,12106448.0,5075325.0,,,14799.0,43108125.0,6196431.0,,,7108472.0,1546720.0,62.11,,28.0,189701063.0,525261.0,,1214497.0,386815.0,,,,1954600.0,43756548.0,,,,,,,10947306.0,,,,199825569.0,84968.0,658073.0,,,,6350944.0,1676883.0,,195.0,,99339316.0,2314216.0,331569.0,,,,,189701063.0,,,,,1114634.0,,,,4216163.0,9695.0,,2549913.0,,66486370.0,-8587374.0,1550505.0,,,1925896.0,,-134336.0,,,,44611213.0,,,1114634.0,,,,15315.0,12277329.0,2509582.0,,9157033.0,,28350746.0,,1396844406.0,,40541174.0,965222.0,58530698.0,3784341.0,2785146.0,,6231969.0,,,41361259.0,,,,,,,,6362642.0,1967697.0,,22523.0,,,,,,33S106,,,,,,6450890.0,,,222179415.0,1114634.0,22152753.0,,Y,,,,-326617.0,,,,,,,,,,,,10195054.0,,277221.0,,180507.0,72587127.0,,,,,,,,,2200520834.0,,,,189755.0,,1.0,16437113.0,,,7.0,,,,,153684.0,12003.0,,,,37810641.0,686853,13674612.0,,1493000.0,,1109003.0,29.26,113948.0,7825900.0,,2014400.0,,,37810641.0,,14932.0,,,,5172683.0,,16346764.0,91903.0,,,,11436.0,,9510429.0,,21008175.0,10694219.0,,,,,,,247.0,,,10278619.0,,36974527.0,,,101089000.0,1175.0,2519617.0,14505.0,,72224592.0,8994129.0,,3397470.0,1131706.0,,979835000.0,,2349.0,,6231969.0,,,182179.0,,,,,,67426.0,,,,Y,,,,-1216920.0,603.0,,102823.0,,,-11681241.0,16346764.0,,,,,,10769.0,,,,,22481828.0,68275.0,,,,,,,,,38429600.0,30306.0,,,,7032259.0,,,N,,,13001,,,,,12964282.0,2051958.0,,,,3186102.0,,,,487.0,,5657197.0,,,78699.0,,1834561.0,,968235.0,157693.0,,1196812.0,,334175.0,,,,,,,5806136.0,,,,11277354.0,,,36593298.0,6852419094.0,5.0,,,-35287.0,,,115437520.0,,,,,3702857.0,,,2466290.0,20111450.0,,,,25218427.0,,,,,,14644737.0,13078.0,6810393.0,,17202.0,10596735.0,234730.0,25878443.0,,,,,,,,,335702,2032.0,,,,,,,,1796896.0,,,,-1.0,,16161.0,,75.23,,12391475.0,5646841.0,1109003.0,-100.0,21989395.0,,,,11336978.0,80350244.0,583624.0,41312.0,52699479.0,13065229.0,,,,,,,,3778210.0,,461413.0,70524.0,330106,11561861.0,,,,,6197535.0,,,,,,,,412874.0,25878443.0,,6196276.0,29666471.0,,,,68208907.0,,2444.0,,,,48.03,,,,,412874.0,,,51972.0,1387358.0,,,,,X,1260297.0,,-384799.0,,2314216.0,,,,,,Y,3764.0,9933.0,,1127964.0,91903.0,,23517143.0,,,,,,,,,,14644737.0,,,20620.0,412874.0,,,5197096.0,,,,-79864.0,,,,2217770.0,,820.0,,48634361.0,,,,37.53,N,10572067.0,,182180.0,,4393142.0,,,38.79,,1089385.0,,99153803.0,,N,,,,,,,904.0,1387358.0,48376160.0,,5518.0,,7458813.0,,,,236587.0,,,-497346465.0,,,,71321982.0,,,,,,41709744.0,19596609.0,,,,29564353.0,,,19062850.0,,,,,,90.0,,,7825900.0,,,,,5380,,,,,,2353230565.0,,7376433.0,,51714077.0,5490.0,,,14255.0,,8440716.0,,,,,,3836.0,,2298229.0,,,,,,,,57171344.0,,,6110805.0,,,,,847667.0,,,600962.0,,,,,-102023.0,,170342597.0,28362533.0,40541174.0,10709638.0,555641.0,4070.0,571975.0,,,269963685.0,5320900.0,,13174.0,260.0,1077788.0,,1936253.0,-1171794.0,,11096183.0,,,170237.0,525078.0,30676773.0,,,,-29393108.0,,21008175.0,,,,1109003.0,,234730.0,,1338395.0,Y,,,,,774699736.0,,22.5,,,,-326617.0,,,10509732.0,,7.0,,466899.0,,,,,,28477897.0,1753438.0,28690745.0,,,278.0,72224592.0,97140.0,,,2016-12-31,,873444779.0,47060.0,,,4031293.0,,5297387.0,,,10798.0,,,5734808.0,,,,,304934689.0,,63002.0,,,,,,,,,287028318.0,,,10330.0,,,811014.0,11336978.0,,13224712.0,66343109.0,,,,16616331.0,,14640.0,,687010.0,,,,,823763.0,323250.0,6434451.0,,,133723206.0,12722500.0,20568.0,,1676883.0,-608766209.0,,14505.0,,,15774007.0,,-78437000.0,,11777685.0,9770740.0,8790.0,894830.0,,,4206119.0,,,42975.0,607651.0,,,,NORTH SHORE UNIVERSITY HOSPITAL,63002.0,2.0,518395.0,305126796.0,,,,,,,,,,,3342616.0,257753.0,,,,,,3397470.0,299208409.0,,,P,9517.0,,,,,,,,,-1216920.0,53.98,31.13,3322617.0,,33073967.0,110114487.0,,5805134.0,38728.0,,,N,,286740548.0,48.7,,,,,,,,,,,19484602.0,,,,,,47601.0,10339131.0,,,588689.0,,,,,,-3155131.0,4.0,,,,-716000.0,,3439754.0,315.0,,,-7757125.0,-3354551.0,409577.0,MANHASSET,,,,46.0,145669786.0,,,,20336633.0,35004,,,1384239.0,170903125.0,,22403590.0,,,,56315049.0,,7106505.0,728730925.0,11784.0,,,831664.0,,8408.0,,,,157249.0,,4463172.0,34657548.0,,,-796315804.0,,1532012.0,,1671638.0,,2166550.0,,,,,,,162860.0,,,,10970111.0,228924366.0,1316522.0,,,15731474.0,,5114967.0,,5020.0,2882753.0,10572067.0,118528.0,,,,3810410.0,,3.0,,,1135002.0,294067.0,5621000.0,11096183.0,,437718.0,129583.0,,-2912252.0,34.37,,,,,,,,25962997.0,14432588.0,,774087158.0,,12230028.0,,,,,,78511.0,,,133723206.0,,,,337148,1208169.0,,10970111.0,,,103848098.0,,13.0,1260297.0,,,,,,288.0,,,2296872.0,153684.0,,173669009.0,58362.0,,2537034.0,,,,,73121.0,,7896187.0,,,345867.0,,227008.0,1142825.0,,1998523.0,,,311155000.0,82044.0,,84.8,,,3557169.0,,,,1630323444.0,,,668680000.0,4651898260.0,,,,,,,,,,,,2200520825.0,,,728547.0,18361577.0,66343109.0,,,,52699479.0,,,80204656.0,,,,27666.0,,110273605.0,,1322905.0,,,,33400,56927.0,,,,1144958000.0,,6852419085.0,,,2662.0,1106124.0,F,,,69.0,,1505664.0,53430530.0,,1534878.0,874256.0,,,,,,,,20568.0,,,,1926.0,,96697008.0,,13310373.0,,336330262.0,,,5197096.0,,,,,,,,,-31165296.0,,,,,8433182.0,151042.0,10596735.0,36593298.0,,423065.0,370039.0,,,,823015.0,,1166281589.0,812.0,,,,97039979.0,1020613000.0,,,,,1930250.0,42877691.0,1275363.0,,,,80487915.0,46443534.0,24155124.0,,61062.0,,268130.0,,36785.0,,,25831005.0,,14742501.0,,,,,,,-4144877.0,,70733647.0,,,,,,227008.0,12853415.0,,,,,1450039.0,N,,,32458717.0,19653965.0,,,,,1008537.0,,664325.0,411348.0,,,,1022039.0,,,,,,,,,,,3397470.0,183.0,,,3266008.0,,,36435624.0,,,15.0,,,,357852058.0,14030220.0,,2077436.0,80718000.0,110025000.0,,,,,,,,,,,,,,21105402.0,,,,10631979.0,,56315049.0,,117597000.0,,2021-02-15 00:00:00,,18403334.0,,10392227.0,227075712.0,603.0,,,669042.0,738128.0,,,,,1801202.0,291418.0,,,,,,,,,,,,5.0,,,,,,,,,4463872.0,,11942765.0,,,,,,,,69.0,47.2,,38429600.0,147173.0,,26901286.0,,,,37380117.0,,,,84.8,,655578.0,,,17377469.0,4160.0,,4270459.0,,4916012.0,3781638.0,33454848.0,0.77,2030658.0,137491745.0,,,9635912.0,84237000.0,,,,,,,294839697.0,11193.4,,246000.0,7376433.0,,,,1448296592.0,47.0,,638785.0,16616331.0,,2109264000.0,42909646.0,6319.0,196426870.0,5057016320.0,,,72587127.0,46546.0,,,,,,,,,51357091.0,11904520.0,520571000.0,45926777.0,16.0,,,,,,18608023.0,80204656.0,135.0,,,,51.0,59414497.0,,904617.0,,,,84969000.0,,,,3101715.0,,,15315.0,,,,,,,16667088.0,,35186.0,,,,18608023.0,28098000.0,3063.0,,,215.0,,20504075.0,,31602320.0,,5320900.0,,1.0,,47487014.0,158889527.0,,,323250.0,,,,2684437.0,42770.0,41361259.0,249.0,1536839.0,,593707.0,,,78122171.0,,,,,60790353.0,,,,,,5518.0,,Y,,,,,,76953638.0,257753.0,72094.0,12599375.0,323250.0,,,-11699213.0,,26.0,,16960076.0,,,70790394.0,4631985.0,,10769.0,,,1186948976.0,67.07,,39109876.0,40.0,,,,-1438793.0,363729.0,,45813299.0,,,379349.0,,584399.0,3421200.0,120910393.0,3.0,49900986.0,,,,134384268.0,30796491.0,,272595730.0,64973816.0,,,13429361.0,,5995232.0,5988745.0,,13398564.0,,,,,,,8027727.0,68799017.0,30981156.0,45926777.0,,,9605000.0,,63790462.0,20111450.0,349.63,,3624432.0,,,9695.0,52517.0,,,,20909923.0,544914000.0,,32458717.0,,,175087.0,25138477.0,,,,7896187.0,,171619125.0,,,,,,15582.0,15225111.0,,,,,25138477.0,27485132.0,44130.0,,16667088.0,6605.0,,,,,,NY,,-38160.0,174528237.0,323250.0,23048358.0,221569.0,,260.0,1074537.0,9812.0,1186948976.0,701760.0,258.0,,,,14255.0,39744770.0,10314.56,,,,NASSAU,103848098.0,,390348.0,7595.0,374664.0,,235685.0,1983639.0,,,,,13224712.0,,,19286.0,300 COMMUNITY DRIVE,,,,,,,,,635134.0,65681394.0,,,68799017.0,,,113.0,357852058.0,-1849796.0,,,,,,46.03,,,1336015.0,,33,5239.0,,290266.0,566182.0,3691304.0,-968081.0,,56105.0,,,,,,386815.0,,,,,,,51357091.0,,,435537.0,,,,,,Y,,2574659.0,10195054.0,,,43756548.0,24541.0,,11188713.0,473908.0,217.0,,968235.0,11908000.0,,34721040.0,2842637.0,,,,1993670.0,70790394.0,467062.0,,1396844406.0,,1556914761.0,,,3348612.0,,,,,,27281659.0,,,,23048358.0,,,,,,,,123549396.0,,4756661.0,1260297.0,3348612.0,1860.0,13078.0,95796.0,407843.0,26500057.0,1266177.0,-41211654.0,,,,12003.0,,,5135824.0,,9340574.0,48634361.0,,70733647.0,,,,18403334.0,1795402765.0,229072.0,,1546720.0,,,,,,,,,13674612.0,,2697388.0,,,,,34.0,,,,19554952.0,,,,,-274521918.0,,13398564.0,,,,,,,,328402.0,,-796315804.0,3047303.0,,,,,130994.0,,,,,,,,1550505.0,,-2313862.0,,23054378.0,,-113171.0,,,,,,114965643.0,,,,,,4651898260.0,503.0,996050.0,188594.0,,,56100954.0,,9517085.0,16401818.83,,443735000.0,,424864.0,887146.0,52517.0,,851050.0,18958402.0,1051.0,,131978471.0,,187039.0,,,409577.0,,,,,,20618744.0,23.26,,,,5176364.0,91903.0,42770.0,109156494.0,41643.0,19342179.0,279.97,11942765.0,5902398.0,,,,,174765.0,,,294839697.0,144028481.0,,,,32142492.0,,73067518.0,,,,,13310373.0,2562.0,,,2016-01-01 00:00:00,,,,141008578.0,,234262508.0,137012768.0,,185393000.0,,,,,10195054.0,421692.0,642466.0,,,,,,,1338395.0,,,36330592.0,,,,,,53.9,35947080.0,NSUH PSYCHIATRIC EXEMPT UNIT,4746.0,,2.0,,73067518.0,,,990805.0,1104.0,14644737.0,525624.0,246520.0,,,10520552.0,476027.0,,,,,333550,,,,,-834.0,,84968.0,,,,,,,,6975.0,,20909923.0,,,,,40037460.0,12277329.0,,,,78431813.0,,,,,,,17420.0,,17458652.0,17828.0,59195023.0,,3606559.0,,141008578.0,,,,,91134.0,,,,53664502.0,,,,,110027148.0,,,2210535.0,662940.0,,,,,,,4,,3107796.0,7301914.0,,,,,,,10766891.0,1332.0,3.0,,,,,133723206.0,,,,,,36474220.0,,,,,,,234730.0,,262716.0,,1177325.0,,,,,470669.0,,0.203847,665971.0,,8262786.0,,,,66202918.0,,,,,,,,,,8433182.0,,-64731.0,J,,6002739.0,224602.0,5.0,,1186948976.0,,44053.0,,,2016,Acute Care Hospitals,NORTH SHORE UNIVERSITY HOSPITAL (330106)
44259,NORTH SHORE UNIVERSITY HOSPITAL (330106),General Short Term (Acute Care Hospitals),Voluntary Nonprofit-Other,-73.703029,40.779269,,04/04/2008,,,,,,,,1204334.0,354769.0,8276482.0,5161.0,49216.0,,,,294708059.0,,,326081.0,,,66767173.0,,,,,,14885808.0,688.0,,,,,60216705.0,796215000.0,,4180838.0,,,-6477.0,-8908741.0,,,N,320118.0,1687376.0,,,366.0,,,1283.0,,13711920.0,341.45,,,,,,48898166.0,,33284954.0,,,811.0,,33279324.0,,,764.0,1544499.0,,,900564.0,,,17323637.0,,,30.0,,,1447430.0,7500000.0,5303245.0,8957954.0,,,,,,,,,,,,382380116.0,,,1289450.0,28.15,,1802531.0,450608.0,,,4617.0,,3917354.0,,8.0,2.0,,,9296617.0,,,,,4515006.0,,35319165.0,2846154.0,45803595.0,,6418675.0,,,,,,,,,,49216.0,,,,107310.0,,,111422487.0,,,684675.0,,,,6720438.0,,,,,-3334871.0,,15297238.0,,,400399.0,107869.0,335653004.0,,1400093.0,,10407.0,,30491572.0,,-5504.0,6325278.0,7082530.0,,,49458.0,9486.0,,,,Y,,731047.0,,3970146.0,,,,2166457.0,31663778.0,,,55932412.0,2052178.0,140541751.0,16354.0,,,,111277.0,,,39949551.0,4685036.0,27102.0,,16413.0,23020910.0,1444112271.0,,,35780.0,,,,,,,,49458.0,117209.0,,,18615.0,70775270.0,,55160006.0,,1048758.0,22976.0,13842767.0,,89897173.0,,,,389891.0,280236687.0,,-2065755.0,409700.0,,,12048.0,,,197050.0,,,,,3904060.0,,,,1478.0,1320092.0,19343220.0,,,,,3817302.0,,,-39407552.0,,,,,,,,,,,,12427687.0,,,,,,,2946263.0,,534696420.0,,,44.51,165425.0,26.78,,,,143663414.0,,,,,,,,44452057.0,6356529.0,,,,,,,,,,,874626.0,706058761.0,10275.0,61.0,24513.0,98197.0,,25990143.0,8221365.0,,20574923.0,1048758.0,47935325.0,,,,20615143.0,,,,,7190311.0,,1764479.0,,,,,,,26390048.0,2892907.0,,576718955.0,,,2179800.0,,,,,,,,,,,,,,N,4820125.0,10513045.0,,294708059.0,,137268783.0,,,,341.45,13159752.0,10192904.0,,321709.0,,,,,10301887.0,13853437.0,76880.0,243385711.0,31062935.0,,197050.0,,,-3693749.0,,3627735.0,,58.54,,17150893.0,,10256257.0,,59561326.0,451242418.0,,916750129.0,,,669149.0,467.65,12265.0,,,-2106669.0,General Short Term,,,23463387.0,,,434476000.0,85155799.0,105050205.0,674566000.0,,,45862521.0,87856941.0,492749.0,,,883000.0,,,,-1166.0,,59202778.0,576852000.0,2586.0,,29.2,85081591.0,,7803959.0,,89897173.0,,10030,,,,,8430027.0,,2312136.0,3741828.0,,,15159171.0,,,,4673380.0,,,3056457.0,209816742.0,3543731.0,,,,,,4654.0,815069797.0,,,,,11364094.0,,55823182.0,8393016.0,,,,1122488.0,30.76,,6.0,,207291.0,1668341.0,,2161.0,,,3143650.0,2748755.0,,11835056.0,,,,,N,-688213.0,79403356.0,,,14149434.0,29571.0,,1103325.0,,33599008.0,606136.0,-463908.0,,,,,2814088.0,,278860.0,,688.0,723446767.0,,148792808.0,5498945.0,,146741.0,,,,,25181068.0,10528.0,,,,,16838323.0,,,,42.24,,,,,,,,,,,452089.0,,,,,15625660.0,24.55,,121000.0,,,8858.0,3499327.0,,,,32264.0,1996388.0,2017.0,9490899.0,47520.0,,30561.0,266.13,,,,,,,1834692.0,,,314730.0,50461805.0,24751522.0,,,,393242.0,,6240160.0,,3918146.0,,,,1463442.0,,31605.0,,58439634.0,25518.0,,,,209816742.0,133012.0,273746.0,1240.0,52662.0,,,,4008.0,,20.0,,,,,,,1089249.0,1971348.0,115436051.0,1617347.0,23160.0,,332401.0,,10438996.0,,1868596233.0,,9031455.0,,,,216510867.0,,1.0,Y,,27043.0,2052178.0,451242418.0,,,32941.0,149581.0,,12387278.0,,124128402.0,,474687.0,27888.0,,2748755.0,,721072621.0,486065.0,,,473013.0,,2017.0,,21597847.0,,815069797.0,,13979788.0,7342268.0,245.0,,7898.0,,,,,48596253.0,,910.0,-671512494.0,,,606.0,,848181.0,,,6838078.0,854157.0,,12080636.0,4844362.0,,,15955.0,44474596.0,6097659.0,,,6617665.0,1627893.0,66.17,,,204513497.0,431481.0,,1053876.0,378408.0,,,,2315421.0,47935325.0,11657.0,,,,,,11667487.0,,,,187706325.0,53675.0,224670.0,,,,5851445.0,1764479.0,,,,79403356.0,136878.0,147849.0,,,,,204513497.0,,,,,1130427.0,,,,6117298.0,10428.0,,2270117.0,,65402721.0,-10847915.0,1687376.0,,,2913215.0,96459.0,-138378.0,,,,54266640.0,,,1130427.0,,,,15056.0,12859034.0,2069350.0,,8723825.0,,332763.0,,1444112271.0,,44471741.0,1206628.0,59545371.0,5952897.0,2741753.0,,8737491.0,,,59910887.0,,,,,,,,5684393.0,2069355.0,,23845.0,,,,,,33S106,,,,,,6986541.0,,,240144009.0,1130427.0,21704743.0,,Y,,,,-100744.0,,,,,,,,,,,,10877614.0,,230207.0,,299355.0,87893138.0,,,,,,,,,2295531402.0,,,,297083.0,,1.0,16838323.0,,,,,,,,193170.0,4732.0,,,,40884476.0,706187,14149434.0,,1666000.0,,874626.0,29.72,60871.0,7229191.0,,1297580.0,,,40884476.0,,8509.0,,,,4622123.0,,17150893.0,91621.0,,,,12048.0,,10335043.0,,6380948.0,23457183.0,,,,,,,245.0,,,6325278.0,,38068666.0,,,107253000.0,228.0,3102929.0,6205.0,,78768695.0,9459039.0,,3521494.0,1091290.0,,1021664000.0,,3421.0,,8737491.0,,,258641.0,,,,,,59322.0,,,,Y,,,,-1265487.0,611.0,,102940.0,,,-13335940.0,17150893.0,,,,,,12144.0,,,,,23679870.0,30662.0,,,,,,,,,45528721.0,28658.0,,,,7813274.0,,,N,,,13001,,,,,13531182.0,2360288.0,,,,4052853.0,,,,513.0,,4515006.0,,,12672.0,,-1926684.0,,1125126.0,171077.0,,1184818.0,,356866.0,,,,,,,2660069.0,,,,10840943.0,,,52495358.0,7106684660.0,,,,-709534.0,,,116288122.0,,,,,3260791.0,91259.0,,4894211.0,26816779.0,,,,25990143.0,,,,,,9031455.0,10670.0,6566624.0,,17155.0,12127938.0,232194.0,23987825.0,,,,,,,,,335702,1862.0,,,,,,,,1983308.0,,,,-156104.0,,16324.0,,75.19,,10420623.0,6536200.0,874626.0,46.0,22964533.0,,,,13159752.0,90420988.0,485574.0,40331.0,55796581.0,13979788.0,,,,,,,,4489023.0,,416264.0,,330106,23846452.0,,,,,6098298.0,,,,,9777.0,,,369538.0,23987825.0,,6196276.0,19841585.0,,,,55932412.0,,12276.0,,,,51.01,,,,,369538.0,,,46809.0,1400093.0,,,,,,1252296.0,,704274.0,,136878.0,,,,,,Y,1943.0,7800.0,,1311928.0,91621.0,,24162718.0,,,,,,,,,,9031455.0,,,26856.0,369538.0,,,5411883.0,,,,-94106.0,,,,2364971.0,,864.0,,45509044.0,,,,41.84,N,11833066.0,,207291.0,,4545167.0,,,38.63,,1242120.0,,111422487.0,,N,,,,,,,1417.0,1400093.0,50136649.0,,5462.0,,7190311.0,,,,320118.0,,,-518308738.0,,,,70931671.0,,,,,,47240159.0,59862537.0,,,,7131600.0,,,22365552.0,,,,,,43.0,,,7229191.0,,,,,5380,,,,,,2498429772.0,,7244871.0,,51423776.0,5475.0,,,13389.0,,,,,,,,4008.0,,2632140.0,,,,,,,,55694502.0,,,6988667.0,,,,,1182160.0,,,881155.0,,,,,-102022.0,,170994652.0,15610476.0,44471741.0,9583172.0,857867.0,4617.0,17667.0,,,264227535.0,7821106.0,,14746.0,,1164210.0,,2196185.0,-839637.0,,11925127.0,,,189904.0,532619.0,21308030.0,,,,,,6380948.0,,,,874626.0,,230797.0,,1876322.0,Y,,,,,828644502.0,,24.11,,,,-100744.0,,,16073527.0,,10.0,,378647.0,,,,,,51736152.0,43913261.0,30786180.0,19964.0,,,78768695.0,81888.0,,,2017-12-31,,931763989.0,72817.0,,,3609897.0,,5317447.0,,,1741.0,,,2607407.0,,,,,307176134.0,,30604.0,,,,,,,,,296182906.0,,,10407.0,,,900564.0,13159752.0,,13073774.0,63479833.0,254763.0,,,21185985.0,,14600.0,,628230.0,,,,,984823.0,151273.0,5299799.0,,,136355547.0,12491500.0,12265.0,,1764479.0,-694119673.0,,6205.0,,,15625660.0,,-83191000.0,,13692919.0,10018039.0,10076.0,897006.0,,,2935764.0,,,63579.0,586847.0,,,,NORTH SHORE UNIVERSITY HOSPITAL,25298.0,2.0,135761.0,340273583.0,,,,,,,,,,,3328255.0,206242.0,,,,,,3521494.0,346372043.0,,,P,10016.0,,,,,,,,,-1265487.0,56.27,32.2,6885763.0,,31663778.0,123246269.0,,10513045.0,35537.0,,,N,,196827166.0,51.39,,,,,,,,,,,22244681.0,,,,,,52051.0,11613179.0,,,586166.0,,,,,,-3097319.0,,,,,-1812000.0,,3499327.0,,,,-10131890.0,-3693749.0,869952.0,MANHASSET,,,,20.0,151892868.0,289809.0,,,17756537.0,35004,,,1228320.0,189197147.0,,11276631.0,,,,55550032.0,,7803887.0,860709641.0,12398.0,,,679300.0,,8858.0,,,,369623.0,,4689965.0,43612080.0,,,-855321255.0,,1255447.0,,1210836.0,,,,,,,,,27102.0,,,,23020910.0,256004443.0,1271936.0,,,18113658.0,,5540251.0,,5224.0,3906585.0,11833066.0,127759.0,,,,3715293.0,,,,,2506890.0,280383.0,5621000.0,11925127.0,,356004.0,55889.0,,-3255231.0,35.86,,,,,,,,24619793.0,19730170.0,,828259859.0,,3560530.0,,,,,,12672.0,,,136569522.0,,,,337148,1580996.0,,23020910.0,,,111701802.0,,,1252296.0,,,,,,303.0,,,3168666.0,193170.0,,174679311.0,45287.0,,1740665.0,,,,,79618.0,,7273064.0,,,399590.0,,223015.0,1100976.0,,2527480.0,24.0,,347098000.0,85364.0,,81.97,,,4420962.0,,,,1113239956.0,,,674566000.0,4815678811.0,,,,,,,,,,,,2289434217.0,,,643731.0,19280559.0,63479833.0,,,,55796581.0,,,81068017.0,,,,14148.0,,122479110.0,,1657314.0,,,,33400,109559.0,,,,1331694000.0,,7105113028.0,,,6940.0,979890.0,F,,,,,4872336.0,54021075.0,,1630818.0,780211.0,,,,,,,,7920.0,,,,2016.0,,107571881.0,,16890014.0,,311762447.0,,,5411883.0,,,,,,,,,-16101705.0,,,,,18275347.0,146741.0,12127938.0,52495358.0,,398125.0,351442.0,,,,877220.0,,1206203233.0,329.0,,,,105358396.0,1200828000.0,,,,,1275750.0,45803595.0,778493.0,,,,85093856.0,58734771.0,25181068.0,,30236.0,,,,9856.0,,,26374786.0,,19176524.0,,,,,,,-4441321.0,,74453854.0,,,,,,223015.0,15159171.0,,,,1773114.0,2079740.0,N,,,38740903.0,30983762.0,,,,,953726.0,,671380.0,325847.0,,,,1032892.0,,,,,,,,,,,3521494.0,95.0,,,3288670.0,,,36381389.0,,,15.0,,,,404541264.0,17323637.0,,2179800.0,117431000.0,119202000.0,,,,,,,,,,,,,,21309418.0,,,,6325278.0,,55550032.0,,145117000.0,,2021-12-03 00:00:00,,17652697.0,,10873014.0,257197457.0,611.0,,,878773.0,1057458.0,,,,,1942137.0,261586.0,,,,,,,,,,,,,,,,,,,,,3142006.0,,10192904.0,,,,,,,,,49.49,,45528721.0,-443223.0,,29703439.0,,,,45813299.0,,,,81.97,,777801.0,,,17410225.0,3325.0,,4702640.0,,5355723.0,3851216.0,33447916.0,,2168542.0,144775790.0,,,6171784.0,82848000.0,,,,,1397.0,,294708059.0,11739.8,,16000.0,7244871.0,,,,1540853003.0,47.0,,563320.0,21185985.0,,2368123000.0,48898166.0,1800.0,198340090.0,5278195750.0,,,87893138.0,45514.0,,,,,,,,,52812847.0,16167200.0,576852000.0,47509740.0,,,,,,,17836198.0,81068017.0,,,,,51.0,62719686.0,,2694557.0,116739.0,,,87228000.0,,,,863939.0,,,15056.0,,,,,,,20529363.0,,34170.0,,,,17836198.0,28200000.0,842.0,,,227.0,,33175806.0,,26654754.0,,7821106.0,,156104.0,,50562549.0,163689230.0,,,152126.0,,,,,49235.0,59910887.0,256.0,2104479.0,,431748.0,,,34975889.0,,,,,63754546.0,,,,,,5462.0,,Y,,,,,,85133420.0,206242.0,70457.0,13502179.0,152126.0,,,-13350796.0,,,,17868954.0,2.0,,76884429.0,5303245.0,,12144.0,,,1292226539.0,71.14,,58061430.0,40.0,,,,-825.0,385689.0,,64088646.0,,,573295.0,,278837.0,3547012.0,137268783.0,,24888137.0,,,,136033998.0,31142521.0,,276452736.0,65063948.0,,,16931009.0,,6592654.0,7030370.0,,13837405.0,,,,,,,13090808.0,72610599.0,38336502.0,47509740.0,,,64992000.0,,65189724.0,26816779.0,454.6,,3918146.0,,,10428.0,46484.0,,,,21826159.0,545453000.0,,38740903.0,,,144666.0,26656642.0,,,,7273064.0,,191009147.0,,,,,,6763.0,13949258.0,,,,,26656642.0,25707258.0,62329.0,,20529363.0,7084.0,,,,,,NY,,-337078.0,171055666.0,151273.0,23847552.0,219989.0,,,864491.0,9486.0,1292226539.0,760889.0,1255.0,,,,13389.0,36413002.0,10785.67,,39188.0,,NASSAU,111701802.0,,518131.0,6018.0,408554.0,,355500.0,2499757.0,,,,,13073774.0,,,7344.0,300 COMMUNITY DRIVE,,,,19964.0,,,,,655585.0,65704443.0,,,72610599.0,,,,404541264.0,1015960.0,,,,,,49.94,,,1241333.0,,33,2771.0,,285442.0,548655.0,4276374.0,-1685474.0,,51005.0,,,,,,378408.0,,,43963.0,,,,52812847.0,,,691064.0,,,,,,Y,,2671389.0,10877614.0,,,47935325.0,26889.0,,10755524.0,1133423.0,,,1125126.0,11908000.0,,28997795.0,2857791.0,,,,1916628.0,76884429.0,307124.0,,1445885385.0,,1643108517.0,,,3904060.0,,,,,,27530506.0,,,,23847552.0,,,,,,,,138132711.0,,5380549.0,1252296.0,3904060.0,2161.0,10670.0,20754.0,406150.0,28078952.0,1349569.0,-42271542.0,,,,4732.0,,608312.0,5670527.0,,10319604.0,45509044.0,,74453854.0,,,,17652697.0,1826917278.0,38898.0,,1627893.0,,,,,,,,,14149434.0,,6720438.0,,,,,,,,,20833716.0,,,,,-309645197.0,,13837405.0,,,,,,,,473013.0,,-855321255.0,2326291.0,,,,,138691.0,,,,,,,,1687376.0,,-2212068.0,,20574923.0,,-130120.0,,,,,,118665370.0,,,,,,4811153258.0,566.0,1291588.0,217850.0,,,49808109.0,,11169262.0,16735674.0,,459577000.0,,449097.0,107869.0,46484.0,,1063075.0,33027513.0,1040.0,,140541751.0,,184919.0,,,869952.0,,,,,,19537705.0,25.04,,,,5528214.0,91621.0,49235.0,112081883.0,69251.0,21597847.0,312.82,10192904.0,6705074.0,,,,,191157.0,,,294708059.0,148792808.0,,,,33284954.0,,87814523.0,,,,,16890014.0,3650.0,,,2017-01-01 00:00:00,,,,145060811.0,,259104933.0,149520079.0,,192572000.0,,,,,10877614.0,374930.0,607676.0,,,,,,140892.0,1876322.0,,,50992569.0,,,,,,46.33,41191817.0,NSUH PSYCHIATRIC EXEMPT UNIT,5476.0,,,,87814523.0,,,,639.0,9031455.0,188479.0,327918.0,,,10687576.0,699706.0,,,,,,,,,,,,53675.0,,,,,,,,7015.0,,21826159.0,,,,,41568592.0,12859034.0,,,,82223598.0,,,,,,,16413.0,,18650410.0,4608.0,60216751.0,,3970146.0,,145060811.0,,,,,93440.0,,,,55823182.0,,,,,122201098.0,,,2541347.0,668611.0,,,,,,,3,,2556181.0,7886849.0,,,,,,,11281568.0,1240.0,,,,,,136569522.0,,,,,,35319165.0,,,,,,,230797.0,,227634.0,,1223184.0,,,,,652193.0,,0.203205,682692.0,,9155394.0,,,4345.0,70775270.0,,,,,,,,,,18275347.0,,-62659.0,L,,7025185.0,232561.0,,,1292226539.0,,41784.0,,,2017,Acute Care Hospitals,NORTH SHORE UNIVERSITY HOSPITAL (330106)
51023,NORTH SHORE UNIVERSITY HOSPITAL (330106),General Short Term (Acute Care Hospitals),Voluntary Nonprofit-Other,-73.703029,40.779269,,04/04/2008,,,,,,,,1322122.0,307341.0,9098955.0,12565.0,46460.0,,,,324320699.0,,,397459.0,,,74666551.0,,,,,,12856853.0,1010.0,,,,,66106090.0,642541000.0,,4250947.0,,,,-9736267.0,,,N,316208.0,2008485.0,,,428.0,,,1423.0,,14096715.0,335.41,,,,,,56494339.0,,37883970.0,,,470.0,,35748452.0,,,764.0,1570108.0,,,881425.0,,,19732364.0,,,45.0,,,1832096.0,7500000.0,5353511.0,11649748.0,,,,,,,,,,,,403689847.0,,,1485127.0,28.81,,1771163.0,485685.0,,,4875.0,,4226242.0,,,2.0,,,9220896.0,,,,,3088359.0,,37030595.0,3753606.0,49140525.0,,6584768.0,,,,,,,,,,46460.0,,,,230594.0,,,113775289.0,,,694778.0,,,,5993565.0,,,,,,,16893734.0,,,181153.0,81636.0,351343163.0,,1236554.0,,10778.0,,34950768.0,,,9902350.0,6536803.0,,,48079.0,6462.0,,,,Y,,913724.0,,1728281.0,,,,2456828.0,37396747.0,,,37562011.0,1918116.0,144407806.0,16803.0,,,,713505.0,,,47238550.0,4882019.0,25560.0,,17423.0,23213599.0,1568721690.0,,,20982.0,,,,,,,,48079.0,152336.0,,,18615.0,78876325.0,,20371482.0,,901919.0,22605.0,13645803.31,,94501014.0,,,,425561.0,299834155.0,,-1600538.0,1814261.0,,48364.0,19182.0,,,296950.0,,,,936150.0,4055937.0,,,,1517.0,1436772.0,24398432.0,,,,,3275554.0,,,-24482887.0,,,,,,,,,,,,2807862.0,,,,,,,3782095.0,,579454103.0,,,43.63,204663.0,27.62,,,,158414758.0,,,,,,,,15981419.0,6547256.0,,,,,,,,,,,750172.0,712090016.0,19910.0,49.0,16427.0,94254.0,,26971439.0,27205224.0,,22406542.0,901919.0,46445451.0,,,,22311575.0,,,,,7894410.0,,1726246.0,,,,,,,29643227.0,3254258.0,,541332455.0,,15005.0,3720825.0,,,,,,,,,,,,,,N,5126277.0,12174878.0,,324320699.0,,145854847.0,,,,335.41,14075715.0,9407831.0,,412790.0,,,,,10505389.0,13655155.31,95165.0,215983080.0,36749576.0,,296950.0,,,-3695152.0,,3601224.0,,59.93,,17867459.0,,10377037.0,,65268670.0,487851399.0,,932126524.0,,,721614.0,475.81,33033.0,,,-1640933.0,General Short Term,,,22318670.0,,,434451000.0,85176358.0,118073330.0,698235000.0,,133.0,48507668.0,85620998.0,368934.0,,,2108000.0,,,,,,58551675.0,624219000.0,-6501.0,,28.98,94411863.0,,8379352.0,,94501014.0,,10030,,,,,9698294.0,,2404142.0,3802997.0,,,14700872.0,,,,4499894.31,160.0,,3007683.0,219286336.0,8038907.0,,,,,,1880.0,734302055.0,,,,,13798094.0,,60494497.0,8141437.0,,,,849336.0,31.13,,6.0,,235432.0,1579251.0,,1736.0,,,3267565.0,2396414.0,,12678829.0,,,,,N,-78707.0,84364155.0,,,14270849.0,29711.0,,971637.0,,35273574.0,705709.0,,,,,,2686121.0,,278860.0,,1010.0,772424330.0,,154805718.0,8177756.0,,144816.0,,,,,24926122.0,,,,,,22077228.0,,,,41.77,,,,,,,,,,,1703180.0,,,,,17401878.0,25.18,,241380.0,,,15643.0,3518634.0,,,,68374.0,2074541.0,1585.0,10206136.0,51411.0,,90226.0,260.73,,,,,,,2040527.0,,,381772.0,54672058.0,24154847.0,,,,387322.0,,6213213.0,,4648976.0,,,,1378859.0,,404926.0,,63964090.0,22770.0,,,,219286336.0,157752.0,435058.0,1212.0,71568.0,,,,3723.0,,27.0,,,,,,,967869.0,2079285.0,3901225.0,1800952.0,20035.31,,403587.0,,8229574.0,,2028287819.0,,8860638.0,,,,209996520.0,,1.0,Y,,27714.0,1918116.0,487851399.0,,,33856.0,170984.0,,13068589.0,,129367080.0,,359113.0,20734.0,,2396414.0,,725595910.0,457799.0,,,381313.0,,1585.0,,21605185.0,,734302055.0,,15302221.0,8317117.0,246.0,,86140.0,,,,,49936140.0,,2377.0,-772596934.0,,,575.0,,880779.0,,,7243046.0,887981.0,,12763374.0,5834573.0,,,13946.0,43216129.0,6205104.0,,,7368710.0,2031158.0,68.26,,,213932825.0,448515.0,,884023.0,376000.0,,,,2747934.0,46445451.0,,,,,,,12091564.0,,,,194899138.0,433701.0,209287.0,,,,6199896.0,1726246.0,,,,84364155.0,2292608.0,116270.0,,,,,213932825.0,,,,,997197.0,,,,4799969.0,9832.0,,,,74185738.0,-12827616.0,2008485.0,,,2958057.0,74272.0,,,,,64173315.0,,,997197.0,,,,15053.0,12118764.0,2150802.0,,8581940.0,,22308.0,,1568721690.0,,46468450.0,1246698.0,65254724.0,7507153.0,2134537.0,,11279151.0,,,62379580.0,,,,,,,,5777631.0,2155556.0,,12186.0,,,,,,33S106,,,,,,6639903.0,,,228306017.0,997197.0,23259129.0,,Y,,,,,,,,,,,,,1.0,,,11034143.0,,239122.0,,292771.0,100623625.0,,,,,,,,,2433107273.0,,,,347384.0,,1.0,22077228.0,,,,,,,,482498.0,19604.0,,,,47881887.0,726057,14270849.0,,2681000.0,,750172.0,30.79,34206.0,7172594.0,,2325296.0,,,47881887.0,,3501.0,,,,4698896.0,,17867459.0,90735.0,,,,13362.0,4103.0,8134217.0,,5877068.0,806851.0,,,,,,,246.0,,,9902350.0,,35147334.0,,,118291000.0,1957.0,3662543.0,4880.0,,96820357.0,9431444.0,,3332992.0,737507.0,,1077143000.0,,3764.0,,11279151.0,,,274601.0,,,,,,62003.0,,,,Y,,,,-2061270.0,611.0,,101738.0,,,-14574707.0,17867459.0,,,,,,12418.0,,,,,25829664.0,20649.0,,,,,,,,,44615329.0,36481.0,,,,7299378.0,,,N,,,13001,,,,,12837923.0,2706518.0,,,,4332542.0,,,,569.0,,3088359.0,,,10667.0,,1492629.0,,694287.0,171118.0,,1534250.0,,308914.0,,,,,,,3125152.0,,,,12029827.0,,,55399521.0,7584948725.0,,,,-61661.0,,,128324696.0,,,,,3298665.0,,,4841829.0,24336397.0,,,,26971439.0,,,,,,8860638.0,9352.0,6641326.0,,17155.0,18468470.0,229318.0,26955670.0,,,,,,,,,335702,,,,,,,,,2096009.0,,,,-802674.0,,18607.0,,75.51,,9228613.0,6021238.0,750172.0,87.0,23674926.0,,,,14075715.0,105061298.0,504094.0,43311.0,55585039.0,15302221.0,,,,,,,,4819764.0,,422809.0,,330106,24698726.0,,,,,6206283.0,,,,,,,,319581.0,26955670.0,,6196276.0,24615277.0,,,,37562011.0,,,,,,52.18,,,,,319581.0,,,60341.0,1236554.0,,,,,,1314249.0,,690436.0,,2292608.0,,,,,,Y,7049.0,5146.0,,1566999.0,90735.0,,24839191.0,,,,,,,,,,8860638.0,,,27724.0,319581.0,,,5576821.0,,,,-80986.0,,,,2458429.0,,958.0,,51769849.0,,,,46.37,N,12818036.0,,235432.0,,4965460.0,,,39.07,,1340865.0,,113775289.0,,N,,,,,,,1468.0,1236554.0,50979628.0,,4916.0,,7894410.0,,,,316208.0,,,-557847419.0,,,,71422123.0,,,,,,53657668.0,23740693.0,,,,17156931.0,,,23174490.0,,,,,,124.0,,,7172594.0,,,,,5380,,,,,,2655989818.0,,5445158.0,,48383822.0,5475.0,,,13698.0,,,,,,,,3723.0,,1965301.0,,,,,,,,56558706.0,,,7180069.0,,,,,2090708.0,,,870658.0,,,,,-102023.0,,169714351.0,17400882.0,46468450.0,9740611.0,1055206.0,4875.0,2562453.0,,,292820495.0,11381546.0,,21967.0,228.0,1183104.0,,2249627.0,-420451.0,,11288966.0,,,732267.0,547740.0,18016743.0,,,,-13368773.0,,5877068.0,,,,750172.0,,228308.0,,2083069.0,Y,,,,,848524667.0,,24.77,,,,,,,14207321.0,,11.0,,392935.0,,,,,,58867025.0,2505315.0,46211828.0,,,,96820357.0,82276.0,,,2018-12-31,,945632418.0,56549.0,,,3668156.0,,5462796.0,,,14476.0,,,3053584.0,,,,,322069062.0,,67954.0,,,,,,,,,313055837.0,,,10778.0,,,881425.0,14075715.0,,13716730.0,67315679.0,260542.0,,,43281488.0,,14600.0,,271144.0,,,,,973536.0,399065.0,5508845.0,,,124635975.0,20010000.0,33033.0,,1726246.0,-774461384.0,,4880.0,,,17401878.0,,-85471000.0,,16366337.0,10213268.0,9589.0,877588.0,,,2877885.0,,,65549.0,576242.0,,,,NORTH SHORE UNIVERSITY HOSPITAL,54880.0,2.0,83712.0,362049353.0,,,,,,,,,,,3229862.0,129590.0,,,,,,3464509.0,354545285.0,,,P,12106.0,,,,,,,,,-2061270.0,57.28,32.62,3703231.0,,37396747.0,143021485.0,,12174878.0,37083.0,,,N,,150232289.0,50.74,,,,,,,,,,,24310974.0,,,,,,44095.0,12548284.0,,,431366.0,,,,,,-3645335.0,,,,,-3139000.0,,3518634.0,,,,-2182526.0,-3695152.0,611478.0,MANHASSET,,,,20.0,174945496.0,78878.0,,,23987333.0,35004,,,1250144.0,35597104.0,,9611605.0,,,,56803254.0,,9669863.0,808194038.0,14991.0,,,707024.0,,15643.0,,,,247874.0,,4785776.0,50436882.0,,,-922124488.0,,,,888323.0,,,,,,,,,25560.0,,,,23213599.0,224520257.0,1189523.0,,,20055327.0,,6095222.0,,6286.0,4505053.0,12818036.0,81365.0,,,,3930980.0,,,,,2491697.0,230547.0,6846000.0,11288966.0,,369669.0,149713.0,,-9152.0,35.36,,,,,,,,24009794.0,18691426.0,,848030805.0,,3240661.0,,,,,,10667.0,,,124730204.0,,,,337148,1560315.0,,23213599.0,,,115578293.0,,,1314249.0,,,,,,337.0,,,2720756.0,482498.0,,176149255.0,46532.0,,2233759.0,,,14957.0,,39402.0,,7295815.0,,,459687.0,,223015.0,1259847.0,,2668221.0,39.0,,378908000.0,86348.0,,80.22,,,4035005.0,,,,932324433.0,,,698235000.0,5151841451.0,,,,,,,,,,,,2428572237.0,,,653641.0,19285213.0,67315679.0,,,,55585039.0,,,84105578.0,,,,19283.0,,145047244.0,,845867.0,,,,33400,7678.0,,,,1149687000.0,,7580413688.0,,,14935.0,1408607.0,F,,,,,3126503.0,59173448.0,,1715293.0,793053.0,,,,,,,,21091.0,,,,2457.0,1190481.0,122928757.0,,18295722.0,,324133459.0,,,5576821.0,,,,,,,,,-16034394.0,,,,,,144816.0,18468470.0,55399521.0,,235801.0,352296.0,,,,1123570.0,,1299961660.0,295.0,,,,135362097.0,1016309000.0,,,,,2301725.0,49140525.0,1537623.0,,,,94444896.0,58970223.0,24926122.0,,21521.0,,,,5241.0,,,27465301.0,,15626558.0,,,,,,,-256427.0,,83282028.0,,,,,,223015.0,14700872.0,,,,1428423.0,3818053.0,N,,,48055703.0,40907762.0,,,,,1154551.0,,851453.0,465580.0,,,,1309928.0,,,,,,,,,,,3464509.0,75.0,,,3354595.0,,,36701193.0,,,15.0,,,,445668797.0,19732364.0,,3720825.0,122840000.0,126926000.0,,,,,937950.0,,,,,,,,,21160347.0,,,,9902350.0,,56803254.0,,138332000.0,,2022-10-06 00:00:00,,20391862.0,,11245774.0,316024691.0,611.0,,,1248793.0,863990.0,,,,,2279962.0,265113.0,,,,,,,,,,,,,,,,,,,,,3007475.0,,9407831.0,,,,,,,,,50.18,,44615329.0,-41201.0,,30964278.0,,,,,,,,80.22,,917344.0,,,17569514.0,3854.0,,537819.0,,4924610.0,3747946.0,35864526.0,,2053792.0,212001379.0,,,6428197.0,85827000.0,,,,,1010.0,,324320699.0,12084.5,,15000.0,5445158.0,,,,1629090620.0,47.0,,527530.0,43281488.0,,2244393000.0,56494339.0,3768.0,222498516.0,5697020804.0,,,100623625.0,39728.0,,,,,,,,,59179346.0,104544.0,624219000.0,45443097.0,,,,,,,18217141.0,84105578.0,,,,,51.0,65546846.0,,1768207.0,37060.0,,1800.0,114785000.0,,,,900204.0,,,15053.0,,,,,,,20636821.0,,27714.0,,,66594.0,18217141.0,28101000.0,1573.0,,,252.0,,27917720.0,,26519450.0,,11381546.0,,802674.0,,54672058.0,177632389.0,,,400729.0,,,,,71030.0,62379580.0,256.0,1999423.0,,581947.0,,,29729089.0,,,,,71341682.0,,,,,,4916.0,,Y,,,,,,100218920.0,129590.0,65797.0,14132091.0,400729.0,,,-14551835.0,,,,18716919.0,,,84268097.0,5353511.0,,12418.0,,,1356028158.0,70.6,,68769375.0,40.0,,,,,385240.0,,,,,617366.0,,593943.0,3355762.0,145854847.0,,41144264.0,,,,150859342.0,53858389.0,,294364411.0,71422093.0,,,20211783.0,,7213637.0,7813231.0,,13424219.0,,,,,,,11046079.0,80082322.0,33223782.0,45443097.0,,,31240000.0,,74496616.0,24336397.0,518.54,,4648976.0,,,9832.0,24565.0,,,,22858940.0,534265000.0,,48055703.0,,,149936.0,29619385.0,,,,7295815.0,,38736104.0,,,,,,48443.0,15069275.0,,,,,29619385.0,25718657.0,53613.0,,20636821.0,5696.0,,,,,,NY,,-31271.0,177276347.0,399065.0,24693869.0,195724.0,,228.0,1363371.0,6462.0,1356028158.0,677616.0,,,,,13698.0,37849722.0,11054.52,,11650.0,,NASSAU,115578293.0,,779612.0,23492.0,444072.0,,348119.0,3175422.0,,9335097.0,,,13716730.0,,,6515.0,300 COMMUNITY DRIVE,,,,,,,,,857010.0,71726270.0,,,80082322.0,,,,445668797.0,861079.0,,,,,,53.62,,,1395456.0,,33,1112.0,,283762.0,187154.0,4346936.0,-2675069.0,,52188.0,,,,,,376000.0,,,105102.0,,,,59179346.0,,,683437.0,,,,,,Y,,3303961.0,11034143.0,,,46445451.0,15685.0,,10157717.0,903843.0,,,694287.0,11908000.0,,25616133.0,2956975.0,,,,1765320.0,84268097.0,509499.0,,1570150113.0,,1733865330.0,,,4055937.0,,1190481.0,,,,31043407.0,,,,24693869.0,,,,,,,,158777680.0,,5902195.0,1314249.0,4055937.0,1736.0,9352.0,51200.0,399459.0,27384709.0,1728571.0,-47873738.0,,,,19604.0,,,7707539.0,,10244551.0,51769849.0,,83282028.0,,,,20391862.0,1883392884.0,57325.0,,2031158.0,,,,,,,,,14270849.0,,5993565.0,,,,,,,,1990.0,22029211.0,,,,,-334140612.0,,13424219.0,,,,,,,,381313.0,,-922124488.0,,,,,,140799.0,,,,,,,,2008485.0,,-2626110.0,,22406542.0,,-31319.0,,,,,,123044840.0,,,,,,5151841452.0,,1412063.0,193574.0,,,49820134.0,,11274364.0,16900061.31,,470487000.0,,555245.0,81636.0,24565.0,,1103591.0,33251566.0,1040.0,,144407806.0,,188748.0,,,611478.0,,,,,,20047002.0,26.24,,,,5260136.0,90735.0,71030.0,114454710.0,85988.0,21605185.0,271.78,9407831.0,11192798.0,,,,,324209.0,,,324320699.0,154805718.0,,,,37883970.0,,92430116.0,,,,,18295722.0,4015.0,,,2018-01-01 00:00:00,,,,149244627.0,,274099985.0,142852992.0,,188354000.0,,,,,11034143.0,311935.0,667736.0,,,,,,147351.0,2083069.0,,,53212304.0,,,,,,48.07,58897863.0,NSUH PSYCHIATRIC EXEMPT UNIT,5845.0,,,,92430116.0,,,,1179.0,8860638.0,228309.0,321354.0,,,10890629.0,705754.0,,,,,,,,,,,,433701.0,,,,,,,,7531.0,,22858940.0,,,,,46849912.0,12118764.0,,,,84827047.0,,,,,,,17423.0,,20227034.0,2187.0,66106177.0,,1728281.0,,149244627.0,,,,,93440.0,,,,60494497.0,,,,,135940789.0,,,2993467.0,830759.0,,,,,,,2,,2657481.0,8920255.0,,,,,,,11689846.0,1212.0,,,,,,124730204.0,,,,,,37030595.0,,,1224965.0,,,,228308.0,,308048.0,,1470512.0,,,,,698413.0,,0.20682,702962.0,,9061447.0,,,9952.0,78876325.0,,,,,,,,,,,,-69061.0,N,,7252504.0,234030.0,,,1356028158.0,,41493.0,,,2018,Acute Care Hospitals,NORTH SHORE UNIVERSITY HOSPITAL (330106)
56139,NORTH SHORE UNIVERSITY HOSPITAL (330106),General Short Term (Acute Care Hospitals),Voluntary Nonprofit-Other,-73.703029,40.779269,,04/04/2008,,,,,,,,1187924.0,245428.0,11156323.0,,12864.0,,,,340416398.0,,,536936.0,,,72321673.0,,,,,,15291615.0,662.0,,,,,59396183.0,629077000.0,,4034691.0,,,-7968747.0,-6094821.0,,,N,79825.0,1936247.0,,,439.0,,,1682.0,,10545105.0,347.61,,,,,,54864985.0,,26465013.0,,,639.0,,68778790.0,,,782.0,1491853.0,,,7149850.0,,,16245600.0,,,35.0,,,2017613.0,47000000.0,3562694.0,12298752.0,,,,,,,,,,,,474228722.0,,,1003141.0,28.75,,2099376.0,465669.0,,,4699.0,,1407328.0,,,2.0,,,10089622.0,,HB2348,,11606.0,3878714.0,,47502742.0,4652449.0,55973046.0,,6827544.0,,,,,,,,,,12864.0,,,,176933.0,,,117847003.0,,,660260.0,,,,4430990.0,,,,,,,15723187.0,,972 BRUSH HOLLOW RD,617641.0,364788.0,393907478.0,,4081476.0,,8534.0,,39525201.0,,,11372524.0,9380206.0,,,46441.0,3790.0,,,,Y,,921145.0,,3445296.0,,,,2759134.0,43192878.0,,,91470639.0,2227623.0,147630005.0,18398.0,,,-2469365.0,558101.0,,,68524954.0,5073333.0,18952.0,,18529.0,24421554.0,1504112150.0,,,23295.0,,,,,,,,46441.0,261052.0,,,18615.0,86932499.0,,60595645.0,,1130438.0,22942.0,12292450.0,,93191785.0,,,,434620.0,293459350.0,,-1537912.0,1201922.0,,78630.0,19303.0,,,400025.0,,,,963937.0,1867212.0,,,,1236.0,24091975.0,24650830.0,,,,,4188695.0,,,-49231720.0,,,,-753890.0,,,,,,,,3346988.0,,,,,,,6650368.0,,272726749.0,,,46.32,248690.0,33.66,,,,138497572.0,,WESTBURY,,,,,,15194187.0,7940095.0,,,,,-12588.0,,,,,,930371.0,618097016.0,17109.0,51.0,16514.0,76035.0,,27915413.0,7914959.0,,22000449.0,1130438.0,52185454.0,,,,27273024.0,,,,,7930248.0,,1653054.0,,61.9,,,,,44386490.0,3377229.0,,505521033.0,,40204.0,3700200.0,,,,,,,,,,,,,,N,5255296.0,11139074.0,,340669814.0,,169378698.0,,,,347.61,15072022.0,17625530.0,,359793.0,,,,,11196822.0,13815384.0,275174.0,301923136.0,36918610.0,,400025.0,,,-3522689.0,,3757219.0,,64.79,,19711083.0,,11156912.0,,58525788.0,477473048.0,,967016565.0,,,936655.0,474.98,25211.0,,,-171882383.0,General Short Term,,,24515232.0,,,556111000.0,97307646.0,129775253.0,806062000.0,,,43453366.0,107581244.0,271254.0,,,1922000.0,,,,,,59737644.0,802127000.0,12762.0,,32.37,74963621.0,,8828982.0,,91018724.0,,10030,,,,,10930003.0,,2537546.0,3610537.0,,,16048783.0,,,,4529793.0,397.0,,3273901.0,254407414.0,5016321.0,,,,,,3984.0,755816403.0,,,,,12993905.0,,68391772.0,9711967.0,,,,2771478.0,23.01,,35.0,,,2190449.0,,1861.0,,,3449538.0,7629670.0,,12235982.0,,,,,N,-34008496.0,87982419.0,,,15126820.0,29252.0,,797195.0,,38829539.0,540475.0,,,,,,1966032.0,,284116.0,,662.0,831193101.0,,145963772.0,8918413.0,,147829.0,,,,,23748673.0,,,,,,22511598.0,,,,44.26,,,,,,,,,,,1000977.0,,,,,19027175.0,27.19,,988397.0,,,15573.0,4233001.0,,,,101226.0,2189306.0,1469.0,13055233.0,54143.0,,346056.0,221.04,,,,,,,2252309.0,,,407526.0,57709554.0,55044884.0,,,,376960.0,,6815721.0,,5022494.0,,,,2259529.0,,403239.0,93581764.0,58757604.0,20944.0,,,,254407414.0,158262.0,354472.0,1218.0,59996.0,,,,3747.0,,72.0,,,,,,,795858.0,1278316.0,85214568.0,1769687.0,26763.0,,374590.0,,28122333.0,,2198595598.0,,7541262.0,,,,231049926.0,,1.0,Y,,29877.0,2227623.0,477473048.0,,,10937.0,9835846.0,,12949370.0,,146485893.0,,412446.0,15000.0,,7462718.0,,644792476.0,481726.0,,,234851.0,,1469.0,,19940657.0,,755816403.0,,15071671.0,9546040.0,310.0,,7300.0,,,,,140024028.0,,1192.0,-738428093.0,,,1237.0,,935512.0,,,4932012.0,938274.0,,12794388.0,7073504.0,,,13226.0,42121406.0,6719287.0,,,6809256.0,1959807.0,70.0,,,225085579.0,474394.0,,883145.0,379498.0,,,,2331947.0,52185454.0,57148.0,,,,,,13101570.0,,,,171070906.0,445467.0,260018.0,,,,5846766.0,1653054.0,,,,87982419.0,2428240.0,90355.0,,,,,225085579.0,,,,,816147.0,,,,6968354.0,9595.0,,2189723.0,,65635029.0,-14108493.0,1936247.0,,,2751989.0,75920.0,,,,,65068982.0,,,816147.0,,,,16384.0,13064544.0,2270781.0,,17559745.0,,4759.0,,1527258353.0,,47892402.0,1407997.0,58512562.0,8807541.0,1847752.0,,14171175.0,,,67681558.0,,,,,,,,5484756.0,2351608.0,,13268.0,,,,,95723004.0,33S106,,,,,,6998370.0,,,256232187.0,816147.0,26498542.0,,Y,,,,,,,,,,,,,,,,13570523.0,,252309.0,,107986.0,119510557.0,,,,,,,,,2524812426.0,,,,330195.0,,1.0,22511598.0,,,,,,NORTHWELL HEALTHCARE INC,,161839.0,,,,,52781797.0,730652,15126820.0,,2765000.0,,930371.0,41.16,63487.0,8778191.0,,1984195.0,,,52781797.0,,583.0,,,,4460935.0,,19711083.0,93034.0,,,,14698.0,,8075376.0,,8075584.0,15685701.0,,,,,,,310.0,,,11372524.0,2141489.0,34954677.0,,,133108000.0,326.0,3015167.0,5936.0,,97015553.0,20813679.0,,3503115.0,980339.0,,1273522000.0,,3012.0,,14171175.0,,,303115.0,,,,,,60261.0,,,,Y,,,,-2741025.0,611.0,,105366.0,,,-11064137.0,19711083.0,,,,,,23034.0,,,,,29503324.0,17559.0,,,,,,,,,26991319.0,32866.0,,,,8121203.0,,,N,,,13001,,,,,19688046.0,2801723.0,,,,4905023.0,,,,523.0,,3878714.0,,,5821.0,,2346620.0,,976875.0,122112.0,,1539689.0,,245839.0,,,,,,,3516170.0,,,,8161334.0,,,60569605.0,8171273716.0,,,,-30009.0,,,135996171.0,,,,,3317211.0,134589.0,,5030832.0,35400362.0,,,,27915413.0,,,,,,7541262.0,11130.0,8393974.0,,22411.0,19110903.0,233050.0,24897461.0,,,,,,,,,335702,,,,,,,,,2571261.0,,,,,,19972.0,,84.5,,7182008.0,7453000.0,94512135.0,81.0,24510709.0,,,,15072022.0,117284809.0,532214.0,44148.0,63394158.0,15114724.0,,,,,,,,4839080.0,,401170.0,,330106,25424695.0,,,,,6719287.0,,,,,,,,251660.0,24897461.0,,7421241.0,21844285.0,,,,91470639.0,,,,,,50.28,,,,,251660.0,,,77569.0,4081476.0,,,,,,1404472.0,,279256.0,,2428240.0,,,,,,Y,1552.0,7580.0,-4761175.0,1678738.0,93034.0,,25191793.0,,,,,,,,,,7541262.0,,,35697.0,251660.0,,,5238424.0,,,,-2305.0,,,,2595366.0,,953.0,,54986180.0,,,,43.86,N,13652479.0,,218851.0,,3964918.0,,,39.71,,1262585.0,,117847003.0,,N,,,,,,,1185.0,4081476.0,48251546.0,,6415.0,,7930248.0,,,,79825.0,,,-709832163.0,,,-3993424.0,69773192.0,,,,,,50134150.0,25052115.0,,,,4629148.0,,,27873878.0,,,,,,67.0,721587.0,,8778191.0,,,,,5380,,,,,,2828868178.0,,5813981.0,,50427475.0,5475.0,,,12843.0,,,,,,,,3747.0,,5585788.0,,,,,,,,81347935.0,,,7357474.0,,,,,2708995.0,,,83706.0,,,,,-102023.0,,168796894.0,50886614.0,47892402.0,9247819.0,1614487.0,4699.0,514408.0,,,339948194.0,13312461.0,,6254.0,,1049021.0,,2582509.0,-6540416.0,,11922863.0,,,96816.0,575506.0,25825741.0,,675216.0,,-12817350.0,,8075584.0,,,,94512135.0,,231588.0,,2053780.0,Y,,,,,781788368.0,,27.44,,,,,,,16579095.0,,,,415259.0,,,,,,60514435.0,31906062.0,48392208.0,,,,97015553.0,79399.0,,,2019-12-31,,993712025.0,19296.0,,,3480990.0,,5488804.0,,,2603.0,,,3456174.0,,,,,358448509.0,,48554.0,,,,,,,4948525.0,,319578945.0,,,8534.0,,,7149850.0,15072022.0,,13078590.0,54505823.0,246553.0,,,17012396.0,,14600.0,,262843.0,,,,,322591.0,295767.0,5816249.0,,,136706302.0,20475075.0,25211.0,,1653054.0,-576671712.0,,5936.0,,,19027175.0,,-91625000.0,,17145084.0,15117705.0,10423.0,969116.0,,,1866262.0,,,49090.0,551285.0,,,,NORTH SHORE UNIVERSITY HOSPITAL,37215.0,2.0,111126.0,375110849.0,,,,,,,,,,,3415821.0,187175.0,,,,,,3503115.0,396830498.0,,,P,12593.0,,,,,,,,,-2741025.0,60.42,34.25,8288860.0,,43192878.0,154556901.0,,11139074.0,35955.0,,,N,,161071802.0,56.57,,,,,,,,,,,17146370.0,,,,,,23718.0,13449879.0,,,519196.0,,,,,,-4038716.0,,,,,112440555.0,,4233001.0,,,,-1708712.0,-3522689.0,620759.0,MANHASSET,,,,20.0,234266908.0,124430.0,,,23858668.0,35004,,,1186797.0,320527142.0,,9339605.0,,,,42685352.0,,11023596.0,1058955235.0,15333.0,,,746414.0,,15573.0,,,,281657.0,,5216816.0,52105086.0,,,-1147221973.0,,1377187.0,03/11/2019,1050931.0,,,,,593239.0,,,,18952.0,,,,24421554.0,231671034.0,1375974.0,,,15240731.0,,5226733.0,,6009.0,8236819.0,13652479.0,122005.0,,,,3115938.0,,,,,2032879.0,163031.0,6846000.0,11922863.0,,390291.0,157227.0,,-3993932.0,46.07,,,,,,,,22269982.0,22365119.0,,767583352.0,,3694051.0,,,,,,5821.0,,,137129760.0,,,,337148,2433109.0,,24421554.0,,,129353084.0,,,1404472.0,,,,,,298.0,,,3051186.0,161839.0,,169496733.0,49936.0,,554309.0,,,470122.0,,41621.0,,6865713.0,,,484776.0,,223015.0,1329738.0,,3170286.0,,,467460000.0,87264.0,,83.59,,,4455658.0,,,,1037313793.0,,,806062000.0,5646461290.0,,,,,,,,,,,,2524812426.0,,,620561.0,18475559.0,54505823.0,,,,61883551.0,,,115238231.0,,,,,,31348680.0,,1699368.0,,,,33400,6648.0,,,,1284151000.0,,8171273716.0,,17181.0,9185.0,1550874.0,F,,,,,779357.0,53299055.0,,1843029.0,754285.0,,,,,,,,14333.0,,,,2301.0,2844261.0,136995892.0,,17073568.0,NY,294946175.0,,,5238424.0,,,,,,,,,-11237975.0,,,,,13257194.0,147829.0,19110903.0,60569605.0,,468087.0,366397.0,,,,1659802.0,,1333702136.0,433.0,,,,148916324.0,1113628000.0,,,,,2539875.0,56008067.0,588580.0,,,,74988832.0,59730173.0,23218816.0,,20463.0,,,,46245.0,,,27915413.0,,19076692.0,,,,,,,-130526381.0,,84998055.0,,,,,,223015.0,16048783.0,,,,2137137.0,3695205.0,N,,,49620476.0,52967050.0,,,,,918270.0,,883702.0,455585.0,,,,1359541.0,,,,,,25759141.0,,,,,3503115.0,92.0,,,3243791.0,,,39890163.0,,,15.0,,,,559146453.0,16245600.0,,3700200.0,131041000.0,161760000.0,,,,,1620660.0,,,,,,,,,7889173.0,,,,11372524.0,,42685352.0,,145076000.0,,2022-10-07 00:00:00,,18277225.0,,11929880.0,334792794.0,611.0,,,1219961.0,947221.0,,,,,3602164.0,252821.0,,,,,,,,,,,,,,,,,,,,,2053437.0,,17625530.0,,,,,,,,,48.99,,26991319.0,487570.0,,41064708.0,,,,64088646.0,,,,62.06,,773193.0,,,18444031.0,17471.0,,1238438.0,,5155341.0,4164611.0,39529405.0,,2102178.0,132420903.0,,,7251041.0,107772000.0,,,,,1462.0,,340669814.0,12988.3,,14000.0,5813981.0,,,,1578144548.0,65.0,,598690.0,28984259.0,,2546248000.0,54931591.0,1337.0,261990772.0,6080833631.0,,,119510557.0,177375.0,,,,,,,,69.27,67234099.0,,802127000.0,49633781.0,,,,,,,19159480.0,115238231.0,,,,,51.0,66259864.0,,490162.0,129568.0,,6702.0,29312000.0,,,,953565.0,,,16384.0,,,,,,,20035644.0,,29877.0,,,69272.0,19159480.0,28057000.0,411.0,,,274.0,,31815956.0,,13646161.0,,13312461.0,,-12588.0,,57709554.0,177291026.0,,,298244.0,,,,,19619.0,67681558.0,,1328054.0,,683937.0,,,38731956.0,,,,,71053372.0,,,,,,6415.0,,Y,,,,,,81894676.0,187175.0,62985.0,15353879.0,298244.0,,,-12298839.0,,,,20646595.0,,,72471192.0,3562694.0,,23034.0,,,1495166042.0,84.56,,71886959.0,40.0,,,,-24697886.0,283484.0,,77345840.0,,,676836.0,,543199.0,3524059.0,169378698.0,,28487816.0,,,,169729379.0,30799405.0,,297213826.0,65154495.0,,,23572811.0,,6854721.0,8110738.0,,12398866.0,,,,,,,12701002.0,60235669.0,45035160.0,49633781.0,,,28828000.0,,68738073.0,35400362.0,533.84,,5022494.0,,,9595.0,31991.0,,,,23795651.0,492003000.0,,49620476.0,,,159007.0,30552349.0,,,,6865713.0,,208086587.0,,,,,,41800.0,15168677.0,,,,,30552349.0,25318646.0,23354.0,,20035644.0,4538.0,,,,,,NY,,-180204.0,185339930.0,295767.0,27526267.0,369779.0,,,3139645.0,3790.0,1495166042.0,564487.0,,,,,12843.0,39962072.0,11938.51,,20096.0,,NASSAU,129353084.0,,810193.0,,460195.0,4699.0,399450.0,2986570.0,,2530906.0,,,13078590.0,,,4924.0,300 COMMUNITY DRIVE,,,,,,,,,830871.0,65442549.0,,95723004.0,60235669.0,,,121.0,559146453.0,-1036915.0,,25759141.0,,,,55.48,,,2106742.0,,33,180.0,,284836.0,1404274.0,4126625.0,-3611434.0,,51645.0,,,,,,379498.0,,,,,,,67234099.0,,,624970.0,,,1060900.0,,,Y,,4067305.0,13570523.0,,,52185454.0,20800.0,,10457741.0,2130412.0,228.0,,976875.0,11908000.0,,29369969.0,2028671.0,,,,1616593.0,72471192.0,512089.0,,1529395490.0,,1681646205.0,,,1867212.0,,2844261.0,,,,35111861.0,,,,27526267.0,,,,,,,,160560499.0,,6617450.0,1404472.0,1867212.0,1861.0,1522934.0,34366.0,403154.0,29501174.0,2553541.0,-62660968.0,,,,,,,5869837.0,,9489746.0,55038694.0,,84191275.0,,1381965.0,,18277225.0,2090440085.0,194834.0,,1959807.0,,,,,,,,,15126820.0,,4430990.0,93581764.0,,,,,,,10878.0,27991137.0,,,,,-413942556.0,,12398866.0,,,,,,,,234851.0,,-1147221973.0,,,,,11590,64955.0,,,,,,,,1936247.0,,-2735226.0,,22000449.0,,,,,,,,130840809.0,,,,,,5646461290.0,,1491357.0,159172.0,,,71278040.0,,13011437.0,15669679.0,,459970000.0,,535992.0,364788.0,31991.0,,1245332.0,34411527.0,802.0,,147630005.0,,196851.0,,,620759.0,,,,,,18341528.0,26.25,,,,5795964.0,93034.0,19619.0,126584474.0,342467.0,20009441.0,217.24,17625530.0,181161891.0,,,,,315829.0,,,340669814.0,145963772.0,,,,26465013.0,,108072347.0,,,,,17073568.0,,,,2019-01-01 00:00:00,,,,81850687.0,,298663477.0,150420242.0,,193463000.0,,,,,13570523.0,406858.0,769270.0,,,,,,155065.0,2053780.0,,,37813780.0,,,,,,47.67,81393403.0,NSUH PSYCHIATRIC EXEMPT UNIT,5490.0,,,,108072347.0,,,,,7541262.0,4604187.0,87405.0,,,11480306.0,1287244.0,,,,,,,,,,,,445467.0,,,,,,,,8166.0,,23795651.0,,,,,48609797.0,13064544.0,,,,28923557.0,,,,,,,18529.0,,44089521.0,14204.0,59396264.0,,3445296.0,,76382998.0,,,,,,10649.0,,,68391772.0,,,,,149486336.0,,,3271658.0,890078.0,,,,,,,5,,2805624.0,9714767.0,,,,,,,12390075.0,1218.0,,,,,,137129760.0,,,,,,47502742.0,,,,,,,231588.0,,460930.0,,1407850.0,,,,,756594.0,,0.184073,702922.0,,12931381.0,,,,86932499.0,,,,,,,,593239.0,,13257194.0,,-24582.0,O,,7596814.0,242447.0,,,1480961026.0,,40994.0,,,2019,Acute Care Hospitals,NORTH SHORE UNIVERSITY HOSPITAL (330106)
64047,NORTH SHORE UNIVERSITY HOSPITAL (330106),General Short Term (Acute Care Hospitals),Voluntary Nonprofit-Other,-73.703029,40.779269,,04/04/2008,,,,,,,,343850.0,141402.0,12194670.0,2371.0,19296.0,,,,324284897.0,,,331285.0,,,73735955.0,,,,,,9761410.0,566.0,,,,,52098461.0,846405000.0,,2375768.0,,,-9227241.0,-4791573.0,,,N,78900.0,1847555.0,,,439.0,,,3220.0,,4550265.0,357.39,,,,,,56396341.0,,27837042.0,,,303.0,,74764926.0,,,782.0,877354.0,,,7563749.0,,,15630078.0,,,41.0,,,2684141.0,,3418374.0,9913423.0,,,,,,,,,,,,518768757.0,,,1493892.0,30.19,,172764139.0,497894.4,,,4889.0,,1389065.0,,,2.0,,,9552722.0,,HB2348,,12818.0,2289792.0,,36700138.0,4866676.0,54839138.0,,5871557.0,,,,,,,,,,19296.0,,,,184768.0,,,98258103.0,,,388610.0,,,,4926746.0,,,,,,,17887671.0,,972 BRUSH HOLLOW RD,558743.0,2686722.0,335893482.0,,4238609.0,,12485.0,,41976170.0,,,8914050.0,6779276.0,,,39927.0,3081.0,248116000.0,,,Y,,665387.0,,4305199.0,,,,2777824.0,35390381.0,,,75697093.0,2354338.0,123650453.0,17978.0,,,-4096754.0,138265.0,,,54090364.0,5134601.0,20386.0,,18378.0,25744742.0,1623466213.0,,,83440.0,,,,,,,,39927.0,187456.0,,,18666.0,70759480.0,,60681154.0,,1341670.0,10298.0,13362019.03,,71765814.0,,,,342489.0,248954738.0,,-1729919.0,783117.0,,61308.0,16819.0,,,337800.0,,,,1389311.0,909822.0,,,,1236.0,24150819.0,27418987.0,,,,,4829930.0,,,-66423444.0,,,,-2013844.0,,,,,,,,3955410.0,,,,,,,5409556.0,,137890161.0,,,47.41,174542.0,29.92,,,,142193213.0,,WESTBURY,,,,,,32731713.0,8557738.0,,,,,1.0,,,,,,572035.0,758551044.0,3509.0,51.0,29006.0,91235.09,,26514147.0,57728061.0,,23482134.0,1341670.0,55502321.0,,,,30251449.0,,,,,7317684.0,,1621789.0,,61.82,,,,,18397148.0,3175373.97,,552604379.0,,64683.0,2430600.0,,,,,,,,,,,,,,N,5502638.0,8792194.0,,324424732.0,,164836719.0,,,,867.92,16381304.0,13901266.0,,134750.0,,,,,11218040.0,14564642.03,333143.0,301049053.0,28906750.0,,337800.0,,,-2919557.0,,3914580.0,79844000.0,61.61,,21453455.0,,8969013.0,,51574962.0,396039487.0,,1100722727.0,,,680615.0,,32728.0,,,-403006897.0,General Short Term,,,,,,551120000.0,99632535.0,126057498.0,842821643.0,,146.0,32368113.0,82203389.0,170368.0,,,4316000.0,,,,,,47171020.0,839294000.0,12398.0,,32.9,79118714.0,,9228035.0,,71743290.0,,10030,,,,,10331940.0,,2559255.0,2125436.0,,,14131885.0,,,,5372855.2,977.0,,3086917.0,267644590.0,19637076.0,,,,,,1236.0,778056844.0,,,,,11931675.0,,52937644.0,9469375.0,,,,6019454.0,24.1,,40.0,,151446.0,1477604.0,,1554.0,,,3478686.0,8829099.0,,9597814.0,,,,,N,-72478456.0,69033557.0,,,15038055.0,16689.0,,457886.0,,38824898.0,337585.0,,,,,,2366421.0,,286212.0,,566.0,682790867.0,,149720854.0,8940132.0,,86248.0,,,,,30130306.0,,,,,,17706244.0,,,,46.45,,,,,,,,,,,734003.0,,,,,13070885.0,27.89,,339833.0,,,12533.0,3064625.0,,,,296461.0,2207406.0,697.0,11065474.0,51354.0,,292280.0,223.31,,,,,,,2636546.0,,,431354.0,44100146.0,67896340.0,,,,417892.58,,6465805.0,,4768246.0,,,,1697516.0,,292149.0,73955058.0,51499676.0,12233.0,,,,267644590.0,124346.0,257982.0,1287.0,15880.0,,,,3601.0,,32.0,,,,,,,456149.0,1207336.0,88157682.0,1441122.0,54986.0,,293555.0,,11888541.0,,1938968861.0,,5877683.0,,,,227370626.0,,1.0,Y,,28241.0,2354338.0,396039487.0,,,590.0,15911308.0,,14240043.0,,143928853.0,,328684.0,11475.0,,8673444.0,,766434780.0,553375.0,,,190012.0,,697.0,,23529009.0,,778056844.0,,15485615.0,7276423.0,289.0,,7320.0,,,,,198894841.0,,531.0,-1078492515.0,,,438.0,,3261627.0,,,6776692.0,945114.0,,8898360.0,4817871.0,,,8683.0,31110999.0,8087397.0,,,6399960.0,1295928.0,75.57,,,247800471.0,477693.0,,688162.0,258500.0,,,,2025997.0,55502321.0,52578.0,35000000.0,,,,,13573089.0,,,,177953682.0,63389.0,105250.0,,,,3664032.0,1621789.0,,,,69033557.0,829982.0,22141.0,,,,,247800471.0,,,,,478272.0,,,,6204940.0,9254.0,,1289805.0,,67934362.0,-18382732.0,1847555.0,,,1656882.0,72592.0,,,,,60884230.0,,,478272.0,,,,12034.0,13151288.0,2289589.0,,18496339.0,,3416.0,,1635584464.0,,37408904.0,977679.0,51566279.0,7800758.0,1180167.0,,9988024.0,,,58187267.0,,,,,,,,3229281.0,2425512.0,,7666.0,,,,,73955058.0,33S106,,,,,,6390744.0,,,293706146.0,478272.0,25803164.0,,Y,,,,-15832029.0,,,,,,,,,,,,14884594.0,,254256.0,,5550.0,122576604.0,,,,,,,,,2190471346.0,,,,254530.0,,1.0,17706244.0,,,,,,NORTHWELL HEALTHCARE INC,,242645.0,676.0,,,,38276362.0,742981,15038055.0,,2856000.0,,572035.0,35.28,27697.0,7728197.0,,1265822.0,,,38276362.0,,,,,,2626100.0,,21453455.0,73990.0,,,,13409.0,,7839336.0,,8376735.0,19470153.0,,,,,,,289.0,,,8914050.0,3523859.0,83974100.0,,,163427000.0,503.0,2793443.0,1773.0,,90932611.0,10922663.0,,3574994.0,898794.0,,1595710000.0,,3071.0,,9988024.0,,,205097.0,,,,,,94450.0,,,,Y,,,,-3359570.0,611.0,,85551.0,,,-6505092.0,21453455.0,,,,,,1215.0,,,,,28558140.0,6822.0,,,,,,,,,18789734.0,31426.0,,,,7807319.0,24507000.0,,N,,,13001,,,,,30482604.0,2659114.0,,,,3552964.0,,,,211.0,,2289792.0,,,5047.0,,-1285370.0,,886457.0,84141.0,,3993922.0,,141765.0,,,,,,,3024659.0,,,,8629232.0,,,40444783.0,7350785683.0,,,,,,,118061404.0,,,,,3388523.0,75924.0,,4159815.0,26519752.0,,,,26514147.0,,,,,,5877683.0,6323.0,10903953.0,,23790.0,13684265.0,203319.0,22224321.0,,,,,,,,,335702,,,,,,,,,3717712.0,,,,1.0,,17134.0,,81.36,,9217571.0,9658842.0,74527093.0,-116.0,25599082.0,,,,16381304.0,120495615.0,536763.0,40988.72,81088518.0,15485615.0,,,,,,,,5166699.0,,236027.0,,330106,27238634.0,,,,,8101471.0,,,,,,,,146812.0,22224321.0,,6846241.0,34822388.0,,,,75697093.0,,447.0,,,,56.77,,,,,146812.0,,,63583.0,4238609.0,,,,,,1529785.0,,370896.0,,829982.0,,,,,,Y,2177.0,3166.0,-14426933.0,1169321.0,73990.0,,25919894.0,,,,,,,,,,5877683.0,,,35374.0,146812.0,,,4154737.0,,,,-144.0,,,,2617041.0,,562.0,,50968509.0,,,,45.07,N,15140869.0,,151446.0,,5610857.0,,,40.86,,263550.0,,98258103.0,,N,,,,,,,1185.0,4238609.0,27461266.0,,5385.0,,7317684.0,,,,78900.0,,,-724984528.0,,,-8305903.0,57585341.0,,,,,,34785845.0,45956070.0,,,,58341179.0,,,17280466.0,,,,,,46.0,3186598.0,,7728197.0,,,,,5380,,,,,,2926572332.0,,10210673.0,,45455101.0,5490.0,,,9690.0,,,,,,,,3601.0,,8749020.0,,,,,,,-7659196.0,73078146.0,,,7814144.0,,,,,3080434.0,,,71282.0,,,,,-102023.0,,170772586.0,45449345.0,37408904.0,5446505.0,1203551.0,4889.0,1458446.0,305202000.0,,282182035.0,12050453.0,,22248.0,300.0,4849858.0,,2339727.0,-10041974.0,,10943131.0,,,173752.0,516259.97,29687056.0,,1809486.0,,,,8376735.0,,,,74527093.0,,202537.0,,1839762.0,Y,,,,,908383850.0,,26.04,,,,,,,9600678.0,,8.0,,418624.0,,,,,,39809621.0,33938681.0,55037994.0,,,,90932611.0,46491.0,,,2020-12-31,,1108606463.0,19296.0,,,2049145.0,,5627674.0,,,3413.0,,,3008779.0,,,,,312610438.0,,111100.0,,,,,,,6404978.0,,300615664.0,,,12485.0,,,7563749.0,16381304.0,,15020137.0,35963878.0,145431.0,,,101398757.0,,14640.0,,147484.0,,,,,200696.0,328406.0,5867153.0,,,169153234.0,15296400.0,32728.0,,1621789.0,-177028103.0,,1773.0,,,13070885.0,,-93461000.0,,18767531.0,9114589.0,,1004355.0,,,2310632.0,,,21322.0,577567.57,,,,NORTH SHORE UNIVERSITY HOSPITAL,42777.0,2.0,694665.0,311910795.0,,,,,,,,,,,17246104.0,137855.0,,,,,,3578095.0,316867648.0,,,P,12593.0,,510.53,,,,318922000.0,,,-3359570.0,62.44,41.56,7170551.0,,35390381.0,156828416.0,,8792194.0,28537.0,,,N,,172864273.0,54.66,,,-79499.0,,,,,,,,11296666.0,,,,,,20211.0,14683768.0,,,437131.0,,,,,,-4121737.0,,,,,167520044.0,,3064625.0,,,,-1876961.0,-2919557.0,638501.0,MANHASSET,,,,20.0,191333713.0,99051.0,,,22360599.0,35004,,,698545.0,327481044.0,,4521745.0,,,,49267117.0,,10364656.0,1405973559.0,15333.0,,,752495.0,,12533.0,,,,239632.0,,5050741.0,48952555.0,,,-1145438136.0,,1389420.0,02/21/2019,475745.0,,,,,2898752.0,,,,20386.0,,,,25744742.0,185051564.0,1481242.0,,,12883432.0,,5963009.0,,4637.0,12832318.0,15140869.0,70700.0,,,,2778369.0,,,,,1968373.0,115468.0,6846000.0,10943131.0,,394225.0,140581.0,,-6277789.0,39.18,,,,,,,,12457778.0,14579281.0,,906061997.0,,3963302.0,,,,,,5047.0,,,169568777.0,,,,337148,1813038.0,,25744742.0,,,105450439.0,,,1529785.0,,,,,,247.0,,,3080325.0,242645.0,,206623437.0,50081.0,,726019.0,,,290479.0,,19611.0,,4482309.0,,,389086.0,,223626.0,1316032.0,,2181486.0,1.0,,752888357.0,,,90.47,,,4610110.0,,,,1102346910.0,,,195939643.0,5160934027.0,,,,,,,,,,,,2190471346.0,,,365961.0,22558310.0,35963878.0,,,,79494718.0,,,85502120.0,,,,,,14452188.0,,2290424.0,,,,33400,50053.0,,,,1542080000.0,,7351405373.0,,1241.0,2542.0,1130642.0,F,,,,,2767955.0,45611953.0,,1787970.0,443445.0,,,,,,,,11248.0,,,,2301.0,2955995.0,141949070.0,,15896434.0,NY,319951196.0,,,4154737.0,,,,,,,,,-18393805.0,,,,,,86248.0,13684265.0,40444783.0,,258289.0,645585.0,,,,1597464.0,,1328143051.0,119.0,,,,121249972.0,1132523000.0,,,,,2272200.0,54929622.0,351478.0,,,,79151442.0,55343664.0,29830894.0,,9616.0,,,,48179.0,,,28836001.0,,24339781.0,,,,,,,-179932446.0,,97608951.0,,,,,,223626.0,14131885.0,,,,1247790.0,4083763.0,N,,,52039761.0,36050203.0,,,,,,,532066.0,326482.0,,,,818563.0,,,,,,16425745.0,,,,,3578095.0,35.0,,,2943799.0,,,32688687.0,,,15.0,,,,579483976.0,15630078.0,,2430600.0,147823000.0,56373000.0,,,,,1882649.0,,,,,,,,,12722905.0,,,,8914050.0,,49267117.0,,162060000.0,,2023-05-24 00:00:00,,12336355.0,,12543431.0,82219467.0,611.0,,,999141.0,805435.0,,,,,2725539.0,149007.0,,,,,,,,,,,,,,,,,,,,,2448487.0,,13901266.0,,,,,,,,,54.79,,18789734.0,106960.0,,26996588.0,,,,,,,,61.97,,670610.0,,,18426578.0,10867.0,,1586275.0,,4602774.0,5140891.0,43406163.0,,2311506.0,210807841.0,,,7531664.0,117279000.0,,,,,782.0,,324424732.0,13263.1,,14000.0,10210673.0,,,,1703429246.0,65.0,,652525.0,108397764.0,,2904046000.0,56481104.0,1290.0,255287899.0,5503325556.0,,,122576604.0,175890.0,,,,,,,,62.2,51319645.0,,534092000.0,44061527.0,,,,,,,18691696.0,85502120.0,,,,,51.0,53134105.0,,2981731.0,75450.0,,10270.0,,,,,9996984.0,,,12034.0,,,,,,,18597980.0,,28241.0,,,22539.0,18691696.0,27990000.0,319.0,,,46.0,,22242300.0,,24785256.0,,12050453.0,,,,59932175.0,141935106.0,,,329888.0,,,,,56913.0,58187267.0,,1817772.0,,769709.0,,,10611159.0,,,,,52558714.0,,,,,,5385.0,,Y,,,,,,82016257.0,137855.0,58924.08,16209635.0,329888.0,,,-6901958.0,,,,24399062.0,,,55681494.0,3418374.0,,1215.0,,,1598429281.0,70.42,,48723671.0,40.0,,,,-36898861.0,230307.0,,,,,666028.0,,313591.0,3587227.0,164836719.0,,80701778.0,,,,139767652.0,43058990.0,,286036383.0,54973973.0,,,7474485.0,,6189263.0,8238643.0,,9119111.0,,,,,,,8094506.0,60686579.0,47761824.0,44061527.0,,,66305000.0,,82906281.0,26519752.0,487.1,,4768246.0,,,9254.0,56502.0,,,,24019275.0,550640000.0,,52039761.0,,,160515.0,24406991.0,,,,4482309.0,,159961000.0,,,,,,8352.0,16424704.0,,,,,24406991.0,24138460.0,16884.0,,18597980.0,3364.0,,,,,,NY,,-14445.0,183271341.0,328406.0,28200005.0,209972.37,,300.0,4214271.0,3081.0,1598429281.0,331460.0,44.0,,,,9690.0,40297032.0,12776.0,,27089.0,,NASSAU,105450439.0,,829456.0,1102.0,459121.0,357.0,274767.0,2751013.0,,4061362.0,,,15020137.0,,,2132.0,300 COMMUNITY DRIVE,,,,,,,,,527039.0,55154185.0,,73955058.0,60686579.0,,,1062.0,579483976.0,147975.0,,16425745.0,,,,55.76,,,2765216.0,,33,,,255945.0,386940.0,2429411.0,-2511588.0,,54853.25,,,,,,258500.0,,,17647.0,,,,51319645.0,,,658429.0,,,1069934.0,,,Y,,2829886.0,14870550.0,,,55502321.0,15923.0,,12933933.0,1921170.0,2184.0,,886457.0,11908000.0,,27176551.0,3763302.0,,,,2402099.0,55681494.0,376070.0,,1636832254.0,,1781134196.0,,,909822.0,,2955995.0,,,,32914981.0,,,,28200005.0,,,,,,,,123242113.0,,7122843.0,1529785.0,909822.0,1554.0,1202623.0,13443.0,497053.77,44800766.0,2457637.0,-70660971.0,,,,676.0,,393305.0,3387800.0,,12258038.0,50968509.0,,97266771.0,,1189027.0,,12336355.0,1848079817.0,3120981.0,,1295928.0,,,,,,,,,15038055.0,,4926746.0,73955058.0,,,,,,,19845.0,28117466.0,,,,,-402857544.0,,9119111.0,,,,,,,,190012.0,,-1145438136.0,,,,,11590,30137.75,,,,,,,,1847555.0,,-2928925.0,,23482134.0,,-316020.0,,,,,,127664002.0,,,,,,5160314337.0,,1088643.0,91230.0,,,58275634.0,,11687546.0,16537393.0,,522672000.0,,373190.0,2686722.0,56502.0,,927821.0,31205204.0,802.0,,123650453.0,,312774.0,,,638501.0,,,,,,9373227.0,27.52,,,,7372107.0,73990.0,56913.0,125565779.0,225600.0,23602291.0,185.7,13901266.0,283626483.0,,,,,303149.0,,,324424732.0,149720854.0,,,,27837042.0,115338000.0,77144921.0,,,,,15896434.0,2928.0,,,2020-01-01 00:00:00,,,,158077637.0,,256151797.0,162130235.0,,186681000.0,,,,,14884594.0,476887.0,770060.0,,,,,,156663.0,1839762.0,,,25054732.0,,,,,,66.21,68084619.0,NSUH PSYCHIATRIC EXEMPT UNIT,1141.0,,,,77144921.0,,,,14074.0,5877683.0,4383298.0,82066.0,,,11448347.0,706901.0,,,,,,,,,,,,63389.0,,,,,,,,7136.0,,24019275.0,,,,,60098332.0,13151288.0,,,,91979702.0,,,,,,,18378.0,,48500716.0,11928.0,52098345.0,,4305199.0,,155760328.0,,,,,,64683.0,,,52937644.0,,,,,147510953.0,,,3071944.0,588205.0,,,,,,,5,,2828921.0,9321543.0,,,,,,,13002552.0,1287.0,,,,,,169568777.0,,,,,,36700138.0,,,,,,,202537.0,,704149.0,,1065280.0,,,,,750852.0,,0.220856,705755.0,,15820390.0,,,1635.0,70759480.0,,,,,,,,2898752.0,,,,-20272.0,P,,6641617.0,263360.62,,,1598429282.0,,,,,2020,Acute Care Hospitals,NORTH SHORE UNIVERSITY HOSPITAL (330106)
69946,NORTH SHORE UNIVERSITY HOSPITAL (330106),General Short Term (Acute Care Hospitals),Voluntary Nonprofit-Other,-73.703029,40.779269,,04/04/2008,,,,,,,,,260388.0,16794865.0,,20280.0,,,,326064181.0,,,678077.0,,,91993611.0,,,,,,14428173.0,545.0,,,,,67272542.0,787024000.0,,2800704.0,,,-13528467.0,-3757931.0,,,N,,1918196.0,,,94.0,,,287.0,,2186090.0,364.38,,,,,,54396849.0,,41374257.0,,,289.0,,84589064.0,,,782.0,1035428.0,,8919.0,10961657.0,,,15947817.0,,,,,,2864258.0,203000000.0,3317792.0,11402370.0,,,,,,,,,,,,632891579.0,,,1343215.0,32.49,,188408281.0,499898.09,,,6009.0,,1250686.0,,,2.0,,,12192434.0,,HB2348,,8525.0,3031860.0,,80763419.0,5700944.0,50183462.0,,5410099.0,,,,,,,,,,20280.0,,,,208446.0,,,119089611.0,,,458371.0,,,,5976136.0,,,,,,,20613445.0,,972 BRUSH HOLLOW RD,596967.0,19495.0,373054351.0,,3615910.0,,14451.0,,45441899.0,,-171.0,12076493.0,6982257.0,,,44467.0,4869.0,131344000.0,,,Y,,1077185.0,,3920321.0,,,,2950176.0,42117149.0,,,169939596.0,2273239.0,142596947.0,13012.0,,,-5718947.0,199923.0,,,72175423.0,8023022.0,14701.0,,16901.0,26024489.0,1594795591.0,,,5465.0,,,,,,,,44467.0,358083.0,,,18615.0,86086615.0,,64550783.0,,2251643.0,,20645398.99,,100782597.0,,,,246901.0,336421147.0,,-2067964.0,3510881.0,,83740.0,13029.0,,,717600.0,,,,1935313.0,355451.0,,,,399.0,11209068.0,27943906.0,,,,,6941321.0,,,-294073820.0,,,,-1734949.0,,,,,,,,4046036.0,,,,,,,8761818.0,,115746902.0,,,53.3,350197.0,31.24,,,,213629351.0,,WESTBURY,,,,,,31549544.0,8942529.0,,,,,,,,,,,2536246.0,1104813433.0,2100.0,3.0,7922.0,87823.74,,312509.0,32463452.0,,21894321.0,2251643.0,47256359.0,,,,33852566.0,,,,,7195580.0,,1384546.0,,60.89,,,,,16963236.0,2764603.96,,573067243.0,,53466.0,3522600.0,,,,,,,,,,,,,,N,5743284.0,7941859.0,,326265525.0,,202452606.0,,,,364.38,16931049.0,16914990.0,,68937.0,,,,,12475474.0,21877863.28,382680.0,304336872.0,21711860.0,,717600.0,,,-2822891.0,,4202526.0,,63.45,,18905431.0,,10174267.0,,67049538.0,502205446.0,,1554710271.0,,,974061.0,430.12,41073.0,,,-461660749.0,General Short Term,,,,,,658787000.0,111885229.0,120394843.0,830277000.0,,98.0,60212794.0,61696251.0,195244.0,,,3724000.0,,,,,,52891286.0,950600000.0,-1296.0,,33.87,91355413.0,,10071838.0,,100745452.0,,10030,,,,,10182258.0,,1780970.0,2672469.0,,,12169287.0,,,,5485053.33,1155.0,,4580085.0,373182801.0,7424740.0,,,,,,,793587688.0,,,,,9892117.0,,60431463.0,10109399.0,,,,6763522.0,24.84,,,,108250.0,1832522.0,,1636.0,,,2421182.0,3074752.0,,11491316.0,,,,,N,-54816524.0,93143688.0,,,16319842.0,20463.0,,932050.0,,38773844.0,958202.0,-336.0,710640.0,,,,,,285430.0,,545.0,820546263.0,,151852218.0,9536739.0,,95588.0,,,40907328.0,,29024403.0,,,,,,20018352.0,,,,50.39,,,,,,,,,,,2323903.0,,,,,16005395.0,28.59,,261560.0,,,10712.0,3482280.0,,,,290906.0,1537204.0,,9287097.0,62333.0,,329646.0,214.54,,,,,,,3375862.0,,,437156.0,62185092.0,68589126.0,,,,410185.69,,7657059.0,,4760736.0,,,,3690282.0,,626004.0,74177791.0,65612388.0,29470.0,,,,373182801.0,93432.0,496328.0,1307.0,105311.0,,,,3587.0,,,,,,,,,887171.0,3040128.0,92483804.0,1281005.0,13502.11,,742919.0,,17479286.0,,2329593187.0,,,,09/14/2021,,286778320.0,,1.0,Y,,30177.0,2273239.0,502205446.0,,,,13342451.0,,14120102.0,,160219315.0,,406866.0,9977.0,,2934749.0,,1140218163.0,563945.0,,,2223806.0,,,,18872852.0,,793587688.0,,15635411.0,12480725.0,,,,,,,,200175847.0,,,-1072680798.0,,,,,1313513.0,,,6893764.0,658430.0,,14447659.0,8074885.0,,,8936.0,38063427.0,6895012.0,,,5897937.0,634068.0,71.06,,,349572662.0,333119.0,,763876.0,350383.0,,,,2022585.0,47256359.0,,,,,,,14954529.0,,,,259461101.0,179395.0,,,,,3443610.0,1384546.0,,,,93143688.0,3822734.0,,,,,,349572662.0,,,,,946751.0,,,,6188557.0,8060.0,,1519719.0,,78962968.0,-19585891.0,1918196.0,,,2241398.0,73934.0,,,,,44365998.0,,,946751.0,,,,13207.0,14478323.0,1699425.0,,21282457.0,,4898.0,,1610498051.0,,43977799.0,1623995.0,67040602.0,9392329.0,658135.0,,10452417.0,,,65553645.0,,,8919.0,,,,,3807484.0,2513020.0,,,,,,,74177791.0,33S106,,,,,,7825993.0,,,366692847.0,946751.0,25167244.0,,Y,,,,,,,,,,,,,,,,14097883.0,,176969.0,,,50437595.0,,,,,,,,,2699794692.0,,,,272632.0,,1.0,20018352.0,,,,,,NORTHWELL HEALTHCARE INC,,257040.0,3952.0,,,,42109198.0,742148,16319842.0,,3356000.0,,2536246.0,33.78,,11313871.0,,2999017.0,,,42109198.0,-1990466.0,,,,,3096735.0,,18905431.0,83166.0,,,,13029.0,2310.0,11952215.0,,8262937.0,16805787.0,,,,,,,,,,12076493.0,31235757.0,91898194.0,,,151120000.0,1187.0,2790584.0,,,61067752.0,10998344.0,,3528030.0,765304.0,,1661324000.0,,3090.0,,10452417.0,,,274059.0,,,,,,40311.0,,,,Y,,,,-3324449.0,611.0,,95588.0,,,-1136736.0,18905431.0,,,,,,151035.0,,,,,29329707.0,,,,,,,,,,20454912.0,24542.0,,,,10113833.0,,,N,,,13001,,,,,31341835.0,2258798.34,,,,5310515.0,,,,964.0,,3031860.0,,,3758.0,,-1439641.0,,925786.0,95342.56,,4956118.0,,264752.0,,,,,,,,,,,12143510.0,,,45685062.0,8776310800.0,,,,,,,120456803.0,,,,,3769054.0,,,5823269.0,20310010.0,,,,312509.0,,,,,,,14263.31,8559974.0,,23725.0,19783629.0,225261.0,27505955.0,,,,,,,,,335702,,,4961.0,,,,,,4164290.0,,,,,,19283.0,,269.29,,9185933.0,11196661.0,76714037.0,-214.0,26612769.51,,,,16931049.0,113948852.0,373891.0,41274.1,65147655.0,15635411.0,,,,,,,,5689825.0,,278297.0,,330106,27367368.0,,,,,6880764.0,,,,,,,,268510.0,27505955.0,,6846241.0,33849808.0,,,,169939596.0,,44879.0,,,,53.51,,,,,268510.0,,,118294.0,3615910.0,,,,,,1574530.0,,-119249.0,,3822734.0,,,,,,Y,1568.0,,-17791601.0,1863898.0,83166.0,,26601147.0,,,,,,,,,,,,,55539.0,268510.0,,,4070613.0,,,,-9252.0,,,,1821742.0,,670.0,,55320230.0,,,,46.47,N,15584051.0,,108027.0,,4951330.0,,,46.7,,155275.0,,119089611.0,,N,,,,,,,396.0,3615910.0,36132040.0,,5106.0,,7195580.0,,,,,,,-849720519.0,,,-9973222.0,56623756.0,,,,,,24876040.0,54999068.0,,,,33712450.0,,,19010212.0,,,,,,266.0,1599424.0,,11313871.0,,,,,5380,,,,,,3224367043.0,,3691547.0,,54625022.0,5475.0,,,10601.0,,,,,,,,3587.0,,10841210.0,,,,,,,-12075090.0,36593993.0,,,8499144.0,,,,,3149856.0,,,89200.0,,,,,-102023.0,,174311311.0,61412775.0,43977799.0,6419928.0,1695769.0,6009.0,3666264.0,,,339521436.0,13319440.0,,92740.0,300.0,4815185.0,,3023655.0,-3507805.0,,13079834.0,,,1012231.0,505805.62,106293150.0,,3507000.0,,,,8262937.0,,,,76714037.0,,224457.0,,1990338.0,Y,,,,,1273072446.0,,26.8,,,,,,,14171307.0,,9.0,,291479.0,,,,,,43704785.0,36202238.0,56023081.0,,,,61067752.0,54568.0,,,2021-12-31,,1590115001.0,20280.0,,,2417364.0,,4866596.0,,,11212.0,,,2853314.0,,,,,349329661.0,,71780.0,,,,,,,10891138.0,,303994494.0,,,14451.0,,,10961657.0,16931049.0,,12063609.0,48062169.0,170525.0,,,64117923.0,,14600.0,,110565.0,,,-14757.0,,,345652.0,4082438.0,,,245077510.0,21764400.0,41073.0,,1384546.0,-158777514.0,,,,,16005395.0,,-113237000.0,,19144582.0,12346729.0,11146.0,1110311.0,,,,,,10386.0,608875.26,,,,NORTH SHORE UNIVERSITY HOSPITAL,41685.0,2.0,5204.0,382490835.0,,,,-19264004.0,,,,,,,17178848.0,,,,,,,3709666.0,368255017.0,,,P,10340.0,,,,,,122723000.0,,,-3324449.0,64.03,37.38,8527737.0,,42117149.0,209126666.0,,7941859.0,23085.0,,,N,,188379843.0,66.85,,,-35563.0,,,,,,,,24158671.0,,,,,,214021.0,15258874.0,,,249640.0,,,,,,-4347597.0,,,,,-8906754.0,,3482280.0,,,,-22705481.0,-2822891.0,678044.0,MANHASSET,,,,,246284975.0,114652.0,,,21596190.0,35004,,,823977.0,139297249.0,,,,,,68817063.0,,9140621.0,1211978047.0,12302.0,,90.0,523968.0,,10712.0,,,,256866.0,,4434141.0,34473881.0,,,-1452236690.0,,966391.0,02/21/2019,,,,,,2875638.0,,,,14701.0,,,,26085285.0,227736416.0,1524530.0,,,14922312.0,,7635011.0,,3535.0,17441626.0,15584051.0,,-2958457.0,-309783.0,,2663249.0,,,,,3129128.0,64319.0,6846000.0,13079834.0,,274129.0,142214.0,,-9251602.0,40.17,,,,,,,,12305763.0,22503058.0,,1244113707.0,,4450828.0,,,,,,3758.0,,,245618328.0,,,,337148,2716815.0,,26085285.0,,,120450821.0,,,1574530.0,,,,,,339.0,,,2479340.0,257040.0,,201632742.0,34700.0,,1236510.0,,,499609.0,,,,3994311.0,,,519036.0,,223015.0,1036127.0,,3444193.0,,,831047000.0,71522.0,,177.82,,,4053870.0,,,,1297566201.0,,,576210000.0,6076916110.0,,,,,,,,,,,,2699084737.0,,,431087.0,25332505.0,48062169.0,,,,63623403.0,,,96346004.0,,,,,,17755532.0,,2280471.0,,,,33400,50434.0,,,,1501787000.0,,8776000847.0,,,172890.0,2244525.0,F,,,,,3099463.0,59414527.0,,2056374.0,523853.0,,,,,,,,14126.0,,,,1868.0,4364403.0,132854283.0,,16120404.0,NY,213016059.0,,,4070613.0,,,,,,,,,-11827000.0,,,,,,95588.0,19783629.0,45685062.0,,234442.0,1098697.0,,,,883144.0,,1514916585.0,,,,,140687011.0,1249378000.0,,,,,3952200.0,50254286.0,1833279.0,,,,91396486.0,104619277.0,28650617.0,,,,,,,,,29271247.0,,24198030.0,,,,,,,-190592596.0,,107515229.0,,,,,,223015.0,12169287.0,,,,1164506.0,3885708.0,N,,,58382187.0,47826040.0,,,,,,,231726.0,720097.0,,,,356501.0,,,,,,20292347.0,,,,,3709666.0,,,,2508317.0,,,35352798.0,,,15.0,,,,335827475.0,15947817.0,,3522600.0,177233000.0,55045000.0,,,,,3014939.0,,,,,,,,,13066181.0,,,,12076493.0,,68817063.0,,185453000.0,,2023-05-10 00:00:00,,16994000.0,,12369308.0,84883268.0,611.0,,,779011.0,817482.0,,,,,4250337.0,175982.0,,,,,,,,,,,,,,,,,,,,,,,16914990.0,,,,,,,,,53.14,,20454912.0,-1407.0,,26052692.0,,,,,,,,62.24,,607621.0,,,20088896.0,27597.0,,1600474.0,,5769619.0,4979211.0,45957227.0,,2786610.0,251678178.0,,,8234480.0,119970000.0,,,,,804.0,,326265525.0,13285.64,,,3691547.0,,,,1682853390.0,65.0,,734479.0,73556274.0,,3115969000.0,54501792.0,,279570093.0,6624314602.0,,,50437595.0,145568.83,,,,,,,,60.89,62394664.0,8919.0,950600000.0,48006417.0,,,,,,,18567599.0,96346004.0,,,,,51.0,57830975.0,,1970952.0,,,3183.0,26365000.0,,,,309955.0,,,13207.0,,,,,,,21088210.0,,30443.0,,,23500.0,18567599.0,28034000.0,,,,57.0,,32082276.0,,25845883.0,,13319440.0,,,,62185092.0,179854904.0,,,347031.0,,,,,269665.0,65553645.0,,3286853.0,,877660.0,,-101081.0,,,,,,67774527.0,,494626.0,,,,5106.0,,Y,,,,,,117588504.0,,49045.57,18330391.0,347031.0,,,43032690.0,,,,20146295.0,,,74668378.0,3317792.0,,151035.0,,,1703915688.0,99.85,,55781278.0,40.0,408587.0,,,-45151864.0,306092.0,,,,,814616.0,,878160.0,3557500.0,202452606.0,,55308640.0,,,,173063558.0,41580371.0,,281491436.0,70663129.0,,,5964892.0,,6308948.0,8819981.0,,10018646.0,,,,,,,11844502.0,42011540.0,56135013.0,48006417.0,,,3817000.0,,102567938.0,20310010.0,274.15,,4760736.0,,,8060.0,17739.0,,,,21932501.0,698686000.0,,58382187.0,,,111907.0,26723071.0,,,,3994311.0,,148204003.0,-40907328.0,,,,,17783.0,16254664.0,,,,,26723071.0,67664538.0,37870.0,,21088210.0,,,,,,,NY,,-101617.0,169179064.0,345652.0,28877509.0,390621.55,,300.0,3904195.0,4869.0,1703915688.0,678241.0,4364.0,,,,10601.0,32551931.0,12555.43,,,,NASSAU,120450821.0,,683432.0,4068.0,538692.0,,331131.0,2667210.0,,6661223.0,,,12063609.0,,,,300 COMMUNITY DRIVE,,,,,,,,,704001.0,70814767.0,,74177791.0,42011540.0,,,,335827475.0,1661561.0,,20292347.0,,,,57.23,,,2855529.0,,33,,,278057.0,1221440.0,2864821.0,-1998678.0,,55071.0,,,,,,350383.0,,,,,,,62394664.0,,,752928.0,,,963912.0,,,Y,,5396693.0,14097883.0,,,47256359.0,,,12022067.0,2792745.0,,,925786.0,11908000.0,,38767602.0,3033134.0,,,,2454334.41,74668378.0,822136.0,,1611662557.0,408587.0,1766595583.0,,,355451.0,,4364403.0,,,,36647829.0,,,,28877509.0,,,,,,,,113469624.0,,1247095.19,1574530.0,355451.0,1636.0,1232464.29,,451267.78,36882144.0,1358682.0,-81311785.0,,,,3952.0,,537505.0,5056636.0,,10019186.0,55320230.0,,107071719.0,,1218200.98,,16994000.0,2151686245.0,4859545.0,,634068.0,,,,,,,,,16319842.0,,5976136.0,74177791.0,,,,,,,26857.0,29806708.0,,,,,-399274172.0,,10018646.0,,,,,,,,2223806.0,,-1452236690.0,,,,,11590,10939.0,,,,,,,,1918196.0,,-2678625.0,,21894321.0,,-72649.0,,,,,,145312254.0,,,,,12300.0,6076516108.0,,1424471.0,177434.0,,,65442304.0,,12068896.0,23410002.95,,663582000.0,,135959.0,19495.0,17739.0,,930646.0,36954739.0,782.0,,142596947.0,494626.0,94063.0,,,678044.0,,,,,,10013173.0,28.23,,,,5304182.0,83166.0,269665.0,132873308.0,214458.0,18964040.0,273.41,16914990.0,305181656.0,,,,,402835.0,,,326265525.0,151852218.0,,,,41374257.0,110351000.0,126448481.0,,,,,16120404.0,3285.0,,,2021-01-01 00:00:00,,,,161691417.0,,318913044.0,153792795.0,,196853000.0,,,,,14097883.0,414219.0,726817.0,,,,,,108437.0,1990338.0,,,6919757.0,,,,,,43.3,83006362.0,NSUH PSYCHIATRIC EXEMPT UNIT,674.0,,,,126448481.0,,,,509.0,,262032.0,,,,12471783.0,1129692.0,,,,,,,,,,-44710.0,,179395.0,,,,,,,-192194214.0,,,21932501.0,,,,,73409520.0,14478323.0,,,,88507485.0,,,,-30750.0,,,16901.0,,53496476.0,,67272328.0,,3920321.0,,158414303.0,,,,,,28940.0,,,60431463.0,,,,,139300274.0,,,3231237.0,1068372.0,,,,,,,5,,1969216.0,10809663.0,,,,,,,12908000.0,1307.0,,,,,,245618328.0,,,,,,80763419.0,,,,,,,224457.0,,679997.0,,822815.0,,,,,870621.0,,0.181716,626843.67,,15359246.0,,,,86086615.0,,,,,,,,2875638.0,,,,-5778.0,P,,6136916.0,266646.2,,,1703915687.0,,,,,2021,Acute Care Hospitals,NORTH SHORE UNIVERSITY HOSPITAL (330106)
72349,NORTH SHORE UNIVERSITY HOSPITAL (330106),General Short Term (Acute Care Hospitals),Voluntary Nonprofit-Other,-73.703029,40.779269,,04/04/2008,,,,,,,,892822.0,,16956428.0,,10223.0,,,,378350139.0,,,629392.0,,,92570219.0,,,,,,18246304.0,859.0,,,,,70858928.0,469432000.0,,2706658.0,,,-10386437.0,-770029.0,,,N,,2142566.0,,,264.0,,,280.0,,3872673.0,373.31,,,,,,64359017.0,,47601120.0,,,194.0,,91282770.0,,,782.0,1000620.0,,,,,,16177954.0,,,,,,4409205.0,203000000.0,3114995.0,17060025.0,,,,,,,,,,,,699855483.0,,,1478082.0,32.91,,201950716.0,513952.0,,,5986.0,,1337190.0,,,2.0,,,13508666.0,,HB2348,,4839.0,3035657.0,,91921568.0,6014882.0,59735374.0,,5982744.0,,,,,,,,,,10223.0,,,,258185.0,,,124072041.0,,,443442.0,,,,4503998.0,,,,,,,18777990.0,,972 BRUSH HOLLOW RD,666406.0,50638.0,405687120.0,,3733101.0,,14532.0,,50099852.0,,,15946660.0,8500741.0,,,44911.0,804.0,744055000.0,,,Y,,1112139.0,,7447496.0,,,,3245858.0,52509893.0,,,60538598.0,2929913.0,157503252.0,18870.0,,,-3256937.0,46269.0,,,80722032.0,13118891.0,,,17621.0,30228789.0,1872714744.0,,,241086.0,,,,,,,,44911.0,429230.0,,,18615.0,84777507.0,,71131063.0,,2523934.0,48.0,21235219.0,,125330197.0,,,,307512.0,359917820.0,,-1832228.0,2072127.0,,32950.0,14196.0,,,727800.0,,,,2539532.0,367432.0,,,,618.0,1716928.0,31426991.0,,,,,7577955.0,,,-221658665.0,,,,-1998611.0,,,,,,,,3808662.0,,,,,,,19102716.0,,114699011.0,,,151.18,353384.0,31.6,,,,217972752.0,,WESTBURY,,,,,,68569649.0,10562677.0,,,,,7408365.0,,,,,,4659707.0,1137021172.0,3937.0,8.0,17394.0,84535.0,,382284.0,15470053.0,,25009556.0,2523934.0,63179683.0,,,,35917830.0,,,,,8566191.0,,1439256.0,,59.07,,,,,25038508.0,1596061.0,,596179103.0,,59519.0,3378600.0,,,,,,,,,,,,,,N,6115973.0,11951195.0,,378465787.0,,221349899.0,,,,373.31,18348737.0,23372695.0,,102008.0,,,,,11815989.0,23301194.0,444436.0,333189092.0,29848086.0,,727800.0,,,-3640915.0,,4639480.0,,58.29,,23066882.0,,9673896.0,,70638746.0,531836081.0,,1657209812.0,,,1019614.0,,27018.0,,,-498975305.0,General Short Term,,,30674595.0,,,727432000.0,95219920.0,152615772.0,1362261000.0,,,68166876.0,64631297.0,248425.0,,,3736000.0,,,,,,52352933.0,1249297000.0,23320.0,,35.7,108965832.0,,12813771.0,,125273166.0,,10030,,,,,11389102.0,,2664489.0,2422958.0,,,14830356.0,,,,4795030.0,796.0,,4862315.0,395055557.0,31772032.0,,,,,,,835323240.0,,,,,15905090.0,,76145357.0,12074986.0,,,,8466971.0,25.53,,,,125484.0,2669243.0,,1665.0,,,3621843.0,,,12044708.0,,,,,N,-58992535.0,99856179.0,,,15854537.0,19169.0,,,,44309865.0,2173395.0,-40073.0,5685120.0,,,,620.0,,285430.0,,859.0,887168905.0,,162457799.0,13205766.0,,137948.0,,,34338487.0,,34678632.0,,,,,,27897855.0,,,,110.07,,869557.0,,,,,,,,,2466726.0,,,,,18846600.0,29.0,,17522.0,,,11806.0,3264554.0,,,,625306.0,2299662.0,,10553925.0,63076.0,,1598595.0,216.98,,,1104455.0,,,,3596531.0,,,539125.0,58589728.0,61772432.0,,,,518587.0,,8643672.0,,5497485.0,,,,5058794.0,,426127.0,120473376.0,69404068.0,21880.0,,,,395055557.0,105914.0,459772.0,1139.0,410840.0,,,,3762.0,,,,,,,,,,4641130.0,111243977.0,1422504.0,30544.0,,519733.0,,20848724.0,,2512101350.0,,5788422.0,,09/14/2021,,282128897.0,,1.0,Y,,31134.0,2929913.0,531836081.0,,,,1871372.0,,15023812.0,,182768448.0,,538123.0,34799.0,,-950275.0,1104455.0,1179783550.0,585193.0,,,2033343.0,,,,17629494.0,,835323240.0,,19399705.0,16673288.0,,,,,,,,197977175.0,,,-1166149041.0,,,,,1766735.0,,,8047742.0,985030.0,,23855980.0,8860266.0,,,12572.0,38936020.0,7083932.0,,,6738265.0,811346.0,71.12,,,391940562.0,498176.0,,924778.0,365843.0,,,,2056072.0,63179683.0,,,,,,,16515229.0,,,,343326995.0,,597.0,,,,3966568.0,1439256.0,,,,99856179.0,3810318.0,3164.0,,,,,391940562.0,,,,,,,,,8170024.0,7525.0,,1469621.0,,79372611.0,-21511003.0,2142566.0,,,2312531.0,107148.0,,,,,68966927.0,,,,,,,12944.0,13305507.0,2385208.0,,20921490.0,,8894.0,,1888232031.0,,45294096.0,2009549.0,70626174.0,11509227.0,727586.0,,15521496.0,,,73844817.0,,,,,,,,3679164.0,2706733.0,,,,,,,120473376.0,33S106,,,,,,9487315.0,,,394852967.0,,29691911.0,,Y,,,,,,,,,,,,,,,,14363629.0,,264184.0,,,26348508.0,,,,,,,,,2870709888.0,,,,332177.0,,1.0,27897855.0,,,,,,NORTHWELL HEALTHCARE INC,,332631.0,1482.0,,,,8263435.0,744619,15854537.0,,3454000.0,,4659707.0,34.74,,12195290.0,,2705347.0,,,8263435.0,,,,,,2992914.0,,23066882.0,86363.0,,,,14196.0,2715.0,14397430.0,,10269538.0,22150344.0,,,,,,,,17763.0,,15946660.0,31658515.0,94012637.0,,,192880000.0,24881.0,2821819.0,,,103874989.0,9867170.0,,3831092.0,730673.0,,2127266000.0,773815.0,3012.0,,15521496.0,,,378145.0,,,,,,99170.0,,,,Y,,,,-3730783.0,611.0,,98681.0,,,-702743.0,23066882.0,,,,,,,,,2254350.0,,32968976.0,612.0,,,,,,,,,21993241.0,23694.0,,,101714.0,10066739.0,,,N,,,13001,,,,,38077943.0,1009502.0,,,,7266996.0,,,,345.0,,3035657.0,,,,,-2178339.0,,1053941.0,101359.0,,5123181.0,,,,,,,,,3121023.0,,,,14452842.0,,,71468370.0,9405209575.0,,,,,,,141163778.0,,,,,3958196.0,,,7415800.0,21185678.0,,,,382284.0,,,,,,5788422.0,26546.0,10153418.0,,23725.0,17475361.0,231542.0,27653242.0,,,,,,,,,335702,,,,,,,,,5611336.0,,,,6078749.0,,17113.0,,258.48,,8560143.0,11699107.0,125133083.0,,26980718.0,,,,18348737.0,141244407.0,558561.0,44548.0,76974331.0,19551825.0,,,,,,,,5978141.0,,268366.0,,330106,31666798.0,,,,,7083932.0,,,,,,,,,27653242.0,,6846241.0,26949805.0,,,,60538598.0,18063.0,,,,,53.54,,,,,,,,196581.0,3733101.0,,,,,,1614058.0,,,,3810318.0,,,,,,Y,13.0,42.0,-3273532.0,2251500.0,86363.0,,31447817.0,,,,,,,,,,5788422.0,,,71556.0,,,,3862267.0,,,,-9160.0,,,,2726132.0,,1323.0,,91981240.0,,,,48.1,N,16371446.0,,125484.0,,5525358.0,,,41.29,,309012.0,,124072041.0,,N,,,,,,,610.0,3733101.0,36076004.0,,5193.0,,8566191.0,,,,,,,-898389978.0,,,-12206421.0,53839312.0,,,,-17152.0,23694.0,35119440.0,109874248.0,,,,72975172.0,,,19527227.0,,,,,,,1293707.0,,12195290.0,,,,,5380,,,,,,3437814264.0,,6764480.0,,22183863.0,5475.0,,,9984.0,,,,,,,,3762.0,,11331675.0,,,,,,,-15575002.0,36303358.0,,,8829794.0,,,,,3864482.0,,,14532.0,,,,,,,194094015.0,27154818.0,45294096.0,6204354.0,1487836.0,5986.0,4560080.0,,,348184981.0,16709324.0,,82417.0,,3782647.0,,3815236.0,-1630002.0,,16395932.0,,,339139.0,586559.0,29874545.0,,3927840.0,,,644176.0,10269538.0,,,,125133083.0,,230811.0,,2366745.0,Y,,,,,1344094839.0,,27.43,,,,,,,20061877.0,,9.0,,436533.0,,,,,,60021571.0,44817135.0,59681223.0,,,,103874989.0,52396.0,,,2022-12-31,,1699972190.0,52803.0,,,2336057.0,,5070291.0,,,205796.0,,,2711769.0,,,,,368371476.0,,77232.0,,,,,,,12325151.0,,340008497.0,,,14532.0,,,,18348737.0,,13160172.0,53493886.0,164853.0,,,41201262.0,,14600.0,,215703.0,,,,,350362.0,350654.0,6107692.0,,,256930139.0,20260650.0,27018.0,,1439256.0,-183637567.0,,,,,18846600.0,,-120639000.0,,20122238.0,16846152.0,13044.0,1275130.0,,,,,,14698.0,577908.0,,,,NORTH SHORE UNIVERSITY HOSPITAL,57381.0,2.0,,408765629.0,,,,-15111274.0,,,,,,,15194081.0,662.0,,,,,,3831092.0,381514075.0,,,P,11826.0,,,,,,,,,-3730783.0,66.87,39.33,9501619.0,,52509893.0,198477521.0,,11951195.0,26559.0,,,N,,197167471.0,82.35,,,-46878.0,,,,,,,,23992411.0,,,,,,213129.0,15862456.0,,,279775.0,,,,,,-4633043.0,,,,,-4367000.0,,3264554.0,,,,1682266.0,-3640915.0,766637.0,MANHASSET,,,,,266454998.0,135882.0,,,34472827.0,35004,,,796151.0,-94390100.0,,,,,,69964322.0,,10209648.0,1071758941.0,14034.0,,,783747.0,,11806.0,,,,302489.0,,4490109.0,53061837.0,,,-1349891988.0,,1446724.0,02/21/2019,3770.0,,,,,1921593.0,,,,,,,,30291827.0,227986690.0,1759766.0,,,16592435.0,,8306745.0,,3813.0,19607537.0,16371446.0,,,-73700.0,,3006151.0,,,,,3630640.0,58053.0,9514000.0,16395932.0,308262.0,410115.0,148544.0,,-8884086.0,45.32,,,,,,,,13640287.0,27106570.0,,1312703826.0,,4866786.0,,,,,,,,,257260123.0,,,,337148,3285999.0,,30291827.0,,,118908838.0,,,1614058.0,,,,,,388.0,,,2576324.0,332631.0,,220381573.0,51579.0,,451948.0,,,631534.0,,,,4676872.0,,,574364.0,,223015.0,1306041.0,,4325188.0,,,765005000.0,80877.0,,175.53,,,4190382.0,,,,1425414721.0,,,618206000.0,6534535646.0,,,,,,,,,,,,2870681637.0,,,416605.0,20884939.0,53493886.0,,,,76607175.0,,,94421484.0,,,,,,12553094.0,,3156248.0,,,,33400,66210.0,308262.0,,,1292499000.0,,9405217283.0,,,,2135683.0,F,,,,,3155211.0,62332001.0,,2172787.0,506061.0,,,,,,,,16235.0,,,,1944.0,5809945.0,164311289.0,,15858986.0,NY,378788128.0,,,3862267.0,,,,,,,,,11230249.0,,,,,,137948.0,17475361.0,71468370.0,,229311.0,1407311.0,,,,1071309.0,,1664178115.0,,,,,164557455.0,1051068000.0,,,,,3811800.0,59761666.0,978507.0,,,,108992850.0,125026700.0,34332154.0,,,,,,9.0,,,31773298.0,,26429455.0,,,,,,,-183089468.0,,119074633.0,,,,,,223015.0,14830356.0,,,,1194849.0,4259782.0,N,,,61766413.0,65288093.0,,,,,,,232754.0,662565.0,,,,358083.0,,,,,,,3937.0,,,,3831092.0,,,,3019659.0,,,36103577.0,,,15.0,,,,319882692.0,16177954.0,,3378600.0,187987000.0,210709000.0,,,,,3782550.0,,,,,,,,,14534984.0,,,,15946660.0,,69964322.0,,196483000.0,,2023-06-19 00:00:00,,18762291.0,,13068721.0,68400301.0,611.0,,,773815.0,1128816.0,,,,,5048053.0,169965.0,,,,,,,,,,,,,,,,,,,,,662.0,,23372695.0,,,,,,,,,57.5,,21993241.0,562038.0,,29286204.0,,,,,,,,60.57,,647350.0,,,19812733.0,73921.0,,2954792.0,,7314528.0,4862524.0,57180547.0,,2780082.0,278107902.0,,,8914636.0,122711000.0,,,,,731.0,,378465787.0,14195.97,,,6764480.0,,,,2020220238.0,65.0,,966417.0,51158914.0,,3394457000.0,64459565.0,,340747202.0,7133552060.0,,,26348508.0,146248.0,,,,,,,,59.07,61771714.0,,1249297000.0,53095040.0,,,,,,,19646802.0,94421484.0,,,,,51.0,64377663.0,,3106054.0,,,21647.0,68171000.0,,,8500.0,520588.0,,,12944.0,,,,,,,25875320.0,,31134.0,,,40938.0,19646802.0,28136000.0,,,,54.0,,41299630.0,,27718577.0,,16709324.0,,1329616.0,,58589728.0,233525939.0,,,351915.0,,,,,225520.0,73844817.0,256.0,3323086.0,,1211261.0,,-96676.0,,,,,,73724813.0,,8316225.0,,,,5193.0,,Y,,,,,,137230766.0,662.0,49709.0,20111760.0,351915.0,,,53861284.0,,,,24987468.0,,,74634915.0,3114995.0,,,,,1804105884.0,150.42,,75968231.0,40.0,3369437.0,,,-36444914.0,238383.0,,,,,952392.0,,637970.0,3852972.0,221349899.0,,107447999.0,,,,169795255.0,-852251.0,,312901927.0,74133988.0,,,15171338.0,,7800893.0,8911921.0,,10895577.0,,,,,,,15404568.0,46561041.0,58269648.0,53095040.0,,,5565000.0,,114250129.0,21185678.0,477.27,,5497485.0,,,7525.0,33155.0,,,,24745975.0,894815000.0,,61766413.0,,,167317.0,35231547.0,,,,4676872.0,,-90023100.0,-34338487.0,,,,,,17831064.0,,,,,35231547.0,77894420.0,37045.0,,25875320.0,,,,,,,NY,,-66520.0,219148976.0,350654.0,35554997.0,328830.0,,,4625366.0,804.0,1804105884.0,,,,,,9984.0,48700511.0,13718.7,,,,NASSAU,118908838.0,,644176.0,1159.0,448928.0,,495835.0,2691103.0,,10889251.0,,,13160172.0,,,,300 COMMUNITY DRIVE,,,,,,,,,811179.0,74376709.0,,120473376.0,46561041.0,,,,319882692.0,,,,,,,58.61,,,3356180.0,,33,,,284235.0,502441.0,2769277.0,-1190537.0,,55657.0,,,,,,365843.0,,,,,,,61771714.0,,,819055.0,,,1395817.0,,,Y,,5845466.0,14363629.0,,,63179683.0,,,14944865.0,,,,1053941.0,,,42735236.0,3382792.0,,,,1708106.0,74634915.0,684818.0,,1889426880.0,6089963.0,2118392011.0,,,367432.0,,5809945.0,,,,42902413.0,,,,35554997.0,,,,,,,,142312762.0,,1237536.0,1614058.0,367432.0,1665.0,2065975.0,,454616.0,40306193.0,1648168.0,-91303277.0,,,,1482.0,,1096564.0,4694441.0,,8393155.0,91981240.0,,118376525.0,,2039429.0,,18762291.0,2271665223.0,411337.0,,811346.0,,95334.0,,,,,,,15854537.0,,4503998.0,120473376.0,,,,,,,10783.0,31099019.0,,,,,-397151547.0,,10895577.0,,,,,,,,2033343.0,,-1349891988.0,,,,,11590,11164.0,,,,,,,,2142566.0,,-330320.0,,25009556.0,,153851.0,,,,,,155345854.0,,,,,218324.0,6534499687.0,,1897061.0,,,,109760531.0,,14284751.0,22831280.0,,852661000.0,,197701.0,50638.0,33155.0,,1021299.0,47132280.0,1038.0,,157503252.0,8316225.0,197586.0,,,766637.0,,,,,,10853868.0,28.95,,,,6779959.0,86363.0,225520.0,140588070.0,221970.0,17651164.0,221.47,23372695.0,337830977.0,,,,,386467.0,,,378465787.0,162457799.0,,,,47601120.0,,163389938.0,,,,102008.0,15858986.0,3285.0,,,2022-01-01 00:00:00,,,,173871471.0,,316241779.0,166276867.0,,212762000.0,,,,,14363629.0,484636.0,799340.0,,,,,,162285.0,2366745.0,,,18918202.0,,,,,,71.08,79355957.0,NSUH PSYCHIATRIC EXEMPT UNIT,1059.0,,,,163389938.0,,,,,5788422.0,-1007221.0,42.0,,,11980672.0,1353554.0,,,,,,,,,,2679.0,,,,,,,,,-45363233.0,8705.0,,24745975.0,,,,,78704784.0,13305507.0,,,,94817520.0,,,,-66261.0,,,17621.0,,58025914.0,2.0,70858928.0,,7447496.0,,170193364.0,,,,,93400.0,19055.0,,,76145357.0,,,,,175682654.0,,,3030456.0,1105152.0,,,,,14999.0,,1,,2946285.0,14313564.0,,,,,,,13517649.0,1139.0,,,,,,257260123.0,,78182.0,,,,91921568.0,,,2667655.0,,,767843.0,230811.0,,1537990.0,,1089669.0,,,,,865422.0,,0.199115,769450.0,,16941409.0,,,,84777507.0,,,,,,,,1921593.0,,,,-20.0,P,,6782084.0,270626.0,,,1804105885.0,,39267.0,,,2022,Acute Care Hospitals,NORTH SHORE UNIVERSITY HOSPITAL (330106)
