,Curated Name and Num,Hospital type (modified),S2_1_C1_21,Lon,Lat,C_1_C6_76,S3_1_C12_17,A_C6_90,D_4_HOS_C13_58,S4_HHA3_C5_38,S2_1_C2_1401,B_1_C21_44,D_5_HOS_C5_200,D1_HOS_C1_50,D_4_HOS_C2_58,D3_HOS_C2_96,D_4_HOS_C3_68,C_1_C5_96,A_C2_43,S4_HHA3_C2_35,S2_1_C2_2,D1_HOS_C1_62,B_1_C26_45,C_1_C5_75,D_5_HOS_C7_200,D_4_HOS_C12_74,C_1_C6_115,D_4_HOS_C3_52,C_1_C6_57,S3_2_C3_1402,S10_C1_3,D_4_HOS_C10_53,A_C2_88,D3_HOS_C2_65,A_C2_97,D_4_HOS_C10_6250,B_1_C22_93,D_4_IRF_C11_60,C_1_C6_51,A8_C2_16,S2_1_C4_2,C_1_C6_30,S3_2_C6_13,C_1_C6_108,S3_1_C7_20,D_4_HOS_C12_52,B_1_C26_76,FY_END_DT,B_1_C0_76,B_1_C21_116,D_4_IRF_C11_65,E_A_HOS_C1_7094,D_5_HOS_C4_72,D_4_HOS_C11_62,D_5_HOS_C6_95,D3_IRF_C2_50,S3_1_C3_19,S3_1_C7_32,S4_HHA2_C4_33,D_4_HOS_C12_67,D_3_HOS_C2_200,B_1_C26_4201,C_1_C5_93,S3_1_C3_10,A_C2_117,D_5_HOS_C5_56,D3_IPF_C3_53,D_4_HOS_C2_76,C_1_C5_105,A_C1_9930,D_1_HOS_C4_30,S2_1_C2_38,C_1_C7_51,D3_IPF_C2_200,B_1_C22_94,B_1_C0_20,A7_3_C7_2,S3_3_C2_5,D_5_HOS_C7_67,S3_2_C4_18,C_1_C6_100,D3_IRF_C2_70,S3_1_C5_12,C_1_C5_73,A_C2_44,S3_2_C4_39,D_4_HOS_C2_94,D_4_IRF_C11_98,E_B_HOS_C1_2,S3_1_C7_11,B_2_C26_192,D_4_HOS_C2_71,E_B_HOS_C1_38,D_4_IRF_C11_69,D3_IPF_C2_90,B_1_C21_66,S5_C3_3,D_5_HOS_C6_64,S2_1_C2_4,B_1_C21_192,D_4_HOS_C11_64,C_1_C6_46,D3_IRF_C3_71,D3_IPF_C3_96,D_4_HOS_C3_75,S3_2_C6_4,S5_C1_8,D3_IRF_C3_54,B_1_C0_42,C_1_C5_51,B_1_C22_9201,D_5_HOS_C4_59,B_1_C21_43,B_1_C26_70,A_C6_72,B_2_C26_64,C_1_C6_33,D_4_HOS_C4_88,C_1_C5_200,D_5_HOS_C4_63,D_5_HOS_C6_94,E_B_HOS_C1_39,D_4_HOS_C11_51,D_4_SNF_C11_69,S2_1_C1_56,A7_1_C1_7,B_1_C0_112,S3_2_C5_35,C_1_C6_9910,S3_2_C4_20,D_5_HOS_C5_59,D_4_HOS_C4_60,B_1_C21_73,C_1_C7_62,D_4_HOS_C2_55,A_C1_193,C_1_C6_89,C_1_C6_90,D_4_HOS_C3_88,D_4_SNF_C11_76,B_1_C0_65,B_1_C26_62,A_C6_100,D_4_IRF_C11_73,S3_1_C11_27,S2_1_C2_1608,A_C2_71,D_5_HOS_C3_72,A_C1_70,S2_1_C2_1506,A_C1_10,D3_IRF_C3_52,S3_2_C2_40,A_C6_9930,B_1_C0_191,A_C6_108,D3_HOS_C2_64,D_5_HOS_C7_56,C_1_C5_98,S3_2_C6_43,D_5_HOS_C4_74,A7_3_C10_2,D_4_IPF_C13_76,B_1_C22_33,G_C1THRU4_38,A_C2_52,B_1_C22_58,D3_HOS_C3_51,S3_1_C8_1801,G_C1THRU4_3,B_2_C26_45,D_5_HOS_C2_63,D_4_SNF_C13_73,D_5_HOS_C7_71,D_5_HOS_C6_51,D_5_HOS_C7_73,B_1_C0_109,D_5_HOS_C5_9201,D3_IPF_C2_6250,C_1_C6_110,D3_IPF_C2_58,A7_1_C1_5,D_4_IRF_C11_62,D3_SNF_C3_56,D3_SNF_C2_64,A_C6_57,S3_2_C6_16,S3_2_C5_30,S3_3_C2_1,D3_SNF_C2_35,E_B_HOS_C1_33,C_1_C6_99,D3_HOS_C2_55,D_1_HOS_C4_40,S10_C1_19,D3_IPF_C3_64,D3_SNF_C2_70,C_1_C5_58,C_1_C5_107,D_4_HOS_C3_54,S3_2_C2_21,B_1_C21_90,D_4_HOS_C13_97,S2_1_C3_3,B_2_C26_44,S4_HHA3_C2_33,B_1_C21_88,G_C1THRU4_39,G_C1THRU4_25,S3_2_C6_3,S2_1_C2_130,A8_C2_23,D3_HOS_C3_91,A_C1_43,S4_HHA3_C5_36,B_1_C0_8,A8_C2_24,S4_HHA1_C2_38,B_1_C0_34,A_C2_9930,D_1_HOS_C4_35,A_C1_6250,D_3_HOS_C9_40,A_C2_98,D3_IRF_C3_63,S2_1_C1_3801,D3_SNF_C3_57,S3_2_C5_16,G_C1THRU4_53,B_2_C26_76,S3_1_C14_17,S2_1_C2_115,A_C2_114,S2_1_C1_93,D_5_HOS_C2_60,B_1_C26_200,D1_IPF_C1_27,D_4_HOS_C1_73,B_1_C21_74,C_1_C5_201,S4_HHA2_C1_34,B_1_C22_60,D4_KIDNEY_C1_69,G_C1THRU4_50,S3_1_C4_14,A_C2_11,A_C2_100,D_4_SNF_C11_74,C_1_C7_9940,A7_1_C2_6,B_2_C26_59,D_5_HOS_C3_91,D_4_HOS_C3_50,C_1_C7_112,S3_2_C2_11,S5_C3_6,D_4_HOS_C11_59,D3_IRF_C2_65,A_C6_33,S3_3_C6_7,C_1_C7_111,D_5_HOS_C3_69,B_1_C0_106,C_1_C2_65,C_1_C6_4501,S2_1_C1_1,G2_C2_28,D_4_SNF_C11_57,A_C6_105,D_4_HOS_C13_75,D_4_HOS_C3_76,S2_1_C2_17,D_4_IPF_C13_72,D3_SNF_C2_75,D_1_HOS_C7_33,D3_SNF_C2_54,D_5_HOS_C7_76,C_1_C6_9201,B_1_C22_112,D_4_HOS_C3_91,D_4_HOS_C11_63,B_1_C26_115,B_1_C22_76,D_5_HOS_C2_62,S5_C1_13,D_4_HOS_C4_58,C_1_C7_117,D_5_HOS_C6_54,D3_IPF_C3_74,B_1_C0_53,S5_C4_6,B_1_C21_57,G_C1THRU4_9,S3_2_C4_5,S2_1_C1_38,D3_IPF_C2_72,G_C1THRU4_41,D_4_HOS_C3_74,D3_SNF_C2_72,A8_C2_33,D3_IPF_C2_9201,D_4_IRF_C13_74,B_1_C21_34,B_1_C21_59,A8_C2_21,D_4_HOS_C12_66,C_1_C7_108,D_5_HOS_C5_62,B_1_C0_6,B_2_C26_100,D3_SNF_C3_50,D_4_IPF_C11_55,D_4_HOS_C11_90,D_5_HOS_C4_65,D_5_HOS_C7_6250,S3_2_C3_24,A_C1_115,D1_HOS_C5_43,S3_2_C3_14,D_4_HOS_C2_70,S3_2_C4_40,A_C1_34,A_C6_61,A_C2_74,D1_IPF_C1_51,S3_2_C4_37,D_4_IRF_C13_57,A_C2_35,S3_2_C2_37,B_1_C0_64,D_4_HOS_C11_57,C_1_C7_96,D3_IRF_C2_67,D3_SNF_C2_51,S3_1_C8_6,A7_1_C7_5,D_5_HOS_C7_90,G_C1THRU4_7,FI_CREAT_DT,D_4_HOS_C12_53,S3_1_C8_9,S3_2_C5_4,A_C6_95,D_1_HOS_C6_200,A_C1_11,B_1_C0_52,S3_2_C2_9,B_1_C0_97,A_C1_13,C_1_C5_63,C_1_C7_65,S3_2_C5_34,B_2_C26_74,S4_HHA1_C1_34,S4_HHA1_C5_38,D_5_HOS_C7_72,D_4_HOS_C10_67,D3_HOS_C2_90,D_1_HOS_C7_34,A_C2_190,S3_2_C5_26,S4_HHA2_C3_34,S5_C5_2,S5_C1_14,D_4_IRF_C13_90,S3_2_C4_17,A_C6_62,A_C6_10,D1_IRF_C1_51,D_5_HOS_C4_67,S3_2_C6_28,S10_C1_21,B_1_C21_68,B_1_C0_57,E_B_HOS_C1_8,D_4_HOS_C10_57,C_1_C5_9201,C_1_C5_115,D_5_HOS_C7_57,S3_2_C6_11,S3_3_C2_4,A7_3_C5_1,B_1_C0_7,S4_HHA2_C3_33,S3_1_C8_1,D_5_HOS_C6_91,S3_1_C2_9,D_4_HOS_C2_200,D3_HOS_C3_55,D_5_HOS_C5_55,C_1_C3_202,D3_SNF_C2_53,D_4_SNF_C11_65,S3_1_C10_20,A_C6_9201,C_1_C5_60,A_C2_42,D3_SNF_C2_71,S3_2_C5_15,S3_2_C6_31,D_1_HOS_C4_33,S10_C1_2701,D_4_HOS_C4_59,S3_1_C6_26,S3_2_C5_36,B_2_C26_32,D_4_HOS_C12_93,S3_2_C4_13,D3_IPF_C3_9201,S3_1_C8_13,A8_C2_17,S3_1_C8_12,D_4_HOS_C10_71,D_4_IPF_C13_200,S3_2_C5_12,S3_2_C2_42,S3_1_C2_20,D_4_HOS_C11_65,D3_HOS_C2_31,A_C1_17,S2_1_C2_1504,A_C1_31,B_1_C21_194,B_1_C26_89,D3_HOS_C3_59,D_4_HOS_C4_68,D_5_HOS_C6_76,B_1_C22_75,S3_1_C2_21,S4_HHA1_C4_34,D_4_HOS_C11_56,D_5_HOS_C2_53,S3_2_C5_42,B_1_C26_9940,A7_1_C2_4,B_1_C22_41,A_C1_68,S4_HHA3_C1_35,D3_IRF_C2_68,D_4_HOS_C4_51,S2_1_C2_1801,S3_1_C7_1,B_1_C22_62,B_1_C26_191,A_C6_101,A_C1_40,D3_IPF_C2_71,B_1_C26_46,D3_SNF_C3_52,B_1_C0_111,A_C1_5,A_C6_7,D_3_HOS_C9_41,A_C2_96,D_5_HOS_C3_90,B_2_C26_62,S3_1_C5_13,S3_2_C2_41,C_1_C7_89,S2_1_C1_126,S2_1_C1_143,S4_HHA1_C1_38,D_4_HOS_C11_68,B_1_C21_56,B_1_C0_9920,D3_HOS_C2_32,S3_1_C7_16,A_C1_108,B_1_C0_63,B_1_C0_99,B_1_C26_94,B_1_C0_4201,D_5_HOS_C3_53,D_5_HOS_C3_71,C_1_C6_74,G_C1THRU4_30,A_C1_99,D_4_HOS_C3_51,S3_2_C3_2201,D_4_HOS_C1_65,S3_1_C7_26,D_4_IRF_C11_75,S3_1_C11_19,S2_1_C2_24,B_1_C21_45,C_1_C5_9940,B_1_C26_65,D_4_HOS_C11_53,C_1_C6_67,S3_1_C4_1,B_1_C26_95,S3_1_C3_1801,A7_1_C4_7,A_C2_9920,A_C6_117,D_4_IRF_C13_66,D1_HOS_C1_48,B_1_C26_43,D3_SNF_C2_73,D3_SNF_C3_66,D3_SNF_C3_96,S2_1_C2_1802,B_1_C21_71,D_4_HOS_C13_98,D_5_HOS_C5_70,E_B_HOS_C1_43,B_1_C22_105,D1_HOS_C1_56,S3_2_C6_40,S3_1_C8_2001,S3_1_C8_8,D_4_HOS_C12_57,S4_HHA3_C5_34,C_1_C6_75,D_4_HOS_C13_76,D_4_HOS_C3_64,D_5_HOS_C5_60,D_5_HOS_C6_62,B_1_C21_112,B_1_C0_46,D_4_IRF_C13_62,B_1_C22_89,D3_IRF_C3_53,E_B_HOS_C1_31,D_4_HOS_C2_66,S4_HHA2_C4_38,D_4_SNF_C11_58,B_1_C0_200,B_1_C26_59,D_5_HOS_C3_66,D_5_HOS_C6_68,B_2_C26_91,D1_IPF_C1_52,B_1_C0_73,D_4_HOS_C4_55,C_1_C7_56,S3_3_C4_3,D_4_HOS_C11_70,S3_1_C8_15,D_4_SNF_C11_67,D3_IPF_C2_31,G_C1THRU4_44,A_C6_63,D_4_HOS_C12_9201,C_1_C7_55,D_4_HOS_C3_71,D_4_IPF_C13_91,S3_1_C8_26,D3_SNF_C2_66,C_1_C5_109,S3_2_C4_10,S3_1_C6_1,A_C1_59,D3_IPF_C2_41,D3_IRF_C3_60,A_C1_58,A_C2_21,S3_2_C2_10,D_4_HOS_C13_65,S2_1_C2_1515,B_1_C0_45,D_4_HOS_C10_54,B_1_C21_115,D_4_IPF_C13_53,D_4_IPF_C1_200,B_1_C22_74,D3_IRF_C2_56,C_1_C6_109,D3_SNF_C2_55,D3_HOS_C3_97,B_1_C21_42,D_4_HOS_C1_53,D_5_HOS_C4_64,D3_SNF_C2_34,D_4_HOS_C4_75,B_1_C26_106,S3_2_C6_42,S2_1_C1_3601,B_1_C0_105,C_1_C6_4201,B_2_C26_88,D_4_HOS_C2_63,S3_2_C4_24,S5_C4_1,A7_1_C3_7,B_1_C26_90,A_C2_56,D_4_IPF_C3_200,B_1_C26_100,D3_IRF_C2_94,B_1_C22_98,D3_IPF_C2_68,C_1_C5_33,D_5_HOS_C7_64,D_1_HOS_C4_32,S2_1_C2_1518,D3_IPF_C3_58,S4_HHA3_C3_33,B_1_C22_95,S3_1_C15_16,D_5_HOS_C4_52,D3_HOS_C3_68,C_1_C5_42,S2_1_C2_140,S3_2_C4_35,A7_1_C2_7,D3_IRF_C3_93,S2_1_C1_36,A_C1_192,S3_2_C4_2553,C_1_C5_106,S3_1_C4_7,S2_1_C2_1609,B_1_C21_98,B_1_C22_55,D_4_HOS_C2_97,D_4_IRF_C11_58,D3_HOS_C2_50,E_B_HOS_C1_21,D3_IPF_C2_55,A8_C2_26,D_4_IPF_C13_90,D_4_IPF_C13_58,D3_HOS_C3_64,D3_IPF_C2_34,S3_2_C2_33,S2_1_C2_1604,D_4_HOS_C10_52,D_4_HOS_C13_74,D_4_HOS_C4_72,D_4_HOS_C13_63,S3_1_C11_20,S3_1_C11_21,A_C6_98,B_2_C26_106,D_4_IPF_C13_74,D_4_IRF_C13_53,S4_HHA3_C4_36,D_4_HOS_C13_50,B_1_C21_107,D_4_SNF_C13_200,S10_C1_6,S4_HHA3_C4_37,D_5_HOS_C6_200,D_4_IRF_C11_9201,A8_C2_15,B_1_C0_51,C_1_C7_53,E_B_HOS_C1_3,S3_1_C7_2,D3_HOS_C3_74,D3_IRF_C2_35,B_2_C26_70,S3_3_C2_3,B_2_C26_41,S3_2_C4_2,C_1_C6_106,A_C6_4,C_1_C5_64,B_1_C22_32,A8_C2_2,S3_1_C6_29,D_4_IPF_C13_69,A_C1_22,D_5_HOS_C3_75,D1_HOS_C1_55,D_4_HOS_C2_91,D_5_HOS_C2_51,A7_3_C5_2,S3_1_C8_5,A_C1_35,A_C2_62,D_4_HOS_C13_68,C_1_C6_116,D_5_HOS_C3_70,D_5_HOS_C4_51,S2_1_C2_1805,D3_HOS_C3_75,S3_1_C7_18,B_1_C26_57,C_1_C5_88,D3_IPF_C2_75,A_C2_19,A7_1_C1_2,A_C6_14,S3_2_C6_41,A7_1_C5_4,G_C1THRU4_35,B_1_C21_32,D_5_HOS_C5_71,A_C2_6250,D_4_IRF_C11_67,A_C2_12,A_C1_15,B_1_C22_117,D3_IRF_C2_54,A_C6_44,C_1_C6_45,S2_1_C2_1806,D3_IRF_C3_56,A7_3_C11_1,S3_2_C4_12,S10_C1_27,B_1_C26_52,S4_HHA3_C5_35,D_3_HOS_C9_34,D3_IRF_C2_51,B_2_C26_53,B_1_C21_65,A_C6_94,G_C1THRU4_2,C_1_C7_64,D_1_HOS_C6_35,A_C2_31,D_4_SNF_C11_51,S3_1_C14_18,S3_1_C3_24,D_5_HOS_C7_60,A_C2_59,S3_2_C5_37,S2_1_C1_129,B_1_C21_30,B_1_C22_43,G2_C1_28,S3_1_C12_14,D3_IPF_C2_50,D_5_HOS_C3_73,D_4_IRF_C13_72,D3_IPF_C2_52,S3_2_C2_2201,A_C1_9,A_C2_1,D3_IPF_C2_51,A_C2_95,S3_2_C2_1402,D_5_HOS_C7_9201,S4_HHA3_C2_38,D_4_HOS_C4_66,D1_HOS_C1_54,A_C1_19,D3_HOS_C3_90,D_4_HOS_C10_62,A_C1_4201,S3_1_C8_22,B_2_C26_52,E_B_HOS_C1_14,S3_1_C15_21,S3_1_C6_32,A7_1_C3_6,D_5_HOS_C2_91,D_4_HOS_C4_50,B_1_C0_91,B_1_C22_100,D_5_HOS_C2_54,D_5_HOS_C4_68,S4_HHA1_C2_35,E_A_HOS_C1_7093,B_2_C26_51,B_2_C26_111,B_1_C0_101,S5_C2_7,S2_1_C2_1512,D_4_HOS_C10_91,S3_2_C4_16,D_4_SNF_C11_73,D_4_IRF_C13_59,S2_1_C2_1522,S3_2_C5_39,B_1_C22_63,A_C1_9920,B_1_C0_6250,C_1_C7_70,D_4_HOS_C1_69,S2_1_C2_129,A_C2_6,S3_2_C2_3,B_1_C0_5,D_4_HOS_C11_71,D_5_HOS_C3_9201,D_5_HOS_C7_93,S3_2_C4_1601,S2_1_C2_132,S3_1_C7_1801,B_1_C26_50,B_1_C22_66,B_1_C0_192,A_C6_190,B_2_C26_201,S2_1_C2_1808,D_5_HOS_C5_6250,A_C6_97,B_1_C0_95,A_C1_111,S2_1_C1_27,S3_1_C6_9,A7_1_C3_3,S3_2_C5_40,D_4_HOS_C12_55,D1_HOS_C5_45,S3_1_C7_13,S3_2_C5_10,D_5_HOS_C7_74,D_4_HOS_C3_53,D_4_HOS_C1_50,D_5_HOS_C4_73,S3_1_C2_11,C_1_C5_100,D_4_HOS_C2_60,D3_IRF_C3_200,B_1_C26_42,B_1_C22_193,B_2_C26_68,A7_1_C3_5,D_4_IPF_C11_51,D_4_IPF_C13_64,D_4_HOS_C13_55,D3_IRF_C2_76,D_5_HOS_C7_91,D_4_HOS_C10_75,B_1_C0_4,D_4_HOS_C10_96,S3_1_C3_16,A_C2_64,S3_2_C2_14,C_1_C5_55,A_C1_16,D_4_SNF_C11_63,D_5_HOS_C7_66,D_4_HOS_C2_50,S5_C2_9,D3_HOS_C2_57,D3_SNF_C2_32,S3_2_C4_42,D_4_HOS_C10_90,D_4_HOS_C13_91,D3_HOS_C2_70,S2_1_C2_1520,D3_HOS_C3_56,B_1_C0_41,C_1_C2_66,A_C6_19,S2_1_C2_1524,D_3_HOS_C5_200,D_4_HOS_C2_53,D_4_HOS_C3_59,A_C1_74,D3_HOS_C2_66,D_4_IPF_C11_200,G_C1THRU4_23,S2_1_C2_36,S4_HHA1_C1_33,S2_1_C2_1505,C_1_C5_94,B_2_C26_116,D_4_HOS_C10_70,S3_1_C7_17,A_C1_51,A_C2_14,B_2_C26_73,S3_1_C9_27,D_4_IRF_C13_75,A_C2_34,A_C2_9910,D3_HOS_C3_73,A_C1_107,S3_3_C4_5,B_1_C21_106,B_1_C21_41,D1_HOS_C1_63,B_1_C26_202,D_5_HOS_C6_69,A_C2_116,S3_2_C4_1602,D3_IRF_C3_67,S2_1_C2_143,D_4_IPF_C13_70,S3_1_C10_22,D_5_HOS_C5_68,S5_C1_21,B_1_C22_111,B_1_C0_35,A_C1_100,D3_IPF_C2_66,D3_HOS_C2_69,D3_IRF_C3_96,D_4_IRF_C13_50,B_2_C26_66,D3_SNF_C3_68,D_5_HOS_C7_68,D_5_HOS_C4_200,D1_IRF_C1_48,B_1_C22_68,D_4_IRF_C13_76,B_1_C21_191,D3_SNF_C2_76,G_C1THRU4_37,S2_1_C2_15,E_B_HOS_C1_28,A7_1_C2_1,B_1_C26_201,D4_LIVER_C1_69,D_4_HOS_C12_96,B_1_C0_110,A_C2_111,S3_2_C6_12,D3_IPF_C3_65,D_5_HOS_C2_69,D1_HOS_C1_26,D3_IPF_C3_66,D3_IRF_C3_73,B_2_C26_9920,S3_2_C4_31,S3_1_C8_24,B_1_C26_93,C_1_C5_53,S3_2_C6_7,E_B_HOS_C101_4,D_4_HOS_C3_60,B_1_C26_41,D_5_HOS_C6_53,D3_HOS_C3_62,A_C1_33,S3_2_C6_1402,A_C6_43,D_5_HOS_C2_64,D3_IPF_C2_53,A_C2_16,S3_2_C5_29,A_C6_22,A_C6_200,C_1_C6_53,B_1_C22_99,S3_2_C5_31,D_3_HOS_C9_200,D_4_HOS_C2_56,D_4_HOS_C2_67,B_1_C26_34,S3_1_C13_1,B_1_C21_9201,D_1_HOS_C4_34,D3_IRF_C3_9201,B_1_C0_15,S3_2_C2_8,D_5_HOS_C3_68,D_5_HOS_C5_57,B_1_C21_117,S3_1_C8_11,D_5_HOS_C2_66,C_1_C5_111,D_5_HOS_C7_55,S5_C2_1,S3_2_C6_37,B_2_C26_93,A_C6_6,S2_1_C2_1610,D1_HOS_C5_44,S3_2_C6_6,C_1_C7_107,D_4_SNF_C11_62,A7_3_C10_3,B_2_C26_193,C_1_C5_43,A_C1_9940,S3_2_C2_5,D3_SNF_C3_70,S3_2_C4_43,G_C1THRU4_46,B_1_C26_66,B_1_C0_22,D_1_HOS_C6_34,B_1_C21_50,B_1_C22_57,A_C6_91,A_C1_45,S3_1_C9_24,D_5_HOS_C6_65,B_1_C26_68,S10_C3_22,S3_3_C4_2,D3_SNF_C3_54,S4_HHA1_C3_34,A_C1_30,D_4_IRF_C11_51,A7_1_C3_1,S3_2_C4_4,A_C2_15,D_4_HOS_C10_65,D3_IRF_C3_70,B_2_C26_194,D_4_SNF_C11_75,S3_1_C3_11,C_1_C5_72,E_B_HOS_C1_25,D3_IRF_C2_75,S2_1_C2_1803,D_4_IRF_C11_71,C_1_C5_71,A_C2_33,D_5_HOS_C5_67,C_1_C7_73,B_1_C26_72,D_1_HOS_C7_40,D3_IPF_C2_70,A7_1_C1_8,S3_2_C6_36,S3_3_C5_3,D3_HOS_C2_71,D_4_HOS_C12_54,D_5_HOS_C6_96,A_C2_193,A_C1_14,D_4_HOS_C4_56,C_1_C6_52,B_1_C26_9920,B_1_C21_190,B_1_C21_31,S3_1_C3_1,S3_1_C10_19,A_C2_18,B_1_C22_192,A_C6_34,D_5_HOS_C2_93,S3_2_C2_1401,S3_2_C5_32,S3_1_C3_14,E_B_HOS_C1_29,C_1_C6_91,D_4_HOS_C10_9201,D_4_IPF_C11_74,D3_SNF_C2_57,D_5_HOS_C3_50,D_5_HOS_C3_96,C_1_C7_60,S2_1_C2_14,S3_2_C6_10,D_4_HOS_C4_200,A7_3_C6_3,D_5_HOS_C4_71,C_1_C6_68,S3_2_C2_16,A7_1_C1_4,D3_HOS_C2_61,S3_1_C5_1,A_C1_117,A8_C2_9,D3_IPF_C3_68,S3_1_C9_22,A_C2_13,S4_HHA1_C4_35,S5_C6_1,D3_SNF_C2_50,D_4_IRF_C13_51,S3_2_C2_4,B_1_C0_94,RPT_STUS_CD,G_C1THRU4_48,D_5_HOS_C4_6250,B_2_C26_9201,D_4_IPF_C11_56,A7_1_C7_4,S3_1_C8_16,A_C1_93,A_C2_200,D_4_SNF_C11_200,B_2_C26_112,S3_2_C2_30,D_4_SNF_C11_71,D1_SNF_C1_74,S2_1_C3_2,S4_HHA3_C5_37,B_1_C0_54,D3_IRF_C3_57,S3_2_C4_22,A7_3_C6_2,S3_3_C4_1,B_1_C21_40,D3_IRF_C2_69,D3_IRF_C2_90,D_4_HOS_C13_70,A_C2_89,C_1_C7_110,A_C2_57,S3_3_C6_4,A7_1_C7_7,S3_1_C6_10,D_4_SNF_C11_68,D_4_HOS_C3_89,D_4_HOS_C4_57,D3_HOS_C2_60,D_4_IPF_C6_200,B_1_C0_4501,A_C2_192,D3_HOS_C3_67,S3_2_C6_15,D_4_IPF_C11_58,A7_1_C6_7,D_5_HOS_C3_64,S5_C1_9,D_5_HOS_C5_72,D_5_HOS_C5_93,C_1_C5_4501,A7_1_C7_1,B_1_C21_76,D_5_HOS_C7_52,S3_2_C4_2550,D_4_HOS_C11_54,D_4_HOS_C11_58,G3_C1_28,S5_C1_3,B_1_C0_69,A_C6_6250,D_4_HOS_C3_57,S3_2_C5_7,S3_1_C6_19,S3_2_C6_39,B_1_C21_101,A_C1_116,B_1_C26_35,S3_2_C2_2553,D_4_IRF_C13_200,S3_2_C4_11,A_C6_54,D_4_HOS_C12_75,D3_SNF_C3_75,D3_IPF_C2_93,D3_IPF_C3_98,A_C2_61,B_1_C0_68,E_B_HOS_C1_13,E_B_HOS_C101_8,S4_HHA1_C4_37,D_4_HOS_C10_93,D_5_HOS_C4_91,S3_2_C4_3,A7_1_C3_2,S2_1_C2_1501,B_1_C22_52,RPT_REC_NUM,D_5_HOS_C2_97,E_B_HOS_C1_41,D_5_HOS_C5_65,S3_3_C6_2,D_5_HOS_C6_98,S3_1_C11_25,B_1_C21_70,S3_2_C3_25,C_1_C6_95,S2_1_C2_16,A_C6_55,S3_1_C7_12,S3_2_C4_21,S10_C1_2,A7_1_C2_3,D_4_IRF_C13_71,E_B_HOS_C1_11,D_4_IRF_C11_70,C_1_C7_9930,D_5_HOS_C5_51,A7_1_C1_3,D3_IPF_C2_94,S3_1_C13_2,D1_IPF_C1_41,D_5_HOS_C6_6250,C_1_C6_101,A_C6_111,D_5_HOS_C3_6250,E_B_HOS_C1_7,D_5_HOS_C7_63,E_A_HOS_C1_59,D3_SNF_C2_52,S4_HHA1_C2_33,A_C2_41,D3_IPF_C3_70,D_5_HOS_C2_74,D_4_HOS_C11_98,S4_HHA3_C4_35,D3_HOS_C3_65,S2_1_C2_12,S10_C3_21,S2_1_C1_3,B_1_C26_109,C_1_C6_62,D_4_IPF_C13_50,S2_1_C2_10,S3_2_C4_38,A_C2_75,D3_IPF_C3_63,A_C6_18,A_C2_23,D1_IPF_C1_49,C_1_C6_42,D3_IRF_C3_50,C_1_C5_32,S2_1_C2_5,S2_1_C1_125,D_4_IPF_C13_73,D_5_HOS_C2_67,A_C2_105,B_1_C22_90,C_1_C5_69,D_5_HOS_C3_56,S3_2_C5_8,B_1_C26_31,FI_NUM,D_4_HOS_C10_58,D3_IRF_C2_6250,C_1_C6_41,E_B_HOS_C1_26,G3_C1_3,A_C1_91,C_1_C6_73,D_1_HOS_C7_32,E_B_HOS_C101_2,S4_HHA2_C2_38,E_B_HOS_C101_3,S3_1_C10_25,D_4_IRF_C13_54,D_4_HOS_C10_51,A_C6_50,S2_1_C3_11801,A_C2_70,D_4_HOS_C2_51,C_1_C5_31,D_4_IRF_C11_59,B_1_C22_34,S2_1_C1_131,D_4_HOS_C3_69,C_1_C5_116,A7_1_C1_10,C_1_C5_9930,A8_C2_20,C_1_C7_9910,D3_IRF_C2_40,E_B_HOS_C1_5,D_3_HOS_C3_200,C_1_C7_75,D_1_HOS_C7_41,D3_IRF_C3_6250,D3_SNF_C2_30,B_2_C26_57,S3_1_C2_10,C_1_C7_54,G_C1THRU4_36,B_1_C0_30,D_4_IPF_C11_93,D3_SNF_C2_40,S2_1_C1_85,A_C6_93,A7_1_C3_8,S10_C1_14,A7_3_C6_1,D_5_HOS_C3_200,S2_1_C2_8,D3_SNF_C2_58,A_C2_2,D_5_HOS_C3_94,C_1_C5_97,C_1_C6_60,S5_C1_2,S3_1_C3_8,S3_1_C11_24,A7_1_C5_8,D_4_IPF_C11_66,A8_C2_25,B_2_C26_54,D_4_SNF_C11_64,S3_2_C5_2,B_1_C22_45,D_5_HOS_C3_74,D_4_HOS_C2_64,A8_C2_31,C_1_C7_71,D3_IPF_C3_76,E_B_HOS_C1_23,D_5_HOS_C2_59,A7_3_C15_2,S2_1_C1_106,D_4_IPF_C11_76,B_1_C26_51,S3_2_C4_1402,S3_1_C4_11,D_4_IPF_C11_71,D_4_IPF_C11_90,D_4_HOS_C11_69,S3_3_C5_7,E_B_HOS_C1_3998,S10_C2_23,D_5_HOS_C6_66,D_4_HOS_C3_56,A7_1_C7_6,D_4_HOS_C1_200,S3_2_C4_23,D3_SNF_C3_200,B_1_C22_51,D_4_IPF_C11_73,S3_3_C4_7,A_C6_58,D_4_HOS_C12_70,S3_1_C7_2001,D_4_HOS_C4_65,D1_IRF_C1_50,S3_2_C4_36,D_5_HOS_C2_72,C_1_C6_50,C_1_C6_96,B_2_C26_107,D3_IPF_C2_69,A_C1_94,A8_C2_29,B_2_C26_55,S3_1_C7_9,C_1_C5_76,C_1_C6_34,B_1_C22_110,D_5_HOS_C4_94,B_2_C26_58,E_B_HOS_C1_40,S10_C1_8,S3_2_C6_38,D_4_IPF_C13_59,D_4_HOS_C4_71,D3_IRF_C2_73,A_C2_32,D_4_HOS_C11_200,B_1_C0_107,D3_HOS_C2_35,D_5_HOS_C4_93,B_2_C26_40,D3_HOS_C3_58,A_C6_194,A_C6_2,S3_1_C13_16,D_4_HOS_C2_69,B_1_C0_2,D_5_HOS_C2_57,D_5_HOS_C4_50,S3_1_C4_12,S3_2_C6_26,A_C6_96,D_4_HOS_C3_72,D_4_HOS_C13_59,D_4_IPF_C13_67,S3_1_C2_18,S5_C4_3,D1_IRF_C1_52,S5_C1_10,A7_3_C11_3,D3_SNF_C2_67,B_1_C22_35,S5_C1_6,S10_C1_1,D_5_HOS_C5_90,B_1_C0_32,S2_1_C2_1514,S3_2_C4_19,D_4_IRF_C13_91,D_5_HOS_C4_9201,S3_2_C4_1,C_1_C5_9910,D_4_HOS_C3_58,S3_3_C6_3,D_4_HOS_C13_62,D3_HOS_C2_67,S3_2_C6_34,S3_2_C4_2201,D_4_HOS_C13_60,B_1_C0_17,D3_HOS_C3_52,B_2_C26_9930,B_1_C22_101,D_4_HOS_C13_73,C_1_C7_67,D3_HOS_C2_30,A_C1_63,A_C2_106,D_4_HOS_C12_63,D3_IPF_C3_54,A_C6_67,A_C2_69,D_4_HOS_C11_67,S2_1_C1_48,S5_C3_2,S4_HHA2_C1_38,C_1_C7_91,D_4_HOS_C4_93,D1_IPF_C1_37,D3_HOS_C2_33,E_B_HOS_C1_27,A_C6_35,S3_1_C15_1,G_C1THRU4_1,S10_C1_30,A_C2_58,D_5_HOS_C5_76,A_C6_70,S3_2_C2_2,S4_HHA3_C3_35,S4_HHA1_C2_34,S5_C6_4,D_4_HOS_C12_56,B_1_C0_9,D_5_HOS_C3_93,A_C2_8,D_5_HOS_C5_58,A_C2_93,S2_1_C1_141,A_C6_69,C_1_C6_40,D_4_IPF_C13_52,D_4_HOS_C2_73,D_4_IRF_C13_70,C_1_C7_105,A_C6_113,D_5_HOS_C2_6250,D_4_IRF_C3_200,B_1_C0_116,C_1_C7_101,S3_1_C5_19,D3_HOS_C2_53,D3_IRF_C3_91,D_3_HOS_C9_44,B_2_C26_9910,S5_C4_4,D_4_HOS_C13_54,D3_IRF_C3_62,S2_1_C1_2,E_B_HOS_C1_1,S3_2_C6_33,D3_IPF_C2_35,B_1_C0_70,S3_1_C4_8,S10_C1_16,A8_C2_14,D_4_IRF_C13_60,B_1_C0_74,S2_1_C7_3,S3_2_C2_2551,A_C6_56,D_5_HOS_C5_69,G3_C1_1,B_1_C22_65,S10_C1_20,D3_HOS_C2_94,B_1_C0_44,C_1_C5_41,PRVDR_NUM,S2_1_C2_1509,S3_2_C4_29,A_C2_7,D1_HOS_C1_57,D3_IRF_C2_66,S2_1_C2_1508,D1_HOS_C1_52,D3_IPF_C3_200,S3_2_C2_1,S3_2_C4_28,C_1_C6_59,A_C1_106,D3_IRF_C3_75,C_1_C5_34,D3_IRF_C3_98,D_4_HOS_C10_98,D1_SNF_C1_37,A_C1_55,B_1_C0_89,A_C6_41,B_2_C26_105,D_4_IPF_C13_68,B_1_C26_40,A_C2_5,S2_1_C2_1603,D_3_HOS_C9_30,D3_IPF_C2_98,E_B_HOS_C1_35,S3_1_C12_16,D_4_IRF_C11_64,B_1_C26_30,A8_C2_8,A7_3_C15_3,S2_1_C1_145,S3_1_C7_24,D_4_HOS_C12_64,C_1_C5_67,S4_HHA1_C5_34,D_5_HOS_C2_71,E_B_HOS_C1_6,D3_IPF_C2_73,D_4_IRF_C13_63,C_1_C7_99,D_1_HOS_C4_42,S2_1_C2_1510,B_2_C26_35,D_4_HOS_C12_73,B_1_C22_190,D_4_SNF_C11_55,B_1_C0_21,S3_1_C7_6,D3_HOS_C2_54,S3_1_C5_17,S3_1_C8_20,B_1_C26_117,S3_2_C3_2552,B_1_C0_96,D_4_HOS_C11_91,S4_HHA1_C1_36,B_1_C0_98,D_1_HOS_C6_30,S2_1_C2_126,S4_HHA1_C5_35,D_4_HOS_C12_65,G_C1THRU4_17,B_1_C22_46,B_1_C0_88,D_4_HOS_C2_90,A_C2_90,S3_2_C3_22,D_1_HOS_C4_31,A_C2_54,A_C2_115,S10_C1_31,D3_IRF_C3_72,S3_3_C4_6,S3_1_C5_9,D1_HOS_C1_53,A_C1_57,A_C6_21,D3_IRF_C2_55,B_1_C0_9940,D_4_SNF_C11_60,B_1_C26_105,A_C6_23,D_4_HOS_C10_66,D3_IPF_C3_55,D_4_HOS_C1_91,A_C2_91,A8_C2_22,A_C6_1,C_1_C5_91,S2_1_C2_1605,S3_2_C2_22,G3_C1_29,B_2_C26_117,E_B_HOS_C1_15,D_5_HOS_C2_73,D_5_HOS_C3_95,B_1_C21_33,A_C6_107,S3_2_C2_24,E_B_HOS_C1_10,S2_1_C1_127,D_5_HOS_C3_63,S4_HHA2_C4_35,S3_2_C5_33,S10_C1_9,B_1_C0_9930,S3_2_C2_27,D4_LUNG_C1_69,B_1_C0_56,D_4_HOS_C1_66,D_4_HOS_C10_68,D_4_IPF_C11_9201,A_C2_9,D_4_HOS_C13_200,S2_1_C2_7,B_1_C26_98,S3_1_C6_2,A_C2_60,A_C2_73,D3_IRF_C2_64,E_B_HOS_C1_42,S2_1_C2_13,A7_1_C2_5,D_4_HOS_C11_60,C_1_C6_44,S5_C2_21,A_C2_63,S3_2_C2_17,S3_1_C15_14,S3_1_C8_25,S4_HHA3_C1_34,S4_HHA2_C5_33,A_C6_53,B_2_C26_6250,D_5_HOS_C2_70,A_C2_76,S3_2_C6_1401,S10_C1_17,A8_C2_27,D_4_HOS_C10_97,D3_SNF_C3_9201,D_4_HOS_C3_55,D3_HOS_C2_93,S3_1_C8_10,S4_HHA2_C5_38,D3_HOS_C2_68,B_1_C0_93,D3_IPF_C3_51,D_5_HOS_C3_67,S4_HHA1_C4_36,C_1_C5_74,A_C1_89,A8_C2_13,S2_1_C2_1602,S3_2_C4_2552,A7_1_C3_10,D_4_HOS_C3_65,A_C2_46,S4_HHA1_C5_37,B_1_C0_16,S2_1_C6_24,C_1_C5_46,S3_2_C6_1,D_4_HOS_C4_53,C_1_C7_66,G_C1THRU4_13,G_C1THRU4_34,S3_1_C2_8,D3_IRF_C2_32,C_1_C7_109,A_C6_89,A_C1_44,D_4_HOS_C3_6250,A_C2_3,D_4_HOS_C4_64,S2_1_C1_11801,A_C1_9910,A7_3_C7_1,S2_1_C2_1201,S5_C2_3,A_C6_42,D3_SNF_C3_63,A_C2_66,D3_IRF_C2_52,S4_HHA1_C5_33,D_5_HOS_C2_76,D_1_HOS_C6_31,S3_1_C2_27,C_1_C5_57,C_1_C7_57,A7_1_C2_10,S3_3_C2_6,G_C1THRU4_15,D_4_SNF_C11_52,C_1_C7_74,B_1_C22_42,A8_C2_3,S5_C2_8,A_C6_16,A_C1_71,D_5_HOS_C7_59,S2_1_C2_9,ST_CTY_CD,S2_1_C2_128,D_5_HOS_C2_9201,D_5_HOS_C6_67,B_1_C26_74,D3_IRF_C2_41,D_4_HOS_C6_200,A_C6_9920,S3_1_C5_14,B_1_C0_50,B_1_C0_62,S4_HHA2_C1_33,D3_HOS_C3_63,S2_1_C1_26,B_2_C26_98,D3_HOS_C3_71,D3_SNF_C2_60,A_C6_9,D3_SNF_C3_58,D3_HOS_C3_9201,D3_IRF_C2_9201,S4_HHA3_C4_38,D_5_HOS_C5_52,S3_2_C5_28,S2_1_C2_1607,B_1_C21_52,A_C6_45,S3_2_C4_41,D3_IPF_C2_64,D1_SNF_C1_85,S3_1_C5_10,B_2_C26_42,D_4_HOS_C2_98,D_4_SNF_C11_93,D3_IPF_C3_69,S2_1_C2_1502,S3_2_C6_2,B_1_C22_116,S3_1_C3_12,A_C6_109,B_1_C21_63,C_1_C5_90,D_1_HOS_C7_35,D_4_IPF_C11_69,D1_SNF_C1_84,D_4_HOS_C2_93,A_C6_192,D_4_HOS_C12_51,D_4_HOS_C11_55,C_1_C5_6250,S3_2_C6_9,B_1_C26_96,D1_IPF_C1_50,A_C2_65,D3_SNF_C2_9201,D_4_HOS_C10_63,D_4_IPF_C4_200,D3_IRF_C3_74,B_1_C22_107,D3_HOS_C2_52,D3_HOS_C3_53,B_1_C22_106,C_1_C7_116,D3_IPF_C2_67,B_2_C26_50,S2_1_C1_108,A_C1_65,B_2_C26_109,S3_1_C8_21,B_1_C0_40,S4_HHA3_C3_38,D4_ISLET_C1_69,A_C1_67,D_5_HOS_C6_73,E_B_HOS_C101_6,D_4_IPF_C13_63,C_1_C7_115,S5_C2_5,S3_2_C2_26,D_4_HOS_C10_73,S3_1_C2_14,D_3_HOS_C9_33,S3_1_C6_11,B_1_C0_9201,D_4_HOS_C13_90,B_1_C0_12,A_C6_112,B_2_C26_4201,S4_HHA1_C4_38,D_4_IRF_C4_200,D3_IPF_C3_72,G3_C1_26,E_B_HOS_C1_44,C_1_C6_202,D3_SNF_C2_69,D_4_HOS_C4_90,A_C1_72,S4_HHA2_C1_35,A_C6_99,B_1_C21_93,B_1_C26_56,S3_2_C2_7,D3_IPF_C3_50,E_B_HOS_C1_32,D_4_HOS_C3_73,B_1_C26_54,S3_1_C2_17,S5_C5_1,S3_2_C2_2552,A_C1_12,S3_2_C2_18,S4_HHA3_C5_33,A_C1_42,S4_HHA2_C2_33,D_4_HOS_C12_98,D_4_SNF_C11_66,E_B_HOS_C1_12,B_2_C26_99,D_5_HOS_C5_63,D3_IPF_C3_62,C_1_C6_9940,D_4_HOS_C11_94,D3_HOS_C2_40,S3_2_C3_2551,B_1_C22_30,C_1_C6_9930,D_4_HOS_C4_69,D1_HOS_C1_51,S3_3_C5_4,S3_2_C5_38,B_2_C0_202,B_2_C26_69,D_5_HOS_C6_60,A_C6_4201,A_C1_110,D3_IPF_C3_73,B_2_C26_115,A_C6_32,C_1_C7_95,C_1_C7_52,A_C1_112,D_4_HOS_C10_69,D_4_HOS_C13_51,D_4_HOS_C2_59,D_4_IPF_C13_93,S2_1_C2_1513,A_C6_4501,A_C6_46,G_C1THRU4_6,S4_HHA2_C4_36,D3_SNF_C2_41,D_5_HOS_C4_62,D3_IRF_C2_96,D_4_IPF_C13_71,A_C6_11,S2_1_C4_3,A_C6_31,D_4_IPF_C11_65,D_4_HOS_C4_54,S3_1_C4_9,D_1_HOS_C7_31,G3_C1_4,A_C2_50,S3_2_C5_27,C_1_C5_30,C_1_C5_89,B_1_C0_43,B_2_C26_4501,D3_HOS_C3_200,B_1_C21_100,S3_1_C5_8,S4_HHA3_C3_36,D_4_HOS_C2_57,D_5_HOS_C4_90,B_1_C26_111,D3_HOS_C2_62,C_1_C6_97,D_5_HOS_C2_50,D_4_IRF_C13_58,S4_HHA2_C3_38,D_5_HOS_C6_90,S3_1_C3_20,S3_2_C4_15,B_1_C0_60,D_1_HOS_C4_200,S3_1_C6_22,A_C2_53,A_C6_71,D3_HOS_C2_97,A8_C2_50,D3_IRF_C2_200,D_4_HOS_C12_58,A8_C2_18,B_1_C21_54,E_B_HOS_C1_34,D_5_HOS_C2_55,S3_1_C15_17,S2_1_C1_60,D3_SNF_C2_65,D3_IRF_C2_57,B_2_C26_89,A7_1_C7_2,S3_2_C5_13,S2_1_C1_22,C_1_C6_105,S4_HHA3_C1_36,D_4_HOS_C10_72,D_3_HOS_C9_32,D_5_HOS_C3_60,D3_IRF_C3_90,S3_1_C3_32,S3_2_C2_39,A_C1_194,B_1_C22_70,D_4_HOS_C13_57,A_C2_113,C_1_C5_9920,S3_1_C3_18,B_1_C0_33,D_4_HOS_C12_68,D3_IRF_C2_34,B_1_C0_13,D_5_HOS_C2_56,C_1_C5_110,D_4_HOS_C10_56,D_4_SNF_C11_50,D_5_HOS_C2_58,S2_1_C2_1507,REGION,D_4_HOS_C13_9201,D_4_HOS_C3_93,A_C6_40,B_1_C0_71,S2_1_C1_142,A_C1_7,S2_1_C2_1807,B_2_C26_90,D_4_IPF_C11_67,D_4_IRF_C11_66,C_1_C6_94,D_4_HOS_C13_67,C_1_C5_108,B_1_C21_60,D_4_HOS_C4_89,B_1_C21_21,D3_IPF_C2_40,D_5_HOS_C3_57,D_4_HOS_C11_52,D3_IRF_C3_68,S4_HHA3_C2_37,S3_2_C2_2550,C_1_C5_65,D_4_IPF_C11_52,S2_1_C2_1523,S3_2_C4_1401,D3_IRF_C2_62,E_B_HOS_C1_4,A7_3_C11_2,A_C1_18,S3_3_C6_5,B_1_C0_66,D_5_HOS_C6_58,D3_SNF_C3_69,D_4_HOS_C4_67,D_4_IRF_C13_52,UTIL_CODE,B_1_C26_193,A_C2_101,S3_2_C3_23,D3_IRF_C2_71,S10_C3_23,S4_HHA1_C3_38,D_4_HOS_C12_97,E_B_HOS_C1_37,D1_HOS_C5_46,A_C6_73,D_4_HOS_C2_65,G3_C1_25,S2_1_C2_3601,D3_IPF_C2_54,S3_1_C10_27,B_1_C26_64,C_1_C5_66,A_C1_75,S2_1_C1_47,D_4_IRF_C11_72,S3_2_C4_14,D_4_IRF_C11_56,A_C6_114,B_1_C22_191,D3_SNF_C3_72,C_1_C6_111,TRNSMTL_NUM,A_C2_112,B_2_C26_65,C_1_C5_52,S3_1_C10_18,C_1_C7_72,D_5_HOS_C5_97,S4_HHA1_C5_36,D_5_HOS_C6_52,D4_PANCREAS_C1_69,B_1_C0_67,D_5_HOS_C4_55,D_5_HOS_C3_59,D3_IRF_C2_58,S3_2_C2_12,S3_2_C2_29,D3_SNF_C2_93,D1_IRF_C1_53,D_4_HOS_C11_66,E_B_HOS_C1_18,B_2_C26_56,B_1_C0_100,D3_HOS_C3_57,S3_1_C2_1,S2_1_C2_1402,D_4_IPF_C11_68,D_4_IRF_C11_52,S3_1_C9_14,B_2_C26_95,B_2_C26_71,D_5_HOS_C7_98,G_C1THRU4_45,S4_HHA2_C5_36,A7_1_C7_3,S3_1_C14_16,S3_1_C6_24,B_1_C26_88,S3_2_C4_25,E_B_HOS_C1_22,B_2_C26_63,D_4_HOS_C11_9201,D3_SNF_C3_64,S3_1_C7_10,G_C1THRU4_51,S3_1_C10_1801,A8_C2_30,A8_C2_4,S3_2_C2_13,D_5_HOS_C6_71,B_1_C22_108,B_1_C0_190,S3_3_C6_1,S10_C1_12,A_C1_98,B_1_C22_50,B_2_C26_43,B_1_C0_58,S3_2_C4_7,B_1_C26_44,D3_IRF_C2_74,D3_IRF_C2_93,S2_1_C1_116,D_1_HOS_C6_41,C_1_C6_72,S3_1_C2_24,E_B_HOS_C1_36,D_1_HOS_C4_4201,D_4_HOS_C3_98,S3_1_C8_17,B_1_C26_107,D3_IRF_C2_98,B_1_C0_14,D3_HOS_C3_66,C_1_C7_59,A_C1_8,A_C2_191,S2_1_C4_24,A_C2_67,D3_SNF_C3_73,A7_1_C1_1,C_1_C5_62,D_4_HOS_C11_73,B_1_C26_53,D_4_IRF_C11_50,S3_1_C2_16,A8_C2_11,S3_1_C12_1,D3_IPF_C2_74,B_2_C26_108,B_1_C21_95,D_5_HOS_C2_65,D_5_HOS_C3_76,A_C1_56,C_1_C7_98,STATE,B_1_C22_67,CENSUS,D3_IRF_C3_94,D3_SNF_C3_62,S2_1_C2_1519,B_1_C26_91,D_5_HOS_C5_66,A7_1_C5_6,B_1_C26_67,S3_1_C10_24,B_2_C26_46,D3_IPF_C2_62,D_5_HOS_C3_55,D3_IRF_C3_51,S3_1_C8_32,D3_HOS_C3_94,D_5_HOS_C6_75,S10_C1_10,D_4_SNF_C11_56,S5_C2_10,S5_C4_2,S4_HHA3_C1_38,B_1_C0_9910,B_1_C26_9910,C_1_C6_9920,E_A_HOS_C1_72,D_5_HOS_C2_52,A_C2_4,D3_IRF_C3_59,A_C6_60,D3_HOS_C2_42,D_4_HOS_C3_97,D_4_HOS_C4_74,A_C2_72,A_C6_59,D_4_SNF_C11_72,B_1_C22_72,D_4_IPF_C13_60,D3_HOS_C3_76,A_C2_10,D_5_HOS_C6_50,C_1_C7_90,C_1_C7_202,C_1_C7_93,B_1_C0_61,B_1_C21_91,S3_2_C6_5,S10_C2_20,D_4_HOS_C4_91,D_4_IPF_C11_63,A_C6_64,D_4_HOS_C4_73,D3_HOS_C3_50,A_C1_23,C_1_C7_97,S4_HHA2_C2_37,D_5_HOS_C4_60,D_4_HOS_C13_56,E_B_HOS_C1_19,S2_1_C1_115,D_4_HOS_C13_52,S4_HHA2_C5_34,D3_HOS_C2_74,B_1_C26_71,A_C6_191,S3_1_C2_12,E_B_HOS_C1_16,S3_2_C4_27,D_4_HOS_C10_55,D3_SNF_C3_94,A7_3_C9_1,A_C2_99,D1_HOS_C1_41,D_4_SNF_C11_59,S2_1_C2_1601,B_1_C26_32,C_1_C6_31,B_1_C26_58,S3_1_C7_8,E_B_HOS_C1_30,E_A_HOS_C1_7099,S3_1_C3_9,S3_1_C2_7,A_C2_55,C_1_C6_63,D_4_IPF_C11_91,D_5_HOS_C3_62,D_4_HOS_C12_62,G_C1THRU4_31,G_C1THRU4_54,S4_HHA2_C1_36,D3_IRF_C3_58,G_C1THRU4_49,D_4_SNF_C11_91,S3_2_C2_15,S3_2_C5_9,S2_1_C1_128,D_4_HOS_C4_76,D3_HOS_C2_56,D_5_HOS_C6_9201,D3_SNF_C3_65,D_4_SNF_C11_54,D_1_HOS_C6_33,D_5_HOS_C6_59,D3_HOS_C2_6250,D_4_HOS_C10_76,S2_1_C1_37,A_C1_96,D3_HOS_C2_63,D_4_IPF_C11_62,S3_1_C8_18,B_1_C26_63,D3_IPF_C2_57,A7_1_C2_2,A_C2_40,S3_1_C14_1,A_C6_68,S3_1_C7_19,D3_IPF_C2_32,D_4_IRF_C13_68,D_4_HOS_C3_66,S3_1_C3_21,G3_C1_2,S2_1_C1_4,B_1_C0_108,A_C6_30,S3_2_C6_14,D_4_IRF_C11_200,D_5_HOS_C4_66,S3_3_C4_4,B_2_C26_60,D_4_HOS_C11_76,D_4_IPF_C11_75,B_2_C26_9940,D3_HOS_C2_76,S4_HHA1_C3_35,S2_1_C1_24,S5_C1_1,A_C6_8,D3_IPF_C3_52,A7_3_C9_2,B_1_C22_44,C_1_C5_4201,D_5_HOS_C4_76,C_1_C5_54,C_1_C6_88,A_C1_21,A7_1_C5_2,D_4_HOS_C2_68,D_5_HOS_C5_73,A_C6_9940,B_2_C26_75,D_5_HOS_C3_51,A_C1_69,D_4_HOS_C2_72,D_5_HOS_C7_94,S10_C1_11,D_1_HOS_C7_200,B_2_C26_97,S3_1_C11_14,D3_IRF_C3_65,S3_2_C3_1401,D_5_HOS_C6_55,D_4_HOS_C2_9201,D3_SNF_C3_67,D3_HOS_C3_60,D3_IPF_C3_93,S3_2_C2_20,D_4_HOS_C3_94,D_5_HOS_C3_52,S4_HHA2_C4_34,D3_HOS_C2_73,B_1_C26_6250,S4_HHA2_C5_35,S3_2_C2_23,D3_HOS_C2_91,D_4_HOS_C2_52,S3_1_C2_2001,S10_C2_21,C_1_C6_55,S3_1_C15_18,A_C1_54,A8_C2_7,A7_3_C9_3,S3_1_C7_5,D3_IPF_C2_65,A_C1_50,D3_IRF_C2_53,B_1_C26_116,S3_1_C9_18,B_1_C21_67,D_5_HOS_C6_57,S2_1_C2_127,D_5_HOS_C5_96,B_1_C21_75,D3_SNF_C2_62,C_1_C6_70,D_5_HOS_C2_68,S5_C6_2,B_1_C22_40,B_1_C22_73,S3_1_C2_1801,B_1_C21_64,D_4_IRF_C11_55,S2_1_C3_24,D_4_IPF_C13_66,D_4_HOS_C11_50,D3_SNF_C2_31,S3_1_C13_14,D_4_IRF_C11_68,D_4_IPF_C13_65,B_1_C22_109,D3_IRF_C2_61,D3_HOS_C3_61,A_C6_106,D3_SNF_C2_59,C_1_C6_61,D_4_HOS_C3_90,D_4_HOS_C12_91,D3_IPF_C2_42,A7_1_C3_4,C_1_C6_98,S3_2_C2_32,B_1_C0_18,C_1_C6_32,S3_1_C6_7,C_1_C5_45,B_1_C22_53,S10_C3_20,S2_1_C2_1202,S2_1_C2_1503,D_5_HOS_C5_53,S3_1_C9_21,D_1_HOS_C6_40,D_5_HOS_C7_96,S3_2_C6_30,D1_IRF_C1_37,A7_1_C2_8,D_5_HOS_C4_70,D3_SNF_C3_60,D3_SNF_C3_91,S3_3_C2_2,D_4_SNF_C11_53,S4_HHA1_C3_33,A_C2_4201,S3_1_C7_25,B_1_C21_46,B_1_C0_75,C_1_C6_54,D_4_HOS_C11_74,D_5_HOS_C4_69,B_1_C26_97,D3_SNF_C3_74,S3_2_C6_27,D_5_HOS_C4_58,D_5_HOS_C7_53,D3_IPF_C3_59,C_1_C5_61,D_4_HOS_C12_90,D_5_HOS_C3_65,D3_HOS_C2_59,D3_HOS_C3_72,S4_HHA3_C4_33,D_1_HOS_C6_32,D_5_HOS_C2_90,A_C6_116,B_1_C21_72,S3_2_C3_2550,D_4_IRF_C13_56,D_4_HOS_C2_62,B_1_C0_117,A_C6_17,S10_C1_22,D_5_HOS_C7_65,G_C1THRU4_40,S3_1_C5_16,S4_HHA3_C1_33,D_5_HOS_C6_72,D_5_HOS_C7_75,D3_IRF_C3_69,S2_1_C1_144,S3_2_C6_8,C_1_C6_56,E_B_HOS_C1_20,D_4_HOS_C12_50,S3_2_C4_6,D_5_HOS_C5_91,G_C1THRU4_19,D4_INTESTINE_C1_69,B_1_C0_55,B_1_C26_194,S2_1_C2_1606,S3_2_C5_5,C_1_C6_66,D_4_HOS_C2_88,S3_3_C5_2,B_1_C21_193,C_1_C6_71,S3_2_C5_11,C_1_C7_94,D_5_HOS_C6_97,D1_IRF_C1_49,A7_3_C15_1,S10_C1_15,B_1_C22_115,B_1_C26_190,D_4_IRF_C11_57,D4_HEART_C1_69,B_2_C26_191,D_4_HOS_C10_59,D_4_HOS_C3_9201,D_5_HOS_C6_56,A8_C2_28,D3_SNF_C2_90,D_5_HOS_C6_74,B_1_C21_53,D3_IPF_C3_75,A_C6_110,S3_1_C13_17,A_C1_9201,S3_1_C5_7,A_C1_76,D_4_IRF_C6_200,S3_2_C5_14,S3_3_C6_6,C_1_C5_202,D_4_IRF_C2_200,S4_HHA1_C1_35,B_1_C26_55,D3_IRF_C2_59,B_2_C26_31,S4_HHA2_C5_37,D3_SNF_C3_90,A7_3_C7_3,S3_1_C3_17,S3_3_C5_6,S10_C1_18,B_2_C26_33,S2_1_C2_1001,C_1_C6_35,C_1_C6_117,S2_1_C2_1517,A_C2_22,D3_IPF_C2_96,D_4_SNF_C11_70,D_5_HOS_C7_70,D3_SNF_C3_53,D3_IPF_C2_63,D3_IPF_C3_91,D_4_IRF_C13_69,B_2_C26_34,A_C6_52,D_4_HOS_C13_64,D_4_IPF_C13_75,S3_2_C5_1,B_2_C26_101,A_C1_200,A_C1_64,A7_1_C1_6,D_4_IPF_C13_9201,C_1_C7_61,A_C1_95,C_1_C5_44,C_1_C7_63,C_1_C7_9920,D3_IRF_C3_55,C_1_C7_6250,C_1_C5_70,D3_HOS_C3_98,S3_1_C4_10,D3_IPF_C3_71,D3_IRF_C3_61,D_5_HOS_C5_50,A_C6_76,B_1_C21_62,B_1_C0_1,G_C1THRU4_11,D_5_HOS_C2_96,D3_HOS_C3_6250,D_1_HOS_C4_43,A8_C2_6,A_C6_15,A_C2_109,B_1_C26_69,D_4_IPF_C11_57,MSA,S10_C2_22,C_1_C6_65,D_4_HOS_C3_96,D3_IPF_C2_59,S3_2_C2_43,D_5_HOS_C7_62,S3_1_C3_2001,C_1_C5_95,B_1_C0_19,D_5_HOS_C6_70,D_4_HOS_C2_54,S4_HHA2_C4_37,D_4_HOS_C4_70,S3_1_C10_14,B_1_C26_192,D_1_HOS_C7_30,C_1_C7_69,A_C6_3,D_5_HOS_C5_74,S3_2_C6_29,C_1_C6_58,S3_2_C2_31,D_4_HOS_C12_59,D3_HOS_C3_70,D3_SNF_C2_96,D3_SNF_C3_76,B_1_C0_31,B_1_C26_60,B_1_C26_4501,S3_2_C2_6,C_1_C5_68,A_C1_191,D_3_HOS_C9_35,D3_IPF_C3_90,B_1_C26_101,C_1_C5_50,S3_2_C6_35,D3_IPF_C3_57,A_C1_46,D3_SNF_C2_74,B_1_C26_61,D_4_HOS_C13_69,A_C1_114,S2_1_C2_1809,A_C6_74,A_C6_20,C_1_C7_88,D1_IRF_C1_41,B_1_C21_105,D3_IRF_C3_64,A_C6_12,S5_C1_5,B_1_C26_9201,D3_IPF_C2_33,S3_1_C6_15,B_1_C21_109,D3_SNF_C3_93,S5_C1_7,S2_1_C1_105,C_1_C7_68,S3_1_C13_18,C_1_C6_6250,C_1_C5_101,B_1_C21_99,B_1_C22_56,B_1_C26_9930,C_1_C5_59,A_C6_51,D_4_HOS_C12_69,S3_2_C4_8,B_1_C22_194,A7_1_C5_5,S4_HHA1_C3_36,A8_C2_1,S3_2_C2_28,D_5_HOS_C6_63,D_4_IRF_C11_63,D3_HOS_C3_93,D_4_IRF_C13_55,D3_IPF_C2_60,D_4_IRF_C11_93,D1_HOS_C1_49,B_2_C26_67,E_B_HOS_C1_4001,B_1_C22_59,B_1_C21_35,A_C1_4,D1_IPF_C1_53,S2_1_C1_35,S3_1_C8_19,FY_BGN_DT,S3_2_C2_25,S3_2_C3_2553,S3_1_C7_22,A_C1_90,D_5_HOS_C7_51,A7_3_C5_3,S3_1_C10_2001,D3_HOS_C2_58,A_C1_88,D_5_HOS_C3_58,S3_1_C6_12,S3_2_C2_35,S3_1_C7_15,D1_HOS_C1_37,D3_IRF_C2_31,C_1_C7_9201,A_C1_32,A_C1_41,A_C6_193,A_C6_75,D3_IPF_C3_60,D_4_IRF_C11_74,D_4_IRF_C13_64,D1_HOS_C1_58,C_1_C6_93,C_1_C7_76,D_5_HOS_C5_75,D3_IPF_C2_91,S3_2_C4_33,S3_2_C4_32,S10_C1_26,B_1_C0_10,D_4_HOS_C3_200,C_1_C5_40,D_5_HOS_C7_54,A_C2_4501,B_1_C21_94,D_4_HOS_C12_76,D_4_IRF_C13_65,B_1_C0_59,A_C6_5,S3_2_C4_2551,S3_2_C6_32,G_C1THRU4_8,A_C2_9940,S3_1_C7_14,S3_1_C10_26,D3_IRF_C3_66,D_4_IPF_C13_56,D3_HOS_C2_75,S3_2_C2_34,A_C6_13,B_1_C0_193,D_5_HOS_C7_58,S2_1_C2_11801,D3_HOS_C3_69,E_B_HOS_C1_9,D_4_IRF_C1_102,D_5_HOS_C4_53,S10_C1_23,E_B_HOS_C101_7,A_C1_60,D3_IPF_C2_76,B_1_C0_115,S3_1_C5_20,D3_IPF_C3_67,B_1_C22_71,D_4_IRF_C13_73,D_4_HOS_C4_52,S3_2_C4_9,D_5_HOS_C4_75,D_4_HOS_C12_6250,A_C1_105,A_C2_110,D_5_HOS_C6_61,S3_1_C6_8,G_C1THRU4_52,A7_1_C5_10,D_4_IPF_C11_60,D_5_HOS_C2_200,G_C1THRU4_4,D_4_IPF_C13_54,S2_1_C2_1611,S2_1_C1_86,C_1_C2_67,A8_C2_12,S4_HHA2_C3_35,D_4_IPF_C13_57,S2_1_C1_140,D3_HOS_C2_41,A_C2_68,D_4_SNF_C11_9201,A_C1_52,C_1_C5_117,D_4_HOS_C13_71,G_C1THRU4_27,D_4_HOS_C11_72,D_5_HOS_C3_61,A_C2_45,D3_HOS_C3_54,A_C2_17,B_1_C0_72,S3_2_C5_3,A_C1_4501,B_1_C26_99,D_4_IRF_C11_53,D3_SNF_C2_98,S3_1_C6_16,D_3_HOS_C6_200,S5_C3_1,D_5_HOS_C3_54,D_4_HOS_C12_72,S3_1_C6_17,D_4_IPF_C11_50,A_C2_94,A_C2_194,D_5_HOS_C4_56,D_3_HOS_C8_200,D_1_HOS_C4_41,S3_1_C11_22,S2_1_C2_1511,D3_IRF_C2_91,B_1_C22_31,C_1_C6_43,D3_IRF_C2_72,S3_2_C5_43,S4_HHA1_C2_37,S3_1_C14_14,S3_2_C2_38,A7_1_C5_1,C_1_C6_107,D_4_HOS_C1_60,B_2_C26_30,D_5_HOS_C5_98,G_C1THRU4_12,D_4_IPF_C13_55,D_4_IPF_C13_51,D_4_HOS_C1_54,S3_1_C8_28,S3_2_C5_41,B_1_C22_64,A_C1_109,A_C6_66,D3_HOS_C2_34,B_2_C26_202,C_1_C5_56,A7_1_C7_10,B_1_C21_89,S5_C1_15,D3_IRF_C2_60,D3_SNF_C2_56,S5_C2_6,B_1_C21_51,S3_1_C2_19,D3_SNF_C2_68,A_C1_73,S5_C1_11,D_4_HOS_C10_64,D_5_HOS_C3_98,B_1_C21_108,B_1_C21_69,D3_HOS_C2_98,A_C1_66,D3_IRF_C2_63,D_4_HOS_C3_70,A_C2_108,D3_IPF_C2_56,C_1_C2_68,S3_2_C2_36,A7_1_C5_3,B_1_C22_69,D_4_IRF_C11_76,C_1_C5_112,A7_3_C10_1,A8_C2_19,A_C1_20,S2_1_C1_132,D_5_HOS_C4_57,D_4_HOS_C11_93,B_2_C26_200,D_4_HOS_C2_74,D_4_HOS_C13_53,A_C2_51,D_5_HOS_C2_98,D3_SNF_C3_98,D3_SNF_C3_51,S2_1_C3_143,C_1_C6_112,S2_1_C2_142,C_1_C6_64,B_1_C0_23,A_C1_97,C_1_C8_202,D1_IRF_C1_27,D_4_IPF_C2_200,D_5_HOS_C4_96,S2_1_C2_1521,D_4_SNF_C11_90,S2_1_C2_3801,D_4_IRF_C11_54,S3_1_C9_19,G3_C1_5,S3_1_C2_32,D_4_HOS_C13_66,A_C6_88,B_1_C0_90,D_5_HOS_C5_64,E_B_HOS_C1_17,S5_C1_12,S3_1_C11_26,B_1_C26_33,S3_1_C10_21,A_C6_115,S3_2_C4_30,B_1_C26_75,B_1_C0_194,C_1_C5_35,A8_C2_10,D_4_IPF_C11_72,D_5_HOS_C6_93,B_1_C22_88,S3_1_C6_25,A_C1_101,D3_SNF_C2_94,D_5_HOS_C5_54,S4_HHA2_C2_35,S10_C1_13,A_C1_53,D3_HOS_C2_51,D3_IPF_C3_56,B_2_C26_190,S4_HHA2_C3_36,D3_HOS_C2_72,D3_SNF_C2_202,D_4_IRF_C13_93,B_2_C26_94,C_1_C7_58,B_1_C21_55,S2_1_C1_134,S3_1_C8_7,B_2_C26_110,D_5_HOS_C7_50,S2_1_C2_1,D3_SNF_C3_55,S2_1_C2_18,A_C6_65,S2_1_C5_24,D_5_HOS_C2_75,D1_IPF_C1_48,S2_1_C2_1516,A_C1_62,D_4_HOS_C2_75,B_1_C21_58,D3_IRF_C3_76,D_4_IPF_C11_59,A_C2_107,B_2_C26_96,C_1_C5_99,S3_1_C8_14,B_1_C26_73,D_4_IPF_C11_54,D_5_HOS_C7_69,D_4_HOS_C3_63,D_4_IPF_C11_53,A8_C2_5,B_1_C22_54,A_C2_20,C_1_C7_100,S3_1_C6_14,B_1_C22_91,D_4_HOS_C10_60,D_3_HOS_C9_31,D_4_IRF_C11_90,D_4_HOS_C10_50,A_C1_6,D_4_HOS_C12_71,D3_HOS_C3_96,D_4_HOS_C3_67,D_5_HOS_C3_97,D_4_IPF_C11_64,S3_1_C9_20,D_4_HOS_C3_62,D_4_IPF_C13_62,C_1_C6_69,D3_SNF_C2_91,D_4_HOS_C13_93,B_1_C0_11,D_4_HOS_C13_72,S3_2_C5_6,D3_SNF_C2_63,A_C1_190,G_C1THRU4_47,D3_HOS_C2_9201,S3_1_C9_26,S3_2_C2_19,A7_1_C7_8,D_4_IPF_C11_70,S3_1_C6_5,D_4_IRF_C11_91,E_B_HOS_C1_24,B_1_C26_112,S3_1_C3_7,D_4_HOS_C12_200,D1_HOS_C1_27,D_5_HOS_C4_98,S2_1_C1_5,S2_1_C2_1804,D3_IPF_C3_94,A_C2_30,D_4_HOS_C12_60,S5_C2_2,A7_1_C5_7,D_4_HOS_C11_75,C_1_C7_50,D3_SNF_C3_71,S3_1_C5_11,B_2_C26_72,D3_SNF_C3_59,S3_1_C7_7,S3_3_C5_1,C_1_C7_106,D_4_HOS_C1_76,D_5_HOS_C4_54,B_1_C26_108,B_1_C26_110,A_C6_9910,S3_2_C4_26,E_B_HOS_C101_5,S4_HHA1_C4_33,S3_2_C4_34,Report_Period_Begin_Yr,Beginning FFY,Medicaid Shortfall (S10_C1_8),Stand-alone CHIP Shortfall (S10_C1_12),State or local govt Shortfall (S10_C1_16),Charity Care Expense Ratio,Total Net Assets,Medicaid Costs,Cash Reserves,Net Profit Margin,Operating Profit,Operating Profit Margin,LIQUIDITY current ratio,LIQUIDITY acid-test ratio,LIQUIDITY acid-test ratio (variation),LIQUIDITY cash ratio,Equity,SOLVENCY Debt-to-Equity Ratio,SOLVENCY Debt Ratio,SOLVENCY Equity Ratio,SOLVENCY Interest Coverage Ratio,SOLVENCY total assets less total liabilities,EFFICIENCY asset turnover ratio,EFFICIENCY Accounts Receivable Turnover Ratio,Hospital Type (From CMS Hospitals Data Archive),,Medicaid Expansion State,Name and Num
,Curated Name and Num,Hospital type (modified),Type of Control of Hospital (See Table I),Lon,Lat,Other Ancillary,Title V discharges,Clinic,MRI,Total Non Routine Medical  Supply Charges,Hospice 2 Provider Number,SNF,Total,Pass through Cost for Program Inpatient Routine,MRI,Durable Medical Equipment Rented,Speech Pathology,Durable Medical Equipment Rented,Nursery,With Outliers:  Total Charges,Hospital State,Relief Payment,NF,ASC (Non Distinct Part),Total,Renal Dialysis,ASC (Distinct Part),Delivery Room and Labor Room,CT Scan,Related Salaries,Received DSH or supplemental payments from Medicaid? (Y/N),Anesthesiology,RHC,Respiratory Therapy,Durable Medical Equipment Sold,Blood Clotting Factors for Hemoph.,Other Outpatient Services,Laboratory,Recovery Room,Sale of medical and surgical supplies to,Hospital County,Adults & Pediatrics,Contract Labor:  Physician Part A,Lung  Acquisition,NF,Delivery Room and Labor Room,Other Ancillary,Fiscal Year End Date,Other Ancillary,Hospice,Respiratory Therapy,HRR adjustment amount,Impl. Dev. Charged to Patients,Whole Blood & Packed Red Blood Cells,Ambulance Services,Operating Room,SNF,Labor and Delivery Days -  Title XIX,PEP Episodes:  Total Visits,Occupational Therapy,Total Allied Health Cost,Subprovider II,Other Outpatient Services,Burn Intensive Care Unit,Other Special Purpose,Radioisotope,Anesthesiology,Other Ancillary,Kidney Acquisition,OOT,Adults & Pediatrics,MDH status ending date (MM/DD/YY),Recovery Room,TOTAL,Home Program Dialysis,Nursing School,New Cap Related Csts Movable Equipment,Subtotal Wage Related Csts,Occupational Therapy,Wage Related Costs Other,Int & Res (non approved teaching program,Electroencephalography,Other Special Care,Drugs Charged to Patients,SNF,Central Services and Supply,Home Program Dialysis,Other Reimbursable,Medical and Other Services reimbursed by OPPS,Surgical Intensive Care Unit,Physicians' Private Office,Medical Supplies Charged to Patients,MSP-LCC reconciliation amount,Electrocardiology,Clinic,Physical Therapy,"Average patient dialysis time 
including setup",Intravenous Therapy,IPF Provider Number,Physicians' Private Office,Intravenous Therapy,OLTC,Medical Supplies Charged to Patients,Durable Medical Equipment Rented,ASC (Non Distinct Part),Physician-Part A,Utilization,Radiology-Diagnostic,Subprovider I,Recovery Room,Observation Beds (Distinct Unit),Cardiac Catheterization,Nursery,Electroencephalography,Impl. Dev. Charged to Patients,Intravenous Therapy,Burn Intensive Care Unit,RHC,Subtotal,"Blood Storing, Processing, Trans",Home Program Dialysis,Other adjustments,Recovery Room,Electrocardiology,"Is this a teaching hospital or
affiliated with a teaching hospital? (Y/N)",Begin Balance,Other Organ Acquisition,Dietary under Contract,CORF,Non-Physician Anesthetist Part A,Cardiac Catheterization,Laboratory,Drugs Charged to Patients,Whole Blood & Packed Red Blood Cells,Radiology-Therapeutic,Nonpaid Workers,FQHC,Clinic,RHC,Other Ancillary,Respiratory Therapy,Whole Blood & Packed Red Blood Cells,Int & Res (non approved teaching program,Drugs Charged to Patients,Total Facility FTEs,FQHC 9 Provider Number,Medical Supplies Charged to Patients,Impl. Dev. Charged to Patients,Electroencephalography,RHC 7 Provider Number,Dietary,Delivery Room and Labor Room,Pharmacy,OOT,Research,Lung  Acquisition,Intravenous Therapy,Radioisotope,Other Reimbursable,Other General Service,Renal Dialysis,New Cap Related Csts Movable Equipment,Other Ancillary,Burn Intensive Care Unit,"Salaries, Wages, and Fees Payable",Delivery Room and Labor Room,MRI,Recovery Room,Subprovider 2,Notes Receivable,NF,"Blood Storing, Processing, Trans",Drugs Charged to Patients,Medical Supplies Charged to Patients,Recovery Room,Drugs Charged to Patients,Pancreas Acquisition,Observation Beds (Distinct Unit),Blood Clotting Factors for Hemoph.,Intestinal Acquisition,MRI,Fixed Equipment,Whole Blood & Packed Red Blood Cells,Radioisotope,Intravenous Therapy,CT Scan,Teaching Physician Salaries,Operation of Plant,Net Salaries,Other Special Care Unit,Component rate ESRD,CMHC,Radiology-Therapeutic,Subprovider-IPF,Total unreimbursed cost for Medicaid and CHIP and state and local indigent care programs,Intravenous Therapy,Electroencephalography,MRI,Liver Acquisition,Radiology-Diagnostic,Non-Physician Anesthetist Part B,Clinic,Durable Medical Equipment Sold,Provider's actual MSA or CBSA,SNF,With Outliers:  Total Visits,RHC,Payroll taxes payable,Minor Equipment Depreciable,Non-Physician Anesthetist Part B,Medicare Certified Pancreas TC term date,Adj for Respiratory therapy costs in excess,Emergency,Nursery,Total Number of Episodes,Laundry and Linen Service,Adj for Physical therapy costs in excess,With Outliers:  Non Routine Med Sup Chgs,Surgical Intensive Care Unit,OOT,Other Special Care Unit,Blood Clotting Factors for Hemoph.,Subprovider-IPF,Other Reimbursable,"Blood Storing, Processing, Trans",MDH status beginning date  (MM/DD/YY),CT Scan,Teaching Physician Salaries,Total Fund Balances,Other Ancillary,Medicaid (Title XIX) discharges,"If Line 32, Col 1 is yes, enter the method used: (A, B, or E only)",Utilization Review SNF,Does the facility operate an ICF/MR facility for purposes of Title XIX? (Y/N),Laboratory,Cross Foot Adjustments,net of Swing Bed Cost,Drugs Charged to Patients,Renal Dialysis,Less Observation Beds,Without Outliers:  Other Charges,Laboratory,Organ Procurement,Total Long-term Liabilities,Total Hospital,Cafeteria,Int & Res (non approved teaching program,Renal Dialysis,OSP,Movable Equipment,Cardiac Catheterization,Emergency,Operating Room,Other Organ Acquisition,Contract Labor,Number of stations,Cardiac Catheterization,Respiratory Therapy,Burn Intensive Care Unit,Total Overhead Costs,Islet Acquisition,Electrocardiology,Heart Acquisition,Respiratory Therapy,ICF,Hospital Street Address,Outpatient Revenue,CT Scan,Kidney Acquisition,ASC (Non Distinct Part),Other Ancillary,CMHC 1 Provider Number,Impl. Dev. Charged to Patients,ASC (Non Distinct Part),Burn Intensive Care Unit,Radiology-Diagnostic,Other Ancillary,Observation Beds (Distinct Unit),Other Organ Acquisition,Emergency,"Blood Storing, Processing, Trans",ASC (Distinct Part),Other Ancillary,Whole Blood & Packed Red Blood Cells,"Net costs of Epoietin furnished to
all maintenance dialysis patients
by the provider",MRI,Other Special Purpose,Radiology-Diagnostic,Renal Dialysis,Anesthesiology,Number of stations,CT Scan,Other Current Assets,Physician-Part B,MDH status beginning date (MM/DD/YY),Impl. Dev. Charged to Patients,Deferred Income,Renal Dialysis,Impl. Dev. Charged to Patients,Other Adjustments (Summed),Observation Beds (Distinct Unit),Renal Dialysis,Surgical Intensive Care Unit,Cardiac Catheterization,"Income from imposition of interest, finance",Physical Therapy,Lung  Acquisition,Whole Blood & Packed Red Blood Cells,Maintenance and Repairs,Int & Res (non approved teaching program,Operating Room,Radiology-Therapeutic,Clinic,Respiratory Therapy,Blood Clotting Factors for Hemoph.,Wage Related Costs RHC/FQHC,ASC (Distinct Part),Intensive Care Unit Program Cost,Home Office Salaries & Wage Related Csts,Electroencephalography,Pharmacy,Surgical Intensive Care Unit,PBP Clinical Lab Services Program Only,Renal Dialysis,Pass Through Cost for  Program Ancillary,Maintenance of Personnel,CT Scan,Other Special Care Unit,Maintenance of Personnel,Intravenous Therapy,CT Scan,Durable Medical Equipment Rented,Occupational Therapy,Recovery Room,Hospital Adlts & Ped Swing Bed NF,Fixed Equipment,Clinic,Inventory,Fiscal Intermediary/MAC Create Date,Anesthesiology,Coronary Care Unit,Physician-Part A,Ambulance Services,Total,Cafeteria,Delivery Room and Labor Room,SNF,Durable Medical Equipment Sold,Nursing Administration,"Blood Storing, Processing, Trans",Respiratory Therapy,Dietary,Renal Dialysis,Without Outliers:  Other Charges,Total Non Routine Medical  Supply Charges,Impl. Dev. Charged to Patients,Occupational Therapy,Clinic,Surgical Intensive Care Unit,"Gift, Flower, Coffee Shop, Canteen",Employee Benefits,LUPA Episodes:  Other Charges,"Number of days in year dialysis 
furnished","Epoietin amount form worksheet A
for home dialysis program",Clinic,Wage Related Costs Core,Whole Blood & Packed Red Blood Cells,Dietary,Pass Through Cost for  Program Ancillary,Occupational Therapy,Administrative and General under Contract,Cost of patients approved for charity care and uninsured discounts,Speech Pathology,CT Scan,Transitional corridor payment,CT Scan,Observation Beds (Distinct Unit),ASC (Distinct Part),CT Scan,Contract Labor,Subtotal Other Wages and Related Csts,New Cap Related Csts Bldg & Fixtures,Operation of Plant,LUPA Episodes:  Total Visits,Hospital Adults & Pediatrics,Emergency,Coronary Care Unit,Total Nursing School,Radiology-Therapeutic,Radiology-Therapeutic,Total Costs,Anesthesiology,Respiratory Therapy,NF,Observation Beds (Distinct Unit),Laboratory,Subprovider I,Medical Supplies Charged to Patients,Home Office:  Physician Part A,Laundry and Linen Service,Burn Intensive Care Unit,Medicare allowable bad debts for the entire hospital complex,Cardiac Catheterization,RHC/FQHC Combined,Cafeteria,Coronary Care Unit,Other Outpatient Services,Contract Labor:  Physician Part A,Observation Beds (Distinct Unit),Nursery,Sale of drugs to other than patients,Other Special Care,Medical Supplies Charged to Patients,Total,Management and Administrative Services,Social Service,NF,Respiratory Therapy,Intensive Care Unit,Social Service,RHC 5 Provider Number,Intensive Care Unit,Other Nonreimbursable,FQHC,Cardiac Catheterization,Speech Pathology,Other Ancillary,ASC (Non Distinct Part),OLTC,PEP Episodes:  Other Charges,Radioisotope,Anesthesiology,Social Service,OSP,Building Improvements,Subprovider-IRF,Speech Pathology,Without Outliers:  Total Charges,Speech Pathology,Recovery Room,Renal 2 Provider Number,Hospital Adults & Pediatrics,Whole Blood & Packed Red Blood Cells,Research,HHA,Subprovider-IPF,Medical Supplies Charged to Patients,OLTC,Delivery Room and Labor Room,Islet Acquisition,Administrative and General,Operation of Plant,Subprovider-IRF,Durable Medical Equipment Rented,Clinic,Whole Blood & Packed Red Blood Cells,Nursery,Medical Records & Med Records Library,FQHC,"Medicare certified kidney 
transplant center cert date",City,Without Outliers:  Non Routine Med Sup Chgs,Speech Pathology,Radioisotope,OPT,Coronary Care Unit,IPF,Lung  Acquisition,"Blood Storing, Processing, Trans",CMHC,Home Program Dialysis,Subprovider II,Anesthesiology,Medical Supplies Charged to Patients,Renal Dialysis,Total Fixed Assets,CMHC,Recovery Room,Physician Part A Teaching,Respiratory Therapy,RHC/FQHC Combined,ASC (Non Distinct Part),SNF,In State Medicaid eligible days,NF,OSP,Respiratory Therapy,Anesthesiology,Occupational Therapy,Hospital Adults & Pediatrics,Ambulance Services,Subprovider 2,Total,OPT,Other Special Purpose,Physical Therapy,Program Inpatient Ancillary Service Cost,Nursery,Drugs Charged to Patients,Physical Therapy,Durable Medical Equipment Rented,Renal 3 Provider Number,Medical Supplies Charged to Patients,Other Reimbursable,Electroencephalography,Balance due provider/program,Kidney Acquisition,Target Amount,Pharmacy,ICF,Intensive Care Unit,CT Scan,Total Other Charges,ASC (Non Distinct Part),Other Ancillary,Intravenous Therapy,Laboratory,Whole Blood & Packed Red Blood Cells,Other Organ Acquisition,OLTC,Whole Blood & Packed Red Blood Cells,FQHC,Anesthesiology,Primary payer payments,Physical Therapy,PEP:  Total Non Routine Med Supply Chgs,MRI,Total,Cardiac Catheterization,Physical Therapy,Speech Pathology,Emergency,Total Program Excludable Costs,Drugs Charged to Patients,Radiology-Therapeutic,Radioisotope,Subtotal Salaries,Electroencephalography,CAH Visits,Occupational Therapy,Intensive Care Unit,Other Current Liabilities,"Blood Storing, Processing, Trans",Observation Beds (Distinct Unit),Radiology-Therapeutic,Medical Supplies Charged to Patients,Emergency,RHC/FQHC Combined,Physical Therapy,Pancreas Acquisition,Excluded Area Salaries,Hospital Adults & Pediatrics,Cardiac Catheterization,Subprovider-IRF,Laboratory,MRI,Interns & Res Salary and Fringe Benefits,Excluded Area Salaries,Respiratory Therapy,RHC 16 Provider Number,NF,Radiology-Diagnostic,ASC (Distinct Part),Anesthesiology,Total Nonphysician Anesthetist Cost,Renal Dialysis,Radioisotope,Pancreas Acquisition,Radiology-Therapeutic,Durable Medical Equipment Sold,Subprovider I,Anesthesiology,Intravenous Therapy,Surgical Intensive Care Unit,ASC (Non Distinct Part),Heart Acquisition,Social Service,Beginning Date of SCH status,Kidney Acquisition,Subprovider II,RHC,"Blood Storing, Processing, Trans",Wage Related Costs RHC/FQHC,"Number of patients in program at 
end of cost reporting period",Donations,Clinic,Radioisotope,Total Allied Health,Int & Res (non approved teaching program,Home Program Dialysis,Other Reimbursable,Speech Pathology,Burn Intensive Care Unit,Intravenous Therapy,Coronary Intensive Care Unit,RHC 19 Provider Number,MRI,LUPA Episodes:  Total Visits,Ambulance Services,Total discharges,Delivery Room and Labor Room,Speech Pathology,Subprovider I,FI/Contractor's Name,Dietary under contract,Purchase,Other Outpatient Services,Beginning Date of SCH status,Physicians' Private Office,Interns & Residents,Heart Acquisition,Total Hospital,FQHC 10 Provider Number,Other Reimbursable,Radiology-Therapeutic,Durable Medical Equipment Sold,MRI,Operating Room,Lesser of cost or charges,Radiology-Therapeutic,Depreciation-New Bldgs & Fixtures,Clinic,MRI,Intravenous Therapy,Surgical Intensive Care Unit,Housekeeping under contract,FQHC 5 Provider Number,Delivery Room and Labor Room,Renal Dialysis,Impl. Dev. Charged to Patients,"Blood Storing, Processing, Trans",NF,OLTC,Other Reimbursable,Heart Acquisition,Renal Dialysis,Anesthesiology,PEP Episodes:  Total Number of Episodes,Operating Room,Liver Acquisition,Total,Medicaid charges,PEP:  Total Number of Outlier Episodes,Total,Observation Beds (Distinct Unit),Rental of quarters to employee and oths,Recovery Room,Anesthesiology,OPPS payments,HMO,Renal Dialysis,Other Special Care Unit,Electroencephalography,Subtotal Salaries,Subprovider-IRF,Non-Physician Anesthetist Part A,Heart Acquisition,Employee Benefits,Intravenous Therapy,Coronary Care Unit,Investment Income-New Movable Equip,Ambulance Trips,Electrocardiology,Interns & Res Other Program Costs,ASC (Non Distinct Part),Target Amount per Discharge,Emergency,Recovery Room,New Cap Related Csts Movable Equipment,Hospital Adlts & Ped Swing Bed SNF,Other Special Care Unit,Whole Blood & Packed Red Blood Cells,Speech Pathology,Hospice,Electroencephalography,Recovery Room,Renal 6 Provider Number,ASC (Non Distinct Part),Subprovider 1,CT Scan,RHC,ASC (Non Distinct Part),Nonphysician Anesthetists,Land Improvements,Central Services and Supply,Medical Records & Med Records Library,Building Improvements,Total Other Assets,Coronary Care Unit,Medical Supplies Charged to Patients,Blood Clotting Factors for Hemoph.,Occupational Therapy,Maintenance of Personnel,Pharmacy,Other Special Purpose,Radiology-Diagnostic,SNF,NF,Renal 7 Provider Number,Radioisotope,New Cap Related Csts Bldg & Fixtures,Management and Administrative Services,Medicare reimbursable bad debts for the entire hospital complex,Delivery Room and Labor Room,Total Charges,Surgical Intensive Care Unit,Recovery Room,Anesthesiology,Respiratory Therapy,Home Program Dialysis,Temporary Investments,Intravenous Therapy,Other Special Care Unit,Intensive Care Unit,Recovery Room,Medicaid (Title XIX) discharges,Hospice,Laboratory,Cardiac Catheterization,Maintenance of Personnel,"Medical certified lung
transplant center cert date",Adults and Pediatrics,Nursery,Inpatient Revenue,Title V discharges,Operating Room,Drugs Charged to Patients,Impl. Dev. Charged to Patients,Delivery Room and Labor Room,Physician Part A,Housekeeping,New Capital Buildings and Fixtures,Recovery Room,Ambulance Services,Related  Salaries,Observation Beds (Distinct Unit),With Outliers:  Non Routine Med Sup Chgs,Physical Therapy,Program Discharges,Nonphysician Anesthetists,Clinic,Whole Blood & Packed Red Blood Cells,Subprovider II,HHA,Delivery Room and Labor Room,Total reasonable charges,Total discharges,Labor and Delivery Days Title 18,Movable Equipment,Emergency,Operating Room,Emergency,Int & Res (non approved teaching program,Radiology-Diagnostic,Speech Pathology,With Outliers:  Total Charges,HVBP payment adjustment amount,Recovery Room,Islet Acquisition,HHA,"Treatment capacity per day per
station",RHC 13 Provider Number,Emergency,Teaching Physician Salaries,Drugs Charged to Patients,Cardiac Catheterization,RHC 23 Provider Number,Central Services and Supply,"Blood Storing, Processing, Trans",OPT,Blood Clotting Factors for Hemoph.,Electroencephalography,Electrocardiology,Medicare Certified Lung TC term date,Maintenance and Repairs,Non-Physician Anesthetist Part B,Administrative and General,Medical Supplies Charged to Patients,Observation Beds (Distinct Unit),Other Outpatient Services,Teaching Physician Salaries,Medicare Certified Islet TC term date,Subprovider 2,Operating Room,Physical Therapy,Physicians' Private Office,"Gift, Flower, Coffee Shop, Canteen",Negative Cost Centers,Renal 9 Provider Number,Blood Clotting Factors for Hemoph.,Durable Medical Equipment Sold,Ambulance Services,Islet Acquisition,Urban (1) or Rural (2),Coronary Care Unit,Buildings and Fixtures,Pharmacy,Radiology-Therapeutic,Burn Intensive Care Unit Program Cost,Nursery,Excluded Area Salaries,Renal Dialysis,Anesthesiology,Operating Room,Drugs Charged to Patients,Surgical Intensive Care Unit,Int & Res (non approved teaching program,Laboratory,TOTAL,Subprovider I,Nonpaid Workers,Speech Pathology,Fixed Equipment,Recovery Room,Intravenous Therapy,Radiology-Therapeutic,Other Ancillary,Emergency,ASC (Non Distinct Part),Employee Benefits,Durable Medical Equipment Rented,IPF,Intravenous Therapy,Home Office Salaries & Wage Related Csts,Radiology-Therapeutic,Medical Records and Medical Rec. Library,"Blood Storing, Processing, Trans",Physical Therapy,Operating Room,Average times dialyzers re-used,CT Scan,Coronary Care Unit,Social Service,Clinic,Emergency,Electroencephalography,RHC 21 Provider Number,Radioisotope,Subprovider-IRF,Physical Therapy,Nonphysician Anesthetists,RHC 25 Provider Number,Total Costs,Anesthesiology,Cardiac Catheterization,Renal Dialysis,Physical Therapy,Total,Major Movable Equipment,Ending Date of SCH status,Without Outliers:  Total Visits,RHC 6 Provider Number,Home Program Dialysis,Hospice,Electroencephalography,IRF,Recovery Room,Central Services and Supply,Drugs Charged to Patients,Total Facility FTEs,ASC (Non Distinct Part),Surgical Intensive Care Unit,CORF,Drugs Charged to Patients,Liver Acquisition,Subtotal Wage Related Csts,Heart Acquisition,Subprovider-IRF,Allowable Inpatient Cost Plus Incentive Pt,Total,Electrocardiology,Hospice,Teaching Physician Salaries,Occupational Therapy,State,Electroencephalography,HHA,Speech Pathology,MCP Physician Payment Method (Y/N),Islet Acquisition,Other Special Care Unit,Int & Res (non approved teaching program,Physical Therapy,Electrocardiology,Durable Medical Equipment Rented,Operating Room,Physical Therapy,Speech Pathology,Speech Pathology,Total,Program Inpatient Ancillary Service Cost,Speech Pathology,Other Ancillary,Research,Other Ancillary,Accounts Payable,RHC 1 Provider Number,interns and residents,Land,Negative Cost Centers,Organ Procurement,Durable Medical Equipment Rented,Intestinal Acquisition,Islet Acquisition,Management and Administrative Services,Respiratory Therapy,Electrocardiology,Total Swing Bed Cost,Physical Therapy,Drugs Charged to Patients,OPT,Laundry and Linen Service,Hospice,Other Outpatient Services,Anesthesiology,Interns & Residents,Outlier payments,Laboratory,Subprovider-IRF,Anesthesiology,Whole Blood & Packed Red Blood Cells,Burn Intensive Care Unit,Related Salaries,Nursery,Intravenous Therapy,Anesthesiology,Medical Records and Medical Rec. Library,Admin & Gen Under Contract,Interns & Res Other Program Costs,Total Salaries,Anesthesiology,CMHC,Laundry and Linen Service,Total,Radioisotope,Occupational Therapy,Surgical Intensive Care Unit,Title XVIII discharges,Observation Beds (Distinct Unit),Surgical Intensive Care Unit,Observation Beds (Distinct Unit),Pharmacy,Home Office Personnel,Speech Pathology,CT Scan,Other Special Purpose,Surgical Intensive Care Unit,Physical Therapy,Islet Acquisition,Radiology-Therapeutic,"Number of patients in program at 
end of cost reporting period",Maintenance of Personnel,Other Outpatient Services,Maintenance and Repairs,FQHC 11 Provider Number,Coronary Care Unit Program Cost,Non-Physician Part B,Liver Acquisition,Whole Blood & Packed Red Blood Cells,Total,Nonpaid Workers,Nursery,OSP,Physician-Part B,Electroencephalography,Other General Service,Mortgage Payable,Physical Therapy,Interns & Res Other Program Costs,Surgical Intensive Care Unit,Operating Room,CT Scan,Emergency,NF,Hospice,Respiratory Therapy,Speech Pathology,Payments received from patients for amounts previously written off as charity care,Excluded Area Salaries,Radiology-Diagnostic,LUPA Episodes:  Other Charges,Adults and Pediatrics,Recovery Room,Land,Physician-Part A,Pharmacy,Respiratory Therapy,Electroencephalography,Other Nonreimbursable,ASC (Non Distinct Part),Surgical Intensive Care Unit,Impl. Dev. Charged to Patients,Deductibles and coinsurance,ASC (Non Distinct Part),Renal 4 Provider Number,Medical Supplies Charged to Patients,Medical Supplies Charged to Patients,Burn Intensive Care Unit,Occupational Therapy,Drugs Charged to Patients,Impl. Dev. Charged to Patients,Subprovider-IPF,Electroencephalography,Subtotal,Cafeteria,Subtotal Salaries,Medical Supplies Charged to Patients,Radiology-Diagnostic,Durable Medical Equipment Rented,Nonpaid Workers,Central Services and Supply,Radioisotope,Delivery Room and Labor Room,OPT,"Gift, Flower, Coffee Shop, Canteen",Intensive Care Unit,Hospital Adults & Pediatrics,SNF,Other General Service,Physicians' Private Office,Surgical Intensive Care Unit,Other Outpatient Services,Home Office Salaries,Housekeeping,Total Hospital,ESRD DME costs,Emergency,Observation Beds (Distinct Unit),Renal Dialysis,CT Scan,Operating Room,Durable Medical Equipment Rented,Laboratory,Hospice 1 Provider Number,Excluded Area Salaries,Total Other Medical Education,Total,Medical Supplies Charged to Patients,Speech Pathology,Teaching Physician Salaries,Building Improvements,PBP Clinical Lab Services Program Only,Hospital Adults & Pediatrics,Other Special Purpose,Parking Lot,Speech Pathology,HHA,Nursing Administration,PEP Episodes:  Total Charges:,"Number of patients in program at 
end of cost reporting period",Operating Room,Recovery Room,Physician-Part A,Home Program Dialysis,Report Status Code,Unsecured Loans,Blood Clotting Factors for Hemoph.,Observation Beds (Distinct Unit),Radioisotope,Building Improvements,IPF,Other Outpatient Services,Total Salaries,Total,Other Organ Acquisition,Operation of Plant,Medical Supplies Charged to Patients,Total Program General Inp. Rtn Service,Hospital Zip Code,Total Number of Outlier Episodes,Radiology-Diagnostic,CT Scan,Physician Part A,New Cap Related Csts Movable Equipment,Net Salaries,Subprovider-IPF,Electrocardiology,Clinic,Electroencephalography,FQHC,Intestinal Acquisition,CT Scan,Subtotal Other Wages and Related Csts,Assets,Burn Intensive Care Unit,Speech Pathology,FQHC,CT Scan,Laboratory,Total Outpatient Program Pass Thru Cost,ICF,Physicians' Private Office,Occupational Therapy,Home Office:  Physician Part A,MRI,Ending Balance,Intravenous Therapy,Average times dialyzers re-used,Impl. Dev. Charged to Patients,Other Outpatient Services,ICF,Land,Other Ancillary,Delivery Room and Labor Room,Interns & Residents,Radiology-Diagnostic,MRI,Total Other Expenses,"Average patient dialysis time 
including setup",Electrocardiology,Blood Clotting Factors for Hemoph.,CT Scan,Interns & Residents,SNF,Central Services and Supply,HHA,Hospice,Other Special Care Unit,Interns & Residents,Total,Contract Labor,Radiology-Diagnostic,ASC (Non Distinct Part),ASC (Non Distinct Part),Other Outpatient Services,Other Reimbursable,PBP Clinical Lab Services Program Only,Speech Pathology,Organ acquisition charges,Transitional corridor payment,PEP:  Total Number of Outlier Episodes,Other Outpatient Services,Emergency,Non-Physician Anesthetist Part B,Land Improvements,RHC 2 Provider Number,Delivery Room and Labor Room,Report Record Number,Durable Medical Equipment Sold,Interim payments,Respiratory Therapy,Excluded Area Salaries,Other Reimbursable,Outpatient Rehab Provider,Electroencephalography,Interns & Residents,Ambulance Services,FQHC 1 Provider Number,Radiology-Therapeutic,Other Special Care,Non-Physician Anesthetist Part B,Net Revenue from Medicaid,Buildings and Fixtures,Medical Supplies Charged to Patients,Total cost,Electroencephalography,OOT,Recovery Room,Buildings and Fixtures,Home Program Dialysis,Title XVIII discharges,Total Program General Inpatient Routine,Blood Clotting Factors for Hemoph.,HHA,Islet Acquisition,Blood Clotting Factors for Hemoph.,"Sum of lines 3,4 divided by line 6","Blood Storing, Processing, Trans",IPPS Payment amount (unadjusted),Delivery Room and Labor Room,With Outliers:  Total Visits,Subprovider-IRF,Electroencephalography,Renal Dialysis,Other Reimbursable,PEP Episodes:  Total Charges:,Respiratory Therapy,HHA 1 Provider Number,Cost of patients approved for charity care and uninsured discounts,Hospital Name,Pancreas Acquisition,Whole Blood & Packed Red Blood Cells,Operating Room,NF Provider Number,Nursing Administration,ASC (Non Distinct Part),"Blood Storing, Processing, Trans",Other General Service,Paramedical Education,Total Program Inpatient Costs,Subprovider I,Operating Room,Coronary Care Unit,IRF Provider Number,"Does this facility operate 
transplant center? (Y/N)",Drugs Charged to Patients,Occupational Therapy,Kidney Acquisition,Clinic,Electrocardiology,Radioisotope,Home Office Personnel,Intensive Care Unit,Fiscal Intermediary Number,MRI,Blood Clotting Factors for Hemoph.,Subprovider-IRF,Deductibles and coinsurance related to line 24,Net Patient Revenue,Emergency,Drugs Charged to Patients,Coronary Intensive Care Unit,Medical and Other Services reimbursed by OPPS,With Outliers:  Non Routine Med Sup Chgs,OPPS payments,Outpatient Rehab Provider,Radiology-Diagnostic,Recovery Room,Operating Room,Self Insurance,Electroencephalography,Recovery Room,Intensive Care Unit,Cardiac Catheterization,Surgical Intensive Care Unit,certification date,Electrocardiology,Hospice,Total,OOT,Vending Machines,CORF,Subprovider-IRF,Payment to cost ratio,Total Other Medical Education Cost,ASC (Non Distinct Part),Subprovider-IRF,Blood Clotting Factors for Hemoph.,Adults and Pediatrics,CT Scan,Burn Intensive Care Unit,Radiology-Diagnostic,Total Assets,Adults and Pediatrics,Other Outpatient Services,Subprovider-IPF,Is this a New Hospital under 42 CFR 413.40(f)(1)(I) (TEFRA)? (Y/N),Other Outpatient Services,Subtotal,Total charges to state or local government programs for indigent care (not Medicaid or CHIP),New Cap Related Csts Bldg & Fixtures,Total,Swing Bed NF Provider Number,MRI,New Capital Equipment,Home Program Dialysis,Durable Medical Equipment Sold,Laboratory,Number of Times per week Patient receives Dialysis,Intensive Care Unit,Hospice,Subtotal,Physical Therapy,Utilization Review-physicians compens,Radiology-Diagnostic,Intravenous Therapy,Non-Physician Anesthetist Part A,NF,Renal Dialysis,Intravenous Therapy,Adj for Speech therapy in excess of lim,Medical Supplies Charged to Patients,Other Ancillary,Cost of physicians svcs in a teaching hospita,Cardiac Catheterization,New Cap Related Csts Movable Equipment,"If this facility qualifies as a RPCH/CAH, has it elected the all inclusive payment for outpatient service? (Y/N)",Other Ancillary,Recovery Room,Related Salaries,Surgical Intensive Care Unit,Medical Supplies Charged to Patients,Clinic,Electrocardiology,Total Overhead Costs,Partial or full credits from manufacturers,Cost of charity care (patients covered by public program + patients w/ coverage accepted by provider),Physical Therapy,Radioisotope,Movable Equipment,Total,Physician Part B,TOTAL,Recovery Room,Drugs Charged to Patients,Total Overhead Costs,MRI,Electroencephalography,ICF,Respiratory Therapy,Pass through Cost for Program Inpatient,Cafeteria,Impl. Dev. Charged to Patients,Operating Room,Durable Medical Equipment Rented,Liver Acquisition,Electrocardiology,Home Program Dialysis,Physicians' Assistant,Radiology-Therapeutic,Coronary Care Unit,Other Ancillary,Surgical Intensive Care Unit,Intestinal Acquisition,Home Program Dialysis,MRI,Subtotal,Medicaid Shortfall -- Costs minus net revenue (0 min),Nursing Administration,Cardiac Catheterization,Medical Supplies Charged to Patients,Drugs Charged to Patients,Coronary Care Unit,Total,Liver Acquisition,Other Special Care Unit,Other Outpatient Services,Subprovider-IPF,MRI,Other Nonreimbursable,New Capital Equipment,Title XVIII discharges,Electrocardiology,New Capital Equipment,CT Scan,Operating Room,Other Special Care,Employee Benefits,Durable Medical Equipment Rented,Impl. Dev. Charged to Patients,Cardiac Catheterization,Occupational Therapy,Subprovider 1,"Average patient dialysis time 
including setup",Total Program Excludable Costs,"Percentage of patients re-using
dialyzers",Total,Occupational Therapy,Other Special Care Unit,Number of stations,Cost To Charge Ratio,Clinic,Coronary Care Unit,RHC 15 Provider Number,Excluded Areas,Emergency,Observation Beds (Distinct Unit),Total Salaries,CORF,MRI,Subtotal Salaries,Whole Blood & Packed Red Blood Cells,Occupational Therapy,Dietary,Physician Part A Teaching,Laboratory,Social Service,Delivery Room and Labor Room,OOT,HHA,Drugs Charged to Patients,Occupational Therapy,Adults and Pediatrics,"Blood Storing, Processing, Trans",Heart Acquisition,"Blood Storing, Processing, Trans",Radiology-Diagnostic,Occupational Therapy,Electrocardiology,Occupational Therapy,Does the hospital elect a fully prospective payment method for capital costs? (Y/N),"Number of Times per week 
Patient receives Dialysis",Without Outliers:  Non Routine Med Sup Chgs,Emergency,Other Outpatient Services,net of Swing Bed and Private Room Diff,Burn Intensive Care Unit,Subtotal,Other Special Care Unit,Total discharges,Cash on Hand and in Banks,Cost of Uncompensated Care,MRI,Other Ancillary,Electroencephalography,Non-Physician Anesthetist Part A,Total Charges:  LUPA Episodes,With Outliers:  Other Charges,CAPD exchanges per day,Radioisotope,Housekeeping,Other Outpatient Services,Laundry and Linen Service,MRI,Other Outpatient Services,Home Office Name,Electrocardiology,Subprovider-IPF,Delivery Room and Labor Room,Drugs Charged to Patients,Electroencephalography,Kidney Acquisition,Interest Expense,Blood Clotting Factors for Hemoph.,Total Allied Health,Hospice,HHA,SNF,Anesthesiology,Emergency,SNF,CORF,CAPD exchanges per day,Radiology-Diagnostic,Whole Blood & Packed Red Blood Cells,Hospital City,Medical and Other Services,Housekeeping under Contract,Other Special Care Unit,Electroencephalography,Intensive Care Unit,State or local govt (not Medicaid or CHIP) Shortfall -- Costs minus net revenue (0 min),Cafeteria employees and guests,Laboratory,Renal Dialysis,Hospital Title 18 Payment System (P/T/O),Interns & Residents,Radioisotope,Electrocardiology,Gross Revenue,Respiratory Therapy,Charity care charges and uninsured discounts for the entire facility,Home Program Dialysis,SNF,Subprovider-IRF,Hospital Provider Number,RHC 10 Provider Number,Admin & Gen Under Contract,Operation of Plant,Operating Cost and Target Amount,Physical Therapy,RHC 9 Provider Number,Total Program Excludable Costs,TOTAL,Total Salaries,Administrative & General under contract,Cardiac Catheterization,Heart Acquisition,ASC (Non Distinct Part),Surgical Intensive Care Unit,Other Reimbursable,Other Reimbursable,net of Swing Bed and Private Room Diff,Radiology-Therapeutic,FQHC,Subprovider-IRF,Kidney Acquisition,Speech Pathology,Subprovider-IPF,Administrative and General,FQHC 4 Provider Number,Adults & Pediatrics,Other Reimbursable,Adjusted reimburseable bad debts,Title V discharges,Intravenous Therapy,Adults and Pediatrics,Television and Radio Service,Total,"If this Hospital is claiming cost for renal services on Worksheet A, are they inpatient services only? (Y/N)",Hospice,Intravenous Therapy,Occupational Therapy,Total Other Charges,Medical Supplies Charged to Patients,Line 2 times line 5,Drugs Charged to Patients,"Blood Storing, Processing, Trans",CMHC,Subprovider I,RHC 11 Provider Number,Other Special Care Unit,Drugs Charged to Patients,"Gift, Flower, Coffee Shop, Canteen",Radiology-Therapeutic,Interns & Res Salary and Fringe Benefits,Hospital Adlts & Ped Swing Bed NF,Radiology-Diagnostic,IRF,NF,Other Special Purpose,Interns & Residents,Durable Medical Equipment Rented,Emergency,W/Out Outliers:  Number of Episodes,Other Reimbursable,Adults & Pediatrics,Medicare Certified Kidney TC term date,Total Charges,Respiratory Therapy,Leasehold Improvements,OLTC,RHC,Clinic,Clinic,Physician Part A,Intensive Care Unit,Radiology-Diagnostic,ASC (Distinct Part),Total unreimbursed and uncompensated care,Impl. Dev. Charged to Patients,Total,Coronary Care Unit,"Anesthetist, and Medical Education Costs",CT Scan,Interns & Res Salary and Fringe Benefits,Radiology-Therapeutic,OSP,Laboratory,Kidney Acquisition,Paramedical Education,Physical Therapy,Radiology-Therapeutic,Emergency,Emergency,Interest expense on Medicare Overpaymts,New Capital Buildings and Fixtures,Emergency,FQHC 6 Provider Number,Physician Part A,Net Income,Other Special Purpose,Aggregate amount collected from patients,Drugs Charged to Patients,Ambulance Services,Burn Intensive Care Unit,Liver Acquisition,Wage Related Costs RHC/FQHC,Organ acquisition,"Medicare certified heart
transplant center cert date","Blood Storing, Processing, Trans",PEP Episodes:  Total Charges:,Housekeeping under Contract,Net Revenue from stand-alone SCHIP,OOT,Administrative and General,Organ Procurement,Radioisotope,Physical Therapy,Speech Pathology,Observation Beds (Distinct Unit),Housekeeping,Total,Swing Bed SNF Provider Number,Other Reimbursable,HMO,Laboratory,Drugs Charged to Patients,Intravenous Therapy,Tentative settlement,ASC 1 Provider Number,Fixed Equipment,Laboratory,SNF,Initial Physician Payment Method (Y/N),"Blood Storing, Processing, Trans",Wage Related Costs Core,Total discharges,Outpatient Rehab Provider,Without Outliers:  Other Charges,Total Visits,Anesthesiology,Blood Clotting Factors for Hemoph.,Electroencephalography,Other Ancillary,Home Office Salaries,Private grants or donations or endowment income restricted to funding charity care,Depreciation-New Movable Equipment,Durable Medical Equipment Sold,Observation Beds (Distinct Unit),Radiology-Therapeutic,Other Outpatient Services,Burn Intensive Care Unit,Total Non Routine Medical  Supply Charges,Speech Pathology,Other Outpatient Services,Recovery Room,Occupational Therapy,PEP Episodes:  Total Number of Episodes,Renal Dialysis,FQHC,Laundry and Linen Service,FQHC 3 Provider Number,Interns & Residents,Total,Respiratory Therapy,OLTC,Total Number of Outlier Episodes,Medical Records and Medical Rec. Library,Other Medicaid Days,OLTC,Total Salaries,Anesthesiology,Physical Therapy,Land Improvements,Other Assets,Intensive Care Unit,Coronary Care Unit,Pancreas Acquisition,FQHC,SNF,Blood Clotting Factors for Hemoph.,Other Capital,Intravenous Therapy,Premiums,CORF,New Cap Related Csts Bldg & Fixtures,HHA 2 Provider Number,"Average patient dialysis time 
including setup",Subprovider I,"Blood Storing, Processing, Trans",Physical Therapy,Delivery Room and Labor Room,Total Visits,Other Ancillary,Intensive Care Unit,Beds Total Facility,CT Scan,CT Scan,Total,Total,Buildings,Delivery Room and Labor Room,Renal Dialysis,Subprovider I,Investment Income-Other,Utilization,Medical Records and Medical Rec. Library,Medical Supplies Charged to Patients,Cardiac Catheterization,SNF Provider Number,SSA State County Code,Medicare Certified Liver TC term date,Observation Beds (Distinct Unit),Occupational Therapy,Renal Dialysis,Subprovider-IRF,Total Outpatient Program Pass Thru Cost,OPT,Total Hospital,Operating Room,Whole Blood & Packed Red Blood Cells,Without Outliers:  Total Visits,"Blood Storing, Processing, Trans",Urban/Rural Indicator at beginning,Other Reimbursable,Medical Supplies Charged to Patients,Laboratory,Housekeeping,MRI,Observation Beds (Distinct Unit),Observation Beds (Distinct Unit),PEP:  Total Non Routine Med Supply Chgs,Delivery Room and Labor Room,Administrative and General under Contract,FQHC 8 Provider Number,Delivery Room and Labor Room,NF,Medical Records & Med Records Library,Intravenous Therapy,Utilization Review - Physician Compen,Burn Intensive Care Unit,Subprovider I,Other Reimbursable,Other Outpatient Services,Electrocardiology,RHC 3 Provider Number,Non-Physician Anesthetist Part A,Hospice,Other Special Care,Pancreas Acquisition,"Blood Storing, Processing, Trans",Clinic,Other Special Care Unit,Electrocardiology,Program Ancillary Services,Other Outpatient Services,Physicians' Private Office,Recovery Room,Radiology-Therapeutic,Blood Clotting Factors for Hemoph.,SNF,Durable Medical Equipment Rented,Pass through Cost for Program Inpatient,Respiratory Therapy,Observation Beds (Distinct Unit),"Blood Storing, Processing, Trans",Total Other Medical Education,Renal Dialysis,Liver Acquisition,Delivery Room and Labor Room,Anesthesiology,Heart Acquisition,Hospice,Occupational Therapy,Operating Room,Is this a rural hospital qualifying for an exception to the certified registered nurse anesthetist the CRNA fee schedule? (Y/N),Respiratory Therapy,Pancreas Acquisition,OLTC,Subprovider-IPF,LUPA:  Total Non Routine Med Sup Chgs,Organ Procurement,Occupational Therapy,Drugs Charged to Patients,Line 2 times line 5,"Blood Storing, Processing, Trans",ASC (Distinct Part),"Number of days in year dialysis 
furnished",Employee Benefits,Drugs Charged to Patients,Beds Total Hospital,Burn Intensive Care Unit,Surgical Intensive Care Unit,Observation Beds (Distinct Unit),Clinic,Maintenance of Personnel,Other Organ Acquisition,Subprovider II,PEP:  Total Non Routine Med Supply Chgs,Total Other Medical Education,Impl. Dev. Charged to Patients,Total Income,Protested amounts,Total,Electrocardiology,Clinic,Impl. Dev. Charged to Patients,Without Outliers:  Total Charges,CMHC,Other Outpatient Services,Radioisotope,Interns & Residents,Operating Room,Subtotal,Drugs Charged to Patients,Radiology-Diagnostic,IRF,"Number of patients in program at 
end of cost reporting period",Interns & Residents,Maintenance of Personnel,Wage Related Costs Other,Total Visits,Subprovider I,With Outliers:  Total Visits,Other Reimbursable,Physical Therapy,Ancillary service charges,CMHC,"Blood Storing, Processing, Trans",Whole Blood & Packed Red Blood Cells,OSP,Home Program Dialysis,Subprovider-IPF,Interns & Residents,Adults and Pediatrics,OOT,Electrocardiology,Pass Through Cost for  Program Ancillary,Subtotal Other Wages and Related Csts,Nursing Administration,Total Directly Assigned New Cap Rel Csts,Electrocardiology,Laboratory,Subprovider II,Intestinal Acquisition,Drugs Charged to Patients,ASC (Distinct Part),Coronary Care Unit,Ambulance Services,Delivery Room and Labor Room,Other Organ Acquisition,Electrocardiology,Recovery Room,Cardiac Catheterization,Other Outpatient Services,RHC 14 Provider Number,ICF,OLTC,Less: Allowances for uncollectible notes and accounts receivable,PEP Episodes:  Total Number of Episodes,Subprovider-IRF,Whole Blood & Packed Red Blood Cells,Durable Medical Equipment Rented,Medical Supplies Charged to Patients,Cafeteria,Hospital Type,Intensive Care Unit,Respiratory Therapy,Radiology-Diagnostic,Coronary Care Unit,Intensive Care Unit,Total Operating Expense,Operating Room,Administrative and General,Adults & Pediatrics,FQHC,Nursery,ICF,TOTAL,Int & Res (non approved teaching program,Intensive Care Unit,LUPA Episodes:  Total Number of Episodes,CT Scan,Clinic,Islet Acquisition,Whole Blood & Packed Red Blood Cells,Durable Medical Equipment Sold,Operating Room,MRI,LUPA:  Total Non Routine Med Sup Chgs,Clinic,NF,Home Office:  Physician Part A,Laboratory,Total,HHA,Anesthesiology,Medical Supplies Charged to Patients,Durable Medical Equipment Sold,Total,TOTAL,MRI,Sale of medical records and abstracts,Radiology-Diagnostic,Allowable bad debts,Radiology-Therapeutic,Total discharges,or allied health costs?,Respiratory Therapy,CT Scan,FQHC,Land Improvements,Contract Labor:  Physician Part A,"Does the facility qualify and is it receiving payments for 
disproportionate share? (Y/N)",Kidney Acquisition,W/Out Outliers:  Number of Episodes,Impl. Dev. Charged to Patients,Coronary Care Unit,Laboratory,Clinic,Labor and Delivery,Central Services and Supply,Other Nonreimbursable,Electroencephalography,CT Scan,Interest Expense,OPT,Subprovider 1,Burn Intensive Care Unit,Speech Pathology,Surgical Intensive Care Unit,Nursing Administration,Radioisotope,Intestinal Acquisition,Radioisotope,Operating Room,MRI,RHC 8 Provider Number,CMS Region Code,Observation Beds (Distinct Unit),Other Outpatient Services,Subprovider-IPF,Medical Supplies Charged to Patients,Home Office Street,Operation of Plant,Renal 8 Provider Number,Clinic,Occupational Therapy,Physical Therapy,Home Program Dialysis,Occupational Therapy,Lung  Acquisition,Laboratory,FQHC,Interns & Res Salary and Fringe Benefits,Subprovider-IPF,CT Scan,Delivery Room and Labor Room,Speech Pathology,With Outliers:  Number of Episodes,Interns & Residents,Respiratory Therapy,Delivery Room and Labor Room,RHC 24 Provider Number,Home Office Salaries,Whole Blood & Packed Red Blood Cells,Outlier payments,New Cap Related Csts Movable Equipment,Other General Service,Subtotal Wage Related Csts,Physical Therapy,MRI,Electrocardiology,Occupational Therapy,Delivery Room and Labor Room,Utilization Code (L/N/F),Nonpaid Workers,HHA,Physician Part B,Medical Supplies Charged to Patients,Cost of charity care,LUPA:  Total Non Routine Med Sup Chgs,Durable Medical Equipment Sold,Subtotal,Surgical Intensive Care Unit Program Cost,Drugs Charged to Patients,Respiratory Therapy,Total Other Income,Ending Date of SCH status,Radiology-Diagnostic,Total Facility FTEs,Intravenous Therapy,Physical Therapy,ASC (Non Distinct Part),"Is this a New Hospital under
42 CFR 412.300 PPS capital
(Y/N)",Impl. Dev. Charged to Patients,Home Office Salaries & Wage Related Csts,Radioisotope,Utilization Review SNF,Research,Impl. Dev. Charged to Patients,Islet Acquisition,NOT IN THIS FILE,Other Organ Acquisition,Respiratory Therapy,Delivery Room and Labor Room,Total Subprovider I Interns & Residents,Impl. Dev. Charged to Patients,Durable Medical Equipment Sold,Total Number of Episodes,Delivery Room and Labor Room,Organ Procurement,Occupational Therapy,Radiology-Therapeutic,Cardiac Catheterization,MRI,Management and Administrative Services,Maintenance and Repairs,Other Outpatient Services,"Anesthetist, and Medical Education Costs",Physical Therapy,Total customary charges,Radioisotope,Int & Res (non approved teaching program,CT Scan,Hospital Adults & Pediatrics,Hospice 3 Provider Number,Speech Pathology,Delivery Room and Labor Room,Total Hospital Interns & Residents,Ambulance Services,Medical Supplies Charged to Patients,Other Reimbursable,Total Current Liabilities,Total Number of Episodes,Buildings and Fixtures,Medicaid (Title XIX) discharges,Hospice,RHC,Interns & Residents,Interns and residents,"Blood Storing, Processing, Trans",Observation Beds (Distinct Unit),Intravenous Therapy,Burn Intensive Care Unit,Total Liabilities,Total Subprovider II Interns & Residents,Adj for Occupational therapy in excess of li,"Trade, Quantity, and Time Discounts",Contract Labor: Pysician Part A,Medical Supplies Charged to Patients,Lung  Acquisition,"Gift, Flower, Coffee Shop, Canteen",Net Salaries,Stand-alone CHIP Shortfall -- Costs minus net revenue (0 min),Other Reimbursable,Operating Room,Nursery,MRI,Interns & Residents,SNF,Renal Dialysis,Other Outpatient Services,Is this hospital classified as a referral center? (Y/N),Subprovider-IRF,Impl. Dev. Charged to Patients,Hospice,Allowable bad debts for dual eligibles beneficiaries,Subprovider II,Other Reimbursable,IRF,Liver Acquisition,Other Reimbursable,Central Services and Supply,Physical Therapy,Cardiac Catheterization,Laundry and Linen Service,Research,Out of State Medicaid eligible days,Occupational Therapy,Drugs Charged to Patients,Land,Whole Blood & Packed Red Blood Cells,Drugs Charged to Patients,Anesthesiology,Operating Room,IPF,"Sale of scrap, waste, etc.",Title V discharges,Renal Dialysis,Lung  Acquisition,Ambulance Services,Respiratory Therapy,Other Ancillary,Radioisotope,Other Reimbursable,SSA State Code,Occupational Therapy,Census Division Code,Home Program Dialysis,Whole Blood & Packed Red Blood Cells,RHC 20 Provider Number,Emergency,Physical Therapy,Movable Equipment,Occupational Therapy,Hospice,OLTC,Whole Blood & Packed Red Blood Cells,Radiology-Therapeutic,Recovery Room,Labor and Delivery Days -  Title XIX,Home Program Dialysis,ASC (Non Distinct Part),Stand-alone CHIP Charges (Gross Revenue),Radioisotope,"Percentage of patients re-using
dialyzers","Number of Times per week
 Patient receives Dialysis",Without Outliers:  Non Routine Med Sup Chgs,CORF,CORF,OPT,IPPS Interim payment,Delivery Room and Labor Room,Employee Benefits,Cardiac Catheterization,Laboratory,Subprovider I,Durable Medical Equipment Sold,Renal Dialysis,Impl. Dev. Charged to Patients,Cardiac Catheterization,Impl. Dev. Charged to Patients,Impl. Dev. Charged to Patients,Laboratory,Other Ancillary,Dietary,Operating Room,Clinic,Total,Other Outpatient Services,PBP Clinical Lab Services Program Only,Emergency,Physician-Part B,Charity care charges and uninsured discounts for the entire facility,Emergency,"Blood Storing, Processing, Trans",Intravenous Therapy,Drugs Charged to Patients,Operating Room,Paramedical Education,Durable Medical Equipment Sold,With Outliers:  Number of Episodes,Laboratory,Radioisotope,Excess of customary charges,Is this hospital an All-Inclusive rate provider? (Y/N),Delivery Room and Labor Room,Total Other Charges,Renal Dialysis,Medical Supplies Charged to Patients,Research,Other Special Care,Amounts expected under 42 CFR,Administrative and General,Radiology-Therapeutic,Home Program Dialysis,New Cap Related Csts Bldg & Fixtures,CMHC,Total Program General Inpatient Routine,Cardiac Catheterization,FQHC 2 Provider Number,Coronary Care Unit,Intensive Care Unit,MRI,Intensive Care Unit,Subtotal,HAC reduction adjustment amount,Coronary Care Unit,Total,Radiology-Therapeutic,"Blood Storing, Processing, Trans",Emergency,Whole Blood & Packed Red Blood Cells,Whole Blood & Packed Red Blood Cells,Investments,Total Liabilities and Fund Balances,W/Out Outliers:  Number of Episodes,MRI,Other Long-term Liabilities,Emergency,Home Office:  Physician Part A,SNF,"Medical certified liver 
transplant center cert date",Other Ancillary,Radioisotope,Observation Beds (Distinct Unit),Respiratory Therapy,Radiology-Diagnostic,Burn Intensive Care Unit,Cardiac Catheterization,Blood Clotting Factors for Hemoph.,Other Ancillary,Number of periods hospital was in MDH status,Durable Medical Equipment Rented,"Blood Storing, Processing, Trans",Whole Blood & Packed Red Blood Cells,Subprovider 1,"Blood Storing, Processing, Trans",CT Scan,Land Improvements,Subprovider-IPF,Medicaid (Title XIX) discharges,Speech Pathology,SNF,Coronary Care Unit,Speech Pathology,Physical Therapy,OLTC,Less Contractual Allowance and Discounts on Patients' Accounts,IPF Provider Number,Lung  Acquisition,Adults and Pediatrics,Home Office Salaries & Wage Related Csts,Total,Physical Therapy,Subtotal Other Wages and Related Csts,Laboratory,Other Ancillary,ASC (Non Distinct Part),OSP,Other Ancillary,Total Charges:  LUPA Episodes,In State Medicaid paid days,"Number of patients in program at 
end of cost reporting period",Laundry and Linen Service,Delivery Room and Labor Room,New Cap Related Csts Movable Equipment,SNF,Subprovider II,Other Ancillary,Radiology-Diagnostic,RHC,Interns & Res Salary and Fringe Benefits,Land Improvements,Speech Pathology,Drugs Charged to Patients,OSP,ASC (Non Distinct Part),Recovery Room,Electrocardiology,Impl. Dev. Charged to Patients,Home Program Dialysis,Stand-alone CHIP Cost,Total,Durable Medical Equipment Sold,Total Hospital Interns & Residents,Respiratory Therapy,Home Office Salaries,Radiology-Therapeutic,Observation Beds (Distinct Unit),Occupational Therapy,Laboratory,Other Outpatient Services,Non-Physician Anesthetist Part A,Home Program Dialysis,Delivery Room and Labor Room,PEP Episodes:  Other Charges,Drugs Charged to Patients,Blood Clotting Factors for Hemoph.,Total Charges,Physician Part B,Emergency,Delivery Room and Labor Room,ICF,Cost of patients approved for charity care and uninsured discounts,Radiology-Therapeutic,Total discharges,Radiology-Diagnostic,Telephone Services,Total,Hospital Adlts & Ped Swing Bed SNF,Respiratory Therapy,Operating Room,Anesthesiology,Hospice,Total Subprovider I Interns & Residents,Occupational Therapy,CT Scan,Medicare Certified Heart TC term date,Durable Medical Equipment Rented,ASC (Non Distinct Part),Whole Blood & Packed Red Blood Cells,Electroencephalography,Speech Pathology,"Number of Times per week
 Patient receives Dialysis",Subprovider-IPF,Drugs Charged to Patients,Subprovider 2,Intravenous Therapy,Radiology-Therapeutic,Out of State Medicaid paid days,Physical Therapy,Operating Room,Intensive Care Unit,Title XVIII discharges,Speech Pathology,Respiratory Therapy,Pancreas Acquisition,PBP Clinical Lab Services Program Only,PBP Clinical Lab Services Program Only,Heart Acquisition,Cardiac Catheterization,PBP Clinical Lab Services Program Only,Clinic,Emergency,Subprovider I,Building Improvements,Other Reimbursable,Housekeeping,Other General Service,Coronary Care Unit,Total Adults & Peds,NF,Anesthesiology,Charity care charges and uninsured discounts for the entire facility,HHA 3 Provider Number,RHC 4 Provider Number,Anesthesiology,OLTC,Subprovider-IPF,Durable Medical Equipment Rented,Operation of Plant,net of Swing Bed and Private Room Diff,Subtotal,Electroencephalography,Laboratory,Emergency,Excluded Area Salaries,Anesthesiology,LUPA Episodes:  Total Visits,Subprovider II,Outpatient Rehab Provider,OLTC,ASC (Non Distinct Part),Radiology-Diagnostic,Renal Dialysis,Electrocardiology,Durable Medical Equipment Sold,Renal Dialysis,Administrative and General,MRI,Anesthesiology,Cardiac Catheterization,PBP Clinical Lab Services Program Only,Clinic,Respiratory Therapy,Cardiac Catheterization,Impl. Dev. Charged to Patients,PEP Episodes:  Total Visits,Coronary Intensive Care Unit,Clinic,Hospice,Impl. Dev. Charged to Patients,Interns & Residents,Radioisotope,Whole Blood & Packed Red Blood Cells,Other Special Purpose,Social Service,Payments received from patients for amounts previously written off as charity care,Respiratory Therapy,Notes and Loans Payable (short term),IPF,Without Outliers:  Total Visits,Impl. Dev. Charged to Patients,ASC (Non Distinct Part),Electrocardiology,Are provider based physicians' costs included in Worksheet A? (Y/N),Home Office Personnel,Radioisotope,Excess of reasonable cost over reasonable charges,Operating Room,Non-Physician Part B,Emergency,Fixed Equipment,Organ Procurement,Radiology-Therapeutic,Other Nonreimbursable,FQHC 7 Provider Number,Physician-Part B,Physical Therapy,RHC,Excluded Area Salaries,Nonpaid Workers,Medical Supplies Charged to Patients,Contract Labor,Home Program Dialysis,Durable Medical Equipment Sold,Total Program Inpatient Costs,New Cap Related Csts Bldg & Fixtures,Total costs for patients covered by a state or local government program,ASC (Distinct Part),"Gift, Flower, Coffee Shop, Canteen",CT Scan,Organ Procurement,Research,Cardiac Catheterization,Observation Beds (Distinct Unit),Radioisotope,Non-physician Anesthetist,Clinic,Renal Dialysis,Anesthesiology,ASC (Non Distinct Part),Intestinal Acquisition,Title XVIII discharges,Observation Beds (Distinct Unit),Total Hospital,Other Ancillary,Total Outpatient Program Pass Thru Cost,Home Office Salaries & Wage Related Csts,Total,Total,Total Nursing School,Without Outliers:  Total Charges,Radiology-Therapeutic,Cardiac Catheterization,Intensive Care Unit,Total Number of Outlier Episodes,Clinic,Total,IRF,Total,Government grants or appropriations or transfers for support of hospital operations,Burn Intensive Care Unit,ICF Provider Number,Other Special Care Unit,Other Special Purpose,RHC 18 Provider Number,Interns & Res Other Program Costs,Durable Medical Equipment Rented,Electroencephalography,Electroencephalography,Anesthesiology,"Blood Storing, Processing, Trans",Emergency,Electrocardiology,Surgical Intensive Care Unit,Delivery Room and Labor Room,Intravenous Therapy,ASC (Non Distinct Part),Total Salaries,HHA,Total Salaries,Intravenous Therapy,Movable Equipment,Observation Beds (Distinct Unit),PBP Clinical Lab Services Program Only,Ambulance Services,SNF,"Blood Storing, Processing, Trans",OPT,Radiology-Therapeutic,Blood Clotting Factors for Hemoph.,Electroencephalography,Other Reimbursable,Burn Intensive Care Unit,Medical Supplies Charged to Patients,PBP Clinical Lab Services Program Only,Operating Room,Other Ancillary,Whole Blood & Packed Red Blood Cells,New Capital Buildings and Fixtures,Total Current Assets,Durable Medical Equipment Rented,Blood Clotting Factors for Hemoph.,Nursery,Rental of Provider space by suppliers,Pharmacy,Pancreas Acquisition,Electrocardiology,CT Scan,Geographic MSA,Payments received from patients for amounts previously written off as charity care,Respiratory Therapy,Durable Medical Equipment Rented,Cardiac Catheterization,Other General Service,Whole Blood & Packed Red Blood Cells,ICF,Ambulance Services,Nonphysician Anesthetists,Electroencephalography,Radiology-Diagnostic,PEP:  Total Number of Outlier Episodes,Electroencephalography,Total Hospital Interns & Residents,Physicians' Private Office,Adults & Pediatrics,Electrocardiology,Other Capital,Renal Dialysis,Admin & Gen Under Contract,MRI,Laundry and Linen Service,Cardiac Catheterization,Electroencephalography,Durable Medical Equipment Rented,Other Ancillary,Intensive Care Unit,Laboratory,ICF,Non-Physician Part B,Speech Pathology,Research,Other Special Care Unit,Clinic,HHA,Operating Room,Dietary under Contract,CT Scan,OLTC,Renal Dialysis,PBP Clinical Lab Services Program Only,Electrocardiology,Utilization Review SNF,Renal 10 Provider Number,Renal Dialysis,Nursing School,RHC,Total Program General Inpatient Routine,Kidney Acquisition,Intravenous Therapy,Maintenance of Personnel,"Number of days in year dialysis 
furnished",Observation Beds (Distinct Unit),Burn Intensive Care Unit,RPCH/CAH Visits,Pancreas Acquisition,Other Outpatient Services,"Treatment capacity per day per
station",Does the hospital qualify as RPCH/CAH? (Y/N),Speech Pathology,Title XVIII discharges,Blood Clotting Factors for Hemoph.,HHA,CMHC,Radioisotope,OOT,Cardiac Catheterization,Recovery Room,Electrocardiology,Home Office Personnel,Other Nonreimbursable,Fixed Equipment,LUPA Episodes:  Total Number of Episodes,Investment Income-New Bldgs & Fixtures,Administrative & General under contract,"Blood Storing, Processing, Trans","Blood Storing, Processing, Trans",Other Outpatient Services,Radiology-Therapeutic,Laboratory,Other Outpatient Services,Total Program Inpatient Costs,Occupational Therapy,Sequestration adjustment,Cardiac Catheterization,Other Special Care Unit,Employee Benefits,"Anesthetist, and Medical Education Costs","If (SCH), enter the # of periods.",SNF,Fiscal Year Begin Date,Interns & Residents,Interns & Residents,HHA,Clinic,Recovery Room,Total,ICF,MRI,RHC,MRI,Other Special Care,Dietary under contract,RPCH/CAH Visits,net of Swing Bed and Private Room Diff,Intensive Care Unit,Observation Beds (Distinct Unit),Coronary Care Unit,Subprovider-IRF,Nonpaid Workers,ASC (Non Distinct Part),Laboratory,Renal Dialysis,Intravenous Therapy,Bonus Payment,Other Outpatient Services,Other Ancillary,ASC (Non Distinct Part),Emergency,Housekeeping under contract,Housekeeping,Total Bad Debt expense,Dietary,Total Allied Health,Subprovider-IPF,Radiology-Diagnostic,ICF,Home Program Dialysis,Other Ancillary,Respiratory Therapy,Cardiac Catheterization,Administrative and General,Interns & Residents,Housekeeping,Prepaid expenses,OSP,Total Hospital,RHC/FQHC Combined,Physical Therapy,Radioisotope,ASC (Non Distinct Part),Dietary,Nursing Administration,Nonpaid Workers,MRI,Paid Losses,Electrocardiology,Ancillary service other pass through costs,Total Nonphysician Anesthetist Cost,Anesthesiology,Cost of charity care (uninsured patients + patients w/ coverage not accepted by provider),"Sum of lines 3,4 divided by line 6",Laboratory,Other Ancillary,ASC (Distinct Part),NF,Occupational Therapy,Medical Supplies Charged to Patients,Drugs Charged to Patients,Delivery Room and Labor Room,SNF,ASC (Non Distinct Part),Blood Clotting Factors for Hemoph.,Kidney Acquisition,Intestinal Acquisition,PBP Clinical Lab Services Program Only,Intensive Care Unit,General Fund Balance,Total,Laboratory,Total,Accounts Receivable,Radiology-Diagnostic,FQHC 12 Provider Number,Have you established a new subprovider excluded unit under 42 CFR 413.40(f)(1)(I)?(Y/N),Occupational Therapy,Related Organization Transactions,Total Charges:  LUPA Episodes,CT Scan,"Are there any related organization or how office costs as defined in HCFA Pub. 15-I, chapter 10? (Y/N)",Subprovider-IRF,Speech Pathology,Observation Beds (Distinct Unit),Delivery Room and Labor Room,Other Special Purpose,Medical Supplies Charged to Patients,Health Information Technology Designated Assets,Impl. Dev. Charged to Patients,PBP Clinical Lab Services Program Only,NF,Radiology-Diagnostic,Social Service,Impl. Dev. Charged to Patients,Non-Physician Anesthetist Part B,ICF,CMHC,Anesthesiology,Other Reimbursable,IPF,Total Patient Days,"Number of patients in program at 
end of cost reporting period",Radiology-Diagnostic,Impl. Dev. Charged to Patients,IRF,Operating Room,Home Program Dialysis,Other Nonreimbursable,Radioisotope,Total Inpatient Program Days,Subprovider-IRF,HHA,RHC 12 Provider Number,Emergency,Intensive Care Unit,Nursery,Impl. Dev. Charged to Patients,Other General Service,With Outliers:  Number of Episodes,Medicaid (Title XIX) discharges,Nursing Administration,Land,Liver Acquisition,Laboratory,Adults & Pediatrics,Other Reimbursable,Land,Radiology-Therapeutic,Recovery Room,Radiology-Diagnostic,Medicaid Observation Days,Medical Records & Med Records Library,Intravenous Therapy,Pancreas Acquisition,Physical Therapy,Surgical Intensive Care Unit,Total,Radioisotope,Total,FQHC,Number of EPO units furnished for Line 13,Laboratory,Radioisotope,Number of stations,Recovery Room,SNF,Speech Pathology,Drugs Charged to Patients,"Number of patients on transplant 
list",Intravenous Therapy,Other Reimbursable,Lung  Acquisition,Electrocardiology,Other Reimbursable,Physical Therapy,"Blood Storing, Processing, Trans",Electroencephalography,Lung  Acquisition,Radioisotope,Speech Pathology,Cafeteria,Buildings and Fixtures,Electrocardiology,Other Ancillary,Other Organ Acquisition,New Cap Related Csts Bldg & Fixtures,Nursing School,Nursing School,certification date,CT Scan,Other Outpatient Services,Cross Foot Adjustments,Renal Dialysis,Anesthesiology,Recovery Room,Other Reimbursable,Other Reimbursable,Recovery Room,Zip Code,Other Organ Acquisition,Home Office PO Box,Intravenous Therapy,Paramedical Education,Durable Medical Equipment Sold,Total Charges,net of Swing Bed Cost,Total Nursing School,Durable Medical Equipment Rented,RHC 22 Provider Number,Clinic,MDH status ending date (MM/DD/YY),Radiology-Diagnostic,SNF,Net Income from Service to Patients,Labor and Delivery,Physical Therapy,RHC,Clinic,Intravenous Therapy,Ratio of line 15 to line 16,"Number of patients transplanted 
during fiscal year",RHC/FQHC Combined,Burn Intensive Care Unit,OLTC,ASC (Distinct Part),Operation of Plant,ASC (Non Distinct Part),Other Nonreimbursable,Other Special Care Unit,Provider-based physician adjustment,Impl. Dev. Charged to Patients,Other Outpatient Services,RHC,CMHC,HHA,Home Program Dialysis,Radiology-Diagnostic,With Outliers:  Total Charges,Net revenue from state/local govt indigent care (not Medicaid or CHIP),Anesthesiology,Recovery Room,Radioisotope,"Gift, Flower, Coffee Shop, Canteen",LUPA Episodes:  Total Number of Episodes,Impl. Dev. Charged to Patients,TOTAL,Other Outpatient Services,Home Program Dialysis,MRI,Radiology-Therapeutic,"If an Organ Procurement Organization, enter the OPO number",Total Adults & Pediatrics,Intestinal Acquisition,Operating Room,Hospital PO Box,Radiology-Therapeutic,Renal 1 Provider Number,Respiratory Therapy,Medicaid HMO Days,ASC (Non Distinct Part),Program Inpatient Ancillary Service Cost,RHC 17 Provider Number,Whole Blood & Packed Red Blood Cells,ASC (Non Distinct Part),MRI,Other Ancillary,Cardiac Catheterization,Liver Acquisition,Durable Medical Equipment Rented,CMHC,Total Hospital,Drugs Charged to Patients,Radiology-Diagnostic,Electrocardiology,"Blood Storing, Processing, Trans",Anesthesiology,Refunds and Rebates of Expenses,Radiology-Diagnostic,Nursing School,Int & Res (non approved teaching program,Total Hospital,Emergency,Laboratory,Intensive Care Unit,Clinic,Operating Room,Maintenance and Repairs,Medical Supplies Charged to Patients,Durable Medical Equipment Rented,Occupational Therapy,Durable Medical Equipment Sold,Intravenous Therapy,NF,Whole Blood & Packed Red Blood Cells,Whole Blood & Packed Red Blood Cells,Electrocardiology,Emergency,Other Outpatient Services,Cafeteria,Impl. Dev. Charged to Patients,Non-Physician Part B,"Blood Storing, Processing, Trans","Gift, Flower, Coffee Shop, Canteen",Notes Payable,Observation Beds (Distinct Unit),RHC/FQHC Combined,Excluded Areas,Subtotal,Electroencephalography,Hospital Adults & Ped Swing Bed SNF,Emergency,Total prospective payment,Other Organ Acquisition,Total Hospital,Total,net of Swing Bed Cost,Other Reimbursable,IRF Provider Number,Renal 5 Provider Number,Home Program Dialysis,Adults and Pediatrics,Laboratory,"Number of Times per week
 Patient receives Dialysis",Disp. And Retirement,ASC (Non Distinct Part),Operating Room,Medical Supplies Charged to Patients,Surgical Intensive Care Unit,Impl. Dev. Charged to Patients,Cardiac Catheterization,Total Adults & Peds,Net Salaries,Heart Acquisition,Other Ancillary,Radiology-Diagnostic,Lung  Acquisition,Intestinal Acquisition,CORF,Employee Benefits,Payment to cost ratio,PEP Episodes:  Total Visits,Dietary,Report_Period_Begin_Yr,Beginning FFY,,,,,,,,,,,,,,,,,,,,,,,Hospital Type (From CMS Hospitals Data Archive),General Ownership Type,,Name and Num
,Curated Name and Num,Hospital type (modified),,Lon,Lat,COMPUTATION OF RATIO OF COST TO CHARGES,Total Inpatient Days/Outpatient Visits,TRIAL BALANCE OF EXPENSE ACCOUNTS,APPORTIONMENT OF INPATIENT/OUTPATIENT ANCILLARY SERVICE OTHER PASS THROUGH COSTS,HHA STATISTICAL DATA,,COST ALLOCATION,APPORTIONMENT OF MEDICAL AND OTHER HEALTH SERVICES,COMPUTATION OF INPATIENT OPERATING COSTS,APPORTIONMENT OF INPATIENT/OUTPATIENT ANCILLARY SERVICE OTHER PASS THROUGH COSTS,INPATIENT ANCILLARY SERVICE COST APPORTIONMENT,APPORTIONMENT OF INPATIENT/OUTPATIENT ANCILLARY SERVICE OTHER PASS THROUGH COSTS,COMPUTATION OF RATIO OF COST TO CHARGES,TRIAL BALANCE OF EXPENSE ACCOUNTS,HHA STATISTICAL DATA,,COMPUTATION OF INPATIENT OPERATING COSTS,COST ALLOCATION,COMPUTATION OF RATIO OF COST TO CHARGES,APPORTIONMENT OF MEDICAL AND OTHER HEALTH SERVICES,APPORTIONMENT OF INPATIENT/OUTPATIENT ANCILLARY SERVICE OTHER PASS THROUGH COSTS,COMPUTATION OF RATIO OF COST TO CHARGES,APPORTIONMENT OF INPATIENT/OUTPATIENT ANCILLARY SERVICE OTHER PASS THROUGH COSTS,COMPUTATION OF RATIO OF COST TO CHARGES,HOSPITAL WAGE INDEX DATA,S-10 DATA,APPORTIONMENT OF INPATIENT/OUTPATIENT ANCILLARY SERVICE OTHER PASS THROUGH COSTS,TRIAL BALANCE OF EXPENSE ACCOUNTS,INPATIENT ANCILLARY SERVICE COST APPORTIONMENT,TRIAL BALANCE OF EXPENSE ACCOUNTS,APPORTIONMENT OF INPATIENT/OUTPATIENT ANCILLARY SERVICE OTHER PASS THROUGH COSTS,COST ALLOCATION,APPORTIONMENT OF INPATIENT/OUTPATIENT ANCILLARY SERVICE OTHER PASS THROUGH COSTS,COMPUTATION OF RATIO OF COST TO CHARGES,ADJUSTMENTS,,COMPUTATION OF RATIO OF COST TO CHARGES,HOSPITAL WAGE INDEX DATA,COMPUTATION OF RATIO OF COST TO CHARGES,Medicaid Inpatient Days/Outpatient Visits,APPORTIONMENT OF INPATIENT/OUTPATIENT ANCILLARY SERVICE OTHER PASS THROUGH COSTS,COST ALLOCATION,HOSPITAL IDENTIFICATION INFORMATION,COST ALLOCATION,COST ALLOCATION,APPORTIONMENT OF INPATIENT/OUTPATIENT ANCILLARY SERVICE OTHER PASS THROUGH COSTS,CALCULATION OF REIMBURSEMENT SETTLEMENT (PPS),APPORTIONMENT OF MEDICAL AND OTHER HEALTH SERVICES,APPORTIONMENT OF INPATIENT/OUTPATIENT ANCILLARY SERVICE OTHER PASS THROUGH COSTS,APPORTIONMENT OF MEDICAL AND OTHER HEALTH SERVICES,INPATIENT ANCILLARY SERVICE COST APPORTIONMENT,BED DAYS AVAILABLE,Medicaid Inpatient Days/Outpatient Visits,HHA STATISTICAL DATA,APPORTIONMENT OF INPATIENT/OUTPATIENT ANCILLARY SERVICE OTHER PASS THROUGH COSTS,APPORTIONMENT OF INPATIENT ROUTINE SERVICE OTHER PASS THROUGH COSTS,COST ALLOCATION,COMPUTATION OF RATIO OF COST TO CHARGES,BED DAYS AVAILABLE,TRIAL BALANCE OF EXPENSE ACCOUNTS,APPORTIONMENT OF MEDICAL AND OTHER HEALTH SERVICES,INPATIENT ANCILLARY SERVICE COST APPORTIONMENT,APPORTIONMENT OF INPATIENT/OUTPATIENT ANCILLARY SERVICE OTHER PASS THROUGH COSTS,COMPUTATION OF RATIO OF COST TO CHARGES,TRIAL BALANCE OF EXPENSE ACCOUNTS,APPORTIONMENT OF INPATIENT ROUTINE SERVICE CAPITAL COSTS,,COMPUTATION OF RATIO OF COST TO CHARGES,INPATIENT ANCILLARY SERVICE COST APPORTIONMENT,COST ALLOCATION,COST ALLOCATION,RECONCILIATION OF CAPITAL COST CENTERS,HOSPITAL WAGE INDEX DATA,APPORTIONMENT OF MEDICAL AND OTHER HEALTH SERVICES,HOSPITAL WAGE INDEX DATA,COMPUTATION OF RATIO OF COST TO CHARGES,INPATIENT ANCILLARY SERVICE COST APPORTIONMENT,BED DAYS AVAILABLE,COMPUTATION OF RATIO OF COST TO CHARGES,TRIAL BALANCE OF EXPENSE ACCOUNTS,HOSPITAL WAGE INDEX DATA,APPORTIONMENT OF INPATIENT/OUTPATIENT ANCILLARY SERVICE OTHER PASS THROUGH COSTS,APPORTIONMENT OF INPATIENT/OUTPATIENT ANCILLARY SERVICE OTHER PASS THROUGH COSTS,CALCULATION OF REIMBURSEMENT SETTLEMENT,Medicaid Inpatient Days/Outpatient Visits,ALLOCATION OF NEW CAPITAL COSTS,APPORTIONMENT OF INPATIENT/OUTPATIENT ANCILLARY SERVICE OTHER PASS THROUGH COSTS,CALCULATION OF REIMBURSEMENT SETTLEMENT,APPORTIONMENT OF INPATIENT/OUTPATIENT ANCILLARY SERVICE OTHER PASS THROUGH COSTS,INPATIENT ANCILLARY SERVICE COST APPORTIONMENT,COST ALLOCATION,RENAL STATISTICAL DATA,APPORTIONMENT OF MEDICAL AND OTHER HEALTH SERVICES,,COST ALLOCATION,APPORTIONMENT OF INPATIENT/OUTPATIENT ANCILLARY SERVICE OTHER PASS THROUGH COSTS,COMPUTATION OF RATIO OF COST TO CHARGES,INPATIENT ANCILLARY SERVICE COST APPORTIONMENT,INPATIENT ANCILLARY SERVICE COST APPORTIONMENT,APPORTIONMENT OF INPATIENT/OUTPATIENT ANCILLARY SERVICE OTHER PASS THROUGH COSTS,HOSPITAL WAGE INDEX DATA,RENAL STATISTICAL DATA,INPATIENT ANCILLARY SERVICE COST APPORTIONMENT,COST ALLOCATION,COMPUTATION OF RATIO OF COST TO CHARGES,COST ALLOCATION,APPORTIONMENT OF MEDICAL AND OTHER HEALTH SERVICES,COST ALLOCATION,COST ALLOCATION,TRIAL BALANCE OF EXPENSE ACCOUNTS,ALLOCATION OF NEW CAPITAL COSTS,COMPUTATION OF RATIO OF COST TO CHARGES,APPORTIONMENT OF INPATIENT/OUTPATIENT ANCILLARY SERVICE OTHER PASS THROUGH COSTS,COMPUTATION OF RATIO OF COST TO CHARGES,APPORTIONMENT OF MEDICAL AND OTHER HEALTH SERVICES,APPORTIONMENT OF MEDICAL AND OTHER HEALTH SERVICES,CALCULATION OF REIMBURSEMENT SETTLEMENT,APPORTIONMENT OF INPATIENT/OUTPATIENT ANCILLARY SERVICE OTHER PASS THROUGH COSTS,APPORTIONMENT OF INPATIENT/OUTPATIENT ANCILLARY SERVICE OTHER PASS THROUGH COSTS,,ANALYSIS OF CHANGES IN NEW CAPITAL BALANCES,COST ALLOCATION,HOSPITAL WAGE INDEX DATA,COMPUTATION OF RATIO OF COST TO CHARGES,HOSPITAL WAGE INDEX DATA,APPORTIONMENT OF MEDICAL AND OTHER HEALTH SERVICES,APPORTIONMENT OF INPATIENT/OUTPATIENT ANCILLARY SERVICE OTHER PASS THROUGH COSTS,COST ALLOCATION,COMPUTATION OF RATIO OF COST TO CHARGES,APPORTIONMENT OF INPATIENT/OUTPATIENT ANCILLARY SERVICE OTHER PASS THROUGH COSTS,TRIAL BALANCE OF EXPENSE ACCOUNTS,COMPUTATION OF RATIO OF COST TO CHARGES,COMPUTATION OF RATIO OF COST TO CHARGES,APPORTIONMENT OF INPATIENT/OUTPATIENT ANCILLARY SERVICE OTHER PASS THROUGH COSTS,APPORTIONMENT OF INPATIENT/OUTPATIENT ANCILLARY SERVICE OTHER PASS THROUGH COSTS,COST ALLOCATION,COST ALLOCATION,TRIAL BALANCE OF EXPENSE ACCOUNTS,APPORTIONMENT OF INPATIENT/OUTPATIENT ANCILLARY SERVICE OTHER PASS THROUGH COSTS,Total Inpatient Days/Outpatient Visits,,TRIAL BALANCE OF EXPENSE ACCOUNTS,APPORTIONMENT OF MEDICAL AND OTHER HEALTH SERVICES,TRIAL BALANCE OF EXPENSE ACCOUNTS,,TRIAL BALANCE OF EXPENSE ACCOUNTS,INPATIENT ANCILLARY SERVICE COST APPORTIONMENT,HOSPITAL WAGE INDEX DATA,TRIAL BALANCE OF EXPENSE ACCOUNTS,COST ALLOCATION,TRIAL BALANCE OF EXPENSE ACCOUNTS,INPATIENT ANCILLARY SERVICE COST APPORTIONMENT,APPORTIONMENT OF MEDICAL AND OTHER HEALTH SERVICES,COMPUTATION OF RATIO OF COST TO CHARGES,HOSPITAL WAGE INDEX DATA,APPORTIONMENT OF MEDICAL AND OTHER HEALTH SERVICES,RECONCILIATION OF CAPITAL COST CENTERS,APPORTIONMENT OF INPATIENT/OUTPATIENT ANCILLARY SERVICE OTHER PASS THROUGH COSTS,COST ALLOCATION,BALANCE SHEET,TRIAL BALANCE OF EXPENSE ACCOUNTS,COST ALLOCATION,INPATIENT ANCILLARY SERVICE COST APPORTIONMENT,Total Inpatient Days/Outpatient Visits,BALANCE SHEET,ALLOCATION OF NEW CAPITAL COSTS,APPORTIONMENT OF MEDICAL AND OTHER HEALTH SERVICES,APPORTIONMENT OF INPATIENT/OUTPATIENT ANCILLARY SERVICE OTHER PASS THROUGH COSTS,APPORTIONMENT OF MEDICAL AND OTHER HEALTH SERVICES,APPORTIONMENT OF MEDICAL AND OTHER HEALTH SERVICES,APPORTIONMENT OF MEDICAL AND OTHER HEALTH SERVICES,COST ALLOCATION,APPORTIONMENT OF MEDICAL AND OTHER HEALTH SERVICES,INPATIENT ANCILLARY SERVICE COST APPORTIONMENT,COMPUTATION OF RATIO OF COST TO CHARGES,INPATIENT ANCILLARY SERVICE COST APPORTIONMENT,ANALYSIS OF CHANGES IN NEW CAPITAL BALANCES,APPORTIONMENT OF INPATIENT/OUTPATIENT ANCILLARY SERVICE OTHER PASS THROUGH COSTS,INPATIENT ANCILLARY SERVICE COST APPORTIONMENT,INPATIENT ANCILLARY SERVICE COST APPORTIONMENT,TRIAL BALANCE OF EXPENSE ACCOUNTS,HOSPITAL WAGE INDEX DATA,HOSPITAL WAGE INDEX DATA,HOSPITAL WAGE INDEX DATA,INPATIENT ANCILLARY SERVICE COST APPORTIONMENT,CALCULATION OF REIMBURSEMENT SETTLEMENT,COMPUTATION OF RATIO OF COST TO CHARGES,INPATIENT ANCILLARY SERVICE COST APPORTIONMENT,APPORTIONMENT OF INPATIENT ROUTINE SERVICE CAPITAL COSTS,S-10 DATA,INPATIENT ANCILLARY SERVICE COST APPORTIONMENT,INPATIENT ANCILLARY SERVICE COST APPORTIONMENT,COMPUTATION OF RATIO OF COST TO CHARGES,COMPUTATION OF RATIO OF COST TO CHARGES,APPORTIONMENT OF INPATIENT/OUTPATIENT ANCILLARY SERVICE OTHER PASS THROUGH COSTS,HOSPITAL WAGE INDEX DATA,COST ALLOCATION,APPORTIONMENT OF INPATIENT/OUTPATIENT ANCILLARY SERVICE OTHER PASS THROUGH COSTS,,ALLOCATION OF NEW CAPITAL COSTS,HHA STATISTICAL DATA,COST ALLOCATION,BALANCE SHEET,BALANCE SHEET,HOSPITAL WAGE INDEX DATA,,ADJUSTMENTS,INPATIENT ANCILLARY SERVICE COST APPORTIONMENT,TRIAL BALANCE OF EXPENSE ACCOUNTS,HHA STATISTICAL DATA,COST ALLOCATION,ADJUSTMENTS,HHA STATISTICAL DATA,COST ALLOCATION,TRIAL BALANCE OF EXPENSE ACCOUNTS,APPORTIONMENT OF INPATIENT ROUTINE SERVICE CAPITAL COSTS,TRIAL BALANCE OF EXPENSE ACCOUNTS,APPORTIONMENT OF INPATIENT ROUTINE SERVICE OTHER PASS THROUGH COSTS,TRIAL BALANCE OF EXPENSE ACCOUNTS,INPATIENT ANCILLARY SERVICE COST APPORTIONMENT,,INPATIENT ANCILLARY SERVICE COST APPORTIONMENT,HOSPITAL WAGE INDEX DATA,BALANCE SHEET,ALLOCATION OF NEW CAPITAL COSTS,Total Inpatient Days/Outpatient Visits,,TRIAL BALANCE OF EXPENSE ACCOUNTS,,APPORTIONMENT OF MEDICAL AND OTHER HEALTH SERVICES,COST ALLOCATION,COMPUTATION OF INPATIENT OPERATING COSTS,APPORTIONMENT OF INPATIENT/OUTPATIENT ANCILLARY SERVICE OTHER PASS THROUGH COSTS,COST ALLOCATION,COMPUTATION OF RATIO OF COST TO CHARGES,HHA STATISTICAL DATA,COST ALLOCATION,,BALANCE SHEET,BED DAYS AVAILABLE,TRIAL BALANCE OF EXPENSE ACCOUNTS,TRIAL BALANCE OF EXPENSE ACCOUNTS,APPORTIONMENT OF INPATIENT/OUTPATIENT ANCILLARY SERVICE OTHER PASS THROUGH COSTS,COMPUTATION OF RATIO OF COST TO CHARGES,ANALYSIS OF CHANGES IN NEW CAPITAL BALANCES,ALLOCATION OF NEW CAPITAL COSTS,APPORTIONMENT OF MEDICAL AND OTHER HEALTH SERVICES,APPORTIONMENT OF INPATIENT/OUTPATIENT ANCILLARY SERVICE OTHER PASS THROUGH COSTS,COMPUTATION OF RATIO OF COST TO CHARGES,HOSPITAL WAGE INDEX DATA,RENAL STATISTICAL DATA,APPORTIONMENT OF INPATIENT/OUTPATIENT ANCILLARY SERVICE OTHER PASS THROUGH COSTS,INPATIENT ANCILLARY SERVICE COST APPORTIONMENT,TRIAL BALANCE OF EXPENSE ACCOUNTS,HOSPITAL WAGE INDEX DATA,COMPUTATION OF RATIO OF COST TO CHARGES,APPORTIONMENT OF MEDICAL AND OTHER HEALTH SERVICES,COST ALLOCATION,COMPUTATION OF RATIO OF COST TO CHARGES,COMPUTATION OF RATIO OF COST TO CHARGES,,STATEMENT OF PATIENT REVENUES AND OPERATING EXPENSES,APPORTIONMENT OF INPATIENT/OUTPATIENT ANCILLARY SERVICE OTHER PASS THROUGH COSTS,TRIAL BALANCE OF EXPENSE ACCOUNTS,APPORTIONMENT OF INPATIENT/OUTPATIENT ANCILLARY SERVICE OTHER PASS THROUGH COSTS,APPORTIONMENT OF INPATIENT/OUTPATIENT ANCILLARY SERVICE OTHER PASS THROUGH COSTS,,APPORTIONMENT OF INPATIENT/OUTPATIENT ANCILLARY SERVICE OTHER PASS THROUGH COSTS,INPATIENT ANCILLARY SERVICE COST APPORTIONMENT,APPORTIONMENT OF INPATIENT ROUTINE SERVICE CAPITAL COSTS,INPATIENT ANCILLARY SERVICE COST APPORTIONMENT,APPORTIONMENT OF MEDICAL AND OTHER HEALTH SERVICES,COMPUTATION OF RATIO OF COST TO CHARGES,COST ALLOCATION,APPORTIONMENT OF INPATIENT/OUTPATIENT ANCILLARY SERVICE OTHER PASS THROUGH COSTS,APPORTIONMENT OF INPATIENT/OUTPATIENT ANCILLARY SERVICE OTHER PASS THROUGH COSTS,COST ALLOCATION,COST ALLOCATION,APPORTIONMENT OF MEDICAL AND OTHER HEALTH SERVICES,RENAL STATISTICAL DATA,APPORTIONMENT OF INPATIENT/OUTPATIENT ANCILLARY SERVICE OTHER PASS THROUGH COSTS,COMPUTATION OF RATIO OF COST TO CHARGES,APPORTIONMENT OF MEDICAL AND OTHER HEALTH SERVICES,INPATIENT ANCILLARY SERVICE COST APPORTIONMENT,COST ALLOCATION,RENAL STATISTICAL DATA,COST ALLOCATION,BALANCE SHEET,HOSPITAL WAGE INDEX DATA,,INPATIENT ANCILLARY SERVICE COST APPORTIONMENT,BALANCE SHEET,APPORTIONMENT OF INPATIENT/OUTPATIENT ANCILLARY SERVICE OTHER PASS THROUGH COSTS,INPATIENT ANCILLARY SERVICE COST APPORTIONMENT,ADJUSTMENTS,INPATIENT ANCILLARY SERVICE COST APPORTIONMENT,APPORTIONMENT OF INPATIENT/OUTPATIENT ANCILLARY SERVICE OTHER PASS THROUGH COSTS,COST ALLOCATION,COST ALLOCATION,ADJUSTMENTS,APPORTIONMENT OF INPATIENT/OUTPATIENT ANCILLARY SERVICE OTHER PASS THROUGH COSTS,COMPUTATION OF RATIO OF COST TO CHARGES,APPORTIONMENT OF MEDICAL AND OTHER HEALTH SERVICES,COST ALLOCATION,ALLOCATION OF NEW CAPITAL COSTS,INPATIENT ANCILLARY SERVICE COST APPORTIONMENT,APPORTIONMENT OF INPATIENT/OUTPATIENT ANCILLARY SERVICE OTHER PASS THROUGH COSTS,APPORTIONMENT OF INPATIENT/OUTPATIENT ANCILLARY SERVICE OTHER PASS THROUGH COSTS,APPORTIONMENT OF MEDICAL AND OTHER HEALTH SERVICES,APPORTIONMENT OF MEDICAL AND OTHER HEALTH SERVICES,HOSPITAL WAGE INDEX DATA,TRIAL BALANCE OF EXPENSE ACCOUNTS,COMPUTATION OF INPATIENT OPERATING COSTS,HOSPITAL WAGE INDEX DATA,APPORTIONMENT OF INPATIENT/OUTPATIENT ANCILLARY SERVICE OTHER PASS THROUGH COSTS,HOSPITAL WAGE INDEX DATA,TRIAL BALANCE OF EXPENSE ACCOUNTS,TRIAL BALANCE OF EXPENSE ACCOUNTS,TRIAL BALANCE OF EXPENSE ACCOUNTS,COMPUTATION OF INPATIENT OPERATING COSTS,HOSPITAL WAGE INDEX DATA,APPORTIONMENT OF INPATIENT/OUTPATIENT ANCILLARY SERVICE OTHER PASS THROUGH COSTS,TRIAL BALANCE OF EXPENSE ACCOUNTS,HOSPITAL WAGE INDEX DATA,COST ALLOCATION,APPORTIONMENT OF INPATIENT/OUTPATIENT ANCILLARY SERVICE OTHER PASS THROUGH COSTS,COMPUTATION OF RATIO OF COST TO CHARGES,INPATIENT ANCILLARY SERVICE COST APPORTIONMENT,INPATIENT ANCILLARY SERVICE COST APPORTIONMENT,Total Inpatient Days/Outpatient Visits,ANALYSIS OF CHANGES IN NEW CAPITAL BALANCES,APPORTIONMENT OF MEDICAL AND OTHER HEALTH SERVICES,BALANCE SHEET,HOSPITAL IDENTIFICATION INFORMATION,APPORTIONMENT OF INPATIENT/OUTPATIENT ANCILLARY SERVICE OTHER PASS THROUGH COSTS,Total Inpatient Days/Outpatient Visits,HOSPITAL WAGE INDEX DATA,TRIAL BALANCE OF EXPENSE ACCOUNTS,APPORTIONMENT OF INPATIENT ROUTINE SERVICE CAPITAL COSTS,TRIAL BALANCE OF EXPENSE ACCOUNTS,COST ALLOCATION,HOSPITAL WAGE INDEX DATA,COST ALLOCATION,TRIAL BALANCE OF EXPENSE ACCOUNTS,COMPUTATION OF RATIO OF COST TO CHARGES,COMPUTATION OF RATIO OF COST TO CHARGES,HOSPITAL WAGE INDEX DATA,ALLOCATION OF NEW CAPITAL COSTS,HHA STATISTICAL DATA,HHA STATISTICAL DATA,APPORTIONMENT OF MEDICAL AND OTHER HEALTH SERVICES,APPORTIONMENT OF INPATIENT/OUTPATIENT ANCILLARY SERVICE OTHER PASS THROUGH COSTS,INPATIENT ANCILLARY SERVICE COST APPORTIONMENT,APPORTIONMENT OF INPATIENT ROUTINE SERVICE CAPITAL COSTS,TRIAL BALANCE OF EXPENSE ACCOUNTS,HOSPITAL WAGE INDEX DATA,HHA STATISTICAL DATA,RENAL STATISTICAL DATA,RENAL STATISTICAL DATA,APPORTIONMENT OF INPATIENT/OUTPATIENT ANCILLARY SERVICE OTHER PASS THROUGH COSTS,HOSPITAL WAGE INDEX DATA,TRIAL BALANCE OF EXPENSE ACCOUNTS,TRIAL BALANCE OF EXPENSE ACCOUNTS,COMPUTATION OF INPATIENT OPERATING COSTS,APPORTIONMENT OF MEDICAL AND OTHER HEALTH SERVICES,HOSPITAL WAGE INDEX DATA,S-10 DATA,COST ALLOCATION,COST ALLOCATION,CALCULATION OF REIMBURSEMENT SETTLEMENT,APPORTIONMENT OF INPATIENT/OUTPATIENT ANCILLARY SERVICE OTHER PASS THROUGH COSTS,COMPUTATION OF RATIO OF COST TO CHARGES,COMPUTATION OF RATIO OF COST TO CHARGES,APPORTIONMENT OF MEDICAL AND OTHER HEALTH SERVICES,HOSPITAL WAGE INDEX DATA,HOSPITAL WAGE INDEX DATA,RECONCILIATION OF CAPITAL COST CENTERS,COST ALLOCATION,HHA STATISTICAL DATA,Total Inpatient Days/Outpatient Visits,APPORTIONMENT OF MEDICAL AND OTHER HEALTH SERVICES,NUMBER OF BEDS,APPORTIONMENT OF INPATIENT/OUTPATIENT ANCILLARY SERVICE OTHER PASS THROUGH COSTS,INPATIENT ANCILLARY SERVICE COST APPORTIONMENT,APPORTIONMENT OF MEDICAL AND OTHER HEALTH SERVICES,COMPUTATION OF RATIO OF COST TO CHARGES,INPATIENT ANCILLARY SERVICE COST APPORTIONMENT,APPORTIONMENT OF INPATIENT/OUTPATIENT ANCILLARY SERVICE OTHER PASS THROUGH COSTS,Total Inpatient Days/Outpatient Visits,TRIAL BALANCE OF EXPENSE ACCOUNTS,COMPUTATION OF RATIO OF COST TO CHARGES,TRIAL BALANCE OF EXPENSE ACCOUNTS,INPATIENT ANCILLARY SERVICE COST APPORTIONMENT,HOSPITAL WAGE INDEX DATA,HOSPITAL WAGE INDEX DATA,APPORTIONMENT OF INPATIENT ROUTINE SERVICE CAPITAL COSTS,S-10 DATA,APPORTIONMENT OF INPATIENT/OUTPATIENT ANCILLARY SERVICE OTHER PASS THROUGH COSTS,Medicare Inpatient Days/Outpatient Visits,HOSPITAL WAGE INDEX DATA,ALLOCATION OF NEW CAPITAL COSTS,APPORTIONMENT OF INPATIENT/OUTPATIENT ANCILLARY SERVICE OTHER PASS THROUGH COSTS,HOSPITAL WAGE INDEX DATA,INPATIENT ANCILLARY SERVICE COST APPORTIONMENT,Total Inpatient Days/Outpatient Visits,ADJUSTMENTS,Total Inpatient Days/Outpatient Visits,APPORTIONMENT OF INPATIENT/OUTPATIENT ANCILLARY SERVICE OTHER PASS THROUGH COSTS,APPORTIONMENT OF INPATIENT/OUTPATIENT ANCILLARY SERVICE OTHER PASS THROUGH COSTS,HOSPITAL WAGE INDEX DATA,HOSPITAL WAGE INDEX DATA,NUMBER OF BEDS,APPORTIONMENT OF INPATIENT/OUTPATIENT ANCILLARY SERVICE OTHER PASS THROUGH COSTS,INPATIENT ANCILLARY SERVICE COST APPORTIONMENT,TRIAL BALANCE OF EXPENSE ACCOUNTS,,TRIAL BALANCE OF EXPENSE ACCOUNTS,COST ALLOCATION,COST ALLOCATION,INPATIENT ANCILLARY SERVICE COST APPORTIONMENT,APPORTIONMENT OF INPATIENT/OUTPATIENT ANCILLARY SERVICE OTHER PASS THROUGH COSTS,APPORTIONMENT OF MEDICAL AND OTHER HEALTH SERVICES,COST ALLOCATION,NUMBER OF BEDS,HHA STATISTICAL DATA,APPORTIONMENT OF INPATIENT/OUTPATIENT ANCILLARY SERVICE OTHER PASS THROUGH COSTS,APPORTIONMENT OF MEDICAL AND OTHER HEALTH SERVICES,HOSPITAL WAGE INDEX DATA,COST ALLOCATION,ANALYSIS OF CHANGES IN NEW CAPITAL BALANCES,COST ALLOCATION,TRIAL BALANCE OF EXPENSE ACCOUNTS,HHA STATISTICAL DATA,INPATIENT ANCILLARY SERVICE COST APPORTIONMENT,APPORTIONMENT OF INPATIENT/OUTPATIENT ANCILLARY SERVICE OTHER PASS THROUGH COSTS,,Medicaid Inpatient Days/Outpatient Visits,COST ALLOCATION,COST ALLOCATION,TRIAL BALANCE OF EXPENSE ACCOUNTS,TRIAL BALANCE OF EXPENSE ACCOUNTS,INPATIENT ANCILLARY SERVICE COST APPORTIONMENT,COST ALLOCATION,INPATIENT ANCILLARY SERVICE COST APPORTIONMENT,COST ALLOCATION,TRIAL BALANCE OF EXPENSE ACCOUNTS,TRIAL BALANCE OF EXPENSE ACCOUNTS,APPORTIONMENT OF INPATIENT ROUTINE SERVICE OTHER PASS THROUGH COSTS,TRIAL BALANCE OF EXPENSE ACCOUNTS,APPORTIONMENT OF MEDICAL AND OTHER HEALTH SERVICES,ALLOCATION OF NEW CAPITAL COSTS,BED DAYS AVAILABLE,HOSPITAL WAGE INDEX DATA,COMPUTATION OF RATIO OF COST TO CHARGES,,,HHA STATISTICAL DATA,APPORTIONMENT OF INPATIENT/OUTPATIENT ANCILLARY SERVICE OTHER PASS THROUGH COSTS,COST ALLOCATION,COST ALLOCATION,INPATIENT ANCILLARY SERVICE COST APPORTIONMENT,Medicaid Inpatient Days/Outpatient Visits,TRIAL BALANCE OF EXPENSE ACCOUNTS,COST ALLOCATION,COST ALLOCATION,COST ALLOCATION,COST ALLOCATION,APPORTIONMENT OF MEDICAL AND OTHER HEALTH SERVICES,APPORTIONMENT OF MEDICAL AND OTHER HEALTH SERVICES,COMPUTATION OF RATIO OF COST TO CHARGES,BALANCE SHEET,TRIAL BALANCE OF EXPENSE ACCOUNTS,APPORTIONMENT OF INPATIENT/OUTPATIENT ANCILLARY SERVICE OTHER PASS THROUGH COSTS,HOSPITAL WAGE INDEX DATA,APPORTIONMENT OF INPATIENT/OUTPATIENT ANCILLARY SERVICE OTHER PASS THROUGH COSTS,Medicaid Inpatient Days/Outpatient Visits,APPORTIONMENT OF INPATIENT/OUTPATIENT ANCILLARY SERVICE OTHER PASS THROUGH COSTS,Total Inpatient Days/Outpatient Visits,,COST ALLOCATION,COMPUTATION OF RATIO OF COST TO CHARGES,COST ALLOCATION,APPORTIONMENT OF INPATIENT/OUTPATIENT ANCILLARY SERVICE OTHER PASS THROUGH COSTS,COMPUTATION OF RATIO OF COST TO CHARGES,BED DAYS AVAILABLE,COST ALLOCATION,BED DAYS AVAILABLE,ANALYSIS OF CHANGES IN NEW CAPITAL BALANCES,TRIAL BALANCE OF EXPENSE ACCOUNTS,TRIAL BALANCE OF EXPENSE ACCOUNTS,APPORTIONMENT OF INPATIENT/OUTPATIENT ANCILLARY SERVICE OTHER PASS THROUGH COSTS,COMPUTATION OF INPATIENT OPERATING COSTS,COST ALLOCATION,INPATIENT ANCILLARY SERVICE COST APPORTIONMENT,INPATIENT ANCILLARY SERVICE COST APPORTIONMENT,INPATIENT ANCILLARY SERVICE COST APPORTIONMENT,,COST ALLOCATION,APPORTIONMENT OF INPATIENT/OUTPATIENT ANCILLARY SERVICE OTHER PASS THROUGH COSTS,APPORTIONMENT OF MEDICAL AND OTHER HEALTH SERVICES,CALCULATION OF REIMBURSEMENT SETTLEMENT,COST ALLOCATION,COMPUTATION OF INPATIENT OPERATING COSTS,HOSPITAL WAGE INDEX DATA,Total Inpatient Days/Outpatient Visits,Total Inpatient Days/Outpatient Visits,APPORTIONMENT OF INPATIENT/OUTPATIENT ANCILLARY SERVICE OTHER PASS THROUGH COSTS,HHA STATISTICAL DATA,COMPUTATION OF RATIO OF COST TO CHARGES,APPORTIONMENT OF INPATIENT/OUTPATIENT ANCILLARY SERVICE OTHER PASS THROUGH COSTS,APPORTIONMENT OF INPATIENT/OUTPATIENT ANCILLARY SERVICE OTHER PASS THROUGH COSTS,APPORTIONMENT OF MEDICAL AND OTHER HEALTH SERVICES,APPORTIONMENT OF MEDICAL AND OTHER HEALTH SERVICES,COST ALLOCATION,COST ALLOCATION,APPORTIONMENT OF INPATIENT/OUTPATIENT ANCILLARY SERVICE OTHER PASS THROUGH COSTS,COST ALLOCATION,INPATIENT ANCILLARY SERVICE COST APPORTIONMENT,CALCULATION OF REIMBURSEMENT SETTLEMENT,APPORTIONMENT OF INPATIENT/OUTPATIENT ANCILLARY SERVICE OTHER PASS THROUGH COSTS,HHA STATISTICAL DATA,APPORTIONMENT OF INPATIENT/OUTPATIENT ANCILLARY SERVICE OTHER PASS THROUGH COSTS,COST ALLOCATION,COST ALLOCATION,APPORTIONMENT OF MEDICAL AND OTHER HEALTH SERVICES,APPORTIONMENT OF MEDICAL AND OTHER HEALTH SERVICES,ALLOCATION OF NEW CAPITAL COSTS,COMPUTATION OF INPATIENT OPERATING COSTS,COST ALLOCATION,APPORTIONMENT OF INPATIENT/OUTPATIENT ANCILLARY SERVICE OTHER PASS THROUGH COSTS,COMPUTATION OF RATIO OF COST TO CHARGES,HOSPITAL WAGE INDEX DATA,APPORTIONMENT OF INPATIENT/OUTPATIENT ANCILLARY SERVICE OTHER PASS THROUGH COSTS,Total Inpatient Days/Outpatient Visits,APPORTIONMENT OF INPATIENT/OUTPATIENT ANCILLARY SERVICE OTHER PASS THROUGH COSTS,INPATIENT ANCILLARY SERVICE COST APPORTIONMENT,BALANCE SHEET,TRIAL BALANCE OF EXPENSE ACCOUNTS,APPORTIONMENT OF INPATIENT/OUTPATIENT ANCILLARY SERVICE OTHER PASS THROUGH COSTS,COMPUTATION OF RATIO OF COST TO CHARGES,APPORTIONMENT OF INPATIENT/OUTPATIENT ANCILLARY SERVICE OTHER PASS THROUGH COSTS,APPORTIONMENT OF INPATIENT/OUTPATIENT ANCILLARY SERVICE OTHER PASS THROUGH COSTS,Total Inpatient Days/Outpatient Visits,INPATIENT ANCILLARY SERVICE COST APPORTIONMENT,COMPUTATION OF RATIO OF COST TO CHARGES,HOSPITAL WAGE INDEX DATA,Medicare Inpatient Days/Outpatient Visits,TRIAL BALANCE OF EXPENSE ACCOUNTS,INPATIENT ANCILLARY SERVICE COST APPORTIONMENT,INPATIENT ANCILLARY SERVICE COST APPORTIONMENT,TRIAL BALANCE OF EXPENSE ACCOUNTS,TRIAL BALANCE OF EXPENSE ACCOUNTS,HOSPITAL WAGE INDEX DATA,APPORTIONMENT OF INPATIENT/OUTPATIENT ANCILLARY SERVICE OTHER PASS THROUGH COSTS,,COST ALLOCATION,APPORTIONMENT OF INPATIENT/OUTPATIENT ANCILLARY SERVICE OTHER PASS THROUGH COSTS,COST ALLOCATION,APPORTIONMENT OF INPATIENT/OUTPATIENT ANCILLARY SERVICE OTHER PASS THROUGH COSTS,APPORTIONMENT OF INPATIENT/OUTPATIENT ANCILLARY SERVICE OTHER PASS THROUGH COSTS,COST ALLOCATION,INPATIENT ANCILLARY SERVICE COST APPORTIONMENT,COMPUTATION OF RATIO OF COST TO CHARGES,INPATIENT ANCILLARY SERVICE COST APPORTIONMENT,INPATIENT ANCILLARY SERVICE COST APPORTIONMENT,COST ALLOCATION,APPORTIONMENT OF INPATIENT/OUTPATIENT ANCILLARY SERVICE OTHER PASS THROUGH COSTS,APPORTIONMENT OF MEDICAL AND OTHER HEALTH SERVICES,INPATIENT ANCILLARY SERVICE COST APPORTIONMENT,APPORTIONMENT OF INPATIENT/OUTPATIENT ANCILLARY SERVICE OTHER PASS THROUGH COSTS,COST ALLOCATION,HOSPITAL WAGE INDEX DATA,,COST ALLOCATION,COMPUTATION OF RATIO OF COST TO CHARGES,ALLOCATION OF NEW CAPITAL COSTS,APPORTIONMENT OF INPATIENT/OUTPATIENT ANCILLARY SERVICE OTHER PASS THROUGH COSTS,HOSPITAL WAGE INDEX DATA,RENAL STATISTICAL DATA,ANALYSIS OF CHANGES IN NEW CAPITAL BALANCES,COST ALLOCATION,TRIAL BALANCE OF EXPENSE ACCOUNTS,APPORTIONMENT OF INPATIENT/OUTPATIENT ANCILLARY SERVICE OTHER PASS THROUGH COSTS,COST ALLOCATION,INPATIENT ANCILLARY SERVICE COST APPORTIONMENT,COST ALLOCATION,INPATIENT ANCILLARY SERVICE COST APPORTIONMENT,COMPUTATION OF RATIO OF COST TO CHARGES,APPORTIONMENT OF MEDICAL AND OTHER HEALTH SERVICES,APPORTIONMENT OF INPATIENT ROUTINE SERVICE CAPITAL COSTS,,INPATIENT ANCILLARY SERVICE COST APPORTIONMENT,HHA STATISTICAL DATA,COST ALLOCATION,Total Inpatient Days/Outpatient Visits,APPORTIONMENT OF MEDICAL AND OTHER HEALTH SERVICES,INPATIENT ANCILLARY SERVICE COST APPORTIONMENT,COMPUTATION OF RATIO OF COST TO CHARGES,,HOSPITAL WAGE INDEX DATA,ANALYSIS OF CHANGES IN NEW CAPITAL BALANCES,INPATIENT ANCILLARY SERVICE COST APPORTIONMENT,,TRIAL BALANCE OF EXPENSE ACCOUNTS,HOSPITAL WAGE INDEX DATA,COMPUTATION OF RATIO OF COST TO CHARGES,BED DAYS AVAILABLE,,COST ALLOCATION,COST ALLOCATION,APPORTIONMENT OF INPATIENT/OUTPATIENT ANCILLARY SERVICE OTHER PASS THROUGH COSTS,APPORTIONMENT OF INPATIENT/OUTPATIENT ANCILLARY SERVICE OTHER PASS THROUGH COSTS,INPATIENT ANCILLARY SERVICE COST APPORTIONMENT,CALCULATION OF REIMBURSEMENT SETTLEMENT,INPATIENT ANCILLARY SERVICE COST APPORTIONMENT,ADJUSTMENTS,APPORTIONMENT OF INPATIENT/OUTPATIENT ANCILLARY SERVICE OTHER PASS THROUGH COSTS,APPORTIONMENT OF INPATIENT/OUTPATIENT ANCILLARY SERVICE OTHER PASS THROUGH COSTS,INPATIENT ANCILLARY SERVICE COST APPORTIONMENT,INPATIENT ANCILLARY SERVICE COST APPORTIONMENT,HOSPITAL WAGE INDEX DATA,,APPORTIONMENT OF INPATIENT/OUTPATIENT ANCILLARY SERVICE OTHER PASS THROUGH COSTS,APPORTIONMENT OF INPATIENT/OUTPATIENT ANCILLARY SERVICE OTHER PASS THROUGH COSTS,APPORTIONMENT OF INPATIENT/OUTPATIENT ANCILLARY SERVICE OTHER PASS THROUGH COSTS,APPORTIONMENT OF INPATIENT/OUTPATIENT ANCILLARY SERVICE OTHER PASS THROUGH COSTS,Total Inpatient Days/Outpatient Visits,Total Inpatient Days/Outpatient Visits,TRIAL BALANCE OF EXPENSE ACCOUNTS,ALLOCATION OF NEW CAPITAL COSTS,APPORTIONMENT OF INPATIENT/OUTPATIENT ANCILLARY SERVICE OTHER PASS THROUGH COSTS,APPORTIONMENT OF INPATIENT/OUTPATIENT ANCILLARY SERVICE OTHER PASS THROUGH COSTS,HHA STATISTICAL DATA,APPORTIONMENT OF INPATIENT/OUTPATIENT ANCILLARY SERVICE OTHER PASS THROUGH COSTS,COST ALLOCATION,APPORTIONMENT OF INPATIENT/OUTPATIENT ANCILLARY SERVICE OTHER PASS THROUGH COSTS,S-10 DATA,HHA STATISTICAL DATA,APPORTIONMENT OF MEDICAL AND OTHER HEALTH SERVICES,APPORTIONMENT OF INPATIENT/OUTPATIENT ANCILLARY SERVICE OTHER PASS THROUGH COSTS,ADJUSTMENTS,COST ALLOCATION,COMPUTATION OF RATIO OF COST TO CHARGES,CALCULATION OF REIMBURSEMENT SETTLEMENT,Medicaid Inpatient Days/Outpatient Visits,INPATIENT ANCILLARY SERVICE COST APPORTIONMENT,INPATIENT ANCILLARY SERVICE COST APPORTIONMENT,ALLOCATION OF NEW CAPITAL COSTS,HOSPITAL WAGE INDEX DATA,ALLOCATION OF NEW CAPITAL COSTS,HOSPITAL WAGE INDEX DATA,COMPUTATION OF RATIO OF COST TO CHARGES,TRIAL BALANCE OF EXPENSE ACCOUNTS,COMPUTATION OF RATIO OF COST TO CHARGES,COST ALLOCATION,ADJUSTMENTS,Medicare Inpatient Days/Outpatient Visits,APPORTIONMENT OF INPATIENT/OUTPATIENT ANCILLARY SERVICE OTHER PASS THROUGH COSTS,TRIAL BALANCE OF EXPENSE ACCOUNTS,APPORTIONMENT OF MEDICAL AND OTHER HEALTH SERVICES,COMPUTATION OF INPATIENT OPERATING COSTS,APPORTIONMENT OF INPATIENT/OUTPATIENT ANCILLARY SERVICE OTHER PASS THROUGH COSTS,APPORTIONMENT OF MEDICAL AND OTHER HEALTH SERVICES,RECONCILIATION OF CAPITAL COST CENTERS,Total Inpatient Days/Outpatient Visits,TRIAL BALANCE OF EXPENSE ACCOUNTS,TRIAL BALANCE OF EXPENSE ACCOUNTS,APPORTIONMENT OF INPATIENT/OUTPATIENT ANCILLARY SERVICE OTHER PASS THROUGH COSTS,COMPUTATION OF RATIO OF COST TO CHARGES,APPORTIONMENT OF MEDICAL AND OTHER HEALTH SERVICES,APPORTIONMENT OF MEDICAL AND OTHER HEALTH SERVICES,,INPATIENT ANCILLARY SERVICE COST APPORTIONMENT,Medicaid Inpatient Days/Outpatient Visits,COST ALLOCATION,COMPUTATION OF RATIO OF COST TO CHARGES,INPATIENT ANCILLARY SERVICE COST APPORTIONMENT,TRIAL BALANCE OF EXPENSE ACCOUNTS,ANALYSIS OF CHANGES IN NEW CAPITAL BALANCES,TRIAL BALANCE OF EXPENSE ACCOUNTS,HOSPITAL WAGE INDEX DATA,ANALYSIS OF CHANGES IN NEW CAPITAL BALANCES,BALANCE SHEET,COST ALLOCATION,APPORTIONMENT OF MEDICAL AND OTHER HEALTH SERVICES,TRIAL BALANCE OF EXPENSE ACCOUNTS,APPORTIONMENT OF INPATIENT/OUTPATIENT ANCILLARY SERVICE OTHER PASS THROUGH COSTS,TRIAL BALANCE OF EXPENSE ACCOUNTS,TRIAL BALANCE OF EXPENSE ACCOUNTS,COST ALLOCATION,INPATIENT ANCILLARY SERVICE COST APPORTIONMENT,TRIAL BALANCE OF EXPENSE ACCOUNTS,COMPUTATION OF RATIO OF COST TO CHARGES,,INPATIENT ANCILLARY SERVICE COST APPORTIONMENT,RECONCILIATION OF CAPITAL COST CENTERS,HOSPITAL WAGE INDEX DATA,S-10 DATA,COST ALLOCATION,HHA STATISTICAL DATA,APPORTIONMENT OF INPATIENT ROUTINE SERVICE OTHER PASS THROUGH COSTS,INPATIENT ANCILLARY SERVICE COST APPORTIONMENT,ALLOCATION OF NEW CAPITAL COSTS,COST ALLOCATION,TRIAL BALANCE OF EXPENSE ACCOUNTS,BALANCE SHEET,COMPUTATION OF RATIO OF COST TO CHARGES,APPORTIONMENT OF INPATIENT ROUTINE SERVICE CAPITAL COSTS,TRIAL BALANCE OF EXPENSE ACCOUNTS,APPORTIONMENT OF INPATIENT/OUTPATIENT ANCILLARY SERVICE OTHER PASS THROUGH COSTS,Total Inpatient Days/Outpatient Visits,BED DAYS AVAILABLE,APPORTIONMENT OF MEDICAL AND OTHER HEALTH SERVICES,TRIAL BALANCE OF EXPENSE ACCOUNTS,HOSPITAL WAGE INDEX DATA,,COST ALLOCATION,COST ALLOCATION,STATEMENT OF PATIENT REVENUES AND OPERATING EXPENSES,Total Inpatient Days/Outpatient Visits,INPATIENT ANCILLARY SERVICE COST APPORTIONMENT,APPORTIONMENT OF MEDICAL AND OTHER HEALTH SERVICES,APPORTIONMENT OF INPATIENT/OUTPATIENT ANCILLARY SERVICE OTHER PASS THROUGH COSTS,INPATIENT ANCILLARY SERVICE COST APPORTIONMENT,HOSPITAL WAGE INDEX DATA,TRIAL BALANCE OF EXPENSE ACCOUNTS,TRIAL BALANCE OF EXPENSE ACCOUNTS,INPATIENT ANCILLARY SERVICE COST APPORTIONMENT,TRIAL BALANCE OF EXPENSE ACCOUNTS,HOSPITAL WAGE INDEX DATA,APPORTIONMENT OF MEDICAL AND OTHER HEALTH SERVICES,HHA STATISTICAL DATA,APPORTIONMENT OF INPATIENT/OUTPATIENT ANCILLARY SERVICE OTHER PASS THROUGH COSTS,COMPUTATION OF INPATIENT OPERATING COSTS,TRIAL BALANCE OF EXPENSE ACCOUNTS,INPATIENT ANCILLARY SERVICE COST APPORTIONMENT,APPORTIONMENT OF INPATIENT/OUTPATIENT ANCILLARY SERVICE OTHER PASS THROUGH COSTS,TRIAL BALANCE OF EXPENSE ACCOUNTS,Total Inpatient Days/Outpatient Visits,ALLOCATION OF NEW CAPITAL COSTS,CALCULATION OF REIMBURSEMENT SETTLEMENT,Total Inpatient Days/Outpatient Visits,Medicare Inpatient Days/Outpatient Visits,ANALYSIS OF CHANGES IN NEW CAPITAL BALANCES,APPORTIONMENT OF MEDICAL AND OTHER HEALTH SERVICES,APPORTIONMENT OF INPATIENT/OUTPATIENT ANCILLARY SERVICE OTHER PASS THROUGH COSTS,COST ALLOCATION,COST ALLOCATION,APPORTIONMENT OF MEDICAL AND OTHER HEALTH SERVICES,APPORTIONMENT OF MEDICAL AND OTHER HEALTH SERVICES,HHA STATISTICAL DATA,CALCULATION OF REIMBURSEMENT SETTLEMENT (PPS),ALLOCATION OF NEW CAPITAL COSTS,ALLOCATION OF NEW CAPITAL COSTS,COST ALLOCATION,RENAL STATISTICAL DATA,,APPORTIONMENT OF INPATIENT/OUTPATIENT ANCILLARY SERVICE OTHER PASS THROUGH COSTS,HOSPITAL WAGE INDEX DATA,APPORTIONMENT OF INPATIENT/OUTPATIENT ANCILLARY SERVICE OTHER PASS THROUGH COSTS,APPORTIONMENT OF INPATIENT/OUTPATIENT ANCILLARY SERVICE OTHER PASS THROUGH COSTS,,HOSPITAL WAGE INDEX DATA,COST ALLOCATION,TRIAL BALANCE OF EXPENSE ACCOUNTS,COST ALLOCATION,COMPUTATION OF RATIO OF COST TO CHARGES,APPORTIONMENT OF INPATIENT/OUTPATIENT ANCILLARY SERVICE OTHER PASS THROUGH COSTS,,TRIAL BALANCE OF EXPENSE ACCOUNTS,HOSPITAL WAGE INDEX DATA,COST ALLOCATION,APPORTIONMENT OF INPATIENT/OUTPATIENT ANCILLARY SERVICE OTHER PASS THROUGH COSTS,APPORTIONMENT OF MEDICAL AND OTHER HEALTH SERVICES,APPORTIONMENT OF MEDICAL AND OTHER HEALTH SERVICES,HOSPITAL WAGE INDEX DATA,,Medicaid Inpatient Days/Outpatient Visits,COST ALLOCATION,COST ALLOCATION,COST ALLOCATION,TRIAL BALANCE OF EXPENSE ACCOUNTS,ALLOCATION OF NEW CAPITAL COSTS,,APPORTIONMENT OF MEDICAL AND OTHER HEALTH SERVICES,TRIAL BALANCE OF EXPENSE ACCOUNTS,COST ALLOCATION,TRIAL BALANCE OF EXPENSE ACCOUNTS,,Medicare Inpatient Days/Outpatient Visits,ANALYSIS OF CHANGES IN NEW CAPITAL BALANCES,HOSPITAL WAGE INDEX DATA,APPORTIONMENT OF INPATIENT/OUTPATIENT ANCILLARY SERVICE OTHER PASS THROUGH COSTS,COMPUTATION OF INPATIENT OPERATING COSTS,Medicaid Inpatient Days/Outpatient Visits,HOSPITAL WAGE INDEX DATA,APPORTIONMENT OF MEDICAL AND OTHER HEALTH SERVICES,APPORTIONMENT OF INPATIENT/OUTPATIENT ANCILLARY SERVICE OTHER PASS THROUGH COSTS,APPORTIONMENT OF INPATIENT/OUTPATIENT ANCILLARY SERVICE OTHER PASS THROUGH COSTS,APPORTIONMENT OF MEDICAL AND OTHER HEALTH SERVICES,NUMBER OF BEDS,COMPUTATION OF RATIO OF COST TO CHARGES,APPORTIONMENT OF INPATIENT/OUTPATIENT ANCILLARY SERVICE OTHER PASS THROUGH COSTS,INPATIENT ANCILLARY SERVICE COST APPORTIONMENT,COST ALLOCATION,COST ALLOCATION,ALLOCATION OF NEW CAPITAL COSTS,ANALYSIS OF CHANGES IN NEW CAPITAL BALANCES,APPORTIONMENT OF INPATIENT/OUTPATIENT ANCILLARY SERVICE OTHER PASS THROUGH COSTS,APPORTIONMENT OF INPATIENT/OUTPATIENT ANCILLARY SERVICE OTHER PASS THROUGH COSTS,APPORTIONMENT OF INPATIENT/OUTPATIENT ANCILLARY SERVICE OTHER PASS THROUGH COSTS,INPATIENT ANCILLARY SERVICE COST APPORTIONMENT,APPORTIONMENT OF MEDICAL AND OTHER HEALTH SERVICES,APPORTIONMENT OF INPATIENT/OUTPATIENT ANCILLARY SERVICE OTHER PASS THROUGH COSTS,COST ALLOCATION,APPORTIONMENT OF INPATIENT/OUTPATIENT ANCILLARY SERVICE OTHER PASS THROUGH COSTS,BED DAYS AVAILABLE,TRIAL BALANCE OF EXPENSE ACCOUNTS,HOSPITAL WAGE INDEX DATA,COMPUTATION OF RATIO OF COST TO CHARGES,TRIAL BALANCE OF EXPENSE ACCOUNTS,APPORTIONMENT OF INPATIENT/OUTPATIENT ANCILLARY SERVICE OTHER PASS THROUGH COSTS,APPORTIONMENT OF MEDICAL AND OTHER HEALTH SERVICES,APPORTIONMENT OF INPATIENT/OUTPATIENT ANCILLARY SERVICE OTHER PASS THROUGH COSTS,RENAL STATISTICAL DATA,INPATIENT ANCILLARY SERVICE COST APPORTIONMENT,INPATIENT ANCILLARY SERVICE COST APPORTIONMENT,HOSPITAL WAGE INDEX DATA,APPORTIONMENT OF INPATIENT/OUTPATIENT ANCILLARY SERVICE OTHER PASS THROUGH COSTS,APPORTIONMENT OF INPATIENT/OUTPATIENT ANCILLARY SERVICE OTHER PASS THROUGH COSTS,INPATIENT ANCILLARY SERVICE COST APPORTIONMENT,,INPATIENT ANCILLARY SERVICE COST APPORTIONMENT,COST ALLOCATION,COMPUTATION OF RATIO OF COST TO CHARGES,TRIAL BALANCE OF EXPENSE ACCOUNTS,,APPORTIONMENT OF INPATIENT ROUTINE SERVICE OTHER PASS THROUGH COSTS,APPORTIONMENT OF INPATIENT/OUTPATIENT ANCILLARY SERVICE OTHER PASS THROUGH COSTS,APPORTIONMENT OF INPATIENT/OUTPATIENT ANCILLARY SERVICE OTHER PASS THROUGH COSTS,TRIAL BALANCE OF EXPENSE ACCOUNTS,INPATIENT ANCILLARY SERVICE COST APPORTIONMENT,APPORTIONMENT OF INPATIENT/OUTPATIENT ANCILLARY SERVICE OTHER PASS THROUGH COSTS,BALANCE SHEET,,HHA STATISTICAL DATA,,COMPUTATION OF RATIO OF COST TO CHARGES,ALLOCATION OF NEW CAPITAL COSTS,APPORTIONMENT OF INPATIENT/OUTPATIENT ANCILLARY SERVICE OTHER PASS THROUGH COSTS,Medicaid Inpatient Days/Outpatient Visits,TRIAL BALANCE OF EXPENSE ACCOUNTS,TRIAL BALANCE OF EXPENSE ACCOUNTS,ALLOCATION OF NEW CAPITAL COSTS,Total Inpatient Days/Outpatient Visits,APPORTIONMENT OF INPATIENT/OUTPATIENT ANCILLARY SERVICE OTHER PASS THROUGH COSTS,TRIAL BALANCE OF EXPENSE ACCOUNTS,TRIAL BALANCE OF EXPENSE ACCOUNTS,INPATIENT ANCILLARY SERVICE COST APPORTIONMENT,TRIAL BALANCE OF EXPENSE ACCOUNTS,HOSPITAL WAGE INDEX DATA,COST ALLOCATION,COST ALLOCATION,COMPUTATION OF INPATIENT OPERATING COSTS,COST ALLOCATION,APPORTIONMENT OF MEDICAL AND OTHER HEALTH SERVICES,TRIAL BALANCE OF EXPENSE ACCOUNTS,HOSPITAL WAGE INDEX DATA,INPATIENT ANCILLARY SERVICE COST APPORTIONMENT,,APPORTIONMENT OF INPATIENT/OUTPATIENT ANCILLARY SERVICE OTHER PASS THROUGH COSTS,Total Inpatient Days/Outpatient Visits,APPORTIONMENT OF MEDICAL AND OTHER HEALTH SERVICES,RENAL STATISTICAL DATA,COST ALLOCATION,COST ALLOCATION,TRIAL BALANCE OF EXPENSE ACCOUNTS,INPATIENT ANCILLARY SERVICE COST APPORTIONMENT,INPATIENT ANCILLARY SERVICE COST APPORTIONMENT,INPATIENT ANCILLARY SERVICE COST APPORTIONMENT,APPORTIONMENT OF INPATIENT/OUTPATIENT ANCILLARY SERVICE OTHER PASS THROUGH COSTS,ALLOCATION OF NEW CAPITAL COSTS,INPATIENT ANCILLARY SERVICE COST APPORTIONMENT,APPORTIONMENT OF MEDICAL AND OTHER HEALTH SERVICES,APPORTIONMENT OF MEDICAL AND OTHER HEALTH SERVICES,COMPUTATION OF INPATIENT OPERATING COSTS,COST ALLOCATION,APPORTIONMENT OF INPATIENT/OUTPATIENT ANCILLARY SERVICE OTHER PASS THROUGH COSTS,COST ALLOCATION,INPATIENT ANCILLARY SERVICE COST APPORTIONMENT,BALANCE SHEET,,CALCULATION OF REIMBURSEMENT SETTLEMENT,ANALYSIS OF CHANGES IN NEW CAPITAL BALANCES,COST ALLOCATION,,APPORTIONMENT OF INPATIENT/OUTPATIENT ANCILLARY SERVICE OTHER PASS THROUGH COSTS,COST ALLOCATION,TRIAL BALANCE OF EXPENSE ACCOUNTS,HOSPITAL WAGE INDEX DATA,INPATIENT ANCILLARY SERVICE COST APPORTIONMENT,APPORTIONMENT OF MEDICAL AND OTHER HEALTH SERVICES,COMPUTATION OF INPATIENT OPERATING COSTS,INPATIENT ANCILLARY SERVICE COST APPORTIONMENT,INPATIENT ANCILLARY SERVICE COST APPORTIONMENT,ALLOCATION OF NEW CAPITAL COSTS,HOSPITAL WAGE INDEX DATA,Total Inpatient Days/Outpatient Visits,COST ALLOCATION,COMPUTATION OF RATIO OF COST TO CHARGES,HOSPITAL WAGE INDEX DATA,CALCULATION OF REIMBURSEMENT SETTLEMENT,APPORTIONMENT OF INPATIENT/OUTPATIENT ANCILLARY SERVICE OTHER PASS THROUGH COSTS,COST ALLOCATION,APPORTIONMENT OF MEDICAL AND OTHER HEALTH SERVICES,INPATIENT ANCILLARY SERVICE COST APPORTIONMENT,TRIAL BALANCE OF EXPENSE ACCOUNTS,HOSPITAL WAGE INDEX DATA,TRIAL BALANCE OF EXPENSE ACCOUNTS,APPORTIONMENT OF MEDICAL AND OTHER HEALTH SERVICES,INPATIENT ANCILLARY SERVICE COST APPORTIONMENT,TRIAL BALANCE OF EXPENSE ACCOUNTS,HOSPITAL WAGE INDEX DATA,TRIAL BALANCE OF EXPENSE ACCOUNTS,TRIAL BALANCE OF EXPENSE ACCOUNTS,COMPUTATION OF RATIO OF COST TO CHARGES,COST ALLOCATION,HOSPITAL WAGE INDEX DATA,APPORTIONMENT OF INPATIENT ROUTINE SERVICE OTHER PASS THROUGH COSTS,APPORTIONMENT OF INPATIENT/OUTPATIENT ANCILLARY SERVICE OTHER PASS THROUGH COSTS,APPORTIONMENT OF INPATIENT/OUTPATIENT ANCILLARY SERVICE OTHER PASS THROUGH COSTS,COST ALLOCATION,Total Inpatient Days/Outpatient Visits,COST ALLOCATION,APPORTIONMENT OF INPATIENT ROUTINE SERVICE CAPITAL COSTS,INPATIENT ANCILLARY SERVICE COST APPORTIONMENT,COST ALLOCATION,HOSPITAL WAGE INDEX DATA,APPORTIONMENT OF MEDICAL AND OTHER HEALTH SERVICES,APPORTIONMENT OF MEDICAL AND OTHER HEALTH SERVICES,COST ALLOCATION,Total Inpatient Days/Outpatient Visits,APPORTIONMENT OF MEDICAL AND OTHER HEALTH SERVICES,COMPUTATION OF RATIO OF COST TO CHARGES,APPORTIONMENT OF MEDICAL AND OTHER HEALTH SERVICES,RENAL STATISTICAL DATA,HOSPITAL WAGE INDEX DATA,ALLOCATION OF NEW CAPITAL COSTS,TRIAL BALANCE OF EXPENSE ACCOUNTS,,COMPUTATION OF INPATIENT OPERATING COSTS,HOSPITAL WAGE INDEX DATA,COMPUTATION OF RATIO OF COST TO CHARGES,APPORTIONMENT OF INPATIENT/OUTPATIENT ANCILLARY SERVICE OTHER PASS THROUGH COSTS,RECONCILIATION OF CAPITAL COST CENTERS,ALLOCATION OF NEW CAPITAL COSTS,COMPUTATION OF RATIO OF COST TO CHARGES,TRIAL BALANCE OF EXPENSE ACCOUNTS,HOSPITAL WAGE INDEX DATA,INPATIENT ANCILLARY SERVICE COST APPORTIONMENT,HOSPITAL WAGE INDEX DATA,BALANCE SHEET,COST ALLOCATION,COST ALLOCATION,APPORTIONMENT OF INPATIENT ROUTINE SERVICE CAPITAL COSTS,COST ALLOCATION,COST ALLOCATION,TRIAL BALANCE OF EXPENSE ACCOUNTS,TRIAL BALANCE OF EXPENSE ACCOUNTS,Total Inpatient Days/Outpatient Visits,APPORTIONMENT OF MEDICAL AND OTHER HEALTH SERVICES,COST ALLOCATION,S-10 DATA,HOSPITAL WAGE INDEX DATA,INPATIENT ANCILLARY SERVICE COST APPORTIONMENT,HHA STATISTICAL DATA,TRIAL BALANCE OF EXPENSE ACCOUNTS,APPORTIONMENT OF INPATIENT/OUTPATIENT ANCILLARY SERVICE OTHER PASS THROUGH COSTS,ANALYSIS OF CHANGES IN NEW CAPITAL BALANCES,HOSPITAL WAGE INDEX DATA,TRIAL BALANCE OF EXPENSE ACCOUNTS,APPORTIONMENT OF INPATIENT/OUTPATIENT ANCILLARY SERVICE OTHER PASS THROUGH COSTS,INPATIENT ANCILLARY SERVICE COST APPORTIONMENT,ALLOCATION OF NEW CAPITAL COSTS,APPORTIONMENT OF INPATIENT/OUTPATIENT ANCILLARY SERVICE OTHER PASS THROUGH COSTS,BED DAYS AVAILABLE,COMPUTATION OF RATIO OF COST TO CHARGES,CALCULATION OF REIMBURSEMENT SETTLEMENT,INPATIENT ANCILLARY SERVICE COST APPORTIONMENT,,APPORTIONMENT OF INPATIENT/OUTPATIENT ANCILLARY SERVICE OTHER PASS THROUGH COSTS,COMPUTATION OF RATIO OF COST TO CHARGES,TRIAL BALANCE OF EXPENSE ACCOUNTS,APPORTIONMENT OF MEDICAL AND OTHER HEALTH SERVICES,COMPUTATION OF RATIO OF COST TO CHARGES,COST ALLOCATION,APPORTIONMENT OF INPATIENT ROUTINE SERVICE CAPITAL COSTS,INPATIENT ANCILLARY SERVICE COST APPORTIONMENT,ANALYSIS OF CHANGES IN NEW CAPITAL BALANCES,HOSPITAL WAGE INDEX DATA,HOSPITAL WAGE INDEX DATA,INPATIENT ANCILLARY SERVICE COST APPORTIONMENT,APPORTIONMENT OF INPATIENT/OUTPATIENT ANCILLARY SERVICE OTHER PASS THROUGH COSTS,APPORTIONMENT OF MEDICAL AND OTHER HEALTH SERVICES,TRIAL BALANCE OF EXPENSE ACCOUNTS,TRIAL BALANCE OF EXPENSE ACCOUNTS,APPORTIONMENT OF INPATIENT/OUTPATIENT ANCILLARY SERVICE OTHER PASS THROUGH COSTS,COMPUTATION OF RATIO OF COST TO CHARGES,COST ALLOCATION,COST ALLOCATION,COST ALLOCATION,BED DAYS AVAILABLE,Total Inpatient Days/Outpatient Visits,TRIAL BALANCE OF EXPENSE ACCOUNTS,COST ALLOCATION,TRIAL BALANCE OF EXPENSE ACCOUNTS,APPORTIONMENT OF MEDICAL AND OTHER HEALTH SERVICES,HOSPITAL WAGE INDEX DATA,HOSPITAL WAGE INDEX DATA,BED DAYS AVAILABLE,CALCULATION OF REIMBURSEMENT SETTLEMENT,COMPUTATION OF RATIO OF COST TO CHARGES,APPORTIONMENT OF INPATIENT/OUTPATIENT ANCILLARY SERVICE OTHER PASS THROUGH COSTS,APPORTIONMENT OF INPATIENT/OUTPATIENT ANCILLARY SERVICE OTHER PASS THROUGH COSTS,INPATIENT ANCILLARY SERVICE COST APPORTIONMENT,APPORTIONMENT OF MEDICAL AND OTHER HEALTH SERVICES,APPORTIONMENT OF MEDICAL AND OTHER HEALTH SERVICES,COMPUTATION OF RATIO OF COST TO CHARGES,,HOSPITAL WAGE INDEX DATA,APPORTIONMENT OF INPATIENT/OUTPATIENT ANCILLARY SERVICE OTHER PASS THROUGH COSTS,RECONCILIATION OF CAPITAL COST CENTERS,APPORTIONMENT OF MEDICAL AND OTHER HEALTH SERVICES,COMPUTATION OF RATIO OF COST TO CHARGES,HOSPITAL WAGE INDEX DATA,ANALYSIS OF CHANGES IN NEW CAPITAL BALANCES,INPATIENT ANCILLARY SERVICE COST APPORTIONMENT,BED DAYS AVAILABLE,TRIAL BALANCE OF EXPENSE ACCOUNTS,ADJUSTMENTS,INPATIENT ANCILLARY SERVICE COST APPORTIONMENT,Total Inpatient Days/Outpatient Visits,TRIAL BALANCE OF EXPENSE ACCOUNTS,HHA STATISTICAL DATA,RENAL STATISTICAL DATA,INPATIENT ANCILLARY SERVICE COST APPORTIONMENT,APPORTIONMENT OF INPATIENT/OUTPATIENT ANCILLARY SERVICE OTHER PASS THROUGH COSTS,HOSPITAL WAGE INDEX DATA,COST ALLOCATION,HOSPITAL IDENTIFICATION INFORMATION,BALANCE SHEET,APPORTIONMENT OF MEDICAL AND OTHER HEALTH SERVICES,ALLOCATION OF NEW CAPITAL COSTS,APPORTIONMENT OF INPATIENT/OUTPATIENT ANCILLARY SERVICE OTHER PASS THROUGH COSTS,ANALYSIS OF CHANGES IN NEW CAPITAL BALANCES,Total Inpatient Days/Outpatient Visits,TRIAL BALANCE OF EXPENSE ACCOUNTS,TRIAL BALANCE OF EXPENSE ACCOUNTS,APPORTIONMENT OF INPATIENT/OUTPATIENT ANCILLARY SERVICE OTHER PASS THROUGH COSTS,ALLOCATION OF NEW CAPITAL COSTS,HOSPITAL WAGE INDEX DATA,APPORTIONMENT OF INPATIENT/OUTPATIENT ANCILLARY SERVICE OTHER PASS THROUGH COSTS,COMPUTATION OF INPATIENT OPERATING COSTS,,HHA STATISTICAL DATA,COST ALLOCATION,INPATIENT ANCILLARY SERVICE COST APPORTIONMENT,HOSPITAL WAGE INDEX DATA,RECONCILIATION OF CAPITAL COST CENTERS,HOSPITAL WAGE INDEX DATA,COST ALLOCATION,INPATIENT ANCILLARY SERVICE COST APPORTIONMENT,INPATIENT ANCILLARY SERVICE COST APPORTIONMENT,APPORTIONMENT OF INPATIENT/OUTPATIENT ANCILLARY SERVICE OTHER PASS THROUGH COSTS,TRIAL BALANCE OF EXPENSE ACCOUNTS,COMPUTATION OF RATIO OF COST TO CHARGES,TRIAL BALANCE OF EXPENSE ACCOUNTS,HOSPITAL WAGE INDEX DATA,ANALYSIS OF CHANGES IN NEW CAPITAL BALANCES,Medicare Inpatient Days/Outpatient Visits,APPORTIONMENT OF INPATIENT/OUTPATIENT ANCILLARY SERVICE OTHER PASS THROUGH COSTS,APPORTIONMENT OF INPATIENT/OUTPATIENT ANCILLARY SERVICE OTHER PASS THROUGH COSTS,APPORTIONMENT OF INPATIENT/OUTPATIENT ANCILLARY SERVICE OTHER PASS THROUGH COSTS,INPATIENT ANCILLARY SERVICE COST APPORTIONMENT,APPORTIONMENT OF INPATIENT/OUTPATIENT ANCILLARY SERVICE OTHER PASS THROUGH COSTS,COST ALLOCATION,TRIAL BALANCE OF EXPENSE ACCOUNTS,INPATIENT ANCILLARY SERVICE COST APPORTIONMENT,HOSPITAL WAGE INDEX DATA,APPORTIONMENT OF INPATIENT/OUTPATIENT ANCILLARY SERVICE OTHER PASS THROUGH COSTS,ANALYSIS OF CHANGES IN NEW CAPITAL BALANCES,APPORTIONMENT OF MEDICAL AND OTHER HEALTH SERVICES,RENAL STATISTICAL DATA,APPORTIONMENT OF MEDICAL AND OTHER HEALTH SERVICES,APPORTIONMENT OF MEDICAL AND OTHER HEALTH SERVICES,COMPUTATION OF RATIO OF COST TO CHARGES,ANALYSIS OF CHANGES IN NEW CAPITAL BALANCES,COST ALLOCATION,APPORTIONMENT OF MEDICAL AND OTHER HEALTH SERVICES,HOSPITAL WAGE INDEX DATA,APPORTIONMENT OF INPATIENT/OUTPATIENT ANCILLARY SERVICE OTHER PASS THROUGH COSTS,APPORTIONMENT OF INPATIENT/OUTPATIENT ANCILLARY SERVICE OTHER PASS THROUGH COSTS,STATEMENT OF REVENUES AND EXPENSES,RENAL STATISTICAL DATA,COST ALLOCATION,TRIAL BALANCE OF EXPENSE ACCOUNTS,APPORTIONMENT OF INPATIENT/OUTPATIENT ANCILLARY SERVICE OTHER PASS THROUGH COSTS,HOSPITAL WAGE INDEX DATA,Medicare Inpatient Days/Outpatient Visits,HOSPITAL WAGE INDEX DATA,COST ALLOCATION,TRIAL BALANCE OF EXPENSE ACCOUNTS,COST ALLOCATION,HOSPITAL WAGE INDEX DATA,APPORTIONMENT OF INPATIENT/OUTPATIENT ANCILLARY SERVICE OTHER PASS THROUGH COSTS,HOSPITAL WAGE INDEX DATA,TRIAL BALANCE OF EXPENSE ACCOUNTS,APPORTIONMENT OF INPATIENT/OUTPATIENT ANCILLARY SERVICE OTHER PASS THROUGH COSTS,INPATIENT ANCILLARY SERVICE COST APPORTIONMENT,INPATIENT ANCILLARY SERVICE COST APPORTIONMENT,INPATIENT ANCILLARY SERVICE COST APPORTIONMENT,TRIAL BALANCE OF EXPENSE ACCOUNTS,COST ALLOCATION,CALCULATION OF REIMBURSEMENT SETTLEMENT,CALCULATION OF REIMBURSEMENT SETTLEMENT,HHA STATISTICAL DATA,APPORTIONMENT OF INPATIENT/OUTPATIENT ANCILLARY SERVICE OTHER PASS THROUGH COSTS,APPORTIONMENT OF MEDICAL AND OTHER HEALTH SERVICES,HOSPITAL WAGE INDEX DATA,ANALYSIS OF CHANGES IN NEW CAPITAL BALANCES,,COST ALLOCATION,HOSPITAL IDENTIFICATION INFORMATION,APPORTIONMENT OF MEDICAL AND OTHER HEALTH SERVICES,CALCULATION OF REIMBURSEMENT SETTLEMENT,APPORTIONMENT OF MEDICAL AND OTHER HEALTH SERVICES,HOSPITAL WAGE INDEX DATA,APPORTIONMENT OF MEDICAL AND OTHER HEALTH SERVICES,Total Inpatient Days/Outpatient Visits,COST ALLOCATION,HOSPITAL WAGE INDEX DATA,COMPUTATION OF RATIO OF COST TO CHARGES,,TRIAL BALANCE OF EXPENSE ACCOUNTS,Medicaid Inpatient Days/Outpatient Visits,HOSPITAL WAGE INDEX DATA,S-10 DATA,ANALYSIS OF CHANGES IN NEW CAPITAL BALANCES,APPORTIONMENT OF INPATIENT/OUTPATIENT ANCILLARY SERVICE OTHER PASS THROUGH COSTS,CALCULATION OF REIMBURSEMENT SETTLEMENT,APPORTIONMENT OF INPATIENT/OUTPATIENT ANCILLARY SERVICE OTHER PASS THROUGH COSTS,COMPUTATION OF RATIO OF COST TO CHARGES,APPORTIONMENT OF MEDICAL AND OTHER HEALTH SERVICES,ANALYSIS OF CHANGES IN NEW CAPITAL BALANCES,INPATIENT ANCILLARY SERVICE COST APPORTIONMENT,Total Inpatient Days/Outpatient Visits,COMPUTATION OF INPATIENT OPERATING COSTS,APPORTIONMENT OF MEDICAL AND OTHER HEALTH SERVICES,COMPUTATION OF RATIO OF COST TO CHARGES,TRIAL BALANCE OF EXPENSE ACCOUNTS,APPORTIONMENT OF MEDICAL AND OTHER HEALTH SERVICES,CALCULATION OF REIMBURSEMENT SETTLEMENT,APPORTIONMENT OF MEDICAL AND OTHER HEALTH SERVICES,CALCULATION OF REIMBURSEMENT SETTLEMENT (PPS),INPATIENT ANCILLARY SERVICE COST APPORTIONMENT,HHA STATISTICAL DATA,TRIAL BALANCE OF EXPENSE ACCOUNTS,INPATIENT ANCILLARY SERVICE COST APPORTIONMENT,APPORTIONMENT OF MEDICAL AND OTHER HEALTH SERVICES,APPORTIONMENT OF INPATIENT/OUTPATIENT ANCILLARY SERVICE OTHER PASS THROUGH COSTS,HHA STATISTICAL DATA,INPATIENT ANCILLARY SERVICE COST APPORTIONMENT,,S-10 DATA,,COST ALLOCATION,COMPUTATION OF RATIO OF COST TO CHARGES,APPORTIONMENT OF INPATIENT/OUTPATIENT ANCILLARY SERVICE OTHER PASS THROUGH COSTS,,HOSPITAL WAGE INDEX DATA,TRIAL BALANCE OF EXPENSE ACCOUNTS,INPATIENT ANCILLARY SERVICE COST APPORTIONMENT,TRIAL BALANCE OF EXPENSE ACCOUNTS,TRIAL BALANCE OF EXPENSE ACCOUNTS,COMPUTATION OF INPATIENT OPERATING COSTS,COMPUTATION OF RATIO OF COST TO CHARGES,INPATIENT ANCILLARY SERVICE COST APPORTIONMENT,COMPUTATION OF RATIO OF COST TO CHARGES,,,APPORTIONMENT OF INPATIENT/OUTPATIENT ANCILLARY SERVICE OTHER PASS THROUGH COSTS,APPORTIONMENT OF MEDICAL AND OTHER HEALTH SERVICES,TRIAL BALANCE OF EXPENSE ACCOUNTS,COST ALLOCATION,COMPUTATION OF RATIO OF COST TO CHARGES,APPORTIONMENT OF MEDICAL AND OTHER HEALTH SERVICES,HOSPITAL WAGE INDEX DATA,COST ALLOCATION,HOSPITAL IDENTIFICATION INFORMATION,APPORTIONMENT OF INPATIENT/OUTPATIENT ANCILLARY SERVICE OTHER PASS THROUGH COSTS,INPATIENT ANCILLARY SERVICE COST APPORTIONMENT,COMPUTATION OF RATIO OF COST TO CHARGES,CALCULATION OF REIMBURSEMENT SETTLEMENT,STATEMENT OF REVENUES AND EXPENSES,TRIAL BALANCE OF EXPENSE ACCOUNTS,COMPUTATION OF RATIO OF COST TO CHARGES,APPORTIONMENT OF INPATIENT ROUTINE SERVICE CAPITAL COSTS,CALCULATION OF REIMBURSEMENT SETTLEMENT,HHA STATISTICAL DATA,CALCULATION OF REIMBURSEMENT SETTLEMENT,Total Inpatient Days/Outpatient Visits,APPORTIONMENT OF INPATIENT/OUTPATIENT ANCILLARY SERVICE OTHER PASS THROUGH COSTS,APPORTIONMENT OF INPATIENT/OUTPATIENT ANCILLARY SERVICE OTHER PASS THROUGH COSTS,TRIAL BALANCE OF EXPENSE ACCOUNTS,,TRIAL BALANCE OF EXPENSE ACCOUNTS,APPORTIONMENT OF INPATIENT/OUTPATIENT ANCILLARY SERVICE OTHER PASS THROUGH COSTS,COMPUTATION OF RATIO OF COST TO CHARGES,APPORTIONMENT OF INPATIENT/OUTPATIENT ANCILLARY SERVICE OTHER PASS THROUGH COSTS,COST ALLOCATION,,APPORTIONMENT OF INPATIENT/OUTPATIENT ANCILLARY SERVICE OTHER PASS THROUGH COSTS,COMPUTATION OF RATIO OF COST TO CHARGES,ANALYSIS OF CHANGES IN NEW CAPITAL BALANCES,COMPUTATION OF RATIO OF COST TO CHARGES,ADJUSTMENTS,COMPUTATION OF RATIO OF COST TO CHARGES,INPATIENT ANCILLARY SERVICE COST APPORTIONMENT,CALCULATION OF REIMBURSEMENT SETTLEMENT,APPORTIONMENT OF INPATIENT ROUTINE SERVICE OTHER PASS THROUGH COSTS,COMPUTATION OF RATIO OF COST TO CHARGES,APPORTIONMENT OF INPATIENT ROUTINE SERVICE CAPITAL COSTS,INPATIENT ANCILLARY SERVICE COST APPORTIONMENT,INPATIENT ANCILLARY SERVICE COST APPORTIONMENT,ALLOCATION OF NEW CAPITAL COSTS,NUMBER OF BEDS,COMPUTATION OF RATIO OF COST TO CHARGES,BALANCE SHEET,COST ALLOCATION,APPORTIONMENT OF INPATIENT/OUTPATIENT ANCILLARY SERVICE OTHER PASS THROUGH COSTS,INPATIENT ANCILLARY SERVICE COST APPORTIONMENT,,TRIAL BALANCE OF EXPENSE ACCOUNTS,ANALYSIS OF CHANGES IN NEW CAPITAL BALANCES,S-10 DATA,RECONCILIATION OF CAPITAL COST CENTERS,APPORTIONMENT OF MEDICAL AND OTHER HEALTH SERVICES,,INPATIENT ANCILLARY SERVICE COST APPORTIONMENT,TRIAL BALANCE OF EXPENSE ACCOUNTS,APPORTIONMENT OF MEDICAL AND OTHER HEALTH SERVICES,COMPUTATION OF RATIO OF COST TO CHARGES,COMPUTATION OF RATIO OF COST TO CHARGES,RENAL STATISTICAL DATA,BED DAYS AVAILABLE,Total Inpatient Days/Outpatient Visits,ANALYSIS OF CHANGES IN NEW CAPITAL BALANCES,APPORTIONMENT OF INPATIENT/OUTPATIENT ANCILLARY SERVICE OTHER PASS THROUGH COSTS,ADJUSTMENTS,ALLOCATION OF NEW CAPITAL COSTS,APPORTIONMENT OF INPATIENT/OUTPATIENT ANCILLARY SERVICE OTHER PASS THROUGH COSTS,HOSPITAL WAGE INDEX DATA,COST ALLOCATION,APPORTIONMENT OF MEDICAL AND OTHER HEALTH SERVICES,APPORTIONMENT OF INPATIENT/OUTPATIENT ANCILLARY SERVICE OTHER PASS THROUGH COSTS,ADJUSTMENTS,COMPUTATION OF RATIO OF COST TO CHARGES,INPATIENT ANCILLARY SERVICE COST APPORTIONMENT,CALCULATION OF REIMBURSEMENT SETTLEMENT,APPORTIONMENT OF MEDICAL AND OTHER HEALTH SERVICES,RECONCILIATION OF CAPITAL COST CENTERS,,APPORTIONMENT OF INPATIENT/OUTPATIENT ANCILLARY SERVICE OTHER PASS THROUGH COSTS,COST ALLOCATION,HOSPITAL WAGE INDEX DATA,BED DAYS AVAILABLE,APPORTIONMENT OF INPATIENT/OUTPATIENT ANCILLARY SERVICE OTHER PASS THROUGH COSTS,APPORTIONMENT OF INPATIENT/OUTPATIENT ANCILLARY SERVICE OTHER PASS THROUGH COSTS,APPORTIONMENT OF INPATIENT/OUTPATIENT ANCILLARY SERVICE OTHER PASS THROUGH COSTS,HOSPITAL WAGE INDEX DATA,CALCULATION OF REIMBURSEMENT SETTLEMENT,S-10 DATA,APPORTIONMENT OF MEDICAL AND OTHER HEALTH SERVICES,APPORTIONMENT OF INPATIENT/OUTPATIENT ANCILLARY SERVICE OTHER PASS THROUGH COSTS,ANALYSIS OF CHANGES IN NEW CAPITAL BALANCES,APPORTIONMENT OF INPATIENT/OUTPATIENT ANCILLARY SERVICE OTHER PASS THROUGH COSTS,HOSPITAL WAGE INDEX DATA,INPATIENT ANCILLARY SERVICE COST APPORTIONMENT,COST ALLOCATION,APPORTIONMENT OF INPATIENT/OUTPATIENT ANCILLARY SERVICE OTHER PASS THROUGH COSTS,HOSPITAL WAGE INDEX DATA,TRIAL BALANCE OF EXPENSE ACCOUNTS,APPORTIONMENT OF INPATIENT/OUTPATIENT ANCILLARY SERVICE OTHER PASS THROUGH COSTS,Medicaid Inpatient Days/Outpatient Visits,APPORTIONMENT OF INPATIENT/OUTPATIENT ANCILLARY SERVICE OTHER PASS THROUGH COSTS,COMPUTATION OF INPATIENT OPERATING COSTS,HOSPITAL WAGE INDEX DATA,APPORTIONMENT OF MEDICAL AND OTHER HEALTH SERVICES,COMPUTATION OF RATIO OF COST TO CHARGES,COMPUTATION OF RATIO OF COST TO CHARGES,ALLOCATION OF NEW CAPITAL COSTS,INPATIENT ANCILLARY SERVICE COST APPORTIONMENT,TRIAL BALANCE OF EXPENSE ACCOUNTS,ADJUSTMENTS,ALLOCATION OF NEW CAPITAL COSTS,Medicaid Inpatient Days/Outpatient Visits,COMPUTATION OF RATIO OF COST TO CHARGES,COMPUTATION OF RATIO OF COST TO CHARGES,COST ALLOCATION,APPORTIONMENT OF MEDICAL AND OTHER HEALTH SERVICES,ALLOCATION OF NEW CAPITAL COSTS,CALCULATION OF REIMBURSEMENT SETTLEMENT,S-10 DATA,HOSPITAL WAGE INDEX DATA,APPORTIONMENT OF INPATIENT/OUTPATIENT ANCILLARY SERVICE OTHER PASS THROUGH COSTS,APPORTIONMENT OF INPATIENT/OUTPATIENT ANCILLARY SERVICE OTHER PASS THROUGH COSTS,INPATIENT ANCILLARY SERVICE COST APPORTIONMENT,TRIAL BALANCE OF EXPENSE ACCOUNTS,APPORTIONMENT OF INPATIENT/OUTPATIENT ANCILLARY SERVICE OTHER PASS THROUGH COSTS,COST ALLOCATION,INPATIENT ANCILLARY SERVICE COST APPORTIONMENT,APPORTIONMENT OF MEDICAL AND OTHER HEALTH SERVICES,ALLOCATION OF NEW CAPITAL COSTS,INPATIENT ANCILLARY SERVICE COST APPORTIONMENT,TRIAL BALANCE OF EXPENSE ACCOUNTS,TRIAL BALANCE OF EXPENSE ACCOUNTS,Total Inpatient Days/Outpatient Visits,APPORTIONMENT OF INPATIENT/OUTPATIENT ANCILLARY SERVICE OTHER PASS THROUGH COSTS,COST ALLOCATION,APPORTIONMENT OF MEDICAL AND OTHER HEALTH SERVICES,APPORTIONMENT OF MEDICAL AND OTHER HEALTH SERVICES,BED DAYS AVAILABLE,HOSPITAL WAGE INDEX DATA,TRIAL BALANCE OF EXPENSE ACCOUNTS,APPORTIONMENT OF INPATIENT/OUTPATIENT ANCILLARY SERVICE OTHER PASS THROUGH COSTS,APPORTIONMENT OF INPATIENT/OUTPATIENT ANCILLARY SERVICE OTHER PASS THROUGH COSTS,APPORTIONMENT OF INPATIENT/OUTPATIENT ANCILLARY SERVICE OTHER PASS THROUGH COSTS,NUMBER OF BEDS,RENAL STATISTICAL DATA,COMPUTATION OF INPATIENT OPERATING COSTS,RENAL STATISTICAL DATA,RECONCILIATION OF CAPITAL COST CENTERS,INPATIENT ANCILLARY SERVICE COST APPORTIONMENT,COST ALLOCATION,RENAL STATISTICAL DATA,S-10 DATA,APPORTIONMENT OF MEDICAL AND OTHER HEALTH SERVICES,COST ALLOCATION,,HOSPITAL WAGE INDEX DATA,APPORTIONMENT OF INPATIENT/OUTPATIENT ANCILLARY SERVICE OTHER PASS THROUGH COSTS,APPORTIONMENT OF MEDICAL AND OTHER HEALTH SERVICES,HOSPITAL WAGE INDEX DATA,COMPUTATION OF RATIO OF COST TO CHARGES,APPORTIONMENT OF INPATIENT/OUTPATIENT ANCILLARY SERVICE OTHER PASS THROUGH COSTS,HOSPITAL WAGE INDEX DATA,APPORTIONMENT OF INPATIENT/OUTPATIENT ANCILLARY SERVICE OTHER PASS THROUGH COSTS,INPATIENT ANCILLARY SERVICE COST APPORTIONMENT,HOSPITAL WAGE INDEX DATA,HOSPITAL WAGE INDEX DATA,APPORTIONMENT OF INPATIENT/OUTPATIENT ANCILLARY SERVICE OTHER PASS THROUGH COSTS,COST ALLOCATION,INPATIENT ANCILLARY SERVICE COST APPORTIONMENT,ALLOCATION OF NEW CAPITAL COSTS,COST ALLOCATION,APPORTIONMENT OF INPATIENT/OUTPATIENT ANCILLARY SERVICE OTHER PASS THROUGH COSTS,COMPUTATION OF RATIO OF COST TO CHARGES,INPATIENT ANCILLARY SERVICE COST APPORTIONMENT,TRIAL BALANCE OF EXPENSE ACCOUNTS,TRIAL BALANCE OF EXPENSE ACCOUNTS,APPORTIONMENT OF INPATIENT/OUTPATIENT ANCILLARY SERVICE OTHER PASS THROUGH COSTS,INPATIENT ANCILLARY SERVICE COST APPORTIONMENT,TRIAL BALANCE OF EXPENSE ACCOUNTS,TRIAL BALANCE OF EXPENSE ACCOUNTS,APPORTIONMENT OF INPATIENT/OUTPATIENT ANCILLARY SERVICE OTHER PASS THROUGH COSTS,,RENAL STATISTICAL DATA,HHA STATISTICAL DATA,COMPUTATION OF RATIO OF COST TO CHARGES,APPORTIONMENT OF INPATIENT/OUTPATIENT ANCILLARY SERVICE OTHER PASS THROUGH COSTS,COMPUTATION OF INPATIENT OPERATING COSTS,INPATIENT ANCILLARY SERVICE COST APPORTIONMENT,CALCULATION OF REIMBURSEMENT SETTLEMENT,TRIAL BALANCE OF EXPENSE ACCOUNTS,Total Inpatient Days/Outpatient Visits,BALANCE SHEET,S-10 DATA,TRIAL BALANCE OF EXPENSE ACCOUNTS,APPORTIONMENT OF MEDICAL AND OTHER HEALTH SERVICES,TRIAL BALANCE OF EXPENSE ACCOUNTS,HOSPITAL WAGE INDEX DATA,HHA STATISTICAL DATA,HHA STATISTICAL DATA,RENAL STATISTICAL DATA,APPORTIONMENT OF INPATIENT/OUTPATIENT ANCILLARY SERVICE OTHER PASS THROUGH COSTS,COST ALLOCATION,APPORTIONMENT OF MEDICAL AND OTHER HEALTH SERVICES,TRIAL BALANCE OF EXPENSE ACCOUNTS,APPORTIONMENT OF MEDICAL AND OTHER HEALTH SERVICES,TRIAL BALANCE OF EXPENSE ACCOUNTS,,TRIAL BALANCE OF EXPENSE ACCOUNTS,COMPUTATION OF RATIO OF COST TO CHARGES,APPORTIONMENT OF INPATIENT/OUTPATIENT ANCILLARY SERVICE OTHER PASS THROUGH COSTS,APPORTIONMENT OF INPATIENT/OUTPATIENT ANCILLARY SERVICE OTHER PASS THROUGH COSTS,APPORTIONMENT OF INPATIENT/OUTPATIENT ANCILLARY SERVICE OTHER PASS THROUGH COSTS,COMPUTATION OF RATIO OF COST TO CHARGES,TRIAL BALANCE OF EXPENSE ACCOUNTS,APPORTIONMENT OF MEDICAL AND OTHER HEALTH SERVICES,APPORTIONMENT OF INPATIENT/OUTPATIENT ANCILLARY SERVICE OTHER PASS THROUGH COSTS,COST ALLOCATION,COMPUTATION OF RATIO OF COST TO CHARGES,BED DAYS AVAILABLE,INPATIENT ANCILLARY SERVICE COST APPORTIONMENT,INPATIENT ANCILLARY SERVICE COST APPORTIONMENT,APPORTIONMENT OF INPATIENT ROUTINE SERVICE OTHER PASS THROUGH COSTS,ALLOCATION OF NEW CAPITAL COSTS,RENAL STATISTICAL DATA,APPORTIONMENT OF INPATIENT/OUTPATIENT ANCILLARY SERVICE OTHER PASS THROUGH COSTS,INPATIENT ANCILLARY SERVICE COST APPORTIONMENT,,CALCULATION OF REIMBURSEMENT SETTLEMENT,HOSPITAL WAGE INDEX DATA,INPATIENT ANCILLARY SERVICE COST APPORTIONMENT,COST ALLOCATION,BED DAYS AVAILABLE,S-10 DATA,ADJUSTMENTS,APPORTIONMENT OF INPATIENT/OUTPATIENT ANCILLARY SERVICE OTHER PASS THROUGH COSTS,COST ALLOCATION,,HOSPITAL WAGE INDEX DATA,TRIAL BALANCE OF EXPENSE ACCOUNTS,APPORTIONMENT OF MEDICAL AND OTHER HEALTH SERVICES,STATEMENT OF REVENUES AND EXPENSES,COST ALLOCATION,S-10 DATA,INPATIENT ANCILLARY SERVICE COST APPORTIONMENT,COST ALLOCATION,COMPUTATION OF RATIO OF COST TO CHARGES,HOSPITAL IDENTIFICATION INFORMATION,,HOSPITAL WAGE INDEX DATA,TRIAL BALANCE OF EXPENSE ACCOUNTS,COMPUTATION OF INPATIENT OPERATING COSTS,INPATIENT ANCILLARY SERVICE COST APPORTIONMENT,,COMPUTATION OF INPATIENT OPERATING COSTS,INPATIENT ANCILLARY SERVICE COST APPORTIONMENT,HOSPITAL WAGE INDEX DATA,HOSPITAL WAGE INDEX DATA,COMPUTATION OF RATIO OF COST TO CHARGES,TRIAL BALANCE OF EXPENSE ACCOUNTS,INPATIENT ANCILLARY SERVICE COST APPORTIONMENT,COMPUTATION OF RATIO OF COST TO CHARGES,INPATIENT ANCILLARY SERVICE COST APPORTIONMENT,APPORTIONMENT OF INPATIENT/OUTPATIENT ANCILLARY SERVICE OTHER PASS THROUGH COSTS,COMPUTATION OF INPATIENT OPERATING COSTS,TRIAL BALANCE OF EXPENSE ACCOUNTS,COST ALLOCATION,TRIAL BALANCE OF EXPENSE ACCOUNTS,ALLOCATION OF NEW CAPITAL COSTS,APPORTIONMENT OF INPATIENT/OUTPATIENT ANCILLARY SERVICE OTHER PASS THROUGH COSTS,COST ALLOCATION,TRIAL BALANCE OF EXPENSE ACCOUNTS,,APPORTIONMENT OF INPATIENT ROUTINE SERVICE OTHER PASS THROUGH COSTS,INPATIENT ANCILLARY SERVICE COST APPORTIONMENT,CALCULATION OF REIMBURSEMENT SETTLEMENT,Total Inpatient Days/Outpatient Visits,APPORTIONMENT OF INPATIENT/OUTPATIENT ANCILLARY SERVICE OTHER PASS THROUGH COSTS,COST ALLOCATION,ADJUSTMENTS,RECONCILIATION OF CAPITAL COST CENTERS,,Medicaid Inpatient Days/Outpatient Visits,APPORTIONMENT OF INPATIENT/OUTPATIENT ANCILLARY SERVICE OTHER PASS THROUGH COSTS,COMPUTATION OF RATIO OF COST TO CHARGES,HHA STATISTICAL DATA,APPORTIONMENT OF MEDICAL AND OTHER HEALTH SERVICES,CALCULATION OF REIMBURSEMENT SETTLEMENT,INPATIENT ANCILLARY SERVICE COST APPORTIONMENT,APPORTIONMENT OF INPATIENT/OUTPATIENT ANCILLARY SERVICE OTHER PASS THROUGH COSTS,COMPUTATION OF RATIO OF COST TO CHARGES,APPORTIONMENT OF INPATIENT ROUTINE SERVICE CAPITAL COSTS,,ALLOCATION OF NEW CAPITAL COSTS,APPORTIONMENT OF INPATIENT/OUTPATIENT ANCILLARY SERVICE OTHER PASS THROUGH COSTS,COST ALLOCATION,APPORTIONMENT OF INPATIENT/OUTPATIENT ANCILLARY SERVICE OTHER PASS THROUGH COSTS,COST ALLOCATION,Medicaid Inpatient Days/Outpatient Visits,INPATIENT ANCILLARY SERVICE COST APPORTIONMENT,BED DAYS AVAILABLE,Total Inpatient Days/Outpatient Visits,COST ALLOCATION,HOSPITAL WAGE INDEX DATA,COST ALLOCATION,APPORTIONMENT OF INPATIENT/OUTPATIENT ANCILLARY SERVICE OTHER PASS THROUGH COSTS,HHA STATISTICAL DATA,COST ALLOCATION,APPORTIONMENT OF INPATIENT ROUTINE SERVICE CAPITAL COSTS,,HHA STATISTICAL DATA,APPORTIONMENT OF INPATIENT/OUTPATIENT ANCILLARY SERVICE OTHER PASS THROUGH COSTS,BALANCE SHEET,COST ALLOCATION,COST ALLOCATION,APPORTIONMENT OF INPATIENT/OUTPATIENT ANCILLARY SERVICE OTHER PASS THROUGH COSTS,TRIAL BALANCE OF EXPENSE ACCOUNTS,HOSPITAL WAGE INDEX DATA,APPORTIONMENT OF INPATIENT ROUTINE SERVICE CAPITAL COSTS,TRIAL BALANCE OF EXPENSE ACCOUNTS,TRIAL BALANCE OF EXPENSE ACCOUNTS,S-10 DATA,INPATIENT ANCILLARY SERVICE COST APPORTIONMENT,HOSPITAL WAGE INDEX DATA,BED DAYS AVAILABLE,COMPUTATION OF INPATIENT OPERATING COSTS,TRIAL BALANCE OF EXPENSE ACCOUNTS,TRIAL BALANCE OF EXPENSE ACCOUNTS,INPATIENT ANCILLARY SERVICE COST APPORTIONMENT,COST ALLOCATION,APPORTIONMENT OF INPATIENT/OUTPATIENT ANCILLARY SERVICE OTHER PASS THROUGH COSTS,COST ALLOCATION,TRIAL BALANCE OF EXPENSE ACCOUNTS,APPORTIONMENT OF INPATIENT/OUTPATIENT ANCILLARY SERVICE OTHER PASS THROUGH COSTS,INPATIENT ANCILLARY SERVICE COST APPORTIONMENT,APPORTIONMENT OF INPATIENT/OUTPATIENT ANCILLARY SERVICE OTHER PASS THROUGH COSTS,TRIAL BALANCE OF EXPENSE ACCOUNTS,ADJUSTMENTS,TRIAL BALANCE OF EXPENSE ACCOUNTS,COMPUTATION OF RATIO OF COST TO CHARGES,,HOSPITAL WAGE INDEX DATA,STATEMENT OF REVENUES AND EXPENSES,ALLOCATION OF NEW CAPITAL COSTS,CALCULATION OF REIMBURSEMENT SETTLEMENT,APPORTIONMENT OF MEDICAL AND OTHER HEALTH SERVICES,APPORTIONMENT OF MEDICAL AND OTHER HEALTH SERVICES,COST ALLOCATION,TRIAL BALANCE OF EXPENSE ACCOUNTS,HOSPITAL WAGE INDEX DATA,CALCULATION OF REIMBURSEMENT SETTLEMENT,,APPORTIONMENT OF MEDICAL AND OTHER HEALTH SERVICES,HHA STATISTICAL DATA,HOSPITAL WAGE INDEX DATA,S-10 DATA,COST ALLOCATION,HOSPITAL WAGE INDEX DATA,,COST ALLOCATION,APPORTIONMENT OF INPATIENT/OUTPATIENT ANCILLARY SERVICE OTHER PASS THROUGH COSTS,APPORTIONMENT OF INPATIENT/OUTPATIENT ANCILLARY SERVICE OTHER PASS THROUGH COSTS,APPORTIONMENT OF INPATIENT/OUTPATIENT ANCILLARY SERVICE OTHER PASS THROUGH COSTS,TRIAL BALANCE OF EXPENSE ACCOUNTS,APPORTIONMENT OF INPATIENT/OUTPATIENT ANCILLARY SERVICE OTHER PASS THROUGH COSTS,,COST ALLOCATION,Medicare Inpatient Days/Outpatient Visits,TRIAL BALANCE OF EXPENSE ACCOUNTS,TRIAL BALANCE OF EXPENSE ACCOUNTS,INPATIENT ANCILLARY SERVICE COST APPORTIONMENT,CALCULATION OF REIMBURSEMENT SETTLEMENT,,ANALYSIS OF CHANGES IN NEW CAPITAL BALANCES,APPORTIONMENT OF INPATIENT/OUTPATIENT ANCILLARY SERVICE OTHER PASS THROUGH COSTS,COMPUTATION OF RATIO OF COST TO CHARGES,RENAL STATISTICAL DATA,TRIAL BALANCE OF EXPENSE ACCOUNTS,HOSPITAL WAGE INDEX DATA,Total Inpatient Days/Outpatient Visits,Total Inpatient Days/Outpatient Visits,HHA STATISTICAL DATA,HHA STATISTICAL DATA,TRIAL BALANCE OF EXPENSE ACCOUNTS,ALLOCATION OF NEW CAPITAL COSTS,APPORTIONMENT OF MEDICAL AND OTHER HEALTH SERVICES,TRIAL BALANCE OF EXPENSE ACCOUNTS,HOSPITAL WAGE INDEX DATA,S-10 DATA,ADJUSTMENTS,APPORTIONMENT OF INPATIENT/OUTPATIENT ANCILLARY SERVICE OTHER PASS THROUGH COSTS,INPATIENT ANCILLARY SERVICE COST APPORTIONMENT,APPORTIONMENT OF INPATIENT/OUTPATIENT ANCILLARY SERVICE OTHER PASS THROUGH COSTS,INPATIENT ANCILLARY SERVICE COST APPORTIONMENT,Total Inpatient Days/Outpatient Visits,HHA STATISTICAL DATA,INPATIENT ANCILLARY SERVICE COST APPORTIONMENT,COST ALLOCATION,INPATIENT ANCILLARY SERVICE COST APPORTIONMENT,APPORTIONMENT OF MEDICAL AND OTHER HEALTH SERVICES,HHA STATISTICAL DATA,COMPUTATION OF RATIO OF COST TO CHARGES,TRIAL BALANCE OF EXPENSE ACCOUNTS,ADJUSTMENTS,,HOSPITAL WAGE INDEX DATA,ANALYSIS OF CHANGES IN NEW CAPITAL BALANCES,APPORTIONMENT OF INPATIENT/OUTPATIENT ANCILLARY SERVICE OTHER PASS THROUGH COSTS,TRIAL BALANCE OF EXPENSE ACCOUNTS,HHA STATISTICAL DATA,COST ALLOCATION,,COMPUTATION OF RATIO OF COST TO CHARGES,HOSPITAL WAGE INDEX DATA,APPORTIONMENT OF INPATIENT/OUTPATIENT ANCILLARY SERVICE OTHER PASS THROUGH COSTS,COMPUTATION OF RATIO OF COST TO CHARGES,BALANCE SHEET,BALANCE SHEET,NUMBER OF BEDS,INPATIENT ANCILLARY SERVICE COST APPORTIONMENT,COMPUTATION OF RATIO OF COST TO CHARGES,TRIAL BALANCE OF EXPENSE ACCOUNTS,TRIAL BALANCE OF EXPENSE ACCOUNTS,APPORTIONMENT OF INPATIENT/OUTPATIENT ANCILLARY SERVICE OTHER PASS THROUGH COSTS,TRIAL BALANCE OF EXPENSE ACCOUNTS,APPORTIONMENT OF INPATIENT/OUTPATIENT ANCILLARY SERVICE OTHER PASS THROUGH COSTS,,TRIAL BALANCE OF EXPENSE ACCOUNTS,RECONCILIATION OF CAPITAL COST CENTERS,,RENAL STATISTICAL DATA,TRIAL BALANCE OF EXPENSE ACCOUNTS,INPATIENT ANCILLARY SERVICE COST APPORTIONMENT,TRIAL BALANCE OF EXPENSE ACCOUNTS,INPATIENT ANCILLARY SERVICE COST APPORTIONMENT,HHA STATISTICAL DATA,APPORTIONMENT OF MEDICAL AND OTHER HEALTH SERVICES,APPORTIONMENT OF INPATIENT ROUTINE SERVICE CAPITAL COSTS,NUMBER OF BEDS,COMPUTATION OF RATIO OF COST TO CHARGES,COMPUTATION OF RATIO OF COST TO CHARGES,ANALYSIS OF CHANGES IN NEW CAPITAL BALANCES,HOSPITAL WAGE INDEX DATA,BALANCE SHEET,APPORTIONMENT OF INPATIENT/OUTPATIENT ANCILLARY SERVICE OTHER PASS THROUGH COSTS,COMPUTATION OF RATIO OF COST TO CHARGES,COST ALLOCATION,ADJUSTMENTS,RENAL STATISTICAL DATA,TRIAL BALANCE OF EXPENSE ACCOUNTS,TRIAL BALANCE OF EXPENSE ACCOUNTS,APPORTIONMENT OF MEDICAL AND OTHER HEALTH SERVICES,,HOSPITAL IDENTIFICATION INFORMATION,,APPORTIONMENT OF MEDICAL AND OTHER HEALTH SERVICES,APPORTIONMENT OF MEDICAL AND OTHER HEALTH SERVICES,COST ALLOCATION,INPATIENT ANCILLARY SERVICE COST APPORTIONMENT,APPORTIONMENT OF INPATIENT/OUTPATIENT ANCILLARY SERVICE OTHER PASS THROUGH COSTS,TRIAL BALANCE OF EXPENSE ACCOUNTS,BED DAYS AVAILABLE,COST ALLOCATION,COST ALLOCATION,HHA STATISTICAL DATA,INPATIENT ANCILLARY SERVICE COST APPORTIONMENT,,ALLOCATION OF NEW CAPITAL COSTS,INPATIENT ANCILLARY SERVICE COST APPORTIONMENT,INPATIENT ANCILLARY SERVICE COST APPORTIONMENT,TRIAL BALANCE OF EXPENSE ACCOUNTS,INPATIENT ANCILLARY SERVICE COST APPORTIONMENT,INPATIENT ANCILLARY SERVICE COST APPORTIONMENT,INPATIENT ANCILLARY SERVICE COST APPORTIONMENT,HHA STATISTICAL DATA,APPORTIONMENT OF MEDICAL AND OTHER HEALTH SERVICES,HOSPITAL WAGE INDEX DATA,,COST ALLOCATION,TRIAL BALANCE OF EXPENSE ACCOUNTS,HOSPITAL WAGE INDEX DATA,INPATIENT ANCILLARY SERVICE COST APPORTIONMENT,COMPUTATION OF INPATIENT OPERATING COSTS,BED DAYS AVAILABLE,ALLOCATION OF NEW CAPITAL COSTS,APPORTIONMENT OF INPATIENT/OUTPATIENT ANCILLARY SERVICE OTHER PASS THROUGH COSTS,APPORTIONMENT OF INPATIENT/OUTPATIENT ANCILLARY SERVICE OTHER PASS THROUGH COSTS,INPATIENT ANCILLARY SERVICE COST APPORTIONMENT,,HOSPITAL WAGE INDEX DATA,COST ALLOCATION,BED DAYS AVAILABLE,TRIAL BALANCE OF EXPENSE ACCOUNTS,COST ALLOCATION,COMPUTATION OF RATIO OF COST TO CHARGES,APPORTIONMENT OF INPATIENT ROUTINE SERVICE CAPITAL COSTS,APPORTIONMENT OF INPATIENT/OUTPATIENT ANCILLARY SERVICE OTHER PASS THROUGH COSTS,COMPUTATION OF INPATIENT OPERATING COSTS,APPORTIONMENT OF INPATIENT/OUTPATIENT ANCILLARY SERVICE OTHER PASS THROUGH COSTS,TRIAL BALANCE OF EXPENSE ACCOUNTS,APPORTIONMENT OF INPATIENT/OUTPATIENT ANCILLARY SERVICE OTHER PASS THROUGH COSTS,APPORTIONMENT OF INPATIENT/OUTPATIENT ANCILLARY SERVICE OTHER PASS THROUGH COSTS,COMPUTATION OF RATIO OF COST TO CHARGES,HOSPITAL WAGE INDEX DATA,COST ALLOCATION,COMPUTATION OF INPATIENT OPERATING COSTS,TRIAL BALANCE OF EXPENSE ACCOUNTS,INPATIENT ANCILLARY SERVICE COST APPORTIONMENT,APPORTIONMENT OF INPATIENT/OUTPATIENT ANCILLARY SERVICE OTHER PASS THROUGH COSTS,APPORTIONMENT OF INPATIENT/OUTPATIENT ANCILLARY SERVICE OTHER PASS THROUGH COSTS,INPATIENT ANCILLARY SERVICE COST APPORTIONMENT,COST ALLOCATION,INPATIENT ANCILLARY SERVICE COST APPORTIONMENT,INPATIENT ANCILLARY SERVICE COST APPORTIONMENT,COST ALLOCATION,COMPUTATION OF RATIO OF COST TO CHARGES,INPATIENT ANCILLARY SERVICE COST APPORTIONMENT,ALLOCATION OF NEW CAPITAL COSTS,,TRIAL BALANCE OF EXPENSE ACCOUNTS,ALLOCATION OF NEW CAPITAL COSTS,Total Inpatient Days/Outpatient Visits,COST ALLOCATION,HHA STATISTICAL DATA,,TRIAL BALANCE OF EXPENSE ACCOUNTS,APPORTIONMENT OF MEDICAL AND OTHER HEALTH SERVICES,CALCULATION OF REIMBURSEMENT SETTLEMENT,APPORTIONMENT OF INPATIENT/OUTPATIENT ANCILLARY SERVICE OTHER PASS THROUGH COSTS,COMPUTATION OF RATIO OF COST TO CHARGES,RENAL STATISTICAL DATA,HOSPITAL WAGE INDEX DATA,APPORTIONMENT OF INPATIENT/OUTPATIENT ANCILLARY SERVICE OTHER PASS THROUGH COSTS,NUMBER OF BEDS,APPORTIONMENT OF INPATIENT ROUTINE SERVICE OTHER PASS THROUGH COSTS,Medicare Inpatient Days/Outpatient Visits,COST ALLOCATION,APPORTIONMENT OF INPATIENT/OUTPATIENT ANCILLARY SERVICE OTHER PASS THROUGH COSTS,COST ALLOCATION,TRIAL BALANCE OF EXPENSE ACCOUNTS,ALLOCATION OF NEW CAPITAL COSTS,HHA STATISTICAL DATA,APPORTIONMENT OF INPATIENT/OUTPATIENT ANCILLARY SERVICE OTHER PASS THROUGH COSTS,INPATIENT ANCILLARY SERVICE COST APPORTIONMENT,STATEMENT OF REVENUES AND EXPENSES,CALCULATION OF REIMBURSEMENT SETTLEMENT,COMPUTATION OF RATIO OF COST TO CHARGES,INPATIENT ANCILLARY SERVICE COST APPORTIONMENT,APPORTIONMENT OF INPATIENT/OUTPATIENT ANCILLARY SERVICE OTHER PASS THROUGH COSTS,TRIAL BALANCE OF EXPENSE ACCOUNTS,HHA STATISTICAL DATA,TRIAL BALANCE OF EXPENSE ACCOUNTS,COST ALLOCATION,COST ALLOCATION,HOSPITAL WAGE INDEX DATA,INPATIENT ANCILLARY SERVICE COST APPORTIONMENT,CALCULATION OF REIMBURSEMENT SETTLEMENT,APPORTIONMENT OF INPATIENT/OUTPATIENT ANCILLARY SERVICE OTHER PASS THROUGH COSTS,COST ALLOCATION,NUMBER OF BEDS,RENAL STATISTICAL DATA,HOSPITAL WAGE INDEX DATA,TRIAL BALANCE OF EXPENSE ACCOUNTS,HOSPITAL WAGE INDEX DATA,HHA STATISTICAL DATA,TRIAL BALANCE OF EXPENSE ACCOUNTS,HHA STATISTICAL DATA,APPORTIONMENT OF INPATIENT/OUTPATIENT ANCILLARY SERVICE OTHER PASS THROUGH COSTS,APPORTIONMENT OF INPATIENT/OUTPATIENT ANCILLARY SERVICE OTHER PASS THROUGH COSTS,CALCULATION OF REIMBURSEMENT SETTLEMENT,ALLOCATION OF NEW CAPITAL COSTS,APPORTIONMENT OF MEDICAL AND OTHER HEALTH SERVICES,INPATIENT ANCILLARY SERVICE COST APPORTIONMENT,COMPUTATION OF RATIO OF COST TO CHARGES,APPORTIONMENT OF INPATIENT/OUTPATIENT ANCILLARY SERVICE OTHER PASS THROUGH COSTS,INPATIENT ANCILLARY SERVICE COST APPORTIONMENT,HOSPITAL WAGE INDEX DATA,COST ALLOCATION,COMPUTATION OF RATIO OF COST TO CHARGES,APPORTIONMENT OF INPATIENT/OUTPATIENT ANCILLARY SERVICE OTHER PASS THROUGH COSTS,COMPUTATION OF INPATIENT OPERATING COSTS,HOSPITAL WAGE INDEX DATA,HOSPITAL WAGE INDEX DATA,ALLOCATION OF NEW CAPITAL COSTS,ALLOCATION OF NEW CAPITAL COSTS,APPORTIONMENT OF MEDICAL AND OTHER HEALTH SERVICES,TRIAL BALANCE OF EXPENSE ACCOUNTS,TRIAL BALANCE OF EXPENSE ACCOUNTS,INPATIENT ANCILLARY SERVICE COST APPORTIONMENT,ALLOCATION OF NEW CAPITAL COSTS,TRIAL BALANCE OF EXPENSE ACCOUNTS,COMPUTATION OF RATIO OF COST TO CHARGES,COMPUTATION OF RATIO OF COST TO CHARGES,TRIAL BALANCE OF EXPENSE ACCOUNTS,APPORTIONMENT OF INPATIENT/OUTPATIENT ANCILLARY SERVICE OTHER PASS THROUGH COSTS,APPORTIONMENT OF INPATIENT/OUTPATIENT ANCILLARY SERVICE OTHER PASS THROUGH COSTS,APPORTIONMENT OF INPATIENT/OUTPATIENT ANCILLARY SERVICE OTHER PASS THROUGH COSTS,APPORTIONMENT OF INPATIENT/OUTPATIENT ANCILLARY SERVICE OTHER PASS THROUGH COSTS,,TRIAL BALANCE OF EXPENSE ACCOUNTS,TRIAL BALANCE OF EXPENSE ACCOUNTS,BALANCE SHEET,HHA STATISTICAL DATA,INPATIENT ANCILLARY SERVICE COST APPORTIONMENT,APPORTIONMENT OF MEDICAL AND OTHER HEALTH SERVICES,INPATIENT ANCILLARY SERVICE COST APPORTIONMENT,APPORTIONMENT OF INPATIENT/OUTPATIENT ANCILLARY SERVICE OTHER PASS THROUGH COSTS,TRIAL BALANCE OF EXPENSE ACCOUNTS,,TRIAL BALANCE OF EXPENSE ACCOUNTS,APPORTIONMENT OF INPATIENT/OUTPATIENT ANCILLARY SERVICE OTHER PASS THROUGH COSTS,APPORTIONMENT OF INPATIENT/OUTPATIENT ANCILLARY SERVICE OTHER PASS THROUGH COSTS,BED DAYS AVAILABLE,APPORTIONMENT OF INPATIENT ROUTINE SERVICE CAPITAL COSTS,STATEMENT OF REVENUES AND EXPENSES,TRIAL BALANCE OF EXPENSE ACCOUNTS,HOSPITAL WAGE INDEX DATA,COMPUTATION OF RATIO OF COST TO CHARGES,COMPUTATION OF RATIO OF COST TO CHARGES,COST ALLOCATION,ALLOCATION OF NEW CAPITAL COSTS,INPATIENT ANCILLARY SERVICE COST APPORTIONMENT,COST ALLOCATION,BED DAYS AVAILABLE,HHA STATISTICAL DATA,APPORTIONMENT OF INPATIENT/OUTPATIENT ANCILLARY SERVICE OTHER PASS THROUGH COSTS,APPORTIONMENT OF MEDICAL AND OTHER HEALTH SERVICES,COST ALLOCATION,INPATIENT ANCILLARY SERVICE COST APPORTIONMENT,COMPUTATION OF RATIO OF COST TO CHARGES,APPORTIONMENT OF MEDICAL AND OTHER HEALTH SERVICES,APPORTIONMENT OF INPATIENT/OUTPATIENT ANCILLARY SERVICE OTHER PASS THROUGH COSTS,HHA STATISTICAL DATA,APPORTIONMENT OF MEDICAL AND OTHER HEALTH SERVICES,BED DAYS AVAILABLE,HOSPITAL WAGE INDEX DATA,COST ALLOCATION,APPORTIONMENT OF INPATIENT ROUTINE SERVICE CAPITAL COSTS,Medicare Inpatient Days/Outpatient Visits,TRIAL BALANCE OF EXPENSE ACCOUNTS,TRIAL BALANCE OF EXPENSE ACCOUNTS,INPATIENT ANCILLARY SERVICE COST APPORTIONMENT,ADJUSTMENTS,INPATIENT ANCILLARY SERVICE COST APPORTIONMENT,APPORTIONMENT OF INPATIENT/OUTPATIENT ANCILLARY SERVICE OTHER PASS THROUGH COSTS,ADJUSTMENTS,COST ALLOCATION,CALCULATION OF REIMBURSEMENT SETTLEMENT,APPORTIONMENT OF MEDICAL AND OTHER HEALTH SERVICES,Total Inpatient Days/Outpatient Visits,,INPATIENT ANCILLARY SERVICE COST APPORTIONMENT,INPATIENT ANCILLARY SERVICE COST APPORTIONMENT,ALLOCATION OF NEW CAPITAL COSTS,ANALYSIS OF CHANGES IN NEW CAPITAL BALANCES,HOSPITAL WAGE INDEX DATA,,COMPUTATION OF RATIO OF COST TO CHARGES,HHA STATISTICAL DATA,APPORTIONMENT OF INPATIENT/OUTPATIENT ANCILLARY SERVICE OTHER PASS THROUGH COSTS,APPORTIONMENT OF INPATIENT ROUTINE SERVICE OTHER PASS THROUGH COSTS,APPORTIONMENT OF MEDICAL AND OTHER HEALTH SERVICES,INPATIENT ANCILLARY SERVICE COST APPORTIONMENT,BED DAYS AVAILABLE,HOSPITAL WAGE INDEX DATA,TRIAL BALANCE OF EXPENSE ACCOUNTS,COST ALLOCATION,APPORTIONMENT OF INPATIENT/OUTPATIENT ANCILLARY SERVICE OTHER PASS THROUGH COSTS,TRIAL BALANCE OF EXPENSE ACCOUNTS,COMPUTATION OF RATIO OF COST TO CHARGES,BED DAYS AVAILABLE,COST ALLOCATION,APPORTIONMENT OF INPATIENT/OUTPATIENT ANCILLARY SERVICE OTHER PASS THROUGH COSTS,INPATIENT ANCILLARY SERVICE COST APPORTIONMENT,COST ALLOCATION,APPORTIONMENT OF MEDICAL AND OTHER HEALTH SERVICES,COMPUTATION OF RATIO OF COST TO CHARGES,APPORTIONMENT OF INPATIENT/OUTPATIENT ANCILLARY SERVICE OTHER PASS THROUGH COSTS,APPORTIONMENT OF INPATIENT/OUTPATIENT ANCILLARY SERVICE OTHER PASS THROUGH COSTS,APPORTIONMENT OF MEDICAL AND OTHER HEALTH SERVICES,,HOSPITAL IDENTIFICATION INFORMATION,APPORTIONMENT OF INPATIENT/OUTPATIENT ANCILLARY SERVICE OTHER PASS THROUGH COSTS,APPORTIONMENT OF INPATIENT/OUTPATIENT ANCILLARY SERVICE OTHER PASS THROUGH COSTS,TRIAL BALANCE OF EXPENSE ACCOUNTS,COST ALLOCATION,,TRIAL BALANCE OF EXPENSE ACCOUNTS,,ALLOCATION OF NEW CAPITAL COSTS,APPORTIONMENT OF INPATIENT/OUTPATIENT ANCILLARY SERVICE OTHER PASS THROUGH COSTS,APPORTIONMENT OF INPATIENT/OUTPATIENT ANCILLARY SERVICE OTHER PASS THROUGH COSTS,COMPUTATION OF RATIO OF COST TO CHARGES,APPORTIONMENT OF INPATIENT/OUTPATIENT ANCILLARY SERVICE OTHER PASS THROUGH COSTS,COMPUTATION OF RATIO OF COST TO CHARGES,COST ALLOCATION,APPORTIONMENT OF INPATIENT/OUTPATIENT ANCILLARY SERVICE OTHER PASS THROUGH COSTS,COST ALLOCATION,INPATIENT ANCILLARY SERVICE COST APPORTIONMENT,APPORTIONMENT OF MEDICAL AND OTHER HEALTH SERVICES,APPORTIONMENT OF INPATIENT/OUTPATIENT ANCILLARY SERVICE OTHER PASS THROUGH COSTS,INPATIENT ANCILLARY SERVICE COST APPORTIONMENT,HHA STATISTICAL DATA,HOSPITAL WAGE INDEX DATA,COMPUTATION OF RATIO OF COST TO CHARGES,APPORTIONMENT OF INPATIENT/OUTPATIENT ANCILLARY SERVICE OTHER PASS THROUGH COSTS,,HOSPITAL WAGE INDEX DATA,INPATIENT ANCILLARY SERVICE COST APPORTIONMENT,CALCULATION OF REIMBURSEMENT SETTLEMENT,RECONCILIATION OF CAPITAL COST CENTERS,TRIAL BALANCE OF EXPENSE ACCOUNTS,HOSPITAL WAGE INDEX DATA,COST ALLOCATION,APPORTIONMENT OF MEDICAL AND OTHER HEALTH SERVICES,INPATIENT ANCILLARY SERVICE COST APPORTIONMENT,APPORTIONMENT OF INPATIENT/OUTPATIENT ANCILLARY SERVICE OTHER PASS THROUGH COSTS,APPORTIONMENT OF INPATIENT/OUTPATIENT ANCILLARY SERVICE OTHER PASS THROUGH COSTS,HOSPITAL IDENTIFICATION INFORMATION,COST ALLOCATION,TRIAL BALANCE OF EXPENSE ACCOUNTS,HOSPITAL WAGE INDEX DATA,INPATIENT ANCILLARY SERVICE COST APPORTIONMENT,S-10 DATA,HHA STATISTICAL DATA,APPORTIONMENT OF INPATIENT/OUTPATIENT ANCILLARY SERVICE OTHER PASS THROUGH COSTS,CALCULATION OF REIMBURSEMENT SETTLEMENT,COMPUTATION OF INPATIENT OPERATING COSTS,TRIAL BALANCE OF EXPENSE ACCOUNTS,APPORTIONMENT OF INPATIENT/OUTPATIENT ANCILLARY SERVICE OTHER PASS THROUGH COSTS,STATEMENT OF REVENUES AND EXPENSES,,INPATIENT ANCILLARY SERVICE COST APPORTIONMENT,Total Inpatient Days/Outpatient Visits,COST ALLOCATION,COMPUTATION OF RATIO OF COST TO CHARGES,TRIAL BALANCE OF EXPENSE ACCOUNTS,,APPORTIONMENT OF INPATIENT/OUTPATIENT ANCILLARY SERVICE OTHER PASS THROUGH COSTS,HOSPITAL WAGE INDEX DATA,APPORTIONMENT OF INPATIENT/OUTPATIENT ANCILLARY SERVICE OTHER PASS THROUGH COSTS,TRIAL BALANCE OF EXPENSE ACCOUNTS,COST ALLOCATION,INPATIENT ANCILLARY SERVICE COST APPORTIONMENT,COMPUTATION OF RATIO OF COST TO CHARGES,HOSPITAL IDENTIFICATION INFORMATION,TRIAL BALANCE OF EXPENSE ACCOUNTS,ALLOCATION OF NEW CAPITAL COSTS,COMPUTATION OF RATIO OF COST TO CHARGES,Total Inpatient Days/Outpatient Visits,COMPUTATION OF RATIO OF COST TO CHARGES,APPORTIONMENT OF MEDICAL AND OTHER HEALTH SERVICES,HHA STATISTICAL DATA,APPORTIONMENT OF MEDICAL AND OTHER HEALTH SERVICES,,COST ALLOCATION,APPORTIONMENT OF MEDICAL AND OTHER HEALTH SERVICES,APPORTIONMENT OF MEDICAL AND OTHER HEALTH SERVICES,INPATIENT ANCILLARY SERVICE COST APPORTIONMENT,HOSPITAL WAGE INDEX DATA,HOSPITAL WAGE INDEX DATA,INPATIENT ANCILLARY SERVICE COST APPORTIONMENT,COMPUTATION OF INPATIENT OPERATING COSTS,APPORTIONMENT OF INPATIENT/OUTPATIENT ANCILLARY SERVICE OTHER PASS THROUGH COSTS,CALCULATION OF REIMBURSEMENT SETTLEMENT,ALLOCATION OF NEW CAPITAL COSTS,COST ALLOCATION,INPATIENT ANCILLARY SERVICE COST APPORTIONMENT,NUMBER OF BEDS,,APPORTIONMENT OF INPATIENT/OUTPATIENT ANCILLARY SERVICE OTHER PASS THROUGH COSTS,APPORTIONMENT OF INPATIENT/OUTPATIENT ANCILLARY SERVICE OTHER PASS THROUGH COSTS,Total Inpatient Days/Outpatient Visits,ALLOCATION OF NEW CAPITAL COSTS,ALLOCATION OF NEW CAPITAL COSTS,APPORTIONMENT OF MEDICAL AND OTHER HEALTH SERVICES,BALANCE SHEET,HHA STATISTICAL DATA,ANALYSIS OF CHANGES IN NEW CAPITAL BALANCES,Total Inpatient Days/Outpatient Visits,Medicare Inpatient Days/Outpatient Visits,COST ALLOCATION,HOSPITAL WAGE INDEX DATA,CALCULATION OF REIMBURSEMENT SETTLEMENT,ALLOCATION OF NEW CAPITAL COSTS,APPORTIONMENT OF INPATIENT/OUTPATIENT ANCILLARY SERVICE OTHER PASS THROUGH COSTS,INPATIENT ANCILLARY SERVICE COST APPORTIONMENT,Medicaid Inpatient Days/Outpatient Visits,BALANCE SHEET,Total Inpatient Days/Outpatient Visits,ADJUSTMENTS,ADJUSTMENTS,HOSPITAL WAGE INDEX DATA,APPORTIONMENT OF MEDICAL AND OTHER HEALTH SERVICES,COST ALLOCATION,COST ALLOCATION,HOSPITAL WAGE INDEX DATA,S-10 DATA,TRIAL BALANCE OF EXPENSE ACCOUNTS,COST ALLOCATION,ALLOCATION OF NEW CAPITAL COSTS,COST ALLOCATION,HOSPITAL WAGE INDEX DATA,COST ALLOCATION,INPATIENT ANCILLARY SERVICE COST APPORTIONMENT,INPATIENT ANCILLARY SERVICE COST APPORTIONMENT,,APPORTIONMENT OF INPATIENT ROUTINE SERVICE CAPITAL COSTS,COMPUTATION OF RATIO OF COST TO CHARGES,NUMBER OF BEDS,CALCULATION OF REIMBURSEMENT SETTLEMENT,APPORTIONMENT OF INPATIENT ROUTINE SERVICE CAPITAL COSTS,APPORTIONMENT OF INPATIENT/OUTPATIENT ANCILLARY SERVICE OTHER PASS THROUGH COSTS,Total Inpatient Days/Outpatient Visits,COST ALLOCATION,INPATIENT ANCILLARY SERVICE COST APPORTIONMENT,COST ALLOCATION,INPATIENT ANCILLARY SERVICE COST APPORTIONMENT,COMPUTATION OF RATIO OF COST TO CHARGES,TRIAL BALANCE OF EXPENSE ACCOUNTS,TRIAL BALANCE OF EXPENSE ACCOUNTS,,TRIAL BALANCE OF EXPENSE ACCOUNTS,INPATIENT ANCILLARY SERVICE COST APPORTIONMENT,ANALYSIS OF CHANGES IN NEW CAPITAL BALANCES,COMPUTATION OF RATIO OF COST TO CHARGES,APPORTIONMENT OF INPATIENT/OUTPATIENT ANCILLARY SERVICE OTHER PASS THROUGH COSTS,COST ALLOCATION,APPORTIONMENT OF INPATIENT/OUTPATIENT ANCILLARY SERVICE OTHER PASS THROUGH COSTS,NUMBER OF BEDS,ADJUSTMENTS,Total Inpatient Days/Outpatient Visits,INPATIENT ANCILLARY SERVICE COST APPORTIONMENT,ALLOCATION OF NEW CAPITAL COSTS,COST ALLOCATION,APPORTIONMENT OF MEDICAL AND OTHER HEALTH SERVICES,APPORTIONMENT OF MEDICAL AND OTHER HEALTH SERVICES,TRIAL BALANCE OF EXPENSE ACCOUNTS,COMPUTATION OF RATIO OF COST TO CHARGES,HOSPITAL IDENTIFICATION INFORMATION,COST ALLOCATION,HOSPITAL IDENTIFICATION INFORMATION,INPATIENT ANCILLARY SERVICE COST APPORTIONMENT,INPATIENT ANCILLARY SERVICE COST APPORTIONMENT,,COST ALLOCATION,APPORTIONMENT OF MEDICAL AND OTHER HEALTH SERVICES,ANALYSIS OF CHANGES IN NEW CAPITAL BALANCES,COST ALLOCATION,Total Inpatient Days/Outpatient Visits,ALLOCATION OF NEW CAPITAL COSTS,INPATIENT ANCILLARY SERVICE COST APPORTIONMENT,APPORTIONMENT OF MEDICAL AND OTHER HEALTH SERVICES,INPATIENT ANCILLARY SERVICE COST APPORTIONMENT,Total Inpatient Days/Outpatient Visits,INPATIENT ANCILLARY SERVICE COST APPORTIONMENT,APPORTIONMENT OF MEDICAL AND OTHER HEALTH SERVICES,S-10 DATA,APPORTIONMENT OF INPATIENT/OUTPATIENT ANCILLARY SERVICE OTHER PASS THROUGH COSTS,RENAL STATISTICAL DATA,RENAL STATISTICAL DATA,HHA STATISTICAL DATA,COST ALLOCATION,COST ALLOCATION,COMPUTATION OF RATIO OF COST TO CHARGES,CALCULATION OF REIMBURSEMENT SETTLEMENT (PPS),APPORTIONMENT OF MEDICAL AND OTHER HEALTH SERVICES,TRIAL BALANCE OF EXPENSE ACCOUNTS,INPATIENT ANCILLARY SERVICE COST APPORTIONMENT,TRIAL BALANCE OF EXPENSE ACCOUNTS,INPATIENT ANCILLARY SERVICE COST APPORTIONMENT,APPORTIONMENT OF INPATIENT/OUTPATIENT ANCILLARY SERVICE OTHER PASS THROUGH COSTS,APPORTIONMENT OF INPATIENT/OUTPATIENT ANCILLARY SERVICE OTHER PASS THROUGH COSTS,TRIAL BALANCE OF EXPENSE ACCOUNTS,TRIAL BALANCE OF EXPENSE ACCOUNTS,APPORTIONMENT OF INPATIENT/OUTPATIENT ANCILLARY SERVICE OTHER PASS THROUGH COSTS,COST ALLOCATION,APPORTIONMENT OF INPATIENT/OUTPATIENT ANCILLARY SERVICE OTHER PASS THROUGH COSTS,INPATIENT ANCILLARY SERVICE COST APPORTIONMENT,TRIAL BALANCE OF EXPENSE ACCOUNTS,APPORTIONMENT OF MEDICAL AND OTHER HEALTH SERVICES,COMPUTATION OF RATIO OF COST TO CHARGES,COMPUTATION OF RATIO OF COST TO CHARGES,COMPUTATION OF RATIO OF COST TO CHARGES,COST ALLOCATION,COST ALLOCATION,HOSPITAL WAGE INDEX DATA,S-10 DATA,APPORTIONMENT OF INPATIENT/OUTPATIENT ANCILLARY SERVICE OTHER PASS THROUGH COSTS,APPORTIONMENT OF INPATIENT/OUTPATIENT ANCILLARY SERVICE OTHER PASS THROUGH COSTS,TRIAL BALANCE OF EXPENSE ACCOUNTS,APPORTIONMENT OF INPATIENT/OUTPATIENT ANCILLARY SERVICE OTHER PASS THROUGH COSTS,INPATIENT ANCILLARY SERVICE COST APPORTIONMENT,TRIAL BALANCE OF EXPENSE ACCOUNTS,COMPUTATION OF RATIO OF COST TO CHARGES,HHA STATISTICAL DATA,APPORTIONMENT OF MEDICAL AND OTHER HEALTH SERVICES,APPORTIONMENT OF INPATIENT/OUTPATIENT ANCILLARY SERVICE OTHER PASS THROUGH COSTS,CALCULATION OF REIMBURSEMENT SETTLEMENT,,APPORTIONMENT OF INPATIENT/OUTPATIENT ANCILLARY SERVICE OTHER PASS THROUGH COSTS,HHA STATISTICAL DATA,INPATIENT ANCILLARY SERVICE COST APPORTIONMENT,COST ALLOCATION,TRIAL BALANCE OF EXPENSE ACCOUNTS,NUMBER OF BEDS,CALCULATION OF REIMBURSEMENT SETTLEMENT,HOSPITAL WAGE INDEX DATA,APPORTIONMENT OF INPATIENT/OUTPATIENT ANCILLARY SERVICE OTHER PASS THROUGH COSTS,INPATIENT ANCILLARY SERVICE COST APPORTIONMENT,RECONCILIATION OF CAPITAL COST CENTERS,TRIAL BALANCE OF EXPENSE ACCOUNTS,COMPUTATION OF INPATIENT OPERATING COSTS,APPORTIONMENT OF INPATIENT/OUTPATIENT ANCILLARY SERVICE OTHER PASS THROUGH COSTS,,COST ALLOCATION,COMPUTATION OF RATIO OF COST TO CHARGES,COST ALLOCATION,Medicaid Inpatient Days/Outpatient Visits,CALCULATION OF REIMBURSEMENT SETTLEMENT,CALCULATION OF REIMBURSEMENT SETTLEMENT (PPS),BED DAYS AVAILABLE,NUMBER OF BEDS,TRIAL BALANCE OF EXPENSE ACCOUNTS,COMPUTATION OF RATIO OF COST TO CHARGES,APPORTIONMENT OF INPATIENT/OUTPATIENT ANCILLARY SERVICE OTHER PASS THROUGH COSTS,APPORTIONMENT OF MEDICAL AND OTHER HEALTH SERVICES,APPORTIONMENT OF INPATIENT/OUTPATIENT ANCILLARY SERVICE OTHER PASS THROUGH COSTS,BALANCE SHEET,BALANCE SHEET,HHA STATISTICAL DATA,INPATIENT ANCILLARY SERVICE COST APPORTIONMENT,BALANCE SHEET,APPORTIONMENT OF INPATIENT/OUTPATIENT ANCILLARY SERVICE OTHER PASS THROUGH COSTS,HOSPITAL WAGE INDEX DATA,HOSPITAL WAGE INDEX DATA,,APPORTIONMENT OF INPATIENT/OUTPATIENT ANCILLARY SERVICE OTHER PASS THROUGH COSTS,INPATIENT ANCILLARY SERVICE COST APPORTIONMENT,APPORTIONMENT OF MEDICAL AND OTHER HEALTH SERVICES,INPATIENT ANCILLARY SERVICE COST APPORTIONMENT,APPORTIONMENT OF INPATIENT/OUTPATIENT ANCILLARY SERVICE OTHER PASS THROUGH COSTS,APPORTIONMENT OF INPATIENT ROUTINE SERVICE CAPITAL COSTS,APPORTIONMENT OF MEDICAL AND OTHER HEALTH SERVICES,INPATIENT ANCILLARY SERVICE COST APPORTIONMENT,APPORTIONMENT OF INPATIENT/OUTPATIENT ANCILLARY SERVICE OTHER PASS THROUGH COSTS,,TRIAL BALANCE OF EXPENSE ACCOUNTS,INPATIENT ANCILLARY SERVICE COST APPORTIONMENT,APPORTIONMENT OF INPATIENT/OUTPATIENT ANCILLARY SERVICE OTHER PASS THROUGH COSTS,Total Inpatient Days/Outpatient Visits,COST ALLOCATION,INPATIENT ANCILLARY SERVICE COST APPORTIONMENT,ANALYSIS OF CHANGES IN NEW CAPITAL BALANCES,TRIAL BALANCE OF EXPENSE ACCOUNTS,Total Inpatient Days/Outpatient Visits,TRIAL BALANCE OF EXPENSE ACCOUNTS,Medicaid Inpatient Days/Outpatient Visits,INPATIENT ANCILLARY SERVICE COST APPORTIONMENT,APPORTIONMENT OF INPATIENT/OUTPATIENT ANCILLARY SERVICE OTHER PASS THROUGH COSTS,APPORTIONMENT OF INPATIENT/OUTPATIENT ANCILLARY SERVICE OTHER PASS THROUGH COSTS,BED DAYS AVAILABLE,STATEMENT OF REVENUES AND EXPENSES,,COST ALLOCATION,TRIAL BALANCE OF EXPENSE ACCOUNTS,HOSPITAL WAGE INDEX DATA,APPORTIONMENT OF INPATIENT/OUTPATIENT ANCILLARY SERVICE OTHER PASS THROUGH COSTS,APPORTIONMENT OF MEDICAL AND OTHER HEALTH SERVICES,HOSPITAL WAGE INDEX DATA,ALLOCATION OF NEW CAPITAL COSTS,APPORTIONMENT OF INPATIENT/OUTPATIENT ANCILLARY SERVICE OTHER PASS THROUGH COSTS,APPORTIONMENT OF INPATIENT/OUTPATIENT ANCILLARY SERVICE OTHER PASS THROUGH COSTS,ALLOCATION OF NEW CAPITAL COSTS,INPATIENT ANCILLARY SERVICE COST APPORTIONMENT,HHA STATISTICAL DATA,,RENAL STATISTICAL DATA,TRIAL BALANCE OF EXPENSE ACCOUNTS,INPATIENT ANCILLARY SERVICE COST APPORTIONMENT,RECONCILIATION OF CAPITAL COST CENTERS,COST ALLOCATION,COMPUTATION OF RATIO OF COST TO CHARGES,APPORTIONMENT OF MEDICAL AND OTHER HEALTH SERVICES,COMPUTATION OF RATIO OF COST TO CHARGES,COMPUTATION OF RATIO OF COST TO CHARGES,TRIAL BALANCE OF EXPENSE ACCOUNTS,ANALYSIS OF CHANGES IN NEW CAPITAL BALANCES,APPORTIONMENT OF INPATIENT/OUTPATIENT ANCILLARY SERVICE OTHER PASS THROUGH COSTS,APPORTIONMENT OF MEDICAL AND OTHER HEALTH SERVICES,TRIAL BALANCE OF EXPENSE ACCOUNTS,ALLOCATION OF NEW CAPITAL COSTS,APPORTIONMENT OF MEDICAL AND OTHER HEALTH SERVICES,TRIAL BALANCE OF EXPENSE ACCOUNTS,APPORTIONMENT OF INPATIENT/OUTPATIENT ANCILLARY SERVICE OTHER PASS THROUGH COSTS,APPORTIONMENT OF MEDICAL AND OTHER HEALTH SERVICES,S-10 DATA,APPORTIONMENT OF INPATIENT ROUTINE SERVICE CAPITAL COSTS,ALLOCATION OF NEW CAPITAL COSTS,Total Inpatient Days/Outpatient Visits,INPATIENT ANCILLARY SERVICE COST APPORTIONMENT,HOSPITAL WAGE INDEX DATA,APPORTIONMENT OF MEDICAL AND OTHER HEALTH SERVICES,APPORTIONMENT OF INPATIENT/OUTPATIENT ANCILLARY SERVICE OTHER PASS THROUGH COSTS,INPATIENT ANCILLARY SERVICE COST APPORTIONMENT,INPATIENT ANCILLARY SERVICE COST APPORTIONMENT,INPATIENT ANCILLARY SERVICE COST APPORTIONMENT,HOSPITAL WAGE INDEX DATA,APPORTIONMENT OF INPATIENT/OUTPATIENT ANCILLARY SERVICE OTHER PASS THROUGH COSTS,APPORTIONMENT OF MEDICAL AND OTHER HEALTH SERVICES,HHA STATISTICAL DATA,INPATIENT ANCILLARY SERVICE COST APPORTIONMENT,COST ALLOCATION,HHA STATISTICAL DATA,HOSPITAL WAGE INDEX DATA,INPATIENT ANCILLARY SERVICE COST APPORTIONMENT,APPORTIONMENT OF INPATIENT/OUTPATIENT ANCILLARY SERVICE OTHER PASS THROUGH COSTS,NUMBER OF BEDS,S-10 DATA,COMPUTATION OF RATIO OF COST TO CHARGES,Total Inpatient Days/Outpatient Visits,TRIAL BALANCE OF EXPENSE ACCOUNTS,ADJUSTMENTS,RECONCILIATION OF CAPITAL COST CENTERS,Medicaid Inpatient Days/Outpatient Visits,INPATIENT ANCILLARY SERVICE COST APPORTIONMENT,TRIAL BALANCE OF EXPENSE ACCOUNTS,INPATIENT ANCILLARY SERVICE COST APPORTIONMENT,COST ALLOCATION,Total Inpatient Days/Outpatient Visits,COST ALLOCATION,APPORTIONMENT OF MEDICAL AND OTHER HEALTH SERVICES,,APPORTIONMENT OF MEDICAL AND OTHER HEALTH SERVICES,COST ALLOCATION,INPATIENT ANCILLARY SERVICE COST APPORTIONMENT,COMPUTATION OF RATIO OF COST TO CHARGES,APPORTIONMENT OF MEDICAL AND OTHER HEALTH SERVICES,RENAL STATISTICAL DATA,COST ALLOCATION,COST ALLOCATION,NUMBER OF BEDS,COST ALLOCATION,APPORTIONMENT OF INPATIENT/OUTPATIENT ANCILLARY SERVICE OTHER PASS THROUGH COSTS,,APPORTIONMENT OF INPATIENT/OUTPATIENT ANCILLARY SERVICE OTHER PASS THROUGH COSTS,APPORTIONMENT OF INPATIENT/OUTPATIENT ANCILLARY SERVICE OTHER PASS THROUGH COSTS,INPATIENT ANCILLARY SERVICE COST APPORTIONMENT,Total Inpatient Days/Outpatient Visits,APPORTIONMENT OF INPATIENT/OUTPATIENT ANCILLARY SERVICE OTHER PASS THROUGH COSTS,APPORTIONMENT OF INPATIENT/OUTPATIENT ANCILLARY SERVICE OTHER PASS THROUGH COSTS,COST ALLOCATION,INPATIENT ANCILLARY SERVICE COST APPORTIONMENT,INPATIENT ANCILLARY SERVICE COST APPORTIONMENT,TRIAL BALANCE OF EXPENSE ACCOUNTS,INPATIENT ANCILLARY SERVICE COST APPORTIONMENT,COMPUTATION OF RATIO OF COST TO CHARGES,APPORTIONMENT OF INPATIENT/OUTPATIENT ANCILLARY SERVICE OTHER PASS THROUGH COSTS,APPORTIONMENT OF INPATIENT/OUTPATIENT ANCILLARY SERVICE OTHER PASS THROUGH COSTS,INPATIENT ANCILLARY SERVICE COST APPORTIONMENT,ANALYSIS OF CHANGES IN NEW CAPITAL BALANCES,COMPUTATION OF RATIO OF COST TO CHARGES,HOSPITAL WAGE INDEX DATA,COST ALLOCATION,COMPUTATION OF RATIO OF COST TO CHARGES,Medicare Inpatient Days/Outpatient Visits,COMPUTATION OF RATIO OF COST TO CHARGES,COST ALLOCATION,S-10 DATA,,,APPORTIONMENT OF MEDICAL AND OTHER HEALTH SERVICES,Total Inpatient Days/Outpatient Visits,APPORTIONMENT OF INPATIENT ROUTINE SERVICE CAPITAL COSTS,APPORTIONMENT OF MEDICAL AND OTHER HEALTH SERVICES,HOSPITAL WAGE INDEX DATA,COMPUTATION OF INPATIENT OPERATING COSTS,ANALYSIS OF CHANGES IN NEW CAPITAL BALANCES,APPORTIONMENT OF MEDICAL AND OTHER HEALTH SERVICES,INPATIENT ANCILLARY SERVICE COST APPORTIONMENT,INPATIENT ANCILLARY SERVICE COST APPORTIONMENT,HOSPITAL WAGE INDEX DATA,APPORTIONMENT OF INPATIENT/OUTPATIENT ANCILLARY SERVICE OTHER PASS THROUGH COSTS,HHA STATISTICAL DATA,TRIAL BALANCE OF EXPENSE ACCOUNTS,Medicaid Inpatient Days/Outpatient Visits,COST ALLOCATION,COST ALLOCATION,COMPUTATION OF RATIO OF COST TO CHARGES,APPORTIONMENT OF INPATIENT/OUTPATIENT ANCILLARY SERVICE OTHER PASS THROUGH COSTS,APPORTIONMENT OF MEDICAL AND OTHER HEALTH SERVICES,COST ALLOCATION,INPATIENT ANCILLARY SERVICE COST APPORTIONMENT,HOSPITAL WAGE INDEX DATA,APPORTIONMENT OF MEDICAL AND OTHER HEALTH SERVICES,APPORTIONMENT OF MEDICAL AND OTHER HEALTH SERVICES,INPATIENT ANCILLARY SERVICE COST APPORTIONMENT,COMPUTATION OF RATIO OF COST TO CHARGES,APPORTIONMENT OF INPATIENT/OUTPATIENT ANCILLARY SERVICE OTHER PASS THROUGH COSTS,APPORTIONMENT OF MEDICAL AND OTHER HEALTH SERVICES,INPATIENT ANCILLARY SERVICE COST APPORTIONMENT,INPATIENT ANCILLARY SERVICE COST APPORTIONMENT,HHA STATISTICAL DATA,APPORTIONMENT OF INPATIENT ROUTINE SERVICE CAPITAL COSTS,APPORTIONMENT OF MEDICAL AND OTHER HEALTH SERVICES,TRIAL BALANCE OF EXPENSE ACCOUNTS,COST ALLOCATION,HOSPITAL WAGE INDEX DATA,APPORTIONMENT OF INPATIENT/OUTPATIENT ANCILLARY SERVICE OTHER PASS THROUGH COSTS,APPORTIONMENT OF INPATIENT/OUTPATIENT ANCILLARY SERVICE OTHER PASS THROUGH COSTS,COST ALLOCATION,TRIAL BALANCE OF EXPENSE ACCOUNTS,S-10 DATA,APPORTIONMENT OF MEDICAL AND OTHER HEALTH SERVICES,BALANCE SHEET,BED DAYS AVAILABLE,HHA STATISTICAL DATA,APPORTIONMENT OF MEDICAL AND OTHER HEALTH SERVICES,APPORTIONMENT OF MEDICAL AND OTHER HEALTH SERVICES,INPATIENT ANCILLARY SERVICE COST APPORTIONMENT,,HOSPITAL WAGE INDEX DATA,COMPUTATION OF RATIO OF COST TO CHARGES,CALCULATION OF REIMBURSEMENT SETTLEMENT,APPORTIONMENT OF INPATIENT/OUTPATIENT ANCILLARY SERVICE OTHER PASS THROUGH COSTS,HOSPITAL WAGE INDEX DATA,APPORTIONMENT OF MEDICAL AND OTHER HEALTH SERVICES,BALANCE SHEET,,COST ALLOCATION,COST ALLOCATION,,HOSPITAL WAGE INDEX DATA,COMPUTATION OF RATIO OF COST TO CHARGES,APPORTIONMENT OF INPATIENT/OUTPATIENT ANCILLARY SERVICE OTHER PASS THROUGH COSTS,HOSPITAL WAGE INDEX DATA,COST ALLOCATION,COMPUTATION OF RATIO OF COST TO CHARGES,HOSPITAL WAGE INDEX DATA,COMPUTATION OF RATIO OF COST TO CHARGES,APPORTIONMENT OF MEDICAL AND OTHER HEALTH SERVICES,COMPUTATION OF INPATIENT OPERATING COSTS,RECONCILIATION OF CAPITAL COST CENTERS,S-10 DATA,COST ALLOCATION,COST ALLOCATION,APPORTIONMENT OF INPATIENT/OUTPATIENT ANCILLARY SERVICE OTHER PASS THROUGH COSTS,,ALLOCATION OF NEW CAPITAL COSTS,APPORTIONMENT OF INPATIENT/OUTPATIENT ANCILLARY SERVICE OTHER PASS THROUGH COSTS,APPORTIONMENT OF INPATIENT/OUTPATIENT ANCILLARY SERVICE OTHER PASS THROUGH COSTS,APPORTIONMENT OF MEDICAL AND OTHER HEALTH SERVICES,ADJUSTMENTS,INPATIENT ANCILLARY SERVICE COST APPORTIONMENT,APPORTIONMENT OF MEDICAL AND OTHER HEALTH SERVICES,COST ALLOCATION,INPATIENT ANCILLARY SERVICE COST APPORTIONMENT,TRIAL BALANCE OF EXPENSE ACCOUNTS,Total Inpatient Days/Outpatient Visits,TRIAL BALANCE OF EXPENSE ACCOUNTS,BED DAYS AVAILABLE,TRIAL BALANCE OF EXPENSE ACCOUNTS,APPORTIONMENT OF INPATIENT/OUTPATIENT ANCILLARY SERVICE OTHER PASS THROUGH COSTS,HOSPITAL WAGE INDEX DATA,HOSPITAL WAGE INDEX DATA,COMPUTATION OF RATIO OF COST TO CHARGES,APPORTIONMENT OF INPATIENT/OUTPATIENT ANCILLARY SERVICE OTHER PASS THROUGH COSTS,HHA STATISTICAL DATA,COST ALLOCATION,INPATIENT ANCILLARY SERVICE COST APPORTIONMENT,ALLOCATION OF NEW CAPITAL COSTS,HHA STATISTICAL DATA,INPATIENT ANCILLARY SERVICE COST APPORTIONMENT,RECONCILIATION OF CAPITAL COST CENTERS,BED DAYS AVAILABLE,HOSPITAL WAGE INDEX DATA,S-10 DATA,ALLOCATION OF NEW CAPITAL COSTS,,COMPUTATION OF RATIO OF COST TO CHARGES,COMPUTATION OF RATIO OF COST TO CHARGES,,TRIAL BALANCE OF EXPENSE ACCOUNTS,INPATIENT ANCILLARY SERVICE COST APPORTIONMENT,APPORTIONMENT OF INPATIENT/OUTPATIENT ANCILLARY SERVICE OTHER PASS THROUGH COSTS,APPORTIONMENT OF MEDICAL AND OTHER HEALTH SERVICES,INPATIENT ANCILLARY SERVICE COST APPORTIONMENT,INPATIENT ANCILLARY SERVICE COST APPORTIONMENT,INPATIENT ANCILLARY SERVICE COST APPORTIONMENT,APPORTIONMENT OF INPATIENT/OUTPATIENT ANCILLARY SERVICE OTHER PASS THROUGH COSTS,ALLOCATION OF NEW CAPITAL COSTS,TRIAL BALANCE OF EXPENSE ACCOUNTS,APPORTIONMENT OF INPATIENT/OUTPATIENT ANCILLARY SERVICE OTHER PASS THROUGH COSTS,APPORTIONMENT OF INPATIENT/OUTPATIENT ANCILLARY SERVICE OTHER PASS THROUGH COSTS,HOSPITAL WAGE INDEX DATA,ALLOCATION OF NEW CAPITAL COSTS,TRIAL BALANCE OF EXPENSE ACCOUNTS,TRIAL BALANCE OF EXPENSE ACCOUNTS,ANALYSIS OF CHANGES IN NEW CAPITAL BALANCES,APPORTIONMENT OF INPATIENT/OUTPATIENT ANCILLARY SERVICE OTHER PASS THROUGH COSTS,COMPUTATION OF RATIO OF COST TO CHARGES,TRIAL BALANCE OF EXPENSE ACCOUNTS,COMPUTATION OF RATIO OF COST TO CHARGES,COMPUTATION OF RATIO OF COST TO CHARGES,COMPUTATION OF RATIO OF COST TO CHARGES,INPATIENT ANCILLARY SERVICE COST APPORTIONMENT,COMPUTATION OF RATIO OF COST TO CHARGES,COMPUTATION OF RATIO OF COST TO CHARGES,INPATIENT ANCILLARY SERVICE COST APPORTIONMENT,BED DAYS AVAILABLE,INPATIENT ANCILLARY SERVICE COST APPORTIONMENT,INPATIENT ANCILLARY SERVICE COST APPORTIONMENT,APPORTIONMENT OF MEDICAL AND OTHER HEALTH SERVICES,TRIAL BALANCE OF EXPENSE ACCOUNTS,COST ALLOCATION,COST ALLOCATION,BALANCE SHEET,APPORTIONMENT OF MEDICAL AND OTHER HEALTH SERVICES,INPATIENT ANCILLARY SERVICE COST APPORTIONMENT,APPORTIONMENT OF INPATIENT ROUTINE SERVICE CAPITAL COSTS,ADJUSTMENTS,TRIAL BALANCE OF EXPENSE ACCOUNTS,TRIAL BALANCE OF EXPENSE ACCOUNTS,COST ALLOCATION,APPORTIONMENT OF INPATIENT/OUTPATIENT ANCILLARY SERVICE OTHER PASS THROUGH COSTS,HOSPITAL IDENTIFICATION INFORMATION,S-10 DATA,COMPUTATION OF RATIO OF COST TO CHARGES,APPORTIONMENT OF INPATIENT/OUTPATIENT ANCILLARY SERVICE OTHER PASS THROUGH COSTS,INPATIENT ANCILLARY SERVICE COST APPORTIONMENT,HOSPITAL WAGE INDEX DATA,APPORTIONMENT OF MEDICAL AND OTHER HEALTH SERVICES,BED DAYS AVAILABLE,COMPUTATION OF RATIO OF COST TO CHARGES,COST ALLOCATION,APPORTIONMENT OF MEDICAL AND OTHER HEALTH SERVICES,APPORTIONMENT OF INPATIENT/OUTPATIENT ANCILLARY SERVICE OTHER PASS THROUGH COSTS,HHA STATISTICAL DATA,APPORTIONMENT OF INPATIENT/OUTPATIENT ANCILLARY SERVICE OTHER PASS THROUGH COSTS,Total Inpatient Days/Outpatient Visits,COST ALLOCATION,APPORTIONMENT OF INPATIENT ROUTINE SERVICE CAPITAL COSTS,COMPUTATION OF RATIO OF COST TO CHARGES,TRIAL BALANCE OF EXPENSE ACCOUNTS,APPORTIONMENT OF MEDICAL AND OTHER HEALTH SERVICES,HOSPITAL WAGE INDEX DATA,COMPUTATION OF RATIO OF COST TO CHARGES,HOSPITAL WAGE INDEX DATA,APPORTIONMENT OF INPATIENT/OUTPATIENT ANCILLARY SERVICE OTHER PASS THROUGH COSTS,INPATIENT ANCILLARY SERVICE COST APPORTIONMENT,INPATIENT ANCILLARY SERVICE COST APPORTIONMENT,INPATIENT ANCILLARY SERVICE COST APPORTIONMENT,COST ALLOCATION,COST ALLOCATION,COST ALLOCATION,HOSPITAL WAGE INDEX DATA,COMPUTATION OF RATIO OF COST TO CHARGES,TRIAL BALANCE OF EXPENSE ACCOUNTS,APPORTIONMENT OF INPATIENT ROUTINE SERVICE OTHER PASS THROUGH COSTS,INPATIENT ANCILLARY SERVICE COST APPORTIONMENT,COST ALLOCATION,COMPUTATION OF RATIO OF COST TO CHARGES,HOSPITAL WAGE INDEX DATA,INPATIENT ANCILLARY SERVICE COST APPORTIONMENT,TRIAL BALANCE OF EXPENSE ACCOUNTS,INPATIENT ANCILLARY SERVICE COST APPORTIONMENT,COST ALLOCATION,APPORTIONMENT OF INPATIENT/OUTPATIENT ANCILLARY SERVICE OTHER PASS THROUGH COSTS,TRIAL BALANCE OF EXPENSE ACCOUNTS,,TRIAL BALANCE OF EXPENSE ACCOUNTS,TRIAL BALANCE OF EXPENSE ACCOUNTS,COMPUTATION OF RATIO OF COST TO CHARGES,COMPUTATION OF INPATIENT OPERATING COSTS,COST ALLOCATION,INPATIENT ANCILLARY SERVICE COST APPORTIONMENT,TRIAL BALANCE OF EXPENSE ACCOUNTS,RENAL STATISTICAL DATA,COST ALLOCATION,INPATIENT ANCILLARY SERVICE COST APPORTIONMENT,Medicare Inpatient Days/Outpatient Visits,COST ALLOCATION,INPATIENT ANCILLARY SERVICE COST APPORTIONMENT,RENAL STATISTICAL DATA,,COMPUTATION OF RATIO OF COST TO CHARGES,Total Inpatient Days/Outpatient Visits,COMPUTATION OF RATIO OF COST TO CHARGES,COMPUTATION OF RATIO OF COST TO CHARGES,COST ALLOCATION,COST ALLOCATION,COST ALLOCATION,COMPUTATION OF RATIO OF COST TO CHARGES,TRIAL BALANCE OF EXPENSE ACCOUNTS,APPORTIONMENT OF INPATIENT/OUTPATIENT ANCILLARY SERVICE OTHER PASS THROUGH COSTS,HOSPITAL WAGE INDEX DATA,COST ALLOCATION,ANALYSIS OF CHANGES IN NEW CAPITAL BALANCES,HHA STATISTICAL DATA,ADJUSTMENTS,HOSPITAL WAGE INDEX DATA,APPORTIONMENT OF MEDICAL AND OTHER HEALTH SERVICES,APPORTIONMENT OF INPATIENT/OUTPATIENT ANCILLARY SERVICE OTHER PASS THROUGH COSTS,INPATIENT ANCILLARY SERVICE COST APPORTIONMENT,APPORTIONMENT OF INPATIENT/OUTPATIENT ANCILLARY SERVICE OTHER PASS THROUGH COSTS,INPATIENT ANCILLARY SERVICE COST APPORTIONMENT,APPORTIONMENT OF INPATIENT/OUTPATIENT ANCILLARY SERVICE OTHER PASS THROUGH COSTS,COMPUTATION OF INPATIENT OPERATING COSTS,ALLOCATION OF NEW CAPITAL COSTS,CALCULATION OF REIMBURSEMENT SETTLEMENT,COST ALLOCATION,COST ALLOCATION,TRIAL BALANCE OF EXPENSE ACCOUNTS,COMPUTATION OF INPATIENT OPERATING COSTS,,Total Inpatient Days/Outpatient Visits,HOSPITAL IDENTIFICATION INFORMATION,HOSPITAL WAGE INDEX DATA,HOSPITAL WAGE INDEX DATA,Medicaid Inpatient Days/Outpatient Visits,TRIAL BALANCE OF EXPENSE ACCOUNTS,APPORTIONMENT OF MEDICAL AND OTHER HEALTH SERVICES,RECONCILIATION OF CAPITAL COST CENTERS,Total Inpatient Days/Outpatient Visits,INPATIENT ANCILLARY SERVICE COST APPORTIONMENT,TRIAL BALANCE OF EXPENSE ACCOUNTS,APPORTIONMENT OF MEDICAL AND OTHER HEALTH SERVICES,Medicare Inpatient Days/Outpatient Visits,HOSPITAL WAGE INDEX DATA,Medicaid Inpatient Days/Outpatient Visits,COMPUTATION OF INPATIENT OPERATING COSTS,INPATIENT ANCILLARY SERVICE COST APPORTIONMENT,COMPUTATION OF RATIO OF COST TO CHARGES,TRIAL BALANCE OF EXPENSE ACCOUNTS,TRIAL BALANCE OF EXPENSE ACCOUNTS,TRIAL BALANCE OF EXPENSE ACCOUNTS,TRIAL BALANCE OF EXPENSE ACCOUNTS,INPATIENT ANCILLARY SERVICE COST APPORTIONMENT,APPORTIONMENT OF INPATIENT/OUTPATIENT ANCILLARY SERVICE OTHER PASS THROUGH COSTS,APPORTIONMENT OF INPATIENT/OUTPATIENT ANCILLARY SERVICE OTHER PASS THROUGH COSTS,COMPUTATION OF INPATIENT OPERATING COSTS,COMPUTATION OF RATIO OF COST TO CHARGES,COMPUTATION OF RATIO OF COST TO CHARGES,APPORTIONMENT OF MEDICAL AND OTHER HEALTH SERVICES,INPATIENT ANCILLARY SERVICE COST APPORTIONMENT,HOSPITAL WAGE INDEX DATA,HOSPITAL WAGE INDEX DATA,S-10 DATA,COST ALLOCATION,APPORTIONMENT OF INPATIENT/OUTPATIENT ANCILLARY SERVICE OTHER PASS THROUGH COSTS,COMPUTATION OF RATIO OF COST TO CHARGES,APPORTIONMENT OF MEDICAL AND OTHER HEALTH SERVICES,TRIAL BALANCE OF EXPENSE ACCOUNTS,COST ALLOCATION,APPORTIONMENT OF INPATIENT/OUTPATIENT ANCILLARY SERVICE OTHER PASS THROUGH COSTS,APPORTIONMENT OF INPATIENT/OUTPATIENT ANCILLARY SERVICE OTHER PASS THROUGH COSTS,COST ALLOCATION,TRIAL BALANCE OF EXPENSE ACCOUNTS,HOSPITAL WAGE INDEX DATA,HOSPITAL WAGE INDEX DATA,BALANCE SHEET,TRIAL BALANCE OF EXPENSE ACCOUNTS,Medicaid Inpatient Days/Outpatient Visits,Total Inpatient Days/Outpatient Visits,INPATIENT ANCILLARY SERVICE COST APPORTIONMENT,APPORTIONMENT OF INPATIENT/OUTPATIENT ANCILLARY SERVICE OTHER PASS THROUGH COSTS,INPATIENT ANCILLARY SERVICE COST APPORTIONMENT,HOSPITAL WAGE INDEX DATA,TRIAL BALANCE OF EXPENSE ACCOUNTS,COST ALLOCATION,APPORTIONMENT OF MEDICAL AND OTHER HEALTH SERVICES,,INPATIENT ANCILLARY SERVICE COST APPORTIONMENT,CALCULATION OF REIMBURSEMENT SETTLEMENT,APPORTIONMENT OF INPATIENT/OUTPATIENT ANCILLARY SERVICE OTHER PASS THROUGH COSTS,APPORTIONMENT OF MEDICAL AND OTHER HEALTH SERVICES,S-10 DATA,CALCULATION OF REIMBURSEMENT SETTLEMENT,TRIAL BALANCE OF EXPENSE ACCOUNTS,INPATIENT ANCILLARY SERVICE COST APPORTIONMENT,COST ALLOCATION,BED DAYS AVAILABLE,INPATIENT ANCILLARY SERVICE COST APPORTIONMENT,COST ALLOCATION,APPORTIONMENT OF INPATIENT/OUTPATIENT ANCILLARY SERVICE OTHER PASS THROUGH COSTS,APPORTIONMENT OF INPATIENT/OUTPATIENT ANCILLARY SERVICE OTHER PASS THROUGH COSTS,HOSPITAL WAGE INDEX DATA,APPORTIONMENT OF MEDICAL AND OTHER HEALTH SERVICES,APPORTIONMENT OF INPATIENT/OUTPATIENT ANCILLARY SERVICE OTHER PASS THROUGH COSTS,TRIAL BALANCE OF EXPENSE ACCOUNTS,TRIAL BALANCE OF EXPENSE ACCOUNTS,APPORTIONMENT OF MEDICAL AND OTHER HEALTH SERVICES,Medicare Inpatient Days/Outpatient Visits,BALANCE SHEET,ANALYSIS OF CHANGES IN NEW CAPITAL BALANCES,APPORTIONMENT OF INPATIENT/OUTPATIENT ANCILLARY SERVICE OTHER PASS THROUGH COSTS,APPORTIONMENT OF MEDICAL AND OTHER HEALTH SERVICES,BALANCE SHEET,APPORTIONMENT OF INPATIENT/OUTPATIENT ANCILLARY SERVICE OTHER PASS THROUGH COSTS,,,COMPUTATION OF RATIO OF COST TO CHARGES,ADJUSTMENTS,HHA STATISTICAL DATA,APPORTIONMENT OF INPATIENT/OUTPATIENT ANCILLARY SERVICE OTHER PASS THROUGH COSTS,,INPATIENT ANCILLARY SERVICE COST APPORTIONMENT,TRIAL BALANCE OF EXPENSE ACCOUNTS,APPORTIONMENT OF INPATIENT/OUTPATIENT ANCILLARY SERVICE OTHER PASS THROUGH COSTS,TRIAL BALANCE OF EXPENSE ACCOUNTS,COMPUTATION OF RATIO OF COST TO CHARGES,APPORTIONMENT OF INPATIENT/OUTPATIENT ANCILLARY SERVICE OTHER PASS THROUGH COSTS,BALANCE SHEET,APPORTIONMENT OF INPATIENT/OUTPATIENT ANCILLARY SERVICE OTHER PASS THROUGH COSTS,APPORTIONMENT OF MEDICAL AND OTHER HEALTH SERVICES,TRIAL BALANCE OF EXPENSE ACCOUNTS,INPATIENT ANCILLARY SERVICE COST APPORTIONMENT,TRIAL BALANCE OF EXPENSE ACCOUNTS,COST ALLOCATION,HOSPITAL WAGE INDEX DATA,TRIAL BALANCE OF EXPENSE ACCOUNTS,COST ALLOCATION,APPORTIONMENT OF INPATIENT/OUTPATIENT ANCILLARY SERVICE OTHER PASS THROUGH COSTS,INPATIENT ANCILLARY SERVICE COST APPORTIONMENT,Medicare Inpatient Days/Outpatient Visits,APPORTIONMENT OF INPATIENT ROUTINE SERVICE OTHER PASS THROUGH COSTS,RENAL STATISTICAL DATA,APPORTIONMENT OF MEDICAL AND OTHER HEALTH SERVICES,APPORTIONMENT OF INPATIENT/OUTPATIENT ANCILLARY SERVICE OTHER PASS THROUGH COSTS,Medicare Inpatient Days/Outpatient Visits,APPORTIONMENT OF INPATIENT/OUTPATIENT ANCILLARY SERVICE OTHER PASS THROUGH COSTS,TRIAL BALANCE OF EXPENSE ACCOUNTS,TRIAL BALANCE OF EXPENSE ACCOUNTS,APPORTIONMENT OF MEDICAL AND OTHER HEALTH SERVICES,APPORTIONMENT OF INPATIENT ROUTINE SERVICE OTHER PASS THROUGH COSTS,APPORTIONMENT OF INPATIENT ROUTINE SERVICE CAPITAL COSTS,Total Inpatient Days/Outpatient Visits,,INPATIENT ANCILLARY SERVICE COST APPORTIONMENT,COST ALLOCATION,COMPUTATION OF RATIO OF COST TO CHARGES,INPATIENT ANCILLARY SERVICE COST APPORTIONMENT,HOSPITAL WAGE INDEX DATA,HHA STATISTICAL DATA,Total Inpatient Days/Outpatient Visits,HOSPITAL WAGE INDEX DATA,ANALYSIS OF CHANGES IN NEW CAPITAL BALANCES,COMPUTATION OF RATIO OF COST TO CHARGES,APPORTIONMENT OF INPATIENT/OUTPATIENT ANCILLARY SERVICE OTHER PASS THROUGH COSTS,ALLOCATION OF NEW CAPITAL COSTS,APPORTIONMENT OF MEDICAL AND OTHER HEALTH SERVICES,BALANCE SHEET,APPORTIONMENT OF INPATIENT/OUTPATIENT ANCILLARY SERVICE OTHER PASS THROUGH COSTS,APPORTIONMENT OF INPATIENT/OUTPATIENT ANCILLARY SERVICE OTHER PASS THROUGH COSTS,APPORTIONMENT OF INPATIENT/OUTPATIENT ANCILLARY SERVICE OTHER PASS THROUGH COSTS,Total Inpatient Days/Outpatient Visits,HOSPITAL WAGE INDEX DATA,COST ALLOCATION,TRIAL BALANCE OF EXPENSE ACCOUNTS,TRIAL BALANCE OF EXPENSE ACCOUNTS,INPATIENT ANCILLARY SERVICE COST APPORTIONMENT,ALLOCATION OF NEW CAPITAL COSTS,COMPUTATION OF RATIO OF COST TO CHARGES,ANALYSIS OF CHANGES IN NEW CAPITAL BALANCES,COST ALLOCATION,RENAL STATISTICAL DATA,INPATIENT ANCILLARY SERVICE COST APPORTIONMENT,INPATIENT ANCILLARY SERVICE COST APPORTIONMENT,RENAL STATISTICAL DATA,COST ALLOCATION,NUMBER OF BEDS,INPATIENT ANCILLARY SERVICE COST APPORTIONMENT,TRIAL BALANCE OF EXPENSE ACCOUNTS,RENAL STATISTICAL DATA,APPORTIONMENT OF INPATIENT/OUTPATIENT ANCILLARY SERVICE OTHER PASS THROUGH COSTS,APPORTIONMENT OF MEDICAL AND OTHER HEALTH SERVICES,COST ALLOCATION,COST ALLOCATION,INPATIENT ANCILLARY SERVICE COST APPORTIONMENT,TRIAL BALANCE OF EXPENSE ACCOUNTS,INPATIENT ANCILLARY SERVICE COST APPORTIONMENT,APPORTIONMENT OF INPATIENT/OUTPATIENT ANCILLARY SERVICE OTHER PASS THROUGH COSTS,TRIAL BALANCE OF EXPENSE ACCOUNTS,INPATIENT ANCILLARY SERVICE COST APPORTIONMENT,COMPUTATION OF RATIO OF COST TO CHARGES,HOSPITAL WAGE INDEX DATA,ANALYSIS OF CHANGES IN NEW CAPITAL BALANCES,COST ALLOCATION,APPORTIONMENT OF INPATIENT/OUTPATIENT ANCILLARY SERVICE OTHER PASS THROUGH COSTS,COMPUTATION OF RATIO OF COST TO CHARGES,RECONCILIATION OF CAPITAL COST CENTERS,ADJUSTMENTS,TRIAL BALANCE OF EXPENSE ACCOUNTS,,APPORTIONMENT OF MEDICAL AND OTHER HEALTH SERVICES,APPORTIONMENT OF INPATIENT/OUTPATIENT ANCILLARY SERVICE OTHER PASS THROUGH COSTS,ALLOCATION OF NEW CAPITAL COSTS,APPORTIONMENT OF INPATIENT/OUTPATIENT ANCILLARY SERVICE OTHER PASS THROUGH COSTS,APPORTIONMENT OF INPATIENT/OUTPATIENT ANCILLARY SERVICE OTHER PASS THROUGH COSTS,TRIAL BALANCE OF EXPENSE ACCOUNTS,APPORTIONMENT OF MEDICAL AND OTHER HEALTH SERVICES,INPATIENT ANCILLARY SERVICE COST APPORTIONMENT,INPATIENT ANCILLARY SERVICE COST APPORTIONMENT,,COMPUTATION OF RATIO OF COST TO CHARGES,,COMPUTATION OF RATIO OF COST TO CHARGES,COST ALLOCATION,TRIAL BALANCE OF EXPENSE ACCOUNTS,COMPUTATION OF RATIO OF COST TO CHARGES,COMPUTATION OF INPATIENT OPERATING COSTS,APPORTIONMENT OF INPATIENT/OUTPATIENT ANCILLARY SERVICE OTHER PASS THROUGH COSTS,APPORTIONMENT OF MEDICAL AND OTHER HEALTH SERVICES,,APPORTIONMENT OF INPATIENT/OUTPATIENT ANCILLARY SERVICE OTHER PASS THROUGH COSTS,,APPORTIONMENT OF INPATIENT/OUTPATIENT ANCILLARY SERVICE OTHER PASS THROUGH COSTS,Total Inpatient Days/Outpatient Visits,STATEMENT OF REVENUES AND EXPENSES,NUMBER OF BEDS,APPORTIONMENT OF INPATIENT/OUTPATIENT ANCILLARY SERVICE OTHER PASS THROUGH COSTS,TRIAL BALANCE OF EXPENSE ACCOUNTS,COST ALLOCATION,APPORTIONMENT OF MEDICAL AND OTHER HEALTH SERVICES,CALCULATION OF REIMBURSEMENT SETTLEMENT,RENAL STATISTICAL DATA,Total Inpatient Days/Outpatient Visits,COST ALLOCATION,Total Inpatient Days/Outpatient Visits,TRIAL BALANCE OF EXPENSE ACCOUNTS,HOSPITAL WAGE INDEX DATA,COST ALLOCATION,COST ALLOCATION,COMPUTATION OF RATIO OF COST TO CHARGES,ADJUSTMENTS,APPORTIONMENT OF INPATIENT/OUTPATIENT ANCILLARY SERVICE OTHER PASS THROUGH COSTS,APPORTIONMENT OF MEDICAL AND OTHER HEALTH SERVICES,COST ALLOCATION,Medicare Inpatient Days/Outpatient Visits,TRIAL BALANCE OF EXPENSE ACCOUNTS,INPATIENT ANCILLARY SERVICE COST APPORTIONMENT,APPORTIONMENT OF MEDICAL AND OTHER HEALTH SERVICES,HHA STATISTICAL DATA,S-10 DATA,TRIAL BALANCE OF EXPENSE ACCOUNTS,INPATIENT ANCILLARY SERVICE COST APPORTIONMENT,INPATIENT ANCILLARY SERVICE COST APPORTIONMENT,ALLOCATION OF NEW CAPITAL COSTS,HHA STATISTICAL DATA,INPATIENT ANCILLARY SERVICE COST APPORTIONMENT,INPATIENT ANCILLARY SERVICE COST APPORTIONMENT,APPORTIONMENT OF INPATIENT/OUTPATIENT ANCILLARY SERVICE OTHER PASS THROUGH COSTS,ALLOCATION OF NEW CAPITAL COSTS,COMPUTATION OF RATIO OF COST TO CHARGES,COST ALLOCATION,,Total Inpatient Days/Outpatient Visits,ALLOCATION OF NEW CAPITAL COSTS,APPORTIONMENT OF MEDICAL AND OTHER HEALTH SERVICES,,INPATIENT ANCILLARY SERVICE COST APPORTIONMENT,,TRIAL BALANCE OF EXPENSE ACCOUNTS,,APPORTIONMENT OF MEDICAL AND OTHER HEALTH SERVICES,COMPUTATION OF INPATIENT OPERATING COSTS,,TRIAL BALANCE OF EXPENSE ACCOUNTS,APPORTIONMENT OF INPATIENT/OUTPATIENT ANCILLARY SERVICE OTHER PASS THROUGH COSTS,COST ALLOCATION,INPATIENT ANCILLARY SERVICE COST APPORTIONMENT,APPORTIONMENT OF INPATIENT/OUTPATIENT ANCILLARY SERVICE OTHER PASS THROUGH COSTS,TRIAL BALANCE OF EXPENSE ACCOUNTS,ALLOCATION OF NEW CAPITAL COSTS,COMPUTATION OF RATIO OF COST TO CHARGES,Total Inpatient Days/Outpatient Visits,COST ALLOCATION,APPORTIONMENT OF INPATIENT/OUTPATIENT ANCILLARY SERVICE OTHER PASS THROUGH COSTS,APPORTIONMENT OF MEDICAL AND OTHER HEALTH SERVICES,APPORTIONMENT OF INPATIENT/OUTPATIENT ANCILLARY SERVICE OTHER PASS THROUGH COSTS,APPORTIONMENT OF INPATIENT/OUTPATIENT ANCILLARY SERVICE OTHER PASS THROUGH COSTS,ADJUSTMENTS,COST ALLOCATION,TRIAL BALANCE OF EXPENSE ACCOUNTS,COMPUTATION OF RATIO OF COST TO CHARGES,Medicare Inpatient Days/Outpatient Visits,COST ALLOCATION,APPORTIONMENT OF INPATIENT/OUTPATIENT ANCILLARY SERVICE OTHER PASS THROUGH COSTS,APPORTIONMENT OF INPATIENT ROUTINE SERVICE OTHER PASS THROUGH COSTS,APPORTIONMENT OF INPATIENT/OUTPATIENT ANCILLARY SERVICE OTHER PASS THROUGH COSTS,APPORTIONMENT OF INPATIENT/OUTPATIENT ANCILLARY SERVICE OTHER PASS THROUGH COSTS,TRIAL BALANCE OF EXPENSE ACCOUNTS,APPORTIONMENT OF INPATIENT/OUTPATIENT ANCILLARY SERVICE OTHER PASS THROUGH COSTS,INPATIENT ANCILLARY SERVICE COST APPORTIONMENT,APPORTIONMENT OF INPATIENT/OUTPATIENT ANCILLARY SERVICE OTHER PASS THROUGH COSTS,APPORTIONMENT OF MEDICAL AND OTHER HEALTH SERVICES,APPORTIONMENT OF INPATIENT/OUTPATIENT ANCILLARY SERVICE OTHER PASS THROUGH COSTS,Total Inpatient Days/Outpatient Visits,APPORTIONMENT OF INPATIENT/OUTPATIENT ANCILLARY SERVICE OTHER PASS THROUGH COSTS,APPORTIONMENT OF INPATIENT/OUTPATIENT ANCILLARY SERVICE OTHER PASS THROUGH COSTS,COMPUTATION OF RATIO OF COST TO CHARGES,INPATIENT ANCILLARY SERVICE COST APPORTIONMENT,APPORTIONMENT OF INPATIENT/OUTPATIENT ANCILLARY SERVICE OTHER PASS THROUGH COSTS,COST ALLOCATION,APPORTIONMENT OF INPATIENT/OUTPATIENT ANCILLARY SERVICE OTHER PASS THROUGH COSTS,HOSPITAL WAGE INDEX DATA,INPATIENT ANCILLARY SERVICE COST APPORTIONMENT,TRIAL BALANCE OF EXPENSE ACCOUNTS,BALANCE SHEET,INPATIENT ANCILLARY SERVICE COST APPORTIONMENT,Total Inpatient Days/Outpatient Visits,HOSPITAL WAGE INDEX DATA,ANALYSIS OF CHANGES IN NEW CAPITAL BALANCES,APPORTIONMENT OF INPATIENT/OUTPATIENT ANCILLARY SERVICE OTHER PASS THROUGH COSTS,Medicare Inpatient Days/Outpatient Visits,APPORTIONMENT OF INPATIENT/OUTPATIENT ANCILLARY SERVICE OTHER PASS THROUGH COSTS,CALCULATION OF REIMBURSEMENT SETTLEMENT,COST ALLOCATION,BED DAYS AVAILABLE,APPORTIONMENT OF INPATIENT/OUTPATIENT ANCILLARY SERVICE OTHER PASS THROUGH COSTS,COMPUTATION OF INPATIENT OPERATING COSTS,APPORTIONMENT OF MEDICAL AND OTHER HEALTH SERVICES,,,INPATIENT ANCILLARY SERVICE COST APPORTIONMENT,TRIAL BALANCE OF EXPENSE ACCOUNTS,APPORTIONMENT OF INPATIENT/OUTPATIENT ANCILLARY SERVICE OTHER PASS THROUGH COSTS,RENAL STATISTICAL DATA,ANALYSIS OF CHANGES IN NEW CAPITAL BALANCES,APPORTIONMENT OF INPATIENT/OUTPATIENT ANCILLARY SERVICE OTHER PASS THROUGH COSTS,COMPUTATION OF RATIO OF COST TO CHARGES,INPATIENT ANCILLARY SERVICE COST APPORTIONMENT,BED DAYS AVAILABLE,ALLOCATION OF NEW CAPITAL COSTS,INPATIENT ANCILLARY SERVICE COST APPORTIONMENT,Medicaid Inpatient Days/Outpatient Visits,HOSPITAL WAGE INDEX DATA,COMPUTATION OF RATIO OF COST TO CHARGES,APPORTIONMENT OF INPATIENT/OUTPATIENT ANCILLARY SERVICE OTHER PASS THROUGH COSTS,APPORTIONMENT OF MEDICAL AND OTHER HEALTH SERVICES,COST ALLOCATION,COST ALLOCATION,TRIAL BALANCE OF EXPENSE ACCOUNTS,HOSPITAL WAGE INDEX DATA,CALCULATION OF REIMBURSEMENT SETTLEMENT,HHA STATISTICAL DATA,HOSPITAL WAGE INDEX DATA,Report_Period_Begin_Yr,Beginning FFY,Financial Indicators,Financial Indicators,Financial Indicators,Financial Indicators,Financial Indicators,S-10 DATA,Financial Indicators,Financial Indicators,Financial Indicators,Financial Indicators,Financial Indicators,Financial Indicators,Financial Indicators,Financial Indicators,Financial Indicators,Financial Indicators,Financial Indicators,Financial Indicators,Financial Indicators,Financial Indicators,Financial Indicators,Financial Indicators,Hospital Type (From CMS Hospitals Data Archive),,HOSPITAL IDENTIFICATION INFORMATION,Name and Num
,Curated Name and Num,Hospital type (modified),Type of Control of Hospital (See Table I) (S2_1_C1_21),Lon,Lat,Other Ancillary (C_1_C6_76),Title V discharges (S3_1_C12_17),Clinic (A_C6_90),MRI (D_4_HOS_C13_58),"HHA III, Total Non Routine Medical  Supply Charges (S4_HHA3_C5_38)",Hospice 2 Provider Number (S2_1_C2_1401),"Allocation of Interns & Residents Salary and Fringes, SNF (B_1_C21_44)","PPS SERVICES COST, Total (D_5_HOS_C5_200)",Pass through Cost for Program Inpatient Routine (D1_HOS_C1_50),MRI (D_4_HOS_C2_58),Durable Medical Equipment Rented (D3_HOS_C2_96),Speech Pathology (D_4_HOS_C3_68),Durable Medical Equipment Rented (C_1_C5_96),Nursery (A_C2_43),"HHA III, With Outliers:  Total Charges (S4_HHA3_C2_35)",Hospital State (S2_1_C2_2),Relief Payment (D1_HOS_C1_62),NF (B_1_C26_45),ASC (Non Distinct Part) (C_1_C5_75),"COST SERVICES NOT SUBJECT TO DEDUCTIBLES AND COINSURANCE - COST, Total (D_5_HOS_C7_200)",Renal Dialysis (D_4_HOS_C12_74),ASC (Distinct Part) (C_1_C6_115),Delivery Room and Labor Room (D_4_HOS_C3_52),"Total Inpatient Charges, CT Scan (C_1_C6_57)","AMOUNT REPORTED, Related Salaries (S3_2_C3_1402)",Received DSH or supplemental payments from Medicaid? (Y/N) (S10_C1_3),Anesthesiology (D_4_HOS_C10_53),RHC (A_C2_88),Respiratory Therapy (D3_HOS_C2_65),Durable Medical Equipment Sold (A_C2_97),Blood Clotting Factors for Hemoph. (D_4_HOS_C10_6250),Other Outpatient Services (B_1_C22_93),Laboratory (D_4_IRF_C11_60),"Total Inpatient Charges, Recovery Room (C_1_C6_51)",Sale of medical and surgical supplies to (A8_C2_16),Hospital County (S2_1_C4_2),"Total Inpatient Charges, Adults & Pediatrics (C_1_C6_30)","AVERAGE HOURLY WAGE, Contract Labor:  Physician Part A (S3_2_C6_13)",Lung  Acquisition (C_1_C6_108),NF (S3_1_C7_20),Delivery Room and Labor Room (D_4_HOS_C12_52),Other Ancillary (B_1_C26_76),Fiscal Year End Date (FY_END_DT),"Net Expense for Cost Allocation, Other Ancillary (B_1_C0_76)",Hospice (B_1_C21_116),Respiratory Therapy (D_4_IRF_C11_65),HRR adjustment amount (E_A_HOS_C1_7094),"COST REIMBURSED SERVICES NOT SUBJECT TO DEDUCTIBLES AND COINSURANCE - CHARGES, Impl. Dev. Charged to Patients (D_5_HOS_C4_72)",Whole Blood & Packed Red Blood Cells (D_4_HOS_C11_62),"COST SERVICES SUBJECT TO DEDUCTIBLES AND COINSURANCE - COST, Ambulance Services (D_5_HOS_C6_95)",Operating Room (D3_IRF_C2_50),SNF (S3_1_C3_19),Labor and Delivery Days -  Title XIX (S3_1_C7_32),"HHA II, PEP Episodes:  Total Visits (S4_HHA2_C4_33)",Occupational Therapy (D_4_HOS_C12_67),Total Allied Health Cost (D_3_HOS_C2_200),Subprovider II (B_1_C26_4201),Other Outpatient Services (C_1_C5_93),Burn Intensive Care Unit (S3_1_C3_10),Other Special Purpose (A_C2_117),"PPS SERVICES COST, Radioisotope (D_5_HOS_C5_56)",Anesthesiology (D3_IPF_C3_53),Other Ancillary (D_4_HOS_C2_76),Kidney Acquisition (C_1_C5_105),OOT (A_C1_9930),Adults & Pediatrics (D_1_HOS_C4_30),MDH status ending date (MM/DD/YY) (S2_1_C2_38),"Total Outpatient Charges, Recovery Room (C_1_C7_51)",TOTAL (D3_IPF_C2_200),Home Program Dialysis (B_1_C22_94),"Net Expense for Cost Allocation, Nursing School (B_1_C0_20)","Other Capital Related Costs, New Cap Related Csts Movable Equipment (A7_3_C7_2)","AMOUNT REPORTED, Subtotal Wage Related Csts (S3_3_C2_5)","COST SERVICES NOT SUBJECT TO DEDUCTIBLES AND COINSURANCE - COST, Occupational Therapy (D_5_HOS_C7_67)","ADJUSTED SALARIES, Wage Related Costs Other (S3_2_C4_18)",Int & Res (non approved teaching program (C_1_C6_100),Electroencephalography (D3_IRF_C2_70),Other Special Care (S3_1_C5_12),Drugs Charged to Patients (C_1_C5_73),SNF (A_C2_44),"ADJUSTED SALARIES, Central Services and Supply (S3_2_C4_39)",Home Program Dialysis (D_4_HOS_C2_94),Other Reimbursable (D_4_IRF_C11_98),Medical and Other Services reimbursed by OPPS (E_B_HOS_C1_2),Surgical Intensive Care Unit (S3_1_C7_11),Physicians' Private Office (B_2_C26_192),Medical Supplies Charged to Patients (D_4_HOS_C2_71),MSP-LCC reconciliation amount (E_B_HOS_C1_38),Electrocardiology (D_4_IRF_C11_69),Clinic (D3_IPF_C2_90),"Allocation of Interns & Residents Salary and Fringes, Physical Therapy (B_1_C21_66)","Average patient dialysis time 
including setup (S5_C3_3)","COST SERVICES SUBJECT TO DEDUCTIBLES AND COINSURANCE - COST, Intravenous Therapy (D_5_HOS_C6_64)",IPF Provider Number (S2_1_C2_4),Physicians' Private Office (B_1_C21_192),Intravenous Therapy (D_4_HOS_C11_64),"Total Inpatient Charges, OLTC (C_1_C6_46)",Medical Supplies Charged to Patients (D3_IRF_C3_71),Durable Medical Equipment Rented (D3_IPF_C3_96),ASC (Non Distinct Part) (D_4_HOS_C3_75),"AVERAGE HOURLY WAGE, Physician-Part A (S3_2_C6_4)",Utilization (S5_C1_8),Radiology-Diagnostic (D3_IRF_C3_54),"Net Expense for Cost Allocation, Subprovider I (B_1_C0_42)",Recovery Room (C_1_C5_51),Observation Beds (Distinct Unit) (B_1_C22_9201),"COST REIMBURSED SERVICES NOT SUBJECT TO DEDUCTIBLES AND COINSURANCE - CHARGES, Cardiac Catheterization (D_5_HOS_C4_59)","Allocation of Interns & Residents Salary and Fringes, Nursery (B_1_C21_43)",Electroencephalography (B_1_C26_70),Impl. Dev. Charged to Patients (A_C6_72),Intravenous Therapy (B_2_C26_64),"Total Inpatient Charges, Burn Intensive Care Unit (C_1_C6_33)",RHC (D_4_HOS_C4_88),Subtotal (C_1_C5_200),"COST REIMBURSED SERVICES NOT SUBJECT TO DEDUCTIBLES AND COINSURANCE - CHARGES, Blood Storing, Processing, Trans (D_5_HOS_C4_63)","COST SERVICES SUBJECT TO DEDUCTIBLES AND COINSURANCE - COST, Home Program Dialysis (D_5_HOS_C6_94)",Other adjustments (E_B_HOS_C1_39),Recovery Room (D_4_HOS_C11_51),Electrocardiology (D_4_SNF_C11_69),"Is this a teaching hospital or
affiliated with a teaching hospital? (Y/N) (S2_1_C1_56)","Fully Depreciated Assets, Begin Balance (A7_1_C1_7)","Net Expense for Cost Allocation, Other Organ Acquisition (B_1_C0_112)","PAID HOURS RELATED TO SALARIES, Dietary under Contract (S3_2_C5_35)",CORF (C_1_C6_9910),"ADJUSTED SALARIES, Non-Physician Anesthetist Part A (S3_2_C4_20)","PPS SERVICES COST, Cardiac Catheterization (D_5_HOS_C5_59)",Laboratory (D_4_HOS_C4_60),Drugs Charged to Patients (B_1_C21_73),"Total Outpatient Charges, Whole Blood & Packed Red Blood Cells (C_1_C7_62)",Radiology-Therapeutic (D_4_HOS_C2_55),Nonpaid Workers (A_C1_193),FQHC (C_1_C6_89),Clinic (C_1_C6_90),RHC (D_4_HOS_C3_88),Other Ancillary (D_4_SNF_C11_76),"Net Expense for Cost Allocation, Respiratory Therapy (B_1_C0_65)",Whole Blood & Packed Red Blood Cells (B_1_C26_62),Int & Res (non approved teaching program (A_C6_100),Drugs Charged to Patients (D_4_IRF_C11_73),Total Facility FTEs (S3_1_C11_27),FQHC 9 Provider Number (S2_1_C2_1608),Medical Supplies Charged to Patients (A_C2_71),"COST REIMBURSED SERVICES SUBJECT TO DEDUCTIBLES  AND COINSURANCE - CHARGES, Impl. Dev. Charged to Patients (D_5_HOS_C3_72)",Electroencephalography (A_C1_70),RHC 7 Provider Number (S2_1_C2_1506),Dietary (A_C1_10),Delivery Room and Labor Room (D3_IRF_C3_52),"AMOUNT REPORTED, Pharmacy (S3_2_C2_40)",OOT (A_C6_9930),"Net Expense for Cost Allocation, Research (B_1_C0_191)",Lung  Acquisition (A_C6_108),Intravenous Therapy (D3_HOS_C2_64),"COST SERVICES NOT SUBJECT TO DEDUCTIBLES AND COINSURANCE - COST, Radioisotope (D_5_HOS_C7_56)",Other Reimbursable (C_1_C5_98),"AVERAGE HOURLY WAGE, Other General Service (S3_2_C6_43)","COST REIMBURSED SERVICES NOT SUBJECT TO DEDUCTIBLES AND COINSURANCE - CHARGES, Renal Dialysis (D_5_HOS_C4_74)","Lease, New Cap Related Csts Movable Equipment (A7_3_C10_2)",Other Ancillary (D_4_IPF_C13_76),"Allocation of Interns & Residents Program Costs, Burn Intensive Care Unit (B_1_C22_33)","Salaries, Wages, and Fees Payable (G_C1THRU4_38)",Delivery Room and Labor Room (A_C2_52),"Allocation of Interns & Residents Program Costs, MRI (B_1_C22_58)",Recovery Room (D3_HOS_C3_51),Subprovider 2 (S3_1_C8_1801),Notes Receivable (G_C1THRU4_3),"TOTAL CAPITAL COSTS AFTER COST ALLOCATION, NF (B_2_C26_45)","PPS REIMBURSED SERVICES -  CHARGES, Blood Storing, Processing, Trans (D_5_HOS_C2_63)",Drugs Charged to Patients (D_4_SNF_C13_73),"COST SERVICES NOT SUBJECT TO DEDUCTIBLES AND COINSURANCE - COST, Medical Supplies Charged to Patients (D_5_HOS_C7_71)","COST SERVICES SUBJECT TO DEDUCTIBLES AND COINSURANCE - COST, Recovery Room (D_5_HOS_C6_51)","COST SERVICES NOT SUBJECT TO DEDUCTIBLES AND COINSURANCE - COST, Drugs Charged to Patients (D_5_HOS_C7_73)","Net Expense for Cost Allocation, Pancreas Acquisition (B_1_C0_109)","PPS SERVICES COST, Observation Beds (Distinct Unit) (D_5_HOS_C5_9201)",Blood Clotting Factors for Hemoph. (D3_IPF_C2_6250),Intestinal Acquisition (C_1_C6_110),MRI (D3_IPF_C2_58),"Beginning Balances, Fixed Equipment (A7_1_C1_5)",Whole Blood & Packed Red Blood Cells (D_4_IRF_C11_62),Radioisotope (D3_SNF_C3_56),Intravenous Therapy (D3_SNF_C2_64),CT Scan (A_C6_57),"AVERAGE HOURLY WAGE, Teaching Physician Salaries (S3_2_C6_16)","PAID HOURS RELATED TO SALARIES, Operation of Plant (S3_2_C5_30)","AMOUNT REPORTED, Net Salaries (S3_3_C2_1)",Other Special Care Unit (D3_SNF_C2_35),Component rate ESRD (E_B_HOS_C1_33),CMHC (C_1_C6_99),Radiology-Therapeutic (D3_HOS_C2_55),Subprovider-IPF (D_1_HOS_C4_40),Total unreimbursed cost for Medicaid and CHIP and state and local indigent care programs (S10_C1_19),Intravenous Therapy (D3_IPF_C3_64),Electroencephalography (D3_SNF_C2_70),MRI (C_1_C5_58),Liver Acquisition (C_1_C5_107),Radiology-Diagnostic (D_4_HOS_C3_54),"AMOUNT REPORTED, Non-Physician Anesthetist Part B (S3_2_C2_21)",Clinic (B_1_C21_90),Durable Medical Equipment Sold (D_4_HOS_C13_97),Provider's actual MSA or CBSA (S2_1_C3_3),"TOTAL CAPITAL COSTS AFTER COST ALLOCATION, SNF (B_2_C26_44)","HHA III, With Outliers:  Total Visits (S4_HHA3_C2_33)",RHC (B_1_C21_88),Payroll taxes payable (G_C1THRU4_39),Minor Equipment Depreciable (G_C1THRU4_25),"AVERAGE HOURLY WAGE, Non-Physician Anesthetist Part B (S3_2_C6_3)",Medicare Certified Pancreas TC term date (S2_1_C2_130),Adj for Respiratory therapy costs in excess (A8_C2_23),Emergency (D3_HOS_C3_91),Nursery (A_C1_43),"HHA III, Total Number of Episodes (S4_HHA3_C5_36)","Net Expense for Cost Allocation, Laundry and Linen Service (B_1_C0_8)",Adj for Physical therapy costs in excess (A8_C2_24),"HHA I, With Outliers:  Non Routine Med Sup Chgs (S4_HHA1_C2_38)","Net Expense for Cost Allocation, Surgical Intensive Care Unit (B_1_C0_34)",OOT (A_C2_9930),Other Special Care Unit (D_1_HOS_C4_35),Blood Clotting Factors for Hemoph. (A_C1_6250),Subprovider-IPF (D_3_HOS_C9_40),Other Reimbursable (A_C2_98),"Blood Storing, Processing, Trans (D3_IRF_C3_63)",MDH status beginning date  (MM/DD/YY) (S2_1_C1_3801),CT Scan (D3_SNF_C3_57),"PAID HOURS RELATED TO SALARIES, Teaching Physician Salaries (S3_2_C5_16)",Total Fund Balances (G_C1THRU4_53),Other Ancillary (B_2_C26_76),Medicaid (Title XIX) discharges (S3_1_C14_17),"If Line 32, Col 1 is yes, enter the method used: (A, B, or E only) (S2_1_C2_115)",Utilization Review SNF (A_C2_114),Does the facility operate an ICF/MR facility for purposes of Title XIX? (Y/N) (S2_1_C1_93),"PPS REIMBURSED SERVICES -  CHARGES, Laboratory (D_5_HOS_C2_60)",Cross Foot Adjustments (B_1_C26_200),"General Inpatient Routine Service Cost, net of Swing Bed Cost (D1_IPF_C1_27)",Drugs Charged to Patients (D_4_HOS_C1_73),Renal Dialysis (B_1_C21_74),Less Observation Beds (C_1_C5_201),"HHA II, Without Outliers:  Other Charges (S4_HHA2_C1_34)","Allocation of Interns & Residents Program Costs, Laboratory (B_1_C22_60)",Organ Procurement (D4_KIDNEY_C1_69),Total Long-term Liabilities (G_C1THRU4_50),Total Hospital (S3_1_C4_14),Cafeteria (A_C2_11),Int & Res (non approved teaching program (A_C2_100),Renal Dialysis (D_4_SNF_C11_74),OSP (C_1_C7_9940),"Purchases, Movable Equipment (A7_1_C2_6)","TOTAL CAPITAL COSTS AFTER COST ALLOCATION, Cardiac Catheterization (B_2_C26_59)","COST REIMBURSED SERVICES SUBJECT TO DEDUCTIBLES  AND COINSURANCE - CHARGES, Emergency (D_5_HOS_C3_91)",Operating Room (D_4_HOS_C3_50),Other Organ Acquisition (C_1_C7_112),"AMOUNT REPORTED, Contract Labor (S3_2_C2_11)",Number of stations (S5_C3_6),Cardiac Catheterization (D_4_HOS_C11_59),Respiratory Therapy (D3_IRF_C2_65),Burn Intensive Care Unit (A_C6_33),"AVERAGE HOURLY WAGE, Total Overhead Costs (S3_3_C6_7)",Islet Acquisition (C_1_C7_111),"COST REIMBURSED SERVICES SUBJECT TO DEDUCTIBLES  AND COINSURANCE - CHARGES, Electrocardiology (D_5_HOS_C3_69)","Net Expense for Cost Allocation, Heart Acquisition (B_1_C0_106)",Respiratory Therapy (C_1_C2_65),"Total Inpatient Charges, ICF (C_1_C6_4501)",Hospital Street Address (S2_1_C1_1),Outpatient Revenue (G2_C2_28),CT Scan (D_4_SNF_C11_57),Kidney Acquisition (A_C6_105),ASC (Non Distinct Part) (D_4_HOS_C13_75),Other Ancillary (D_4_HOS_C3_76),CMHC 1 Provider Number (S2_1_C2_17),Impl. Dev. Charged to Patients (D_4_IPF_C13_72),ASC (Non Distinct Part) (D3_SNF_C2_75),Burn Intensive Care Unit (D_1_HOS_C7_33),Radiology-Diagnostic (D3_SNF_C2_54),"COST SERVICES NOT SUBJECT TO DEDUCTIBLES AND COINSURANCE - COST, Other Ancillary (D_5_HOS_C7_76)",Observation Beds (Distinct Unit) (C_1_C6_9201),Other Organ Acquisition (B_1_C22_112),Emergency (D_4_HOS_C3_91),"Blood Storing, Processing, Trans (D_4_HOS_C11_63)",ASC (Distinct Part) (B_1_C26_115),Other Ancillary (B_1_C22_76),"PPS REIMBURSED SERVICES -  CHARGES, Whole Blood & Packed Red Blood Cells (D_5_HOS_C2_62)","Net costs of Epoietin furnished to
all maintenance dialysis patients
by the provider (S5_C1_13)",MRI (D_4_HOS_C4_58),Other Special Purpose (C_1_C7_117),"COST SERVICES SUBJECT TO DEDUCTIBLES AND COINSURANCE - COST, Radiology-Diagnostic (D_5_HOS_C6_54)",Renal Dialysis (D3_IPF_C3_74),"Net Expense for Cost Allocation, Anesthesiology (B_1_C0_53)",Number of stations (S5_C4_6),"Allocation of Interns & Residents Salary and Fringes, CT Scan (B_1_C21_57)",Other Current Assets (G_C1THRU4_9),"ADJUSTED SALARIES, Physician-Part B (S3_2_C4_5)",MDH status beginning date (MM/DD/YY) (S2_1_C1_38),Impl. Dev. Charged to Patients (D3_IPF_C2_72),Deferred Income (G_C1THRU4_41),Renal Dialysis (D_4_HOS_C3_74),Impl. Dev. Charged to Patients (D3_SNF_C2_72),Other Adjustments (Summed) (A8_C2_33),Observation Beds (Distinct Unit) (D3_IPF_C2_9201),Renal Dialysis (D_4_IRF_C13_74),"Allocation of Interns & Residents Salary and Fringes, Surgical Intensive Care Unit (B_1_C21_34)","Allocation of Interns & Residents Salary and Fringes, Cardiac Catheterization (B_1_C21_59)","Income from imposition of interest, finance (A8_C2_21)",Physical Therapy (D_4_HOS_C12_66),Lung  Acquisition (C_1_C7_108),"PPS SERVICES COST, Whole Blood & Packed Red Blood Cells (D_5_HOS_C5_62)","Net Expense for Cost Allocation, Maintenance and Repairs (B_1_C0_6)",Int & Res (non approved teaching program (B_2_C26_100),Operating Room (D3_SNF_C3_50),Radiology-Therapeutic (D_4_IPF_C11_55),Clinic (D_4_HOS_C11_90),"COST REIMBURSED SERVICES NOT SUBJECT TO DEDUCTIBLES AND COINSURANCE - CHARGES, Respiratory Therapy (D_5_HOS_C4_65)","COST SERVICES NOT SUBJECT TO DEDUCTIBLES AND COINSURANCE - COST, Blood Clotting Factors for Hemoph. (D_5_HOS_C7_6250)","AMOUNT REPORTED, Wage Related Costs RHC/FQHC (S3_2_C3_24)",ASC (Distinct Part) (A_C1_115),Intensive Care Unit Program Cost (D1_HOS_C5_43),"AMOUNT REPORTED, Home Office Salaries & Wage Related Csts (S3_2_C3_14)",Electroencephalography (D_4_HOS_C2_70),"ADJUSTED SALARIES, Pharmacy (S3_2_C4_40)",Surgical Intensive Care Unit (A_C1_34),PBP Clinical Lab Services Program Only (A_C6_61),Renal Dialysis (A_C2_74),Pass Through Cost for  Program Ancillary (D1_IPF_C1_51),"ADJUSTED SALARIES, Maintenance of Personnel (S3_2_C4_37)",CT Scan (D_4_IRF_C13_57),Other Special Care Unit (A_C2_35),"AMOUNT REPORTED, Maintenance of Personnel (S3_2_C2_37)","Net Expense for Cost Allocation, Intravenous Therapy (B_1_C0_64)",CT Scan (D_4_HOS_C11_57),Durable Medical Equipment Rented (C_1_C7_96),Occupational Therapy (D3_IRF_C2_67),Recovery Room (D3_SNF_C2_51),Hospital Adlts & Ped Swing Bed NF (S3_1_C8_6),"Disposals and Retirements, Fixed Equipment (A7_1_C7_5)","COST SERVICES NOT SUBJECT TO DEDUCTIBLES AND COINSURANCE - COST, Clinic (D_5_HOS_C7_90)",Inventory (G_C1THRU4_7),Fiscal Intermediary/MAC Create Date (FI_CREAT_DT),Anesthesiology (D_4_HOS_C12_53),Coronary Care Unit (S3_1_C8_9),"PAID HOURS RELATED TO SALARIES, Physician-Part A (S3_2_C5_4)",Ambulance Services (A_C6_95),Total (D_1_HOS_C6_200),Cafeteria (A_C1_11),"Net Expense for Cost Allocation, Delivery Room and Labor Room (B_1_C0_52)","AMOUNT REPORTED, SNF (S3_2_C2_9)","Net Expense for Cost Allocation, Durable Medical Equipment Sold (B_1_C0_97)",Nursing Administration (A_C1_13),"Blood Storing, Processing, Trans (C_1_C5_63)",Respiratory Therapy (C_1_C7_65),"PAID HOURS RELATED TO SALARIES, Dietary (S3_2_C5_34)",Renal Dialysis (B_2_C26_74),"HHA I, Without Outliers:  Other Charges (S4_HHA1_C1_34)","HHA I, Total Non Routine Medical  Supply Charges (S4_HHA1_C5_38)","COST SERVICES NOT SUBJECT TO DEDUCTIBLES AND COINSURANCE - COST, Impl. Dev. Charged to Patients (D_5_HOS_C7_72)",Occupational Therapy (D_4_HOS_C10_67),Clinic (D3_HOS_C2_90),Surgical Intensive Care Unit (D_1_HOS_C7_34),"Gift, Flower, Coffee Shop, Canteen (A_C2_190)","PAID HOURS RELATED TO SALARIES, Employee Benefits (S3_2_C5_26)","HHA II, LUPA Episodes:  Other Charges (S4_HHA2_C3_34)","Number of days in year dialysis 
furnished (S5_C5_2)","Epoietin amount form worksheet A
for home dialysis program (S5_C1_14)",Clinic (D_4_IRF_C13_90),"ADJUSTED SALARIES, Wage Related Costs Core (S3_2_C4_17)",Whole Blood & Packed Red Blood Cells (A_C6_62),Dietary (A_C6_10),Pass Through Cost for  Program Ancillary (D1_IRF_C1_51),"COST REIMBURSED SERVICES NOT SUBJECT TO DEDUCTIBLES AND COINSURANCE - CHARGES, Occupational Therapy (D_5_HOS_C4_67)","AVERAGE HOURLY WAGE, Administrative and General under Contract (S3_2_C6_28)",Cost of patients approved for charity care and uninsured discounts (S10_C1_21),"Allocation of Interns & Residents Salary and Fringes, Speech Pathology (B_1_C21_68)","Net Expense for Cost Allocation, CT Scan (B_1_C0_57)",Transitional corridor payment (E_B_HOS_C1_8),CT Scan (D_4_HOS_C10_57),Observation Beds (Distinct Unit) (C_1_C5_9201),ASC (Distinct Part) (C_1_C5_115),"COST SERVICES NOT SUBJECT TO DEDUCTIBLES AND COINSURANCE - COST, CT Scan (D_5_HOS_C7_57)","AVERAGE HOURLY WAGE, Contract Labor (S3_2_C6_11)","AMOUNT REPORTED, Subtotal Other Wages and Related Csts (S3_3_C2_4)","Insurance, New Cap Related Csts Bldg & Fixtures (A7_3_C5_1)","Net Expense for Cost Allocation, Operation of Plant (B_1_C0_7)","HHA II, LUPA Episodes:  Total Visits (S4_HHA2_C3_33)",Hospital Adults & Pediatrics (S3_1_C8_1),"COST SERVICES SUBJECT TO DEDUCTIBLES AND COINSURANCE - COST, Emergency (D_5_HOS_C6_91)",Coronary Care Unit (S3_1_C2_9),Total Nursing School (D_4_HOS_C2_200),Radiology-Therapeutic (D3_HOS_C3_55),"PPS SERVICES COST, Radiology-Therapeutic (D_5_HOS_C5_55)",Total Costs (C_1_C3_202),Anesthesiology (D3_SNF_C2_53),Respiratory Therapy (D_4_SNF_C11_65),NF (S3_1_C10_20),Observation Beds (Distinct Unit) (A_C6_9201),Laboratory (C_1_C5_60),Subprovider I (A_C2_42),Medical Supplies Charged to Patients (D3_SNF_C2_71),"PAID HOURS RELATED TO SALARIES, Home Office:  Physician Part A (S3_2_C5_15)","AVERAGE HOURLY WAGE, Laundry and Linen Service (S3_2_C6_31)",Burn Intensive Care Unit (D_1_HOS_C4_33),Medicare allowable bad debts for the entire hospital complex (S10_C1_2701),Cardiac Catheterization (D_4_HOS_C4_59),RHC/FQHC Combined (S3_1_C6_26),"PAID HOURS RELATED TO SALARIES, Cafeteria (S3_2_C5_36)","TOTAL CAPITAL COSTS AFTER COST ALLOCATION, Coronary Care Unit (B_2_C26_32)",Other Outpatient Services (D_4_HOS_C12_93),"ADJUSTED SALARIES, Contract Labor:  Physician Part A (S3_2_C4_13)",Observation Beds (Distinct Unit) (D3_IPF_C3_9201),Nursery (S3_1_C8_13),Sale of drugs to other than patients (A8_C2_17),Other Special Care (S3_1_C8_12),Medical Supplies Charged to Patients (D_4_HOS_C10_71),Total (D_4_IPF_C13_200),"PAID HOURS RELATED TO SALARIES, Management and Administrative Services (S3_2_C5_12)","AMOUNT REPORTED, Social Service (S3_2_C2_42)",NF (S3_1_C2_20),Respiratory Therapy (D_4_HOS_C11_65),Intensive Care Unit (D3_HOS_C2_31),Social Service (A_C1_17),RHC 5 Provider Number (S2_1_C2_1504),Intensive Care Unit (A_C1_31),Other Nonreimbursable (B_1_C21_194),FQHC (B_1_C26_89),Cardiac Catheterization (D3_HOS_C3_59),Speech Pathology (D_4_HOS_C4_68),"COST SERVICES SUBJECT TO DEDUCTIBLES AND COINSURANCE - COST, Other Ancillary (D_5_HOS_C6_76)",ASC (Non Distinct Part) (B_1_C22_75),OLTC (S3_1_C2_21),"HHA I, PEP Episodes:  Other Charges (S4_HHA1_C4_34)",Radioisotope (D_4_HOS_C11_56),"PPS REIMBURSED SERVICES -  CHARGES, Anesthesiology (D_5_HOS_C2_53)","PAID HOURS RELATED TO SALARIES, Social Service (S3_2_C5_42)",OSP (B_1_C26_9940),"Purchases, Building Improvements (A7_1_C2_4)","Allocation of Interns & Residents Program Costs, Subprovider-IRF (B_1_C22_41)",Speech Pathology (A_C1_68),"HHA III, Without Outliers:  Total Charges (S4_HHA3_C1_35)",Speech Pathology (D3_IRF_C2_68),Recovery Room (D_4_HOS_C4_51),Renal 2 Provider Number (S2_1_C2_1801),Hospital Adults & Pediatrics (S3_1_C7_1),"Allocation of Interns & Residents Program Costs, Whole Blood & Packed Red Blood Cells (B_1_C22_62)",Research (B_1_C26_191),HHA (A_C6_101),Subprovider-IPF (A_C1_40),Medical Supplies Charged to Patients (D3_IPF_C2_71),OLTC (B_1_C26_46),Delivery Room and Labor Room (D3_SNF_C3_52),"Net Expense for Cost Allocation, Islet Acquisition (B_1_C0_111)",Administrative and General (A_C1_5),Operation of Plant (A_C6_7),Subprovider-IRF (D_3_HOS_C9_41),Durable Medical Equipment Rented (A_C2_96),"COST REIMBURSED SERVICES SUBJECT TO DEDUCTIBLES  AND COINSURANCE - CHARGES, Clinic (D_5_HOS_C3_90)","TOTAL CAPITAL COSTS AFTER COST ALLOCATION, Whole Blood & Packed Red Blood Cells (B_2_C26_62)",Nursery (S3_1_C5_13),"AMOUNT REPORTED, Medical Records & Med Records Library (S3_2_C2_41)",FQHC (C_1_C7_89),"Medicare certified kidney 
transplant center cert date (S2_1_C1_126)",City (S2_1_C1_143),"HHA I, Without Outliers:  Non Routine Med Sup Chgs (S4_HHA1_C1_38)",Speech Pathology (D_4_HOS_C11_68),"Allocation of Interns & Residents Salary and Fringes, Radioisotope (B_1_C21_56)","Net Expense for Cost Allocation, OPT (B_1_C0_9920)",Coronary Care Unit (D3_HOS_C2_32),IPF (S3_1_C7_16),Lung  Acquisition (A_C1_108),"Net Expense for Cost Allocation, Blood Storing, Processing, Trans (B_1_C0_63)","Net Expense for Cost Allocation, CMHC (B_1_C0_99)",Home Program Dialysis (B_1_C26_94),"Net Expense for Cost Allocation, Subprovider II (B_1_C0_4201)","COST REIMBURSED SERVICES SUBJECT TO DEDUCTIBLES  AND COINSURANCE - CHARGES, Anesthesiology (D_5_HOS_C3_53)","COST REIMBURSED SERVICES SUBJECT TO DEDUCTIBLES  AND COINSURANCE - CHARGES, Medical Supplies Charged to Patients (D_5_HOS_C3_71)",Renal Dialysis (C_1_C6_74),Total Fixed Assets (G_C1THRU4_30),CMHC (A_C1_99),Recovery Room (D_4_HOS_C3_51),"AMOUNT REPORTED, Physician Part A Teaching (S3_2_C3_2201)",Respiratory Therapy (D_4_HOS_C1_65),RHC/FQHC Combined (S3_1_C7_26),ASC (Non Distinct Part) (D_4_IRF_C11_75),SNF (S3_1_C11_19),In State Medicaid eligible days (S2_1_C2_24),"Allocation of Interns & Residents Salary and Fringes, NF (B_1_C21_45)",OSP (C_1_C5_9940),Respiratory Therapy (B_1_C26_65),Anesthesiology (D_4_HOS_C11_53),Occupational Therapy (C_1_C6_67),Hospital Adults & Pediatrics (S3_1_C4_1),Ambulance Services (B_1_C26_95),Subprovider 2 (S3_1_C3_1801),"Fully Depreciated Assets, Total (A7_1_C4_7)",OPT (A_C2_9920),Other Special Purpose (A_C6_117),Physical Therapy (D_4_IRF_C13_66),Program Inpatient Ancillary Service Cost (D1_HOS_C1_48),Nursery (B_1_C26_43),Drugs Charged to Patients (D3_SNF_C2_73),Physical Therapy (D3_SNF_C3_66),Durable Medical Equipment Rented (D3_SNF_C3_96),Renal 3 Provider Number (S2_1_C2_1802),"Allocation of Interns & Residents Salary and Fringes, Medical Supplies Charged to Patients (B_1_C21_71)",Other Reimbursable (D_4_HOS_C13_98),"PPS SERVICES COST, Electroencephalography (D_5_HOS_C5_70)",Balance due provider/program (E_B_HOS_C1_43),Kidney Acquisition (B_1_C22_105),Target Amount (D1_HOS_C1_56),"AVERAGE HOURLY WAGE, Pharmacy (S3_2_C6_40)",ICF (S3_1_C8_2001),Intensive Care Unit (S3_1_C8_8),CT Scan (D_4_HOS_C12_57),"HHA III, Total Other Charges (S4_HHA3_C5_34)",ASC (Non Distinct Part) (C_1_C6_75),Other Ancillary (D_4_HOS_C13_76),Intravenous Therapy (D_4_HOS_C3_64),"PPS SERVICES COST, Laboratory (D_5_HOS_C5_60)","COST SERVICES SUBJECT TO DEDUCTIBLES AND COINSURANCE - COST, Whole Blood & Packed Red Blood Cells (D_5_HOS_C6_62)",Other Organ Acquisition (B_1_C21_112),"Net Expense for Cost Allocation, OLTC (B_1_C0_46)",Whole Blood & Packed Red Blood Cells (D_4_IRF_C13_62),FQHC (B_1_C22_89),Anesthesiology (D3_IRF_C3_53),Primary payer payments (E_B_HOS_C1_31),Physical Therapy (D_4_HOS_C2_66),"HHA II, PEP:  Total Non Routine Med Supply Chgs (S4_HHA2_C4_38)",MRI (D_4_SNF_C11_58),"Net Expense for Cost Allocation, Total (B_1_C0_200)",Cardiac Catheterization (B_1_C26_59),"COST REIMBURSED SERVICES SUBJECT TO DEDUCTIBLES  AND COINSURANCE - CHARGES, Physical Therapy (D_5_HOS_C3_66)","COST SERVICES SUBJECT TO DEDUCTIBLES AND COINSURANCE - COST, Speech Pathology (D_5_HOS_C6_68)",Emergency (B_2_C26_91),Total Program Excludable Costs (D1_IPF_C1_52),"Net Expense for Cost Allocation, Drugs Charged to Patients (B_1_C0_73)",Radiology-Therapeutic (D_4_HOS_C4_55),"Total Outpatient Charges, Radioisotope (C_1_C7_56)","ADJUSTED SALARIES, Subtotal Salaries (S3_3_C4_3)",Electroencephalography (D_4_HOS_C11_70),CAH Visits (S3_1_C8_15),Occupational Therapy (D_4_SNF_C11_67),Intensive Care Unit (D3_IPF_C2_31),Other Current Liabilities (G_C1THRU4_44),"Blood Storing, Processing, Trans (A_C6_63)",Observation Beds (Distinct Unit) (D_4_HOS_C12_9201),"Total Outpatient Charges, Radiology-Therapeutic (C_1_C7_55)",Medical Supplies Charged to Patients (D_4_HOS_C3_71),Emergency (D_4_IPF_C13_91),RHC/FQHC Combined (S3_1_C8_26),Physical Therapy (D3_SNF_C2_66),Pancreas Acquisition (C_1_C5_109),"ADJUSTED SALARIES, Excluded Area Salaries (S3_2_C4_10)",Hospital Adults & Pediatrics (S3_1_C6_1),Cardiac Catheterization (A_C1_59),Subprovider-IRF (D3_IPF_C2_41),Laboratory (D3_IRF_C3_60),MRI (A_C1_58),Interns & Res Salary and Fringe Benefits (A_C2_21),"AMOUNT REPORTED, Excluded Area Salaries (S3_2_C2_10)",Respiratory Therapy (D_4_HOS_C13_65),RHC 16 Provider Number (S2_1_C2_1515),"Net Expense for Cost Allocation, NF (B_1_C0_45)",Radiology-Diagnostic (D_4_HOS_C10_54),ASC (Distinct Part) (B_1_C21_115),Anesthesiology (D_4_IPF_C13_53),Total Nonphysician Anesthetist Cost (D_4_IPF_C1_200),Renal Dialysis (B_1_C22_74),Radioisotope (D3_IRF_C2_56),Pancreas Acquisition (C_1_C6_109),Radiology-Therapeutic (D3_SNF_C2_55),Durable Medical Equipment Sold (D3_HOS_C3_97),"Allocation of Interns & Residents Salary and Fringes, Subprovider I (B_1_C21_42)",Anesthesiology (D_4_HOS_C1_53),"COST REIMBURSED SERVICES NOT SUBJECT TO DEDUCTIBLES AND COINSURANCE - CHARGES, Intravenous Therapy (D_5_HOS_C4_64)",Surgical Intensive Care Unit (D3_SNF_C2_34),ASC (Non Distinct Part) (D_4_HOS_C4_75),Heart Acquisition (B_1_C26_106),"AVERAGE HOURLY WAGE, Social Service (S3_2_C6_42)",Beginning Date of SCH status (S2_1_C1_3601),"Net Expense for Cost Allocation, Kidney Acquisition (B_1_C0_105)","Total Inpatient Charges, Subprovider II (C_1_C6_4201)",RHC (B_2_C26_88),"Blood Storing, Processing, Trans (D_4_HOS_C2_63)","ADJUSTED SALARIES, Wage Related Costs RHC/FQHC (S3_2_C4_24)","Number of patients in program at 
end of cost reporting period (S5_C4_1)","Fully Depreciated Assets, Donations (A7_1_C3_7)",Clinic (B_1_C26_90),Radioisotope (A_C2_56),Total Allied Health (D_4_IPF_C3_200),Int & Res (non approved teaching program (B_1_C26_100),Home Program Dialysis (D3_IRF_C2_94),Other Reimbursable (B_1_C22_98),Speech Pathology (D3_IPF_C2_68),Burn Intensive Care Unit (C_1_C5_33),"COST SERVICES NOT SUBJECT TO DEDUCTIBLES AND COINSURANCE - COST, Intravenous Therapy (D_5_HOS_C7_64)",Coronary Intensive Care Unit (D_1_HOS_C4_32),RHC 19 Provider Number (S2_1_C2_1518),MRI (D3_IPF_C3_58),"HHA III, LUPA Episodes:  Total Visits (S4_HHA3_C3_33)",Ambulance Services (B_1_C22_95),Total discharges (S3_1_C15_16),"COST REIMBURSED SERVICES NOT SUBJECT TO DEDUCTIBLES AND COINSURANCE - CHARGES, Delivery Room and Labor Room (D_5_HOS_C4_52)",Speech Pathology (D3_HOS_C3_68),Subprovider I (C_1_C5_42),FI/Contractor's Name (S2_1_C2_140),"ADJUSTED SALARIES, Dietary under contract (S3_2_C4_35)","Fully Depreciated Assets, Purchase (A7_1_C2_7)",Other Outpatient Services (D3_IRF_C3_93),Beginning Date of SCH status (S2_1_C1_36),Physicians' Private Office (A_C1_192),"ADJUSTED SALARIES, Interns & Residents (S3_2_C4_2553)",Heart Acquisition (C_1_C5_106),Total Hospital (S3_1_C4_7),FQHC 10 Provider Number (S2_1_C2_1609),Other Reimbursable (B_1_C21_98),"Allocation of Interns & Residents Program Costs, Radiology-Therapeutic (B_1_C22_55)",Durable Medical Equipment Sold (D_4_HOS_C2_97),MRI (D_4_IRF_C11_58),Operating Room (D3_HOS_C2_50),Lesser of cost or charges (E_B_HOS_C1_21),Radiology-Therapeutic (D3_IPF_C2_55),Depreciation-New Bldgs & Fixtures (A8_C2_26),Clinic (D_4_IPF_C13_90),MRI (D_4_IPF_C13_58),Intravenous Therapy (D3_HOS_C3_64),Surgical Intensive Care Unit (D3_IPF_C2_34),"AMOUNT REPORTED, Housekeeping under contract (S3_2_C2_33)",FQHC 5 Provider Number (S2_1_C2_1604),Delivery Room and Labor Room (D_4_HOS_C10_52),Renal Dialysis (D_4_HOS_C13_74),Impl. Dev. Charged to Patients (D_4_HOS_C4_72),"Blood Storing, Processing, Trans (D_4_HOS_C13_63)",NF (S3_1_C11_20),OLTC (S3_1_C11_21),Other Reimbursable (A_C6_98),Heart Acquisition (B_2_C26_106),Renal Dialysis (D_4_IPF_C13_74),Anesthesiology (D_4_IRF_C13_53),"HHA III, PEP Episodes:  Total Number of Episodes (S4_HHA3_C4_36)",Operating Room (D_4_HOS_C13_50),Liver Acquisition (B_1_C21_107),Total (D_4_SNF_C13_200),Medicaid charges (S10_C1_6),"HHA III, PEP:  Total Number of Outlier Episodes (S4_HHA3_C4_37)","COST SERVICES SUBJECT TO DEDUCTIBLES AND COINSURANCE - COST, Total (D_5_HOS_C6_200)",Observation Beds (Distinct Unit) (D_4_IRF_C11_9201),Rental of quarters to employee and oths (A8_C2_15),"Net Expense for Cost Allocation, Recovery Room (B_1_C0_51)","Total Outpatient Charges, Anesthesiology (C_1_C7_53)",OPPS payments (E_B_HOS_C1_3),HMO (S3_1_C7_2),Renal Dialysis (D3_HOS_C3_74),Other Special Care Unit (D3_IRF_C2_35),Electroencephalography (B_2_C26_70),"AMOUNT REPORTED, Subtotal Salaries (S3_3_C2_3)","TOTAL CAPITAL COSTS AFTER COST ALLOCATION, Subprovider-IRF (B_2_C26_41)","ADJUSTED SALARIES, Non-Physician Anesthetist Part A (S3_2_C4_2)",Heart Acquisition (C_1_C6_106),Employee Benefits (A_C6_4),Intravenous Therapy (C_1_C5_64),"Allocation of Interns & Residents Program Costs, Coronary Care Unit (B_1_C22_32)",Investment Income-New Movable Equip (A8_C2_2),Ambulance Trips (S3_1_C6_29),Electrocardiology (D_4_IPF_C13_69),Interns & Res Other Program Costs (A_C1_22),"COST REIMBURSED SERVICES SUBJECT TO DEDUCTIBLES  AND COINSURANCE - CHARGES, ASC (Non Distinct Part) (D_5_HOS_C3_75)",Target Amount per Discharge (D1_HOS_C1_55),Emergency (D_4_HOS_C2_91),"PPS REIMBURSED SERVICES -  CHARGES, Recovery Room (D_5_HOS_C2_51)","Insurance, New Cap Related Csts Movable Equipment (A7_3_C5_2)",Hospital Adlts & Ped Swing Bed SNF (S3_1_C8_5),Other Special Care Unit (A_C1_35),Whole Blood & Packed Red Blood Cells (A_C2_62),Speech Pathology (D_4_HOS_C13_68),Hospice (C_1_C6_116),"COST REIMBURSED SERVICES SUBJECT TO DEDUCTIBLES  AND COINSURANCE - CHARGES, Electroencephalography (D_5_HOS_C3_70)","COST REIMBURSED SERVICES NOT SUBJECT TO DEDUCTIBLES AND COINSURANCE - CHARGES, Recovery Room (D_5_HOS_C4_51)",Renal 6 Provider Number (S2_1_C2_1805),ASC (Non Distinct Part) (D3_HOS_C3_75),Subprovider 1 (S3_1_C7_18),CT Scan (B_1_C26_57),RHC (C_1_C5_88),ASC (Non Distinct Part) (D3_IPF_C2_75),Nonphysician Anesthetists (A_C2_19),"Beginning Balances, Land Improvements (A7_1_C1_2)",Central Services and Supply (A_C6_14),"AVERAGE HOURLY WAGE, Medical Records & Med Records Library (S3_2_C6_41)","Disposals and Retirements, Building Improvements (A7_1_C5_4)",Total Other Assets (G_C1THRU4_35),"Allocation of Interns & Residents Salary and Fringes, Coronary Care Unit (B_1_C21_32)","PPS SERVICES COST, Medical Supplies Charged to Patients (D_5_HOS_C5_71)",Blood Clotting Factors for Hemoph. (A_C2_6250),Occupational Therapy (D_4_IRF_C11_67),Maintenance of Personnel (A_C2_12),Pharmacy (A_C1_15),Other Special Purpose (B_1_C22_117),Radiology-Diagnostic (D3_IRF_C2_54),SNF (A_C6_44),"Total Inpatient Charges, NF (C_1_C6_45)",Renal 7 Provider Number (S2_1_C2_1806),Radioisotope (D3_IRF_C3_56),"Interest, New Cap Related Csts Bldg & Fixtures (A7_3_C11_1)","ADJUSTED SALARIES, Management and Administrative Services (S3_2_C4_12)",Medicare reimbursable bad debts for the entire hospital complex (S10_C1_27),Delivery Room and Labor Room (B_1_C26_52),"HHA III, Total Charges (S4_HHA3_C5_35)",Surgical Intensive Care Unit (D_3_HOS_C9_34),Recovery Room (D3_IRF_C2_51),"TOTAL CAPITAL COSTS AFTER COST ALLOCATION, Anesthesiology (B_2_C26_53)","Allocation of Interns & Residents Salary and Fringes, Respiratory Therapy (B_1_C21_65)",Home Program Dialysis (A_C6_94),Temporary Investments (G_C1THRU4_2),Intravenous Therapy (C_1_C7_64),Other Special Care Unit (D_1_HOS_C6_35),Intensive Care Unit (A_C2_31),Recovery Room (D_4_SNF_C11_51),Medicaid (Title XIX) discharges (S3_1_C14_18),Hospice (S3_1_C3_24),"COST SERVICES NOT SUBJECT TO DEDUCTIBLES AND COINSURANCE - COST, Laboratory (D_5_HOS_C7_60)",Cardiac Catheterization (A_C2_59),"PAID HOURS RELATED TO SALARIES, Maintenance of Personnel (S3_2_C5_37)","Medical certified lung
transplant center cert date (S2_1_C1_129)","Allocation of Interns & Residents Salary and Fringes, Adults and Pediatrics (B_1_C21_30)","Allocation of Interns & Residents Program Costs, Nursery (B_1_C22_43)",Inpatient Revenue (G2_C1_28),Title V discharges (S3_1_C12_14),Operating Room (D3_IPF_C2_50),"COST REIMBURSED SERVICES SUBJECT TO DEDUCTIBLES  AND COINSURANCE - CHARGES, Drugs Charged to Patients (D_5_HOS_C3_73)",Impl. Dev. Charged to Patients (D_4_IRF_C13_72),Delivery Room and Labor Room (D3_IPF_C2_52),"AMOUNT REPORTED, Physician Part A (S3_2_C2_2201)",Housekeeping (A_C1_9),New Capital Buildings and Fixtures (A_C2_1),Recovery Room (D3_IPF_C2_51),Ambulance Services (A_C2_95),"AMOUNT REPORTED, Related  Salaries (S3_2_C2_1402)","COST SERVICES NOT SUBJECT TO DEDUCTIBLES AND COINSURANCE - COST, Observation Beds (Distinct Unit) (D_5_HOS_C7_9201)","HHA III, With Outliers:  Non Routine Med Sup Chgs (S4_HHA3_C2_38)",Physical Therapy (D_4_HOS_C4_66),Program Discharges (D1_HOS_C1_54),Nonphysician Anesthetists (A_C1_19),Clinic (D3_HOS_C3_90),Whole Blood & Packed Red Blood Cells (D_4_HOS_C10_62),Subprovider II (A_C1_4201),HHA (S3_1_C8_22),"TOTAL CAPITAL COSTS AFTER COST ALLOCATION, Delivery Room and Labor Room (B_2_C26_52)",Total reasonable charges (E_B_HOS_C1_14),Total discharges (S3_1_C15_21),Labor and Delivery Days Title 18 (S3_1_C6_32),"Donations, Movable Equipment (A7_1_C3_6)","PPS REIMBURSED SERVICES -  CHARGES, Emergency (D_5_HOS_C2_91)",Operating Room (D_4_HOS_C4_50),"Net Expense for Cost Allocation, Emergency (B_1_C0_91)",Int & Res (non approved teaching program (B_1_C22_100),"PPS REIMBURSED SERVICES -  CHARGES, Radiology-Diagnostic (D_5_HOS_C2_54)","COST REIMBURSED SERVICES NOT SUBJECT TO DEDUCTIBLES AND COINSURANCE - CHARGES, Speech Pathology (D_5_HOS_C4_68)","HHA I, With Outliers:  Total Charges (S4_HHA1_C2_35)",HVBP payment adjustment amount (E_A_HOS_C1_7093),"TOTAL CAPITAL COSTS AFTER COST ALLOCATION, Recovery Room (B_2_C26_51)",Islet Acquisition (B_2_C26_111),"Net Expense for Cost Allocation, HHA (B_1_C0_101)","Treatment capacity per day per
station (S5_C2_7)",RHC 13 Provider Number (S2_1_C2_1512),Emergency (D_4_HOS_C10_91),"ADJUSTED SALARIES, Teaching Physician Salaries (S3_2_C4_16)",Drugs Charged to Patients (D_4_SNF_C11_73),Cardiac Catheterization (D_4_IRF_C13_59),RHC 23 Provider Number (S2_1_C2_1522),"PAID HOURS RELATED TO SALARIES, Central Services and Supply (S3_2_C5_39)","Allocation of Interns & Residents Program Costs, Blood Storing, Processing, Trans (B_1_C22_63)",OPT (A_C1_9920),"Net Expense for Cost Allocation, Blood Clotting Factors for Hemoph. (B_1_C0_6250)",Electroencephalography (C_1_C7_70),Electrocardiology (D_4_HOS_C1_69),Medicare Certified Lung TC term date (S2_1_C2_129),Maintenance and Repairs (A_C2_6),"AMOUNT REPORTED, Non-Physician Anesthetist Part B (S3_2_C2_3)","Net Expense for Cost Allocation, Administrative and General (B_1_C0_5)",Medical Supplies Charged to Patients (D_4_HOS_C11_71),"COST REIMBURSED SERVICES SUBJECT TO DEDUCTIBLES  AND COINSURANCE - CHARGES, Observation Beds (Distinct Unit) (D_5_HOS_C3_9201)","COST SERVICES NOT SUBJECT TO DEDUCTIBLES AND COINSURANCE - COST, Other Outpatient Services (D_5_HOS_C7_93)","ADJUSTED SALARIES, Teaching Physician Salaries (S3_2_C4_1601)",Medicare Certified Islet TC term date (S2_1_C2_132),Subprovider 2 (S3_1_C7_1801),Operating Room (B_1_C26_50),"Allocation of Interns & Residents Program Costs, Physical Therapy (B_1_C22_66)","Net Expense for Cost Allocation, Physicians' Private Office (B_1_C0_192)","Gift, Flower, Coffee Shop, Canteen (A_C6_190)",Negative Cost Centers (B_2_C26_201),Renal 9 Provider Number (S2_1_C2_1808),"PPS SERVICES COST, Blood Clotting Factors for Hemoph. (D_5_HOS_C5_6250)",Durable Medical Equipment Sold (A_C6_97),"Net Expense for Cost Allocation, Ambulance Services (B_1_C0_95)",Islet Acquisition (A_C1_111),Urban (1) or Rural (2) (S2_1_C1_27),Coronary Care Unit (S3_1_C6_9),"Donations, Buildings and Fixtures (A7_1_C3_3)","PAID HOURS RELATED TO SALARIES, Pharmacy (S3_2_C5_40)",Radiology-Therapeutic (D_4_HOS_C12_55),Burn Intensive Care Unit Program Cost (D1_HOS_C5_45),Nursery (S3_1_C7_13),"PAID HOURS RELATED TO SALARIES, Excluded Area Salaries (S3_2_C5_10)","COST SERVICES NOT SUBJECT TO DEDUCTIBLES AND COINSURANCE - COST, Renal Dialysis (D_5_HOS_C7_74)",Anesthesiology (D_4_HOS_C3_53),Operating Room (D_4_HOS_C1_50),"COST REIMBURSED SERVICES NOT SUBJECT TO DEDUCTIBLES AND COINSURANCE - CHARGES, Drugs Charged to Patients (D_5_HOS_C4_73)",Surgical Intensive Care Unit (S3_1_C2_11),Int & Res (non approved teaching program (C_1_C5_100),Laboratory (D_4_HOS_C2_60),TOTAL (D3_IRF_C3_200),Subprovider I (B_1_C26_42),Nonpaid Workers (B_1_C22_193),Speech Pathology (B_2_C26_68),"Donations, Fixed Equipment (A7_1_C3_5)",Recovery Room (D_4_IPF_C11_51),Intravenous Therapy (D_4_IPF_C13_64),Radiology-Therapeutic (D_4_HOS_C13_55),Other Ancillary (D3_IRF_C2_76),"COST SERVICES NOT SUBJECT TO DEDUCTIBLES AND COINSURANCE - COST, Emergency (D_5_HOS_C7_91)",ASC (Non Distinct Part) (D_4_HOS_C10_75),"Net Expense for Cost Allocation, Employee Benefits (B_1_C0_4)",Durable Medical Equipment Rented (D_4_HOS_C10_96),IPF (S3_1_C3_16),Intravenous Therapy (A_C2_64),"AMOUNT REPORTED, Home Office Salaries & Wage Related Csts (S3_2_C2_14)",Radiology-Therapeutic (C_1_C5_55),Medical Records and Medical Rec. Library (A_C1_16),"Blood Storing, Processing, Trans (D_4_SNF_C11_63)","COST SERVICES NOT SUBJECT TO DEDUCTIBLES AND COINSURANCE - COST, Physical Therapy (D_5_HOS_C7_66)",Operating Room (D_4_HOS_C2_50),Average times dialyzers re-used (S5_C2_9),CT Scan (D3_HOS_C2_57),Coronary Care Unit (D3_SNF_C2_32),"ADJUSTED SALARIES, Social Service (S3_2_C4_42)",Clinic (D_4_HOS_C10_90),Emergency (D_4_HOS_C13_91),Electroencephalography (D3_HOS_C2_70),RHC 21 Provider Number (S2_1_C2_1520),Radioisotope (D3_HOS_C3_56),"Net Expense for Cost Allocation, Subprovider-IRF (B_1_C0_41)",Physical Therapy (C_1_C2_66),Nonphysician Anesthetists (A_C6_19),RHC 25 Provider Number (S2_1_C2_1524),Total Costs (D_3_HOS_C5_200),Anesthesiology (D_4_HOS_C2_53),Cardiac Catheterization (D_4_HOS_C3_59),Renal Dialysis (A_C1_74),Physical Therapy (D3_HOS_C2_66),Total (D_4_IPF_C11_200),Major Movable Equipment (G_C1THRU4_23),Ending Date of SCH status (S2_1_C2_36),"HHA I, Without Outliers:  Total Visits (S4_HHA1_C1_33)",RHC 6 Provider Number (S2_1_C2_1505),Home Program Dialysis (C_1_C5_94),Hospice (B_2_C26_116),Electroencephalography (D_4_HOS_C10_70),IRF (S3_1_C7_17),Recovery Room (A_C1_51),Central Services and Supply (A_C2_14),Drugs Charged to Patients (B_2_C26_73),Total Facility FTEs (S3_1_C9_27),ASC (Non Distinct Part) (D_4_IRF_C13_75),Surgical Intensive Care Unit (A_C2_34),CORF (A_C2_9910),Drugs Charged to Patients (D3_HOS_C3_73),Liver Acquisition (A_C1_107),"ADJUSTED SALARIES, Subtotal Wage Related Csts (S3_3_C4_5)",Heart Acquisition (B_1_C21_106),"Allocation of Interns & Residents Salary and Fringes, Subprovider-IRF (B_1_C21_41)",Allowable Inpatient Cost Plus Incentive Pt (D1_HOS_C1_63),Total (B_1_C26_202),"COST SERVICES SUBJECT TO DEDUCTIBLES AND COINSURANCE - COST, Electrocardiology (D_5_HOS_C6_69)",Hospice (A_C2_116),"ADJUSTED SALARIES, Teaching Physician Salaries (S3_2_C4_1602)",Occupational Therapy (D3_IRF_C3_67),State (S2_1_C2_143),Electroencephalography (D_4_IPF_C13_70),HHA (S3_1_C10_22),"PPS SERVICES COST, Speech Pathology (D_5_HOS_C5_68)",MCP Physician Payment Method (Y/N) (S5_C1_21),Islet Acquisition (B_1_C22_111),"Net Expense for Cost Allocation, Other Special Care Unit (B_1_C0_35)",Int & Res (non approved teaching program (A_C1_100),Physical Therapy (D3_IPF_C2_66),Electrocardiology (D3_HOS_C2_69),Durable Medical Equipment Rented (D3_IRF_C3_96),Operating Room (D_4_IRF_C13_50),Physical Therapy (B_2_C26_66),Speech Pathology (D3_SNF_C3_68),"COST SERVICES NOT SUBJECT TO DEDUCTIBLES AND COINSURANCE - COST, Speech Pathology (D_5_HOS_C7_68)","COST REIMBURSED SERVICES NOT SUBJECT TO DEDUCTIBLES AND COINSURANCE - CHARGES, Total (D_5_HOS_C4_200)",Program Inpatient Ancillary Service Cost (D1_IRF_C1_48),"Allocation of Interns & Residents Program Costs, Speech Pathology (B_1_C22_68)",Other Ancillary (D_4_IRF_C13_76),Research (B_1_C21_191),Other Ancillary (D3_SNF_C2_76),Accounts Payable (G_C1THRU4_37),RHC 1 Provider Number (S2_1_C2_15),interns and residents (E_B_HOS_C1_28),"Purchases, Land (A7_1_C2_1)",Negative Cost Centers (B_1_C26_201),Organ Procurement (D4_LIVER_C1_69),Durable Medical Equipment Rented (D_4_HOS_C12_96),"Net Expense for Cost Allocation, Intestinal Acquisition (B_1_C0_110)",Islet Acquisition (A_C2_111),"AVERAGE HOURLY WAGE, Management and Administrative Services (S3_2_C6_12)",Respiratory Therapy (D3_IPF_C3_65),"PPS REIMBURSED SERVICES -  CHARGES, Electrocardiology (D_5_HOS_C2_69)",Total Swing Bed Cost (D1_HOS_C1_26),Physical Therapy (D3_IPF_C3_66),Drugs Charged to Patients (D3_IRF_C3_73),OPT (B_2_C26_9920),"ADJUSTED SALARIES, Laundry and Linen Service (S3_2_C4_31)",Hospice (S3_1_C8_24),Other Outpatient Services (B_1_C26_93),Anesthesiology (C_1_C5_53),"AVERAGE HOURLY WAGE, Interns & Residents (S3_2_C6_7)",Outlier payments (E_B_HOS_C101_4),Laboratory (D_4_HOS_C3_60),Subprovider-IRF (B_1_C26_41),"COST SERVICES SUBJECT TO DEDUCTIBLES AND COINSURANCE - COST, Anesthesiology (D_5_HOS_C6_53)",Whole Blood & Packed Red Blood Cells (D3_HOS_C3_62),Burn Intensive Care Unit (A_C1_33),"AVERAGE HOURLY WAGE, Related Salaries (S3_2_C6_1402)",Nursery (A_C6_43),"PPS REIMBURSED SERVICES -  CHARGES, Intravenous Therapy (D_5_HOS_C2_64)",Anesthesiology (D3_IPF_C2_53),Medical Records and Medical Rec. Library (A_C2_16),"PAID HOURS RELATED TO SALARIES, Admin & Gen Under Contract (S3_2_C5_29)",Interns & Res Other Program Costs (A_C6_22),Total Salaries (A_C6_200),"Total Inpatient Charges, Anesthesiology (C_1_C6_53)",CMHC (B_1_C22_99),"PAID HOURS RELATED TO SALARIES, Laundry and Linen Service (S3_2_C5_31)",Total (D_3_HOS_C9_200),Radioisotope (D_4_HOS_C2_56),Occupational Therapy (D_4_HOS_C2_67),Surgical Intensive Care Unit (B_1_C26_34),Title XVIII discharges (S3_1_C13_1),Observation Beds (Distinct Unit) (B_1_C21_9201),Surgical Intensive Care Unit (D_1_HOS_C4_34),Observation Beds (Distinct Unit) (D3_IRF_C3_9201),"Net Expense for Cost Allocation, Pharmacy (B_1_C0_15)","AMOUNT REPORTED, Home Office Personnel (S3_2_C2_8)","COST REIMBURSED SERVICES SUBJECT TO DEDUCTIBLES  AND COINSURANCE - CHARGES, Speech Pathology (D_5_HOS_C3_68)","PPS SERVICES COST, CT Scan (D_5_HOS_C5_57)",Other Special Purpose (B_1_C21_117),Surgical Intensive Care Unit (S3_1_C8_11),"PPS REIMBURSED SERVICES -  CHARGES, Physical Therapy (D_5_HOS_C2_66)",Islet Acquisition (C_1_C5_111),"COST SERVICES NOT SUBJECT TO DEDUCTIBLES AND COINSURANCE - COST, Radiology-Therapeutic (D_5_HOS_C7_55)","Number of patients in program at 
end of cost reporting period (S5_C2_1)","AVERAGE HOURLY WAGE, Maintenance of Personnel (S3_2_C6_37)",Other Outpatient Services (B_2_C26_93),Maintenance and Repairs (A_C6_6),FQHC 11 Provider Number (S2_1_C2_1610),Coronary Care Unit Program Cost (D1_HOS_C5_44),"AVERAGE HOURLY WAGE, Non-Physician Part B (S3_2_C6_6)",Liver Acquisition (C_1_C7_107),Whole Blood & Packed Red Blood Cells (D_4_SNF_C11_62),"Lease, Total (A7_3_C10_3)",Nonpaid Workers (B_2_C26_193),Nursery (C_1_C5_43),OSP (A_C1_9940),"AMOUNT REPORTED, Physician-Part B (S3_2_C2_5)",Electroencephalography (D3_SNF_C3_70),"ADJUSTED SALARIES, Other General Service (S3_2_C4_43)",Mortgage Payable (G_C1THRU4_46),Physical Therapy (B_1_C26_66),"Net Expense for Cost Allocation, Interns & Res Other Program Costs (B_1_C0_22)",Surgical Intensive Care Unit (D_1_HOS_C6_34),"Allocation of Interns & Residents Salary and Fringes, Operating Room (B_1_C21_50)","Allocation of Interns & Residents Program Costs, CT Scan (B_1_C22_57)",Emergency (A_C6_91),NF (A_C1_45),Hospice (S3_1_C9_24),"COST SERVICES SUBJECT TO DEDUCTIBLES AND COINSURANCE - COST, Respiratory Therapy (D_5_HOS_C6_65)",Speech Pathology (B_1_C26_68),Payments received from patients for amounts previously written off as charity care (S10_C3_22),"ADJUSTED SALARIES, Excluded Area Salaries (S3_3_C4_2)",Radiology-Diagnostic (D3_SNF_C3_54),"HHA I, LUPA Episodes:  Other Charges (S4_HHA1_C3_34)",Adults and Pediatrics (A_C1_30),Recovery Room (D_4_IRF_C11_51),"Donations, Land (A7_1_C3_1)","ADJUSTED SALARIES, Physician-Part A (S3_2_C4_4)",Pharmacy (A_C2_15),Respiratory Therapy (D_4_HOS_C10_65),Electroencephalography (D3_IRF_C3_70),Other Nonreimbursable (B_2_C26_194),ASC (Non Distinct Part) (D_4_SNF_C11_75),Surgical Intensive Care Unit (S3_1_C3_11),Impl. Dev. Charged to Patients (C_1_C5_72),Deductibles and coinsurance (E_B_HOS_C1_25),ASC (Non Distinct Part) (D3_IRF_C2_75),Renal 4 Provider Number (S2_1_C2_1803),Medical Supplies Charged to Patients (D_4_IRF_C11_71),Medical Supplies Charged to Patients (C_1_C5_71),Burn Intensive Care Unit (A_C2_33),"PPS SERVICES COST, Occupational Therapy (D_5_HOS_C5_67)",Drugs Charged to Patients (C_1_C7_73),Impl. Dev. Charged to Patients (B_1_C26_72),Subprovider-IPF (D_1_HOS_C7_40),Electroencephalography (D3_IPF_C2_70),"Beginning Balances, Subtotal (A7_1_C1_8)","AVERAGE HOURLY WAGE, Cafeteria (S3_2_C6_36)","PAID HOURS RELATED TO SALARIES, Subtotal Salaries (S3_3_C5_3)",Medical Supplies Charged to Patients (D3_HOS_C2_71),Radiology-Diagnostic (D_4_HOS_C12_54),"COST SERVICES SUBJECT TO DEDUCTIBLES AND COINSURANCE - COST, Durable Medical Equipment Rented (D_5_HOS_C6_96)",Nonpaid Workers (A_C2_193),Central Services and Supply (A_C1_14),Radioisotope (D_4_HOS_C4_56),"Total Inpatient Charges, Delivery Room and Labor Room (C_1_C6_52)",OPT (B_1_C26_9920),"Gift, Flower, Coffee Shop, Canteen (B_1_C21_190)","Allocation of Interns & Residents Salary and Fringes, Intensive Care Unit (B_1_C21_31)",Hospital Adults & Pediatrics (S3_1_C3_1),SNF (S3_1_C10_19),Other General Service (A_C2_18),Physicians' Private Office (B_1_C22_192),Surgical Intensive Care Unit (A_C6_34),"PPS REIMBURSED SERVICES -  CHARGES, Other Outpatient Services (D_5_HOS_C2_93)","AMOUNT REPORTED, Home Office Salaries (S3_2_C2_1401)","PAID HOURS RELATED TO SALARIES, Housekeeping (S3_2_C5_32)",Total Hospital (S3_1_C3_14),ESRD DME costs (E_B_HOS_C1_29),Emergency (C_1_C6_91),Observation Beds (Distinct Unit) (D_4_HOS_C10_9201),Renal Dialysis (D_4_IPF_C11_74),CT Scan (D3_SNF_C2_57),"COST REIMBURSED SERVICES SUBJECT TO DEDUCTIBLES  AND COINSURANCE - CHARGES, Operating Room (D_5_HOS_C3_50)","COST REIMBURSED SERVICES SUBJECT TO DEDUCTIBLES  AND COINSURANCE - CHARGES, Durable Medical Equipment Rented (D_5_HOS_C3_96)","Total Outpatient Charges, Laboratory (C_1_C7_60)",Hospice 1 Provider Number (S2_1_C2_14),"AVERAGE HOURLY WAGE, Excluded Area Salaries (S3_2_C6_10)",Total Other Medical Education (D_4_HOS_C4_200),"Taxes, Total (A7_3_C6_3)","COST REIMBURSED SERVICES NOT SUBJECT TO DEDUCTIBLES AND COINSURANCE - CHARGES, Medical Supplies Charged to Patients (D_5_HOS_C4_71)",Speech Pathology (C_1_C6_68),"AMOUNT REPORTED, Teaching Physician Salaries (S3_2_C2_16)","Beginning Balances, Building Improvements (A7_1_C1_4)",PBP Clinical Lab Services Program Only (D3_HOS_C2_61),Hospital Adults & Pediatrics (S3_1_C5_1),Other Special Purpose (A_C1_117),Parking Lot (A8_C2_9),Speech Pathology (D3_IPF_C3_68),HHA (S3_1_C9_22),Nursing Administration (A_C2_13),"HHA I, PEP Episodes:  Total Charges: (S4_HHA1_C4_35)","Number of patients in program at 
end of cost reporting period (S5_C6_1)",Operating Room (D3_SNF_C2_50),Recovery Room (D_4_IRF_C13_51),"AMOUNT REPORTED, Physician-Part A (S3_2_C2_4)","Net Expense for Cost Allocation, Home Program Dialysis (B_1_C0_94)",Report Status Code (RPT_STUS_CD),Unsecured Loans (G_C1THRU4_48),"COST REIMBURSED SERVICES NOT SUBJECT TO DEDUCTIBLES AND COINSURANCE - CHARGES, Blood Clotting Factors for Hemoph. (D_5_HOS_C4_6250)",Observation Beds (Distinct Unit) (B_2_C26_9201),Radioisotope (D_4_IPF_C11_56),"Disposals and Retirements, Building Improvements (A7_1_C7_4)",IPF (S3_1_C8_16),Other Outpatient Services (A_C1_93),Total Salaries (A_C2_200),Total (D_4_SNF_C11_200),Other Organ Acquisition (B_2_C26_112),"AMOUNT REPORTED, Operation of Plant (S3_2_C2_30)",Medical Supplies Charged to Patients (D_4_SNF_C11_71),Total Program General Inp. Rtn Service (D1_SNF_C1_74),Hospital Zip Code (S2_1_C3_2),"HHA III, Total Number of Outlier Episodes (S4_HHA3_C5_37)","Net Expense for Cost Allocation, Radiology-Diagnostic (B_1_C0_54)",CT Scan (D3_IRF_C3_57),"ADJUSTED SALARIES, Physician Part A (S3_2_C4_22)","Taxes, New Cap Related Csts Movable Equipment (A7_3_C6_2)","ADJUSTED SALARIES, Net Salaries (S3_3_C4_1)","Allocation of Interns & Residents Salary and Fringes, Subprovider-IPF (B_1_C21_40)",Electrocardiology (D3_IRF_C2_69),Clinic (D3_IRF_C2_90),Electroencephalography (D_4_HOS_C13_70),FQHC (A_C2_89),Intestinal Acquisition (C_1_C7_110),CT Scan (A_C2_57),"AVERAGE HOURLY WAGE, Subtotal Other Wages and Related Csts (S3_3_C6_4)","Fully Depreciated Assets, Assets (A7_1_C7_7)",Burn Intensive Care Unit (S3_1_C6_10),Speech Pathology (D_4_SNF_C11_68),FQHC (D_4_HOS_C3_89),CT Scan (D_4_HOS_C4_57),Laboratory (D3_HOS_C2_60),Total Outpatient Program Pass Thru Cost (D_4_IPF_C6_200),"Net Expense for Cost Allocation, ICF (B_1_C0_4501)",Physicians' Private Office (A_C2_192),Occupational Therapy (D3_HOS_C3_67),"AVERAGE HOURLY WAGE, Home Office:  Physician Part A (S3_2_C6_15)",MRI (D_4_IPF_C11_58),"Fully Depreciated Assets, Ending Balance (A7_1_C6_7)","COST REIMBURSED SERVICES SUBJECT TO DEDUCTIBLES  AND COINSURANCE - CHARGES, Intravenous Therapy (D_5_HOS_C3_64)",Average times dialyzers re-used (S5_C1_9),"PPS SERVICES COST, Impl. Dev. Charged to Patients (D_5_HOS_C5_72)","PPS SERVICES COST, Other Outpatient Services (D_5_HOS_C5_93)",ICF (C_1_C5_4501),"Disposals and Retirements, Land (A7_1_C7_1)",Other Ancillary (B_1_C21_76),"COST SERVICES NOT SUBJECT TO DEDUCTIBLES AND COINSURANCE - COST, Delivery Room and Labor Room (D_5_HOS_C7_52)","ADJUSTED SALARIES, Interns & Residents (S3_2_C4_2550)",Radiology-Diagnostic (D_4_HOS_C11_54),MRI (D_4_HOS_C11_58),Total Other Expenses (G3_C1_28),"Average patient dialysis time 
including setup (S5_C1_3)","Net Expense for Cost Allocation, Electrocardiology (B_1_C0_69)",Blood Clotting Factors for Hemoph. (A_C6_6250),CT Scan (D_4_HOS_C3_57),"PAID HOURS RELATED TO SALARIES, Interns & Residents (S3_2_C5_7)",SNF (S3_1_C6_19),"AVERAGE HOURLY WAGE, Central Services and Supply (S3_2_C6_39)",HHA (B_1_C21_101),Hospice (A_C1_116),Other Special Care Unit (B_1_C26_35),"AMOUNT REPORTED, Interns & Residents (S3_2_C2_2553)",Total (D_4_IRF_C13_200),"ADJUSTED SALARIES, Contract Labor (S3_2_C4_11)",Radiology-Diagnostic (A_C6_54),ASC (Non Distinct Part) (D_4_HOS_C12_75),ASC (Non Distinct Part) (D3_SNF_C3_75),Other Outpatient Services (D3_IPF_C2_93),Other Reimbursable (D3_IPF_C3_98),PBP Clinical Lab Services Program Only (A_C2_61),"Net Expense for Cost Allocation, Speech Pathology (B_1_C0_68)",Organ acquisition charges (E_B_HOS_C1_13),Transitional corridor payment (E_B_HOS_C101_8),"HHA I, PEP:  Total Number of Outlier Episodes (S4_HHA1_C4_37)",Other Outpatient Services (D_4_HOS_C10_93),"COST REIMBURSED SERVICES NOT SUBJECT TO DEDUCTIBLES AND COINSURANCE - CHARGES, Emergency (D_5_HOS_C4_91)","ADJUSTED SALARIES, Non-Physician Anesthetist Part B (S3_2_C4_3)","Donations, Land Improvements (A7_1_C3_2)",RHC 2 Provider Number (S2_1_C2_1501),"Allocation of Interns & Residents Program Costs, Delivery Room and Labor Room (B_1_C22_52)",Report Record Number (RPT_REC_NUM),"PPS REIMBURSED SERVICES -  CHARGES, Durable Medical Equipment Sold (D_5_HOS_C2_97)",Interim payments (E_B_HOS_C1_41),"PPS SERVICES COST, Respiratory Therapy (D_5_HOS_C5_65)","AVERAGE HOURLY WAGE, Excluded Area Salaries (S3_3_C6_2)","COST SERVICES SUBJECT TO DEDUCTIBLES AND COINSURANCE - COST, Other Reimbursable (D_5_HOS_C6_98)",Outpatient Rehab Provider (S3_1_C11_25),"Allocation of Interns & Residents Salary and Fringes, Electroencephalography (B_1_C21_70)","AMOUNT REPORTED, Interns & Residents (S3_2_C3_25)",Ambulance Services (C_1_C6_95),FQHC 1 Provider Number (S2_1_C2_16),Radiology-Therapeutic (A_C6_55),Other Special Care (S3_1_C7_12),"ADJUSTED SALARIES, Non-Physician Anesthetist Part B (S3_2_C4_21)",Net Revenue from Medicaid (S10_C1_2),"Purchases, Buildings and Fixtures (A7_1_C2_3)",Medical Supplies Charged to Patients (D_4_IRF_C13_71),Total cost (E_B_HOS_C1_11),Electroencephalography (D_4_IRF_C11_70),OOT (C_1_C7_9930),"PPS SERVICES COST, Recovery Room (D_5_HOS_C5_51)","Beginning Balances, Buildings and Fixtures (A7_1_C1_3)",Home Program Dialysis (D3_IPF_C2_94),Title XVIII discharges (S3_1_C13_2),Total Program General Inpatient Routine (D1_IPF_C1_41),"COST SERVICES SUBJECT TO DEDUCTIBLES AND COINSURANCE - COST, Blood Clotting Factors for Hemoph. (D_5_HOS_C6_6250)",HHA (C_1_C6_101),Islet Acquisition (A_C6_111),"COST REIMBURSED SERVICES SUBJECT TO DEDUCTIBLES  AND COINSURANCE - CHARGES, Blood Clotting Factors for Hemoph. (D_5_HOS_C3_6250)","Sum of lines 3,4 divided by line 6 (E_B_HOS_C1_7)","COST SERVICES NOT SUBJECT TO DEDUCTIBLES AND COINSURANCE - COST, Blood Storing, Processing, Trans (D_5_HOS_C7_63)",IPPS Payment amount (unadjusted) (E_A_HOS_C1_59),Delivery Room and Labor Room (D3_SNF_C2_52),"HHA I, With Outliers:  Total Visits (S4_HHA1_C2_33)",Subprovider-IRF (A_C2_41),Electroencephalography (D3_IPF_C3_70),"PPS REIMBURSED SERVICES -  CHARGES, Renal Dialysis (D_5_HOS_C2_74)",Other Reimbursable (D_4_HOS_C11_98),"HHA III, PEP Episodes:  Total Charges: (S4_HHA3_C4_35)",Respiratory Therapy (D3_HOS_C3_65),HHA 1 Provider Number (S2_1_C2_12),Cost of patients approved for charity care and uninsured discounts (S10_C3_21),Hospital Name (S2_1_C1_3),Pancreas Acquisition (B_1_C26_109),"Total Inpatient Charges, Whole Blood & Packed Red Blood Cells (C_1_C6_62)",Operating Room (D_4_IPF_C13_50),NF Provider Number (S2_1_C2_10),"ADJUSTED SALARIES, Nursing Administration (S3_2_C4_38)",ASC (Non Distinct Part) (A_C2_75),"Blood Storing, Processing, Trans (D3_IPF_C3_63)",Other General Service (A_C6_18),Paramedical Education (A_C2_23),Total Program Inpatient Costs (D1_IPF_C1_49),"Total Inpatient Charges, Subprovider I (C_1_C6_42)",Operating Room (D3_IRF_C3_50),Coronary Care Unit (C_1_C5_32),IRF Provider Number (S2_1_C2_5),"Does this facility operate 
transplant center? (Y/N) (S2_1_C1_125)",Drugs Charged to Patients (D_4_IPF_C13_73),"PPS REIMBURSED SERVICES -  CHARGES, Occupational Therapy (D_5_HOS_C2_67)",Kidney Acquisition (A_C2_105),Clinic (B_1_C22_90),Electrocardiology (C_1_C5_69),"COST REIMBURSED SERVICES SUBJECT TO DEDUCTIBLES  AND COINSURANCE - CHARGES, Radioisotope (D_5_HOS_C3_56)","PAID HOURS RELATED TO SALARIES, Home Office Personnel (S3_2_C5_8)",Intensive Care Unit (B_1_C26_31),Fiscal Intermediary Number (FI_NUM),MRI (D_4_HOS_C10_58),Blood Clotting Factors for Hemoph. (D3_IRF_C2_6250),"Total Inpatient Charges, Subprovider-IRF (C_1_C6_41)",Deductibles and coinsurance related to line 24 (E_B_HOS_C1_26),Net Patient Revenue (G3_C1_3),Emergency (A_C1_91),Drugs Charged to Patients (C_1_C6_73),Coronary Intensive Care Unit (D_1_HOS_C7_32),Medical and Other Services reimbursed by OPPS (E_B_HOS_C101_2),"HHA II, With Outliers:  Non Routine Med Sup Chgs (S4_HHA2_C2_38)",OPPS payments (E_B_HOS_C101_3),Outpatient Rehab Provider (S3_1_C10_25),Radiology-Diagnostic (D_4_IRF_C13_54),Recovery Room (D_4_HOS_C10_51),Operating Room (A_C6_50),Self Insurance (S2_1_C3_11801),Electroencephalography (A_C2_70),Recovery Room (D_4_HOS_C2_51),Intensive Care Unit (C_1_C5_31),Cardiac Catheterization (D_4_IRF_C11_59),"Allocation of Interns & Residents Program Costs, Surgical Intensive Care Unit (B_1_C22_34)",certification date (S2_1_C1_131),Electrocardiology (D_4_HOS_C3_69),Hospice (C_1_C5_116),"Beginning Balances, Total (A7_1_C1_10)",OOT (C_1_C5_9930),Vending Machines (A8_C2_20),CORF (C_1_C7_9910),Subprovider-IRF (D3_IRF_C2_40),Payment to cost ratio (E_B_HOS_C1_5),Total Other Medical Education Cost (D_3_HOS_C3_200),ASC (Non Distinct Part) (C_1_C7_75),Subprovider-IRF (D_1_HOS_C7_41),Blood Clotting Factors for Hemoph. (D3_IRF_C3_6250),Adults and Pediatrics (D3_SNF_C2_30),"TOTAL CAPITAL COSTS AFTER COST ALLOCATION, CT Scan (B_2_C26_57)",Burn Intensive Care Unit (S3_1_C2_10),"Total Outpatient Charges, Radiology-Diagnostic (C_1_C7_54)",Total Assets (G_C1THRU4_36),"Net Expense for Cost Allocation, Adults and Pediatrics (B_1_C0_30)",Other Outpatient Services (D_4_IPF_C11_93),Subprovider-IPF (D3_SNF_C2_40),Is this a New Hospital under 42 CFR 413.40(f)(1)(I) (TEFRA)? (Y/N) (S2_1_C1_85),Other Outpatient Services (A_C6_93),"Donations, Subtotal (A7_1_C3_8)",Total charges to state or local government programs for indigent care (not Medicaid or CHIP) (S10_C1_14),"Taxes, New Cap Related Csts Bldg & Fixtures (A7_3_C6_1)","COST REIMBURSED SERVICES SUBJECT TO DEDUCTIBLES  AND COINSURANCE - CHARGES, Total (D_5_HOS_C3_200)",Swing Bed NF Provider Number (S2_1_C2_8),MRI (D3_SNF_C2_58),New Capital Equipment (A_C2_2),"COST REIMBURSED SERVICES SUBJECT TO DEDUCTIBLES  AND COINSURANCE - CHARGES, Home Program Dialysis (D_5_HOS_C3_94)",Durable Medical Equipment Sold (C_1_C5_97),"Total Inpatient Charges, Laboratory (C_1_C6_60)",Number of Times per week Patient receives Dialysis (S5_C1_2),Intensive Care Unit (S3_1_C3_8),Hospice (S3_1_C11_24),"Disposals and Retirements, Subtotal (A7_1_C5_8)",Physical Therapy (D_4_IPF_C11_66),Utilization Review-physicians compens (A8_C2_25),"TOTAL CAPITAL COSTS AFTER COST ALLOCATION, Radiology-Diagnostic (B_2_C26_54)",Intravenous Therapy (D_4_SNF_C11_64),"PAID HOURS RELATED TO SALARIES, Non-Physician Anesthetist Part A (S3_2_C5_2)","Allocation of Interns & Residents Program Costs, NF (B_1_C22_45)","COST REIMBURSED SERVICES SUBJECT TO DEDUCTIBLES  AND COINSURANCE - CHARGES, Renal Dialysis (D_5_HOS_C3_74)",Intravenous Therapy (D_4_HOS_C2_64),Adj for Speech therapy in excess of lim (A8_C2_31),Medical Supplies Charged to Patients (C_1_C7_71),Other Ancillary (D3_IPF_C3_76),Cost of physicians svcs in a teaching hospita (E_B_HOS_C1_23),"PPS REIMBURSED SERVICES -  CHARGES, Cardiac Catheterization (D_5_HOS_C2_59)","Total, New Cap Related Csts Movable Equipment (A7_3_C15_2)","If this facility qualifies as a RPCH/CAH, has it elected the all inclusive payment for outpatient service? (Y/N) (S2_1_C1_106)",Other Ancillary (D_4_IPF_C11_76),Recovery Room (B_1_C26_51),"ADJUSTED SALARIES, Related Salaries (S3_2_C4_1402)",Surgical Intensive Care Unit (S3_1_C4_11),Medical Supplies Charged to Patients (D_4_IPF_C11_71),Clinic (D_4_IPF_C11_90),Electrocardiology (D_4_HOS_C11_69),"PAID HOURS RELATED TO SALARIES, Total Overhead Costs (S3_3_C5_7)",Partial or full credits from manufacturers (E_B_HOS_C1_3998),Cost of charity care (patients covered by public program + patients w/ coverage accepted by provider) (S10_C2_23),"COST SERVICES SUBJECT TO DEDUCTIBLES AND COINSURANCE - COST, Physical Therapy (D_5_HOS_C6_66)",Radioisotope (D_4_HOS_C3_56),"Disposals and Retirements, Movable Equipment (A7_1_C7_6)",Total (D_4_HOS_C1_200),"ADJUSTED SALARIES, Physician Part B (S3_2_C4_23)",TOTAL (D3_SNF_C3_200),"Allocation of Interns & Residents Program Costs, Recovery Room (B_1_C22_51)",Drugs Charged to Patients (D_4_IPF_C11_73),"ADJUSTED SALARIES, Total Overhead Costs (S3_3_C4_7)",MRI (A_C6_58),Electroencephalography (D_4_HOS_C12_70),ICF (S3_1_C7_2001),Respiratory Therapy (D_4_HOS_C4_65),Pass through Cost for Program Inpatient (D1_IRF_C1_50),"ADJUSTED SALARIES, Cafeteria (S3_2_C4_36)","PPS REIMBURSED SERVICES -  CHARGES, Impl. Dev. Charged to Patients (D_5_HOS_C2_72)","Total Inpatient Charges, Operating Room (C_1_C6_50)",Durable Medical Equipment Rented (C_1_C6_96),Liver Acquisition (B_2_C26_107),Electrocardiology (D3_IPF_C2_69),Home Program Dialysis (A_C1_94),Physicians' Assistant (A8_C2_29),"TOTAL CAPITAL COSTS AFTER COST ALLOCATION, Radiology-Therapeutic (B_2_C26_55)",Coronary Care Unit (S3_1_C7_9),Other Ancillary (C_1_C5_76),"Total Inpatient Charges, Surgical Intensive Care Unit (C_1_C6_34)",Intestinal Acquisition (B_1_C22_110),"COST REIMBURSED SERVICES NOT SUBJECT TO DEDUCTIBLES AND COINSURANCE - CHARGES, Home Program Dialysis (D_5_HOS_C4_94)","TOTAL CAPITAL COSTS AFTER COST ALLOCATION, MRI (B_2_C26_58)",Subtotal (E_B_HOS_C1_40),Medicaid Shortfall -- Costs minus net revenue (0 min) (S10_C1_8),"AVERAGE HOURLY WAGE, Nursing Administration (S3_2_C6_38)",Cardiac Catheterization (D_4_IPF_C13_59),Medical Supplies Charged to Patients (D_4_HOS_C4_71),Drugs Charged to Patients (D3_IRF_C2_73),Coronary Care Unit (A_C2_32),Total (D_4_HOS_C11_200),"Net Expense for Cost Allocation, Liver Acquisition (B_1_C0_107)",Other Special Care Unit (D3_HOS_C2_35),"COST REIMBURSED SERVICES NOT SUBJECT TO DEDUCTIBLES AND COINSURANCE - CHARGES, Other Outpatient Services (D_5_HOS_C4_93)","TOTAL CAPITAL COSTS AFTER COST ALLOCATION, Subprovider-IPF (B_2_C26_40)",MRI (D3_HOS_C3_58),Other Nonreimbursable (A_C6_194),New Capital Equipment (A_C6_2),Title XVIII discharges (S3_1_C13_16),Electrocardiology (D_4_HOS_C2_69),"Net Expense for Cost Allocation, New Capital Equipment (B_1_C0_2)","PPS REIMBURSED SERVICES -  CHARGES, CT Scan (D_5_HOS_C2_57)","COST REIMBURSED SERVICES NOT SUBJECT TO DEDUCTIBLES AND COINSURANCE - CHARGES, Operating Room (D_5_HOS_C4_50)",Other Special Care (S3_1_C4_12),"AVERAGE HOURLY WAGE, Employee Benefits (S3_2_C6_26)",Durable Medical Equipment Rented (A_C6_96),Impl. Dev. Charged to Patients (D_4_HOS_C3_72),Cardiac Catheterization (D_4_HOS_C13_59),Occupational Therapy (D_4_IPF_C13_67),Subprovider 1 (S3_1_C2_18),"Average patient dialysis time 
including setup (S5_C4_3)",Total Program Excludable Costs (D1_IRF_C1_52),"Percentage of patients re-using
dialyzers (S5_C1_10)","Interest, Total (A7_3_C11_3)",Occupational Therapy (D3_SNF_C2_67),"Allocation of Interns & Residents Program Costs, Other Special Care Unit (B_1_C22_35)",Number of stations (S5_C1_6),Cost To Charge Ratio (S10_C1_1),"PPS SERVICES COST, Clinic (D_5_HOS_C5_90)","Net Expense for Cost Allocation, Coronary Care Unit (B_1_C0_32)",RHC 15 Provider Number (S2_1_C2_1514),"ADJUSTED SALARIES, Excluded Areas (S3_2_C4_19)",Emergency (D_4_IRF_C13_91),"COST REIMBURSED SERVICES NOT SUBJECT TO DEDUCTIBLES AND COINSURANCE - CHARGES, Observation Beds (Distinct Unit) (D_5_HOS_C4_9201)","ADJUSTED SALARIES, Total Salaries (S3_2_C4_1)",CORF (C_1_C5_9910),MRI (D_4_HOS_C3_58),"AVERAGE HOURLY WAGE, Subtotal Salaries (S3_3_C6_3)",Whole Blood & Packed Red Blood Cells (D_4_HOS_C13_62),Occupational Therapy (D3_HOS_C2_67),"AVERAGE HOURLY WAGE, Dietary (S3_2_C6_34)","ADJUSTED SALARIES, Physician Part A Teaching (S3_2_C4_2201)",Laboratory (D_4_HOS_C13_60),"Net Expense for Cost Allocation, Social Service (B_1_C0_17)",Delivery Room and Labor Room (D3_HOS_C3_52),OOT (B_2_C26_9930),HHA (B_1_C22_101),Drugs Charged to Patients (D_4_HOS_C13_73),Occupational Therapy (C_1_C7_67),Adults and Pediatrics (D3_HOS_C2_30),"Blood Storing, Processing, Trans (A_C1_63)",Heart Acquisition (A_C2_106),"Blood Storing, Processing, Trans (D_4_HOS_C12_63)",Radiology-Diagnostic (D3_IPF_C3_54),Occupational Therapy (A_C6_67),Electrocardiology (A_C2_69),Occupational Therapy (D_4_HOS_C11_67),Does the hospital elect a fully prospective payment method for capital costs? (Y/N) (S2_1_C1_48),"Number of Times per week 
Patient receives Dialysis (S5_C3_2)","HHA II, Without Outliers:  Non Routine Med Sup Chgs (S4_HHA2_C1_38)",Emergency (C_1_C7_91),Other Outpatient Services (D_4_HOS_C4_93),"General Inpatient Routine Service Cost, net of Swing Bed and Private Room Diff (D1_IPF_C1_37)",Burn Intensive Care Unit (D3_HOS_C2_33),Subtotal (E_B_HOS_C1_27),Other Special Care Unit (A_C6_35),Total discharges (S3_1_C15_1),Cash on Hand and in Banks (G_C1THRU4_1),Cost of Uncompensated Care (S10_C1_30),MRI (A_C2_58),"PPS SERVICES COST, Other Ancillary (D_5_HOS_C5_76)",Electroencephalography (A_C6_70),"AMOUNT REPORTED, Non-Physician Anesthetist Part A (S3_2_C2_2)","HHA III, Total Charges:  LUPA Episodes (S4_HHA3_C3_35)","HHA I, With Outliers:  Other Charges (S4_HHA1_C2_34)",CAPD exchanges per day (S5_C6_4),Radioisotope (D_4_HOS_C12_56),"Net Expense for Cost Allocation, Housekeeping (B_1_C0_9)","COST REIMBURSED SERVICES SUBJECT TO DEDUCTIBLES  AND COINSURANCE - CHARGES, Other Outpatient Services (D_5_HOS_C3_93)",Laundry and Linen Service (A_C2_8),"PPS SERVICES COST, MRI (D_5_HOS_C5_58)",Other Outpatient Services (A_C2_93),Home Office Name (S2_1_C1_141),Electrocardiology (A_C6_69),"Total Inpatient Charges, Subprovider-IPF (C_1_C6_40)",Delivery Room and Labor Room (D_4_IPF_C13_52),Drugs Charged to Patients (D_4_HOS_C2_73),Electroencephalography (D_4_IRF_C13_70),Kidney Acquisition (C_1_C7_105),Interest Expense (A_C6_113),"PPS REIMBURSED SERVICES -  CHARGES, Blood Clotting Factors for Hemoph. (D_5_HOS_C2_6250)",Total Allied Health (D_4_IRF_C3_200),"Net Expense for Cost Allocation, Hospice (B_1_C0_116)",HHA (C_1_C7_101),SNF (S3_1_C5_19),Anesthesiology (D3_HOS_C2_53),Emergency (D3_IRF_C3_91),SNF (D_3_HOS_C9_44),CORF (B_2_C26_9910),CAPD exchanges per day (S5_C4_4),Radiology-Diagnostic (D_4_HOS_C13_54),Whole Blood & Packed Red Blood Cells (D3_IRF_C3_62),Hospital City (S2_1_C1_2),Medical and Other Services (E_B_HOS_C1_1),"AVERAGE HOURLY WAGE, Housekeeping under Contract (S3_2_C6_33)",Other Special Care Unit (D3_IPF_C2_35),"Net Expense for Cost Allocation, Electroencephalography (B_1_C0_70)",Intensive Care Unit (S3_1_C4_8),State or local govt (not Medicaid or CHIP) Shortfall -- Costs minus net revenue (0 min) (S10_C1_16),Cafeteria employees and guests (A8_C2_14),Laboratory (D_4_IRF_C13_60),"Net Expense for Cost Allocation, Renal Dialysis (B_1_C0_74)",Hospital Title 18 Payment System (P/T/O) (S2_1_C7_3),"AMOUNT REPORTED, Interns & Residents (S3_2_C2_2551)",Radioisotope (A_C6_56),"PPS SERVICES COST, Electrocardiology (D_5_HOS_C5_69)",Gross Revenue (G3_C1_1),"Allocation of Interns & Residents Program Costs, Respiratory Therapy (B_1_C22_65)",Charity care charges and uninsured discounts for the entire facility (S10_C1_20),Home Program Dialysis (D3_HOS_C2_94),"Net Expense for Cost Allocation, SNF (B_1_C0_44)",Subprovider-IRF (C_1_C5_41),Hospital Provider Number (PRVDR_NUM),RHC 10 Provider Number (S2_1_C2_1509),"ADJUSTED SALARIES, Admin & Gen Under Contract (S3_2_C4_29)",Operation of Plant (A_C2_7),"Difference between Adjusted Inpatient, Operating Cost and Target Amount (D1_HOS_C1_57)",Physical Therapy (D3_IRF_C2_66),RHC 9 Provider Number (S2_1_C2_1508),Total Program Excludable Costs (D1_HOS_C1_52),TOTAL (D3_IPF_C3_200),"AMOUNT REPORTED, Total Salaries (S3_2_C2_1)","ADJUSTED SALARIES, Administrative & General under contract (S3_2_C4_28)","Total Inpatient Charges, Cardiac Catheterization (C_1_C6_59)",Heart Acquisition (A_C1_106),ASC (Non Distinct Part) (D3_IRF_C3_75),Surgical Intensive Care Unit (C_1_C5_34),Other Reimbursable (D3_IRF_C3_98),Other Reimbursable (D_4_HOS_C10_98),"General Inpatient Routine Service Cost, net of Swing Bed and Private Room Diff (D1_SNF_C1_37)",Radiology-Therapeutic (A_C1_55),"Net Expense for Cost Allocation, FQHC (B_1_C0_89)",Subprovider-IRF (A_C6_41),Kidney Acquisition (B_2_C26_105),Speech Pathology (D_4_IPF_C13_68),Subprovider-IPF (B_1_C26_40),Administrative and General (A_C2_5),FQHC 4 Provider Number (S2_1_C2_1603),Adults & Pediatrics (D_3_HOS_C9_30),Other Reimbursable (D3_IPF_C2_98),Adjusted reimburseable bad debts (E_B_HOS_C1_35),Title V discharges (S3_1_C12_16),Intravenous Therapy (D_4_IRF_C11_64),Adults and Pediatrics (B_1_C26_30),Television and Radio Service (A8_C2_8),"Total, Total (A7_3_C15_3)","If this Hospital is claiming cost for renal services on Worksheet A, are they inpatient services only? (Y/N) (S2_1_C1_145)",Hospice (S3_1_C7_24),Intravenous Therapy (D_4_HOS_C12_64),Occupational Therapy (C_1_C5_67),"HHA I, Total Other Charges (S4_HHA1_C5_34)","PPS REIMBURSED SERVICES -  CHARGES, Medical Supplies Charged to Patients (D_5_HOS_C2_71)",Line 2 times line 5 (E_B_HOS_C1_6),Drugs Charged to Patients (D3_IPF_C2_73),"Blood Storing, Processing, Trans (D_4_IRF_C13_63)",CMHC (C_1_C7_99),Subprovider I (D_1_HOS_C4_42),RHC 11 Provider Number (S2_1_C2_1510),"TOTAL CAPITAL COSTS AFTER COST ALLOCATION, Other Special Care Unit (B_2_C26_35)",Drugs Charged to Patients (D_4_HOS_C12_73),"Gift, Flower, Coffee Shop, Canteen (B_1_C22_190)",Radiology-Therapeutic (D_4_SNF_C11_55),"Net Expense for Cost Allocation, Interns & Res Salary and Fringe Benefits (B_1_C0_21)",Hospital Adlts & Ped Swing Bed NF (S3_1_C7_6),Radiology-Diagnostic (D3_HOS_C2_54),IRF (S3_1_C5_17),NF (S3_1_C8_20),Other Special Purpose (B_1_C26_117),"AMOUNT REPORTED, Interns & Residents (S3_2_C3_2552)","Net Expense for Cost Allocation, Durable Medical Equipment Rented (B_1_C0_96)",Emergency (D_4_HOS_C11_91),"HHA I, W/Out Outliers:  Number of Episodes (S4_HHA1_C1_36)","Net Expense for Cost Allocation, Other Reimbursable (B_1_C0_98)",Adults & Pediatrics (D_1_HOS_C6_30),Medicare Certified Kidney TC term date (S2_1_C2_126),"HHA I, Total Charges (S4_HHA1_C5_35)",Respiratory Therapy (D_4_HOS_C12_65),Leasehold Improvements (G_C1THRU4_17),"Allocation of Interns & Residents Program Costs, OLTC (B_1_C22_46)","Net Expense for Cost Allocation, RHC (B_1_C0_88)",Clinic (D_4_HOS_C2_90),Clinic (A_C2_90),"AMOUNT REPORTED, Physician Part A (S3_2_C3_22)",Intensive Care Unit (D_1_HOS_C4_31),Radiology-Diagnostic (A_C2_54),ASC (Distinct Part) (A_C2_115),Total unreimbursed and uncompensated care (S10_C1_31),Impl. Dev. Charged to Patients (D3_IRF_C3_72),"ADJUSTED SALARIES, Total (S3_3_C4_6)",Coronary Care Unit (S3_1_C5_9),"Total Program Inpatient Operating Cost excluding Capital Related, Nonphysician, Anesthetist, and Medical Education Costs (D1_HOS_C1_53)",CT Scan (A_C1_57),Interns & Res Salary and Fringe Benefits (A_C6_21),Radiology-Therapeutic (D3_IRF_C2_55),"Net Expense for Cost Allocation, OSP (B_1_C0_9940)",Laboratory (D_4_SNF_C11_60),Kidney Acquisition (B_1_C26_105),Paramedical Education (A_C6_23),Physical Therapy (D_4_HOS_C10_66),Radiology-Therapeutic (D3_IPF_C3_55),Emergency (D_4_HOS_C1_91),Emergency (A_C2_91),Interest expense on Medicare Overpaymts (A8_C2_22),New Capital Buildings and Fixtures (A_C6_1),Emergency (C_1_C5_91),FQHC 6 Provider Number (S2_1_C2_1605),"AMOUNT REPORTED, Physician Part A (S3_2_C2_22)",Net Income (G3_C1_29),Other Special Purpose (B_2_C26_117),Aggregate amount collected from patients (E_B_HOS_C1_15),"PPS REIMBURSED SERVICES -  CHARGES, Drugs Charged to Patients (D_5_HOS_C2_73)","COST REIMBURSED SERVICES SUBJECT TO DEDUCTIBLES  AND COINSURANCE - CHARGES, Ambulance Services (D_5_HOS_C3_95)","Allocation of Interns & Residents Salary and Fringes, Burn Intensive Care Unit (B_1_C21_33)",Liver Acquisition (A_C6_107),"AMOUNT REPORTED, Wage Related Costs RHC/FQHC (S3_2_C2_24)",Organ acquisition (E_B_HOS_C1_10),"Medicare certified heart
transplant center cert date (S2_1_C1_127)","COST REIMBURSED SERVICES SUBJECT TO DEDUCTIBLES  AND COINSURANCE - CHARGES, Blood Storing, Processing, Trans (D_5_HOS_C3_63)","HHA II, PEP Episodes:  Total Charges: (S4_HHA2_C4_35)","PAID HOURS RELATED TO SALARIES, Housekeeping under Contract (S3_2_C5_33)",Net Revenue from stand-alone SCHIP (S10_C1_9),"Net Expense for Cost Allocation, OOT (B_1_C0_9930)","AMOUNT REPORTED, Administrative and General (S3_2_C2_27)",Organ Procurement (D4_LUNG_C1_69),"Net Expense for Cost Allocation, Radioisotope (B_1_C0_56)",Physical Therapy (D_4_HOS_C1_66),Speech Pathology (D_4_HOS_C10_68),Observation Beds (Distinct Unit) (D_4_IPF_C11_9201),Housekeeping (A_C2_9),Total (D_4_HOS_C13_200),Swing Bed SNF Provider Number (S2_1_C2_7),Other Reimbursable (B_1_C26_98),HMO (S3_1_C6_2),Laboratory (A_C2_60),Drugs Charged to Patients (A_C2_73),Intravenous Therapy (D3_IRF_C2_64),Tentative settlement (E_B_HOS_C1_42),ASC 1 Provider Number (S2_1_C2_13),"Purchases, Fixed Equipment (A7_1_C2_5)",Laboratory (D_4_HOS_C11_60),"Total Inpatient Charges, SNF (C_1_C6_44)",Initial Physician Payment Method (Y/N) (S5_C2_21),"Blood Storing, Processing, Trans (A_C2_63)","AMOUNT REPORTED, Wage Related Costs Core (S3_2_C2_17)",Total discharges (S3_1_C15_14),Outpatient Rehab Provider (S3_1_C8_25),"HHA III, Without Outliers:  Other Charges (S4_HHA3_C1_34)","HHA II, Total Visits (S4_HHA2_C5_33)",Anesthesiology (A_C6_53),"TOTAL CAPITAL COSTS AFTER COST ALLOCATION, Blood Clotting Factors for Hemoph. (B_2_C26_6250)","PPS REIMBURSED SERVICES -  CHARGES, Electroencephalography (D_5_HOS_C2_70)",Other Ancillary (A_C2_76),"AVERAGE HOURLY WAGE, Home Office Salaries (S3_2_C6_1401)",Private grants or donations or endowment income restricted to funding charity care (S10_C1_17),Depreciation-New Movable Equipment (A8_C2_27),Durable Medical Equipment Sold (D_4_HOS_C10_97),Observation Beds (Distinct Unit) (D3_SNF_C3_9201),Radiology-Therapeutic (D_4_HOS_C3_55),Other Outpatient Services (D3_HOS_C2_93),Burn Intensive Care Unit (S3_1_C8_10),"HHA II, Total Non Routine Medical  Supply Charges (S4_HHA2_C5_38)",Speech Pathology (D3_HOS_C2_68),"Net Expense for Cost Allocation, Other Outpatient Services (B_1_C0_93)",Recovery Room (D3_IPF_C3_51),"COST REIMBURSED SERVICES SUBJECT TO DEDUCTIBLES  AND COINSURANCE - CHARGES, Occupational Therapy (D_5_HOS_C3_67)","HHA I, PEP Episodes:  Total Number of Episodes (S4_HHA1_C4_36)",Renal Dialysis (C_1_C5_74),FQHC (A_C1_89),Laundry and Linen Service (A8_C2_13),FQHC 3 Provider Number (S2_1_C2_1602),"ADJUSTED SALARIES, Interns & Residents (S3_2_C4_2552)","Donations, Total (A7_1_C3_10)",Respiratory Therapy (D_4_HOS_C3_65),OLTC (A_C2_46),"HHA I, Total Number of Outlier Episodes (S4_HHA1_C5_37)","Net Expense for Cost Allocation, Medical Records and Medical Rec. Library (B_1_C0_16)",Other Medicaid Days (S2_1_C6_24),OLTC (C_1_C5_46),"AVERAGE HOURLY WAGE, Total Salaries (S3_2_C6_1)",Anesthesiology (D_4_HOS_C4_53),Physical Therapy (C_1_C7_66),Land Improvements (G_C1THRU4_13),Other Assets (G_C1THRU4_34),Intensive Care Unit (S3_1_C2_8),Coronary Care Unit (D3_IRF_C2_32),Pancreas Acquisition (C_1_C7_109),FQHC (A_C6_89),SNF (A_C1_44),Blood Clotting Factors for Hemoph. (D_4_HOS_C3_6250),Other Capital (A_C2_3),Intravenous Therapy (D_4_HOS_C4_64),Premiums (S2_1_C1_11801),CORF (A_C1_9910),"Other Capital Related Costs, New Cap Related Csts Bldg & Fixtures (A7_3_C7_1)",HHA 2 Provider Number (S2_1_C2_1201),"Average patient dialysis time 
including setup (S5_C2_3)",Subprovider I (A_C6_42),"Blood Storing, Processing, Trans (D3_SNF_C3_63)",Physical Therapy (A_C2_66),Delivery Room and Labor Room (D3_IRF_C2_52),"HHA I, Total Visits (S4_HHA1_C5_33)","PPS REIMBURSED SERVICES -  CHARGES, Other Ancillary (D_5_HOS_C2_76)",Intensive Care Unit (D_1_HOS_C6_31),Beds Total Facility (S3_1_C2_27),CT Scan (C_1_C5_57),"Total Outpatient Charges, CT Scan (C_1_C7_57)","Purchases, Total (A7_1_C2_10)","AMOUNT REPORTED, Total (S3_3_C2_6)",Buildings (G_C1THRU4_15),Delivery Room and Labor Room (D_4_SNF_C11_52),Renal Dialysis (C_1_C7_74),"Allocation of Interns & Residents Program Costs, Subprovider I (B_1_C22_42)",Investment Income-Other (A8_C2_3),Utilization (S5_C2_8),Medical Records and Medical Rec. Library (A_C6_16),Medical Supplies Charged to Patients (A_C1_71),"COST SERVICES NOT SUBJECT TO DEDUCTIBLES AND COINSURANCE - COST, Cardiac Catheterization (D_5_HOS_C7_59)",SNF Provider Number (S2_1_C2_9),SSA State County Code (ST_CTY_CD),Medicare Certified Liver TC term date (S2_1_C2_128),"PPS REIMBURSED SERVICES -  CHARGES, Observation Beds (Distinct Unit) (D_5_HOS_C2_9201)","COST SERVICES SUBJECT TO DEDUCTIBLES AND COINSURANCE - COST, Occupational Therapy (D_5_HOS_C6_67)",Renal Dialysis (B_1_C26_74),Subprovider-IRF (D3_IRF_C2_41),Total Outpatient Program Pass Thru Cost (D_4_HOS_C6_200),OPT (A_C6_9920),Total Hospital (S3_1_C5_14),"Net Expense for Cost Allocation, Operating Room (B_1_C0_50)","Net Expense for Cost Allocation, Whole Blood & Packed Red Blood Cells (B_1_C0_62)","HHA II, Without Outliers:  Total Visits (S4_HHA2_C1_33)","Blood Storing, Processing, Trans (D3_HOS_C3_63)",Urban/Rural Indicator at beginning (S2_1_C1_26),Other Reimbursable (B_2_C26_98),Medical Supplies Charged to Patients (D3_HOS_C3_71),Laboratory (D3_SNF_C2_60),Housekeeping (A_C6_9),MRI (D3_SNF_C3_58),Observation Beds (Distinct Unit) (D3_HOS_C3_9201),Observation Beds (Distinct Unit) (D3_IRF_C2_9201),"HHA III, PEP:  Total Non Routine Med Supply Chgs (S4_HHA3_C4_38)","PPS SERVICES COST, Delivery Room and Labor Room (D_5_HOS_C5_52)","PAID HOURS RELATED TO SALARIES, Administrative and General under Contract (S3_2_C5_28)",FQHC 8 Provider Number (S2_1_C2_1607),"Allocation of Interns & Residents Salary and Fringes, Delivery Room and Labor Room (B_1_C21_52)",NF (A_C6_45),"ADJUSTED SALARIES, Medical Records & Med Records Library (S3_2_C4_41)",Intravenous Therapy (D3_IPF_C2_64),Utilization Review - Physician Compen (D1_SNF_C1_85),Burn Intensive Care Unit (S3_1_C5_10),"TOTAL CAPITAL COSTS AFTER COST ALLOCATION, Subprovider I (B_2_C26_42)",Other Reimbursable (D_4_HOS_C2_98),Other Outpatient Services (D_4_SNF_C11_93),Electrocardiology (D3_IPF_C3_69),RHC 3 Provider Number (S2_1_C2_1502),"AVERAGE HOURLY WAGE, Non-Physician Anesthetist Part A (S3_2_C6_2)",Hospice (B_1_C22_116),Other Special Care (S3_1_C3_12),Pancreas Acquisition (A_C6_109),"Allocation of Interns & Residents Salary and Fringes, Blood Storing, Processing, Trans (B_1_C21_63)",Clinic (C_1_C5_90),Other Special Care Unit (D_1_HOS_C7_35),Electrocardiology (D_4_IPF_C11_69),Program Ancillary Services (D1_SNF_C1_84),Other Outpatient Services (D_4_HOS_C2_93),Physicians' Private Office (A_C6_192),Recovery Room (D_4_HOS_C12_51),Radiology-Therapeutic (D_4_HOS_C11_55),Blood Clotting Factors for Hemoph. (C_1_C5_6250),"AVERAGE HOURLY WAGE, SNF (S3_2_C6_9)",Durable Medical Equipment Rented (B_1_C26_96),Pass through Cost for Program Inpatient (D1_IPF_C1_50),Respiratory Therapy (A_C2_65),Observation Beds (Distinct Unit) (D3_SNF_C2_9201),"Blood Storing, Processing, Trans (D_4_HOS_C10_63)",Total Other Medical Education (D_4_IPF_C4_200),Renal Dialysis (D3_IRF_C3_74),Liver Acquisition (B_1_C22_107),Delivery Room and Labor Room (D3_HOS_C2_52),Anesthesiology (D3_HOS_C3_53),Heart Acquisition (B_1_C22_106),Hospice (C_1_C7_116),Occupational Therapy (D3_IPF_C2_67),"TOTAL CAPITAL COSTS AFTER COST ALLOCATION, Operating Room (B_2_C26_50)",Is this a rural hospital qualifying for an exception to the certified registered nurse anesthetist the CRNA fee schedule? (Y/N) (S2_1_C1_108),Respiratory Therapy (A_C1_65),Pancreas Acquisition (B_2_C26_109),OLTC (S3_1_C8_21),"Net Expense for Cost Allocation, Subprovider-IPF (B_1_C0_40)","HHA III, LUPA:  Total Non Routine Med Sup Chgs (S4_HHA3_C3_38)",Organ Procurement (D4_ISLET_C1_69),Occupational Therapy (A_C1_67),"COST SERVICES SUBJECT TO DEDUCTIBLES AND COINSURANCE - COST, Drugs Charged to Patients (D_5_HOS_C6_73)",Line 2 times line 5 (E_B_HOS_C101_6),"Blood Storing, Processing, Trans (D_4_IPF_C13_63)",ASC (Distinct Part) (C_1_C7_115),"Number of days in year dialysis 
furnished (S5_C2_5)","AMOUNT REPORTED, Employee Benefits (S3_2_C2_26)",Drugs Charged to Patients (D_4_HOS_C10_73),Beds Total Hospital (S3_1_C2_14),Burn Intensive Care Unit (D_3_HOS_C9_33),Surgical Intensive Care Unit (S3_1_C6_11),"Net Expense for Cost Allocation, Observation Beds (Distinct Unit) (B_1_C0_9201)",Clinic (D_4_HOS_C13_90),"Net Expense for Cost Allocation, Maintenance of Personnel (B_1_C0_12)",Other Organ Acquisition (A_C6_112),"TOTAL CAPITAL COSTS AFTER COST ALLOCATION, Subprovider II (B_2_C26_4201)","HHA I, PEP:  Total Non Routine Med Supply Chgs (S4_HHA1_C4_38)",Total Other Medical Education (D_4_IRF_C4_200),Impl. Dev. Charged to Patients (D3_IPF_C3_72),Total Income (G3_C1_26),Protested amounts (E_B_HOS_C1_44),Total (C_1_C6_202),Electrocardiology (D3_SNF_C2_69),Clinic (D_4_HOS_C4_90),Impl. Dev. Charged to Patients (A_C1_72),"HHA II, Without Outliers:  Total Charges (S4_HHA2_C1_35)",CMHC (A_C6_99),Other Outpatient Services (B_1_C21_93),Radioisotope (B_1_C26_56),"AMOUNT REPORTED, Interns & Residents (S3_2_C2_7)",Operating Room (D3_IPF_C3_50),Subtotal (E_B_HOS_C1_32),Drugs Charged to Patients (D_4_HOS_C3_73),Radiology-Diagnostic (B_1_C26_54),IRF (S3_1_C2_17),"Number of patients in program at 
end of cost reporting period (S5_C5_1)","AMOUNT REPORTED, Interns & Residents (S3_2_C2_2552)",Maintenance of Personnel (A_C1_12),"AMOUNT REPORTED, Wage Related Costs Other (S3_2_C2_18)","HHA III, Total Visits (S4_HHA3_C5_33)",Subprovider I (A_C1_42),"HHA II, With Outliers:  Total Visits (S4_HHA2_C2_33)",Other Reimbursable (D_4_HOS_C12_98),Physical Therapy (D_4_SNF_C11_66),Ancillary service charges (E_B_HOS_C1_12),CMHC (B_2_C26_99),"PPS SERVICES COST, Blood Storing, Processing, Trans (D_5_HOS_C5_63)",Whole Blood & Packed Red Blood Cells (D3_IPF_C3_62),OSP (C_1_C6_9940),Home Program Dialysis (D_4_HOS_C11_94),Subprovider-IPF (D3_HOS_C2_40),"AMOUNT REPORTED, Interns & Residents (S3_2_C3_2551)","Allocation of Interns & Residents Program Costs, Adults and Pediatrics (B_1_C22_30)",OOT (C_1_C6_9930),Electrocardiology (D_4_HOS_C4_69),Pass Through Cost for  Program Ancillary (D1_HOS_C1_51),"PAID HOURS RELATED TO SALARIES, Subtotal Other Wages and Related Csts (S3_3_C5_4)","PAID HOURS RELATED TO SALARIES, Nursing Administration (S3_2_C5_38)","TOTAL CAPITAL COSTS AFTER COST ALLOCATION, Total Directly Assigned New Cap Rel Csts (B_2_C0_202)",Electrocardiology (B_2_C26_69),"COST SERVICES SUBJECT TO DEDUCTIBLES AND COINSURANCE - COST, Laboratory (D_5_HOS_C6_60)",Subprovider II (A_C6_4201),Intestinal Acquisition (A_C1_110),Drugs Charged to Patients (D3_IPF_C3_73),ASC (Distinct Part) (B_2_C26_115),Coronary Care Unit (A_C6_32),Ambulance Services (C_1_C7_95),"Total Outpatient Charges, Delivery Room and Labor Room (C_1_C7_52)",Other Organ Acquisition (A_C1_112),Electrocardiology (D_4_HOS_C10_69),Recovery Room (D_4_HOS_C13_51),Cardiac Catheterization (D_4_HOS_C2_59),Other Outpatient Services (D_4_IPF_C13_93),RHC 14 Provider Number (S2_1_C2_1513),ICF (A_C6_4501),OLTC (A_C6_46),Less: Allowances for uncollectible notes and accounts receivable (G_C1THRU4_6),"HHA II, PEP Episodes:  Total Number of Episodes (S4_HHA2_C4_36)",Subprovider-IRF (D3_SNF_C2_41),"COST REIMBURSED SERVICES NOT SUBJECT TO DEDUCTIBLES AND COINSURANCE - CHARGES, Whole Blood & Packed Red Blood Cells (D_5_HOS_C4_62)",Durable Medical Equipment Rented (D3_IRF_C2_96),Medical Supplies Charged to Patients (D_4_IPF_C13_71),Cafeteria (A_C6_11),Hospital Type (S2_1_C4_3),Intensive Care Unit (A_C6_31),Respiratory Therapy (D_4_IPF_C11_65),Radiology-Diagnostic (D_4_HOS_C4_54),Coronary Care Unit (S3_1_C4_9),Intensive Care Unit (D_1_HOS_C7_31),Total Operating Expense (G3_C1_4),Operating Room (A_C2_50),"PAID HOURS RELATED TO SALARIES, Administrative and General (S3_2_C5_27)",Adults & Pediatrics (C_1_C5_30),FQHC (C_1_C5_89),"Net Expense for Cost Allocation, Nursery (B_1_C0_43)","TOTAL CAPITAL COSTS AFTER COST ALLOCATION, ICF (B_2_C26_4501)",TOTAL (D3_HOS_C3_200),Int & Res (non approved teaching program (B_1_C21_100),Intensive Care Unit (S3_1_C5_8),"HHA III, LUPA Episodes:  Total Number of Episodes (S4_HHA3_C3_36)",CT Scan (D_4_HOS_C2_57),"COST REIMBURSED SERVICES NOT SUBJECT TO DEDUCTIBLES AND COINSURANCE - CHARGES, Clinic (D_5_HOS_C4_90)",Islet Acquisition (B_1_C26_111),Whole Blood & Packed Red Blood Cells (D3_HOS_C2_62),Durable Medical Equipment Sold (C_1_C6_97),"PPS REIMBURSED SERVICES -  CHARGES, Operating Room (D_5_HOS_C2_50)",MRI (D_4_IRF_C13_58),"HHA II, LUPA:  Total Non Routine Med Sup Chgs (S4_HHA2_C3_38)","COST SERVICES SUBJECT TO DEDUCTIBLES AND COINSURANCE - COST, Clinic (D_5_HOS_C6_90)",NF (S3_1_C3_20),"ADJUSTED SALARIES, Home Office:  Physician Part A (S3_2_C4_15)","Net Expense for Cost Allocation, Laboratory (B_1_C0_60)",Total (D_1_HOS_C4_200),HHA (S3_1_C6_22),Anesthesiology (A_C2_53),Medical Supplies Charged to Patients (A_C6_71),Durable Medical Equipment Sold (D3_HOS_C2_97),Total (A8_C2_50),TOTAL (D3_IRF_C2_200),MRI (D_4_HOS_C12_58),Sale of medical records and abstracts (A8_C2_18),"Allocation of Interns & Residents Salary and Fringes, Radiology-Diagnostic (B_1_C21_54)",Allowable bad debts (E_B_HOS_C1_34),"PPS REIMBURSED SERVICES -  CHARGES, Radiology-Therapeutic (D_5_HOS_C2_55)",Total discharges (S3_1_C15_17),or allied health costs? (S2_1_C1_60),Respiratory Therapy (D3_SNF_C2_65),CT Scan (D3_IRF_C2_57),FQHC (B_2_C26_89),"Disposals and Retirements, Land Improvements (A7_1_C7_2)","PAID HOURS RELATED TO SALARIES, Contract Labor:  Physician Part A (S3_2_C5_13)","Does the facility qualify and is it receiving payments for 
disproportionate share? (Y/N) (S2_1_C1_22)",Kidney Acquisition (C_1_C6_105),"HHA III, W/Out Outliers:  Number of Episodes (S4_HHA3_C1_36)",Impl. Dev. Charged to Patients (D_4_HOS_C10_72),Coronary Care Unit (D_3_HOS_C9_32),"COST REIMBURSED SERVICES SUBJECT TO DEDUCTIBLES  AND COINSURANCE - CHARGES, Laboratory (D_5_HOS_C3_60)",Clinic (D3_IRF_C3_90),Labor and Delivery (S3_1_C3_32),"AMOUNT REPORTED, Central Services and Supply (S3_2_C2_39)",Other Nonreimbursable (A_C1_194),"Allocation of Interns & Residents Program Costs, Electroencephalography (B_1_C22_70)",CT Scan (D_4_HOS_C13_57),Interest Expense (A_C2_113),OPT (C_1_C5_9920),Subprovider 1 (S3_1_C3_18),"Net Expense for Cost Allocation, Burn Intensive Care Unit (B_1_C0_33)",Speech Pathology (D_4_HOS_C12_68),Surgical Intensive Care Unit (D3_IRF_C2_34),"Net Expense for Cost Allocation, Nursing Administration (B_1_C0_13)","PPS REIMBURSED SERVICES -  CHARGES, Radioisotope (D_5_HOS_C2_56)",Intestinal Acquisition (C_1_C5_110),Radioisotope (D_4_HOS_C10_56),Operating Room (D_4_SNF_C11_50),"PPS REIMBURSED SERVICES -  CHARGES, MRI (D_5_HOS_C2_58)",RHC 8 Provider Number (S2_1_C2_1507),CMS Region Code (REGION),Observation Beds (Distinct Unit) (D_4_HOS_C13_9201),Other Outpatient Services (D_4_HOS_C3_93),Subprovider-IPF (A_C6_40),"Net Expense for Cost Allocation, Medical Supplies Charged to Patients (B_1_C0_71)",Home Office Street (S2_1_C1_142),Operation of Plant (A_C1_7),Renal 8 Provider Number (S2_1_C2_1807),Clinic (B_2_C26_90),Occupational Therapy (D_4_IPF_C11_67),Physical Therapy (D_4_IRF_C11_66),Home Program Dialysis (C_1_C6_94),Occupational Therapy (D_4_HOS_C13_67),Lung  Acquisition (C_1_C5_108),"Allocation of Interns & Residents Salary and Fringes, Laboratory (B_1_C21_60)",FQHC (D_4_HOS_C4_89),"Allocation of Interns & Residents Salary and Fringes, Interns & Res Salary and Fringe Benefits (B_1_C21_21)",Subprovider-IPF (D3_IPF_C2_40),"COST REIMBURSED SERVICES SUBJECT TO DEDUCTIBLES  AND COINSURANCE - CHARGES, CT Scan (D_5_HOS_C3_57)",Delivery Room and Labor Room (D_4_HOS_C11_52),Speech Pathology (D3_IRF_C3_68),"HHA III, With Outliers:  Number of Episodes (S4_HHA3_C2_37)","AMOUNT REPORTED, Interns & Residents (S3_2_C2_2550)",Respiratory Therapy (C_1_C5_65),Delivery Room and Labor Room (D_4_IPF_C11_52),RHC 24 Provider Number (S2_1_C2_1523),"ADJUSTED SALARIES, Home Office Salaries (S3_2_C4_1401)",Whole Blood & Packed Red Blood Cells (D3_IRF_C2_62),Outlier payments (E_B_HOS_C1_4),"Interest, New Cap Related Csts Movable Equipment (A7_3_C11_2)",Other General Service (A_C1_18),"AVERAGE HOURLY WAGE, Subtotal Wage Related Csts (S3_3_C6_5)","Net Expense for Cost Allocation, Physical Therapy (B_1_C0_66)","COST SERVICES SUBJECT TO DEDUCTIBLES AND COINSURANCE - COST, MRI (D_5_HOS_C6_58)",Electrocardiology (D3_SNF_C3_69),Occupational Therapy (D_4_HOS_C4_67),Delivery Room and Labor Room (D_4_IRF_C13_52),Utilization Code (L/N/F) (UTIL_CODE),Nonpaid Workers (B_1_C26_193),HHA (A_C2_101),"AMOUNT REPORTED, Physician Part B (S3_2_C3_23)",Medical Supplies Charged to Patients (D3_IRF_C2_71),Cost of charity care (S10_C3_23),"HHA I, LUPA:  Total Non Routine Med Sup Chgs (S4_HHA1_C3_38)",Durable Medical Equipment Sold (D_4_HOS_C12_97),Subtotal (E_B_HOS_C1_37),Surgical Intensive Care Unit Program Cost (D1_HOS_C5_46),Drugs Charged to Patients (A_C6_73),Respiratory Therapy (D_4_HOS_C2_65),Total Other Income (G3_C1_25),Ending Date of SCH status (S2_1_C2_3601),Radiology-Diagnostic (D3_IPF_C2_54),Total Facility FTEs (S3_1_C10_27),Intravenous Therapy (B_1_C26_64),Physical Therapy (C_1_C5_66),ASC (Non Distinct Part) (A_C1_75),"Is this a New Hospital under
42 CFR 412.300 PPS capital
(Y/N) (S2_1_C1_47)",Impl. Dev. Charged to Patients (D_4_IRF_C11_72),"ADJUSTED SALARIES, Home Office Salaries & Wage Related Csts (S3_2_C4_14)",Radioisotope (D_4_IRF_C11_56),Utilization Review SNF (A_C6_114),Research (B_1_C22_191),Impl. Dev. Charged to Patients (D3_SNF_C3_72),Islet Acquisition (C_1_C6_111),NOT IN THIS FILE (TRNSMTL_NUM),Other Organ Acquisition (A_C2_112),Respiratory Therapy (B_2_C26_65),Delivery Room and Labor Room (C_1_C5_52),Total Subprovider I Interns & Residents (S3_1_C10_18),Impl. Dev. Charged to Patients (C_1_C7_72),"PPS SERVICES COST, Durable Medical Equipment Sold (D_5_HOS_C5_97)","HHA I, Total Number of Episodes (S4_HHA1_C5_36)","COST SERVICES SUBJECT TO DEDUCTIBLES AND COINSURANCE - COST, Delivery Room and Labor Room (D_5_HOS_C6_52)",Organ Procurement (D4_PANCREAS_C1_69),"Net Expense for Cost Allocation, Occupational Therapy (B_1_C0_67)","COST REIMBURSED SERVICES NOT SUBJECT TO DEDUCTIBLES AND COINSURANCE - CHARGES, Radiology-Therapeutic (D_5_HOS_C4_55)","COST REIMBURSED SERVICES SUBJECT TO DEDUCTIBLES  AND COINSURANCE - CHARGES, Cardiac Catheterization (D_5_HOS_C3_59)",MRI (D3_IRF_C2_58),"AMOUNT REPORTED, Management and Administrative Services (S3_2_C2_12)","AMOUNT REPORTED, Maintenance and Repairs (S3_2_C2_29)",Other Outpatient Services (D3_SNF_C2_93),"Total Program Inpatient Operating Cost excluding Capital Related, Nonphysician, Anesthetist, and Medical Education Costs (D1_IRF_C1_53)",Physical Therapy (D_4_HOS_C11_66),Total customary charges (E_B_HOS_C1_18),"TOTAL CAPITAL COSTS AFTER COST ALLOCATION, Radioisotope (B_2_C26_56)","Net Expense for Cost Allocation, Int & Res (non approved teaching program (B_1_C0_100)",CT Scan (D3_HOS_C3_57),Hospital Adults & Pediatrics (S3_1_C2_1),Hospice 3 Provider Number (S2_1_C2_1402),Speech Pathology (D_4_IPF_C11_68),Delivery Room and Labor Room (D_4_IRF_C11_52),Total Hospital Interns & Residents (S3_1_C9_14),Ambulance Services (B_2_C26_95),Medical Supplies Charged to Patients (B_2_C26_71),"COST SERVICES NOT SUBJECT TO DEDUCTIBLES AND COINSURANCE - COST, Other Reimbursable (D_5_HOS_C7_98)",Total Current Liabilities (G_C1THRU4_45),"HHA II, Total Number of Episodes (S4_HHA2_C5_36)","Disposals and Retirements, Buildings and Fixtures (A7_1_C7_3)",Medicaid (Title XIX) discharges (S3_1_C14_16),Hospice (S3_1_C6_24),RHC (B_1_C26_88),"ADJUSTED SALARIES, Interns & Residents (S3_2_C4_25)",Interns and residents (E_B_HOS_C1_22),"Blood Storing, Processing, Trans (B_2_C26_63)",Observation Beds (Distinct Unit) (D_4_HOS_C11_9201),Intravenous Therapy (D3_SNF_C3_64),Burn Intensive Care Unit (S3_1_C7_10),Total Liabilities (G_C1THRU4_51),Total Subprovider II Interns & Residents (S3_1_C10_1801),Adj for Occupational therapy in excess of li (A8_C2_30),"Trade, Quantity, and Time Discounts (A8_C2_4)","AMOUNT REPORTED, Contract Labor: Pysician Part A (S3_2_C2_13)","COST SERVICES SUBJECT TO DEDUCTIBLES AND COINSURANCE - COST, Medical Supplies Charged to Patients (D_5_HOS_C6_71)",Lung  Acquisition (B_1_C22_108),"Net Expense for Cost Allocation, Gift, Flower, Coffee Shop, Canteen (B_1_C0_190)","AVERAGE HOURLY WAGE, Net Salaries (S3_3_C6_1)",Stand-alone CHIP Shortfall -- Costs minus net revenue (0 min) (S10_C1_12),Other Reimbursable (A_C1_98),"Allocation of Interns & Residents Program Costs, Operating Room (B_1_C22_50)","TOTAL CAPITAL COSTS AFTER COST ALLOCATION, Nursery (B_2_C26_43)","Net Expense for Cost Allocation, MRI (B_1_C0_58)","ADJUSTED SALARIES, Interns & Residents (S3_2_C4_7)",SNF (B_1_C26_44),Renal Dialysis (D3_IRF_C2_74),Other Outpatient Services (D3_IRF_C2_93),Is this hospital classified as a referral center? (Y/N) (S2_1_C1_116),Subprovider-IRF (D_1_HOS_C6_41),Impl. Dev. Charged to Patients (C_1_C6_72),Hospice (S3_1_C2_24),Allowable bad debts for dual eligibles beneficiaries (E_B_HOS_C1_36),Subprovider II (D_1_HOS_C4_4201),Other Reimbursable (D_4_HOS_C3_98),IRF (S3_1_C8_17),Liver Acquisition (B_1_C26_107),Other Reimbursable (D3_IRF_C2_98),"Net Expense for Cost Allocation, Central Services and Supply (B_1_C0_14)",Physical Therapy (D3_HOS_C3_66),"Total Outpatient Charges, Cardiac Catheterization (C_1_C7_59)",Laundry and Linen Service (A_C1_8),Research (A_C2_191),Out of State Medicaid eligible days (S2_1_C4_24),Occupational Therapy (A_C2_67),Drugs Charged to Patients (D3_SNF_C3_73),"Beginning Balances, Land (A7_1_C1_1)",Whole Blood & Packed Red Blood Cells (C_1_C5_62),Drugs Charged to Patients (D_4_HOS_C11_73),Anesthesiology (B_1_C26_53),Operating Room (D_4_IRF_C11_50),IPF (S3_1_C2_16),"Sale of scrap, waste, etc. (A8_C2_11)",Title V discharges (S3_1_C12_1),Renal Dialysis (D3_IPF_C2_74),Lung  Acquisition (B_2_C26_108),Ambulance Services (B_1_C21_95),"PPS REIMBURSED SERVICES -  CHARGES, Respiratory Therapy (D_5_HOS_C2_65)","COST REIMBURSED SERVICES SUBJECT TO DEDUCTIBLES  AND COINSURANCE - CHARGES, Other Ancillary (D_5_HOS_C3_76)",Radioisotope (A_C1_56),Other Reimbursable (C_1_C7_98),SSA State Code (STATE),"Allocation of Interns & Residents Program Costs, Occupational Therapy (B_1_C22_67)",Census Division Code (CENSUS),Home Program Dialysis (D3_IRF_C3_94),Whole Blood & Packed Red Blood Cells (D3_SNF_C3_62),RHC 20 Provider Number (S2_1_C2_1519),Emergency (B_1_C26_91),"PPS SERVICES COST, Physical Therapy (D_5_HOS_C5_66)","Disposals and Retirements, Movable Equipment (A7_1_C5_6)",Occupational Therapy (B_1_C26_67),Hospice (S3_1_C10_24),"TOTAL CAPITAL COSTS AFTER COST ALLOCATION, OLTC (B_2_C26_46)",Whole Blood & Packed Red Blood Cells (D3_IPF_C2_62),"COST REIMBURSED SERVICES SUBJECT TO DEDUCTIBLES  AND COINSURANCE - CHARGES, Radiology-Therapeutic (D_5_HOS_C3_55)",Recovery Room (D3_IRF_C3_51),Labor and Delivery Days -  Title XIX (S3_1_C8_32),Home Program Dialysis (D3_HOS_C3_94),"COST SERVICES SUBJECT TO DEDUCTIBLES AND COINSURANCE - COST, ASC (Non Distinct Part) (D_5_HOS_C6_75)",Stand-alone CHIP Charges (Gross Revenue) (S10_C1_10),Radioisotope (D_4_SNF_C11_56),"Percentage of patients re-using
dialyzers (S5_C2_10)","Number of Times per week
 Patient receives Dialysis (S5_C4_2)","HHA III, Without Outliers:  Non Routine Med Sup Chgs (S4_HHA3_C1_38)","Net Expense for Cost Allocation, CORF (B_1_C0_9910)",CORF (B_1_C26_9910),OPT (C_1_C6_9920),IPPS Interim payment (E_A_HOS_C1_72),"PPS REIMBURSED SERVICES -  CHARGES, Delivery Room and Labor Room (D_5_HOS_C2_52)",Employee Benefits (A_C2_4),Cardiac Catheterization (D3_IRF_C3_59),Laboratory (A_C6_60),Subprovider I (D3_HOS_C2_42),Durable Medical Equipment Sold (D_4_HOS_C3_97),Renal Dialysis (D_4_HOS_C4_74),Impl. Dev. Charged to Patients (A_C2_72),Cardiac Catheterization (A_C6_59),Impl. Dev. Charged to Patients (D_4_SNF_C11_72),"Allocation of Interns & Residents Program Costs, Impl. Dev. Charged to Patients (B_1_C22_72)",Laboratory (D_4_IPF_C13_60),Other Ancillary (D3_HOS_C3_76),Dietary (A_C2_10),"COST SERVICES SUBJECT TO DEDUCTIBLES AND COINSURANCE - COST, Operating Room (D_5_HOS_C6_50)",Clinic (C_1_C7_90),Total (C_1_C7_202),Other Outpatient Services (C_1_C7_93),"Net Expense for Cost Allocation, PBP Clinical Lab Services Program Only (B_1_C0_61)",Emergency (B_1_C21_91),"AVERAGE HOURLY WAGE, Physician-Part B (S3_2_C6_5)",Charity care charges and uninsured discounts for the entire facility (S10_C2_20),Emergency (D_4_HOS_C4_91),"Blood Storing, Processing, Trans (D_4_IPF_C11_63)",Intravenous Therapy (A_C6_64),Drugs Charged to Patients (D_4_HOS_C4_73),Operating Room (D3_HOS_C3_50),Paramedical Education (A_C1_23),Durable Medical Equipment Sold (C_1_C7_97),"HHA II, With Outliers:  Number of Episodes (S4_HHA2_C2_37)","COST REIMBURSED SERVICES NOT SUBJECT TO DEDUCTIBLES AND COINSURANCE - CHARGES, Laboratory (D_5_HOS_C4_60)",Radioisotope (D_4_HOS_C13_56),Excess of customary charges (E_B_HOS_C1_19),Is this hospital an All-Inclusive rate provider? (Y/N) (S2_1_C1_115),Delivery Room and Labor Room (D_4_HOS_C13_52),"HHA II, Total Other Charges (S4_HHA2_C5_34)",Renal Dialysis (D3_HOS_C2_74),Medical Supplies Charged to Patients (B_1_C26_71),Research (A_C6_191),Other Special Care (S3_1_C2_12),Amounts expected under 42 CFR (E_B_HOS_C1_16),"ADJUSTED SALARIES, Administrative and General (S3_2_C4_27)",Radiology-Therapeutic (D_4_HOS_C10_55),Home Program Dialysis (D3_SNF_C3_94),"Depreciation, New Cap Related Csts Bldg & Fixtures (A7_3_C9_1)",CMHC (A_C2_99),Total Program General Inpatient Routine (D1_HOS_C1_41),Cardiac Catheterization (D_4_SNF_C11_59),FQHC 2 Provider Number (S2_1_C2_1601),Coronary Care Unit (B_1_C26_32),"Total Inpatient Charges, Intensive Care Unit (C_1_C6_31)",MRI (B_1_C26_58),Intensive Care Unit (S3_1_C7_8),Subtotal (E_B_HOS_C1_30),HAC reduction adjustment amount (E_A_HOS_C1_7099),Coronary Care Unit (S3_1_C3_9),Total (S3_1_C2_7),Radiology-Therapeutic (A_C2_55),"Blood Storing, Processing, Trans (C_1_C6_63)",Emergency (D_4_IPF_C11_91),"COST REIMBURSED SERVICES SUBJECT TO DEDUCTIBLES  AND COINSURANCE - CHARGES, Whole Blood & Packed Red Blood Cells (D_5_HOS_C3_62)",Whole Blood & Packed Red Blood Cells (D_4_HOS_C12_62),Investments (G_C1THRU4_31),Total Liabilities and Fund Balances (G_C1THRU4_54),"HHA II, W/Out Outliers:  Number of Episodes (S4_HHA2_C1_36)",MRI (D3_IRF_C3_58),Other Long-term Liabilities (G_C1THRU4_49),Emergency (D_4_SNF_C11_91),"AMOUNT REPORTED, Home Office:  Physician Part A (S3_2_C2_15)","PAID HOURS RELATED TO SALARIES, SNF (S3_2_C5_9)","Medical certified liver 
transplant center cert date (S2_1_C1_128)",Other Ancillary (D_4_HOS_C4_76),Radioisotope (D3_HOS_C2_56),"COST SERVICES SUBJECT TO DEDUCTIBLES AND COINSURANCE - COST, Observation Beds (Distinct Unit) (D_5_HOS_C6_9201)",Respiratory Therapy (D3_SNF_C3_65),Radiology-Diagnostic (D_4_SNF_C11_54),Burn Intensive Care Unit (D_1_HOS_C6_33),"COST SERVICES SUBJECT TO DEDUCTIBLES AND COINSURANCE - COST, Cardiac Catheterization (D_5_HOS_C6_59)",Blood Clotting Factors for Hemoph. (D3_HOS_C2_6250),Other Ancillary (D_4_HOS_C10_76),Number of periods hospital was in MDH status (S2_1_C1_37),Durable Medical Equipment Rented (A_C1_96),"Blood Storing, Processing, Trans (D3_HOS_C2_63)",Whole Blood & Packed Red Blood Cells (D_4_IPF_C11_62),Subprovider 1 (S3_1_C8_18),"Blood Storing, Processing, Trans (B_1_C26_63)",CT Scan (D3_IPF_C2_57),"Purchases, Land Improvements (A7_1_C2_2)",Subprovider-IPF (A_C2_40),Medicaid (Title XIX) discharges (S3_1_C14_1),Speech Pathology (A_C6_68),SNF (S3_1_C7_19),Coronary Care Unit (D3_IPF_C2_32),Speech Pathology (D_4_IRF_C13_68),Physical Therapy (D_4_HOS_C3_66),OLTC (S3_1_C3_21),Less Contractual Allowance and Discounts on Patients' Accounts (G3_C1_2),IPF Provider Number (S2_1_C1_4),"Net Expense for Cost Allocation, Lung  Acquisition (B_1_C0_108)",Adults and Pediatrics (A_C6_30),"AVERAGE HOURLY WAGE, Home Office Salaries & Wage Related Csts (S3_2_C6_14)",Total (D_4_IRF_C11_200),"COST REIMBURSED SERVICES NOT SUBJECT TO DEDUCTIBLES AND COINSURANCE - CHARGES, Physical Therapy (D_5_HOS_C4_66)","ADJUSTED SALARIES, Subtotal Other Wages and Related Csts (S3_3_C4_4)","TOTAL CAPITAL COSTS AFTER COST ALLOCATION, Laboratory (B_2_C26_60)",Other Ancillary (D_4_HOS_C11_76),ASC (Non Distinct Part) (D_4_IPF_C11_75),OSP (B_2_C26_9940),Other Ancillary (D3_HOS_C2_76),"HHA I, Total Charges:  LUPA Episodes (S4_HHA1_C3_35)",In State Medicaid paid days (S2_1_C1_24),"Number of patients in program at 
end of cost reporting period (S5_C1_1)",Laundry and Linen Service (A_C6_8),Delivery Room and Labor Room (D3_IPF_C3_52),"Depreciation, New Cap Related Csts Movable Equipment (A7_3_C9_2)","Allocation of Interns & Residents Program Costs, SNF (B_1_C22_44)",Subprovider II (C_1_C5_4201),"COST REIMBURSED SERVICES NOT SUBJECT TO DEDUCTIBLES AND COINSURANCE - CHARGES, Other Ancillary (D_5_HOS_C4_76)",Radiology-Diagnostic (C_1_C5_54),RHC (C_1_C6_88),Interns & Res Salary and Fringe Benefits (A_C1_21),"Disposals and Retirements, Land Improvements (A7_1_C5_2)",Speech Pathology (D_4_HOS_C2_68),"PPS SERVICES COST, Drugs Charged to Patients (D_5_HOS_C5_73)",OSP (A_C6_9940),ASC (Non Distinct Part) (B_2_C26_75),"COST REIMBURSED SERVICES SUBJECT TO DEDUCTIBLES  AND COINSURANCE - CHARGES, Recovery Room (D_5_HOS_C3_51)",Electrocardiology (A_C1_69),Impl. Dev. Charged to Patients (D_4_HOS_C2_72),"COST SERVICES NOT SUBJECT TO DEDUCTIBLES AND COINSURANCE - COST, Home Program Dialysis (D_5_HOS_C7_94)",Stand-alone CHIP Cost (S10_C1_11),Total (D_1_HOS_C7_200),Durable Medical Equipment Sold (B_2_C26_97),Total Hospital Interns & Residents (S3_1_C11_14),Respiratory Therapy (D3_IRF_C3_65),"AMOUNT REPORTED, Home Office Salaries (S3_2_C3_1401)","COST SERVICES SUBJECT TO DEDUCTIBLES AND COINSURANCE - COST, Radiology-Therapeutic (D_5_HOS_C6_55)",Observation Beds (Distinct Unit) (D_4_HOS_C2_9201),Occupational Therapy (D3_SNF_C3_67),Laboratory (D3_HOS_C3_60),Other Outpatient Services (D3_IPF_C3_93),"AMOUNT REPORTED, Non-Physician Anesthetist Part A (S3_2_C2_20)",Home Program Dialysis (D_4_HOS_C3_94),"COST REIMBURSED SERVICES SUBJECT TO DEDUCTIBLES  AND COINSURANCE - CHARGES, Delivery Room and Labor Room (D_5_HOS_C3_52)","HHA II, PEP Episodes:  Other Charges (S4_HHA2_C4_34)",Drugs Charged to Patients (D3_HOS_C2_73),Blood Clotting Factors for Hemoph. (B_1_C26_6250),"HHA II, Total Charges (S4_HHA2_C5_35)","AMOUNT REPORTED, Physician Part B (S3_2_C2_23)",Emergency (D3_HOS_C2_91),Delivery Room and Labor Room (D_4_HOS_C2_52),ICF (S3_1_C2_2001),Cost of patients approved for charity care and uninsured discounts (S10_C2_21),"Total Inpatient Charges, Radiology-Therapeutic (C_1_C6_55)",Total discharges (S3_1_C15_18),Radiology-Diagnostic (A_C1_54),Telephone Services (A8_C2_7),"Depreciation, Total (A7_3_C9_3)",Hospital Adlts & Ped Swing Bed SNF (S3_1_C7_5),Respiratory Therapy (D3_IPF_C2_65),Operating Room (A_C1_50),Anesthesiology (D3_IRF_C2_53),Hospice (B_1_C26_116),Total Subprovider I Interns & Residents (S3_1_C9_18),"Allocation of Interns & Residents Salary and Fringes, Occupational Therapy (B_1_C21_67)","COST SERVICES SUBJECT TO DEDUCTIBLES AND COINSURANCE - COST, CT Scan (D_5_HOS_C6_57)",Medicare Certified Heart TC term date (S2_1_C2_127),"PPS SERVICES COST, Durable Medical Equipment Rented (D_5_HOS_C5_96)",ASC (Non Distinct Part) (B_1_C21_75),Whole Blood & Packed Red Blood Cells (D3_SNF_C2_62),Electroencephalography (C_1_C6_70),"PPS REIMBURSED SERVICES -  CHARGES, Speech Pathology (D_5_HOS_C2_68)","Number of Times per week
 Patient receives Dialysis (S5_C6_2)","Allocation of Interns & Residents Program Costs, Subprovider-IPF (B_1_C22_40)",Drugs Charged to Patients (B_1_C22_73),Subprovider 2 (S3_1_C2_1801),"Allocation of Interns & Residents Salary and Fringes, Intravenous Therapy (B_1_C21_64)",Radiology-Therapeutic (D_4_IRF_C11_55),Out of State Medicaid paid days (S2_1_C3_24),Physical Therapy (D_4_IPF_C13_66),Operating Room (D_4_HOS_C11_50),Intensive Care Unit (D3_SNF_C2_31),Title XVIII discharges (S3_1_C13_14),Speech Pathology (D_4_IRF_C11_68),Respiratory Therapy (D_4_IPF_C13_65),Pancreas Acquisition (B_1_C22_109),PBP Clinical Lab Services Program Only (D3_IRF_C2_61),PBP Clinical Lab Services Program Only (D3_HOS_C3_61),Heart Acquisition (A_C6_106),Cardiac Catheterization (D3_SNF_C2_59),"Total Inpatient Charges, PBP Clinical Lab Services Program Only (C_1_C6_61)",Clinic (D_4_HOS_C3_90),Emergency (D_4_HOS_C12_91),Subprovider I (D3_IPF_C2_42),"Donations, Building Improvements (A7_1_C3_4)",Other Reimbursable (C_1_C6_98),"AMOUNT REPORTED, Housekeeping (S3_2_C2_32)","Net Expense for Cost Allocation, Other General Service (B_1_C0_18)","Total Inpatient Charges, Coronary Care Unit (C_1_C6_32)",Total Adults & Peds (S3_1_C6_7),NF (C_1_C5_45),"Allocation of Interns & Residents Program Costs, Anesthesiology (B_1_C22_53)",Charity care charges and uninsured discounts for the entire facility (S10_C3_20),HHA 3 Provider Number (S2_1_C2_1202),RHC 4 Provider Number (S2_1_C2_1503),"PPS SERVICES COST, Anesthesiology (D_5_HOS_C5_53)",OLTC (S3_1_C9_21),Subprovider-IPF (D_1_HOS_C6_40),"COST SERVICES NOT SUBJECT TO DEDUCTIBLES AND COINSURANCE - COST, Durable Medical Equipment Rented (D_5_HOS_C7_96)","AVERAGE HOURLY WAGE, Operation of Plant (S3_2_C6_30)","General Inpatient Routine Service Cost, net of Swing Bed and Private Room Diff (D1_IRF_C1_37)","Purchases, Subtotal (A7_1_C2_8)","COST REIMBURSED SERVICES NOT SUBJECT TO DEDUCTIBLES AND COINSURANCE - CHARGES, Electroencephalography (D_5_HOS_C4_70)",Laboratory (D3_SNF_C3_60),Emergency (D3_SNF_C3_91),"AMOUNT REPORTED, Excluded Area Salaries (S3_3_C2_2)",Anesthesiology (D_4_SNF_C11_53),"HHA I, LUPA Episodes:  Total Visits (S4_HHA1_C3_33)",Subprovider II (A_C2_4201),Outpatient Rehab Provider (S3_1_C7_25),"Allocation of Interns & Residents Salary and Fringes, OLTC (B_1_C21_46)","Net Expense for Cost Allocation, ASC (Non Distinct Part) (B_1_C0_75)","Total Inpatient Charges, Radiology-Diagnostic (C_1_C6_54)",Renal Dialysis (D_4_HOS_C11_74),"COST REIMBURSED SERVICES NOT SUBJECT TO DEDUCTIBLES AND COINSURANCE - CHARGES, Electrocardiology (D_5_HOS_C4_69)",Durable Medical Equipment Sold (B_1_C26_97),Renal Dialysis (D3_SNF_C3_74),"AVERAGE HOURLY WAGE, Administrative and General (S3_2_C6_27)","COST REIMBURSED SERVICES NOT SUBJECT TO DEDUCTIBLES AND COINSURANCE - CHARGES, MRI (D_5_HOS_C4_58)","COST SERVICES NOT SUBJECT TO DEDUCTIBLES AND COINSURANCE - COST, Anesthesiology (D_5_HOS_C7_53)",Cardiac Catheterization (D3_IPF_C3_59),PBP Clinical Lab Services Program Only (C_1_C5_61),Clinic (D_4_HOS_C12_90),"COST REIMBURSED SERVICES SUBJECT TO DEDUCTIBLES  AND COINSURANCE - CHARGES, Respiratory Therapy (D_5_HOS_C3_65)",Cardiac Catheterization (D3_HOS_C2_59),Impl. Dev. Charged to Patients (D3_HOS_C3_72),"HHA III, PEP Episodes:  Total Visits (S4_HHA3_C4_33)",Coronary Intensive Care Unit (D_1_HOS_C6_32),"PPS REIMBURSED SERVICES -  CHARGES, Clinic (D_5_HOS_C2_90)",Hospice (A_C6_116),"Allocation of Interns & Residents Salary and Fringes, Impl. Dev. Charged to Patients (B_1_C21_72)","AMOUNT REPORTED, Interns & Residents (S3_2_C3_2550)",Radioisotope (D_4_IRF_C13_56),Whole Blood & Packed Red Blood Cells (D_4_HOS_C2_62),"Net Expense for Cost Allocation, Other Special Purpose (B_1_C0_117)",Social Service (A_C6_17),Payments received from patients for amounts previously written off as charity care (S10_C1_22),"COST SERVICES NOT SUBJECT TO DEDUCTIBLES AND COINSURANCE - COST, Respiratory Therapy (D_5_HOS_C7_65)",Notes and Loans Payable (short term) (G_C1THRU4_40),IPF (S3_1_C5_16),"HHA III, Without Outliers:  Total Visits (S4_HHA3_C1_33)","COST SERVICES SUBJECT TO DEDUCTIBLES AND COINSURANCE - COST, Impl. Dev. Charged to Patients (D_5_HOS_C6_72)","COST SERVICES NOT SUBJECT TO DEDUCTIBLES AND COINSURANCE - COST, ASC (Non Distinct Part) (D_5_HOS_C7_75)",Electrocardiology (D3_IRF_C3_69),Are provider based physicians' costs included in Worksheet A? (Y/N) (S2_1_C1_144),"AVERAGE HOURLY WAGE, Home Office Personnel (S3_2_C6_8)","Total Inpatient Charges, Radioisotope (C_1_C6_56)",Excess of reasonable cost over reasonable charges (E_B_HOS_C1_20),Operating Room (D_4_HOS_C12_50),"ADJUSTED SALARIES, Non-Physician Part B (S3_2_C4_6)","PPS SERVICES COST, Emergency (D_5_HOS_C5_91)",Fixed Equipment (G_C1THRU4_19),Organ Procurement (D4_INTESTINE_C1_69),"Net Expense for Cost Allocation, Radiology-Therapeutic (B_1_C0_55)",Other Nonreimbursable (B_1_C26_194),FQHC 7 Provider Number (S2_1_C2_1606),"PAID HOURS RELATED TO SALARIES, Physician-Part B (S3_2_C5_5)",Physical Therapy (C_1_C6_66),RHC (D_4_HOS_C2_88),"PAID HOURS RELATED TO SALARIES, Excluded Area Salaries (S3_3_C5_2)",Nonpaid Workers (B_1_C21_193),Medical Supplies Charged to Patients (C_1_C6_71),"PAID HOURS RELATED TO SALARIES, Contract Labor (S3_2_C5_11)",Home Program Dialysis (C_1_C7_94),"COST SERVICES SUBJECT TO DEDUCTIBLES AND COINSURANCE - COST, Durable Medical Equipment Sold (D_5_HOS_C6_97)",Total Program Inpatient Costs (D1_IRF_C1_49),"Total, New Cap Related Csts Bldg & Fixtures (A7_3_C15_1)",Total costs for patients covered by a state or local government program (S10_C1_15),ASC (Distinct Part) (B_1_C22_115),"Gift, Flower, Coffee Shop, Canteen (B_1_C26_190)",CT Scan (D_4_IRF_C11_57),Organ Procurement (D4_HEART_C1_69),Research (B_2_C26_191),Cardiac Catheterization (D_4_HOS_C10_59),Observation Beds (Distinct Unit) (D_4_HOS_C3_9201),"COST SERVICES SUBJECT TO DEDUCTIBLES AND COINSURANCE - COST, Radioisotope (D_5_HOS_C6_56)",Non-physician Anesthetist (A8_C2_28),Clinic (D3_SNF_C2_90),"COST SERVICES SUBJECT TO DEDUCTIBLES AND COINSURANCE - COST, Renal Dialysis (D_5_HOS_C6_74)","Allocation of Interns & Residents Salary and Fringes, Anesthesiology (B_1_C21_53)",ASC (Non Distinct Part) (D3_IPF_C3_75),Intestinal Acquisition (A_C6_110),Title XVIII discharges (S3_1_C13_17),Observation Beds (Distinct Unit) (A_C1_9201),Total Hospital (S3_1_C5_7),Other Ancillary (A_C1_76),Total Outpatient Program Pass Thru Cost (D_4_IRF_C6_200),"PAID HOURS RELATED TO SALARIES, Home Office Salaries & Wage Related Csts (S3_2_C5_14)","AVERAGE HOURLY WAGE, Total (S3_3_C6_6)",Total (C_1_C5_202),Total Nursing School (D_4_IRF_C2_200),"HHA I, Without Outliers:  Total Charges (S4_HHA1_C1_35)",Radiology-Therapeutic (B_1_C26_55),Cardiac Catheterization (D3_IRF_C2_59),"TOTAL CAPITAL COSTS AFTER COST ALLOCATION, Intensive Care Unit (B_2_C26_31)","HHA II, Total Number of Outlier Episodes (S4_HHA2_C5_37)",Clinic (D3_SNF_C3_90),"Other Capital Related Costs, Total (A7_3_C7_3)",IRF (S3_1_C3_17),"PAID HOURS RELATED TO SALARIES, Total (S3_3_C5_6)",Government grants or appropriations or transfers for support of hospital operations (S10_C1_18),"TOTAL CAPITAL COSTS AFTER COST ALLOCATION, Burn Intensive Care Unit (B_2_C26_33)",ICF Provider Number (S2_1_C2_1001),"Total Inpatient Charges, Other Special Care Unit (C_1_C6_35)",Other Special Purpose (C_1_C6_117),RHC 18 Provider Number (S2_1_C2_1517),Interns & Res Other Program Costs (A_C2_22),Durable Medical Equipment Rented (D3_IPF_C2_96),Electroencephalography (D_4_SNF_C11_70),"COST SERVICES NOT SUBJECT TO DEDUCTIBLES AND COINSURANCE - COST, Electroencephalography (D_5_HOS_C7_70)",Anesthesiology (D3_SNF_C3_53),"Blood Storing, Processing, Trans (D3_IPF_C2_63)",Emergency (D3_IPF_C3_91),Electrocardiology (D_4_IRF_C13_69),"TOTAL CAPITAL COSTS AFTER COST ALLOCATION, Surgical Intensive Care Unit (B_2_C26_34)",Delivery Room and Labor Room (A_C6_52),Intravenous Therapy (D_4_HOS_C13_64),ASC (Non Distinct Part) (D_4_IPF_C13_75),"PAID HOURS RELATED TO SALARIES, Total Salaries (S3_2_C5_1)",HHA (B_2_C26_101),Total Salaries (A_C1_200),Intravenous Therapy (A_C1_64),"Beginning Balances, Movable Equipment (A7_1_C1_6)",Observation Beds (Distinct Unit) (D_4_IPF_C13_9201),"Total Outpatient Charges, PBP Clinical Lab Services Program Only (C_1_C7_61)",Ambulance Services (A_C1_95),SNF (C_1_C5_44),"Blood Storing, Processing, Trans (C_1_C7_63)",OPT (C_1_C7_9920),Radiology-Therapeutic (D3_IRF_C3_55),"Total Outpatient Charges, Blood Clotting Factors for Hemoph. (C_1_C7_6250)",Electroencephalography (C_1_C5_70),Other Reimbursable (D3_HOS_C3_98),Burn Intensive Care Unit (S3_1_C4_10),Medical Supplies Charged to Patients (D3_IPF_C3_71),PBP Clinical Lab Services Program Only (D3_IRF_C3_61),"PPS SERVICES COST, Operating Room (D_5_HOS_C5_50)",Other Ancillary (A_C6_76),"Allocation of Interns & Residents Salary and Fringes, Whole Blood & Packed Red Blood Cells (B_1_C21_62)","Net Expense for Cost Allocation, New Capital Buildings and Fixtures (B_1_C0_1)",Total Current Assets (G_C1THRU4_11),"PPS REIMBURSED SERVICES -  CHARGES, Durable Medical Equipment Rented (D_5_HOS_C2_96)",Blood Clotting Factors for Hemoph. (D3_HOS_C3_6250),Nursery (D_1_HOS_C4_43),Rental of Provider space by suppliers (A8_C2_6),Pharmacy (A_C6_15),Pancreas Acquisition (A_C2_109),Electrocardiology (B_1_C26_69),CT Scan (D_4_IPF_C11_57),Geographic MSA (MSA),Payments received from patients for amounts previously written off as charity care (S10_C2_22),Respiratory Therapy (C_1_C6_65),Durable Medical Equipment Rented (D_4_HOS_C3_96),Cardiac Catheterization (D3_IPF_C2_59),"AMOUNT REPORTED, Other General Service (S3_2_C2_43)","COST SERVICES NOT SUBJECT TO DEDUCTIBLES AND COINSURANCE - COST, Whole Blood & Packed Red Blood Cells (D_5_HOS_C7_62)",ICF (S3_1_C3_2001),Ambulance Services (C_1_C5_95),"Net Expense for Cost Allocation, Nonphysician Anesthetists (B_1_C0_19)","COST SERVICES SUBJECT TO DEDUCTIBLES AND COINSURANCE - COST, Electroencephalography (D_5_HOS_C6_70)",Radiology-Diagnostic (D_4_HOS_C2_54),"HHA II, PEP:  Total Number of Outlier Episodes (S4_HHA2_C4_37)",Electroencephalography (D_4_HOS_C4_70),Total Hospital Interns & Residents (S3_1_C10_14),Physicians' Private Office (B_1_C26_192),Adults & Pediatrics (D_1_HOS_C7_30),Electrocardiology (C_1_C7_69),Other Capital (A_C6_3),"PPS SERVICES COST, Renal Dialysis (D_5_HOS_C5_74)","AVERAGE HOURLY WAGE, Admin & Gen Under Contract (S3_2_C6_29)","Total Inpatient Charges, MRI (C_1_C6_58)","AMOUNT REPORTED, Laundry and Linen Service (S3_2_C2_31)",Cardiac Catheterization (D_4_HOS_C12_59),Electroencephalography (D3_HOS_C3_70),Durable Medical Equipment Rented (D3_SNF_C2_96),Other Ancillary (D3_SNF_C3_76),"Net Expense for Cost Allocation, Intensive Care Unit (B_1_C0_31)",Laboratory (B_1_C26_60),ICF (B_1_C26_4501),"AMOUNT REPORTED, Non-Physician Part B (S3_2_C2_6)",Speech Pathology (C_1_C5_68),Research (A_C1_191),Other Special Care Unit (D_3_HOS_C9_35),Clinic (D3_IPF_C3_90),HHA (B_1_C26_101),Operating Room (C_1_C5_50),"AVERAGE HOURLY WAGE, Dietary under Contract (S3_2_C6_35)",CT Scan (D3_IPF_C3_57),OLTC (A_C1_46),Renal Dialysis (D3_SNF_C2_74),PBP Clinical Lab Services Program Only (B_1_C26_61),Electrocardiology (D_4_HOS_C13_69),Utilization Review SNF (A_C1_114),Renal 10 Provider Number (S2_1_C2_1809),Renal Dialysis (A_C6_74),Nursing School (A_C6_20),RHC (C_1_C7_88),Total Program General Inpatient Routine (D1_IRF_C1_41),Kidney Acquisition (B_1_C21_105),Intravenous Therapy (D3_IRF_C3_64),Maintenance of Personnel (A_C6_12),"Number of days in year dialysis 
furnished (S5_C1_5)",Observation Beds (Distinct Unit) (B_1_C26_9201),Burn Intensive Care Unit (D3_IPF_C2_33),RPCH/CAH Visits (S3_1_C6_15),Pancreas Acquisition (B_1_C21_109),Other Outpatient Services (D3_SNF_C3_93),"Treatment capacity per day per
station (S5_C1_7)",Does the hospital qualify as RPCH/CAH? (Y/N) (S2_1_C1_105),Speech Pathology (C_1_C7_68),Title XVIII discharges (S3_1_C13_18),"Total Inpatient Charges, Blood Clotting Factors for Hemoph. (C_1_C6_6250)",HHA (C_1_C5_101),CMHC (B_1_C21_99),"Allocation of Interns & Residents Program Costs, Radioisotope (B_1_C22_56)",OOT (B_1_C26_9930),Cardiac Catheterization (C_1_C5_59),Recovery Room (A_C6_51),Electrocardiology (D_4_HOS_C12_69),"ADJUSTED SALARIES, Home Office Personnel (S3_2_C4_8)",Other Nonreimbursable (B_1_C22_194),"Disposals and Retirements, Fixed Equipment (A7_1_C5_5)","HHA I, LUPA Episodes:  Total Number of Episodes (S4_HHA1_C3_36)",Investment Income-New Bldgs & Fixtures (A8_C2_1),"AMOUNT REPORTED, Administrative & General under contract (S3_2_C2_28)","COST SERVICES SUBJECT TO DEDUCTIBLES AND COINSURANCE - COST, Blood Storing, Processing, Trans (D_5_HOS_C6_63)","Blood Storing, Processing, Trans (D_4_IRF_C11_63)",Other Outpatient Services (D3_HOS_C3_93),Radiology-Therapeutic (D_4_IRF_C13_55),Laboratory (D3_IPF_C2_60),Other Outpatient Services (D_4_IRF_C11_93),Total Program Inpatient Costs (D1_HOS_C1_49),Occupational Therapy (B_2_C26_67),Sequestration adjustment (E_B_HOS_C1_4001),"Allocation of Interns & Residents Program Costs, Cardiac Catheterization (B_1_C22_59)","Allocation of Interns & Residents Salary and Fringes, Other Special Care Unit (B_1_C21_35)",Employee Benefits (A_C1_4),"Total Program Inpatient Operating Cost excluding Capital Related, Nonphysician, Anesthetist, and Medical Education Costs (D1_IPF_C1_53)","If (SCH), enter the # of periods. (S2_1_C1_35)",SNF (S3_1_C8_19),Fiscal Year Begin Date (FY_BGN_DT),"AMOUNT REPORTED, Interns & Residents (S3_2_C2_25)","AMOUNT REPORTED, Interns & Residents (S3_2_C3_2553)",HHA (S3_1_C7_22),Clinic (A_C1_90),"COST SERVICES NOT SUBJECT TO DEDUCTIBLES AND COINSURANCE - COST, Recovery Room (D_5_HOS_C7_51)","Insurance, Total (A7_3_C5_3)",ICF (S3_1_C10_2001),MRI (D3_HOS_C2_58),RHC (A_C1_88),"COST REIMBURSED SERVICES SUBJECT TO DEDUCTIBLES  AND COINSURANCE - CHARGES, MRI (D_5_HOS_C3_58)",Other Special Care (S3_1_C6_12),"AMOUNT REPORTED, Dietary under contract (S3_2_C2_35)",RPCH/CAH Visits (S3_1_C7_15),"General Inpatient Routine Service Cost, net of Swing Bed and Private Room Diff (D1_HOS_C1_37)",Intensive Care Unit (D3_IRF_C2_31),Observation Beds (Distinct Unit) (C_1_C7_9201),Coronary Care Unit (A_C1_32),Subprovider-IRF (A_C1_41),Nonpaid Workers (A_C6_193),ASC (Non Distinct Part) (A_C6_75),Laboratory (D3_IPF_C3_60),Renal Dialysis (D_4_IRF_C11_74),Intravenous Therapy (D_4_IRF_C13_64),Bonus Payment (D1_HOS_C1_58),Other Outpatient Services (C_1_C6_93),Other Ancillary (C_1_C7_76),"PPS SERVICES COST, ASC (Non Distinct Part) (D_5_HOS_C5_75)",Emergency (D3_IPF_C2_91),"ADJUSTED SALARIES, Housekeeping under contract (S3_2_C4_33)","ADJUSTED SALARIES, Housekeeping (S3_2_C4_32)",Total Bad Debt expense (S10_C1_26),"Net Expense for Cost Allocation, Dietary (B_1_C0_10)",Total Allied Health (D_4_HOS_C3_200),Subprovider-IPF (C_1_C5_40),"COST SERVICES NOT SUBJECT TO DEDUCTIBLES AND COINSURANCE - COST, Radiology-Diagnostic (D_5_HOS_C7_54)",ICF (A_C2_4501),Home Program Dialysis (B_1_C21_94),Other Ancillary (D_4_HOS_C12_76),Respiratory Therapy (D_4_IRF_C13_65),"Net Expense for Cost Allocation, Cardiac Catheterization (B_1_C0_59)",Administrative and General (A_C6_5),"ADJUSTED SALARIES, Interns & Residents (S3_2_C4_2551)","AVERAGE HOURLY WAGE, Housekeeping (S3_2_C6_32)",Prepaid expenses (G_C1THRU4_8),OSP (A_C2_9940),Total Hospital (S3_1_C7_14),RHC/FQHC Combined (S3_1_C10_26),Physical Therapy (D3_IRF_C3_66),Radioisotope (D_4_IPF_C13_56),ASC (Non Distinct Part) (D3_HOS_C2_75),"AMOUNT REPORTED, Dietary (S3_2_C2_34)",Nursing Administration (A_C6_13),"Net Expense for Cost Allocation, Nonpaid Workers (B_1_C0_193)","COST SERVICES NOT SUBJECT TO DEDUCTIBLES AND COINSURANCE - COST, MRI (D_5_HOS_C7_58)",Paid Losses (S2_1_C2_11801),Electrocardiology (D3_HOS_C3_69),Ancillary service other pass through costs (E_B_HOS_C1_9),Total Nonphysician Anesthetist Cost (D_4_IRF_C1_102),"COST REIMBURSED SERVICES NOT SUBJECT TO DEDUCTIBLES AND COINSURANCE - CHARGES, Anesthesiology (D_5_HOS_C4_53)",Cost of charity care (uninsured patients + patients w/ coverage not accepted by provider) (S10_C1_23),"Sum of lines 3,4 divided by line 6 (E_B_HOS_C101_7)",Laboratory (A_C1_60),Other Ancillary (D3_IPF_C2_76),"Net Expense for Cost Allocation, ASC (Distinct Part) (B_1_C0_115)",NF (S3_1_C5_20),Occupational Therapy (D3_IPF_C3_67),"Allocation of Interns & Residents Program Costs, Medical Supplies Charged to Patients (B_1_C22_71)",Drugs Charged to Patients (D_4_IRF_C13_73),Delivery Room and Labor Room (D_4_HOS_C4_52),"ADJUSTED SALARIES, SNF (S3_2_C4_9)","COST REIMBURSED SERVICES NOT SUBJECT TO DEDUCTIBLES AND COINSURANCE - CHARGES, ASC (Non Distinct Part) (D_5_HOS_C4_75)",Blood Clotting Factors for Hemoph. (D_4_HOS_C12_6250),Kidney Acquisition (A_C1_105),Intestinal Acquisition (A_C2_110),"COST SERVICES SUBJECT TO DEDUCTIBLES AND COINSURANCE - COST, PBP Clinical Lab Services Program Only (D_5_HOS_C6_61)",Intensive Care Unit (S3_1_C6_8),General Fund Balance (G_C1THRU4_52),"Disposals and Retirements, Total (A7_1_C5_10)",Laboratory (D_4_IPF_C11_60),"PPS REIMBURSED SERVICES -  CHARGES, Total (D_5_HOS_C2_200)",Accounts Receivable (G_C1THRU4_4),Radiology-Diagnostic (D_4_IPF_C13_54),FQHC 12 Provider Number (S2_1_C2_1611),Have you established a new subprovider excluded unit under 42 CFR 413.40(f)(1)(I)?(Y/N) (S2_1_C1_86),Occupational Therapy (C_1_C2_67),Related Organization Transactions (A8_C2_12),"HHA II, Total Charges:  LUPA Episodes (S4_HHA2_C3_35)",CT Scan (D_4_IPF_C13_57),"Are there any related organization or how office costs as defined in HCFA Pub. 15-I, chapter 10? (Y/N) (S2_1_C1_140)",Subprovider-IRF (D3_HOS_C2_41),Speech Pathology (A_C2_68),Observation Beds (Distinct Unit) (D_4_SNF_C11_9201),Delivery Room and Labor Room (A_C1_52),Other Special Purpose (C_1_C5_117),Medical Supplies Charged to Patients (D_4_HOS_C13_71),Health Information Technology Designated Assets (G_C1THRU4_27),Impl. Dev. Charged to Patients (D_4_HOS_C11_72),"COST REIMBURSED SERVICES SUBJECT TO DEDUCTIBLES  AND COINSURANCE - CHARGES, PBP Clinical Lab Services Program Only (D_5_HOS_C3_61)",NF (A_C2_45),Radiology-Diagnostic (D3_HOS_C3_54),Social Service (A_C2_17),"Net Expense for Cost Allocation, Impl. Dev. Charged to Patients (B_1_C0_72)","PAID HOURS RELATED TO SALARIES, Non-Physician Anesthetist Part B (S3_2_C5_3)",ICF (A_C1_4501),CMHC (B_1_C26_99),Anesthesiology (D_4_IRF_C11_53),Other Reimbursable (D3_SNF_C2_98),IPF (S3_1_C6_16),Total Patient Days (D_3_HOS_C6_200),"Number of patients in program at 
end of cost reporting period (S5_C3_1)","COST REIMBURSED SERVICES SUBJECT TO DEDUCTIBLES  AND COINSURANCE - CHARGES, Radiology-Diagnostic (D_5_HOS_C3_54)",Impl. Dev. Charged to Patients (D_4_HOS_C12_72),IRF (S3_1_C6_17),Operating Room (D_4_IPF_C11_50),Home Program Dialysis (A_C2_94),Other Nonreimbursable (A_C2_194),"COST REIMBURSED SERVICES NOT SUBJECT TO DEDUCTIBLES AND COINSURANCE - CHARGES, Radioisotope (D_5_HOS_C4_56)",Total Inpatient Program Days (D_3_HOS_C8_200),Subprovider-IRF (D_1_HOS_C4_41),HHA (S3_1_C11_22),RHC 12 Provider Number (S2_1_C2_1511),Emergency (D3_IRF_C2_91),"Allocation of Interns & Residents Program Costs, Intensive Care Unit (B_1_C22_31)","Total Inpatient Charges, Nursery (C_1_C6_43)",Impl. Dev. Charged to Patients (D3_IRF_C2_72),"PAID HOURS RELATED TO SALARIES, Other General Service (S3_2_C5_43)","HHA I, With Outliers:  Number of Episodes (S4_HHA1_C2_37)",Medicaid (Title XIX) discharges (S3_1_C14_14),"AMOUNT REPORTED, Nursing Administration (S3_2_C2_38)","Disposals and Retirements, Land (A7_1_C5_1)",Liver Acquisition (C_1_C6_107),Laboratory (D_4_HOS_C1_60),"TOTAL CAPITAL COSTS AFTER COST ALLOCATION, Adults & Pediatrics (B_2_C26_30)","PPS SERVICES COST, Other Reimbursable (D_5_HOS_C5_98)",Land (G_C1THRU4_12),Radiology-Therapeutic (D_4_IPF_C13_55),Recovery Room (D_4_IPF_C13_51),Radiology-Diagnostic (D_4_HOS_C1_54),Medicaid Observation Days (S3_1_C8_28),"PAID HOURS RELATED TO SALARIES, Medical Records & Med Records Library (S3_2_C5_41)","Allocation of Interns & Residents Program Costs, Intravenous Therapy (B_1_C22_64)",Pancreas Acquisition (A_C1_109),Physical Therapy (A_C6_66),Surgical Intensive Care Unit (D3_HOS_C2_34),Total (B_2_C26_202),Radioisotope (C_1_C5_56),"Fully Depreciated Assets, Total (A7_1_C7_10)",FQHC (B_1_C21_89),Number of EPO units furnished for Line 13 (S5_C1_15),Laboratory (D3_IRF_C2_60),Radioisotope (D3_SNF_C2_56),Number of stations (S5_C2_6),"Allocation of Interns & Residents Salary and Fringes, Recovery Room (B_1_C21_51)",SNF (S3_1_C2_19),Speech Pathology (D3_SNF_C2_68),Drugs Charged to Patients (A_C1_73),"Number of patients on transplant 
list (S5_C1_11)",Intravenous Therapy (D_4_HOS_C10_64),"COST REIMBURSED SERVICES SUBJECT TO DEDUCTIBLES  AND COINSURANCE - CHARGES, Other Reimbursable (D_5_HOS_C3_98)",Lung  Acquisition (B_1_C21_108),"Allocation of Interns & Residents Salary and Fringes, Electrocardiology (B_1_C21_69)",Other Reimbursable (D3_HOS_C2_98),Physical Therapy (A_C1_66),"Blood Storing, Processing, Trans (D3_IRF_C2_63)",Electroencephalography (D_4_HOS_C3_70),Lung  Acquisition (A_C2_108),Radioisotope (D3_IPF_C2_56),Speech Pathology (C_1_C2_68),"AMOUNT REPORTED, Cafeteria (S3_2_C2_36)","Disposals and Retirements, Buildings and Fixtures (A7_1_C5_3)","Allocation of Interns & Residents Program Costs, Electrocardiology (B_1_C22_69)",Other Ancillary (D_4_IRF_C11_76),Other Organ Acquisition (C_1_C5_112),"Lease, New Cap Related Csts Bldg & Fixtures (A7_3_C10_1)",Nursing School (A8_C2_19),Nursing School (A_C1_20),certification date (S2_1_C1_132),"COST REIMBURSED SERVICES NOT SUBJECT TO DEDUCTIBLES AND COINSURANCE - CHARGES, CT Scan (D_5_HOS_C4_57)",Other Outpatient Services (D_4_HOS_C11_93),Cross Foot Adjustments (B_2_C26_200),Renal Dialysis (D_4_HOS_C2_74),Anesthesiology (D_4_HOS_C13_53),Recovery Room (A_C2_51),"PPS REIMBURSED SERVICES -  CHARGES, Other Reimbursable (D_5_HOS_C2_98)",Other Reimbursable (D3_SNF_C3_98),Recovery Room (D3_SNF_C3_51),Zip Code (S2_1_C3_143),Other Organ Acquisition (C_1_C6_112),Home Office PO Box (S2_1_C2_142),Intravenous Therapy (C_1_C6_64),"Net Expense for Cost Allocation, Paramedical Education (B_1_C0_23)",Durable Medical Equipment Sold (A_C1_97),Total Charges (C_1_C8_202),"General Inpatient Routine Service Cost, net of Swing Bed Cost (D1_IRF_C1_27)",Total Nursing School (D_4_IPF_C2_200),"COST REIMBURSED SERVICES NOT SUBJECT TO DEDUCTIBLES AND COINSURANCE - CHARGES, Durable Medical Equipment Rented (D_5_HOS_C4_96)",RHC 22 Provider Number (S2_1_C2_1521),Clinic (D_4_SNF_C11_90),MDH status ending date (MM/DD/YY) (S2_1_C2_3801),Radiology-Diagnostic (D_4_IRF_C11_54),SNF (S3_1_C9_19),Net Income from Service to Patients (G3_C1_5),Labor and Delivery (S3_1_C2_32),Physical Therapy (D_4_HOS_C13_66),RHC (A_C6_88),"Net Expense for Cost Allocation, Clinic (B_1_C0_90)","PPS SERVICES COST, Intravenous Therapy (D_5_HOS_C5_64)",Ratio of line 15 to line 16 (E_B_HOS_C1_17),"Number of patients transplanted 
during fiscal year (S5_C1_12)",RHC/FQHC Combined (S3_1_C11_26),Burn Intensive Care Unit (B_1_C26_33),OLTC (S3_1_C10_21),ASC (Distinct Part) (A_C6_115),"ADJUSTED SALARIES, Operation of Plant (S3_2_C4_30)",ASC (Non Distinct Part) (B_1_C26_75),"Net Expense for Cost Allocation, Other Nonreimbursable (B_1_C0_194)",Other Special Care Unit (C_1_C5_35),Provider-based physician adjustment (A8_C2_10),Impl. Dev. Charged to Patients (D_4_IPF_C11_72),"COST SERVICES SUBJECT TO DEDUCTIBLES AND COINSURANCE - COST, Other Outpatient Services (D_5_HOS_C6_93)",RHC (B_1_C22_88),CMHC (S3_1_C6_25),HHA (A_C1_101),Home Program Dialysis (D3_SNF_C2_94),"PPS SERVICES COST, Radiology-Diagnostic (D_5_HOS_C5_54)","HHA II, With Outliers:  Total Charges (S4_HHA2_C2_35)",Net revenue from state/local govt indigent care (not Medicaid or CHIP) (S10_C1_13),Anesthesiology (A_C1_53),Recovery Room (D3_HOS_C2_51),Radioisotope (D3_IPF_C3_56),"Gift, Flower, Coffee Shop, Canteen (B_2_C26_190)","HHA II, LUPA Episodes:  Total Number of Episodes (S4_HHA2_C3_36)",Impl. Dev. Charged to Patients (D3_HOS_C2_72),TOTAL (D3_SNF_C2_202),Other Outpatient Services (D_4_IRF_C13_93),Home Program Dialysis (B_2_C26_94),"Total Outpatient Charges, MRI (C_1_C7_58)","Allocation of Interns & Residents Salary and Fringes, Radiology-Therapeutic (B_1_C21_55)","If an Organ Procurement Organization, enter the OPO number (S2_1_C1_134)",Total Adults & Pediatrics (S3_1_C8_7),Intestinal Acquisition (B_2_C26_110),"COST SERVICES NOT SUBJECT TO DEDUCTIBLES AND COINSURANCE - COST, Operating Room (D_5_HOS_C7_50)",Hospital PO Box (S2_1_C2_1),Radiology-Therapeutic (D3_SNF_C3_55),Renal 1 Provider Number (S2_1_C2_18),Respiratory Therapy (A_C6_65),Medicaid HMO Days (S2_1_C5_24),"PPS REIMBURSED SERVICES -  CHARGES, ASC (Non Distinct Part) (D_5_HOS_C2_75)",Program Inpatient Ancillary Service Cost (D1_IPF_C1_48),RHC 17 Provider Number (S2_1_C2_1516),Whole Blood & Packed Red Blood Cells (A_C1_62),ASC (Non Distinct Part) (D_4_HOS_C2_75),"Allocation of Interns & Residents Salary and Fringes, MRI (B_1_C21_58)",Other Ancillary (D3_IRF_C3_76),Cardiac Catheterization (D_4_IPF_C11_59),Liver Acquisition (A_C2_107),Durable Medical Equipment Rented (B_2_C26_96),CMHC (C_1_C5_99),Total Hospital (S3_1_C8_14),Drugs Charged to Patients (B_1_C26_73),Radiology-Diagnostic (D_4_IPF_C11_54),"COST SERVICES NOT SUBJECT TO DEDUCTIBLES AND COINSURANCE - COST, Electrocardiology (D_5_HOS_C7_69)","Blood Storing, Processing, Trans (D_4_HOS_C3_63)",Anesthesiology (D_4_IPF_C11_53),Refunds and Rebates of Expenses (A8_C2_5),"Allocation of Interns & Residents Program Costs, Radiology-Diagnostic (B_1_C22_54)",Nursing School (A_C2_20),Int & Res (non approved teaching program (C_1_C7_100),Total Hospital (S3_1_C6_14),Emergency (B_1_C22_91),Laboratory (D_4_HOS_C10_60),Intensive Care Unit (D_3_HOS_C9_31),Clinic (D_4_IRF_C11_90),Operating Room (D_4_HOS_C10_50),Maintenance and Repairs (A_C1_6),Medical Supplies Charged to Patients (D_4_HOS_C12_71),Durable Medical Equipment Rented (D3_HOS_C3_96),Occupational Therapy (D_4_HOS_C3_67),"COST REIMBURSED SERVICES SUBJECT TO DEDUCTIBLES  AND COINSURANCE - CHARGES, Durable Medical Equipment Sold (D_5_HOS_C3_97)",Intravenous Therapy (D_4_IPF_C11_64),NF (S3_1_C9_20),Whole Blood & Packed Red Blood Cells (D_4_HOS_C3_62),Whole Blood & Packed Red Blood Cells (D_4_IPF_C13_62),Electrocardiology (C_1_C6_69),Emergency (D3_SNF_C2_91),Other Outpatient Services (D_4_HOS_C13_93),"Net Expense for Cost Allocation, Cafeteria (B_1_C0_11)",Impl. Dev. Charged to Patients (D_4_HOS_C13_72),"PAID HOURS RELATED TO SALARIES, Non-Physician Part B (S3_2_C5_6)","Blood Storing, Processing, Trans (D3_SNF_C2_63)","Gift, Flower, Coffee Shop, Canteen (A_C1_190)",Notes Payable (G_C1THRU4_47),Observation Beds (Distinct Unit) (D3_HOS_C2_9201),RHC/FQHC Combined (S3_1_C9_26),"AMOUNT REPORTED, Excluded Areas (S3_2_C2_19)","Fully Depreciated Assets, Subtotal (A7_1_C7_8)",Electroencephalography (D_4_IPF_C11_70),Hospital Adults & Ped Swing Bed SNF (S3_1_C6_5),Emergency (D_4_IRF_C11_91),Total prospective payment (E_B_HOS_C1_24),Other Organ Acquisition (B_1_C26_112),Total Hospital (S3_1_C3_7),Total (D_4_HOS_C12_200),"General Inpatient Routine Service Cost, net of Swing Bed Cost (D1_HOS_C1_27)","COST REIMBURSED SERVICES NOT SUBJECT TO DEDUCTIBLES AND COINSURANCE - CHARGES, Other Reimbursable (D_5_HOS_C4_98)",IRF Provider Number (S2_1_C1_5),Renal 5 Provider Number (S2_1_C2_1804),Home Program Dialysis (D3_IPF_C3_94),Adults and Pediatrics (A_C2_30),Laboratory (D_4_HOS_C12_60),"Number of Times per week
 Patient receives Dialysis (S5_C2_2)","Fully Depreciated Assets, Disp. And Retirement (A7_1_C5_7)",ASC (Non Distinct Part) (D_4_HOS_C11_75),"Total Outpatient Charges, Operating Room (C_1_C7_50)",Medical Supplies Charged to Patients (D3_SNF_C3_71),Surgical Intensive Care Unit (S3_1_C5_11),Impl. Dev. Charged to Patients (B_2_C26_72),Cardiac Catheterization (D3_SNF_C3_59),Total Adults & Peds (S3_1_C7_7),"PAID HOURS RELATED TO SALARIES, Net Salaries (S3_3_C5_1)",Heart Acquisition (C_1_C7_106),Other Ancillary (D_4_HOS_C1_76),"COST REIMBURSED SERVICES NOT SUBJECT TO DEDUCTIBLES AND COINSURANCE - CHARGES, Radiology-Diagnostic (D_5_HOS_C4_54)",Lung  Acquisition (B_1_C26_108),Intestinal Acquisition (B_1_C26_110),CORF (A_C6_9910),"ADJUSTED SALARIES, Employee Benefits (S3_2_C4_26)",Payment to cost ratio (E_B_HOS_C101_5),"HHA I, PEP Episodes:  Total Visits (S4_HHA1_C4_33)","ADJUSTED SALARIES, Dietary (S3_2_C4_34)",Report_Period_Begin_Yr,Beginning FFY,Medicaid Shortfall (S10_C1_8),Stand-alone CHIP Shortfall (S10_C1_12),State or local govt Shortfall (S10_C1_16),Charity Care Expense Ratio,Total Net Assets,Medicaid Costs,Cash Reserves,Net Profit Margin,Operating Profit,Operating Profit Margin,LIQUIDITY current ratio,LIQUIDITY acid-test ratio,LIQUIDITY acid-test ratio (variation),LIQUIDITY cash ratio,Equity,SOLVENCY Debt-to-Equity Ratio,SOLVENCY Debt Ratio,SOLVENCY Equity Ratio,SOLVENCY Interest Coverage Ratio,SOLVENCY total assets less total liabilities,EFFICIENCY asset turnover ratio,EFFICIENCY Accounts Receivable Turnover Ratio,Hospital Type (From CMS Hospitals Data Archive),General Ownership Type,Medicaid Expansion State,Name and Num
7015,NEW YORK METHODIST HOSPITAL - ACUTE (330236),General Short Term (Acute Care Hospitals),Voluntary Nonprofit-Other,-73.979141,40.668263,1952165.0,,-460902.0,,,,,14571369.0,3058384.0,,,,,97762.0,,NY,,,20478631.0,2204.0,,,,18874667.0,,Y,,,1537455.0,,,,,13131968.0,,KINGS,301448576.0,101.24,,,,651685.0,2011-12-31,334379.0,,,,,,,33665.0,,,,,659744.0,,,,,277128.0,,,,,142376.0,,11827971.0,1783886.0,,,,65856096.0,,,,13931.0,,21628532.0,,1015442.0,,,14570233.0,,,,-448.0,,160.0,,,,33S236,,,,,,,100.04,,26902.0,,4483336.0,,,535461.0,3717181.0,,,,,456483624.0,,,,,,Y,14967234.0,,,,,,,,4865873.0,,,,309137.0,,,3441945.0,6246753.0,,,,,,,2474868.0,,3633893.0,,4434233.0,,,,,,,,,207915.0,,,32704025.0,1774697.0,,588482.0,,,,,,,,2204.0,,,,,67322.0,14802451.0,,,,-101215.0,,105495.0,199206278.0,,,,575207.0,15576.0,5776111.0,,,3961521.0,,,259242.0,2465639.0,,35644,,,,867193.0,,73.7,,,1664939.0,1672562.0,,1874287.0,,,,,9134.0,,1565.0,,,,,,16090000.0,98394.0,15.0,,,N,814281.0,,14559120.0,,,,,,,303877000.0,,,,,,6153669.0,,,,,5326689.0,,,8965.0,,32.88,,,,,,NEW YORK METHODIST HOSPITAL,328721488.0,,,,,,,,,,,,,14454.0,,,,576860.0,,,,,22144.0,,,,18897230.0,6817566.0,,3770.0,,,,-3135884.0,,,,,,,,167867.0,6216136.0,,,,9.0,,,,,10682164.0,,,4928638.0,,,564738.0,23524.0,84804.0,,717091.0,171459.0,,,,1733200.0,,,11819891.0,,7671847.0,2024-06-25 00:00:00,,,57989.0,,72096.0,30458.0,6808171.0,,,7468637.0,,1329983.0,172965.0,129147.0,,,,381714.0,54673.0,,,45435.0,,,,,58236428.0,,,100337.0,,144.18,6960048.0,,1618430.0,,7007303.0,,,,71.93,7881752.0,,10937604.0,,142376.0,,,,417233.0,24737.0,454329086.0,,,,,18024961.0,,,,17.01,,111655.0,,,2535.0,,,2555063.0,,11325.0,-1614.0,9134.0,1464285.0,,,1357198.0,,,18087100.0,1357198.0,,7736421.0,13730.0,,,,,969839.0,,,,,41535.0,,6060771.0,,,,,,,11435.0,,,,4686295.0,,,,,19789875.0,-634471.0,,,,111015.0,,2923345.0,,,,,,,,,3361.0,,,,,,,,3539704.0,165430172.0,,,,,,,,8096.0,,,6461239.0,,3933141.0,,,,695167.0,,,,47483574.0,4748287.0,,,,,,,403620.0,9465.0,,,40.12,,11867.0,2268028.0,,,,,118398.0,,,,,,,4506.0,,,,523419794.0,,,,1322135.0,871862.0,,,3669813.0,175563914.0,,,,,28409306.0,,,43300.0,,,,,,7928155.0,53055.0,,,70264.0,861317.0,,8197318.0,,,,7788141.0,,,,,14993.0,,,,,,,,,,32.79,,,,,,,,,25200570.0,680532.0,17551.0,,,,,,,,,9168.0,,,922.0,,,,,,695167.0,,,,,,,,,57306.0,,,12918337.0,2204.0,,,,,,,351515.0,,20062.0,,,,,,,,,,,,,,286883735.0,,,,-1006444.0,1941335.0,,11465922.0,40965.0,2566134.0,,212874.0,191008960.0,436664.0,,,-89333.0,,,-416517.0,,,35978553.0,,,,1746174.0,,,4813278.0,3025652.0,,,,,,,,2822936.0,,,,1399515.0,,27.08,,118568828.0,,412700.0,,,822548.0,4434233.0,,100330.0,,,,3845.0,,,78158.0,17832006.0,,,1641.0,,,,76487352.0,,,4952994.0,,,,,,3900.0,,14472325.0,67048.0,875519647.0,,89514.0,,,,21019998.0,4733952.0,17185040.0,,,,,,,,,72700.0,5038560.0,,,1089692.0,4110.0,,,,5766094.0,,7048680.0,,4110739.0,,,,138818.0,,,,,8098975.0,,,,,40112.0,,,,9679649.0,,,4187848.0,1040707.0,78524531.0,,,,,,,31002640.0,,,,,,,,,,1.0,,,122850.0,34103.0,,910.0,224445.0,,,,4110.0,,,,1724134.0,,,,,,,,197172.0,,,73158821.0,,18250.0,,,1762254.0,2923345.0,,,,,7007303.0,,1362048.0,54673.0,767.0,646611.0,,296926.0,2762353.0,,,,659744.0,,,1713823.0,1828680.0,51.0,165615337.0,,,,,,646611.0,187.0,1928069.0,1804791.0,384791.0,249.76,,,,7726024.0,,65856096.0,,,,458203003.0,,,,128295.0,,,,,,,5009494.0,,107969.0,16347467.0,,,112908.0,,,4110.0,1724134.0,,,,,27766476.0,,1778958.0,,,,,,,,2849.0,4768252.0,,48015.0,240919.0,,262065.0,,,,32.67,,,6805477.0,,1466226.0,,,,,,1224914.0,80535.0,,-10272071.0,,,15405.0,275259.0,,,,8567.0,,,,23842985.0,,,219590.0,,,,,,,21.74,,,,,,,,4194455.0,,4748287.0,,6817566.0,,,45655013.0,7163288.0,25836915.0,,2088070.0,,,,,,,319354.0,7928155.0,,,44783941.0,,,5801130.0,13925407.0,1537455.0,4141.0,251266.0,,,26664872.0,,,,,5225866.0,,,928596.0,26664872.0,846773.0,16229.0,544915690.0,12.01,4873167.0,1464285.0,4110739.0,,,,,12676241.0,,,2080061.0,165710.0,,,,,,,249015.0,188340.0,,31293327.0,,,,,,39170760.0,,35.32,,,,,,232630540.0,,,,-601463.0,,,1660054.0,,,,,5801130.0,,2,,,,,76233332.0,15576.0,,313160590.0,,,3019982.0,,,11215-9008,,6445916.0,11274.0,7619668.0,,183492069.0,,332528.0,,,,,902357.0,79.38,7676782.0,,,,,31129482.0,17551.0,,,28255.0,,,15662401.0,,,1423052.0,,,,,,,,,22812000.0,,8370677.0,,,536640.0,,25.32,,,11707695.0,,,5326689.0,-101215.0,6570804.0,,,,,,,,,,,1040707.0,,,1596606.0,776621,,10344171.0,345042.0,35.32,,,144163.0,,,,,733.0,259242.0,94806570.0,,,2204.0,,,313650.0,117360258.0,,3761.0,7315040.0,,,,,95.18,,154250775.0,,,366655.0,4824.0,,,,2090713.0,,8914551.0,NEW YORK METHODIST HOSPITAL - ACUTE,,16600548.0,,,7474183.0,648615.0,,,179676.0,7804922.0,,26045.0,,33T236,N,,,,13099202.0,25251579.0,,,24196457.0,13001,5295352.0,,17197078.0,2639920.0,532710434.0,8157343.0,39397971.0,,,,,,,3276243.0,,,467309.0,,24196457.0,,,,,,544915690.0,,-33008.0,,,0.829,,37917967.0,320732.0,,,63118.0,,46039700.0,577118000.0,44487794.0,,,N,,,,,,,,8897272.0,,,84316349.0,,13870.0,,1477651.0,,,903738.0,,,,,,,3419120.0,648.0,,,8750458.0,,,4483336.0,,,,,,1714994.0,,1821058.0,,,118061225.0,,8954736.0,,182558.0,,56388774.0,,1357869.0,,,320732.0,30458.0,2493975.0,40072943.0,,,150931.0,,,517663.0,,651685.0,,,,235186.0,10660579.0,5500439.0,50.1,,,449195.0,,1086.0,,,,1685321.0,721121.0,,-416517.0,394.0,,8750458.0,2268028.0,,,39.87,,,,,,,421069.0,,,,2159327.0,,0.377274,3009033.0,,,2651383.0,,,222348908.0,,,36.03,,381714.0,21.02,21019998.0,,1469690.0,28176.0,,,,733481.0,111371300.0,,,,35196.0,,23634218.0,,N,,,77456843.0,,14559120.0,,8860344.0,,32508.0,70781587.0,13563834.0,364357.0,4376.0,,,,,,1080696.0,8868317.0,,1613126.0,364547.0,,,-239252.0,32663733.0,,,,,,,17551.0,,,,,,,,,,19369.0,BROOKLYN,2204.0,29.83,,1988439.0,,,-30458.0,,1827570.0,P,,,1404678.0,1204241135.0,,18448259.0,,,6805477.0,330236,,2027370.0,8689136.0,,1927321.0,,5468260.0,489882.0,220531275.0,2185051.0,,,,,,,,531347.0,,,,,14179763.0,63794385.0,,75869.0,,25335.0,,,120670420.0,,26528198.0,Y,,,345431.0,,726960.0,12078723.0,187135.0,,,,,410122.0,480030.0,,,17532245.0,,7788141.0,,,,,,1077.0,,,53055.0,,,253735.0,14895562.0,,,,5634298.0,,11867.0,6668883.0,,19339945.0,5375.0,249301762.0,,98133780.0,805381.0,,70580.0,,,,,1828680.0,,,6568382.0,,-3110174.0,22356196.0,,7619668.0,10838000.0,,,480030.0,,,,,,,,,11782.0,695912.0,,19789875.0,,469193.0,,,,4156592.0,1136.0,,,24370.0,5843837.0,,,306943.0,,505793.0,,,,,58236428.0,32508.0,,,,,,1357869.0,315826.0,,,,,,,,,,,,,,,4241326.0,,-240.0,,,,,,,4135324.0,,,37.45,,8380511.0,1399515.0,116120323.0,38.0,,,,,,205961.0,,,,,,,,,5864253.0,,,16407.0,5239.0,591.0,2924151.0,10282001.0,13415400.0,264746808.0,356051569.0,,1320.0,,,,-63807.0,,,,33331,,,,4241326.0,12549600.0,17551.0,,,7927257.0,1684789.0,,,1.0,,831285.0,,,,,,,,15155.0,,905021.0,,2956828.0,,,,,,,25076.0,,,,8760.0,,,25204108.0,,,,,,1746174.0,,,,,848338.0,960227.0,,,,139133.0,,20062.0,,,,5370.0,2705316.0,N,2990602.0,,,4774694.0,,,,,,,,,1972260.0,14405221.0,516.0,,,,369.0,,,,,,2151.0,33650000.0,,875519647.0,,,,,,,1757094.0,,69253.0,10634796.0,,15050016.0,25.0,,,171459.0,,,,,,,4110.0,,,9443.0,,,,,1812172.0,,,2409876.0,99294.0,149175.0,,2513683.0,,,,100367.0,,,,20458.0,,16347467.0,,,,,,,,,,,,,-30458.0,General Short Term,,,,,326652.0,533691865.0,26342001.0,549900.0,121930707.0,,1751956.0,,47483574.0,,,,,,,5038560.0,,,,,,,,5755017.0,198414.0,,,,,-10272071.0,5739387.0,2676946.0,-63807.0,84667.0,36193.0,34103.0,637.0,Y,,112417.0,,1024709.0,25237.0,Y,,,11639992.0,,,,,,177184.0,18052.0,,,,,,,,8896507.0,1080696.0,,1157901.0,,2676946.0,,2.0,,,-379357.0,4487032.0,,3019982.0,,1924392.0,,,,,,,,26676952.0,16434600.0,,,,,,6461239.0,,,,66559.0,31002.0,,,37.51,5886764.0,,,,,F,,,,,8595197.0,,,10660131.0,,,,34631431.0,,137372.0,3094.2,,7163288.0,1448204.0,N,,,,,,,,B,,484031.0,17832006.0,,7860574.0,,,,,14416.0,,,69940.0,,2025700.0,,6301750.0,,4110.0,175653.0,,702769.0,454.0,,,,249.76,,25232.0,,93481000.0,,21597708.0,174.0,,,6218754.0,,,,,,397358000.0,,,-503082.0,2555063.0,,,,36.0,275672.0,,4665670.0,190370.0,2213789.0,17531842.0,,116160.0,,N,5976.0,38871027.0,,21534.0,,,8136.0,,,41102174.0,813227.0,,262065.0,,57.0,36888.0,,2816373.0,6246753.0,,,,50.0,,,18488.0,,,253735.0,,149064.0,,33,,2.0,,,,22356196.0,,1477651.0,345431.0,,,32449.0,,295.0,,,,2575273.0,,,,,,,,143838694.0,,70957809.0,,-740401.0,,,,,,,,,114621.0,2394880.0,,18645380.0,328721488.0,,,2869523.0,51.27,1954503.0,,,,,9994336.0,808827.0,,,,,1906.0,N,,,2142430.0,5225866.0,,24.0,,20508671.0,575207.0,,13647027.0,,45436302.0,,,,41303921.0,3961521.0,953.0,10639302.0,,,454.0,304404.0,,51.0,,576860.0,1807000.0,6587000.0,,9524.0,258221987.0,,,,,,1157901.0,,,,,,,429743.0,,,,,,,102043.0,,620009.0,2065.0,,,,,,,671530701.0,NEW YORK METHODIST HOSPITAL - PSYCH,,-1260287.0,,,,7881752.0,798710.0,,,,429743.0,,14031.0,,-240.0,,8480755.0,,,,15151231.0,,,,,257457.0,,848480.0,,6078003.0,,,971584.0,3952195.0,,,12191.0,,,,,4543846.0,,,,,,14405221.0,,,8954736.0,8098975.0,,,1954503.0,2386185.0,,6399069.0,,22127782.0,,2095.0,11352601.0,,,,,,,,,,2825780.0,,,,,,,,21.0,,,,8567.0,,,,,,,,,3097.0,5766094.0,,,,4733952.0,9354770.0,,53055.0,,,20402762.0,,,,,7826.0,,28.63,6805477.0,13415400.0,,,,8197318.0,,,,,,6380806.0,22197890.0,,,,,37.3,,,,,2263234.0,,,6641733.0,,,2263234.0,,,,,,,,185909.0,,3734000.0,,,,,65683.0,Y,,3182192.0,,,,1185359.0,412682.0,,405069.0,3873917.0,,132976.0,7727362.0,,224445.0,,5786102.0,74057.0,,,6722819.0,17777740.0,,,,,,,,,,,,,,,,461.0,,,18615.0,17551.0,,50.14,456483624.0,,,1762254.0,,739900.0,,,,9125.0,4972461.0,52925.0,,,36580373.0,,,3530063.0,,,,,,79280.0,,,,,,5936458.0,,220531275.0,,160939319.0,,,,,,,51196.0,,3717181.0,,,,,,,,17777740.0,293119000.0,,,11325.0,,-1614.0,,25012327.0,,5600,133445.0,3421443.0,,,,,,,,,,,,2990.0,,2458038.0,33391939.0,,,25.17,16525172.0,262065.0,,192202.0,,,11174375.0,17955287.0,,,,,,213.0,,31002640.0,,10234.0,,,,,,,,,,4998685.0,,,-1006444.0,,,,,,,,N,,,,,,,,,,4768252.0,,7424.0,,,-2145517.0,2185051.0,,,,,463219.0,,103602040.0,105611.0,,,524020.0,1972260.0,6933060.0,,,2011-01-01 00:00:00,6218754.0,,,6858702.0,,,,5295352.0,,,,,,121930707.0,,,,2525012.0,,,67614.0,,,,,491160.0,3548740.0,385650.0,351515.0,4735198.0,13247994.0,6013851.0,17551.0,14559120.0,,,,16407.0,,,-1636384.0,,19.02,2287927.0,,14031.0,,857093.0,,,3633893.0,,,,,3882129.0,1136.0,,,6774139.0,,5785388.0,2431.0,,,397.0,,,,,,,,,,5239.0,157083000.0,1477651.0,,38005187.0,49597960.0,,,,,-4834.0,,,Y,,,,6469289.0,,,15662401.0,,,,2100497.0,114929.0,22862399.0,14120.0,,,,,7826.0,198414.0,,,2493975.0,5976.0,,,2803042.0,,72096.0,8136.0,,,,2896138.0,19247397.0,9420.0,,,2065.0,7468637.0,,,,6595992.0,,2816373.0,,,,,109200.0,,,,,26528198.0,1757094.0,236413647.0,,,481370.0,,,,,,,,,,,36613.0,,66724.0,,,,11739.0,,30458.0,,694882.0,,,3986540.0,,,,,,1187665.0,,,375148.0,,,,,,,,439322.0,,1204241135.0,6805477.0,,,,,,,,-981431.0,,,,7989842.0,,,,,,,,3019982.0,20478631.0,2825536.0,11707695.0,-2154538.0,,,,,,,1091395.0,,,,3276243.0,3010.0,,,11639992.0,,,,12565089.0,457659.0,,142376.0,,,PO BOX 159008,,,,23768.0,6570804.0,489882.0,,1437736.0,,,52590.0,,,,,174702.0,21628532.0,,,,,-174665.0,10602.0,,,58294.0,1015379.0,31129482.0,197825.0,,12918337.0,2025700.0,726960.0,,,,,,,,58057255.0,,,,,,,,,,,2651383.0,236413647.0,,,,11498060.0,,165710.0,38005187.0,121930707.0,,NEW YORK METHODIST HOSPITAL - REHAB,,,7281984.0,814281.0,,,,,,,130311.0,,11435.0,5097612.0,,,,,,,1811382.0,,,3635139.0,2011,2011,5500439.0,275672.0,,0.01610516772632463,179760000.0,108233774.23839,147268939.0,0.020345011676643824,-981431.0,-0.0018423348546613976,3.1355997475422814,2.1059562798857523,3.0290564499737913,0.7571761855350285,179760000.0,2.2104917668001782,0.6885212382909561,0.3114787617090439,,179760000.0,0.9230528834657731,10.740571467052273,Acute Care Hospitals,non-profit,0,NEW YORK METHODIST HOSPITAL - ACUTE (330236)
14433,NEW YORK METHODIST HOSPITAL - ACUTE (330236),General Short Term (Acute Care Hospitals),Voluntary Nonprofit-Other,-73.979141,40.668263,1863553.0,,-1035803.0,,,,,13911633.0,2774719.0,,,,,48315.0,,NY,,,22788774.0,2522.0,,,,17924014.0,,Y,,,1206183.0,,,,,12820545.0,,KINGS,299671582.0,,,,,751800.0,2012-12-31,429745.0,,,-206937.0,,,,30602.0,,,,,803526.0,,,,,223265.0,,,,,145096.0,,13551273.0,1721663.0,,,,72071718.0,,,,18179.0,,27054846.0,,1118208.0,,,13911261.0,,,,-162.0,,531.0,,,,33S236,,,,11660.0,,,120.04,,34658.0,,4427691.0,,,486890.0,3970044.0,,,,,486538110.0,,,,,,Y,7985619.0,,,,,,,,4690202.0,,,,468086.0,,,3473505.0,6274851.0,,,,,,,2671957.0,,3945807.0,,4644387.0,,,,,,,,,276591.0,,,34586618.0,2160614.0,,482814.0,,,,,,,,2522.0,,,,,68221.0,15308244.0,,,,-177468.0,,112515.0,215925348.0,,,,591461.0,15842.0,18038388.0,,,4203981.0,,,21748.0,2231918.0,,35644,,,,2637396.0,,75.51,,,1842401.0,1851560.0,,2110812.0,,,,,9928.0,,,,,,,,16469000.0,94908.0,8.0,,,N,835357.0,,14966842.0,,,,,,,316700000.0,,,,,,6552906.0,,,4251.0,,6013153.0,,,5986.0,,34.42,,,,,,NEW YORK METHODIST HOSPITAL,377794094.0,,,,,,,,,,,,,6377.0,,,,486695.0,,,,,39512.0,,,,20750037.0,8186921.0,,10120.0,,,,-3613380.0,,,,,,,,147579.0,7190121.0,,,,,,,,,12505046.0,,,5176121.0,,,490400.0,25382.0,100316.0,,858904.0,154821.0,,,,,,,412682.0,,7713833.0,2024-09-12 00:00:00,,,60114.0,,68292.0,,7808812.0,,,8198452.0,,1385817.0,175110.0,120628.0,,,,,41132.0,,,45240.0,,,,,65128272.0,,-1193799.0,79186.0,,137.96,8076283.0,,1178574.0,,6615638.0,,,,71.36,6013153.0,,10037593.0,,145096.0,,,,372614.0,2296.0,482590122.0,,,,,23976967.0,,,,17.78,,908261.0,,,,,,,,11539.0,-137846.0,9928.0,968010.0,,,1354048.0,,,23318600.0,1354048.0,,8314266.0,58304.0,,,,,1765656.0,,,,,39975.0,,6951277.0,,,,,,,9767.0,,,,4933036.0,,,,,19067422.0,-753073.0,,,,108371.0,,3041396.0,,,,,,,,,3744.0,,,,,,,,3543541.0,158627311.0,,,,,,,,4921.0,,,6522627.0,,,,,,1369645.0,,,,45947992.0,5195706.0,,,,,,,445504.0,297399.0,,,41.61,,11829.0,2270894.0,,,,,157149.0,,,,,,,4249.0,,,,556658291.0,,,,1239965.0,762572.0,,,4833297.0,193154869.0,,,,,23212063.0,,,22932.0,,,,,,8650457.0,49763.0,,,63244.0,892488.0,,8787231.0,,,,7648003.0,,,,,2088.0,,,,,,,,,,33.95,,,,,,,,,25964670.0,675330.0,10628.0,,,,,,,,,8393.0,,,830.0,,,,,,1369645.0,,,,,,,,,41592.0,,,12284713.0,3063.0,,,,,,,538884.0,,28342.0,,,,,,,,,,,,,,318653370.0,,541.0,,-954754.0,1895188.0,,11357995.0,37096.0,2290951.0,,329082.0,207138117.0,398770.0,,,-1819.0,,,-326940.0,,,41261286.0,,,,1835928.0,,,5296172.0,3321958.0,,,,,,,,2260475.0,,,,1399515.0,,27.92,528648.0,147105689.0,,447741.0,,,632372.0,4644387.0,,136192.0,,,,349.0,,,635783.0,19668202.0,,,6769.0,,,,118722000.0,,,5063212.0,,,,,,2925.0,,12718456.0,82491.0,892408806.0,,133375.0,772.0,,,16609535.0,5159556.0,16462203.0,2775.0,,,,,,,,45842.0,5529281.0,,,1046284.0,4373.0,,,,6422332.0,,9065432.0,,4706292.0,,,14983.0,134847.0,,,,,8281682.0,,,,,43368.0,,,,11654113.0,,,5056443.0,83895.0,80241084.0,,,,,,,35742865.0,,,,,,,,,,1.0,,,124410.0,3644.0,,687.0,235950.0,,,,3601.0,,,,2131056.0,,,,,,,,136342.0,,,83298530.0,,18300.0,,,1478570.0,3041396.0,,,,,6615638.0,,1357099.0,41132.0,372.0,825670.0,,244011.0,2942501.0,,,,803526.0,,,1770401.0,2746363.0,32.0,179152536.0,,,,,,825670.0,75.0,1871939.0,4135085.0,398577.0,257.43,,,,8956630.0,,72071718.0,,,,486652055.0,,,,,,,,,,,5586174.0,,116891.0,12935759.0,,,216573.0,,,3601.0,2131056.0,,,,,35894046.0,,1742645.0,,,,,,,,2658.0,7228202.0,,40969.0,180474.0,,260097.0,,,,32.76,,,6827386.0,,1676622.0,,,,,,1561818.0,81315.0,,-13976007.0,,,14625.0,330738.0,,,,8468.0,,,,26690073.0,,,191143.0,,,,,,,34.3,,,,,,,,4028734.0,,5195706.0,,8186921.0,,,42041000.0,8679027.0,30546721.0,,2543896.0,,,,,,,284882.0,8650457.0,,,47829813.0,,,7216221.0,17398246.0,1206183.0,4773.0,260175.0,,,19683146.0,,,,,6092151.0,,,1688512.0,19683146.0,737190.0,6466.0,556853439.0,,5181704.0,968010.0,4706292.0,,,,,13233291.0,,,2016091.0,166164.0,,,,,,,265200.0,188856.0,,32263559.0,,,,,,49829427.0,,36.66,,,,,,238691311.0,,,,-749682.0,,,1884955.0,,,,,7216221.0,,2,,,,,101032740.0,15842.0,,333138996.0,,,3299679.0,,,11215-9008,,7186626.0,8911.0,6943446.0,,201805326.0,,219665.0,,,,,922214.0,71.36,10899485.0,,,,,25431335.0,10628.0,,,,,,9355264.0,,,902751.0,,,,,,,,,7287000.0,,9653436.0,,,485355.0,,25.78,,,12796343.0,,,6013153.0,-274060.0,6278467.0,,,,,,,,,,,83895.0,,,1659467.0,784104,,10561649.0,316744.0,36.66,,,,,,,,591.0,21748.0,97063362.0,,,3063.0,,,308243.0,117360258.0,,4001.0,6838173.0,,,,,99.94,,155148326.0,,,289779.0,1698.0,,,,1595272.0,,9697624.0,NEW YORK METHODIST HOSPITAL - ACUTE,,16003419.0,,,8228460.0,724262.0,,,70451.0,7422653.0,,25528.0,,33T236,N,,,,15967588.0,29269424.0,,,25368251.0,13001,5814418.0,,16858800.0,2640077.0,570239313.0,9361212.0,36947532.0,,,,,,,2875692.0,,,531468.0,,25368251.0,,,,,,556853439.0,,-3391.0,,,0.829,,40358967.0,270925.0,,,39917.0,,58767043.0,643098000.0,45603039.0,,,N,,,,,772.0,,,8306979.0,,,76830116.0,,13908.0,,1221137.0,,,856821.0,,,,,,,2340821.0,2968.0,,,8333416.0,,,4427691.0,,,,,,1725782.0,,1487193.0,,,123223690.0,,7877452.0,,325046.0,,59400761.0,,1699949.0,,,270925.0,,1915368.0,42847452.0,,,80122.0,,,406377.0,,751800.0,,,,229598.0,11141333.0,17740152.0,50.96,,,257729.0,,1696.0,,,,1613502.0,715307.0,,-326940.0,350.0,,8333416.0,2270894.0,,,40.67,,,,,,,350111.0,,,,2863047.0,,0.379932,1566157.0,,,2959302.0,,,239275850.0,,,37.28,,,22.54,16609535.0,,1420608.0,42061.0,,,,,104173700.0,,,,27636.0,,23484095.0,,N,,,77455992.0,,14966842.0,,8889072.0,,33064.0,78127000.0,13264782.0,418860.0,8109.0,-7343.0,,,,,1333897.0,9592730.0,,1858724.0,395948.0,,,-331844.0,33211227.0,,,,,,,10628.0,,,,,,,,,,22018.0,BROOKLYN,3063.0,30.21,,2174443.0,,,-1193799.0,,1802346.0,P,,,2181927.0,1270202900.0,,21257179.0,,,6827386.0,330236,,2145811.0,7656373.0,,4212305.0,,4908126.0,584480.0,237495302.0,3424023.0,,,,,,,,554198.0,,,,,14573655.0,66442713.0,,146303.0,,513703.0,,,123175145.0,,25339810.0,Y,,,,,473075.0,11532435.0,209454.0,,,,,392257.0,749730.0,,,15901040.0,,7648003.0,,,,,,480.0,,,49763.0,,,239490.0,15032033.0,,,,6291213.0,,11829.0,6688086.0,,31303170.0,1480.0,271239740.0,,96679978.0,786830.0,,103777.0,,,,,2746363.0,,,5658076.0,,-2954058.0,24408978.0,,6943446.0,46139000.0,,,749730.0,,,,,,,,,17840.0,796446.0,,19067422.0,,233639.0,,,,4442575.0,372.0,,,26664.0,6613744.0,,,282285.0,,136471.0,,,,,65128272.0,33064.0,,,,,,1699949.0,411945.0,,,,,,,,,,,,466.0,,,4165050.0,,,,,,,,,4532598.0,,,38.6,,11049405.0,1399515.0,145055603.0,38.0,,,,,,213294.0,,,,,,,,,7026483.0,,,26740.0,5831.0,591.0,2437943.0,8931884.0,15010299.0,285222988.0,362474198.0,,4620.0,,,,-88198.0,,,,33331,,,,4165050.0,11466000.0,10628.0,,,7129298.0,1382344.0,,,1.0,,916172.0,,,,,,,,24819.0,,803982.0,,3048346.0,,,,,,,18146.0,,,,8784.0,,,25983417.0,,,,,,1835928.0,,,,,737190.0,851899.0,,,,120861.0,,28342.0,,,,,2946264.0,N,3127968.0,,,5089184.0,,,,541.0,,,,,2061399.0,12790636.0,516.0,,,,,,,,,,4770.0,53426000.0,,892408805.0,,,,,,,1556520.0,,111260.0,10627468.0,,16194379.0,25.0,,,154821.0,,,,,,,4373.0,,,10042.0,,,,,2154807.0,,,2133407.0,84269.0,161460.0,,2181553.0,,,,146670.0,,,,19797.0,,12935759.0,,,,,,,,,,,,,,General Short Term,,,,,348461.0,570634298.0,25803843.0,507780.0,125770926.0,,1882419.0,,45947992.0,,,,,,,5529281.0,,,,,,,,6463054.0,202271.0,,,,,-13976007.0,5820424.0,3218489.0,-88198.0,154454.0,733862.0,3644.0,632.0,Y,,98160.0,,1053413.0,,Y,,,9087796.0,,,,,,104760.0,,,,,,,,,9658130.0,1333897.0,,1457841.0,,3218489.0,,2.0,,,-393187.0,5333215.0,,3299679.0,,1739651.0,,,,,,,,24242191.0,15200500.0,,,,,,6522627.0,,,,72613.0,167719.0,,,37.31,7014488.0,,,,,F,,,,12320.0,9412742.0,,,11141171.0,,,,53820985.0,,122864.0,3229.0,,8679027.0,1524502.0,N,,,,,,,,B,,431542.0,19668202.0,,7289661.0,,,,,,,,67507.0,,2144761.0,,6419160.0,,4373.0,172253.0,,600561.0,454.0,,,,257.43,,24461.0,,100120000.0,,22985382.0,150.0,,,6109952.0,,,,,,416820000.0,,,-558279.0,,,,,37.25,298236.0,,4771313.0,173818.0,2271173.0,15900570.0,,102960.0,,N,5460.0,34472074.0,,677948.0,,,8037.0,,,49914081.0,962573.0,,260097.0,,28.0,,,2816373.0,6274851.0,,,3.0,50.0,,,33660.0,,,239490.0,,60900.0,,33,,2.0,,,,24408978.0,,692489.0,,,,33118.0,,1136.0,,,,2881258.0,,,,,,,,142586522.0,,80972569.0,,-984255.0,,,,,,,,,119466.0,3081503.0,,22845580.0,377794094.0,,,2446722.0,52.26,1621341.0,,,,,10247772.0,999705.0,,,,,1310.0,N,,,1951636.0,6092151.0,,24.0,,19756817.0,591461.0,,13117743.0,,43135066.0,,,,60566100.0,4203981.0,704.0,10631717.0,,,454.0,329545.0,,19.0,,486695.0,1453410.0,6587000.0,,8305.0,274659000.0,,,,,,1457841.0,,,,,,,393956.0,,,,,,,112646.0,,720769.0,1740.0,,,,,,,699963587.0,NEW YORK METHODIST HOSPITAL - PSYCH,,-2595781.0,,3.0,,6013153.0,1022718.0,,,,393956.0,,11749.0,,,,7980039.0,,,,16468439.0,,,,,524998.0,,729526.0,,6721126.0,,,1094682.0,3452096.0,,,7917.0,,,,,4814203.0,,,,,,12790636.0,,,7877452.0,8281682.0,,,1621341.0,2324046.0,,6584423.0,,21097782.0,,2010.0,11951076.0,,,,,,,,38869.0,,3494745.0,,,,,,,,60.0,,1216.0,,8468.0,,,,,,,,,,6422332.0,,,,5159556.0,11423476.0,,49763.0,,,22878520.0,,,,,7238.0,,29.33,6827386.0,15010299.0,,,,8787231.0,,,,,,6348618.0,24764984.0,,,,,38.91,,,,,1406252.0,,,4283260.0,,,1406252.0,,,,,,,,150734.0,,3789877.0,,,,,56648.0,Y,,4466131.0,,,,1428757.0,412682.0,,308493.0,4061933.0,,156665.0,13713154.0,,235950.0,,4096033.0,84269.0,,,6769271.0,17006394.0,,,,,,,,,,,,,,,,426.0,,,17800.0,10628.0,,51.51,486538110.0,,,1478570.0,,706951.0,,,,9150.0,5265973.0,114671.0,,,43043600.0,,,3714117.0,,,,,,74148.0,,,,,,6198744.0,,237495302.0,,173292119.0,,,,,,,65378.0,,3977387.0,,,,,,,,17006394.0,337365000.0,,,11539.0,,-137846.0,,28937580.0,,5600,134148.0,3545933.0,,,,,,,,,,,,3121.7,,2095520.0,45688111.0,,,26.39,19401224.0,260097.0,,216783.0,,,11891463.0,23827409.0,,,,,,592.0,,35742865.0,,10226.0,,,,,,,,,,4638215.0,,,-954754.0,,,,,,,,N,,,,,,,,,,7228202.0,,48119.0,,,-2006153.0,3424023.0,,,,,438839.0,,101588104.0,,,,497118.0,2061399.0,6660081.0,,,2012-01-01 00:00:00,6109952.0,,,7744821.0,,,,5814418.0,,,,,,125770926.0,,,,2749730.0,,,83073.0,,,,,615623.0,3545149.0,333299.0,538884.0,5160340.0,10774544.0,5823991.0,10628.0,14966842.0,,,,26740.0,,,-1765779.0,,19.46,2372657.0,,11749.0,,1476371.0,,,3945807.0,,,,,3620047.0,372.0,,,7925549.0,,6486090.0,9786.0,,,,,,,,,,,,,5831.0,203222000.0,1221137.0,,41130801.0,47778597.0,,,,,-4944.0,,,Y,,,,7361845.0,,,9355264.0,,,,1902630.0,55584.0,16974044.0,1111.0,,,,,7238.0,202271.0,,,1915368.0,5460.0,13.0,,2626830.0,,68292.0,8037.0,,,,3171383.0,21938200.0,3140.0,,,1740.0,8198452.0,,,,6110432.0,,2816373.0,,,,,109200.0,,,,,25339810.0,1556520.0,259607392.0,,,334090.0,,,,,,,,,,,,,68967.0,,,,7486.0,,,,1657096.0,,,3752143.0,,,,,,1128066.0,,,286373.0,,,,,,,,526984.0,,1270202899.0,6827386.0,,,,,,,,-394985.0,,,,8444516.0,,,,,,,,3299679.0,22788774.0,2844140.0,12796343.0,-3947988.0,,,,,,,1118173.0,,,,2875692.0,1253.0,,,9087796.0,,,,14771017.0,245491.0,,145096.0,,,PO BOX 159008,,,,32087.0,6278467.0,584480.0,,1264606.0,,,41345.0,,,,,178392.0,27054846.0,,,,,-390653.0,434069.0,,,55594.0,1510765.0,25431335.0,184435.0,,12284713.0,2144761.0,473075.0,,,,,,,,52095864.0,,,,,,,,,,,2959302.0,259607392.0,,,,11526086.0,,166164.0,41130801.0,125770926.0,,NEW YORK METHODIST HOSPITAL - REHAB,,,6894775.0,835357.0,,,,,,,85923.0,,9767.0,5417654.0,,,,,,,1839969.0,,,3946591.0,2012,2012,17740152.0,298236.0,,0.01649522651020181,226278000.0,121066612.17084,196849000.0,0.08091164349449194,-394985.0,-0.0006926653266362924,3.36960647223332,2.4433439572512983,3.2688624650419498,0.7803335996803835,226278000.0,1.8420703736112216,0.6481438287788175,0.35185617122118246,,226278000.0,0.8867067118852803,11.93503679063661,Acute Care Hospitals,non-profit,0,NEW YORK METHODIST HOSPITAL - ACUTE (330236)
20703,NEW YORK METHODIST HOSPITAL - ACUTE (330236),General Short Term (Acute Care Hospitals),Voluntary Nonprofit-Other,-73.979141,40.668263,2317384.0,,-775716.0,,,,,17404701.0,2615641.0,,,,,22849.0,,NY,,,24889224.0,893.0,1320.0,,,18586559.0,,Y,,,1206961.0,,,,,13733164.0,,KINGS,433192192.0,116.0,,,470.0,586537.0,2013-12-31,450976.0,,,-933284.0,,,,86914.0,,,,,773111.0,,,,,273903.0,,,,,155639.0,,14317110.0,2154450.0,,,,77837807.0,,,,23710.0,,33676019.0,,708.0,,,17404096.0,,,,-173.0,,500.0,,,,33S236,,,,785.0,,,116.54,,38742.0,,4187435.0,,,584735.0,4184585.0,,,,,512474647.0,,,,,,Y,9355264.0,,,,,,,,4914066.0,,,,383480.0,,,3574467.0,5744527.0,,,,,,,2815412.0,,3998886.0,,5138217.0,,,,,,,,,451568.0,,,35235753.0,2458847.0,,347221.0,,,,,,,,893.0,,,,,55587.0,15444715.0,,,,-152133.0,,115245.0,228954371.0,,,,487654.0,16090.0,21055253.0,,,4217429.0,,,,2304001.0,,35644,,,,2504394.0,,,,,1885845.0,1784733.0,,2143510.0,,,,,9361.0,,,,,,,,17895000.0,20479.0,2.0,,,N,1001618.0,,13301015.0,,,,,,,291266000.0,,,,,,6350412.0,,,1103.0,,6103304.0,,,7968.0,,36.02,,,,,,P.O. BOX 159008,431940928.0,,,,,,,,,,,,,8823.0,,,,590319.0,,,,,40543.0,,,,21422000.0,9210808.0,,,,,,-3774651.0,,,,,,,,168018.0,7299253.0,,,,1.0,,,,,10845024.0,,,5881919.0,,,551174.0,27937.0,57936.0,,625928.0,155354.0,,,,,,,,,8346004.0,2024-09-18 00:00:00,,,65080.0,,70645.0,,8189819.0,,,9101255.0,,1660811.0,176865.0,290118.0,,,,,43919.0,,,45045.0,,,,,72618148.0,,-1362997.0,80743.0,,105.71,6839815.0,,1368255.0,,6789614.0,,,,73.97,8999186.0,,10316324.0,,155639.0,,,,319355.0,1316.0,508318783.0,,,,,21741727.0,,,,18.03,,1191614.0,,,,,,2292556.0,,12349.0,-176980.0,9361.0,1025170.0,,6240.0,1282330.0,,,28399600.0,1282330.0,,8575491.0,66798.0,,,,,1915274.0,,,,,37635.0,,15366678.0,,,,,,,7571.0,,,,5356175.0,,,,,19965258.0,-848626.0,,,,78008.0,,3007693.0,,,,,,,,,3297.0,,,,,,,,3600895.0,158750136.0,,,,,,,,6205.0,,,6506714.0,,,,,,,,,,43167402.0,4744410.0,,,,,,,499084.0,265459.0,,,42.42,,12139.0,2289601.0,,,,,159541.0,,,,,,,2293.0,,,,589504697.0,,,,1328744.0,377375.0,,,6214847.0,204023528.0,,,,,45140853.0,,,24176.0,,,,,,9744482.0,52908.0,,,50532.0,888708.0,,10022706.0,,,,7268091.0,,,,,13046.0,,,,,,,,,,34.21,,,,,,,,,30062633.0,910110.0,11029.0,,,,,,,,,6694.0,,,981.0,,,,,,,,,,,,,,,55517.0,,,11559453.0,980.0,,,,,,,720681.0,,22201.0,,,,,,,,,,,,,,404816319.0,,87.0,,-715885.0,1957955.0,,13965818.0,42274.0,2682580.0,,446422.0,218931665.0,415646.0,,,-1442.0,,,-236101.0,,,44426511.0,,,,1969500.0,,,5878502.0,3271977.0,,,,,,,,2601317.0,,,,1399515.0,-1280543.0,28.8,96032740.0,190902864.0,,562593.0,,,653060.0,5138217.0,,119155.0,,,,2441.0,,603326.0,774549.0,20447463.0,,,14025.0,,,,176061000.0,,,4269787.0,,,,,,1755.0,,14384076.0,88984.0,1159903684.0,,131912.0,193.0,,,13538251.0,5288158.0,15718597.0,3845.0,,,,,,,,41097.0,4330673.0,,,1066079.0,2170.0,,,,6878216.0,,9713257.0,,4865840.0,,,12366.0,120174.0,,,,,8597504.0,,,,,23.0,,,,14409207.0,,,5344340.0,,82728910.0,,,,,,,36831091.0,,,,,,,,,,1.0,,,138645.0,2010.0,,601.0,288600.0,,,,1977.0,,,,2387264.0,,,,,,,,141546.0,,,88627872.0,,18250.0,,,1453828.0,3007693.0,,,,,6789614.0,,1287317.0,43919.0,509.0,941136.0,,214992.0,2979988.0,,,,773111.0,,,1791653.0,3128896.0,28.0,43575439.0,,,,,,941136.0,43.0,1938969.0,3501633.0,480302.0,263.3,,,,10190864.0,,77837807.0,,,,515653858.0,,,,,,,,,,,5942622.0,,124160.0,12524139.0,,,294123.0,,,1977.0,2387264.0,,,,,35310000.0,,2333735.0,,,,,,,96.69,1040.0,8188386.0,,48688.0,322340.0,,277785.0,731.0,,,34.28,,,7038446.0,,1232605.0,,,,,,1507916.0,77415.0,,-14310712.0,,,15405.0,292973.0,,,,8587.0,,,,32066529.0,,,215699.0,,,,,,,33.01,,,,,,,,3710692.0,,4744410.0,,9210808.0,,,39251000.0,9960337.0,33470742.0,,2090249.0,,,,,,,254363.0,9744482.0,,,50572683.0,,,7584664.0,21023815.0,1206961.0,5579.0,634838.0,,,25671510.0,,,,,6869869.0,,,5439245.0,25671510.0,349438.0,11536.0,570642601.0,,5310462.0,1025170.0,4865840.0,,,,,13577639.0,,,2082027.0,165710.0,,,,,,,271635.0,188340.0,,33940245.0,,,,,,54064542.0,,33.76,,,,,,245113940.0,,,,-846440.0,,,2546892.0,,,,,7584664.0,,3,,,,,,16090.0,,352340244.0,,,3429009.0,,,11215-9008,,7576436.0,10501.0,5219659.0,,213768010.0,,254878.0,,,,,827204.0,82.93,,,,,,25654677.0,11029.0,,,,,,8319343.0,,,1493028.0,,,,,,,,,-31597000.0,,9490845.0,,,493545.0,,30.78,,,13459756.0,,,6103304.0,-228022.0,8432808.0,,,,,,,,,,,,,,1685221.0,784105,,12808184.0,447558.0,33.76,,,,,,,,455.0,,100817624.0,,,980.0,,,294013.0,117360258.0,,4816.0,5628728.0,,,,,98.5,,166352884.0,,,290963.0,2714.0,1320.0,,,1497207.0,,9219989.0,NEW YORK METHODIST HOSPITAL,,15268953.0,,,9115087.0,433242.0,,,35906.0,6321872.0,,70230.0,,33T236,N,,,,17522941.0,27521317.0,,,23780251.0,13001,5995986.0,,21627200.0,3019883.0,621272003.0,10047198.0,69140573.0,,,,,,,2325925.0,,,438993.0,,23780251.0,,,,,,570642601.0,,-2186.0,,,0.829,,44568598.0,285830.0,,,49229.0,,61650493.0,768552000.0,48445701.0,,,N,,,,,193.0,,,7879474.0,,,81597317.0,,13870.0,,275634837.0,,,938103.0,,,,,,,3249090.0,1261.0,,,8183057.0,,,4187435.0,,,,,,1768017.0,,2213249.0,,,,,7262289.0,,384358.0,,63690394.0,,2138138.0,,,285830.0,,3189910.0,45580624.0,,,126544.0,,,385508.0,,586537.0,,,,213435.0,14133151.0,20883498.0,52.82,,,713864.0,,914.0,,,,825808.0,722079.0,,-236101.0,357.0,,8183057.0,2289601.0,,,42.25,,,,,,,366573.0,,,,2980018.0,,0.319327,2635238.0,,,3725751.0,,,253206961.0,,,38.42,,,22.62,13538251.0,,1384725.0,33292.0,,,,,147277600.0,,,,34221.0,,28976178.0,,N,,,84645000.0,,13301015.0,,11193637.0,,34406.0,101139000.0,13150039.0,404148.0,5455.0,-33765.0,,,,,1463696.0,9614478.0,,1865891.0,420931.0,,,-345487.0,45021900.0,,,,,,,11029.0,,,,,,,,,,9523.0,BROOKLYN,980.0,31.13,,2187851.0,,,-1362997.0,,1841389.0,P,,,1646482.0,1591844612.0,,21419470.0,,,7043218.0,330236,,1954088.0,7991803.0,,4197073.0,,4588001.0,693144.0,251475165.0,5089452.0,,,,,,,,560914.0,,-4772.0,,,12685671.0,65416291.0,,168247.0,,607899.0,,,128424735.0,,24338750.0,Y,,,,,727730.0,14427996.0,566828.0,,,,,347890.0,2173518.0,,,16918157.0,,7268091.0,,,,,,636.0,,,52908.0,,,360795.0,2890068.0,,,,6613306.0,,12139.0,6359168.0,,34205292.0,36910.0,290860521.0,,93975606.0,893934.0,,36642.0,,,,,3128896.0,,,6153050.0,,-2659737.0,26011494.0,,5219659.0,128601000.0,,,2173518.0,,,,,,,,,23152.0,681523.0,,19965258.0,,265754.0,,,,4326928.0,605.0,,,31621.0,7507311.0,,,846097.0,,55875.0,,,,,72618148.0,34406.0,,,,,,2138138.0,431746.0,,,,,,,,,,,,574.0,,,4623482.0,,,,,,,,,4498741.0,,,39.6,,10669453.0,337202.0,186293207.0,38.0,,,,,,251761.0,,,,,,,,,8082278.0,,,28114.0,5536.0,591.0,2753450.0,9026012.0,21772965.0,305768658.0,258842304.0,,11880.0,,,,-43452.0,,,,33331,,,,4623482.0,15049900.0,11029.0,,,6944378.0,1337491.0,,,1.0,,792537.0,,,,,,,705.0,48147.0,,1099590.0,,3015830.0,,,,,,,22347.0,,,,8760.0,,,30074137.0,,,,,,1969500.0,,,,,349438.0,902031.0,,,,74328.0,,22201.0,,,,,3046149.0,N,3149635.0,,,5287926.0,,,,87.0,,,,,2106122.0,22568978.0,516.0,,,,96.0,,,,,,,97004000.0,,1159903684.0,,,,,,,1767899.0,,106591.0,13525079.0,,19107629.0,25.0,,,155354.0,,,,,,,2170.0,,,9615.0,,,,,2188941.0,,,1972360.0,108509.0,172575.0,,1759782.0,,,,255947.0,,,,58088.0,,12524139.0,,,,,,,,,,,,,,General Short Term,,,,,304757.0,603815409.0,29298331.0,539760.0,131056507.0,,1806365.0,,43167402.0,,,,,,,4330673.0,,,,,,,,6326147.0,213419.0,,,,,-14310712.0,6282716.0,3495324.0,-43452.0,,935229.0,2010.0,622.0,Y,,105311.0,,,19764.0,Y,,,6528714.0,,,,2920.0,,643502.0,,,,,,,,,11000719.0,1463696.0,,1148885.0,,3495324.0,,2.0,,,-615344.0,6113965.0,,3429009.0,,1682739.0,,,,,,,,25405668.0,18816000.0,,,,,,6506714.0,,,,33457.0,246117.0,,,38.15,8088382.0,,,,,F,,,,1015.0,8965626.0,,,14132978.0,,,,79547406.0,,128877.0,3349.0,,9960337.0,1665506.0,N,,,,,,,,D,,409383.0,20447463.0,,10981447.0,,,,,,,,81869.0,603326.0,1952371.0,,6864109.0,,2170.0,173796.0,,677040.0,454.0,,,,263.3,,13392.0,,120981000.0,,,190.0,,,3964692.0,,,,,,412247000.0,,,-641838.0,2292556.0,,,,38.18,171755.0,,5418973.0,169380.0,2275433.0,16918157.0,,58080.0,,N,5392.0,43866738.0,,884259.0,,,7841.0,,,50061922.0,1226968.0,,277785.0,,49.0,,,2816373.0,5744527.0,,,2.0,50.0,,,31680.0,,,360795.0,,34673.0,,33,,2.0,,,,26011494.0,,141927509.0,,,,33782.0,,2094.0,,,,2672115.0,,,,,,,,153607121.0,470.0,86147065.0,,-1314065.0,,,,,,,,,91412.0,3126889.0,,31755876.0,431940928.0,,,2239259.0,53.92,2380174.0,,,,,9340535.0,1217956.0,,,,,1190.0,N,,,2096160.0,6869869.0,,24.0,,21667746.0,487654.0,,12732924.0,,44551181.0,,,,77714700.0,4217429.0,590.0,13527372.0,,,454.0,599092.0,,25.0,,590319.0,1118293.0,6587000.0,,9859.0,252015000.0,,,,,,1148885.0,,,,,,,471163.0,,,,,,,122611.0,,744654.0,1583.0,,,,,,,970572609.0,NEW YORK METHODIST HOSPITAL - PSYCH,,-2631772.0,,2.0,,8999186.0,892025.0,,,,471163.0,,9217.0,,,,7643373.0,,,,19335651.0,,,1062313.0,,981437.0,,671426.0,,7029362.0,,,853278.0,2957936.0,,,9884.0,,,,,4111521.0,,,,,,22568978.0,,,7262289.0,8597504.0,,,2380174.0,2195816.0,,6986821.0,,20376297.0,,838.0,13233933.0,,,,,,,,,,3518043.0,,,,,,,,53.0,,277.0,,8587.0,,,,,,,,,1103.0,6878216.0,,,,5288158.0,11568054.0,,52908.0,,,23799644.0,,,,,6809.0,,29.75,7043218.0,21772965.0,,,,10022706.0,,,,,,8247035.0,24606397.0,,,,,40.14,,,,,2817279.0,,,3055745.0,,,2817279.0,,,,,,,,87438.0,,2790000.0,,,,,46214.0,Y,,3232548.0,,,,1508723.0,,,327401.0,7335075.0,,170818.0,14730458.0,,288600.0,,5637282.0,82505.0,,,7230682.0,16155693.0,,,,,,,,,,,,,,,,415.0,,,19708.0,11029.0,,53.67,512474647.0,,,1453828.0,,668231.0,,,,9125.0,5418971.0,,,,55668000.0,,,3523504.0,,,,,,75205.0,,,,,,6393957.0,,251475165.0,,179152536.0,,,,,,,23996.0,,4218350.0,,,,,,,,16155693.0,418899000.0,,,12349.0,,-176980.0,,27175830.0,,5600,166925.0,3584523.0,,,,,,,,,,,,3238.2,,2017911.0,58507884.0,,1689.0,25.24,19953303.0,277785.0,,221453.0,,,11427051.0,21608662.0,,,,,,468.0,,36831091.0,,12226.0,,,,,,,,,,4843418.0,,,-715885.0,,,,,,,,N,,,,,,,,,,8188386.0,,49252.0,12610522.0,,-1711831.0,5089452.0,,,,,456590.0,,98563607.0,,213411.0,,190116.0,2106122.0,5944497.0,,,2013-01-01 00:00:00,3964692.0,,,7804465.0,,,,5995986.0,,,,,,131056507.0,,,,2805073.0,,,73175.0,,,,,705779.0,4709285.0,342857.0,720681.0,5289439.0,13878400.0,5754345.0,11029.0,13301015.0,,,,28114.0,,,-883873.0,,19.47,2028792.0,,9217.0,,1645844.0,,,3998886.0,,,,,2366238.0,605.0,,,6752377.0,,6518255.0,6499.0,,,,,,,,,,,,,5536.0,331823000.0,275634837.0,,50614592.0,39617996.0,,,,,-3782.0,,,Y,,,,7883419.0,,,8319343.0,,,,2116816.0,106894.0,22628640.0,,,,,,6809.0,213419.0,,,3189910.0,5392.0,3.0,,3323267.0,,70645.0,7841.0,,,,3157178.0,30706700.0,78860.0,,,1583.0,9101255.0,,,,5935681.0,,2816373.0,,,,,104715.0,,,,,24338750.0,1767899.0,,,,315303.0,,,,,,,,,,,,,68817.0,,,,9804.0,,,22965832.0,1543946.0,,,3259124.0,,,,,,927247.0,,,165211.0,,,,,,,,507496.0,,1591844612.0,7043218.0,,,,,,,,17456594.0,8.0,,,8110659.0,,,,,,,,3429009.0,24889224.0,4297982.0,13459756.0,-4155864.0,,,,,,,1380003.0,,,,2325925.0,1835.0,,,6528714.0,,,,15067324.0,364817.0,,155639.0,,,,,,,35967.0,8432808.0,693144.0,,1180719.0,,,27462.0,,,,,189488.0,33676019.0,,,,,-638705.0,,,,58444.0,1370063.0,25654677.0,124726.0,,11559453.0,1952371.0,727730.0,,,,,,,,76921051.0,,,,,,,,,,,3725751.0,,,,,14212540.0,,165710.0,50614592.0,131056507.0,,NEW YORK METHODIST HOSPITAL - REHAB,,,7710740.0,1001618.0,,1035921.0,,,,,54613.0,,7571.0,5599062.0,,,,,,,1903230.0,,,4000167.0,2013,2013,20883498.0,171755.0,,0.014848289504317701,356305000.0,129268780.69731301,277200000.0,0.20699629047987214,17456594.0,0.02809815011091044,3.462518907927691,2.6187417528372223,3.376763326472752,0.835990775411015,356305000.0,1.1570059359256817,0.5363944144312942,0.46360558556870585,,356305000.0,0.808366906858612,15.681560546373925,Acute Care Hospitals,non-profit,0,NEW YORK METHODIST HOSPITAL (330236)
26944,NEW YORK METHODIST HOSPITAL - ACUTE (330236),General Short Term (Acute Care Hospitals),Voluntary Nonprofit-Other,-73.979141,40.668263,1911825.0,,-11296.0,,,,,22529196.0,2288632.0,,,,,65476.0,,NY,,,31107716.0,379.0,,,,21129915.0,,Y,,,1460686.0,,,,,14932776.0,,KINGS,469342700.0,116.91,,,,880156.0,2014-12-31,695610.0,,,-1277902.0,,,,89427.0,,,,,745264.0,,,,,228684.0,,,,,153363.0,,16636428.0,2267983.0,,,,89008004.0,,,,20418.0,,40994657.0,,565.0,,,22529196.0,,,,2443.0,,531.0,,,,33S236,,,,1087.0,,,115.35,,29079.0,,4740602.0,,,447273.0,5007474.0,,,,,563607359.0,,,,,,Y,8319343.0,,,,,,,,5754820.0,,,,340581.0,,,3607645.0,6020968.0,,,,,,,3196781.0,,4237032.0,,5800986.0,,,,,,,,,450533.0,,,38700101.0,2513700.0,,356362.0,,,,,,,,379.0,,,,,37849.0,2890068.0,,,,-147896.0,,121290.0,257330529.0,,,,482875.0,15740.0,29464372.0,,,3554144.0,,,,2744474.0,,35644,,,,606842.0,,,,,2100214.0,1401996.0,,2215004.0,,,,,8615.0,,,,,,,,18011000.0,19180.0,5.0,,,N,4053454.0,,15342261.0,,,,,,,332711000.0,,,,,,8350626.0,,,,,7541772.0,,,19938.0,,40.82,,,,,,506 SIXTH STREET,500990203.0,,,,,,,,,,,,,,,,,882970.0,,,,,104832.0,,,,16694704.0,10012211.0,,,,,,-1930905.0,,,,,,,,216491.0,11887431.0,,,,,,,,,12402321.0,,,6609473.0,,,2292747.0,21382.0,54381.0,,514630.0,138159.0,,,,,,,,,7424522.0,2024-01-18 00:00:00,,,68355.0,,64905.0,,8477297.0,,,9624464.0,,1697392.0,187785.0,263282.0,,,,,39274.0,,,49530.0,,,,,80295051.0,,-1619990.0,70890.0,,100.03,6972836.0,,1632569.0,,7209411.0,,,,90.38,9724272.0,,9914730.0,,153363.0,,,,267873.0,13490.0,559445810.0,,,,,20469815.0,,,,18.12,,1450444.0,,,,,,2182500.0,,12554.0,-887587.0,8615.0,1396460.0,,,1372068.0,,,31518900.0,1372068.0,,9252475.0,50698.0,,,,,2078350.0,,,,,40950.0,,1231183.0,,,,,,,9430.0,,,,6000655.0,,,,,23387095.0,-749252.0,,,,70523.0,,3459769.0,,,,,,,,,4567.0,,,,,,,,4134042.0,165345701.0,,,,,,,,6567.0,,,6997175.0,,,,,,,,,,44464440.0,4706555.0,,,,,,,641052.0,,,,43.34,,12719.0,2559904.0,,,,,532081.0,,,,,,,1941.0,,,,656348700.0,,,,1312846.0,330836.0,,,7987072.0,229117412.0,,,,,51716322.0,,,26623.0,,,,,,12577586.0,48181.0,,,42929.0,983297.0,,12919220.0,,,,7690525.0,,,,,10522.0,,,,,,,,,,33.8,,,,,,,,,29298497.0,778928.0,,,,,,,,,,3453.0,,,971.0,,,,,,,,,,,,,,,57404.0,,,12123130.0,523.0,,,,,,,574659.0,,38973.0,,,,,,,,,,,,,,477693711.0,,144.0,,-360814.0,2056592.0,,18869063.0,40360.0,3416109.0,,398774.0,244411309.0,378036.0,,,-2145.0,,,-203185.0,,,48491127.0,,,,2669778.0,,,5803535.0,3561078.0,,,,,,,,3040894.0,,,,337202.0,-1943083.0,32.0,4164090.0,201068299.0,,845831.0,,,562259.0,5800986.0,,87741.0,,,,1520.0,,,942788.0,22192263.0,,,12030.0,,,,268432000.0,,,5533785.0,,,,,,1170.0,,15385281.0,73043.0,1299319556.0,,68332.0,386.0,,,23966175.0,5735294.0,14793463.0,1050.0,,,,,,,,33327.0,5603784.0,,,997811.0,1405.0,,,,7489444.0,,10615301.0,,5428070.0,,,-191299.0,115724.0,,,,,8816762.0,,,,,26.0,,,,14536689.0,,,9683959.0,,109492274.0,,,,,,,38965166.0,,,,,,,,,,1.0,,,152490.0,24317.0,,772.0,397995.0,,,,1019.0,,,,2310805.0,,,,,,,,130064.0,,,90253043.0,,18250.0,,,1527502.0,3459769.0,,,,,7209411.0,,1384264.0,39274.0,,921148.0,,164700.0,2702014.0,,,,745264.0,,,1853740.0,3527077.0,,54081029.0,,,,,,921148.0,68.0,2030183.0,3994895.0,379671.0,265.02,,,,11658099.0,,89008004.0,,,,572813344.0,,,,,,,,,,,5870238.0,,134273.0,16367502.0,,,278620.0,,,1019.0,2310805.0,,,,,40089000.0,,2839766.0,3740000.0,,,,,,,7315.0,13353792.0,,49598.0,251123.0,,279209.0,504.0,,,35.48,,,6912410.0,,1373964.0,,,,,,1678758.0,82680.0,,-13120830.0,,,15405.0,298321.0,,,,8186.0,,,,37259081.0,,,248915.0,,,,,,,46.48,,,,,,,,2917120.0,,4706555.0,,10012211.0,,,33581442.0,10612945.0,36889979.0,,2172146.0,,,,,,,370358.0,12577586.0,,,54403424.0,,,7884653.0,26665401.0,1460686.0,5500.0,756560.0,,,29597448.0,,,,,7525637.0,,,10255280.0,29597448.0,309454.0,12469.0,316780729.0,,5654175.0,1396460.0,5428070.0,,,,,15025769.0,,,2668990.0,165710.0,,,,,,,290550.0,188340.0,,35965993.0,,,,,,62990170.0,,31.6,,,,,,164447878.0,,,,-747335.0,,,2494517.0,,,,,7884653.0,,4,,,,,,15740.0,,396755773.0,,,3716131.0,,,11215-9008,,8053620.0,11090.0,8712953.0,,241694998.0,,199623.0,,,,,1217375.0,95.23,,,,,,27867764.0,,,,,,,2833418.0,,,2728120.0,,,,,,,,,46953000.0,,10597763.0,,,525720.0,,21.73,,,13394726.0,,,7541772.0,-228154.0,10423568.0,,,,,,,,,,,,,,1841876.0,762186,,16932313.0,425992.0,31.6,,,,,,,,530.0,,112477712.0,24258997.0,,523.0,,,400907.0,94394426.0,,5380.0,6081340.0,,,,,,,169715274.0,,,257610.0,3359.0,,,,1641532.0,,10032867.0,NEW YORK METHODIST HOSPITAL,,18801988.0,,,9629183.0,333341.0,,,27717.0,6789016.0,,67106.0,,33T236,N,,,,20058128.0,28752870.0,,,28530478.0,13001,5684395.0,,23425500.0,3775237.0,687712415.0,10918815.0,99859975.0,,,,,,,2373138.0,,,572115.0,,28530478.0,,,,,,316780729.0,,-1917.0,,,0.829,,54709742.0,227827.0,,,70890.0,,66449165.0,890767000.0,51624031.0,,,N,,,,,386.0,,,6943398.0,,,92136844.0,,13870.0,,36822843.0,,,1015852.0,,,,,,,8285495.0,1679.0,,,7280863.0,,,4740602.0,,,,,,2008263.0,,2851448.0,,,,,1719714.0,,408953.0,,81971974.0,,2379883.0,,,227827.0,,5506426.0,51925831.0,,,124951.0,,,349613.0,,880156.0,,,,97354.0,19030360.0,29263007.0,54.5,,,674537.0,,,,,,780632.0,518639.0,,-203185.0,339.0,,7280863.0,2559904.0,,,43.11,,,,,,,298717.0,,,,2631403.0,,0.31075,3292525.0,,,4847409.0,,,275729503.0,,,40.52,,,22.57,23966175.0,,1463500.0,57512.0,,,,,147830800.0,,,,36238.0,,24642417.0,,N,,,90952662.0,,15342261.0,,15434791.0,,34803.0,112108000.0,14992526.0,288330.0,244.0,,,,,,1583245.0,11445387.0,,1937233.0,322180.0,,,-295590.0,48528500.0,,,,,,,,,,,,276.0,,,,,10409.0,BROOKLYN,523.0,31.64,,2438979.0,,,-1619990.0,,3742363.0,P,,,2374943.0,1800309759.0,,22438731.0,,,7192685.0,330236,,2226176.0,7170397.0,,4308938.0,,3952077.0,707676.0,272713757.0,15555461.0,,,,,,,,512881.0,,-280275.0,,,15038975.0,89598178.0,,66490.0,,760187.0,,,139879183.0,,22294775.0,Y,,,,,1949265.0,18676703.0,706127.0,,,,,297244.0,2496780.0,,,18651277.0,,7690525.0,,,,,,,,,48181.0,,,379061.0,2875482.0,,,,5809250.0,,12719.0,6800092.0,,44456898.0,9597.0,327849688.0,,97735541.0,980308.0,,64296.0,,,,,3527077.0,,,6129420.0,,-2154170.0,30232942.0,,8712953.0,68864000.0,,,2496780.0,,,,,,,,,18164.0,830206.0,,23387095.0,,168734.0,,,,5715784.0,,,,34318.0,7104958.0,,,1717440.0,,,,,,,80295051.0,34803.0,,,,,,2379883.0,696252.0,,,,,,,,,,,,158.0,,,6852290.0,,,,,,,,,5167887.0,,,40.5,,11377144.0,300774.0,195816060.0,38.0,,,,,,271778.0,,,,,,,,,8345347.0,,,743.0,5529.0,591.0,3188790.0,10143357.0,37580806.0,343143585.0,253725034.0,,11748.0,,,,-55149.0,,,,33331,,,,6852290.0,15186900.0,,,,8204660.0,1125067.0,,,1.0,,605956.0,,,,,,,,155506.0,,1261827.0,,3532043.0,,,,,,,20129.0,,,,8760.0,,,29309793.0,,,,,,2669778.0,,,,,309454.0,1107549.0,,,,144213.0,,38973.0,,,,,2785844.0,N,3254884.0,,,6260226.0,,,,144.0,,,,,2421884.0,31314647.0,516.0,,,,,273629.0,,,,,,115817000.0,,1299319556.0,,,,,,,1637172.0,,51276.0,18272616.0,,21377671.0,25.0,,,138159.0,,,,,,,1405.0,,,10180.0,,,,,2512538.0,,,1663445.0,102110.0,176670.0,,1578964.0,,,,262883.0,,,,12834.0,,16367502.0,,,,,,,,,,,,,,General Short Term,,,,,278440.0,669469530.0,37576453.0,605677.0,142667304.0,,1463851.0,,44464440.0,,,,,,,5603784.0,,,,,,,,6134975.0,211215.0,,,,,-13120830.0,6334344.0,3531169.0,-55149.0,45065.0,1169519.0,24317.0,657.0,Y,,108760.0,,,18668.0,Y,,,3904188.0,,,,5475.0,,2893056.0,,,,,,,,,11039778.0,1583245.0,,1140264.0,,3531169.0,,2.0,,,-303286.0,6407814.0,,3716131.0,,1352147.0,,,,,,,,28460965.0,19050500.0,,,,,,6997175.0,,,,42453.0,340442.0,,,38.85,8321643.0,,,,,F,,,,2505.0,9662509.0,,,19032803.0,,,,97574115.0,,124948.0,3571.0,,10612945.0,1939309.0,N,,,,,,,,F,,325862.0,22192263.0,,13991807.0,,,,,,,,129978.0,,2224806.0,,6346606.0,,1405.0,155544.0,,735108.0,454.0,,,,265.02,,14060.0,,132771000.0,,,245.0,,,3339553.0,,,,,,465482000.0,,,-115524.0,2182500.0,,,,39.94,201365.0,,6515401.0,157908.0,1894936.0,18651277.0,,87252.0,,N,4956.0,45747556.0,,1094958.0,,,8224.0,,,53354975.0,1302849.0,,279209.0,,44.0,,,2816373.0,6020968.0,,,,50.0,,,63426.0,,,379061.0,,37972.0,,33,,2.0,,,,30232942.0,,678454.0,,,,41521.0,,1806.0,,,,3319618.0,,,,,,,,157913045.0,,87009875.0,,-106931.0,,,,,,,,,128748.0,3318214.0,,34199044.0,500990203.0,,,2767007.0,55.26,3060031.0,,,,,9097197.0,1238470.0,,,,,882.0,N,,,2066823.0,7525637.0,,24.0,,26300915.0,482875.0,,12365664.0,,44820857.0,,,,89167600.0,3554144.0,782.0,18274557.0,377846.0,,454.0,432917.0,,,,882970.0,2232644.0,6587000.0,,11859.0,299129558.0,,,,,,1140264.0,,,,,,,391501.0,,,,,,,130604.0,,687230.0,1743.0,,,,,,,1112597344.0,NEW YORK METHODIST HOSPITAL - PSYCH,,-2788121.0,,,,9724272.0,715024.0,,,,391501.0,,11514.0,,,,6740213.0,,,,21605825.0,,,36428.0,,929524.0,,641602.0,,7670568.0,,,1031571.0,2527592.0,,,22407.0,,,,,3677291.0,,,,,,31314647.0,,,1719714.0,8816762.0,,,3060031.0,2726887.0,,7208924.0,,19105877.0,,6509.0,14818558.0,,,,,,,,84497.0,,4053350.0,,,,,,,,25.0,,,,8186.0,,,,,,,,,,7489444.0,,,,5735294.0,11834226.0,,48181.0,,,25498762.0,,,,,6239.0,,30.64,7192685.0,37580806.0,,,,12919220.0,,,,,,9053671.0,27205202.0,,,,,43.42,,,,,3881514.0,,,1934303.0,,,3881514.0,,,,,,,,161775.0,,1658735.0,,,,,30706.0,Y,,3347512.0,,,,1784038.0,,,297023.0,13367534.0,,181199.0,17354246.0,,397995.0,,9057740.0,83442.0,,,6645323.0,15013912.0,,,,,,,,,,,,,,,,398.0,,,-232.0,,,56.96,563607359.0,,,1527502.0,,640479.0,,,,9125.0,5756285.0,,,,57372800.0,,,4019903.0,,,,,,80247.0,,,,,,6807524.0,,272713757.0,,43575439.0,,,,,,,35668.0,,5007474.0,,,,,,,,15013912.0,524353000.0,,,12554.0,,-887587.0,,28457280.0,,5600,208583.0,4528910.0,,,,,,,,,,,,3449.9,,1711871.0,73338080.0,,,26.93,22084343.0,279209.0,,248123.0,,,13245723.0,20362884.0,,,,,,451.0,,38965166.0,,13317.0,,,,,,,,,,4334518.0,,,-360814.0,,,,,,,,N,,,,,,,,,,13353792.0,,41259.0,14586.0,,-1206265.0,15555461.0,,,,,466012.0,,101687618.0,,380607.0,,482198.0,2421884.0,6458180.0,,,2014-01-01 00:00:00,3339553.0,,,7692791.0,,,,5684395.0,,,,,,142667304.0,,,,2787039.0,,,61493.0,,,,,764577.0,5926799.0,336878.0,574659.0,5736316.0,16968901.0,5917458.0,,15342261.0,,,,743.0,,,-983906.0,,19.74,2383712.0,,11514.0,,1591657.0,,,4237032.0,,,,,2810002.0,,,,6811061.0,,5710835.0,5107.0,,,,,,,,,,,,,5529.0,400687000.0,36822843.0,,68593383.0,33426996.0,,,,,-3051.0,,,Y,,,,8154539.0,,,,,,,2336532.0,67543.0,25219870.0,,,,,,6239.0,211215.0,,,5506426.0,4956.0,,,5372527.0,,64905.0,8224.0,,,1159.0,3766852.0,34114600.0,19370.0,,,1743.0,9624464.0,,,,5448552.0,,6556373.0,,,,,110370.0,,,,,22294775.0,1637172.0,,,,325333.0,,,,,,,,,,,,,36986.0,,,,7396.0,,,26443360.0,1101534.0,,,2466587.0,,,,,,840641.0,,,177639.0,,,,,,,,472541.0,,1800309759.0,7192685.0,,,,,,,,18242885.0,15.0,,,7970929.0,,,,,,,,3716131.0,31107716.0,8638581.0,13394726.0,-4161549.0,,,,,,,1617380.0,,,,2373138.0,1068.0,,,3904188.0,,,,16870074.0,351509.0,,153363.0,,,,,,,33724.0,10423568.0,707676.0,,1043944.0,,,42773.0,,,,,187251.0,40994657.0,,,,,-1827559.0,7360.0,,,53710.0,1856824.0,27867764.0,231831.0,,12123130.0,2224806.0,1949265.0,,,,,,,,85096571.0,,,,,,,,,,,4847409.0,,,,,19209505.0,,165710.0,68593383.0,142667304.0,,NEW YORK METHODIST HOSPITAL - REHAB,,,7991335.0,4053454.0,,5485925.0,,,,,55536.0,,9430.0,6052170.0,,,,,,,2135144.0,,,4238054.0,2014,2014,29263007.0,201365.0,,0.014433082563145181,425285000.0,148443320.69325,380540000.0,0.10013487978110734,18242885.0,0.02652690950766099,3.949303688305428,3.1179022226239166,3.8754303725964254,0.8443711352629716,425285000.0,1.0945177939499395,0.5225631394068257,0.4774368605931742,,425285000.0,0.7720452318058482,20.57356320621811,Acute Care Hospitals,non-profit,1,NEW YORK METHODIST HOSPITAL (330236)
33131,NEW YORK METHODIST HOSPITAL - ACUTE (330236),General Short Term (Acute Care Hospitals),Voluntary Nonprofit-Other,-73.979141,40.668263,2370424.0,,-17779.0,,,,,26130099.0,2288735.0,,,,,46822.0,,NY,,,33169640.0,992.0,,,,26369712.0,,Y,,,5066055.0,,,,,21683242.0,,KINGS,546511607.0,124.75,,,,865165.0,2015-12-31,680710.0,,,-1459525.0,,,,66527.0,,,,,636232.0,,,,,197814.0,,,,,152302.0,,21578040.0,1720869.0,,,,99873694.0,,,,24439.0,,28384217.0,,588.0,,,26130099.0,,,,3949.0,,225.0,,,,33S236,,,,,,,114.55,,27570.0,,6558424.0,,,337060.0,5098632.0,,,,,590010086.0,,,,,,Y,2833418.0,,,,,,,,7892786.0,,,,235265.0,,,4108151.0,6103929.0,,,,,,,3302089.0,,4500361.0,,6357165.0,,,,,,,,,492189.0,,,42083000.0,2125290.0,,605239.0,,,,,,,,992.0,,,,,36226.0,2875482.0,,,,-72846.0,,129870.0,274075020.0,,,,224786.0,15497.0,25923193.0,,,3498054.0,,,13733.0,4600634.0,,35614,,,,917000.0,,76.82,,,2344590.0,1173500.0,,3358769.0,,,,,8575.0,,,,,,,,16527000.0,22187.0,4.0,,,N,4209926.0,,16770756.0,,,,,,,322223000.0,,,,,,15380884.0,,,,,7760152.0,,,27296.0,,40.29,,,,,,506 SIXTH STREET,573734464.0,,,,,,,,,,,,,,,,,1271857.0,,,,,46947.0,,,,19468000.0,10920950.0,,,,,,-6023248.0,,,,,,50736.0,,236366.0,8217563.0,,,,,,,,,14190592.0,,,7271414.0,,,3206070.0,18447.0,59142.0,,806834.0,146062.0,,,,,,,,,11809000.0,2024-01-18 00:00:00,,,73594.0,,61543.0,,7536116.0,,,10431924.0,,1472712.0,192855.0,277568.0,,,,,25825.0,,,58695.0,,,,,92981653.0,,-1782301.0,71769.0,,92.33,7280371.0,,1610565.0,,8017985.0,,,,91.55,9972652.0,,11055809.0,,152302.0,,,,200046.0,6923.0,584121901.0,,,,,23514825.0,,,,20.2,,1421770.0,,,,,,2212500.0,,12179.0,-3459289.0,8575.0,1459733.0,,,1598689.0,,,36954455.0,1598689.0,,10337034.0,7022.0,,,,,2099845.0,,,,,44850.0,,17527403.0,,,,,,,7867.0,,,,6932398.0,,,,,20719457.0,-734743.0,,,,69342.0,,3828959.0,,,,,,,,,3725.0,,,,,,,,4367979.0,178234000.0,,,,,,,,4655.0,,,7652827.0,,,,,,,,,,43312872.0,4379166.0,,,,,,,555554.0,,,,44.71,,12438.0,3145903.0,,,,,632247.0,,,,,,,9976.0,,,,686146720.0,,,,1447298.0,316124.0,,,11425541.0,242743688.0,,,,,57982000.0,,,9639.0,,,,,,15478403.0,45260.0,,,49934.0,1007989.0,,16023432.0,,,,9066035.0,,,,,20298.0,,,,,,,,,,35.83,,,,,,,,,34554092.0,689961.0,,,,,,,,,,3210.0,,,1110.0,,,,,,,,,,,,,,,54767.0,,,16540261.0,992.0,,,,,,,1091060.0,,12968.0,,,,,,,,,,,,,,531187505.0,,,,-279009.0,2727580.0,,21067618.0,43019.0,2486663.0,,422872.0,258051588.0,413785.0,,,-317626.0,,,-145460.0,,,50365968.0,,,,3657132.0,,,6220136.0,3556371.0,,,,,,,,3368781.0,,,,300774.0,,34.19,66989.0,193962000.0,,833922.0,,,451488.0,6357165.0,,122073.0,,,,1969.0,,,924152.0,18039461.0,,,15134.0,,,,307105000.0,,,6917116.0,,,,,,1170.0,,12127136.0,49290.0,1404816073.0,,35286.0,,,,19161567.0,5929213.0,14692693.0,2289.0,,,,,,,,23756.0,6617897.0,,,816776.0,1909.0,,,,8056500.0,,12149418.0,,6201909.0,,,-320408.0,133165.0,,,,,9684866.0,,,,,16.0,,,,14997054.0,,,5810453.0,74285.0,85364231.0,,,,,,,43427569.0,,,,,,,,,,1.0,,,162630.0,7779.0,,628.0,475410.0,,,,1909.0,,,,2117743.0,,,,,,,,152435.0,,,112661588.0,,18250.0,,,1508474.0,3828959.0,,,,,8017985.0,,1607180.0,25825.0,,970932.0,,111090.0,3159494.0,,,,636232.0,,,2103587.0,3032985.0,,68665000.0,,,,,,970932.0,37.0,2560480.0,2777552.0,410857.0,270.97,,,,6659724.0,,99873694.0,,,,602059079.0,,,,,,,,,,,6312612.0,,95210.0,23303839.0,,,298700.0,,,1909.0,2117743.0,,,,,42797000.0,,3138669.0,,,,,,,,7231.0,14091046.0,,34985.0,160373.0,,307310.0,103.0,,,35.6,,,7767148.0,,1229890.0,,,,,,2773617.0,87360.0,-480000.0,-21030506.0,,,15210.0,211389.0,,,,8193.0,,,,38133145.0,,,259987.0,,,50736.0,,,,50.55,,,,,,,,4078904.0,,4379166.0,,10920950.0,,,33604000.0,10884692.0,38957799.0,,2208445.0,,,,,,,1631086.0,15478403.0,,,61241604.0,,,8429910.0,19609886.0,5066055.0,6621.0,1046763.0,,,29235792.0,,,,,7007665.0,,,16421086.0,29235792.0,297677.0,12319.0,317538692.0,,5786886.0,1459733.0,6201909.0,,,,,14990114.0,,,2001293.0,165710.0,,,,,,,288990.0,188340.0,,40981017.0,,,,,,64100099.0,,32.56,,,,,,161514971.0,,,,-733931.0,,,2549033.0,,,,,8429910.0,,4,,,,,,15497.0,,412441621.0,,,4004190.0,,,11215,,8240663.0,7537.0,6892041.0,,258222091.0,,244902.0,,,,,1296511.0,97.3,,,,,,26223853.0,,,,,,,2833418.0,,,2817454.0,,,,,,,,,6921000.0,,11969136.0,,,531180.0,,36.75,,,14400571.0,,,7760152.0,-218538.0,13071621.0,,,,,,,,,,,74285.0,,,1836145.0,762187,,20080580.0,148474.0,32.56,,,112353.0,,,,,443.0,13733.0,125560653.0,,,992.0,,,554421.0,92210063.0,,5523.0,5919579.0,,,,,97.74,,170533982.0,,,161125.0,3338.0,,,,2280140.0,,9926179.0,NEW YORK METHODIST HOSPITAL,,24951764.0,,,10475036.0,753370.0,,,35386.0,6373063.0,,41876.0,,33T236,N,,,,20804474.0,32942384.0,,,31693715.0,13001,5370783.0,,28124990.0,3862660.0,732887554.0,12644055.0,38203843.0,,,,,,,3992340.0,,,724638.0,,31693715.0,,,,,,317538692.0,,-812.0,,,0.829,,73255604.0,274681.0,,,105245.0,,75709642.0,981198000.0,57161305.0,,,N,,,,,,,,8565596.0,,,91305577.0,,13870.0,,264207.0,,,1593138.0,,,,,,,9047875.0,2779.0,,,9030800.0,,,6558424.0,,,,,,1992951.0,,2266105.0,,,,,2133900.0,,456166.0,,80300693.0,,2050553.0,,,274681.0,,5620676.0,68991514.0,,,201979.0,,,367249.0,,865165.0,,,,120689.0,21163426.0,25778425.0,57.64,,,308636.0,,,,,,843383.0,475894.0,,-145460.0,333.0,,9030800.0,3145903.0,,,43.54,,,,,,,346450.0,,,,2705587.0,,0.295227,4577693.0,,,6521725.0,,,297792616.0,,,41.95,,,23.34,19161567.0,,1759623.0,15592.0,,,,,159031770.0,,,,28708.0,,27344800.0,,N,,,100477926.0,,16770756.0,,17310532.0,,35575.0,122026000.0,12509103.0,471822.0,,,,,,,2038778.0,11640845.0,,3110531.0,331289.0,,,-489242.0,55386773.0,,,,,,,,,,,,,,,,,9154.0,BROOKLYN,992.0,35.67,,2512037.0,,,-1782301.0,,2915603.0,P,,,2460362.0,1978550537.0,,24660249.0,,,7891394.0,330236,,2470906.0,8015980.0,,4335345.0,,4285670.0,453484.0,294735605.0,12476031.0,,,,,,,,581922.0,,-124246.0,,,15819180.0,71328101.0,,145285.0,,728150.0,,,154406660.0,,25535837.0,Y,,,,,2179436.0,21661852.0,204716.0,,,,,308080.0,6056324.0,,,17821714.0,,9066035.0,,,,,,,,,45260.0,,,329881.0,4746000.0,,,,8205957.0,,12438.0,6309377.0,,38432296.0,2181.0,352590034.0,,100243839.0,1100753.0,-1088226.0,36764.0,,,,,3032985.0,,,9152438.0,,-1945630.0,34245461.0,,6892041.0,88934000.0,,,6056324.0,,,,,,,,,30588.0,855047.0,,20719457.0,,174933.0,,,,5735556.0,,,,36334.0,7530150.0,,,659577.0,,1870035.0,,,,,92981653.0,35575.0,,,,,,2050553.0,704587.0,,,,,,,,,,,,347.0,,,4868658.0,,,,,,,,,6578303.0,,,42.28,,13223815.0,301000.0,190593000.0,38.0,,,,,,320202.0,,,,,,,,,9069210.0,,,,5569.0,591.0,3441627.0,14393296.0,34778322.0,367897934.0,271785000.0,,15939.0,,,,-45204.0,,,,33331,,,,4868658.0,18425625.0,,,,11079219.0,1193560.0,,,1.0,,558541.0,,,,,,,,135128.0,,995965.0,,3847056.0,,,,,,,30673.0,,,,8760.0,,,34571871.0,,,,,,3657132.0,,,,,297677.0,1551831.0,,,,94664.0,,12968.0,,,,,3300522.0,N,3294303.0,,,6594882.0,,,,,,,,,2924021.0,12816528.0,516.0,,,,,268423.0,,,,,,95855000.0,,1404816073.0,,,,,,,1454285.0,,22211.0,20439225.0,,19937638.0,25.0,,,146062.0,,,,,,,1909.0,,,8160.0,,,,,1773421.0,,,1996935.0,102498.0,181740.0,,1951821.0,,,,106375.0,,,,13244.0,,23303839.0,,,,,,,,,,,,,,General Short Term,,,,,311753.0,707177226.0,37891154.0,551334.0,158244656.0,,1211485.0,,43312872.0,,,,,,,6617897.0,,,,,,,,7231827.0,208891.0,,,,,-21030506.0,5960337.0,3738813.0,-45204.0,11703.0,1120230.0,7779.0,625.0,Y,,89272.0,,,17735.0,Y,,,7306054.0,,,,5475.0,,4603342.0,16430.0,,,,,,,,12365072.0,2038778.0,,1144948.0,,3738813.0,,2.0,,,-951576.0,6264514.0,,4004190.0,,1669980.0,,,,,,,,26820841.0,19232710.0,,,,,,7652827.0,,,,49256.0,104582.0,,,41.14,8993504.0,,,,,F,,,,,8295093.0,,,21167375.0,,,,70144672.0,,135282.0,3678.6,,10884692.0,2233566.0,N,,,,,,,,G,,371079.0,18039461.0,,13987926.0,,,,,,,,48365.0,,2469481.0,,7009577.0,,1909.0,163696.0,,676958.0,454.0,,,,270.97,,13255.0,,146240000.0,,,273.0,,,3632339.0,,,,,,468463000.0,,,-33107.0,2212500.0,,,,41.23,144768.0,,7165450.0,164922.0,1707741.0,18909940.0,,85239.0,,N,5244.0,44335963.0,,1052024.0,,,7900.0,,,52409780.0,1114473.0,,307310.0,,72.0,,,6556373.0,6103929.0,,,,50.0,,,42273.0,,,329881.0,,43420.0,,33,,2.0,,,,34245461.0,18643.0,197218.0,,,,43909.0,,2294.0,,,,3386596.0,,,,,,,,157869857.0,,111182521.0,,-175962.0,,,,,,,,,154705.0,3659287.0,,37347968.0,573734462.0,,,3063968.0,58.89,2645808.0,,,,,10411466.0,1282728.0,,,,,917.0,N,,,2239083.0,7007665.0,,24.0,,23704801.0,224786.0,,12716595.0,,47026045.0,,,,89656985.0,3498054.0,642.0,20449201.0,1164670.0,,454.0,385281.0,,,,1271857.0,2444000.0,6587000.0,,4286.0,288619000.0,,,,,,1144948.0,,,,,,,608275.0,,,,,,,103764.0,,752899.0,1772.0,,,,,,,1245662983.0,NEW YORK METHODIST HOSPITAL - PSYCH,,-3837996.0,,,,9972652.0,889437.0,,,,608275.0,,9580.0,,,,8420136.0,,,,20156176.0,,,,,3146987.0,,785728.0,,8400151.0,,,999815.0,2649704.0,,,12285.0,,,,,3968010.0,,,,,,12816528.0,,,2133900.0,9684866.0,,,2645808.0,1685391.0,,6626821.0,,21136731.0,,16065.0,17701463.0,,,,,,,,46814.0,,3821998.0,,,,,,,,80.0,,,,8193.0,,,,,,,,,,8056500.0,,,,5929213.0,12425062.0,,45260.0,,,27306057.0,,,,,5470.0,,30.83,7891394.0,34778322.0,,,,16023432.0,,,,,,11523155.0,32056769.0,,,,,43.0,,,,,4978990.0,,,3662276.0,,,4978990.0,,,,,,,,1251383.0,,2461000.0,,,,,32485.0,Y,,3563021.0,,,,1950382.0,,,358942.0,17937178.0,,185439.0,16398345.0,,475410.0,,9266485.0,84763.0,,,7356027.0,16505037.0,,,,,,,,,,,,,,,,404.0,,,,,,59.87,590010086.0,,,1508474.0,,696231.0,,,,9125.0,5889384.0,,,,63842595.0,,,4052360.0,,,,,,85961.0,,,,,,7043056.0,,294735605.0,,51247611.0,,,,,,,32718.0,,5098632.0,,,,,,,,16505037.0,609002000.0,,,12179.0,,-3459289.0,,32453142.0,,5600,379703.0,15530486.0,,,,,,,,,,,,3544.7,,1765593.0,79081901.0,,,28.28,21226704.0,307310.0,,263054.0,,,15233760.0,23338863.0,,,,,,207.0,,43427569.0,,8761.0,,,,,,,-2103587.0,,,5238284.0,,,-279009.0,,,,,,,,N,,,,,,,,,,14091046.0,,7735.0,,,-997724.0,12476031.0,,,,,411212.0,,104529509.0,,423269.0,,610921.0,2924021.0,6056939.0,,,2015-01-01 00:00:00,3632339.0,,,9508454.0,,,,5370783.0,,,,,,158244656.0,,,,3204964.0,,,62222.0,,,,,1031258.0,5918738.0,355080.0,1091060.0,5929213.0,14010021.0,6361065.0,,16770756.0,,,,,,,-2761246.0,,20.52,3137000.0,,9580.0,,1593027.0,,,4500361.0,,,,,3903274.0,,,,6028988.0,,6693764.0,10928.0,,,,,,,,,,,,,5569.0,489621000.0,264207.0,,80757860.0,46601000.0,,,,,-3236.0,,,Y,,,,7256465.0,,,,,,,2167491.0,141846.0,26215953.0,967.0,,,,,5470.0,208891.0,,,5620676.0,5244.0,,,7258363.0,,61543.0,7900.0,,,,3747450.0,33512755.0,4350.0,,,1772.0,10431924.0,,,,5940968.0,,6556000.0,,,,,112515.0,,,,,25535837.0,1454285.0,,,,330006.0,,,,,,,,,,,323016.0,,,,,,14106.0,,,,1261444.0,,,3586715.0,,,,,,835883.0,,,957262.0,,,,,,,,403155.0,,1978550535.0,7891394.0,,,,,,,,25710328.0,15.0,,,9688511.0,,,,,,,,4004190.0,33169640.0,12273561.0,14400571.0,-5888185.0,,,,,,,1482843.0,,,,3992340.0,1369.0,,,7306054.0,,,,18251111.0,374511.0,,152302.0,,,,,,,38212.0,13071621.0,453484.0,,1097817.0,,,38769.0,,,,,185494.0,28384217.0,,,,,-1639000.0,1711.0,,,50829.0,2165394.0,26223853.0,66104.0,,16540261.0,2469481.0,2179436.0,,,,,,,,105444755.0,,,,,,,,,,,6521725.0,,,,,21172200.0,,165710.0,80757860.0,158244656.0,,NEW YORK METHODIST HOSPITAL - REHAB,,,9760294.0,4209926.0,,,,,,,55218.0,,7867.0,6262296.0,,,,,,,2555341.0,,,4501425.0,2015,2015,25778425.0,144768.0,,0.011729864445606454,512735000.0,156820893.53863502,429131000.0,0.1213474011321524,25710328.0,0.03508086316881293,4.164400984682714,3.253090809628009,4.062199124726477,0.8344228665207878,512735000.0,0.9136552020049343,0.4774398235626245,0.5225601764373755,,512735000.0,0.7469313573814867,15.726863243278041,Acute Care Hospitals,non-profit,1,NEW YORK METHODIST HOSPITAL (330236)
39206,NEW YORK-PRESBYTERIAN/BROOKLYN METHOD (330236),General Short Term (Acute Care Hospitals),Voluntary Nonprofit-Other,-73.979141,40.668263,2451528.0,,-79489.0,,,,,31207576.0,2635920.0,,,,,114022.0,,NY,,,35460810.0,902.0,,,,29038054.0,,Y,,,5559603.0,,,,,19929754.0,,KINGS,625035082.0,130.79,,,,821524.0,2016-12-31,682921.0,,,-1519298.0,,,,34498.0,,,,,801328.0,,,,,223586.0,,,,,148443.0,,22222723.0,2266688.0,,,,95282756.0,,,,20036.0,,35037506.0,,471.0,,,31207576.0,,,,,,1135.0,,,,33S236,,,,3524.0,,,232.35,,31300.0,,6224986.0,,,524220.0,5040687.0,,,,,632369777.0,,,,,,Y,2833418.0,,,,,,,,8610905.0,,,,474353.0,,,3710491.0,6479512.0,,,,,,,3736144.0,,4668802.0,,7955132.0,,,,,,,,,481378.0,,,51090000.0,2309852.0,,419847.0,,,,,,,,902.0,,,,,51183.0,4745517.0,,,,-236783.0,,139815.0,306199898.0,,,,455576.0,16046.0,27619608.0,,,3007898.0,,,494684.0,4280944.0,,35614,,,,3101000.0,,84.88,,,2201044.0,636708.0,,1423215.0,,,,,6628.0,,,,,,,,17017000.0,26120.0,2.0,,,N,5166708.0,,16327041.0,,,,,,,341981000.0,,,,,,23119948.0,,,,,6404665.0,,,32545.0,,44.6,,,,,,506 SIXTH STREET,714827797.0,,,,,,,,,,,,,,,,,1727175.0,,,,116.0,12961.0,,,,22557000.0,12720449.0,,287.0,,,,-8798064.0,,,,,,41721.0,,319835.0,8817984.0,,,,,,,,,15110677.0,,,8779831.0,,,3839381.0,22318.0,52471.0,,998526.0,122169.0,,,,,,,412682.0,,14827000.0,2024-01-18 00:00:00,,,41906.0,,60181.0,,8215561.0,,,12350152.0,,1600999.0,193245.0,330326.0,,,,,37486.0,,,65618.0,,,,,93681680.0,,-1790382.0,73182.0,,123.38,8982366.0,,1520927.0,,8379029.0,,,,89.27,10130609.0,,10978572.0,,148443.0,,,,137089.0,500120.0,627894001.0,,,,,22243359.0,,,,20.67,,1671955.0,,,,,,3725944.0,,13776.0,-1256092.0,6628.0,1157487.0,,,1934595.0,,,43073605.0,1934595.0,,12852643.0,29438.0,,,,,2089205.0,,,,,52455.0,,36662588.0,,,,,,,8430.0,,,,7067372.0,,,,,26221847.0,-752144.0,,,,56791.0,,3910398.0,,,,,,,,,2405.0,,,,,,,,4818360.0,212076000.0,,,,,,,,4039.0,,,7102618.0,,,,,,,,,,37933400.0,3076444.0,,,,,,,620913.0,,,,44.76,,13942.0,3681784.0,,,,,674193.0,,,,,,,1085.0,,,,724203890.0,,,,1748100.0,372190.0,,,9034969.0,275920539.0,,,,,66984000.0,,,5892629.0,,,,,,12935488.0,43279.0,,,38633.0,1051294.0,,13385351.0,,,,9124863.0,,,,,2089.0,,,,,,,,,,37.04,,,,,,,,,53263228.0,684979.0,,,,,,,,,,3846.0,,,1138.0,,,,,,,,,,,,,,,54590.0,,,15673458.0,1018.0,,,,,,,1306688.0,,34258.0,,,,,,,,,,,,,,605758384.0,,116.0,,-281036.0,3021518.0,,25271582.0,41454.0,2708202.0,,625200.0,292814547.0,494996.0,,,-587580.0,,,-198480.0,,,54725194.0,,,,3664525.0,,,6489886.0,3935630.0,,,,,,,,3439664.0,,,,300774.0,,35.44,,216079000.0,,872582.0,,,549618.0,7955132.0,,147387.0,,,,239.0,,,1086770.0,19333927.0,,,9445.0,,,,373610000.0,,,8857660.0,,,,,,1170.0,,12333328.0,74339.0,1583062879.0,,56643.0,,,,4707450.0,6399536.0,15038455.0,8342.0,,,,,,,,51672.0,6394999.0,,,975862.0,5139.0,,,,9336002.0,,14528830.0,,8437016.0,,,-234224.0,143713.0,,,,,9643085.0,,,,,13.0,,,,12230157.0,,,6428097.0,1854452.0,73653363.0,,,,,,,44521355.0,,,,,,,,,,1.0,,,196170.0,1662043.0,,683.0,338121.0,,,,4676.0,,,,2054977.0,,,,,,,,98271.0,,,113402065.0,,18300.0,,,2500038.0,3910398.0,,,,,8379029.0,,1942924.0,37486.0,,760026.0,,113947.0,3759709.0,,,,801328.0,,,2323822.0,2847868.0,,91337000.0,,,,,,760026.0,42.0,3003447.0,964789.0,541762.0,275.59,,,,3995611.0,,95282756.0,,,,636091616.0,,,,,,,,,,,6687481.0,,78314.0,20936207.0,,,346357.0,,,4676.0,2054977.0,,,,,52396000.0,,3768971.0,,,,,,,,5150.0,14933644.0,,29591.0,110624.0,,318480.0,392.0,,,37.23,,,8468934.0,,1184213.0,,,,,,2689541.0,88140.0,-320000.0,-20363309.0,,,15405.0,241158.0,,,,7587.0,,,,51319498.0,,,269260.0,,,41721.0,,,,44.85,,,,,,,,6138393.0,,3076444.0,,12720449.0,,,31861000.0,11063666.0,42057501.0,,2772820.0,,-270843.0,,,,,510956.0,12935488.0,,,67371861.0,,,9736796.0,24497683.0,5559603.0,6505.0,1167251.0,,,29330985.0,,,,,8455734.0,,,107796889.0,29330985.0,349872.0,5017.0,352052807.0,,6354423.0,1157487.0,8437016.0,,,,,15615172.0,,,2586003.0,166164.0,,,,,,,299325.0,188856.0,,43802265.0,,,,,,71309181.0,,38.26,,,,,,178975385.0,,,,-751150.0,,,3345617.0,,,,,9736796.0,,4,,,,,39472650.0,16046.0,,414981833.0,,,4320929.0,,,11215,,8379998.0,4880.0,1601076.0,,288856027.0,,224884.0,,,,,2035176.0,101.07,,,,,,26264722.0,,,,,,,2833418.0,,,2639254.0,,,,,,,,,-10126178.0,,12705104.0,,,548730.0,,36.23,,,14638742.0,,,6404665.0,-236987.0,12455869.0,,,,,,,,,,,1854452.0,,,1806003.0,762188,,23706019.0,164570.0,38.26,,,,,,,-48.0,468.0,494684.0,128131828.0,,,1018.0,,,541170.0,92210063.0,,5440.0,6010432.0,,,,,,,165072029.0,,,95726.0,1629.0,,,,2107234.0,,12512855.0,NEWYORK-PRESBYTERIAN/BROOKLYN METHOD,,26379729.0,,,12396604.0,1839098.0,,,54697.0,6460207.0,,22157.0,,33T236,N,,,,21350398.0,32027428.0,,,36316642.0,13001,5421327.0,,30489717.0,4686394.0,788052135.0,14927898.0,73841017.0,,,,,,,2842991.0,-2404885.0,,745605.0,,36316642.0,,,,,,352052807.0,,-994.0,,,,,77877784.0,336363.0,,,130225.0,,95417148.0,1174358000.0,64628443.0,,,N,,,,,463.0,,,11415490.0,,,98363476.0,,13908.0,,448237.0,,,3100837.0,,,,,,,10951721.0,2327.0,,,11821834.0,,,6224986.0,,,,,,2114306.0,,3208615.0,,,16798388.0,,3744105.0,,432005.0,,94290068.0,,1934627.0,,,336363.0,,5201669.0,69318088.0,,,251521.0,,,456483.0,,821524.0,,,,87625.0,25385830.0,27553771.0,60.78,,,573485.0,,,,,,950461.0,407386.0,,-198480.0,352.0,,11821834.0,3681784.0,,,43.07,,,,,,,409545.0,,,,2704226.0,,0.273248,7545102.0,,,4701156.0,,,332671897.0,,,43.42,,,24.16,4707450.0,,2077351.0,42329.0,,,,,172783040.0,,,,30766.0,,28041205.0,,N,,,111241709.0,,16327041.0,,20745930.0,,34958.0,152113000.0,16968476.0,280620.0,,-58416.0,,,,,1953385.0,12286065.0,,1315400.0,324450.0,,,-302625.0,64208931.0,,,,,,,,,,,,,,,,,6697.0,BROOKLYN,1018.0,36.1,,2254887.0,,,-1790382.0,,3638194.0,P,,,2515677.0,2297890676.0,,32872577.0,,,8481244.0,330236,,2599048.0,7645950.0,,4378639.0,,4748766.0,449775.0,329585366.0,16153584.0,,,,,,,,1031543.0,,-12310.0,,,15854115.0,56151917.0,,129837.0,,872014.0,,,161488027.0,,31397525.0,Y,,,,,2394697.0,,633398.0,,,,,383635.0,23163320.0,,,19538234.0,,9124863.0,,,,,,,,,43279.0,,,434193.0,4767000.0,,,,19667288.0,,13942.0,5430891.0,,44588084.0,12130.0,381333904.0,,96165347.0,1183943.0,-892168.0,13131.0,,,,,2847868.0,,,7939501.0,,-1240888.0,35388936.0,,1601076.0,145581000.0,,,23163320.0,,,,,,,,,36192.0,968274.0,,26221847.0,,168615.0,,,,5899297.0,,,,35581.0,6390537.0,,,1172094.0,,21292.0,,,,,93681680.0,34958.0,,,,,,1934627.0,684202.0,,,,,,,,,,,,1232.0,,,5431396.0,,,,,,,,,6581343.0,,,44.73,,12978115.0,301000.0,210441000.0,38.0,,,,,,286743.0,,,,,,,,,9428629.0,,,,5801.0,591.0,3676447.0,17994856.0,59803828.0,398227912.0,92210000.0,,60384.0,,,,-37013.0,,,,33331,,,,5431396.0,20738590.0,,,,12763132.0,1263210.0,,,1.0,,421766.0,,,,,,,,130928.0,,1149209.0,,3925253.0,,,,,,,37133.0,,,,8784.0,,,53342717.0,,,,,,3664525.0,,,,,349872.0,1056339.0,,,,94779.0,,34258.0,,,,,3560696.0,N,3443714.0,,,6744189.0,,,,,,,,,2679261.0,20713594.0,516.0,,,,,,,,,,146.0,135454822.0,,1583062878.0,,,,,,,1451080.0,,36380.0,24513816.0,,21101352.0,25.0,,,122169.0,,,,,,,5139.0,,,8882.0,,,,,1748967.0,,,2112846.0,100235.0,203970.0,,2232341.0,,,,122181.0,,,,32270.0,,20936207.0,,,,,,,,,,,,,,General Short Term,,,,,333383.0,744567199.0,41120372.0,581100.0,164190300.0,,685550.0,,37933400.0,,,,,,,6394999.0,,,,,,,,8732990.0,206479.0,,,,,-20363309.0,6113514.0,4317647.0,-37013.0,12454.0,1341560.0,1662043.0,601.0,Y,,62426.0,,36428.0,28488.0,Y,,,6693723.0,,,,5490.0,,1267596.0,,,,,,,,,15215348.0,1953385.0,,995507.0,,4317647.0,,2.0,,,-472926.0,7706763.0,,4320929.0,,2362495.0,,,,,,,,28367904.0,23549265.0,,,,,,7102618.0,,,,36167.0,159724.0,,,34.53,9377966.0,,,,,F,,,,9670.0,12001899.0,,,25385830.0,,,,91969886.0,,166303.0,3846.2,,11063666.0,2440314.0,N,,,,,,,,K,,391806.0,19333927.0,,14256953.0,,,,,,,,67109.0,,2597905.0,,7408331.0,,5139.0,185280.0,,654972.0,454.0,,,,275.59,,13527.0,,173571000.0,,5338156.0,213.0,,,3495363.0,,,,,,515552000.0,,,-40543.0,3725944.0,,,,43.16,65837.0,,7489422.0,179631.0,1538746.0,20430402.0,,85135.0,,N,5194.0,43551113.0,,1316893.0,,,7644.0,,,53576045.0,1076061.0,,318480.0,,94.0,,,6556373.0,6479512.0,,,,50.0,,,11642.0,,,434193.0,,49666.0,,33,,2.0,,,,35118093.0,15764.0,448237.0,,,,47967.0,,1395.0,,,,3784515.0,,,,,,,,153958616.0,,110757882.0,,-103076.0,,,,,,,,,165550.0,3546744.0,,38223653.0,714827797.0,,,3244958.0,62.98,3530489.0,,,,,10066686.0,1317592.0,,,,,4121.0,N,,,2432638.0,8455734.0,,24.0,,28598164.0,455576.0,,13755379.0,,47870036.0,,,,105218100.0,3007898.0,708.0,24514901.0,364552.0,,454.0,561556.0,,,,1727175.0,2416000.0,6587000.0,,5043.0,310120000.0,,,,,,995507.0,,,,,,,793227.0,,,,,,,103489.0,,288682.0,1800.0,,,,,,,1509838541.0,NEWYORK-PRESBYTERIAN/BROOKLYN METHOD,,-2702273.0,,,,10130609.0,1103316.0,,,,793227.0,,10428.0,,,,11217010.0,,,,21338339.0,,,,,4468158.0,,933917.0,,10486110.0,,,1034111.0,3080997.0,,,12335.0,,,,,3443200.0,,,,,,20713594.0,,,3744105.0,9643085.0,,,3530489.0,2415548.0,,7051801.0,-6687.0,24972389.0,,13588.0,21295798.0,,,,,,,,,,3475488.0,,,,,,,,29.0,,,,7587.0,,,,,,,,,,9336002.0,,,,6399536.0,14855987.0,,43279.0,,,36403066.0,,,,,5907.0,,30.9,8481244.0,59803828.0,,,,13385351.0,,,,,,13423195.0,33961687.0,,,,,49.21,,,,,5481837.0,,,3396301.0,,,5481837.0,,,,,,,,189082.0,,,,,,,25815.0,Y,,3642532.0,,,,2114642.0,216238000.0,,923316.0,8197615.0,,201967.0,16302611.0,,338121.0,,12254054.0,71747.0,,,7817876.0,19575691.0,,,,,,,,,,,,,,,,408.0,,,,,,59.08,632369777.0,,,2499990.0,,801233.0,,,,9150.0,6454658.0,,,,70235547.0,,,5744550.0,,,,,,92997.0,,,,,,7436616.0,,329585366.0,,66431277.0,,,,,,,3951.0,,5099103.0,,,,,,,,19575691.0,746203000.0,,,13776.0,,-1256092.0,,31724803.0,,5600,321874.0,17138121.0,,,,,,,,,,,,3705.1,,2061379.0,75802918.0,,,29.49,20220904.0,318480.0,,246755.0,,,19559070.0,22140283.0,,,,,,1565.0,,44521355.0,,8090.0,,,,,,,-2323822.0,,,5762899.0,,,-281036.0,,,,,,,,N,,,,,,,,,,14933644.0,,39585.0,,,-292983.0,16153584.0,,,,,415299.0,,100914113.0,,507717.0,,891061.0,2679261.0,6088017.0,,,2016-01-01 00:00:00,3495363.0,,,11516114.0,,,,5421327.0,,,,,,164190300.0,,,,3732791.0,,,54444.0,,,,,1484775.0,5671643.0,407431.0,1306688.0,6399536.0,17706442.0,6412727.0,,16327041.0,,,,,,,-3803043.0,,21.38,4260000.0,,10289.0,,1654460.0,,,4668802.0,,,,,3286659.0,,,,8793284.0,,7884870.0,11150.0,,,,,,,,,,,,,5801.0,635202000.0,448237.0,,105987862.0,48473000.0,,,,,-10508.0,,,Y,,,,8010420.0,,,,,,,1806876.0,132531.0,26847079.0,21847.0,,,,,5907.0,206479.0,,463.0,5201669.0,5194.0,,,2961272.0,,60181.0,7644.0,,,,3093305.0,38761749.0,23907.0,,,1800.0,12350152.0,,,,7070278.0,,6556000.0,,,,,110760.0,,,,,31397525.0,1451080.0,62058304.0,,,294690.0,,,,,,,,,,,158512.0,,,,,,3979.0,,,,1778826.0,,,5657015.0,,,,,,952048.0,,,353745.0,,,,,,,,533963.0,,2297890675.0,8481244.0,,,,,,,,43484936.0,15.0,,,11906802.0,,,,,,,,4320929.0,35460810.0,4702417.0,14638742.0,-4475776.0,,,,,,,1726657.0,,,,2842991.0,455.0,,,6693723.0,,,,19807059.0,384957.0,,148443.0,,,,,,,37153.0,12455869.0,449775.0,,1207619.0,,,20510.0,,,,,182789.0,35037506.0,,,,,-2423601.0,1766.0,,,49080.0,2152771.0,26264722.0,111321.0,,15673458.0,2597905.0,2394697.0,,,,,,,,112119898.0,,,,,,,,,,,4701156.0,62058304.0,,,,25431306.0,,166164.0,105987862.0,164190300.0,,NEWYORK-PRESBYTERIAN/BROOKLYN METHOD,,,8856338.0,5166708.0,,,,,,,45213.0,,8430.0,6692544.0,,,,,,,2826430.0,,,4669655.0,2016,2016,27553771.0,65837.0,,0.016119295902531423,658806000.0,165522266.911232,525723000.0,0.18473523962979937,43484936.0,0.055180278142384576,4.299122549273784,3.3081332711109575,4.189156022607463,0.8763733573004707,658806000.0,0.7825551072698185,0.4390075258141044,0.5609924741858956,,658806000.0,0.6710493180103512,16.257548222721926,Acute Care Hospitals,non-profit,1,NEWYORK-PRESBYTERIAN/BROOKLYN METHOD (330236)
45337,NEW YORK-PRESBYTERIAN/BROOKLYN METHOD (330236),General Short Term (Acute Care Hospitals),Voluntary Nonprofit-Other,-73.979141,40.668263,2348462.0,,-302395.0,,,,,28851462.0,2423731.0,,,,,127554.0,,NY,,,41906830.0,2404.0,,,,31328749.0,,Y,,,5467893.0,,,,,18732379.0,,KINGS,648579134.0,136.51,,,,934201.0,2017-12-31,788503.0,,,-1761281.0,,,,49753.0,,,,,734642.0,,,,,290843.0,,,,,139156.0,,23874077.0,1998644.0,,,,102816451.0,,,,13830.0,,35453626.0,,,,,28851462.0,,,,,,1241.0,,,,33S236,,,,,,,236.84,,26060.0,,6603317.0,,,379221.0,5454256.0,,,,,670872222.0,,,,,,Y,2833418.0,,,,,,,,10175708.0,,,,501793.0,,,3969584.0,6472308.0,,,,,,,4129235.0,,4975810.0,,9826963.0,,,,,,,,,401407.0,,,53977000.0,2123060.0,,484416.0,,,,,,,,2404.0,,,,,36496.0,4766809.0,,,,-270171.0,,150345.0,327449954.0,,,,638106.0,14718.0,16729668.0,,,3001297.0,,,547161.0,3467997.0,,35614,,,,3122000.0,,84.7,,,2665713.0,1207938.0,,2665587.0,,,,,7943.0,,,,,,,,18951000.0,22639.0,12.0,,,N,4536179.0,,18287383.0,,,,,,,645528000.0,,,,,,10451513.0,,,,,7482392.0,,,40332.0,,44.19,,,,,,506 SIXTH STREET,744338288.0,,,,,,,,,,,,,,,,,1516571.0,,,,,16405.0,,,,22119000.0,14332104.0,,,,,,-9078180.0,,,,,,29852.0,,274445.0,9749913.0,,,,,,,,,17628386.0,,,10713925.0,,,4614584.0,17877.0,44387.0,,1032153.0,98490.0,,,,,,,412682.0,,16632000.0,2024-01-18 00:00:00,,,47753.0,,55786.0,,8141173.0,,,16699010.0,,1665176.0,200655.0,288830.0,,,,,27962.0,,,68055.0,,,,,100806241.0,,-1185658.0,46981.0,,110.21,7828139.0,,2084549.0,,9488609.0,,,,89.67,11277878.0,,10556860.0,,139156.0,,,,128162.0,1219139.0,665023198.0,,,,,24100410.0,,,,21.5,,1330530.0,,,,,,3795486.0,,11176.0,-813043.0,7943.0,985459.0,,,2265692.0,,,50006740.0,2265692.0,,15396963.0,,,,,,2337577.0,,,,,60255.0,,68331877.0,,,,,,,8161.0,,,,8462512.0,,,,,24365028.0,-929929.0,,,,45060.0,,3784902.0,,,,,,,,,2536.0,,,,,,,,5253762.0,273390000.0,,,,,,,,3035.0,,,7633109.0,,,,,,,,,,41973568.0,3866974.0,,,,,,,372481.0,,,,44.17,,14351.0,4028533.0,,,,,611840.0,,,,,,,731.0,,,,764890700.0,,,,1710248.0,273040.0,,,8143859.0,293805071.0,,,,,58868000.0,,,23479398.0,,,,,,15950994.0,40823.0,,,37120.0,1043135.0,,16646628.0,,,,8789648.0,,,,,9578.0,,,,,,,,,,37.64,,,,,,,,,58576460.0,899763.0,,,,,,,,,,2501.0,,,1062.0,,,,,,,,,,,,,,,80633.0,,,16100203.0,2440.0,,,,,,,1098234.0,,28190.0,,,,,,,,,,,,,,607453086.0,,36.0,,-234023.0,2875869.0,,21958551.0,38809.0,2872074.0,,455403.0,310803326.0,434359.0,,,-623345.0,,,-174690.0,,,56806623.0,,,,3905774.0,,,6725631.0,3856063.0,,,,,,,,4095098.0,,,,300774.0,,36.7,,480089000.0,,1005240.0,,,513029.0,9826963.0,,104102.0,,,,1370.0,,,864844.0,18956318.0,,,13212.0,,,,524465000.0,,,8061744.0,,,,,,975.0,,15274167.0,20370.0,1627437954.0,,30127.0,193.0,,,5129578.0,7024242.0,24446492.0,2346.0,,,,,,,,44559.0,6133239.0,,,834467.0,12979.0,,,,10232377.0,,17627649.0,,6636936.0,,,-101792.0,132503.0,,,,,9942202.0,,,,,,,,,3178263.0,,,7112359.0,2029556.0,76967187.0,,,,,,,36531490.0,,,,,,,,,,1.0,,,242580.0,6073648.0,,607.0,416360.0,,,,12786.0,,,,1467580.0,,,,,,,,118166.0,,,120127892.0,,18250.0,,,5314691.0,3784902.0,,,,,9488609.0,,2268287.0,27962.0,,1009389.0,,148697.0,3794099.0,,,,734642.0,,,2480116.0,3093516.0,,101582000.0,,,,,,1009389.0,240.0,2860302.0,1010226.0,444547.0,277.77,,,,4748573.0,,102816451.0,,,,676923800.0,,,,,,,,,,,6952384.0,,69614.0,22664141.0,,,305529.0,,,12786.0,1467580.0,,,,,80648000.0,,3400954.0,,,,,,,,436.0,21615342.0,,22780.0,152367.0,,335342.0,223.0,,,38.46,,,8374557.0,,1109895.0,,,,,,2483654.0,88920.0,-94706.0,-31912342.0,,,15600.0,234431.0,,,,7395.0,,,,52368450.0,,,316755.0,,,29852.0,,,,45.53,,,,,,,,5210241.0,,3866974.0,,14332104.0,,,352775000.0,11150291.0,40773159.0,,2716578.0,,-110948.0,,,,,323374.0,15950994.0,,,68687162.0,,,11309968.0,22202439.0,5467893.0,10760.0,1009129.0,,,34341957.0,,,,,7900800.0,,,95767756.0,34341957.0,255163.0,5790.0,411408398.0,,6684321.0,985459.0,6636936.0,,,,,15359899.0,,,2591342.0,165710.0,,,,,,,317265.0,188340.0,,42838246.0,,,,,,76068723.0,,38.31,,,,,,215637973.0,,,,-928285.0,,,2825774.0,,,,,11309968.0,,4,,,,,54060070.0,14718.0,,441370976.0,,,4748321.0,,,11215,,9192728.0,7724.0,2010210.0,,309756065.0,,234376.0,,,,,2263692.0,101.38,863256.0,,,,,27980801.0,,,,,,,2832812.0,,,3336238.0,,,,,,,,,-11297000.0,,13714828.0,,,564116.0,,,,,14860593.0,,,7482392.0,-655437.0,11093501.0,,,,,,,,,,,2029556.0,,,1988922.0,762189,,21440905.0,135464.0,38.31,,,76078.0,,,,-3198.0,454.0,547161.0,139038248.0,,,2440.0,,,605332.0,92210063.0,,5567.0,5537912.0,,,,,,,166784085.0,,,117029.0,4505.0,,,,2128273.0,,10627747.0,NEW YORK-PRESBYTERIAN/BROOKLYN METHO,,25589940.0,,,16702938.0,1926647.0,,,74961.0,5938228.0,,27158.0,,33T236,N,,,,30027783.0,35549695.0,,,39040884.0,13001,5366926.0,,29299323.0,3896104.0,835374466.0,19560354.0,92783670.0,,,,,,,3125590.0,-2418954.0,,759459.0,,39040884.0,,,,,,411408398.0,,-1644.0,,,,,66925031.0,259435.0,,,113210.0,,91300264.0,1683537000.0,65261611.0,,,N,,,,,193.0,,,11375128.0,,,100355211.0,,13870.0,,204867.0,,,3761063.0,,,,,,,10342627.0,2689.0,,,11719887.0,,,6603317.0,,,,,,2269395.0,,2631139.0,,,20544272.0,,4344815.0,,957197.0,,100278274.0,,487935.0,,,259435.0,,6282366.0,66925031.0,,,173453.0,,,406643.0,,934201.0,,,,72617.0,22290122.0,16548324.0,64.31,,,810325.0,,,,,,842644.0,367763.0,,-174690.0,276.0,,11719887.0,4028533.0,,,49.95,,,,,,,306416.0,,,,1895639.0,,0.281697,4510812.0,,,5974798.0,,,359431432.0,,,43.95,,,24.8,5129578.0,,2409562.0,34749.0,,,,,179637600.0,,,,28869.0,,27567510.0,,N,,,111502282.0,,18287383.0,,18167647.0,,33008.0,120119000.0,16414238.0,303625.0,,-104524.0,,,,,2032613.0,13546472.0,,2714049.0,338894.0,,,-316231.0,63620460.0,,,,,,,,,,,,387.0,,,,,6080.0,BROOKLYN,2440.0,36.56,,2622609.0,,,-1185658.0,,4377338.0,P,,,3830185.0,2371776242.0,,27789217.0,,,8374557.0,330236,,2755602.0,6956706.0,,3086718.0,,4374732.0,400316.0,355432066.0,14310191.0,,,,,,,,1862064.0,,,,,17318506.0,60382875.0,,92260.0,,722252.0,,,164941541.0,,29052454.0,Y,,,,,2399920.0,,533190.0,,,,,403024.0,3844032.0,,,21163703.0,,8789648.0,,,,,,,,,40823.0,,,348031.0,11857000.0,,,,20185187.0,,14351.0,5410561.0,,33143906.0,8958.0,407899400.0,,104614479.0,1365688.0,-529552.0,19407.0,,,,,3093516.0,,,7746603.0,,-12035327.0,41382005.0,,2010210.0,180654000.0,,,3844032.0,,,,,,,,,30038.0,1185289.0,,24365028.0,,223199.0,,,,6558795.0,,,,35259.0,7097693.0,,,403415.0,,7090610.0,,,,,100806241.0,33008.0,,,,,,487935.0,788886.0,,,,,,,,,,,,364.0,,,6320241.0,,,,,,,,,6226777.0,,,45.56,,15646668.0,301000.0,474709000.0,38.0,,,,,,258834.0,,,,,,,,,9670580.0,,,,6480.0,591.0,4365269.0,20753360.0,85874000.0,424897655.0,92210000.0,,44613.0,,,,-45353.0,,,,33331,,,,6320241.0,17674800.0,,,,8796119.0,1342536.0,,,1.0,,412773.0,,,,,,,,129847.0,,891871.0,,3785569.0,,,,,,,23757.0,,,,8760.0,,,58576460.0,,,,,,3905774.0,,,,,255163.0,1455483.0,,,,94784.0,,28190.0,,,,,2683384.0,N,3633331.0,,,7589569.0,,,,36.0,,,,,3397738.0,25254071.0,516.0,,,,,28224.0,,,,,,169357000.0,,1627457954.0,,,,,,,1633590.0,,16445.0,21567870.0,,24042835.0,25.0,,,98490.0,,,,,,,12979.0,,,9166.0,,,,,576880.0,,,1951001.0,111247.0,259740.0,,2263895.0,,,,100257.0,,,,18307.0,,22664141.0,,,,,,,,,,,,,,General Short Term,,,,,330221.0,796803042.0,42937634.0,601965.0,168349607.0,,1276957.0,,41973568.0,,,,,,,6133239.0,,,,,,,,8376738.0,194085.0,,,,,-31912342.0,5054974.0,4945630.0,-45353.0,18727.0,1111157.0,6073648.0,492.0,Y,,92160.0,,109559.0,27803.0,Y,,,10937630.0,,,,5475.0,,3142372.0,18390.0,,,,,,,,18908637.0,2032613.0,,1039198.0,,4945630.0,,2.0,,,-968877.0,7287003.0,,4748321.0,,2368833.0,,,,,,,,30323612.0,19535200.0,,,,,,7633109.0,,,,33598.0,102760.0,,,34.99,9615393.0,,,,,F,,,,,10304373.0,,,22290122.0,,,,130785576.0,,134487.0,4096.3,,11150291.0,2563321.0,N,,,,,,,,M,,305034.0,18956318.0,,20672185.0,,,,,,,,59911.0,,2754709.0,,6162785.0,,12979.0,158355.0,,795288.0,454.0,,,,277.77,,9966.0,,196615000.0,,7240509.0,194.0,,,4863630.0,,,,,,842143000.0,,,-35569.0,3795486.0,,,,43.62,181344.0,,15256443.0,151927.0,1680027.0,21693255.0,,79459.0,,N,4026.0,43996068.0,,1046762.0,,,6741.0,,,52409734.0,1012304.0,,335342.0,,155.0,,,6556373.0,6472308.0,,,,50.0,,,13753.0,,,348031.0,,59342.0,,33,,2.0,,,,41271057.0,9769.0,204261.0,,,,50653.0,,2048.0,3525.0,,,4851428.0,,,,,,,,153162338.0,,117637963.0,,-304305.0,,,,,,,,,171405.0,3186138.0,,36256651.0,733319895.0,,,3483212.0,65.64,2799608.0,,,,,8788409.0,1320033.0,,,,,10539.0,N,,,2407713.0,7900800.0,,24.0,,28115128.0,638106.0,,12382941.0,,49387257.0,,,,109049761.0,3001297.0,671.0,21568601.0,1115473.0,,454.0,1905058.0,,,,1516571.0,2026000.0,6587000.0,,4105.0,292753000.0,,,,,,1039198.0,,,,,,,703172.0,,,,,,,104945.0,,367119.0,1837.0,,,,,,,1536401776.0,NEW YORK-PRESBYTERIAN/BROOKLYN METHO,,-3562766.0,,,,11277878.0,1097672.0,,,,703172.0,,9893.0,,,,11200438.0,,,,24405539.0,,,,,722801.0,,858135.0,,10981647.0,,,1366633.0,2703898.0,,,15698.0,,,,,3822317.0,,,,,,25254071.0,,,4344815.0,9942202.0,,,2799608.0,2981979.0,,8603023.0,,23583379.0,,1119.0,21286235.0,,,,,,,,,,3966597.0,,,,,,,,24.0,,,,7395.0,,,,,,,,,,10232377.0,,,,7024242.0,17449620.0,,40823.0,,,30588825.0,,,,,4457.0,,31.58,8374557.0,85874000.0,,,,16646628.0,,,,,,17834595.0,32451050.0,,,,,46.71,,,,,2830667.0,,,5808407.0,,,2830667.0,,,,,,,,154905.0,,,,,,,30180.0,Y,,3272836.0,,,,2736168.0,284571000.0,,3017233.0,11900602.0,,218360.0,18427708.0,,416360.0,,8519835.0,83444.0,,,6469201.0,17332567.0,,,,,,,,,,,,,,,,314.0,,,7823.0,,,60.02,670872222.0,,,5311493.0,,731339.0,,,,9125.0,6795568.0,,,,71034342.0,,,6228580.0,,,,,,97603.0,,,,,,7889942.0,,355432066.0,,89102988.0,,,,,,,3898.0,,5558780.0,,,,,,,,17332567.0,930058000.0,,,11176.0,,-813043.0,,35233464.0,,5600,168469.0,17945572.0,,,,,,,,,,,,3936.0,,1859079.0,92842526.0,,,30.99,20620728.0,335342.0,,785316.0,,,21330960.0,23796105.0,,,,,,1978.0,,36531490.0,,8796.0,,,,,,,-2480115.0,,,5001621.0,,,-234023.0,,,,,,,,N,,,,,,,,,,21615342.0,,,,,-11087421.0,14310191.0,,,,,457784.0,,108989211.0,,445802.0,,897723.0,3397738.0,5665188.0,,,2017-01-01 00:00:00,4863630.0,,,12146590.0,,,,5366926.0,,,,,,168349607.0,,,,3721711.0,,,62536.0,,,,,1483994.0,6946484.0,364027.0,1098234.0,7024242.0,21366877.0,6965118.0,,18287383.0,,,,,,,-3748795.0,,22.14,6458000.0,,9893.0,,1010079.0,,,4975810.0,,,,,3574960.0,,,,7673234.0,,7896718.0,11032.0,,,,,,,,,,,,,6480.0,815856000.0,204867.0,,92839907.0,57757000.0,,,,,-20566.0,,,Y,,,,7894460.0,,,,,,,2069515.0,127470.0,31746591.0,23962.0,,,,,4457.0,194085.0,,,6282366.0,4026.0,,,5220986.0,,55786.0,6741.0,,,1443.0,124203.0,38905727.0,16868.0,,,1837.0,16699010.0,,,,6336632.0,,6556000.0,,,,,103155.0,,,,,29052454.0,1633590.0,83230348.0,,,271736.0,,,,,,,,,,,193122.0,,,,,,8587.0,,,,1809940.0,,,4808834.0,,,,,,762965.0,,,530218.0,,,,,,,,502698.0,,2360777849.0,8374557.0,,,,,,,,38571424.0,15.0,,,13706794.0,,,,,,,,4748321.0,41906830.0,7792015.0,14860593.0,-5849024.0,,,,,,,1588572.0,,,,3125590.0,1229.0,,,10937630.0,,,,23178427.0,333574.0,,139156.0,,,,,,,35595.0,11093501.0,400316.0,,1311490.0,,,28804.0,,,,,172626.0,35453626.0,,,,,-2458886.0,4527.0,,,47303.0,2544784.0,27980801.0,142171.0,,16100203.0,2754709.0,2399920.0,,,,,,,,112769692.0,,,,,,,,,,,5974798.0,83230348.0,,,,22061311.0,,165710.0,92839907.0,168349607.0,,NEW YORK-PRESBYTERIAN/BROOKLYN METHO,,,8306613.0,4536179.0,,606.0,,,,,42402.0,,8161.0,7100681.0,,,,,,,3399631.0,,,4976477.0,2017,2017,16548324.0,181344.0,,0.012932145658148729,841394000.0,171117711.96694198,644584000.0,0.21625511354808397,38571424.0,0.046172615479487256,4.730351193957735,3.572163873560003,4.612913562037485,0.610935076164077,841394000.0,1.0008901893762019,0.5002224483334788,0.49977755166652116,,841394000.0,0.4962020234779515,14.463605554305106,Acute Care Hospitals,non-profit,1,NEW YORK-PRESBYTERIAN/BROOKLYN METHO (330236)
51426,NEW YORK-PRESBYTERIAN/BROOKLYN METHOD (330236),General Short Term (Acute Care Hospitals),Voluntary Nonprofit-Other,-73.979141,40.668263,1178300.0,,-106976.0,92.0,,,,26681644.0,2461491.0,,,,,37485.0,,NY,,,51310568.0,6374.0,,,3925.0,36569053.0,,Y,,,6660373.0,,,,,18268599.0,,,686338459.0,140.61,,,,1102996.0,2018-12-31,933926.0,,,-1483305.0,,,,42404.0,,,,,1140508.0,,,,,350568.0,,,,,141669.0,,25808343.0,1969753.0,,,,108475555.0,,,,16707.0,,30206100.0,,,,,26680993.0,,,,73.0,1.0,910.0,,,,33S236,,,,598.0,,,267.52,,32651.0,,7434339.0,,,484948.0,5139552.0,,,,,692805258.0,,,,,,Y,2832812.0,,,,,,,,11110837.0,,,,651171.0,,,3956010.0,6946663.0,,,,,,,4011752.0,,5396239.0,,10926015.0,,,,,,,,,256867.0,,,52155000.0,2175201.0,,648599.0,,,,,,,,708.0,,,,,48272.0,11857419.0,,,,-267082.0,,159315.0,337484473.0,,,,704613.0,14987.0,24856500.0,,,3278605.0,,,494198.0,4443205.0,,35614,,,,3193000.0,,89.23,,,2721423.0,662253.0,,2497773.0,,,,,7496.0,,4441.0,,,,,,17039000.0,20217.0,9.0,,,N,5513764.0,,20783544.0,,,,,,,649375000.0,,,,,,17424860.0,,,3140.0,,4512469.0,,,48426.0,,46.03,,,,,,506 SIXTH STREET,812291960.0,,,,,,,,,,,,,7064.0,,,,1317873.0,,,,,24841.0,,,,18460000.0,14265020.0,,58.0,,,,-9482882.0,,,,,,23634.0,,238224.0,11887633.0,,,,,,,,,18347495.0,,,11876450.0,,,4177807.0,15399.0,50254.0,,824227.0,112499.0,,,,,,,412682.0,5666.0,,2024-01-18 00:00:00,,,43639.0,,56776.0,,8285757.0,,,15538012.0,,1835816.0,211965.0,262125.0,,,,,30526.0,,,49140.0,,,,,106733405.0,,-1300384.0,45452.0,,116.57,6213176.0,,2049609.0,,11328856.0,,,,95.43,9069239.0,,12236716.0,,141669.0,,,,170933.0,1412245.0,680486582.0,,,,,27684252.0,,,,23.13,,2303322.0,,,,,,4556770.0,,10629.0,-510654.0,7496.0,1089667.0,,,2265391.0,,,52705597.0,2265391.0,,14568388.0,,,,,,5582855.0,,,,,61035.0,,102716418.0,,,,,,,6959.0,,,,9972732.0,,,,,26906288.0,-1047835.0,1882.0,,,42895.0,,4423135.0,,,,,,,,,2025.0,,,,,,,,5084903.0,377669000.0,,,,,,,,4282.0,,,7359788.0,,,,,,,,,,45070229.0,3278257.0,,,,,,,286113.0,,,,47.29,,12514.0,4545687.0,,,,,728997.0,,,,,,,1302.0,,,,783695347.0,,,,1516265.0,226817.0,,,8092536.0,300414497.0,,,,,53377000.0,,,24230391.0,,,,,,19879405.0,41737.0,,,53328.0,1183339.0,,20451041.0,,,,8338580.0,,,,,15052.0,,,,,,,,,,37.15,,,,,,,,,67116229.0,590968.0,15699.0,,,,,,,,,3461.0,,,1126.0,,,,,,,,,,,,,,,58645.0,,2.0,17933967.0,6406.0,,,,,,,1057107.0,,11962.0,,,,,,,,,,,,,,632210492.0,,32.0,,-228594.0,2736146.0,,21377133.0,38981.0,3363411.0,,306230.0,317033432.0,401581.0,,,-708020.0,,,-117340.0,,,57492362.0,,,,3887748.0,,,6699496.0,4192873.0,,,,,,,,4450693.0,,,,300774.0,,39.21,,360215000.0,,859606.0,,,495540.0,10926015.0,,140417.0,,,,2500.0,,,1497160.0,20791372.0,,,2581.0,,,,532044000.0,,,2270502.0,,,,,,1560.0,,15244752.0,49531.0,1717337727.0,,12659.0,212.0,,,4518794.0,7181722.0,22039590.0,,,,,,,,,55230.0,7396701.0,,,835537.0,8094.0,,,,11161290.0,,18217505.0,,5662964.0,,,169306.0,135015.0,,,,,10997424.0,,,,,,,,,2001816.0,,,9320020.0,1873250.0,81075386.0,,,,,,,40685294.0,,,,,,,,,,1.0,,,251160.0,5821481.0,,504.0,475605.0,,,,4750.0,,,,1884484.0,,,,,,,,40919.0,,,126782039.0,,18250.0,,,6472485.0,4423135.0,,,,,11328856.0,,2267619.0,30526.0,469.0,1058899.0,,173600.0,4960279.0,,,,1140508.0,,,2532507.0,4213259.0,15.0,119007000.0,,,,,,1058899.0,148.0,2723417.0,1566183.0,338244.0,282.97,,,,4409413.0,,108475555.0,,,,692941949.0,,,,,,,,,,,6756683.0,,121511.0,30566826.0,,,233062.0,,,7882.0,1884484.0,,,,,79876000.0,,3444438.0,,,,,,,,5077.0,23813500.0,,42662.0,123860.0,,387941.0,192.0,,,37.67,,,10631946.0,,1337057.0,,,,,,2360909.0,88530.0,-378706.0,-35333101.0,,,16770.0,418768.0,,,,7419.0,,,,55343534.0,,,328621.0,,,23634.0,,,,32.21,,,,,,,,3746415.0,,3278257.0,,14265020.0,,,349718000.0,13576093.0,42208150.0,,2855675.0,,-272789.0,,,,,,19879405.0,,,69943008.0,,,11674203.0,18778835.0,6660373.0,14532.0,1050186.0,,,28814397.0,,,,,7191770.0,,,99720763.0,28814397.0,206977.0,17991.0,497077531.0,,6717678.0,1089667.0,5662964.0,,,,,22818491.0,,,1930399.0,165710.0,,,,,,,315900.0,188340.0,,46947985.0,,,,,,92428981.0,,41.8,,,,,,283969850.0,,,,-1047041.0,,,2940320.0,,,,,11674203.0,,4,,,,,66773839.0,14987.0,,453786155.0,,,5316877.0,,,11215,,8615034.0,9927.0,1742150.0,,320293902.0,1174.0,272876.0,3050.0,,,,2402490.0,113.8,1168821.0,,,,,33042061.0,15699.0,,,,,1.0,2832812.0,,,3290237.0,,,,,,,,96.0,21266000.0,,9910575.0,,,586170.0,,,,,14722476.0,,,4512469.0,-631806.0,12620648.0,,,,,,,,,,,1873250.0,,,1253750.0,762190,,21179890.0,118152.0,41.8,,,117421.0,,,,,364.0,494198.0,135379782.0,,,6406.0,,,655735.0,92210063.0,,5962.0,5598390.0,,,,,,,169864144.0,,,159766.0,15648.0,,,,2291761.0,,8904170.0,NEW YORK-PRESBYTERIAN/BROOKLYN METHO,,27318527.0,,,15538782.0,2055501.0,,,29125.0,5976459.0,,23044.0,,33T236,N,,,,20658428.0,33654031.0,,,35204005.0,13001,5665978.0,,33975089.0,3766723.0,861755673.0,20188486.0,102862194.0,,,,,,,3845440.0,-2166993.0,,682020.0,,35204005.0,,,,785.0,,497077531.0,,-794.0,,,,,91658896.0,240442.0,,,108915.0,,86957704.0,1738818000.0,64884931.0,,,N,,,,,212.0,,,12343009.0,,,114429719.0,,13870.0,,,,,3725860.0,,,,,,,6600551.0,2359.0,,,12380948.0,,,7434339.0,,,,,104.0,2268055.0,,2690994.0,,,29927344.0,,4167990.0,,26585.0,,104391802.0,,353153.0,,,242324.0,,6665553.0,74865629.0,,,108223.0,,,371779.0,,1102996.0,,,,69108.0,22398760.0,24648313.0,64.11,,,830688.0,,1417.0,,,,768432.0,406290.0,,-360888.0,240.0,,12380948.0,4545687.0,,,41.19,,,,,,,287776.0,,,,1049367.0,,0.269017,3303345.0,,,7191838.0,,,369654220.0,,785.0,44.72,,,25.46,4518794.0,,2466329.0,10885.0,,,,,192625588.0,,,,26820.0,,32089090.0,,N,,,122772638.0,,20783544.0,,17673421.0,,32433.0,91072000.0,12952364.0,202402.0,,-378273.0,,,,,2110811.0,14879258.0,,2552923.0,386966.0,,,-2660148.0,68267941.0,,,,,,,15699.0,,,,,,,,,,6196.0,BROOKLYN,6406.0,36.68,,2135747.0,,,-1300384.0,,4059877.0,P,,,3273790.0,2529629687.0,,23095850.0,,,11236484.0,330236,,2833907.0,7971195.0,,3904815.0,,4484884.0,378069.0,365242293.0,15127714.0,,,,,,,,2086030.0,,-604538.0,,,19711756.0,61235049.0,,216198.0,,1282276.0,,,166134539.0,,27651651.0,Y,,,,,1279789.0,,600447.0,,,,,375408.0,2079710.0,,,21888443.0,,8338580.0,,,,,,462.0,,,41737.0,,,343377.0,21397000.0,,,,20608007.0,,12514.0,4997828.0,,37808864.0,24035.0,417959291.0,,109671676.0,1295771.0,-190868.0,20763.0,,,,,4213259.0,,,8720722.0,,-10395678.0,41999125.0,,1742150.0,61360000.0,,,2079710.0,,,,,,,,,28822.0,1287329.0,,26906288.0,,524427.0,,,,7704004.0,651.0,,,37576.0,7723693.0,,,770895.0,,9539966.0,,,,,106733405.0,32433.0,,,,,,353153.0,864678.0,,,,,,,,,,,,,,,6042117.0,,,,,,,,,6763394.0,,,46.3,,16478433.0,301000.0,354901000.0,38.0,,,,,,297261.0,,,,,,,,,11858601.0,,,,6522.0,591.0,4717775.0,24995937.0,129681244.0,434578226.0,92210000.0,,25667.0,,,,-39631.0,,,,33331,,,,6042117.0,20680660.0,15699.0,,,9488114.0,1418731.0,,,1.0,,731905.0,,,,,,,,129775.0,,1212957.0,,4426518.0,,,,,,,9781.0,,,,8760.0,,,67124622.0,,,,,,3887748.0,,,,,211418.0,1126215.0,,,,135132.0,,11962.0,,,,,2977357.0,N,3671137.0,,,8985249.0,,,,32.0,,,,,2021332.0,29572534.0,516.0,,,,,18058.0,,,,,29.0,82626000.0,,1717337727.0,,,,,,,1880385.0,476813.0,6879.0,21116557.0,,20934306.0,25.0,,,112499.0,,,,,,,8094.0,,,6442.0,,,,,1557038.0,,,2023393.0,79693.0,242385.0,,1795264.0,,,,89530.0,,,,29613.0,,30566826.0,,,,,,,,,,,,,,General Short Term,,,,,362036.0,819028448.0,46337253.0,598793.0,172223778.0,,699738.0,,45070229.0,,,,,3132.0,,7396701.0,,,,,,,,9166159.0,194778.0,,,,,-35333101.0,6175525.0,5396486.0,-39631.0,209009.0,1972732.0,5821481.0,531.0,Y,,129548.0,,109559.0,32407.0,Y,,,10262253.0,,,5518.0,5475.0,,3603668.0,11993.0,,,,,,,,18229718.0,2110811.0,,1045264.0,,5396486.0,,2.0,,,-1071788.0,6666053.0,,5316877.0,,2596423.0,,,,,,,,31422996.0,18602100.0,,2.0,,,,7359788.0,,,,34279.0,55954.0,,,36.11,11809007.0,,,,,F,,,,890.0,8904170.0,,,22398833.0,,,,39898775.0,,127104.0,4049.8,,13576093.0,2720835.0,N,,,,,,,,M,,279181.0,20791372.0,,23084450.0,,,,,,,,110652.0,,2833391.0,,8323876.0,,8094.0,143606.0,,868142.0,454.0,,,,282.97,,6750.0,,188601000.0,,7240509.0,197.0,,,4702342.0,,,,,,837976000.0,,,-10101.0,4556770.0,,,,44.53,208187.0,,9237527.0,144520.0,1717735.0,22079311.0,,114298.0,,N,4480.0,35289484.0,,1613210.0,,,7483.0,,,61276983.0,1479271.0,,387941.0,,283.0,,,6556373.0,6946663.0,,,2.0,50.0,,,21011.0,,,343377.0,,406979.0,,33,,2.0,,,,41726336.0,8298.0,,,,,35640.0,,435.0,3400.0,,,5559187.0,,,,,,,,150358246.0,,124061100.0,,-334620.0,,,,,,,,,142322.0,3188902.0,,36449116.0,812191960.0,,,3588381.0,67.16,2690994.0,,,,,9746107.0,1460861.0,,,,,1688.0,N,,,2844856.0,7191770.0,,24.0,,30905785.0,704613.0,,11625854.0,,50738836.0,,,,107841850.0,3278605.0,542.0,21117859.0,,,454.0,2337162.0,,13.0,,1317873.0,1966000.0,6587000.0,,7935.0,299657000.0,,,,,,1045264.0,,,,,,,261067.0,,,,,,,115301.0,,138172.0,1531.0,,,,,,,1667874014.0,NEW YORK-PRESBYTERIAN/BROOKLYN METHO,,-6221539.0,,5.0,,9069239.0,1157147.0,,,,261067.0,,8369.0,,,,11982121.0,,,,21566112.0,,476813.0,,,310095.0,,842715.0,,10649277.0,,,1495516.0,2496465.0,,,16663.0,,,,,4422085.0,,,,,,29572534.0,,,4167990.0,10997424.0,,,2690994.0,2450168.0,,8690205.0,,23607975.0,,14754.0,21085014.0,,,,,,,,,,4342002.0,,,120.0,,,,,80.0,,753.0,,7419.0,,,,,,,,,,11161290.0,,,,7181722.0,19011291.0,,41737.0,,,25786844.0,,,,,4037.0,,33.37,11236484.0,129681244.0,,,,20451041.0,,,,,,16591436.0,28152828.0,,,,,51.61,,,,,1826012.0,,,5065633.0,,,1826012.0,,,,,,,,,,,,,,,29809.0,Y,,3229483.0,,,,2744037.0,387287000.0,,3931478.0,12455367.0,,212402.0,22189043.0,,475605.0,,4106622.0,47286.0,,,8611652.0,15270703.0,,,,,,,,,,,,,,,,327.0,,,74459.0,15699.0,,61.49,692805258.0,,,6472485.0,,694673.0,,,,9125.0,6797371.0,,,,70487370.0,,,5459859.0,,,,,,75823.0,,,,,,7983053.0,,365242293.0,,99350240.0,,,,,,,5037.0,,5517825.0,,,,,,,,15270703.0,1000934000.0,,,10629.0,,-510654.0,,30993883.0,,5600,,19553373.0,,,,,,,,,,,,3875.3,,1687010.0,112240220.0,,,32.01,20898277.0,387941.0,,921026.0,,,15270877.0,27349632.0,,,,,,1646.0,,40685294.0,,8836.0,,,,90.0,,,-2518999.0,,,6727168.0,,,-228594.0,,,,,,,,N,,,,,,,,,,23813500.0,,,,,-8665081.0,15127714.0,,,,,435138.0,,114156560.0,,447975.0,,643466.0,2021332.0,5749642.0,,,2018-01-01 00:00:00,4702342.0,,,12808648.0,,,,5665978.0,,,,,,172223778.0,,,,5413780.0,,,58235.0,,,,,844970.0,7065026.0,306406.0,1057107.0,7181722.0,14354725.0,7280594.0,15699.0,20783544.0,,,,,,,-2936292.0,,22.73,,,8369.0,,1370977.0,,,5396239.0,,,,,4165516.0,651.0,,,6213176.0,,8036001.0,4328.0,,,,,,,,,,,,,6522.0,877216000.0,,,94423480.0,79096000.0,,,,,-21918.0,,,Y,,,,8095350.0,,,,,,,1939620.0,194080.0,26556608.0,20994.0,,,,,4037.0,194778.0,,,6665553.0,4480.0,1.0,,4157514.0,,56776.0,7483.0,,,,3772849.0,38400083.0,48691.0,,,1531.0,15538012.0,,,,5726283.0,,6556000.0,,,,,112905.0,,,,,27651651.0,1880385.0,105632754.0,,,398469.0,,,,,,,,,,,117421.0,,,,,,,,,,1101979.0,,,3489548.0,,,,,,693948.0,,,1305274.0,,,,,,,,761453.0,,2529529687.0,11236484.0,,,,,,,,42727225.0,15.0,,,13163792.0,,,,,,,,5317090.0,51310568.0,7945461.0,14722476.0,-12318676.0,,,,,,,1321589.0,,,,3845440.0,,,,10262253.0,,,,24824282.0,574188.0,,141669.0,,,,,,,34336.0,12620648.0,378069.0,,1380883.0,,,22307.0,,,,,172308.0,30206100.0,,,,,-1590005.0,21347.0,,,48259.0,2147700.0,33042061.0,196247.0,,17933967.0,2833391.0,1279789.0,,,,,,,,120821084.0,,,,,,,,,,,7191838.0,105632754.0,,,,21433738.0,,165710.0,94423480.0,172223778.0,,NEW YORK-PRESBYTERIAN/BROOKLYN METHO,,,9212800.0,5513764.0,,,,,,,32925.0,,6959.0,7193283.0,,,,,,,2023904.0,,,5397009.0,2018,2018,24648313.0,208187.0,,0.01087162481564987,900842000.0,170075369.926364,623116000.0,0.07120347671909089,42727225.0,0.049581599911324284,5.307151075551031,3.7232676390899306,,0.48288185110365267,900842000.0,0.9302141774029186,0.48192277742696477,0.5180772225730352,,900842000.0,0.4955985462538345,10.895060091534338,Acute Care Hospitals,non-profit,1,NEW YORK-PRESBYTERIAN/BROOKLYN METHO (330236)
56923,NEW YORK-PRESBYTERIAN/BROOKLYN METHOD (330236),General Short Term (Acute Care Hospitals),Voluntary Nonprofit-Other,-73.979141,40.668263,2998594.0,,-187955.0,,,,,28428705.0,2344348.0,,,,,102154.0,,NY,,,43216476.0,3204.0,,,,41992085.0,,Y,,,2690340.0,,,,,15834073.0,,KINGS,708847806.0,165.53,,,,1254596.0,2019-12-31,1052433.0,,,-1014950.0,,,,68078.0,,,,,1170177.0,,,,,365120.0,,,,,139849.0,,28406009.0,1861614.0,,,,113957615.0,,,,29349.0,,34844772.0,,,,,28412882.0,,,,-71.0,,572.0,,,,33S236,,,,186.0,,,284.0,,31307.0,,5620743.0,,,881247.0,5024968.0,,,,,707393710.0,,,100283.0,,,Y,2832812.0,,,,,,,,13188860.0,,,,1118375.0,,,4272089.0,5921933.0,,,,,,,3363503.0,,5509941.0,,10865189.0,,,,,,,,,572953.0,,,55911000.0,1536705.0,,485026.0,,,,,,,,1592.0,,,,,117902.0,21397385.0,,,,-178529.0,,160251.0,351069724.0,,,,560512.0,11748.0,32861529.0,,,2884979.0,,,596099.0,2505102.0,,35614,,,,862000.0,,92.59,,,3071828.0,406573.0,,1590702.0,,,,,6875.0,,,,,,,,20161000.0,20071.0,13.0,,,N,6430007.0,,20590405.0,,,,,,,705374000.0,,,,,,13250238.0,,,,,973175.0,,,46320.0,,47.84,,,,,,506 SIXTH STREET,947781381.0,,,,,,,,,,,,,234035.0,,,,1625491.0,,,,,9205.0,,,,115015000.0,15617534.0,,23458.0,,,,-10307944.0,,,,,,4032.0,,237393.0,10063313.0,,,,,,,,,17110923.0,,,12152583.0,,,4277890.0,12200.0,48627.0,,488174.0,105416.0,,,,,,,412682.0,1612.0,,2023-12-08 00:00:00,,,39327.0,,52411.0,,8668335.0,,,16815938.0,,2534984.0,209820.0,252807.0,,,,,117537.0,,,59735.0,,,,,111700192.0,,-1287700.0,45592.0,,106.79,6612523.0,,1810965.0,,13232037.0,,,,70.0,5357689.0,,12305279.0,,139849.0,,,,112250.0,1382956.0,694795831.0,,,,,28267513.0,,,,23.83,,1899016.0,,,,,,4384514.0,,10467.0,-1769684.0,6875.0,217707.0,,,2604715.0,,,49330513.0,2604715.0,,14094587.0,,,,,,4380732.0,,,,,68250.0,,152735409.0,,,,,,,6786.0,,,,9546927.0,1669.0,,,,28431108.0,-1207665.0,,,,34647.0,,4115944.0,,,,,,,,,1189.0,,,,,,,,5945170.0,518225000.0,,,,,,,,3744.0,,,7686837.0,,,,,,,,,,46511989.0,3052944.0,,,,,,,291253.0,443620.0,,,49.23,,11088.0,6409325.0,,,,,649759.0,,,,,,,4160.0,,,,788617369.0,,,,1814267.0,183790.0,,,7877501.0,313332820.0,,,,,49725000.0,,,27473913.0,,,,,,20976445.0,40309.0,,,39811.0,1325544.0,130524.0,21816351.0,,,,9305309.0,,,,,5335.0,,,,,,,,,,38.19,,,,,,,,,69996111.0,602224.0,234035.0,,,,,,,,,6536.0,,,1032.0,,,,,,,,,,,,,,,81103.0,,,20123029.0,3379.0,,,,,,,2145698.0,,18018.0,,,,,,,,,,,,,,665978215.0,,175.0,,-84269.0,2725745.0,,21950782.0,38109.0,3202887.0,,274781.0,329253373.0,381445.0,,,-707290.0,,,-61064.0,,,51300692.0,,,,4124070.0,,,6708615.0,3190072.0,,,,,,,,3995070.0,,,,300774.0,,37.49,,525465000.0,,197417.0,,,490752.0,10865189.0,,153289.0,,,,985.0,,,1234361.0,20905090.0,,,11319.0,,,,382278000.0,,,2559238.0,,,,,,780.0,,16211098.0,110548.0,1712968048.0,,11450.0,936.0,,,4901409.0,7448296.0,16682948.0,,,,,,,,,328918.0,7297483.0,,,777234.0,10024.0,,,,12439782.0,,19258140.0,,6567908.0,,,1633.0,112797.0,,,,,11914114.0,,,,,,,,,2296053.0,,,7151319.0,2116327.0,78650541.0,,,,,,,43140611.0,,,,,,,,,,1.0,,,246870.0,7160268.0,,496.0,509145.0,,,,8512.0,,,,1512478.0,,,,,,,,233940.0,,,139442730.0,,18250.0,,,6020673.0,4115944.0,,,,,13232037.0,,2606779.0,117537.0,15823.0,1648063.0,,194819.0,6753905.0,,,,1170177.0,,,2596119.0,5423387.0,348.0,132257000.0,,,,,,1648063.0,222.0,2640158.0,1285195.0,245271.0,281.21,,,,4221419.0,,113957615.0,,,,705635567.0,,,,,,,,,,,6776552.0,,137587.0,30334040.0,,,207188.0,,,9088.0,1512478.0,,,,,86889000.0,,3610929.0,,,,,,,,3859.0,26282299.0,,34100.0,93527.0,,469430.0,254.0,,,38.19,,,13058632.0,,1065754.0,,,,,,4102739.0,94965.0,-238395.0,-35860140.0,,,19695.0,389952.0,,,,7335.0,,,,56005430.0,,,345584.0,,,4032.0,,,,62.34,,,,,,,,3821589.0,,3052944.0,,15617534.0,,,341135000.0,8415199.0,38084851.0,,3369877.0,,-507973.0,,,,,,20976445.0,,,72695326.0,,,11168703.0,23236643.0,2690340.0,19424.0,1128845.0,,,26856497.0,,,,,8481821.0,,,105328459.0,26856497.0,171590.0,6227.0,626758775.0,,6803422.0,217707.0,6567908.0,,,,,12583225.0,,,3777556.0,165710.0,,,,,,,319995.0,188340.0,,49480923.0,,,,,,147412545.0,,41.2,,,,,,386686268.0,,,,-1206198.0,,,3111433.0,,,,,11168703.0,,2,,,,,67031741.0,11748.0,,446298764.0,,,5878077.0,,,11215,,8768103.0,8695.0,2257423.0,,334309265.0,,339430.0,501.0,,,,1242505.0,132.65,1168821.0,,,,,36716130.0,234035.0,,,,,,2832812.0,,,3277427.0,,,,,,,,,-93188000.0,,10721897.0,,,601575.0,,,,,15139949.0,,,973175.0,-201950.0,14103313.0,,,,,,,,,,,2116327.0,,,1186802.0,757937,,21920768.0,302052.0,41.2,,,,,,,-214059.0,326.0,596099.0,135209126.0,,,3379.0,,,523967.0,92210063.0,,5567.0,4882939.0,,,,,,,167122115.0,,,149676.0,4121.0,,,,1505826.0,,9492053.0,NEW YORK-PRESBYTERIAN/BROOKLYN METHO,,27360037.0,,,16816651.0,1178127.0,,,58743.0,5208669.0,,41466.0,,33T236,N,,,,16249848.0,39743053.0,,,33296974.0,13001,5601878.0,,32648782.0,3930636.0,848145694.0,21054756.0,80995727.0,,,,,,,3817569.0,-2427894.0,,703534.0,,33296974.0,,,,,,626758775.0,,-1467.0,,,,,102100007.0,201595.0,,,103096.0,,96536042.0,1963562000.0,65960051.0,,,N,,,,,936.0,,,12690140.0,,,129044350.0,,13870.0,,,,,3848420.0,,,,,,,5222438.0,1051.0,,,13055443.0,,,5620743.0,,,,,,2359914.0,100283.0,2879530.0,,,31183284.0,,4909851.0,,25155.0,,112902614.0,,473180.0,,,201595.0,,6929974.0,70827796.0,,,163104.0,,,387411.0,,1254596.0,,,,64067.0,22960662.0,32580722.0,66.53,,,500112.0,,15155.0,,,,723546.0,310563.0,,-295962.0,198.0,,13055443.0,6409325.0,,,49.46,,,,,,,247187.0,,,,1695003.0,,0.261128,5440760.0,,,8421396.0,,,382172547.0,,,46.06,,,26.26,4901409.0,,2708158.0,29887.0,,,,,195439141.0,,,,20492.0,,31928779.0,,N,,,134538934.0,,20590405.0,,18247961.0,,30330.0,74078000.0,13148109.0,153177.0,,-378026.0,,,,,1977351.0,16665230.0,,1426110.0,338440.0,,,-2019749.0,56343761.0,,,,,,,234035.0,,,,,921.0,,,,,5223.0,BROOKLYN,3379.0,33.85,,1735918.0,,,-1287700.0,,4183977.0,P,,,4178888.0,2660749429.0,,25322920.0,,,13561339.0,330236,,3154278.0,7637623.0,,4236243.0,,4489553.0,325730.0,378178745.0,13304232.0,,,,,,,,1843602.0,,-502707.0,,,18663752.0,63441818.0,,269667.0,,1105861.0,,,174554594.0,,27304680.0,Y,,,,,260888.0,,420439.0,,,,,362127.0,1987547.0,,,23100955.0,,9305309.0,,,,,,15155.0,,,40309.0,,,539652.0,21806000.0,,,,22913201.0,,11088.0,4244793.0,,46009638.0,14605.0,432648124.0,,111269826.0,1336296.0,,77878.0,,,,,5423387.0,,,7975012.0,,-5615500.0,47445983.0,,2257423.0,160837000.0,,,1987547.0,,,,,,,,,63391.0,1547338.0,,28431108.0,,536315.0,,,,9216934.0,15823.0,,,37047.0,8434966.0,,,137061.0,,408586.0,,,,,111700192.0,30330.0,,,,,,473180.0,977846.0,,,,,,,,,,,,,,,5960254.0,,,,,,,,,8015248.0,,,47.3,,9394090.0,301000.0,310801000.0,38.0,,,,,,180138.0,,,,,,,,,3726158.0,,,,5698.0,591.0,4173599.0,32101995.0,166394233.0,448568677.0,92210000.0,,37638.0,,,,-43623.0,,,,33331,,,,5960254.0,17526201.0,234035.0,,,10153427.0,1437813.0,,,1.0,,164742.0,,,,,,,,124588.0,,1740531.0,,4610515.0,,,,,,,19749.0,,,,8760.0,,,70003856.0,,,,,,4124070.0,,,,,171590.0,1135433.0,,,,59750.0,,18018.0,,,,,3269191.0,N,3869023.0,,,8252529.0,,,,175.0,,,,,8240270.0,22572987.0,516.0,,,,,158673.0,,,,,11094.0,67649000.0,,1712968047.0,,,,,,,2115705.0,2217251.0,6974.0,21854730.0,,22303191.0,25.0,,,105416.0,,,,,,,10024.0,,,7128.0,,,,,2033597.0,,,2145205.0,40391.0,252771.0,,1867206.0,,,,78627.0,,,,19850.0,,30334040.0,,,,,,,,,,,,,,General Short Term,,,,,338005.0,824477509.0,43190081.0,615823.0,180883774.0,,470735.0,,46511989.0,,,,,576.0,,7297483.0,,,,,,,,8667397.0,186873.0,,,,,-35860140.0,6454826.0,6104719.0,-43623.0,,1701324.0,7160268.0,546.0,Y,,154355.0,,109559.0,26488.0,Y,,,12476400.0,,,1402.0,5475.0,,3264747.0,,,,,,,,,19728966.0,1977351.0,,1055065.0,,6104719.0,,2.0,,,-1926653.0,7881301.0,,5878077.0,,2166226.0,,,,,,,,34003498.0,13478850.0,,,,,,7686837.0,,,,35766.0,208613.0,,,36.37,6132066.0,,,,,F,,,,246.0,9492053.0,,,22960591.0,,,,43980815.0,,107488.0,3990.8,,8415199.0,2673982.0,N,,,,,,,,N,,249910.0,20905090.0,,21530614.0,,,,,,,,78886.0,,3153800.0,,8432223.0,,10024.0,141107.0,,745334.0,454.0,,,,281.21,,7110.0,,193387000.0,,7240509.0,101.0,,,5517934.0,,,,,,898761000.0,,,-1487.0,4384514.0,,,,45.72,280807.0,,7742794.0,138677.0,1510859.0,22971512.0,,59976.0,,N,3618.0,35256301.0,,1574881.0,,,6846.0,,,59729295.0,1344159.0,,469430.0,,109.0,,,6556373.0,5921933.0,,,,50.0,,,9240.0,,,539652.0,,484433.0,,33,,2.0,,,,46938010.0,999.0,,,,,48804.0,,1438.0,3363.0,,,7000955.0,,,,,,,,148606238.0,,128930244.0,,-331308.0,,,,,,,,,193914.0,3553474.0,,46728324.0,947781382.0,,,4234652.0,69.06,2879530.0,,,,,12256776.0,1841615.0,,,,,6645.0,N,,,3215008.0,8481821.0,,24.0,,35791020.0,560512.0,,10908775.0,,52136467.0,,,,111013516.0,2884979.0,525.0,21858890.0,,,454.0,2304396.0,,348.0,,1625491.0,213747000.0,6587000.0,,4373.0,364239000.0,,,,,,1055065.0,,,,,,,846307.0,,,,,,,100622.0,,484505.0,1246.0,,,,,,,1812603735.0,NEW YORK-PRESBYTERIAN/BROOKLYN METHO,,-6504880.0,,5.0,,5357689.0,963903.0,,,,846307.0,,8133.0,,,,12394178.0,,,,22505141.0,,2217251.0,,,371695.0,,745101.0,,10872706.0,,,1828145.0,2327581.0,,,25926.0,,,,,3754188.0,,,,,,22572987.0,,,4909851.0,11914114.0,,,2879530.0,2589917.0,,8238852.0,,23302953.0,,6895.0,21519890.0,,,,,,,,30198.0,,5867686.0,,,,,,,,6.0,,,,7335.0,,,,,,,,,,12439782.0,,,,7448296.0,20542484.0,,40309.0,,,28202450.0,,,,,2786.0,,36.75,13561339.0,166394233.0,,,,21816351.0,,,,,,16502365.0,33342894.0,,,,,58.12,,,,,1944441.0,,,5900526.0,,,1944441.0,,,,,,,,,,,,,,,44308.0,Y,,3580362.0,,,,3173015.0,540022000.0,,3178000.0,10839736.0,,226132.0,24559426.0,,509145.0,,5986336.0,13903.0,,,8679410.0,14249237.0,,,,,,,,,,,,,,,,298.0,,,77776.0,234035.0,,63.22,707393710.0,,,5806614.0,,657705.0,,,,9125.0,6843813.0,,,,68416559.0,,,8692990.0,,,,,,70476.0,,,,,,8080579.0,,378178745.0,,116775100.0,,,,,,,15596.0,,5402994.0,,,1263.0,,,,,14249237.0,919872000.0,,,10467.0,,-1769684.0,,37723304.0,,5600,,11198472.0,,,,,,,,,,,,3804.0,,1616391.0,132913692.0,,,33.22,22376475.0,469430.0,,1090734.0,,,14389907.0,27936205.0,,,,,,1601.0,,43140611.0,,5668.0,,,,,,,-2596119.0,,,7166932.0,,,-84269.0,,,,,,,,N,,,,,,,,,,26282299.0,,,,,-3284196.0,13304232.0,,,,,428227.0,,115759379.0,,459213.0,,277277.0,8240270.0,5024879.0,,,2019-01-01 00:00:00,5517934.0,,,12895085.0,,,,5601878.0,,,,,,180883774.0,,,,7163062.0,,,43786.0,,,,,2476872.0,5969594.0,273343.0,2145698.0,7448296.0,13354705.0,7771369.0,234035.0,20590405.0,,,,,,,-6632250.0,,23.28,,,8133.0,,1049932.0,,,5509941.0,,,,,4587965.0,15823.0,,,6612523.0,,8211010.0,4587.0,,,,,,,,,,,,,5698.0,1038053000.0,,,105364247.0,87243000.0,,,,,-20330.0,,,Y,,,,8501575.0,,,,,,,1944474.0,97344.0,24769483.0,22858.0,,,,,2786.0,186873.0,,,6929974.0,3618.0,,,2912266.0,,52411.0,6846.0,,,3572.0,3693695.0,39805813.0,30882.0,,,1246.0,16815938.0,,,,5607724.0,,6556000.0,,,,,122980.0,,,,,27304680.0,2115705.0,107146596.0,,,389349.0,,,,,,,,,,,329438.0,,2417082.0,,,,,,,,770817.0,,,3248636.0,,,,,,724232.0,,,162700.0,,,,,,,,832308.0,,2660749429.0,13561339.0,,,,,,,,23668185.0,15.0,,,13011164.0,,,,,,,,5889267.0,43216476.0,6335686.0,15139949.0,-12597879.0,,,,,,,1382386.0,,,,3817569.0,,,,12476400.0,,,,29662562.0,646522.0,,139849.0,,,,,,,34250.0,14103313.0,325730.0,,1379834.0,,,53603.0,,,,,168279.0,34844772.0,,,,,-5194299.0,,,,46007.0,1373902.0,36716130.0,120285.0,,20123029.0,3153800.0,260888.0,,,,,,,,112953586.0,,,,,,,,,,,8421396.0,107146596.0,,,5.0,22175218.0,,165710.0,105364247.0,180883774.0,,NEW YORK-PRESBYTERIAN/BROOKLYN METHO,,,7608041.0,6430007.0,,,,,,,28568.0,,6786.0,7312567.0,,,,,,,2954584.0,,,5510654.0,2019,2019,32580722.0,280807.0,,0.011512810108686664,1064801000.0,173905559.32652003,456356000.0,0.18963369281693246,23668185.0,0.027905801052148006,4.756638243522056,2.8109386877091014,,0.3830557379761825,1064801000.0,0.8440647595184453,0.4577196951254913,0.5422803048745086,,1064801000.0,0.4319424056892525,9.72164751326754,Acute Care Hospitals,non-profit,1,NEW YORK-PRESBYTERIAN/BROOKLYN METHO (330236)
63086,NEW YORK-PRESBYTERIAN/BROOKLYN METHOD (330236),General Short Term (Acute Care Hospitals),Voluntary Nonprofit-Other,-73.979141,40.668263,3265636.0,,-1608137.0,,,,,24703796.0,2670178.0,,,,,175130.0,,NY,,,39880084.0,2203.0,,,,43923230.0,,Y,,,4450002.0,,,,,11263505.0,,KINGS,648713069.0,235.67,,,,971910.0,2020-12-31,767866.0,,,-967550.0,,,,143111.0,,,,,1122672.0,,,,,318352.0,,,,,121920.0,,19536235.0,376470.0,,,,117101866.0,,,,21850.0,,36567364.0,,,,,24694301.0,,,,,,,,,,33S236,,,,593.0,,,276.81,,46784.0,,4781549.0,,,970489.0,4886044.0,,,,,755754350.0,,,,,,Y,2832812.0,,,,,,,,12689309.0,,,,1032278.0,,,6609314.0,6993769.0,,,,,,,3195179.0,,5811833.0,,11792574.0,,,,,,,,,606270.0,,,66337000.0,1665892.0,,422482.0,,,,,,,,2149.0,,,,,12674.0,21805971.0,,,,-243184.0,,146211.0,373514381.0,,,,518489.0,3781.0,50646077.0,,,2924808.0,,,534081.0,2761066.0,,35614,,,,9171000.0,,95.24,,,3017426.0,793906.0,,1589312.0,,,,,7165.0,,,,,,,,26073000.0,21195.0,9.0,,,N,5252501.0,,7974617.0,,,,,,,774564000.0,,,,,,24218711.0,,,,,1574799.0,,,57989.0,,50.82,,,,,,506 SIXTH STREET,823070051.0,,,,,,,,,,,,,187112.0,,,,1366676.0,,,,,,,,,462996000.0,17134533.0,,,,,,-25965787.0,,,,,,23616.0,,232368.0,8801256.0,,,,,,,,,25349036.0,,,13308227.0,,,3876799.0,2478.0,76223.0,,535512.0,166592.0,,,,,,,89370.0,,,2024-04-15 00:00:00,,,39065.0,,45324.0,,9812422.0,,,18729314.0,,1631033.0,202025.0,278268.0,,,,,111463.0,,,65733.0,,,,,115765382.0,,-754917.0,64717.0,,249.43,7281798.0,,1527979.0,,12595925.0,,,,78.68,14623972.0,,13925482.0,,121920.0,,,,117640.0,1536019.0,740563586.0,,,,,35422407.0,,,,24.63,,1169617.0,,,,,,13049173.0,,8001.0,-2729958.0,7165.0,286722.0,,,2856749.0,,,57125403.0,2856749.0,,27507395.0,,,,,,4564157.0,,,,,68729.0,,115803442.0,,,,,,,6791.0,,,,3343985.0,,,,,28400958.0,-1226204.0,,,,59696.0,,4234134.0,,,,,,,,,265.0,,,,,,,,6219363.0,616085000.0,,,,,,,,2681.0,,,12133184.0,,,,,,,,,,46635826.0,2917095.0,,,,,,,126619.0,306403.0,,,54.44,,14687.0,5421937.0,,,,,631335.0,,,,,,,,,,,845827964.0,,,,1786711.0,63159.0,,,5811611.0,343875468.0,,,,,83870000.0,,,29127275.0,,,,,,13968402.0,35282.0,,,69155.0,1328897.0,125005.0,15168748.0,,,,8349762.0,,,,,,,,,,,,,,,41.61,,,,,,,,,74425552.0,463659.0,187112.0,,,,,,,,,761.0,,,253.0,,,,,,,,,,,,,,,77015.0,,,16038420.0,2307.0,,,,,,,2464330.0,,27585.0,,,,,,,,,,,,,,628630649.0,,104.0,,-346962.0,2438619.0,,16235381.0,33371.0,2930222.0,,276761.0,358345633.0,432294.0,,,-781270.0,,,-23804.0,,,48170251.0,,,,2893395.0,,,7545958.0,3862323.0,,,,,,,,4262661.0,,,,300774.0,,44.61,,535784000.0,,211342.0,,,654059.0,11792574.0,,184783.0,,,,,,,760252.0,22572256.0,,,23041.0,,,,406522000.0,,,3318347.0,,,,54.0,,858.0,,17863017.0,104912.0,1649862764.0,,,514.0,,,2859710.0,7740401.0,15451693.0,,,,,,,,,405476.0,9281414.0,,,806114.0,11568.0,,,,9060394.0,,20546595.0,,4311785.0,,,74931.0,113178.0,,,,,10418247.0,,,,,,,,,1307014.0,,,5972422.0,1950086.0,101178034.0,,,,,,,35778102.0,,,,,,,,,,2.0,,,244464.0,6957050.0,,435.0,336019.0,,,,10607.0,,,,2395887.0,,,,,,,,249601.0,,,147448359.0,,18300.0,,,7247115.0,4234134.0,,,,,12595925.0,,2860011.0,111463.0,9495.0,1456146.0,,242458.0,5388086.0,,,,1122672.0,,,2860425.0,4724309.0,66.0,152618000.0,,,,,,1456146.0,114.0,2376201.0,1395335.0,519799.0,287.87,,,,4564851.0,,117101866.0,,,,753651734.0,,,,,,,,,,,7655731.0,,27277.0,26535611.0,,,234219.0,,,11054.0,2395887.0,,,,,96658000.0,,3159725.0,,,,,,,,1309.0,20518942.0,,10649.0,157339.0,,519460.0,235.0,,,41.37,,,11597768.0,,1578063.0,,,,,,4467153.0,91695.0,-1595996.0,-53731336.0,,,21087.0,394063.0,,,,5748.0,,,,53145404.0,,,307256.0,,,23616.0,,,,88.84,,,,,,,,5375486.0,,2917095.0,,17134533.0,,,319418000.0,11369010.0,40088678.0,,3712557.0,,-1390825.0,,,,,,13968402.0,,,83000789.0,,,10813565.0,25902882.0,4450002.0,18083.0,1192759.0,,,23660944.0,89.0,,,,7084853.0,,,97023750.0,23660944.0,60681.0,2745.0,793153008.0,,6917634.0,286722.0,4311785.0,,,,,13186688.0,,,4162180.0,166164.0,,,,,,,305499.0,188856.0,,45088610.0,,,,,,141390908.0,,41.57,,,,,,539421677.0,,,,-1225749.0,,,2645038.0,,,,,10813565.0,,5,,,,,50695202.0,3781.0,,493735634.0,,,5352684.0,,,11215,,10035674.0,9642.0,1336484.0,,357843870.0,,476827.0,5549.0,,,,699552.0,193.99,,,,,,39739765.0,187112.0,,,,,,2832812.0,,,2605718.0,,,,,,,,,-58945000.0,,11376118.0,,,609570.0,,,,,15971553.0,,,1574799.0,-332778.0,11164770.0,,,,,,,,,,,1950086.0,,,1689028.0,769294,,16977932.0,211304.0,41.57,,,,,,,-194982.0,390.0,534081.0,128275271.0,,,2307.0,,,449188.0,92210063.0,,4822.0,1292897.0,,,,,,,155405816.0,,,445360.0,2272.0,,,,2846849.0,,11965162.0,NEW YORK-PRESBYTERIAN/BROOKLYN METHO,,28444700.0,,,18760889.0,1789309.0,,,103044.0,1367589.0,,86359.0,,33T236,N,,,,18343163.0,41502112.0,,,61395332.0,13001,4947266.0,,38253972.0,2784405.0,756699094.0,24025276.0,83474420.0,,,,,,,2721372.0,-2613153.0,,932061.0,,61395332.0,,,,,,793153008.0,,-455.0,,,,,82829804.0,199107.0,,,120919.0,,86319944.0,2174122000.0,73359141.0,,,N,,,,,514.0,,,11779683.0,,,148254982.0,,13908.0,,3858828.0,,,2778210.0,,,,,,,3247522.0,453.0,,,12439592.0,,,4781549.0,,,,,,2207261.0,,4683364.0,,,39889808.0,,5190123.0,,32928.0,,112183059.0,,169123.0,,,199107.0,,5549134.0,59289812.0,,,24529.0,,,498794.0,,971910.0,,,,69414.0,17399170.0,50042183.0,69.01,,,776635.0,,10918.0,,,,374280.0,297177.0,-163249.0,-23804.0,38.0,,12439592.0,5421937.0,,,43.6,,,,,,,263824.0,,,,1909942.0,,0.299468,4223875.0,,,5656969.0,,,413240725.0,,,49.71,,,28.77,2859710.0,,2939060.0,47052.0,,,,,181452122.0,,,,4794.0,,28653695.0,,N,,,133370917.0,,7974617.0,,13574722.0,,25197.0,69657000.0,15775281.0,141531.0,,-515026.0,,,,,1391473.0,18428966.0,,1261451.0,338714.0,,,-2218967.0,19182664.0,,,,,,,187112.0,,,,,1138.0,,,,,19044.0,BROOKLYN,2307.0,33.96,,1404587.0,,,-754917.0,,4008185.0,P,,,4228912.0,2472932815.0,,24315780.0,,,11963217.0,330236,,3249168.0,9816184.0,,4196551.0,,4670065.0,74692.0,405823666.0,5272144.0,,,,,,,,2067736.0,,-365449.0,,,7373384.0,88237222.0,,162297.0,,664723.0,,,190198762.0,,27822258.0,Y,,,,,243294.0,,95782.0,,,,,371907.0,1613224.0,,,25343121.0,,8349762.0,,,,,,10918.0,,,35282.0,,,330296.0,2840000.0,,,,19268485.0,,14687.0,3987549.0,,66421358.0,20925.0,475601306.0,,125066492.0,1529693.0,,57333.0,,,,,4724309.0,,,10241474.0,,-4784464.0,51687137.0,,1336484.0,66330000.0,,,1613224.0,,,,,,,,,72562.0,669534.0,,28400958.0,,560270.0,,,,10762849.0,9495.0,,,35568.0,13517912.0,,,,,-18966599.0,,,,,115765382.0,25197.0,,,,,,169123.0,676906.0,,,,,,,,,,,,,,,5716448.0,,,,,,,,,8133766.0,,,50.94,,4966071.0,301000.0,310689000.0,38.0,,,,,,180138.0,,,,,,,,,2450241.0,,,,6064.0,591.0,4505845.0,31297684.0,121055554.0,490071471.0,92210000.0,,54993.0,,,,-217878.0,,,,33331,,,,5716448.0,17165552.0,187112.0,,,8144740.0,1522296.0,,,1.0,,249067.0,,,,,,,,21137.0,,1917231.0,,5256919.0,,,,,,,2709.0,,,,8784.0,,,74431852.0,,,,,,2893395.0,,,,,60681.0,1197579.0,,,,97194.0,,27585.0,,,,,3003494.0,N,6372522.0,,,2865476.0,,,,104.0,,,,,8259949.0,22532346.0,516.0,,,,,,,,,,,7385000.0,,1649862764.0,,,,,,,2033251.0,2130546.0,,16734447.0,,22968775.0,25.0,,,166592.0,,,,,,,11568.0,,,1394.0,,,,,1931036.0,,,1999887.0,75384.0,271851.0,,1581440.0,,,,19405.0,,,,46638.0,,26535611.0,,,,,,,,,,,,,,General Short Term,,,,,575170.0,899559300.0,36215852.0,577580.0,199565913.0,,851628.0,,46635826.0,,,,,,,9281414.0,,,,,,,,10438250.0,162860.0,,,,,-53731336.0,7291821.0,5638754.0,-28117.0,,1022650.0,6957050.0,583.0,Y,,160962.0,,73131.0,55370.0,Y,,,9106005.0,,,20186.0,5490.0,,4379852.0,,,,,,,,,8033747.0,1391473.0,,1059748.0,,5638754.0,,2.0,,,-694956.0,6539625.0,,5352684.0,,2629124.0,,,,,,,,37465951.0,3121569.0,,,,,,12133184.0,,,,112008.0,112033.0,,,34.05,7687671.0,,,,,F,,,,683.0,11965162.0,,,17399170.0,,,,150245206.0,,17803.0,3938.9,,11369010.0,4557162.0,N,,,,,,,,T,,240962.0,22572256.0,,21090201.0,,,,,,,,104256.0,,3248413.0,,7642082.0,,11568.0,155294.0,,754509.0,454.0,,,,287.87,,8954.0,,262515000.0,,7367147.0,22.0,,,5884923.0,,,,,,1037079000.0,,,-13415.0,13049173.0,,,,49.33,603894.0,,8287653.0,136382.0,1498857.0,25218116.0,,106680.0,,N,3365.0,29298137.0,,882560.0,,,7306.0,,,66183760.0,1844394.0,,519460.0,,118.0,,,6556373.0,6993769.0,,,,50.0,,,,,,330296.0,,505156.0,,33,,2.0,,,,50296312.0,9220.0,3858828.0,,,,8201.0,,3577.0,2968.0,,,4252301.0,,,,,,,,145116713.0,,138102884.0,,-607962.0,,,,,,,,,214996.0,7175804.0,,19428607.0,823070051.0,,,4665631.0,73.29,4683364.0,,,,,9678288.0,2027914.0,,,447.0,,9261.0,N,,,3216204.0,7084853.0,,24.0,,38592317.0,518489.0,,10510755.0,,57751695.0,,,,154393147.0,2924808.0,799.0,16734447.0,352567.0,,454.0,3778494.0,,66.0,,1366676.0,225095000.0,6587000.0,,6263.0,455146000.0,,,,,,1059748.0,,,,,,,805471.0,,,,,,,31791.0,,756009.0,1143.0,,,,,,,1716233721.0,NEW YORK-PRESBYTERIAN/BROOKLYN METHO,,-9528151.0,,4.0,,14623972.0,1093791.0,,,,805471.0,,8415.0,,,,11755879.0,,,,23301553.0,,2130546.0,,,326825.0,,793657.0,,11138389.0,,,1273428.0,2535903.0,,,37098.0,,,,,4860014.0,,,,,,22532346.0,,,5190123.0,10418247.0,,,4683364.0,2813732.0,,9027351.0,,22266634.0,,2046.0,17870346.0,,,,,,,,33247.0,,5219186.0,,,,,,,,,,,,5748.0,,,,,,,,,,9060394.0,,,,7740401.0,26352129.0,,35282.0,,,28999144.0,,,,,613.0,,36.96,11963217.0,121055554.0,,,,15168748.0,,,,,,16424498.0,31335233.0,,,,,66.82,,,,,1161217.0,,,4275925.0,,,1161217.0,,,,,,,,,,6479000.0,,,,,84522.0,Y,,3075460.0,,,,2553545.0,655825000.0,,3773107.0,13088148.0,,233778.0,24154984.0,,336019.0,,4908465.0,20014.0,,,7905906.0,15382666.0,,,,,,,,,,,,,,,,296.0,,,93605.0,187112.0,,68.01,755754350.0,,,7052133.0,,1393020.0,,,,9150.0,6993018.0,,,,73526400.0,,,19319549.0,,,,,,18108.0,,,,,,8112333.0,,405823666.0,,130025338.0,,,,,,,13008.0,,5401070.0,,,,,,,,15382666.0,1022253000.0,,,8001.0,,-2729958.0,,39936238.0,,5600,,17334733.0,,,,,,,,,,,,3843.3,,1700945.0,103768933.0,,,35.43,20935180.0,519460.0,,1205104.0,,,28119066.0,34814445.0,,,,,,,,35778102.0,,1904.0,,,,,,,-2599635.0,,,5510019.0,,,-346962.0,,,,,,,,N,,,,,,,,,,20518942.0,,,,,-3830646.0,5272144.0,,,,,89403.0,,129736557.0,,114835.0,,305554.0,8259949.0,1304430.0,,,2020-01-01 00:00:00,5884923.0,,,12630663.0,,,,4947266.0,,,,,,199565913.0,,,,5416997.0,,-114773.0,10934.0,,,,,375572.0,5375502.0,62522.0,2464330.0,7740401.0,12525603.0,12207691.0,187112.0,7974617.0,,,,,,,-4950956.0,,25.34,,,8415.0,,1638354.0,,,5811833.0,-13127700.0,,,,5004487.0,9495.0,,,7281798.0,,8508952.0,1697.0,,,,,,,,,,,,,6064.0,1104383000.0,3858828.0,,83067581.0,65395000.0,,,,,-19111.0,,,Y,,,,9646440.0,,,,,,,2079346.0,65754.0,21636123.0,20475.0,,,,,613.0,162860.0,,,5549134.0,3365.0,,,3434040.0,,45324.0,7306.0,,,3930.0,4039122.0,32351906.0,44561.0,,,1143.0,18729314.0,,,,5877899.0,,6556000.0,,,,,117830.0,,,,,27822258.0,2033251.0,98114658.0,,,565471.0,,,,,,,,,,,362548.0,,5272104.0,,,,,,,,1504499.0,,,4769216.0,,,,,,937546.0,,,231931.0,,,,,,,,753770.0,,2472932815.0,11963217.0,,,,,,,,-142860206.0,15.0,,,10661518.0,,,,,,,,5404015.0,39880084.0,7799729.0,15971553.0,-15190764.0,,,,,,,1017702.0,,,,2721372.0,,,,9106005.0,,,,27756030.0,712431.0,,121920.0,,,,,,,30572.0,11164770.0,74692.0,,1386915.0,,,66623.0,,,,,151773.0,36567364.0,,,,,-3601651.0,,,,41346.0,1393429.0,39739765.0,231766.0,,16038420.0,3248413.0,243294.0,,,,,,,,100923272.0,,,,,,,,,,,5656969.0,98114658.0,,,4.0,16356909.0,,166164.0,83067581.0,199565913.0,,NEW YORK-PRESBYTERIAN/BROOKLYN METHO,,,8001843.0,5252501.0,,,,,,,36177.0,,6791.0,7253653.0,,,,,,,2865995.0,,,5812960.0,2020,2020,50042183.0,603894.0,,0.01330113756814031,1137043000.0,188254763.194732,476179000.0,0.08765703636484068,-142860206.0,-0.18879394350114023,3.8940746243071827,2.0630211606955795,,0.2653448374378607,1137043000.0,0.9120842395582225,0.47701048975172505,0.5229895102482749,,1137043000.0,0.34804812885385455,11.571207187093815,Acute Care Hospitals,non-profit,1,NEW YORK-PRESBYTERIAN/BROOKLYN METHO (330236)
68190,NEW YORK-PRESBYTERIAN/BROOKLYN METHOD (330236),General Short Term (Acute Care Hospitals),Voluntary Nonprofit-Other,-73.979141,40.668263,3108160.0,,-643458.0,,,,,42662703.0,4854428.0,,,,,123066.0,,NY,,,48578775.0,4116.0,2327.0,,,52075576.0,,Y,,,6999228.0,,,,,16508159.0,,KINGS,752512699.0,254.58,,,,887673.0,2021-12-31,706191.0,,136.0,-1096474.0,,,,76804.0,,,,,1225391.0,,,,,277304.0,,,,,125434.0,,29882713.0,,,,,126524380.0,,,,22042.0,,45537752.0,,,,,42659967.0,,,,697.0,,,,,,33S236,,,,313.0,,,246.05,,38249.0,,4992871.0,,,,3907234.0,,,,,779733379.0,,,,,,Y,2832812.0,,,,,,,,14310331.0,,,,1346129.0,,,6251121.0,6243984.0,,,,,,,3040206.0,,5715434.0,,13149629.0,,,,,,,,,346510.0,,,73366000.0,1384216.0,,410863.0,,,,,,,,4116.0,,,,,,2839372.0,,,,-199773.0,,175942.0,348665259.0,,,,433788.0,,84825156.0,,,3383583.0,,,557330.0,3509234.0,,35614,,,,9462000.0,,116.16,,,2744399.0,794926.0,,2389312.0,,,,,6377.0,,,,,,,,28362000.0,29169.0,15.0,,,N,12184717.0,,,,,,,,,678693000.0,,,,,,60384405.0,,,,,3056949.0,,,79049.0,,44.45,,,,,,506 SIXTH STREET,1094947107.0,,,,,,,,,,,,,29470.0,,,,341970.0,,,,,,,,,17683000.0,19764254.0,,,,16657.0,,-30148570.0,,,,,,41138.0,,49320.0,10678771.0,,,,,,,,,11584379.0,,,14739621.0,,,4388283.0,,77428.0,,488430.0,169231.0,,,,,,,412682.0,,19595000.0,2024-04-15 00:00:00,,,30596.0,,44279.0,,10075962.0,,,19350593.0,,3326300.0,195195.0,388804.0,,,,,109105.0,,,71157.0,,,,,125545357.0,,-796125.0,79711.0,,184.63,7505578.0,,1499419.0,,14814010.0,,,,90.14,20252424.0,330514.0,16562121.0,,125434.0,,,,95823.0,1146052.0,763620084.0,,,,,44010245.0,,,,25.24,,1332894.0,,,,,,17195475.0,,8722.0,-1515851.0,6377.0,599717.0,,,2632206.0,,12067.0,59707065.0,2632206.0,,17274525.0,,,,,,5092100.0,,,,,61425.0,,8614758.0,,,,,,,5722.0,,,,,,,,,22853525.0,-1392656.0,5692.0,,,108648.0,,2692885.0,,,,,,,,,,,,,,,,,6773686.0,646976000.0,,,,,,,,2848.0,,,10911118.0,,,,,,,,,,48819631.0,3326001.0,,,,,,,141136.0,283293.0,,,55.83,,16893.0,7061843.0,,,,,1464969.0,,,,,,,,,,,870311857.0,,,,2726561.0,,,,13236778.0,333540447.0,,,,,103875000.0,,,29305372.0,,,,,,9647755.0,35867.0,,,80618.0,1251433.0,272059.0,11032020.0,1018.0,,,8055072.0,,,,,21082.0,,,,,,,,,,42.91,,,,,,,,,85356908.0,665243.0,99942.0,,,,,,,,,,,,,,,,,,,,,,,,,,,,,,19848922.0,20326.0,,,,,,,2333875.0,,16799.0,6.0,,,,,,,,,,,,,745833685.0,,16210.0,,-242618.0,2528207.0,,29178544.0,36154.0,3282044.0,,329655.0,337633239.0,589537.0,,,-3029653.0,,,-10459.0,,,37971563.0,,,,4745697.0,101662.0,,7136804.0,2966289.0,,,,,,,,3826054.0,,,,300774.0,,26.43,72984193.0,604129000.0,,220585.0,,,397530.0,13149629.0,,182287.0,,,,2724.0,5773866.0,,866380.0,23168659.0,,,13211.0,,,,277309000.0,,,2505195.0,,,,,,780.0,,27295537.0,,1843594467.0,,,75.0,,,2401157.0,9682774.0,31110324.0,,,,,,,,,234435.0,1061318.0,,,1180143.0,153957.0,,,,12139748.0,,19882601.0,,10504053.0,,,84879.0,162863.0,,,,,11176173.0,,,,,,,,,1960531.0,,,6302394.0,2404138.0,96283098.0,,,,,,,42959025.0,,,,,,,,,,2.0,,,264030.0,5304518.0,,388.0,229710.0,,,,19191.0,,,,2237983.0,,,,,,,,249264.0,,,140862282.0,,,,,6946298.0,2692885.0,,,,,14814010.0,,2635519.0,109105.0,1712.0,1670043.0,,138866.0,4790081.0,,,,1225391.0,,,2712354.0,4308645.0,,210770000.0,,,,,,1670043.0,219.0,2467463.0,1175724.0,895972.0,275.45,,,,5221295.0,,126524380.0,,,,774721662.0,,,,,,,,,,,7230794.0,,,30799247.0,,,324558.0,,,19191.0,2237983.0,,,,,84446000.0,,5873952.0,,,,,,,,,28135130.0,,,160423.0,,507015.0,456.0,,,41.04,,,10119189.0,,153066.0,,,,,,2374575.0,120900.0,-1726895.0,-62055838.0,,,20085.0,354735.0,,,,5602.0,,,,65955806.0,,,293123.0,,,41138.0,,,,99.27,,,,,,,,2226601.0,,3326001.0,,19764254.0,,,310918000.0,10981660.0,46297227.0,,2192261.0,,-1186794.0,,,,,,9647755.0,,,80365526.0,,,7528231.0,33551376.0,6999228.0,11005.0,1423840.0,,,23462150.0,,,,,9262247.0,,,121154495.0,23462150.0,,,910349734.0,,7013581.0,599717.0,10504053.0,,,,,15724452.0,,,,165710.0,,,,,,,379275.0,188340.0,,49787923.0,,,,,,197507677.0,,42.0,,,,,,655225119.0,,,,-1391414.0,,,2878202.0,,,,,7528231.0,,5,,,,,55219903.0,,,542640693.0,,,6008900.0,,,11215,,9922247.0,8152.0,979023.0,,343188202.0,,692065.0,2975.0,,,,802246.0,199.62,,,,,,53220540.0,99942.0,,,,,,,,,2827292.0,,,,,,,,,-53143005.0,,12280605.0,,,606255.0,,,,,15269608.0,,,3056949.0,-265973.0,15649044.0,,,,,,,,,,,2404138.0,,,1813924.0,769295,,30864453.0,206447.0,42.0,,,,,,,-152428.0,284.0,557330.0,107240397.0,,,20326.0,,,510760.0,92210063.0,,5436.0,,,,,,,,164384206.0,,,819941.0,,2327.0,,,2445908.0,,12754596.0,NEW YORK-PRESBYTERIAN/BROOKLYN METHO,,28983641.0,,,19351738.0,10731630.0,,,18445.0,,,43469.0,,33T236,N,,,,20173446.0,47924584.0,,,39272523.0,13001,5400583.0,,40938576.0,4768377.0,847027995.0,21897294.0,91161590.0,,,,,,,3817508.0,-4805859.0,,820426.0,,39272523.0,,,,,,910349734.0,,-1242.0,,,,,116793231.0,262456.0,,,176975.0,,108603443.0,2200355000.0,68116726.0,,,N,,,,,134766.0,,,20449015.0,,,162138465.0,,13870.0,,83935990.0,,,3817257.0,,,,,,,4455929.0,,,,20886728.0,,,4992871.0,,,,,,2541180.0,,5249018.0,,,31592107.0,,5478594.0,,43709.0,,112953502.0,,319475.0,,,268148.0,,5757599.0,75903586.0,,,,,,635016.0,,887673.0,,,,109208.0,31147746.0,84149008.0,63.87,,,747959.0,,20746.0,,,,,291394.0,-369391.0,-10459.0,,,20886728.0,7061843.0,,,33.8,,,,,,,347859.0,,5773866.0,,2119887.0,,0.260662,13312512.0,,,3656609.0,,,399603084.0,,,47.56,,,29.29,2401157.0,,2781281.0,24693.0,,,,,193181480.0,,,,,,30477833.0,,N,,,159657193.0,,,,24534788.0,,26032.0,52955000.0,15149588.0,87415.0,,-539590.0,,,,,2146368.0,16707897.0,,2163629.0,422013.0,,,-1454631.0,,,,,,,,99942.0,,,,,,,,,,18331.0,BROOKLYN,20326.0,33.77,,1079463.0,,,-796125.0,,4813709.0,P,,,4896872.0,2938541574.0,,28794293.0,,,10873278.0,330236,,4687749.0,11944877.0,,4730450.0,,7463420.0,,389727002.0,4806361.0,,,,,,,,2211974.0,,-754089.0,,,,90855398.0,,224169.0,,739703.0,,,188926864.0,,46051935.0,Y,,,,,279832.0,,,,,,,510544.0,23189705.0,,,25058344.0,,8055072.0,,,,,,1576.0,,,35867.0,,,590770.0,2754000.0,,,,21194135.0,,16893.0,3499705.0,,99974744.0,15377.0,480317251.0,,110320258.0,1261494.0,,33405.0,,,,,4308645.0,,,10963627.0,,-8011533.0,51430967.0,,979023.0,103822000.0,,,23189705.0,,,,,,,,,69114.0,905486.0,,22853525.0,,478870.0,,,,7083777.0,2736.0,,,41498.0,19290109.0,,,,,593837.0,,,,,125545357.0,26032.0,,,,,,319475.0,605612.0,,,,,,,,,,,,,,,7697562.0,,,,,,53815.0,,,4686167.0,,,49.24,,9016012.0,227000.0,60264000.0,38.0,,,,,,432176.0,,,,,,,,,2524528.0,,,,4983.0,541.0,4025827.0,40101290.0,69593000.0,484410043.0,84843000.0,,76224.0,,,,-399025.0,,,,33331,,,,7697562.0,18324900.0,99942.0,,,6958537.0,1723898.0,,,2.0,,472744.0,,,,,,,,26033.0,,,,3700807.0,,,,,,,,,,,8760.0,,,85367095.0,,,,,,4745697.0,,,,,,838832.0,,,,108385.0,,16799.0,,,,,4004314.0,N,6088232.0,,,,,,,16.0,,,,,8319499.0,24343857.0,516.0,,,,,,,,,,,50678995.0,,1834594466.0,,,,,,,2129413.0,9525853.0,,30408740.0,,25740444.0,25.0,,,169231.0,,,,,,,153957.0,,,,,,,,2733334.0,,,2608992.0,101456.0,302966.0,,2675944.0,16194.0,,,,,,,37240.0,,30799247.0,,,,,,,,,,,,,,General Short Term,,,,,580818.0,933059000.0,34148829.0,714240.0,200668194.0,,862579.0,,48819631.0,,,,,,,1061318.0,,,,,,,,18924695.0,165128.0,,,,,-62055838.0,8065327.0,7821427.0,-55868.0,480735.0,1138005.0,5304518.0,622.0,Y,,186644.0,,729363.0,67544.0,Y,,,11657917.0,,134691.0,6392.0,5475.0,,4160727.0,,,,,,,,,7735995.0,2146368.0,,1074837.0,,7821427.0,,2.0,,,,8646711.0,,6008900.0,,4591595.0,,,,,,,,36312355.0,,,,,,,10911118.0,,,,127105.0,101559.0,,,37.93,7551085.0,,,,,F,,,,397.0,12754596.0,,,31148443.0,,,,136710000.0,,,3996.1,,10981660.0,9529568.0,N,,,,,,,,S,,375839.0,23168659.0,,18587729.0,,,,,,,,114025.0,,4686982.0,,6731015.0,,153957.0,218180.0,,647002.0,454.0,,,,275.45,,67411.0,,278507000.0,,22995554.0,,,,6258459.0,,,,,,957200000.0,,,-14451.0,17195475.0,,,,47.38,676148.0,,8699079.0,209993.0,1589444.0,24878992.0,,96450.0,,Y,3429.0,29191440.0,,,,,7702.0,,,67699252.0,1394713.0,,507015.0,,71.0,,,6556373.0,6243984.0,,,,,,,,,,590770.0,,430766.0,,33,,2.0,,,,50251292.0,13316.0,,,,,,,1422.0,3065.0,,,6067757.0,,,,,,,,153387633.0,,135721388.0,,-770076.0,,,,,,,,,162954.0,3492450.0,,38378545.0,1094947108.0,,,2834588.0,75.22,5249018.0,,,,,11233855.0,2127643.0,,,,,133631.0,N,,,2920628.0,9262247.0,,24.0,,36241842.0,433788.0,,17180736.0,,57379668.0,,,,138621125.0,3383583.0,752.0,30408740.0,368310.0,,454.0,3278437.0,,,,341970.0,543865000.0,6587000.0,,6152.0,367775000.0,,,,,,1074837.0,,,,,,,676207.0,,,,,,,,,,997.0,,,,,,,2091513579.0,NEW YORK-PRESBYTERIAN/BROOKLYN METHO,,-12047133.0,,371.0,,20252424.0,1885384.0,,,,676207.0,,7146.0,,,,20438556.0,,,,26006417.0,,9525853.0,,,4973751.0,,1782724.0,,11772022.0,,,1581634.0,4767841.0,,,27624.0,,,,,6512651.0,,,,,,24343857.0,,,5478594.0,11176173.0,,,5249018.0,2140232.0,,9877311.0,,37619292.0,,,18260557.0,,,,,,,,,,6883855.0,,,,,,,,,,,,5602.0,,,,,,,,,,12139748.0,,,,9682774.0,28408740.0,,35867.0,,,34043311.0,,,,,,,34.48,10873278.0,69593000.0,,,,11032020.0,,,,,,23024626.0,33105802.0,7103.0,,,,50.74,,,,,6196316.0,,,5724667.0,,,6196316.0,,,,,,,,,,7358000.0,,,,,110649.0,Y,,3245095.0,,,,2912641.0,590856000.0,,3975235.0,11101578.0,,262766.0,24909296.0,,229710.0,,7294042.0,33912.0,,,7078874.0,25165207.0,,,,,,,,,,,,,,,,293.0,,,102365.0,99942.0,,67.51,779733379.0,,,6793870.0,,1969060.0,,,,9125.0,7115037.0,,,,73161604.0,,,30394528.0,,,,,,,,,,,,8115549.0,,389727002.0,,150385221.0,,,,,,,7379.0,,4415870.0,,,,,,,,25165207.0,949250000.0,,,8722.0,,-1515851.0,,47393456.0,,5600,,27897031.0,,,,,,,,,,,,3942.5,,3924567.0,148376554.0,,2615.0,38.77,23105673.0,507015.0,,833827.0,,,17491289.0,43240169.0,,,,,,,,42959025.0,,,,,,,,,-2185558.0,,,4840891.0,,,-242618.0,,,,,,,,N,,,,,,,,,,28135130.0,,,678707.0,,-7071532.0,4806361.0,,,,,,,117783678.0,,,,,8319499.0,,,,2021-01-01 00:00:00,6258459.0,,,14193441.0,,432176.0,,5400583.0,,,,,,200668194.0,,,,4743650.0,,,,235.0,,,,575399.0,6509032.0,,2333875.0,9682774.0,8731281.0,8396820.0,99942.0,,,,,,,,-5700070.0,,25.53,20921000.0,,7146.0,,1531251.0,,,5715434.0,-13856200.0,,,,5034061.0,2736.0,,,7505578.0,,8252849.0,,,,,,,,,,,,,,4983.0,1208206000.0,83935990.0,,142411677.0,79625000.0,,,,,,,,Y,,,,9947867.0,,,,,,,1760371.0,137726.0,21761628.0,20697.0,,,,,,165128.0,,,5757599.0,3429.0,,,2579982.0,,44279.0,7702.0,,,,3343740.0,37548050.0,31315.0,,,997.0,19350593.0,,,,13724407.0,,6556000.0,,,,,140038.0,,,,,46051935.0,2129413.0,110949609.0,,,658798.0,,,,,,,,,,,,,5044203.0,,,,,,,7440278.0,1660943.0,,,1880091.0,,,,,,1087562.0,,,204700.0,,,,,,,,760570.0,,2929541574.0,10873278.0,,,,,,,,-86031005.0,15.0,,,14315009.0,,,,,,,,6067339.0,48578775.0,6515507.0,15269608.0,-16113295.0,,,,,,,2482963.0,,,,3817508.0,,,,11657917.0,,,,39604122.0,,,125434.0,,,,,,,33235.0,15649044.0,,,1515713.0,,,60068.0,,,,,157426.0,45537752.0,,,,,-4694413.0,48140.0,,,40850.0,699087.0,53220540.0,124874.0,,19848922.0,4686982.0,279832.0,,,,,,,,130528579.0,,,,,,,,,,,3656609.0,110949609.0,,,,29282839.0,,165710.0,142411677.0,200668194.0,,NEW YORK-PRESBYTERIAN/BROOKLYN METHO,,,6496391.0,12184717.0,,2832812.0,,,,,50772.0,,5722.0,7243291.0,,,,,,,2404855.0,,,5716579.0,2021,2021,84149008.0,676148.0,,0.013669656474027903,1243155000.0,194410499.99947,330264000.0,0.12257209987492798,-86031005.0,-0.10156807745179662,3.4083523932971165,1.4717367965616663,3.262876696097405,0.19013884749754945,1243155000.0,0.7699763907155583,0.43502071256683583,0.5649792874331642,,1243155000.0,0.3849506079700776,10.637714222919938,Acute Care Hospitals,non-profit,1,NEW YORK-PRESBYTERIAN/BROOKLYN METHO (330236)
74924,NEW YORK-PRESBYTERIAN/BROOKLYN METHOD (330236),General Short Term (Acute Care Hospitals),Voluntary Nonprofit-Other,-73.979141,40.668263,1690390.0,,-584742.0,,,,,33517001.0,3187092.0,,,,,87430.0,,NY,,,32914047.0,7361.0,,,,44150725.0,,Y,,,14842611.0,,,,,18420948.0,,KINGS,627887310.0,261.38,,,,630580.0,2022-09-30,428812.0,,179.0,-754256.0,,,,95630.0,,,,,1560557.0,,,,,419877.0,,,,,87041.0,,19559913.0,,,,,89437099.0,,,,45614.0,,19980323.0,,400439.0,,,33500797.0,,,,286.0,,,,,,33S236,,,,9582.0,,,236.77,,20116.0,,5321980.0,,,223401.0,2448800.0,,,,,577094359.0,,,,,,Y,,,,,,,,,2424430.0,,,,1738983.0,,,4711099.0,5110139.0,,,,,,,1936182.0,,4044001.0,,9761786.0,,,,,,,,,240944.0,,,66453000.0,1186295.0,,985516.0,,,,,,,,7361.0,,,,,,2754502.0,,,,-202371.0,,129192.0,276547300.0,,,,,95.0,52424465.0,,,2459372.0,,,533584.0,3653895.0,,35614,,,,9801000.0,,126.49,,,2434901.0,870022.0,,1785410.0,,,,,5141.0,,,,,,,,23229000.0,24118.0,18.0,,,N,7356824.0,,3899976.0,,,,,,,674899000.0,,,,,,1424404.0,,,,,2425747.0,,,128343.0,,49.74,,,,,,506 SIXTH STREET,963766782.0,,,,,,,,,,,,,238997.0,,,,140141.0,,,,,,,,,24270000.0,16434648.0,,,,24238.0,,-28795319.0,,,,,,23609.0,,176086.0,7562267.0,,,,,,,,,7883304.0,,,10610560.0,,,3104631.0,,58608.0,,428485.0,134618.0,,,,,,,2281.0,,21823000.0,2024-11-26 00:00:00,,,16297.0,,31440.0,,9422449.0,,,15895345.0,,2594921.0,144598.0,351986.0,,,,,75295.0,,,46335.0,,,,,88811726.0,,-789224.0,58380.0,,211.88,5547014.0,,1331680.0,,11773688.0,,,,92.5,16585463.0,252340.0,11467936.0,,87041.0,,,,,1100814.0,565538041.0,,,,,29552710.0,,,,25.11,,858302.0,,,,,,14159716.0,,6006.0,-1197673.0,5141.0,5557491.0,,,1920886.0,,20720.0,37661625.0,1920886.0,,14626718.0,,,,,,3760942.0,,,,,47668.0,,24748888.0,,,,,,,4264.0,,,,105099.0,,,,,21776275.0,-1144999.0,999.0,,,53083.0,,1955750.0,,,,,,,,,27.0,,,,,,,,9709550.0,633645000.0,,,,,,,,3085.0,,,8160474.0,,,,,,,,,,45604515.0,2764986.0,,,,,,,112637.0,1256418.0,,,54.78,,14049.0,6097709.0,,,,,718747.0,,,,,,,1399.0,,,,742053122.0,,,,2646769.0,,,,6235878.0,278315638.0,,,,,128044000.0,,,45506700.0,,,,,,8230088.0,25619.0,,,66670.0,937718.0,712639.0,8821523.0,892.0,,,6579675.0,,,,,1759.0,,,,,,,,,,40.3,,,,,,,,,48868034.0,657614.0,341334.0,,,,,,,,,,,,10.0,,,,,,,,,,,,,,,60556.0,,,21606445.0,7437.0,,,,,,,1379578.0,,26970.0,,,,,,,,,,,,,,669002405.0,,76.0,,-278939.0,2880126.0,,24305697.0,27990.0,2674778.0,,280125.0,267725777.0,519177.0,,,-5697938.0,,,-1838.0,,,15639105.0,,,,5953799.0,75418.0,,5867837.0,2140080.0,,,,,,,,2660250.0,,,,300774.0,,33.33,,532005000.0,,841059.0,,,623744.0,9761786.0,,133722.0,,,,372.0,5364654.0,,557896.0,19220915.0,,,22830.0,,,,164457000.0,,,2221388.0,,,,,,660.0,,15281488.0,15904.0,1572617938.0,,,637.0,,,1489509.0,6860663.0,29969287.0,,,,,,,,,118465.0,991374.0,,,1081004.0,62224.0,,,,10937417.0,,18847667.0,,9008998.0,,,,154006.0,,,,,9156897.0,,,,,11275.0,,,,1470398.0,,,4659034.0,2402675.0,79582335.0,,,,,,,47538035.0,,,,,,,,,,2.0,,,193697.0,8651542.0,,284.0,180082.0,,,,61587.0,,,,1336931.0,,,,,,,,201595.0,,,102741873.0,,190.0,,,5945930.0,1955750.0,,,,,11773688.0,,1920886.0,75295.0,15312.0,1666701.0,,94846.0,3854743.0,,,,1560557.0,,,2097049.0,4200214.0,,212194000.0,,,,,,1666701.0,303.0,2843485.0,2526851.0,654612.0,295.08,,,,1866499.0,,89437099.0,,,,671863478.0,,,,,,,,,,,5922632.0,,,34515357.0,,,290047.0,,,61587.0,1336931.0,,,,,100353000.0,,4554176.0,,,,,,,,,20320172.0,,,27255.0,,392334.0,432.0,,,40.3,,,7529518.0,,1245655.0,,,,,,1293937.0,83016.0,-1254379.0,-51193878.0,,,15627.0,441553.0,,,,4120.0,,,,53596104.0,,,218865.0,,,23609.0,,,,88.8,,,,,,,,1287153.0,,2764986.0,,16434648.0,,,305046000.0,8696223.0,31072749.0,,2491780.0,,-1392133.0,,,,,,8230088.0,,,64722112.0,,,3858721.0,23071735.0,14842611.0,20037.0,5801693.0,,,16539275.0,,,,,8523718.0,,,115020412.0,16539275.0,,,896006744.0,,5288628.0,5557491.0,9008998.0,,,400018.0,,44811624.0,,,2341414.0,123942.0,,,,,,,287687.0,140868.0,,34275698.0,,,,,,115274615.0,,45.7,,,,,,590855684.0,,,,-1144750.0,,,2173977.0,,,,,3858721.0,,1,,,,,379448.0,95.0,,474176978.0,,,4441720.0,,,11215,,8277261.0,5371.0,625373.0,,286545726.0,,346609.0,312.0,,,,580981.0,206.3,,,,,,48042376.0,341334.0,,,,,,,,,3215351.0,,,,,,,,,-2226275.0,,10106261.0,,,473250.0,,35.52,,,15524712.0,,,2425747.0,-219949.0,16588176.0,,,,,,,,,,,2402675.0,,,1409317.0,791396,,24054592.0,93222.0,45.7,,,,,,,-155702.0,243.0,533584.0,95434214.0,,,7437.0,,,834264.0,84769785.0,,4118.0,,,,,,,,127693296.0,,,600268.0,,,,,2164542.0,,10670188.0,NEW YORK-PRESBYTERIAN/BROOKLYN METHO,,1642551.0,,,15941502.0,6101972.0,,,20707.0,,,42900.0,,33T236,N,,,,14309563.0,36605620.0,,,28398154.0,13001,5075862.0,,30685719.0,4084307.0,658206467.0,18829446.0,52150653.0,,,,,,,7033218.0,-4188288.0,,842508.0,,28398154.0,,,,,,896006744.0,,-249.0,,,,,139606289.0,191351.0,,,153991.0,,110661335.0,1570298000.0,55768442.0,,,N,,,,,637.0,,,19630712.0,,,181831954.0,,10374.0,,,,,2693860.0,,,,,,,8252278.0,,,,19945236.0,,,5321980.0,,,,,,1828219.0,,5123174.0,,,682151.0,,4702238.0,,43700.0,,90930118.0,,291919.0,,,192350.0,,6624659.0,105970083.0,,,,,,543834.0,,630580.0,,,,100799.0,25566677.0,51052815.0,71.38,,,228033.0,,44761.0,,,,863458.0,185254.0,-249728.0,-1838.0,,,19945236.0,6097709.0,,,56.29,,,,,,,250730.0,,5364654.0,,1688725.0,,0.22297,9949920.0,,,3059906.0,,,328862793.0,,,52.63,,,27.97,1489509.0,,2568118.0,10554.0,,,,,153255800.0,,,,,,25430226.0,,N,,,136429831.0,,3899976.0,,20517491.0,,18697.0,50334000.0,12001983.0,439227.0,,-374697.0,,,,,1986880.0,11696440.0,,1588305.0,287898.0,,,-1040175.0,524455.0,,,,,,,341334.0,,,,,,,,,,3615.0,BROOKLYN,7437.0,33.34,,1095083.0,,,-789224.0,,3551287.0,P,,,4474300.0,2536384720.0,,24877849.0,,,7922337.0,330236,,3072330.0,8091023.0,,3065617.0,,5734779.0,,319070022.0,2827121.0,,,,,,,,2111795.0,,-392819.0,,,3882373.0,62684835.0,,286933.0,,496695.0,,,135998526.0,,45766685.0,Y,,,,,2105702.0,,,,,,,516245.0,24122536.0,,,19396901.0,,6579675.0,,,,,,12820.0,,,25619.0,,,639240.0,2747000.0,,,,24310025.0,,14049.0,2965824.0,,64426448.0,5537.0,384338200.0,,90205260.0,1114003.0,-212459.0,,,,,,4200214.0,,,8449962.0,,-5446387.0,45392219.0,,625373.0,-188415000.0,,,24122536.0,,,,,,,,,41376.0,1608734.0,,21776275.0,,335814.0,,,,4821310.0,16204.0,,,29845.0,10947280.0,,,,,-7676.0,,,,,88811726.0,18697.0,,,,,,291919.0,138455.0,,,,,,,,,,,,,,,5778562.0,,,,,,78099.0,,,2883215.0,,,53.42,,6568656.0,228000.0,,38.0,,,,,,,,,,,,,,,1987939.0,,,,3900.0,553.0,2862621.0,29965507.0,26165616.0,373748339.0,84842000.0,,14041.0,,,,-387292.0,,,,33331,,,,5778562.0,10789400.0,341334.0,,,14890497.0,1237674.0,,,2.0,,2219773.0,,,,,,,,13343.0,,1381220.0,,2728404.0,,,,,,,,,,,6552.0,,,48877784.0,,,,,,5953799.0,,,,,,327970.0,,,,97682.0,,26970.0,,,,,3836083.0,N,4689683.0,,,425914.0,,,,76.0,,,,,5798611.0,15616629.0,516.0,,,,,,,,,,,-190641275.0,,1572617940.0,,,,,,,1676868.0,19278228.0,,25070268.0,,19556685.0,25.0,,,134618.0,,,,,,,62224.0,,,,,,,,1087871.0,,,2547687.0,80396.0,223328.0,,2970375.0,,,,,,,,4307977.0,,34515357.0,,,,,,,,,,,,,,General Short Term,,,,,216918.0,793247000.0,25549599.0,508551.0,144232324.0,,920655.0,,45604515.0,,,,,,,991374.0,,,,,,,,9075553.0,117544.0,,,,,-51193878.0,5363186.0,7888259.0,-31477.0,42962.0,764146.0,8651542.0,404.0,Y,,139071.0,,,54172.0,Y,,,12459742.0,,,491.0,4095.0,400018.0,3324257.0,,,,,,,,,6225282.0,1986880.0,,448817.0,,7888259.0,,2.0,,,-17603.0,7777850.0,,4441720.0,,3667608.0,,,,,,,,30382536.0,,,,,,,8160474.0,,,,2877.0,272460.0,,,32.14,5980496.0,,,,,F,,,,23990.0,10670188.0,,,25566963.0,,,,-55600742.0,,,4014.3,,8696223.0,10015550.0,N,,,,,,,,P,,353989.0,19220915.0,,12029492.0,,,,,,,,81142.0,,3071682.0,,4006159.0,,62224.0,190541.0,,454735.0,454.0,,,,295.08,,18610.0,,312245000.0,,,2.0,,,5535871.0,,,,,,987144000.0,,,-9850.0,14159716.0,,,,52.4,1371650.0,,5792795.0,191022.0,1285483.0,19072573.0,,164370.0,,Y,1921.0,22046769.0,,,,,5212.0,,,54764244.0,1210754.0,,392029.0,,76.0,,,6556373.0,5110139.0,,,,12.0,,,,,,639240.0,,310033.0,,33,,2.0,,,,44055624.0,6806.0,,,,,,,3199.0,3114.0,,,13366748.0,,,,,,,,121588585.0,,102727706.0,,-525945.0,,,,,,,,,157836.0,2061060.0,,29327267.0,963766780.0,,,2884880.0,78.92,5123174.0,,,,,9692630.0,1714520.0,,,,,54787.0,N,,,4500849.0,8523718.0,,24.0,,33578985.0,,,19158246.0,,42452220.0,,,,43887941.0,2459372.0,664.0,25071667.0,,,454.0,2112965.0,,,,140141.0,532005000.0,6587000.0,,2961.0,369853000.0,,,,,,448817.0,,,,,,,513200.0,,,,,,,,,379385.0,758.0,,,,,,,1878178253.0,NEW YORK-PRESBYTERIAN/BROOKLYN METHO,,-8657697.0,,589.0,,16585463.0,1750983.0,,,,513200.0,,5455.0,,,,19628874.0,,,,19776634.0,,19278228.0,,,2883126.0,,4343374.0,,9664474.0,,,2980384.0,2937889.0,,,18717.0,,,,,4778679.0,,,,,,15616629.0,,,4702238.0,9156897.0,,,5123174.0,,,8238482.0,,38787120.0,,,15700286.0,,,,,,,,345842.0,,4876108.0,,,,,,,,,,,,4120.0,,,,,,,,,,10937417.0,,,,6860663.0,20183145.0,,25619.0,,,30001023.0,,,,,,,34.85,7922337.0,26165616.0,,,,8821523.0,,,,,,11346520.0,32221770.0,11221.0,,,,66.03,,,,,6325337.0,,,6047473.0,,,6325337.0,,,,,,,,,,7594000.0,,,,,66730.0,Y,,1699153.0,,,,2822729.0,615605000.0,,3250782.0,106325437.0,,208233.0,23599310.0,,180082.0,,13087961.0,26224.0,,,4256889.0,25821449.0,,,,,,,,,,,,,,,,161.0,,,296302.0,341334.0,,71.58,577094359.0,,,5790228.0,,781456.0,,,,6825.0,5369024.0,,,,59365456.0,,,23848428.0,,,,,,,,,,,,6156417.0,,319070022.0,,210769626.0,,,,,,,,,2787841.0,,,,,,,,25821449.0,404648000.0,,,6006.0,,-1197673.0,,36482875.0,,5600,,53362791.0,,,,,,,,,,,,3964.0,,2529620.0,132505292.0,,,37.01,21733239.0,392029.0,,732135.0,,,14765673.0,29026765.0,,,,,,,,47538035.0,,,,,,,,,-1539240.0,,,2919958.0,,,-278939.0,,,,,,,,N,,,,,,,,,,20320172.0,,,,,-4733152.0,2827121.0,,,,,,,95940039.0,,255667.0,,395248.0,5798611.0,,,,2022-01-01 00:00:00,5535871.0,,,11189123.0,,327758.0,,5075862.0,,,,,,144232324.0,,,,3677647.0,,,,410.0,,,,359930.0,3910878.0,,1379578.0,6863865.0,5483987.0,5310757.0,341334.0,3899976.0,,,,,,,-4079397.0,,23.86,16822000.0,,5455.0,,883695.0,,,4044001.0,-11162264.0,,,,7562648.0,16204.0,,,5547014.0,,8226710.0,,,,,,,,,,,,,,3900.0,553338000.0,,,135062919.0,103647000.0,,,,,,,,Y,,,,9342118.0,,,,,,,966842.0,647925.0,15134203.0,18995.0,,,,,,117544.0,,,6624659.0,1921.0,,,56393613.0,,31440.0,5212.0,,,,1586921.0,28506291.0,11407.0,,,758.0,15895345.0,,,,8594647.0,,6556000.0,,,,,81866.0,,,,,45766685.0,1676868.0,1063880.0,,,670265.0,,,,,,,,,,,489764.0,,4020443.0,,,,,,,,1083658.0,,,1046209.0,,,,,,2306905.0,,,166247.0,,,,,,,,1143473.0,,2536384720.0,7922337.0,,,,,,,,-135040533.0,15.0,,,12213390.0,,,,,,,,4502631.0,32914047.0,59468142.0,15524712.0,-11556318.0,,,,,,,1450422.0,,,,7033218.0,,,,12459742.0,,,,45651618.0,850642.0,,87041.0,,,,,,,24829.0,16588176.0,,,1228211.0,,,62001.0,,,,,112237.0,19980323.0,,,,,-2655089.0,,,,29519.0,314620.0,48042376.0,153621.0,,21606445.0,3071682.0,2105702.0,,,,,,,,112740508.0,,,,,,,,,,,3059906.0,1063880.0,,,,24594361.0,,123942.0,135062919.0,144232324.0,,NEW YORK-PRESBYTERIAN/BROOKLYN METHO,,,5473394.0,7356824.0,,,,,,,32285.0,,4264.0,5468710.0,,,,,,,2608071.0,,,4044804.0,2022,2022,51052815.0,1371650.0,,0.013451280622555144,583154000.0,149167466.24285,214791000.0,-0.2862551637615557,-135040533.0,-0.20516439714652637,1.295931079761085,1.0198337843680443,1.1721660875274225,0.16120033947701323,583154000.0,1.6927672621640253,0.6286348196329614,0.37136518036703864,,583154000.0,0.4191602275491658,6.350463274383243,Acute Care Hospitals,non-profit,1,NEW YORK-PRESBYTERIAN/BROOKLYN METHO (330236)
