,Curated Name and Num,Hospital type (modified),S2_1_C1_21,Lon,Lat,S2_1_C1_3801,B_1_C21_192,S2_1_C1_126,D_1_HOS_C6_30,D1_HOS_C1_56,S3_2_C6_12,B_1_C21_117,C_1_C7_89,S3_2_C2_16,A_C1_75,S3_2_C5_9,S5_C2_6,D_4_HOS_C2_60,D3_HOS_C3_91,S5_C2_5,A_C6_93,D_4_IRF_C11_74,S2_1_C2_1516,D_4_HOS_C1_91,C_1_C7_110,D_5_HOS_C4_200,E_B_HOS_C1_41,S2_1_C4_2,A_C1_111,B_1_C26_4201,D1_IRF_C1_50,D_4_IPF_C3_200,S3_1_C15_14,C_1_C7_96,B_1_C21_57,B_2_C26_43,D3_IPF_C2_62,S2_1_C1_27,S3_2_C4_1402,D_4_HOS_C3_88,A_C1_60,A_C1_6250,S3_1_C13_16,D3_IRF_C3_58,S2_1_C1_35,S5_C4_4,A_C1_191,C_1_C5_90,B_1_C26_91,S3_1_C14_16,S3_2_C6_34,B_2_C26_192,D_3_HOS_C9_44,D3_SNF_C3_57,C_1_C6_100,D3_SNF_C3_72,B_1_C26_43,A_C2_17,D3_SNF_C3_200,D3_SNF_C2_58,S3_2_C4_27,C_1_C5_33,D1_HOS_C1_62,A_C6_110,G_C1THRU4_40,D_5_HOS_C6_69,S4_HHA3_C4_37,S10_C2_22,D_4_IRF_C13_59,S3_1_C2_21,S2_1_C2_7,D3_IPF_C2_69,A7_3_C6_3,D_5_HOS_C4_76,D_5_HOS_C7_63,A7_1_C3_4,C_1_C5_9930,C_1_C5_115,D_4_IRF_C11_60,S4_HHA3_C5_34,D_4_IPF_C11_65,B_1_C0_91,D3_SNF_C3_50,B_1_C26_200,D_4_HOS_C10_72,C_1_C7_73,D_5_HOS_C7_65,S4_HHA1_C1_36,G_C1THRU4_19,S3_1_C9_19,D3_SNF_C3_70,D_5_HOS_C4_70,E_B_HOS_C1_24,D_5_HOS_C3_73,S3_1_C15_1,B_1_C22_67,D_4_HOS_C10_62,D_4_IPF_C11_63,C_1_C5_4501,D_4_IPF_C13_51,D3_IPF_C2_94,D_4_IPF_C11_9201,D3_IPF_C2_73,S3_2_C5_41,C_1_C7_93,S2_1_C1_115,C_1_C8_202,A_C2_200,S3_2_C6_1,B_1_C21_107,D3_SNF_C3_94,FI_CREAT_DT,B_1_C0_16,D3_HOS_C2_61,S3_2_C3_2550,S3_1_C8_8,C_1_C2_65,A7_3_C10_1,D_4_SNF_C11_9201,C_1_C7_9201,D1_HOS_C1_58,D3_IRF_C3_90,S3_1_C8_11,D_4_HOS_C13_67,D_4_IRF_C13_64,A_C2_57,A7_1_C5_5,A7_1_C7_4,S5_C1_2,D_5_HOS_C2_59,D_5_HOS_C3_90,D_5_HOS_C4_59,A_C2_95,D3_HOS_C2_66,D_1_HOS_C7_31,B_1_C22_63,E_A_HOS_C1_59,S2_1_C2_13,A8_C2_2,D3_IRF_C2_61,D_5_HOS_C6_6250,S3_1_C2_7,D_5_HOS_C2_71,B_2_C26_65,D_5_HOS_C7_72,D3_HOS_C3_6250,D_4_HOS_C13_56,S3_2_C6_29,D_4_HOS_C13_90,A_C1_67,D3_IPF_C2_34,D_4_SNF_C11_53,D_4_HOS_C10_50,D_4_HOS_C10_51,A_C1_4501,D_1_HOS_C6_33,A_C2_4501,D_4_HOS_C3_51,B_1_C0_191,S4_HHA3_C4_36,D_4_HOS_C4_52,S3_1_C8_9,C_1_C5_9920,S2_1_C2_1520,B_1_C22_190,B_1_C0_68,B_1_C0_57,A_C6_57,S4_HHA2_C5_34,D_1_HOS_C6_200,D_4_IRF_C11_68,S3_2_C4_16,B_1_C26_9930,S2_1_C2_38,C_1_C5_112,D_4_HOS_C3_89,G_C1THRU4_45,D_5_HOS_C3_53,E_B_HOS_C101_8,A_C6_12,B_1_C21_42,S3_1_C14_18,B_2_C26_89,D_4_HOS_C3_200,A_C2_94,D_4_HOS_C2_57,S2_1_C5_24,D_4_IPF_C11_69,A_C1_34,S3_1_C7_18,D3_IPF_C3_9201,D_4_HOS_C12_51,S3_2_C4_22,A_C6_9201,B_1_C0_4,D3_HOS_C3_63,D_4_HOS_C12_68,D3_IPF_C3_98,B_2_C26_191,S3_1_C8_17,A_C6_89,D3_IPF_C2_35,C_1_C5_41,C_1_C5_88,D_4_HOS_C12_90,E_B_HOS_C1_20,A_C2_60,C_1_C7_76,B_1_C26_9201,D_4_HOS_C4_56,D_4_IRF_C13_58,D_5_HOS_C4_55,S3_1_C5_20,D_4_SNF_C11_59,A_C6_97,D_5_HOS_C4_72,D_5_HOS_C7_98,B_1_C26_67,S3_2_C6_14,C_1_C7_106,A_C6_91,B_1_C21_74,D_5_HOS_C2_72,D1_HOS_C1_57,D3_HOS_C2_33,D_5_HOS_C4_6250,D_5_HOS_C5_74,S3_1_C4_1,D3_IPF_C2_90,D3_IPF_C2_74,S3_1_C7_32,D3_IRF_C2_54,A8_C2_3,B_1_C0_9201,A_C1_33,D_4_IRF_C11_57,B_1_C0_32,B_1_C21_58,D_4_IRF_C11_93,A_C1_99,D_5_HOS_C4_54,S3_2_C4_23,A_C1_108,D_5_HOS_C3_50,D3_IRF_C3_200,D_5_HOS_C2_75,D_5_HOS_C5_72,B_1_C22_43,D_4_SNF_C11_69,S3_1_C15_17,D_5_HOS_C6_56,D_5_HOS_C6_72,S2_1_C1_22,S3_1_C3_11,A_C1_9920,D_4_HOS_C13_76,B_2_C26_93,B_1_C26_46,D3_IRF_C3_69,S3_1_C3_9,D3_HOS_C3_53,S3_2_C5_4,D_4_HOS_C3_50,D3_IRF_C2_51,S3_2_C2_19,S3_1_C10_20,A8_C2_6,S3_2_C4_17,D_5_HOS_C7_96,D3_HOS_C2_42,S3_2_C2_2551,S3_1_C2_16,D_4_IRF_C13_75,D_4_HOS_C3_94,D_5_HOS_C6_74,D_4_HOS_C4_93,S2_1_C1_26,A7_1_C2_6,D_4_HOS_C2_63,B_2_C26_66,B_1_C21_75,S2_1_C2_1506,D_4_IRF_C11_52,S3_2_C4_15,B_1_C26_63,D1_HOS_C5_44,S4_HHA3_C2_38,D3_IRF_C3_91,D1_IPF_C1_52,S3_1_C2_10,D3_HOS_C3_57,S3_2_C4_24,D_5_HOS_C5_93,C_1_C5_62,D_4_IPF_C11_59,D_4_HOS_C12_56,D3_IRF_C3_94,D1_HOS_C1_52,D_5_HOS_C4_75,D_5_HOS_C6_95,S3_2_C4_20,A_C2_63,D_5_HOS_C5_56,A7_3_C9_2,D_5_HOS_C2_51,D_5_HOS_C6_94,D3_SNF_C3_63,A_C6_43,S3_1_C3_24,S3_1_C5_13,C_1_C7_61,D_4_HOS_C11_69,D3_IRF_C2_69,C_1_C5_94,S3_1_C9_22,D_4_SNF_C13_73,D3_IRF_C2_50,D3_IPF_C2_40,C_1_C6_4501,D_5_HOS_C5_62,B_1_C26_117,S2_1_C2_1807,B_1_C22_106,D_4_IPF_C11_90,D3_IPF_C2_70,C_1_C6_70,A7_1_C1_2,D3_SNF_C2_53,S3_1_C6_16,E_B_HOS_C101_7,A_C6_114,S4_HHA1_C1_35,D_4_SNF_C11_74,D3_SNF_C3_65,B_1_C0_90,E_B_HOS_C1_12,D_4_IPF_C13_56,S3_2_C4_2,A_C1_46,D1_IPF_C1_49,D3_IPF_C3_67,A_C2_191,D_5_HOS_C7_67,A_C6_35,D_4_HOS_C4_51,S2_1_C1_129,B_1_C0_11,S3_1_C7_26,B_1_C26_88,D_4_SNF_C11_56,D_4_HOS_C4_54,D3_IRF_C2_71,D1_HOS_C5_45,D_5_HOS_C2_93,B_2_C26_74,A_C2_114,D_4_IRF_C11_67,B_1_C0_41,D_4_HOS_C2_69,D_5_HOS_C7_200,S3_2_C3_1401,S3_3_C6_4,D1_IRF_C1_53,D3_IRF_C3_98,D_4_IPF_C11_50,C_1_C6_58,S3_3_C6_7,D3_HOS_C3_90,S3_3_C6_3,D3_SNF_C3_62,A_C2_106,D3_HOS_C2_52,B_2_C26_91,B_1_C22_35,D_4_IRF_C11_75,D_4_IRF_C11_90,C_1_C5_101,S10_C1_11,S2_1_C1_142,D3_IRF_C2_98,C_1_C5_109,S2_1_C2_1604,S3_2_C5_5,S3_2_C2_3,D_3_HOS_C9_32,A_C6_115,S3_3_C2_1,A_C6_71,B_1_C22_42,D_4_HOS_C3_66,S3_1_C8_28,B_2_C26_76,D3_HOS_C3_93,S3_1_C6_8,S3_2_C4_21,B_1_C0_22,D3_IPF_C2_6250,A_C1_200,S3_2_C4_2550,A_C2_107,S3_2_C2_8,A_C2_69,D3_HOS_C2_40,S5_C4_6,S3_2_C2_31,S3_2_C2_32,A_C1_41,D_4_HOS_C3_93,D3_IRF_C3_75,A_C2_65,C_1_C6_9940,A_C6_16,D3_IRF_C2_34,D_4_HOS_C12_96,A_C6_194,D_4_IPF_C13_200,C_1_C2_68,B_1_C26_55,S3_1_C5_8,A_C1_30,C_1_C7_108,D_4_IRF_C2_200,D_4_HOS_C3_98,D_4_HOS_C11_76,D_5_HOS_C2_63,G_C1THRU4_17,D_4_HOS_C13_91,B_1_C21_56,D_3_HOS_C9_34,S3_3_C5_3,C_1_C6_112,S3_2_C2_39,D_5_HOS_C7_93,D3_HOS_C2_6250,S3_2_C3_25,C_1_C5_43,D1_HOS_C1_37,B_1_C0_8,D_5_HOS_C7_57,D_4_HOS_C13_59,B_1_C22_116,B_1_C22_76,S3_2_C3_2201,D_4_HOS_C4_59,S2_1_C2_130,C_1_C5_9910,C_1_C5_65,D_1_HOS_C7_41,D_5_HOS_C6_76,D3_HOS_C2_31,A_C6_34,D3_IPF_C2_52,C_1_C7_68,B_2_C26_33,B_1_C21_60,S3_2_C4_7,D_4_IRF_C11_55,B_2_C26_31,C_1_C5_54,D_4_IPF_C11_70,G_C1THRU4_53,B_2_C26_72,S5_C2_2,A_C1_6,D_5_HOS_C5_91,S3_2_C6_15,B_2_C26_193,D3_HOS_C3_68,D3_IPF_C2_96,D4_LIVER_C1_69,A8_C2_24,D_5_HOS_C6_93,D3_IRF_C3_60,B_2_C26_68,C_1_C7_9910,D_4_IRF_C11_56,D_4_SNF_C11_58,A8_C2_4,D_4_HOS_C11_63,E_B_HOS_C1_7,C_1_C7_66,D_5_HOS_C3_70,S3_2_C2_28,A_C6_69,S3_2_C5_38,C_1_C6_43,D3_IPF_C2_56,D3_IPF_C3_69,D_4_HOS_C2_93,B_1_C22_117,D_4_HOS_C2_94,D3_HOS_C2_65,B_1_C22_9201,C_1_C6_51,D_3_HOS_C9_200,A_C6_117,S2_1_C2_1607,D_5_HOS_C3_93,S3_2_C3_23,D_4_HOS_C4_65,S3_2_C4_1401,S2_1_C2_1611,S3_2_C2_29,S2_1_C2_142,D_4_HOS_C4_75,S3_2_C4_2552,S5_C1_15,D_5_HOS_C3_51,B_1_C0_50,D_4_HOS_C10_68,B_1_C0_70,D1_IPF_C1_37,B_2_C26_9910,S2_1_C1_37,D3_IRF_C3_52,D_4_HOS_C11_72,S2_1_C1_5,D_4_HOS_C10_52,D_5_HOS_C2_98,D_5_HOS_C2_54,A_C2_10,C_1_C6_75,S3_1_C7_15,A_C1_9,D_4_IRF_C13_65,S3_2_C5_11,D_5_HOS_C6_61,D_4_HOS_C4_69,S3_2_C2_24,S2_1_C2_1808,D_4_HOS_C13_64,C_1_C5_45,B_2_C26_56,A_C6_5,D_5_HOS_C6_59,S3_2_C6_26,A8_C2_11,D_4_HOS_C6_200,A7_3_C7_3,C_1_C6_88,B_1_C0_10,S2_1_C2_1401,A_C1_15,C_1_C5_110,B_1_C0_190,E_A_HOS_C1_7094,D_4_HOS_C3_56,S4_HHA3_C4_35,A_C1_23,S3_1_C7_5,S3_1_C11_24,D_5_HOS_C7_54,D4_HEART_C1_69,A_C1_193,A_C2_12,D1_HOS_C1_26,D1_HOS_C5_46,C_1_C6_56,D3_IRF_C3_61,D_4_IPF_C11_54,S3_2_C6_6,B_1_C22_59,D3_SNF_C3_96,A8_C2_29,S2_1_C2_16,D_4_HOS_C4_68,A_C2_75,C_1_C6_109,A7_1_C1_8,A_C2_4201,A_C1_57,B_1_C26_66,D3_HOS_C2_76,A7_3_C5_3,S3_1_C6_14,C_1_C7_53,D3_IPF_C3_51,B_1_C0_100,A_C6_96,D1_HOS_C1_63,B_1_C22_71,S3_3_C4_7,B_1_C0_9910,B_1_C26_4501,D_4_HOS_C10_53,D_4_IRF_C11_98,D_4_HOS_C12_6250,D_4_HOS_C10_54,S2_1_C2_1201,D3_IPF_C3_57,S3_1_C9_18,B_1_C21_193,A_C6_11,B_1_C0_54,S3_2_C4_1602,S3_2_C3_2553,S3_1_C8_5,S3_1_C6_5,S2_1_C2_1609,D_4_HOS_C12_200,D3_IRF_C2_55,B_1_C22_57,D_4_IRF_C11_51,S3_2_C3_2552,S3_2_C5_40,D_4_HOS_C12_60,D3_SNF_C2_63,D3_SNF_C2_64,E_B_HOS_C1_5,S2_1_C2_14,D3_SNF_C2_68,S3_2_C4_18,TRNSMTL_NUM,D_4_HOS_C4_57,S10_C2_23,C_1_C7_75,B_1_C26_62,D3_SNF_C2_34,D_5_HOS_C5_96,D_4_SNF_C13_200,D3_IRF_C3_76,S5_C5_2,D_4_HOS_C2_90,D_5_HOS_C4_93,A_C2_54,D3_HOS_C2_94,S3_2_C5_2,B_1_C26_99,A_C2_76,A7_1_C3_7,D_4_HOS_C11_66,D_4_SNF_C11_71,D_4_IPF_C6_200,B_2_C0_202,D3_IPF_C2_63,B_1_C21_76,A_C1_55,G_C1THRU4_2,A_C2_7,A_C1_74,A7_1_C5_10,A_C6_54,D3_IRF_C3_63,S4_HHA3_C1_34,B_1_C22_44,S3_1_C6_9,S3_1_C9_24,D_5_HOS_C4_60,B_1_C0_106,S3_3_C4_2,S4_HHA3_C3_38,D_4_HOS_C10_65,D_4_SNF_C11_90,S4_HHA3_C5_35,D_5_HOS_C3_65,D_5_HOS_C7_53,B_1_C21_62,B_1_C21_90,S3_2_C2_2201,S2_1_C2_1508,A7_1_C5_8,E_B_HOS_C1_25,B_2_C26_94,D_4_SNF_C11_72,B_1_C26_89,B_2_C26_9930,S3_1_C5_10,D_1_HOS_C7_40,D1_HOS_C1_53,D_5_HOS_C2_56,D_5_HOS_C7_73,S3_1_C9_27,D3_IRF_C2_62,S3_2_C3_2551,D_4_HOS_C2_65,D_5_HOS_C4_94,D_3_HOS_C9_30,D_4_IPF_C4_200,A_C6_4,B_1_C21_191,D_4_IPF_C13_90,B_1_C26_59,B_1_C26_98,C_1_C7_95,D_3_HOS_C8_200,D_5_HOS_C4_58,A8_C2_12,B_1_C0_192,C_1_C5_105,B_1_C0_46,B_1_C26_94,S3_1_C2_14,B_1_C22_58,B_1_C0_6,S3_1_C14_17,S3_1_C6_25,S3_1_C7_25,D3_IRF_C2_66,A_C6_9,D_5_HOS_C5_65,D3_HOS_C2_35,D_4_IRF_C13_53,D_5_HOS_C6_55,D_5_HOS_C2_57,B_1_C22_70,S2_1_C1_141,D3_IPF_C3_63,D_5_HOS_C6_9201,D_5_HOS_C4_64,S4_HHA1_C4_33,S4_HHA1_C3_36,B_1_C26_96,C_1_C7_54,S3_1_C3_2001,E_B_HOS_C1_2,D_4_IPF_C13_75,D_5_HOS_C4_71,D_5_HOS_C7_55,G3_C1_5,S3_1_C3_8,PRVDR_NUM,S4_HHA1_C5_37,D_5_HOS_C3_56,B_2_C26_201,D_4_HOS_C11_60,D4_INTESTINE_C1_69,S3_2_C2_35,D_5_HOS_C2_97,D_4_HOS_C11_56,E_B_HOS_C1_27,D_5_HOS_C6_57,D_4_HOS_C13_74,S4_HHA2_C2_35,B_1_C22_32,A8_C2_16,S10_C1_23,D3_IPF_C3_96,B_1_C26_73,A_C2_50,D3_HOS_C3_62,D_4_SNF_C11_63,S2_1_C1_93,A_C1_54,S2_1_C2_132,S5_C4_2,S2_1_C2_127,C_1_C6_42,D3_HOS_C2_57,S10_C1_20,C_1_C5_53,S3_2_C2_18,B_1_C21_98,D_4_SNF_C11_73,S2_1_C2_1608,S5_C1_21,C_1_C5_97,S3_2_C2_2550,D3_HOS_C3_9201,B_1_C0_194,D_4_HOS_C11_75,D3_IRF_C3_53,S3_3_C5_6,S3_3_C2_6,D_4_SNF_C11_70,S2_1_C1_3,S3_2_C3_14,A_C1_192,B_1_C22_91,S3_1_C11_22,A_C2_194,D_4_IPF_C11_53,E_A_HOS_C1_7093,B_1_C26_109,A_C2_31,D_4_HOS_C2_72,A_C1_56,S2_1_C2_1507,B_1_C22_191,B_1_C21_91,D_4_IPF_C11_55,D3_SNF_C3_75,S3_1_C2_32,S10_C2_21,A_C1_42,G_C1THRU4_12,S3_3_C4_6,B_1_C26_9920,D_4_IPF_C13_58,C_1_C5_30,A_C6_65,A7_3_C15_1,S3_2_C4_2551,S3_1_C6_29,D_5_HOS_C7_9201,D_5_HOS_C5_51,S2_1_C2_36,D_1_HOS_C4_4201,RPT_REC_NUM,S3_2_C4_38,D_4_IPF_C11_62,CENSUS,C_1_C6_107,D3_IPF_C3_52,D1_SNF_C1_85,A_C2_44,D_4_IPF_C1_200,B_1_C0_105,D3_SNF_C3_76,D_5_HOS_C5_67,A_C6_51,E_B_HOS_C1_10,S5_C1_1,D_4_SNF_C11_62,D_4_IRF_C11_71,D_5_HOS_C2_52,D3_HOS_C3_52,S4_HHA3_C4_33,S3_2_C2_12,S5_C2_1,C_1_C5_4201,S4_HHA1_C2_38,B_1_C0_52,S3_2_C5_16,S4_HHA2_C4_33,D3_HOS_C3_69,A_C2_35,A_C6_112,A_C1_97,S2_1_C2_1606,S3_1_C7_6,C_1_C2_66,S3_1_C5_16,D_4_IPF_C11_67,D3_HOS_C2_67,A_C2_53,B_1_C0_200,D_5_HOS_C7_74,A7_1_C7_8,C_1_C5_44,D3_IPF_C2_72,G2_C2_28,A_C6_95,B_1_C0_9,D_4_HOS_C1_76,S3_2_C2_9,A_C2_93,C_1_C6_117,D3_IRF_C2_6250,S3_2_C6_28,A_C1_98,A_C6_62,B_1_C0_72,B_1_C0_95,A7_1_C1_5,B_1_C22_62,B_1_C0_51,D3_HOS_C3_66,S3_1_C10_2001,FY_BGN_DT,S3_2_C6_1401,B_1_C21_67,C_1_C7_50,S3_1_C7_7,D_5_HOS_C2_73,D_5_HOS_C6_51,A8_C2_50,C_1_C5_73,C_1_C5_75,D_4_IRF_C13_76,S4_HHA3_C2_33,D_4_HOS_C4_60,D_4_IRF_C4_200,B_1_C26_76,D3_SNF_C2_40,C_1_C6_74,B_1_C0_33,A_C6_20,S2_1_C1_47,B_2_C26_53,S2_1_C2_1517,C_1_C6_111,S3_2_C5_10,D4_LUNG_C1_69,D_4_HOS_C12_66,S3_2_C5_37,A8_C2_21,C_1_C7_58,D_4_HOS_C2_68,S3_2_C4_1601,A_C2_111,S3_2_C5_31,D_4_IRF_C11_66,B_1_C26_60,S3_1_C15_21,A_C2_13,A_C2_30,A_C6_193,B_1_C22_99,D_1_HOS_C7_34,D_4_HOS_C11_50,D3_SNF_C2_72,S3_2_C2_43,D_4_IRF_C11_70,A8_C2_7,D_4_HOS_C11_98,A7_1_C1_3,D_4_HOS_C3_62,RPT_STUS_CD,D_4_IPF_C13_65,S4_HHA3_C1_35,S2_1_C2_1809,S2_1_C2_126,S10_C1_9,A_C2_105,D_4_HOS_C12_75,S3_2_C6_42,S3_2_C4_32,E_B_HOS_C1_21,S3_2_C2_22,E_B_HOS_C1_3,B_1_C22_192,B_1_C26_51,B_1_C0_99,D_4_HOS_C11_71,A7_3_C6_2,A_C2_109,S2_1_C2_1514,S3_2_C4_40,D3_IRF_C2_74,A7_3_C5_2,D_1_HOS_C6_34,C_1_C7_111,D_4_IRF_C13_200,A_C6_66,B_1_C21_9201,S4_HHA1_C2_34,S2_1_C1_131,S2_1_C2_10,D_4_HOS_C10_60,A7_1_C2_8,S3_1_C6_19,G_C1THRU4_36,B_1_C26_41,S3_2_C4_31,D_4_SNF_C11_67,A_C6_2,C_1_C5_74,C_1_C6_95,D_5_HOS_C2_200,A_C1_95,B_1_C21_41,A_C2_97,D_4_HOS_C10_71,S4_HHA3_C3_36,C_1_C6_115,D_5_HOS_C7_75,D_4_HOS_C12_93,D3_HOS_C2_71,B_1_C22_110,A7_1_C6_7,B_1_C26_6250,S2_1_C3_11801,S3_2_C5_14,D3_SNF_C2_52,D_4_HOS_C13_97,S3_1_C6_26,E_B_HOS_C1_43,S2_1_C2_9,S3_2_C4_12,A7_1_C1_10,C_1_C6_45,D_4_IPF_C13_59,D3_HOS_C2_50,C_1_C5_93,A_C1_106,B_1_C22_73,D3_HOS_C2_56,S3_1_C7_13,S2_1_C1_2,S3_1_C8_25,D_5_HOS_C5_68,D3_IRF_C2_94,B_1_C0_34,E_B_HOS_C1_4,G_C1THRU4_52,S3_1_C5_9,C_1_C6_61,D_5_HOS_C6_66,D3_IRF_C2_96,C_1_C6_99,A7_1_C5_1,B_1_C26_57,D_4_IPF_C13_91,G_C1THRU4_41,D3_HOS_C2_53,D3_SNF_C2_93,D_4_HOS_C3_58,D_5_HOS_C7_52,S3_1_C7_22,A7_1_C7_7,D3_IRF_C3_68,D_4_HOS_C2_59,A7_1_C7_3,D3_SNF_C3_71,S3_2_C5_26,S3_2_C6_30,A8_C2_15,D_5_HOS_C6_50,B_1_C22_54,S3_1_C7_11,S3_2_C2_30,S4_HHA3_C3_35,D3_IPF_C2_33,A7_1_C5_6,A_C1_94,A_C2_3,D3_HOS_C2_69,S3_1_C7_12,A_C2_18,S3_2_C4_10,A_C6_40,D1_IRF_C1_52,B_1_C22_98,D3_IPF_C2_200,D1_SNF_C1_84,A_C1_89,D_5_HOS_C3_6250,A8_C2_9,S4_HHA3_C2_35,D3_IPF_C2_98,A_C1_58,E_B_HOS_C1_40,D_4_HOS_C2_73,C_1_C5_52,B_1_C21_32,C_1_C5_35,D3_IRF_C2_73,C_1_C7_107,S3_1_C7_2001,D_5_HOS_C2_50,B_2_C26_44,D_4_HOS_C12_98,C_1_C5_91,S3_2_C5_42,G_C1THRU4_50,D_4_HOS_C11_68,D_5_HOS_C3_97,S5_C1_8,A_C1_66,D3_IRF_C3_72,A_C1_45,A_C1_32,D_4_HOS_C10_96,G_C1THRU4_13,A_C2_41,B_1_C0_17,S4_HHA1_C4_38,A_C1_4201,D3_SNF_C3_58,D_5_HOS_C5_58,A7_1_C5_3,D_4_HOS_C3_57,B_1_C0_35,D_5_HOS_C6_58,C_1_C2_67,D_4_IRF_C11_53,A_C6_74,D3_IRF_C2_40,A_C6_68,D_4_IPF_C11_75,D_4_HOS_C10_69,D_4_IRF_C13_57,D_5_HOS_C5_63,S5_C3_6,D3_IPF_C3_62,A_C6_70,B_1_C0_19,S10_C2_20,B_1_C0_14,B_1_C22_64,D_4_HOS_C11_93,D3_IRF_C2_31,B_1_C26_56,D3_IRF_C3_65,D_5_HOS_C6_64,D_4_HOS_C1_200,D_4_HOS_C11_64,D_4_IRF_C13_60,B_2_C26_35,G3_C1_28,D_4_HOS_C10_63,A_C6_190,S3_2_C4_9,S2_1_C2_1511,B_1_C21_95,A_C6_113,D3_SNF_C3_9201,S5_C2_8,S3_2_C2_41,D3_IPF_C3_75,A_C6_108,B_1_C26_107,D_4_IPF_C11_72,G_C1THRU4_46,A_C1_9910,A8_C2_14,C_1_C5_111,S2_1_C2_1515,S2_1_C1_56,S4_HHA1_C3_38,D_4_IRF_C11_50,D_4_HOS_C11_55,D_4_IRF_C13_63,A_C1_9930,D_4_HOS_C13_63,A_C6_46,D_4_IPF_C13_54,D_4_IPF_C11_52,A8_C2_22,A8_C2_30,C_1_C5_58,B_2_C26_63,S3_2_C4_3,S10_C3_21,A_C2_64,A_C6_22,D_5_HOS_C3_75,D_4_HOS_C3_63,B_1_C21_116,S2_1_C2_11801,D_4_IPF_C13_67,S3_1_C7_14,D_4_HOS_C10_6250,B_1_C22_101,B_1_C0_5,D_4_SNF_C11_75,D3_HOS_C2_70,S2_1_C2_1603,D_4_HOS_C2_91,B_2_C26_98,B_1_C21_51,D_4_HOS_C11_74,A_C2_89,A_C6_15,B_1_C0_53,S4_HHA2_C3_36,B_1_C22_90,D_4_HOS_C1_53,D3_IRF_C3_73,B_1_C26_45,D3_HOS_C3_76,A_C6_106,A_C1_35,S4_HHA2_C1_36,S4_HHA3_C5_38,B_1_C0_45,C_1_C6_93,B_2_C26_95,A_C2_192,C_1_C6_66,A_C1_12,G_C1THRU4_30,A7_1_C7_6,D3_IPF_C3_71,B_2_C26_117,S5_C6_4,S3_2_C4_39,D_5_HOS_C5_6250,D_4_HOS_C3_74,S3_1_C7_20,S3_2_C5_15,S2_1_C2_1803,D3_HOS_C2_74,B_1_C21_53,A_C6_99,S4_HHA1_C1_34,D3_HOS_C3_70,D3_HOS_C2_98,S3_1_C10_26,A_C6_9940,D_4_IRF_C11_73,D_4_IPF_C13_69,B_1_C0_1,B_1_C21_63,A_C2_23,D_4_HOS_C2_64,S3_2_C6_10,D_4_HOS_C11_90,S5_C5_1,C_1_C5_201,D3_IRF_C2_9201,S3_1_C6_10,S3_1_C7_8,D_4_HOS_C11_70,C_1_C5_57,E_B_HOS_C1_13,B_1_C21_89,D3_IPF_C2_32,D_4_IPF_C11_74,D_5_HOS_C2_65,D_4_IRF_C11_72,S3_2_C2_27,B_1_C0_23,C_1_C7_91,A_C6_101,S3_1_C6_2,S3_1_C8_10,A7_1_C7_2,B_1_C26_58,B_1_C21_101,D3_HOS_C3_72,D_4_HOS_C2_51,E_B_HOS_C1_15,S2_1_C2_1610,D3_HOS_C2_58,B_2_C26_50,S3_1_C7_1801,A_C2_43,A7_1_C2_7,C_1_C5_31,A_C6_23,D1_SNF_C1_37,S3_2_C2_1401,D3_IRF_C2_90,B_1_C0_193,C_1_C7_202,C_1_C6_46,D_4_HOS_C10_58,D_5_HOS_C4_9201,S3_2_C6_38,B_1_C22_60,A_C2_52,S2_1_C1_38,D_4_HOS_C3_65,D_4_HOS_C4_74,S2_1_C2_24,A7_3_C11_1,C_1_C7_63,D_1_HOS_C4_35,A_C1_5,B_1_C26_101,D_5_HOS_C5_69,D3_SNF_C2_51,D_4_HOS_C11_59,S10_C1_15,B_2_C26_42,S2_1_C2_1801,B_1_C26_72,C_1_C7_100,S3_1_C11_14,S3_1_C8_26,S3_2_C5_33,S10_C1_30,A7_1_C1_4,B_1_C22_95,A_C6_98,B_2_C26_9940,S3_2_C3_1402,D3_HOS_C3_98,A_C1_17,B_1_C0_74,A_C1_71,A_C6_44,A_C2_68,C_1_C6_62,D_4_HOS_C4_90,A_C1_59,S2_1_C1_140,B_1_C22_72,D_5_HOS_C5_52,D_5_HOS_C6_67,D_4_HOS_C10_76,S3_1_C7_24,S3_2_C2_20,A_C6_41,S2_1_C3_2,B_2_C26_64,D3_IPF_C2_60,S3_3_C5_2,D1_IRF_C1_41,B_1_C21_46,S3_1_C10_24,D3_IRF_C3_64,S3_1_C6_7,A_C2_11,A_C1_70,D_4_HOS_C12_57,C_1_C6_9930,S3_1_C8_18,D_4_HOS_C4_89,C_1_C7_9920,A7_1_C5_2,B_1_C21_43,D_5_HOS_C4_62,A8_C2_33,D3_HOS_C3_61,D3_IPF_C2_59,S4_HHA2_C5_33,S3_2_C4_19,S5_C1_9,B_1_C22_75,D_5_HOS_C2_69,A_C6_100,G2_C1_28,B_1_C21_68,D3_SNF_C3_56,B_1_C0_109,S3_1_C8_2001,D3_SNF_C2_60,D_4_HOS_C10_73,C_1_C6_50,S3_1_C10_18,D3_IPF_C2_42,A_C1_109,D_4_HOS_C3_6250,D_4_IRF_C13_70,D3_HOS_C2_97,D_4_HOS_C2_71,B_1_C22_65,D_4_HOS_C2_50,A7_3_C7_2,C_1_C6_64,A_C1_72,G3_C1_4,S3_1_C7_1,S3_2_C6_11,D_1_HOS_C4_42,S3_1_C13_17,D3_IPF_C2_91,D3_SNF_C3_67,S2_1_C1_144,D_4_SNF_C11_65,D3_IPF_C3_59,A_C1_53,S3_2_C4_2553,C_1_C6_41,A7_1_C3_3,B_1_C26_75,B_2_C26_115,D_5_HOS_C5_59,S3_2_C2_40,D_4_HOS_C1_73,D_4_HOS_C3_67,D_4_HOS_C12_74,S2_1_C2_1804,A_C2_1,A_C1_63,B_1_C26_95,C_1_C5_42,S2_1_C1_108,S3_2_C5_30,D_4_IPF_C11_57,C_1_C6_35,S2_1_C2_128,D_5_HOS_C2_76,S3_1_C10_25,D3_HOS_C2_41,D3_SNF_C3_90,D3_IRF_C2_64,G_C1THRU4_27,A_C1_101,C_1_C7_117,A_C1_44,D_4_HOS_C12_64,B_1_C0_62,D3_SNF_C2_76,S3_1_C5_19,A7_1_C5_4,D_4_HOS_C13_58,D_4_HOS_C13_68,S3_1_C10_21,A7_3_C10_3,C_1_C7_71,S5_C3_2,A8_C2_8,C_1_C7_88,C_1_C6_105,B_1_C21_21,A_C1_107,S10_C1_12,D3_IPF_C3_94,B_2_C26_108,D_4_HOS_C13_62,D_5_HOS_C3_74,D3_IPF_C2_53,S3_2_C2_23,A7_1_C2_10,B_1_C21_100,D3_HOS_C2_64,B_1_C26_70,S3_1_C2_12,A_C1_65,A_C2_22,B_1_C22_46,D_5_HOS_C6_98,S4_HHA3_C5_37,D_4_HOS_C12_69,A_C1_90,E_B_HOS_C1_28,A_C6_105,A_C2_14,S2_1_C2_1505,C_1_C5_117,D_5_HOS_C7_76,D3_SNF_C2_202,E_B_HOS_C1_16,E_B_HOS_C1_32,D3_SNF_C2_74,C_1_C6_108,D_4_IPF_C13_62,D_4_SNF_C11_200,D3_SNF_C2_90,S3_2_C4_29,B_2_C26_109,A7_1_C3_10,S3_1_C9_26,B_1_C22_69,C_1_C7_115,S10_C3_22,D_5_HOS_C4_68,C_1_C5_40,E_B_HOS_C1_14,D_5_HOS_C2_53,D3_HOS_C2_60,C_1_C7_67,D3_SNF_C3_98,D_1_HOS_C7_35,D_5_HOS_C6_60,A_C2_88,D_4_HOS_C13_9201,S3_1_C6_11,A_C6_4501,D3_SNF_C3_64,B_1_C21_35,D_4_IPF_C13_55,C_1_C5_116,S3_2_C4_25,D_4_HOS_C2_58,D3_HOS_C2_93,C_1_C6_31,S5_C1_7,D_4_IPF_C13_9201,D1_HOS_C1_48,B_1_C0_56,S3_1_C8_14,D_5_HOS_C3_94,D_4_HOS_C12_52,D_4_SNF_C11_68,D3_HOS_C2_91,D_5_HOS_C7_62,C_1_C6_4201,E_B_HOS_C1_3998,S3_1_C7_19,D_5_HOS_C6_97,S2_1_C1_132,S3_3_C6_6,A_C2_34,A8_C2_28,G_C1THRU4_9,E_B_HOS_C1_19,G_C1THRU4_25,D3_IPF_C2_31,G_C1THRU4_51,B_1_C21_44,S2_1_C1_128,S10_C1_19,A_C2_115,A_C6_21,B_1_C26_97,D_4_HOS_C3_71,S4_HHA1_C2_37,B_1_C26_112,D_4_IRF_C11_69,S2_1_C3_143,A_C6_94,D_5_HOS_C4_65,D3_IPF_C2_54,A_C6_10,S3_1_C4_11,S2_1_C2_1602,S3_2_C4_34,D_4_HOS_C3_52,D_4_SNF_C11_64,D3_HOS_C2_72,S2_1_C1_11801,D_4_IRF_C3_200,S3_1_C3_1,S3_2_C5_12,D3_IPF_C2_41,S4_HHA1_C1_38,A_C6_200,D_5_HOS_C4_57,B_1_C21_52,E_B_HOS_C1_26,S2_1_C4_24,S3_1_C15_18,S3_2_C5_28,S3_1_C3_16,S3_2_C5_34,D_4_HOS_C13_72,S3_1_C2_24,S5_C1_14,D_5_HOS_C3_52,A_C2_61,B_1_C0_2,D3_SNF_C2_55,D_4_HOS_C13_73,A_C1_19,B_1_C26_9910,B_2_C26_75,C_1_C5_95,S10_C1_6,D_5_HOS_C6_63,A7_1_C3_1,D3_IRF_C2_68,A_C6_109,A_C6_19,D_4_IRF_C13_91,A_C6_76,D_4_HOS_C4_71,B_2_C26_62,C_1_C5_32,C_1_C5_200,C_1_C6_73,S3_1_C8_32,D3_IRF_C3_9201,A7_1_C2_3,S2_1_C1_36,S2_1_C1_24,A_C1_18,S4_HHA1_C5_35,A_C6_31,A8_C2_27,S2_1_C1_127,D_4_IPF_C13_64,D_4_HOS_C2_97,B_2_C26_70,B_1_C21_94,D_5_HOS_C3_9201,B_1_C22_194,D3_HOS_C3_64,D_5_HOS_C6_75,D3_IRF_C2_32,C_1_C5_71,B_1_C0_71,B_1_C26_32,D_5_HOS_C2_58,A_C1_96,D_5_HOS_C4_91,D_5_HOS_C7_91,G_C1THRU4_47,D_4_HOS_C12_55,D_5_HOS_C2_55,D_5_HOS_C2_70,S3_1_C13_1,S3_2_C5_35,D_4_IRF_C13_62,S3_2_C2_6,D_4_HOS_C13_57,B_1_C26_50,D4_ISLET_C1_69,S3_1_C6_32,D3_HOS_C2_34,D1_HOS_C1_41,D_5_HOS_C3_63,D3_HOS_C3_55,B_1_C0_115,D_4_IPF_C13_93,D_4_HOS_C13_51,S2_1_C2_1402,D_4_HOS_C12_71,D_1_HOS_C4_31,B_1_C26_30,A_C1_4,B_1_C0_117,C_1_C6_52,A7_1_C4_7,A_C2_45,D3_IPF_C2_71,B_1_C0_4501,D_5_HOS_C4_73,D_1_HOS_C4_43,B_1_C22_109,A_C2_20,D_5_HOS_C7_68,D_5_HOS_C2_6250,A8_C2_13,A_C2_6250,A7_1_C3_2,S3_1_C6_15,D_4_HOS_C12_50,S3_1_C4_7,S3_2_C2_37,S3_2_C4_11,S3_1_C12_17,S3_2_C6_37,A_C1_190,C_1_C7_94,D_4_HOS_C4_66,D_5_HOS_C7_60,D_4_HOS_C2_70,C_1_C7_57,D3_IRF_C2_35,D_4_SNF_C11_51,A_C1_114,S3_2_C6_35,D_4_HOS_C1_50,C_1_C5_61,D_4_HOS_C12_54,S3_1_C3_10,S4_HHA2_C1_34,A7_1_C3_6,D3_IRF_C2_41,S4_HHA1_C4_37,A7_1_C7_5,C_1_C7_97,S3_1_C4_9,B_1_C26_65,B_2_C26_116,C_1_C6_55,A_C6_52,B_2_C26_73,B_1_C0_116,S3_1_C6_12,G3_C1_2,C_1_C7_70,G_C1THRU4_39,S2_1_C1_106,A_C2_55,D_4_HOS_C13_70,S3_1_C10_1801,C_1_C6_40,B_1_C26_190,B_1_C0_111,S2_1_C1_86,D3_SNF_C3_66,D3_HOS_C2_51,E_B_HOS_C1_39,B_1_C21_50,B_2_C26_51,G_C1THRU4_48,A_C1_11,C_1_C7_9940,D_5_HOS_C4_53,S2_1_C2_1502,S3_1_C11_21,C_1_C6_32,D_4_IPF_C13_73,D_4_IRF_C11_9201,G_C1THRU4_4,C_1_C7_72,D3_IRF_C3_57,A_C1_9940,S3_2_C4_28,S3_2_C5_6,D3_IPF_C3_53,S3_2_C6_33,B_1_C21_40,D_5_HOS_C6_91,D_4_HOS_C3_68,E_B_HOS_C1_17,B_2_C26_101,D_1_HOS_C6_40,D3_HOS_C3_59,S4_HHA1_C1_33,B_1_C26_9940,D3_SNF_C2_94,B_1_C22_45,B_1_C26_64,D_5_HOS_C7_56,S3_3_C4_1,S3_1_C2_9,D_5_HOS_C3_57,S3_2_C5_43,D_4_HOS_C11_57,A_C2_112,D1_HOS_C1_51,S3_1_C7_10,D_5_HOS_C5_9201,S3_1_C3_12,S3_1_C6_17,D_5_HOS_C3_96,D_4_HOS_C3_60,S3_1_C2_18,S3_2_C2_17,D3_IPF_C2_75,E_B_HOS_C1_4001,D3_IRF_C3_6250,S10_C1_2,C_1_C6_60,B_1_C26_110,B_1_C21_55,C_1_C7_60,S4_HHA2_C5_36,B_1_C26_52,B_1_C0_40,A_C2_72,D1_SNF_C1_74,S2_1_C2_143,B_1_C26_193,C_1_C7_59,D3_IPF_C2_64,S3_1_C10_14,S10_C1_17,D_5_HOS_C3_95,A_C2_117,S4_HHA2_C4_36,D3_HOS_C2_68,D3_IRF_C3_74,C_1_C7_109,D_4_HOS_C13_54,B_2_C26_71,D_4_HOS_C10_97,B_1_C21_106,D_4_IRF_C6_200,D3_IPF_C3_73,S2_1_C2_15,C_1_C7_9930,S2_1_C2_1509,B_1_C0_107,B_1_C21_115,C_1_C5_50,A7_1_C7_10,S3_3_C4_5,S3_1_C8_12,D_4_HOS_C2_74,D_4_HOS_C4_64,D_4_SNF_C11_50,S4_HHA2_C1_33,D3_HOS_C2_96,A_C2_58,D3_SNF_C3_51,S2_1_C3_24,D_4_HOS_C13_66,D_5_HOS_C3_200,S3_1_C9_21,B_1_C0_7,S2_1_C2_1202,D_5_HOS_C2_62,B_1_C22_88,S2_1_C1_48,S4_HHA3_C1_36,D_4_HOS_C2_98,B_1_C26_74,D_5_HOS_C5_98,D_5_HOS_C2_91,A_C6_191,A7_3_C11_3,S3_1_C2_1,B_2_C26_45,D3_IPF_C2_50,D_4_HOS_C3_90,A_C6_56,B_1_C21_190,A_C6_73,C_1_C6_57,D_4_SNF_C11_93,D_4_HOS_C10_91,S5_C1_10,A_C6_67,B_2_C26_9920,B_2_C26_69,S4_HHA1_C5_38,D3_IRF_C3_70,A_C2_51,A_C2_74,A_C6_111,MSA,C_1_C5_60,D3_SNF_C3_60,S10_C1_31,S4_HHA2_C5_35,A_C2_8,D1_IPF_C1_50,A_C6_61,A_C6_59,B_2_C26_100,A7_3_C15_3,S3_2_C2_1402,D1_HOS_C1_50,D3_IPF_C2_93,B_1_C0_12,E_B_HOS_C101_2,S3_2_C4_6,D_3_HOS_C5_200,B_1_C22_108,S3_1_C12_1,B_1_C0_110,B_1_C0_9920,S5_C6_1,B_2_C26_106,D_5_HOS_C6_53,A_C6_58,E_B_HOS_C1_11,D_4_IRF_C13_74,A_C6_18,A_C2_70,S3_2_C2_11,E_B_HOS_C1_1,S4_HHA3_C2_37,D4_PANCREAS_C1_69,D_4_HOS_C3_91,C_1_C6_30,B_1_C21_34,A_C6_90,A_C2_59,D3_SNF_C3_93,S3_2_C6_41,S2_1_C2_4,S3_1_C2_8,D_5_HOS_C2_68,A_C1_50,G3_C1_25,D_5_HOS_C5_97,B_1_C22_112,B_1_C0_61,D_5_HOS_C5_90,D3_HOS_C3_73,B_2_C26_59,A_C1_115,A_C2_33,S3_1_C11_27,B_1_C26_105,C_1_C5_67,C_1_C7_99,D1_IRF_C1_37,E_B_HOS_C101_6,S2_1_C1_1,S2_1_C2_1524,D_1_HOS_C7_200,D_5_HOS_C2_90,D_4_IPF_C11_93,D_5_HOS_C7_59,D1_IPF_C1_48,D3_IRF_C2_93,B_2_C26_41,B_1_C22_50,D_4_IRF_C13_90,D3_HOS_C3_60,S4_HHA3_C5_33,B_1_C0_76,D_5_HOS_C7_6250,B_1_C22_111,D3_IPF_C3_91,D3_HOS_C3_96,A_C1_110,D3_IRF_C3_55,S3_1_C7_16,D_4_HOS_C13_75,S3_1_C15_16,D3_IRF_C3_96,B_2_C26_58,D_4_HOS_C13_55,D_5_HOS_C5_57,D_4_IPF_C13_63,B_2_C26_4201,D3_IRF_C2_59,S3_2_C4_26,S5_C2_3,D_4_HOS_C4_50,S2_1_C2_3601,D_4_HOS_C2_52,D_5_HOS_C6_200,A_C6_1,B_1_C21_108,C_1_C6_63,D3_HOS_C2_75,C_1_C5_98,D_5_HOS_C5_200,A_C1_194,C_1_C7_105,S3_1_C7_9,B_2_C26_112,A_C2_16,B_1_C22_52,B_1_C26_34,S3_1_C2_19,D3_IPF_C3_66,S4_HHA2_C3_34,B_1_C0_55,B_1_C0_89,S3_2_C5_29,S10_C1_16,S3_2_C6_8,B_1_C22_89,S3_1_C3_20,S3_1_C8_22,D3_IRF_C2_58,D_4_IRF_C13_71,D3_IRF_C2_72,C_1_C6_76,S5_C4_1,S4_HHA1_C5_36,A7_3_C5_1,B_2_C26_30,A_C1_51,D_4_IRF_C11_200,D3_SNF_C3_52,S3_2_C5_13,S10_C1_22,B_1_C0_43,S3_2_C4_35,B_2_C26_190,A7_1_C1_7,B_1_C26_54,E_B_HOS_C1_9,G_C1THRU4_35,B_1_C22_193,S4_HHA1_C4_34,A_C1_20,B_2_C26_200,D_4_HOS_C3_76,D_1_HOS_C4_200,S3_2_C6_16,S3_2_C4_41,S3_2_C6_5,B_1_C21_109,B_1_C0_65,D_4_SNF_C11_91,S2_1_C2_1522,S3_2_C2_2552,S3_3_C5_4,D_1_HOS_C7_32,D3_SNF_C3_69,S4_HHA3_C1_38,S2_1_C1_4,D_4_HOS_C4_73,D1_IPF_C1_51,G3_C1_3,B_2_C26_32,D_4_IRF_C13_50,B_1_C22_56,B_1_C0_18,S4_HHA1_C5_33,A_C6_4201,S10_C1_26,D_4_IPF_C11_66,D_4_IRF_C13_93,D_5_HOS_C7_51,S3_2_C4_42,D3_SNF_C3_91,B_2_C26_110,A_C2_108,A7_1_C2_4,D3_IPF_C2_65,S3_2_C2_42,D_5_HOS_C3_71,D_5_HOS_C6_62,S3_2_C4_43,D_5_HOS_C3_61,D_4_HOS_C10_70,D_5_HOS_C3_55,D_4_IPF_C13_66,C_1_C6_67,E_B_HOS_C1_23,E_B_HOS_C1_18,D3_IPF_C3_60,D_4_HOS_C12_70,FY_END_DT,D_5_HOS_C7_50,D3_IRF_C2_200,S4_HHA2_C1_38,A_C6_8,B_1_C26_100,D_4_IPF_C11_68,D_4_HOS_C4_55,C_1_C6_90,D3_IRF_C3_59,D3_HOS_C2_63,E_B_HOS_C1_8,S5_C1_6,D_4_IRF_C11_64,B_1_C0_4201,D_4_HOS_C12_67,D_4_IRF_C11_58,G_C1THRU4_7,A8_C2_20,B_1_C21_112,D3_HOS_C2_30,C_1_C6_6250,S3_2_C2_38,D3_SNF_C3_74,D_5_HOS_C5_54,D_5_HOS_C7_90,S4_HHA1_C2_35,S2_1_C2_1501,S3_1_C5_17,A_C6_6250,D3_IPF_C3_70,D_4_HOS_C11_54,B_1_C22_115,G_C1THRU4_44,D_1_HOS_C7_30,E_B_HOS_C1_22,S3_1_C4_8,C_1_C6_91,S3_2_C3_22,D_4_HOS_C3_70,D_5_HOS_C4_90,D_5_HOS_C2_9201,S2_1_C1_143,D_5_HOS_C4_74,S5_C1_11,D_5_HOS_C3_64,A8_C2_31,C_1_C7_112,S3_1_C10_22,B_1_C0_108,D3_SNF_C2_96,A_C6_55,S3_1_C11_20,S3_1_C11_25,A_C6_88,D_4_IPF_C13_76,C_1_C5_68,B_2_C26_9201,C_1_C6_53,S3_3_C2_4,B_1_C22_94,D_5_HOS_C2_66,S3_1_C8_1,S3_2_C4_13,S3_1_C2_20,S5_C1_12,S3_3_C2_2,D_4_HOS_C2_88,C_1_C5_6250,D_4_HOS_C3_97,C_1_C7_101,D3_IRF_C2_52,S2_1_C2_1513,A_C1_93,A_C6_9910,D3_IPF_C3_72,D3_IRF_C2_63,S5_C1_13,D_5_HOS_C3_76,S2_1_C3_3,A_C1_100,A_C6_64,C_1_C7_69,C_1_C6_33,A_C2_98,B_1_C21_105,D_4_IPF_C11_56,A_C1_21,S2_1_C2_1518,D_4_HOS_C4_91,D_5_HOS_C6_54,D_4_HOS_C2_54,S3_1_C10_19,C_1_C6_96,D_4_IRF_C13_69,D_4_HOS_C3_64,D_4_IPF_C13_70,B_1_C0_9940,D_4_IRF_C11_62,A8_C2_17,B_1_C21_194,B_2_C26_34,D3_SNF_C3_53,B_1_C0_93,S10_C1_21,C_1_C6_98,A_C6_3,D_4_HOS_C11_58,A_C2_4,D_5_HOS_C5_73,A_C6_9930,S3_2_C3_24,B_1_C0_97,A8_C2_10,D_4_HOS_C2_66,B_2_C26_40,D_5_HOS_C2_60,C_1_C5_72,S3_1_C2_11,D_4_HOS_C10_64,A_C6_63,S3_2_C6_39,D_4_IPF_C13_74,S4_HHA2_C5_37,D3_IPF_C2_57,G_C1THRU4_34,D3_HOS_C3_65,S3_3_C4_4,A_C2_91,D_4_IRF_C13_68,D3_SNF_C2_91,D_4_HOS_C3_75,S3_1_C3_18,A_C1_16,S4_HHA3_C5_36,D_4_HOS_C10_66,D_4_HOS_C2_62,D_4_HOS_C2_75,A7_1_C5_7,B_1_C21_65,A_C2_2,A_C2_62,E_B_HOS_C1_34,D_5_HOS_C5_70,D1_HOS_C1_49,D_4_HOS_C12_63,D_4_HOS_C2_67,S10_C3_23,C_1_C6_59,REGION,A_C1_40,S4_HHA2_C2_38,G_C1THRU4_23,A_C1_14,B_1_C21_33,B_1_C0_9930,S2_1_C2_1605,D_4_HOS_C13_98,E_B_HOS_C101_3,D3_HOS_C3_71,S3_2_C4_37,S3_1_C10_27,D_4_IRF_C13_56,D_5_HOS_C4_50,B_1_C0_88,D_5_HOS_C6_71,S4_HHA2_C3_38,A_C1_69,S3_2_C4_30,D3_HOS_C3_58,S4_HHA2_C4_38,D3_IPF_C3_58,B_2_C26_90,B_1_C26_53,D3_SNF_C2_9201,S3_1_C11_26,B_1_C21_88,D3_HOS_C2_54,B_2_C26_4501,C_1_C6_110,D_4_IRF_C1_102,D3_IPF_C2_51,D_4_HOS_C12_73,S3_1_C12_14,S3_2_C2_1,A_C2_96,B_1_C0_64,D_4_IPF_C11_51,D_5_HOS_C3_58,D3_SNF_C2_41,D3_IRF_C2_76,A7_3_C6_1,D1_IRF_C1_27,D_4_HOS_C3_9201,A_C2_116,S3_1_C8_20,B_1_C0_6250,B_1_C22_34,D_5_HOS_C4_52,C_1_C5_96,D_4_HOS_C12_58,B_1_C26_61,S2_1_C2_1601,D3_IPF_C3_76,D3_HOS_C2_55,S3_1_C6_22,D_1_HOS_C6_32,D3_IRF_C3_56,C_1_C6_72,A_C2_113,D_4_HOS_C12_65,D3_IPF_C3_200,A_C2_15,D3_HOS_C2_73,A_C6_45,B_1_C21_70,S3_1_C13_18,S3_2_C2_33,S3_2_C6_27,D_4_IPF_C2_200,S2_1_C2_1805,S2_1_C1_145,B_1_C26_111,C_1_C6_116,D_4_SNF_C11_52,E_B_HOS_C1_29,G_C1THRU4_1,S3_2_C6_43,S3_3_C2_5,D_3_HOS_C9_31,D3_IPF_C3_64,D_4_HOS_C11_62,D_4_HOS_C11_73,D3_SNF_C2_98,D_4_IPF_C13_72,B_2_C26_52,C_1_C5_51,E_A_HOS_C1_7099,D_4_IRF_C13_55,C_1_C5_107,D_1_HOS_C7_33,D_4_HOS_C11_65,D1_IPF_C1_27,S2_1_C2_5,D_4_IRF_C11_54,S3_1_C13_2,B_1_C22_53,S2_1_C2_1503,S3_2_C6_7,D_4_HOS_C3_96,S4_HHA3_C1_33,A_C1_31,D_4_IPF_C13_60,A_C1_8,D3_SNF_C3_54,D_4_HOS_C2_9201,A_C6_42,G3_C1_1,B_1_C22_66,D_4_IPF_C11_60,A_C1_73,S4_HHA3_C4_38,D_5_HOS_C6_52,D_1_HOS_C4_34,C_1_C6_101,S10_C1_2701,D3_IRF_C3_71,B_2_C26_202,S3_1_C14_14,B_2_C26_88,S2_1_C4_3,S2_1_C2_115,D_1_HOS_C4_40,D_4_HOS_C10_55,D3_IPF_C3_74,C_1_C6_54,S2_1_C1_134,D_4_HOS_C12_97,D_4_IPF_C11_200,A_C1_91,D3_IPF_C3_68,D_5_HOS_C4_98,A_C6_32,D3_IRF_C2_70,S3_2_C4_5,S3_2_C6_9,A7_1_C1_6,S3_3_C2_3,D_4_SNF_C11_55,D3_SNF_C2_31,D3_HOS_C2_62,B_1_C21_66,D_1_HOS_C4_41,A7_3_C9_3,D_5_HOS_C6_73,A_C1_10,S5_C3_3,B_1_C21_59,A_C6_75,A_C6_60,B_1_C22_33,S3_2_C2_4,E_B_HOS_C1_31,A_C2_66,A_C6_107,B_1_C0_67,B_1_C26_68,D_3_HOS_C9_40,D_4_HOS_C2_56,G_C1THRU4_6,A_C6_14,S3_3_C6_5,S3_2_C4_8,D_5_HOS_C2_67,S3_1_C3_7,D3_IRF_C3_67,D_5_HOS_C2_64,D3_HOS_C3_67,D_4_HOS_C12_72,D_4_HOS_C13_52,D_4_HOS_C13_53,C_1_C6_94,D_4_IPF_C11_64,D_4_SNF_C11_54,D_5_HOS_C5_76,D_4_IPF_C13_50,G_C1THRU4_15,S2_1_C2_12,B_1_C26_201,C_1_C6_202,D_4_HOS_C12_53,B_1_C21_64,A_C6_7,B_1_C0_60,B_1_C0_66,D_4_HOS_C11_52,S10_C1_27,A_C2_9910,D_4_HOS_C3_72,S2_1_C1_60,S3_1_C7_2,D_4_SNF_C11_76,D_5_HOS_C5_71,A_C2_9,S3_2_C2_13,G_C1THRU4_49,D_4_HOS_C3_69,S3_2_C4_2201,C_1_C5_55,A7_1_C3_8,C_1_C5_66,D_1_HOS_C4_32,A7_3_C9_1,S4_HHA2_C2_33,D_5_HOS_C7_66,A7_3_C15_2,B_2_C26_96,A7_1_C7_1,B_1_C22_107,S2_1_C2_1523,ST_CTY_CD,C_1_C7_52,A8_C2_25,S3_2_C2_5,S4_HHA2_C4_35,D_4_HOS_C13_50,D1_HOS_C1_27,D3_IRF_C3_93,B_1_C0_15,D_4_HOS_C10_56,S3_2_C2_2,S3_1_C4_14,S3_3_C4_3,B_1_C26_90,S3_2_C6_4,C_1_C5_89,D3_IRF_C2_65,D4_KIDNEY_C1_69,UTIL_CODE,A_C6_33,B_2_C26_99,S2_1_C2_1521,D_4_IPF_C11_58,D_5_HOS_C3_68,D_5_HOS_C2_74,D_5_HOS_C7_58,G3_C1_29,D3_IRF_C2_67,B_1_C0_58,B_2_C26_55,D_4_HOS_C11_91,S3_2_C2_2553,S2_1_C2_1512,A_C2_100,D_4_HOS_C13_71,G_C1THRU4_54,A_C2_9930,D_4_HOS_C12_91,D_4_HOS_C4_72,D3_HOS_C3_75,D_4_HOS_C2_55,C_1_C6_106,D1_IRF_C1_49,S4_HHA1_C4_35,D_4_IPF_C13_53,A_C2_193,D_5_HOS_C4_66,D_4_HOS_C3_73,D_3_HOS_C9_35,D_5_HOS_C3_66,C_1_C6_34,B_2_C26_105,D_5_HOS_C5_50,D_4_IPF_C11_76,S3_2_C6_13,S4_HHA2_C5_38,C_1_C7_74,S2_1_C2_1504,S4_HHA2_C4_37,A8_C2_1,C_1_C7_64,A7_1_C2_5,S3_2_C2_10,B_2_C26_57,B_1_C26_31,C_1_C5_34,A7_3_C7_1,D3_HOS_C2_90,D_5_HOS_C7_71,S5_C1_3,D3_IRF_C3_54,A_C2_99,D_4_HOS_C3_59,S3_1_C3_1801,D3_HOS_C3_56,B_2_C26_194,S3_2_C6_31,D_4_IRF_C11_76,A_C1_7,D3_SNF_C3_73,D_4_HOS_C3_55,D_1_HOS_C6_41,D_4_IPF_C11_91,A7_1_C2_1,S2_1_C2_1510,B_1_C21_30,D_4_HOS_C11_200,D_1_HOS_C4_33,D1_IRF_C1_51,S3_2_C5_36,E_B_HOS_C1_35,C_1_C6_9920,D_4_IPF_C11_73,C_1_C7_56,S2_1_C2_140,C_1_C7_65,D_5_HOS_C3_98,S3_1_C14_1,D_5_HOS_C4_51,C_1_C5_76,E_B_HOS_C1_36,G_C1THRU4_3,S3_1_C12_16,D_4_HOS_C13_69,A_C6_50,S3_1_C5_11,B_1_C0_30,A_C1_117,A_C1_105,A_C2_56,E_B_HOS_C1_44,D_3_HOS_C3_200,S4_HHA1_C3_35,D3_HOS_C3_94,A_C6_6,A_C1_62,S3_1_C8_21,D_5_HOS_C3_59,D_1_HOS_C6_31,C_1_C7_51,D_5_HOS_C3_67,S3_2_C5_39,B_1_C0_21,S2_1_C2_1806,B_1_C26_93,C_1_C6_65,G_C1THRU4_38,S4_HHA3_C3_33,D3_SNF_C2_59,D3_SNF_C2_32,D_5_HOS_C3_54,D3_HOS_C2_59,B_2_C26_60,D3_SNF_C2_73,D_5_HOS_C4_96,B_1_C26_35,C_1_C7_62,D_4_HOS_C12_76,A_C2_9940,D_4_IPF_C13_68,A_C1_88,A_C2_67,D_5_HOS_C4_63,D_4_HOS_C10_59,S5_C6_2,A_C1_64,B_1_C0_44,S3_2_C2_34,B_1_C21_73,B_1_C22_74,D_4_SNF_C11_60,C_1_C7_55,D_4_HOS_C10_93,S3_1_C9_14,A_C2_32,D_4_SNF_C11_57,D_4_HOS_C10_90,D3_IPF_C2_9201,D_4_HOS_C4_58,B_1_C0_96,C_1_C6_71,E_A_HOS_C1_72,A_C6_53,B_1_C0_98,E_B_HOS_C1_33,S4_HHA1_C3_33,S4_HHA2_C3_35,A8_C2_23,S3_1_C8_15,D_4_HOS_C13_93,A_C2_9920,S3_1_C5_1,B_1_C0_13,A_C1_68,D3_SNF_C2_50,D1_IRF_C1_48,D_1_HOS_C4_30,S2_1_C2_129,B_1_C22_51,D3_HOS_C3_74,B_1_C26_115,B_1_C22_105,S3_1_C3_21,S4_HHA1_C4_36,S3_1_C5_7,S3_1_C5_14,D_4_IRF_C11_65,C_1_C5_56,D3_SNF_C2_69,B_1_C0_73,S3_1_C13_14,C_1_C6_89,D_4_IPF_C13_71,S5_C4_3,D_4_HOS_C3_54,D3_SNF_C3_68,S10_C3_20,D_4_SNF_C11_66,B_2_C26_6250,D_5_HOS_C4_67,S3_1_C6_24,S5_C2_7,S3_1_C2_17,D_4_HOS_C10_75,D_4_HOS_C11_9201,D3_IPF_C2_58,D_4_IRF_C11_63,D3_IRF_C3_66,D1_IPF_C1_53,C_1_C5_9201,S3_2_C2_7,C_1_C5_202,B_1_C26_202,D_5_HOS_C7_64,S4_HHA1_C3_34,A_C1_112,D_5_HOS_C5_53,C_1_C3_202,S2_1_C6_24,D3_HOS_C3_50,D3_IPF_C3_54,S3_1_C8_24,S2_1_C1_3601,C_1_C5_106,A_C1_13,S2_1_C2_2,A8_C2_18,S3_1_C6_1,D3_HOS_C3_51,D_4_IRF_C13_66,D3_SNF_C2_75,S3_1_C4_12,D3_SNF_C2_35,D3_SNF_C2_57,D3_HOS_C2_32,D3_IRF_C2_91,D1_IPF_C1_41,B_2_C26_46,C_1_C7_90,B_1_C0_101,D_4_HOS_C4_67,D3_IPF_C2_55,D3_HOS_C3_97,B_2_C26_97,S10_C1_3,A_C2_101,S3_2_C5_8,S2_1_C1_85,S3_2_C5_27,A_C2_190,S3_2_C2_15,A_C2_90,D_4_IPF_C11_71,C_1_C5_64,S3_1_C11_19,S3_2_C6_1402,D_4_HOS_C2_200,S3_1_C2_2001,C_1_C5_59,C_1_C5_63,A7_1_C1_1,D_4_HOS_C10_9201,S3_1_C8_7,S3_3_C5_7,D_5_HOS_C3_60,D_5_HOS_C7_69,D_5_HOS_C5_66,D_4_HOS_C2_76,D_4_HOS_C3_53,D3_SNF_C3_59,S3_2_C4_4,E_B_HOS_C1_38,D3_IPF_C3_56,B_1_C26_33,S5_C2_10,S3_1_C2_1801,C_1_C6_69,E_B_HOS_C1_42,S10_C1_1,D_5_HOS_C6_68,C_1_C6_9910,S3_2_C2_25,A_C6_17,A_C6_192,B_1_C21_45,A_C2_6,S3_2_C2_26,C_1_C6_9201,B_2_C26_67,D_4_IRF_C13_72,B_1_C26_106,B_1_C26_42,B_1_C22_100,D_4_HOS_C4_76,S4_HHA2_C2_37,D_5_HOS_C7_94,D3_SNF_C2_56,S2_1_C2_8,C_1_C7_116,S2_1_C2_18,B_1_C26_191,B_1_C26_194,G_C1THRU4_11,D3_IPF_C3_65,D1_HOS_C1_55,E_B_HOS_C1_6,S3_1_C3_32,D_5_HOS_C7_70,D3_IPF_C2_76,B_1_C22_31,C_1_C5_9940,D_5_HOS_C3_62,B_1_C21_31,D_4_HOS_C4_88,D3_IPF_C3_50,G_C1THRU4_31,S10_C1_10,D_5_HOS_C6_70,D_4_HOS_C12_9201,S3_1_C9_20,C_1_C6_44,S3_2_C2_36,D_5_HOS_C3_69,S3_2_C4_14,STATE,A_C1_22,D_4_HOS_C10_57,G_C1THRU4_8,S2_1_C1_105,C_1_C6_97,B_1_C22_55,A_C2_19,C_1_C7_6250,D1_HOS_C5_43,B_1_C0_63,D_4_IRF_C13_51,D_3_HOS_C2_200,S2_1_C2_1802,S3_2_C2_21,D3_IRF_C2_57,S3_1_C3_14,B_1_C22_93,S3_1_C8_19,S3_1_C7_17,D3_SNF_C2_65,S3_3_C6_2,B_1_C26_71,B_1_C26_44,D3_HOS_C3_54,D3_SNF_C2_67,A_C2_46,S5_C1_5,B_1_C21_72,S3_2_C6_2,B_1_C21_54,D_5_HOS_C5_75,D_4_IRF_C13_73,D_4_HOS_C12_62,S10_C1_18,D3_IRF_C3_62,S3_1_C3_17,D_4_IRF_C11_59,D_4_HOS_C13_65,A8_C2_5,B_1_C0_69,S2_1_C1_125,A_C1_76,S3_2_C4_1,A7_3_C11_2,B_1_C22_30,D_5_HOS_C5_64,C_1_C6_68,B_1_C26_40,D_4_IRF_C13_54,B_2_C26_54,G3_C1_26,C_1_C7_98,A_C2_40,S3_2_C5_1,D_5_HOS_C4_69,A_C2_73,D_5_HOS_C5_55,B_1_C0_20,S3_2_C6_3,D3_IRF_C2_53,D_4_IPF_C13_52,D3_IPF_C2_67,E_B_HOS_C1_37,B_1_C0_31,B_1_C0_75,D3_HOS_C3_200,A_C1_9201,S3_1_C3_19,B_1_C21_69,S4_HHA2_C4_34,B_1_C0_112,D_3_HOS_C9_33,B_1_C21_71,D_4_HOS_C13_60,D3_IRF_C2_56,C_1_C5_46,D3_IPF_C3_55,S2_1_C2_1519,S10_C1_14,A8_C2_19,S3_2_C5_3,D_4_IPF_C13_57,A7_1_C2_2,D_4_HOS_C10_98,D3_IPF_C2_66,S3_3_C6_1,A_C2_42,S3_1_C8_1801,A_C6_9920,A_C6_116,D_5_HOS_C5_60,D_4_HOS_C2_53,A_C6_72,D_3_HOS_C6_200,D3_SNF_C2_62,D1_HOS_C1_54,S3_1_C4_10,S3_1_C5_12,D_4_HOS_C4_53,A_C6_13,D_4_HOS_C10_67,B_1_C21_99,D_4_HOS_C11_67,D_5_HOS_C6_65,S5_C2_9,S3_1_C2_27,S2_1_C2_1,A_C6_30,A_C1_116,D3_IPF_C3_90,S3_3_C5_1,C_1_C5_100,D3_SNF_C2_54,D3_SNF_C2_66,S2_1_C1_116,B_1_C26_192,D_4_HOS_C11_53,S3_1_C8_16,C_1_C5_108,S3_2_C5_7,B_1_C22_41,A_C2_5,S2_1_C2_17,D_4_HOS_C11_94,E_B_HOS_C1_30,D_5_HOS_C6_90,S3_1_C8_6,A_C1_43,C_1_C5_70,D_4_HOS_C12_59,B_1_C21_93,D_5_HOS_C2_96,B_1_C26_116,S3_2_C4_36,D_4_IRF_C11_91,D3_IPF_C3_93,A_C1_52,D3_SNF_C2_71,B_1_C22_68,D3_IRF_C3_50,B_2_C26_111,D_5_HOS_C3_72,A8_C2_26,D_1_HOS_C6_35,E_B_HOS_C101_5,D_4_HOS_C4_70,S2_1_C2_1001,A_C2_71,D3_HOS_C2_9201,S3_2_C5_32,G_C1THRU4_37,D3_IRF_C2_60,S3_2_C6_36,S2_1_C2_3801,E_B_HOS_C101_4,D_4_HOS_C13_200,C_1_C5_69,FI_NUM,B_1_C26_69,B_1_C0_94,S5_C3_1,D3_SNF_C2_70,S3_2_C6_32,S3_2_C6_40,D3_SNF_C2_30,A_C2_21,S3_2_C4_33,C_1_C5_99,B_1_C0_59,A7_3_C10_2,D_4_HOS_C11_51,D_4_HOS_C4_200,S4_HHA2_C1_35,S3_2_C2_14,B_1_C22_40,S2_1_C7_3,D_5_HOS_C3_91,B_1_C26_108,S5_C2_21,B_1_C0_42,D3_IPF_C2_68,D3_IRF_C3_51,D_3_HOS_C9_41,D_4_IRF_C13_52,S4_HHA1_C5_34,A7_1_C3_5,D_5_HOS_C6_96,S10_C1_13,D3_IRF_C2_75,D_5_HOS_C4_56,S3_1_C8_13,D3_SNF_C3_55,S4_HHA2_C3_33,A_C2_110,S4_HHA1_C2_33,B_2_C26_107,Report_Period_Begin_Yr,Ratio of Charity Care to Total Operating Expense,Total Net Assets,Medicaid Costs,Medicaid Shortfall,Cash Reserves,Total charitable care,Net Profit Margin,Operating Profit,Operating Profit Margin,LIQUIDITY current ratio,LIQUIDITY acid-test ratio,LIQUIDITY acid-test ratio (variation),LIQUIDITY cash ratio,Equity,SOLVENCY Debt-to-Equity Ratio,SOLVENCY Debt Ratio,SOLVENCY Equity Ratio,SOLVENCY Interest Coverage Ratio,SOLVENCY total assets less total liabilities,EFFICIENCY asset turnover ratio,EFFICIENCY Accounts Receivable Turnover Ratio,Hospital Type (From CMS Hospitals Data Archive),,Medicaid Expansion State,Name and Num
,Curated Name and Num,Hospital type (modified),Type of Control of Hospital (See Table I),Lon,Lat,MDH status beginning date  (MM/DD/YY),Physicians' Private Office,"Medicare certified kidney 
transplant center cert date",Adults & Pediatrics,Target Amount,Management and Administrative Services,Other Special Purpose,FQHC,Teaching Physician Salaries,ASC (Non Distinct Part),SNF,Number of stations,Laboratory,Emergency,"Number of days in year dialysis 
furnished",Other Outpatient Services,Renal Dialysis,RHC 17 Provider Number,Emergency,Intestinal Acquisition,Total,Interim payments,Hospital County,Islet Acquisition,Subprovider II,Pass through Cost for Program Inpatient,Total Allied Health,Total discharges,Durable Medical Equipment Rented,CT Scan,Nursery,Whole Blood & Packed Red Blood Cells,Urban (1) or Rural (2),Related Salaries,RHC,Laboratory,Blood Clotting Factors for Hemoph.,Title XVIII discharges,MRI,"If (SCH), enter the # of periods.",CAPD exchanges per day,Research,Clinic,Emergency,Medicaid (Title XIX) discharges,Dietary,Physicians' Private Office,SNF,CT Scan,Int & Res (non approved teaching program,Impl. Dev. Charged to Patients,Nursery,Social Service,TOTAL,MRI,Administrative and General,Burn Intensive Care Unit,Relief Payment,Intestinal Acquisition,Notes and Loans Payable (short term),Electrocardiology,PEP:  Total Number of Outlier Episodes,Payments received from patients for amounts previously written off as charity care,Cardiac Catheterization,OLTC,Swing Bed SNF Provider Number,Electrocardiology,Total,Other Ancillary,"Blood Storing, Processing, Trans",Building Improvements,OOT,ASC (Distinct Part),Laboratory,Total Other Charges,Respiratory Therapy,Emergency,Operating Room,Cross Foot Adjustments,Impl. Dev. Charged to Patients,Drugs Charged to Patients,Respiratory Therapy,W/Out Outliers:  Number of Episodes,Fixed Equipment,SNF,Electroencephalography,Electroencephalography,Total prospective payment,Drugs Charged to Patients,Total discharges,Occupational Therapy,Whole Blood & Packed Red Blood Cells,"Blood Storing, Processing, Trans",ICF,Recovery Room,Home Program Dialysis,Observation Beds (Distinct Unit),Drugs Charged to Patients,Medical Records & Med Records Library,Other Outpatient Services,Is this hospital an All-Inclusive rate provider? (Y/N),Total Charges,Total Salaries,Total Salaries,Liver Acquisition,Home Program Dialysis,Fiscal Intermediary/MAC Create Date,Medical Records and Medical Rec. Library,PBP Clinical Lab Services Program Only,Interns & Residents,Intensive Care Unit,Respiratory Therapy,New Cap Related Csts Bldg & Fixtures,Observation Beds (Distinct Unit),Observation Beds (Distinct Unit),Bonus Payment,Clinic,Surgical Intensive Care Unit,Occupational Therapy,Intravenous Therapy,CT Scan,Fixed Equipment,Building Improvements,Number of Times per week Patient receives Dialysis,Cardiac Catheterization,Clinic,Cardiac Catheterization,Ambulance Services,Physical Therapy,Intensive Care Unit,"Blood Storing, Processing, Trans",IPPS Payment amount (unadjusted),ASC 1 Provider Number,Investment Income-New Movable Equip,PBP Clinical Lab Services Program Only,Blood Clotting Factors for Hemoph.,Total,Medical Supplies Charged to Patients,Respiratory Therapy,Impl. Dev. Charged to Patients,Blood Clotting Factors for Hemoph.,Radioisotope,Admin & Gen Under Contract,Clinic,Occupational Therapy,Surgical Intensive Care Unit,Anesthesiology,Operating Room,Recovery Room,ICF,Burn Intensive Care Unit,ICF,Recovery Room,Research,PEP Episodes:  Total Number of Episodes,Delivery Room and Labor Room,Coronary Care Unit,OPT,RHC 21 Provider Number,"Gift, Flower, Coffee Shop, Canteen",Speech Pathology,CT Scan,CT Scan,Total Other Charges,Total,Speech Pathology,Teaching Physician Salaries,OOT,MDH status ending date (MM/DD/YY),Other Organ Acquisition,FQHC,Total Current Liabilities,Anesthesiology,Transitional corridor payment,Maintenance of Personnel,Subprovider I,Medicaid (Title XIX) discharges,FQHC,Total Allied Health,Home Program Dialysis,CT Scan,Medicaid HMO Days,Electrocardiology,Surgical Intensive Care Unit,Subprovider 1,Observation Beds (Distinct Unit),Recovery Room,Physician Part A,Observation Beds (Distinct Unit),Employee Benefits,"Blood Storing, Processing, Trans",Speech Pathology,Other Reimbursable,Research,IRF,FQHC,Other Special Care Unit,Subprovider-IRF,RHC,Clinic,Excess of reasonable cost over reasonable charges,Laboratory,Other Ancillary,Observation Beds (Distinct Unit),Radioisotope,MRI,Radiology-Therapeutic,NF,Cardiac Catheterization,Durable Medical Equipment Sold,Impl. Dev. Charged to Patients,Other Reimbursable,Occupational Therapy,Home Office Salaries & Wage Related Csts,Heart Acquisition,Emergency,Renal Dialysis,Impl. Dev. Charged to Patients,Operating Cost and Target Amount,Burn Intensive Care Unit,Blood Clotting Factors for Hemoph.,Renal Dialysis,Hospital Adults & Pediatrics,Clinic,Renal Dialysis,Labor and Delivery Days -  Title XIX,Radiology-Diagnostic,Investment Income-Other,Observation Beds (Distinct Unit),Burn Intensive Care Unit,CT Scan,Coronary Care Unit,MRI,Other Outpatient Services,CMHC,Radiology-Diagnostic,Physician Part B,Lung  Acquisition,Operating Room,TOTAL,ASC (Non Distinct Part),Impl. Dev. Charged to Patients,Nursery,Electrocardiology,Total discharges,Radioisotope,Impl. Dev. Charged to Patients,"Does the facility qualify and is it receiving payments for 
disproportionate share? (Y/N)",Surgical Intensive Care Unit,OPT,Other Ancillary,Other Outpatient Services,OLTC,Electrocardiology,Coronary Care Unit,Anesthesiology,Physician-Part A,Operating Room,Recovery Room,Excluded Areas,NF,Rental of Provider space by suppliers,Wage Related Costs Core,Durable Medical Equipment Rented,Subprovider I,Interns & Residents,IPF,ASC (Non Distinct Part),Home Program Dialysis,Renal Dialysis,Other Outpatient Services,Urban/Rural Indicator at beginning,Movable Equipment,"Blood Storing, Processing, Trans",Physical Therapy,ASC (Non Distinct Part),RHC 7 Provider Number,Delivery Room and Labor Room,Home Office:  Physician Part A,"Blood Storing, Processing, Trans",Coronary Care Unit Program Cost,With Outliers:  Non Routine Med Sup Chgs,Emergency,Total Program Excludable Costs,Burn Intensive Care Unit,CT Scan,Wage Related Costs RHC/FQHC,Other Outpatient Services,Whole Blood & Packed Red Blood Cells,Cardiac Catheterization,Radioisotope,Home Program Dialysis,Total Program Excludable Costs,ASC (Non Distinct Part),Ambulance Services,Non-Physician Anesthetist Part A,"Blood Storing, Processing, Trans",Radioisotope,New Cap Related Csts Movable Equipment,Recovery Room,Home Program Dialysis,"Blood Storing, Processing, Trans",Nursery,Hospice,Nursery,PBP Clinical Lab Services Program Only,Electrocardiology,Electrocardiology,Home Program Dialysis,HHA,Drugs Charged to Patients,Operating Room,Subprovider-IPF,ICF,Whole Blood & Packed Red Blood Cells,Other Special Purpose,Renal 8 Provider Number,Heart Acquisition,Clinic,Electroencephalography,Electroencephalography,Land Improvements,Anesthesiology,IPF,"Sum of lines 3,4 divided by line 6",Utilization Review SNF,Without Outliers:  Total Charges,Renal Dialysis,Respiratory Therapy,Clinic,Ancillary service charges,Radioisotope,Non-Physician Anesthetist Part A,OLTC,Total Program Inpatient Costs,Occupational Therapy,Research,Occupational Therapy,Other Special Care Unit,Recovery Room,"Medical certified lung
transplant center cert date",Cafeteria,RHC/FQHC Combined,RHC,Radioisotope,Radiology-Diagnostic,Medical Supplies Charged to Patients,Burn Intensive Care Unit Program Cost,Other Outpatient Services,Renal Dialysis,Utilization Review SNF,Occupational Therapy,Subprovider-IRF,Electrocardiology,Total,Home Office Salaries,Subtotal Other Wages and Related Csts,"Anesthetist, and Medical Education Costs",Other Reimbursable,Operating Room,MRI,Total Overhead Costs,Clinic,Subtotal Salaries,Whole Blood & Packed Red Blood Cells,Heart Acquisition,Delivery Room and Labor Room,Emergency,Other Special Care Unit,ASC (Non Distinct Part),Clinic,HHA,Stand-alone CHIP cost,Home Office Street,Other Reimbursable,Pancreas Acquisition,FQHC 5 Provider Number,Physician-Part B,Non-Physician Anesthetist Part B,Coronary Care Unit,ASC (Distinct Part),Net Salaries,Medical Supplies Charged to Patients,Subprovider I,Physical Therapy,Medicaid Observation Days,Other Ancillary,Other Outpatient Services,Intensive Care Unit,Non-Physician Anesthetist Part B,Interns & Res Other Program Costs,Blood Clotting Factors for Hemoph.,Total Salaries,Interns & Residents,Liver Acquisition,Home Office Personnel,Electrocardiology,Subprovider-IPF,Number of stations,Laundry and Linen Service,Housekeeping,Subprovider-IRF,Other Outpatient Services,ASC (Non Distinct Part),Respiratory Therapy,OSP,Medical Records and Medical Rec. Library,Surgical Intensive Care Unit,Durable Medical Equipment Rented,Other Nonreimbursable,Total,Speech Pathology,Radiology-Therapeutic,Intensive Care Unit,Adults and Pediatrics,Lung  Acquisition,Total Nursing School,Other Reimbursable,Other Ancillary,"Blood Storing, Processing, Trans",Leasehold Improvements,Emergency,Radioisotope,Surgical Intensive Care Unit,Subtotal Salaries,Other Organ Acquisition,Central Services and Supply,Other Outpatient Services,Blood Clotting Factors for Hemoph.,Interns & Residents,Nursery,net of Swing Bed and Private Room Diff,Laundry and Linen Service,CT Scan,Cardiac Catheterization,Hospice,Other Ancillary,Physician Part A Teaching,Cardiac Catheterization,Medicare Certified Pancreas TC term date,CORF,Respiratory Therapy,Subprovider-IRF,Other Ancillary,Intensive Care Unit,Surgical Intensive Care Unit,Delivery Room and Labor Room,Speech Pathology,Burn Intensive Care Unit,Laboratory,Interns & Residents,Radiology-Therapeutic,Intensive Care Unit,Radiology-Diagnostic,Electroencephalography,Total Fund Balances,Impl. Dev. Charged to Patients,"Number of Times per week
 Patient receives Dialysis",Maintenance and Repairs,Emergency,Home Office:  Physician Part A,Nonpaid Workers,Speech Pathology,Durable Medical Equipment Rented,Organ Procurement,Adj for Physical therapy costs in excess,Other Outpatient Services,Laboratory,Speech Pathology,CORF,Radioisotope,MRI,"Trade, Quantity, and Time Discounts","Blood Storing, Processing, Trans","Sum of lines 3,4 divided by line 6",Physical Therapy,Electroencephalography,Administrative & General under contract,Electrocardiology,Nursing Administration,Nursery,Radioisotope,Electrocardiology,Other Outpatient Services,Other Special Purpose,Home Program Dialysis,Respiratory Therapy,Observation Beds (Distinct Unit),Recovery Room,Total,Other Special Purpose,FQHC 8 Provider Number,Other Outpatient Services,Physician Part B,Respiratory Therapy,Home Office Salaries,FQHC 12 Provider Number,Maintenance and Repairs,Home Office PO Box,ASC (Non Distinct Part),Interns & Residents,Number of EPO units furnished for Line 13,Recovery Room,Operating Room,Speech Pathology,Electroencephalography,net of Swing Bed and Private Room Diff,CORF,Number of periods hospital was in MDH status,Delivery Room and Labor Room,Impl. Dev. Charged to Patients,IRF Provider Number,Delivery Room and Labor Room,Other Reimbursable,Radiology-Diagnostic,Dietary,ASC (Non Distinct Part),RPCH/CAH Visits,Housekeeping,Respiratory Therapy,Contract Labor,PBP Clinical Lab Services Program Only,Electrocardiology,Wage Related Costs RHC/FQHC,Renal 9 Provider Number,Intravenous Therapy,NF,Radioisotope,Administrative and General,Cardiac Catheterization,Employee Benefits,"Sale of scrap, waste, etc.",Total Outpatient Program Pass Thru Cost,Total,RHC,Dietary,Hospice 2 Provider Number,Pharmacy,Intestinal Acquisition,"Gift, Flower, Coffee Shop, Canteen",HRR adjustment amount,Radioisotope,PEP Episodes:  Total Charges:,Paramedical Education,Hospital Adlts & Ped Swing Bed SNF,Hospice,Radiology-Diagnostic,Organ Procurement,Nonpaid Workers,Maintenance of Personnel,Total Swing Bed Cost,Surgical Intensive Care Unit Program Cost,Radioisotope,PBP Clinical Lab Services Program Only,Radiology-Diagnostic,Non-Physician Part B,Cardiac Catheterization,Durable Medical Equipment Rented,Physicians' Assistant,FQHC 1 Provider Number,Speech Pathology,ASC (Non Distinct Part),Pancreas Acquisition,Subtotal,Subprovider II,CT Scan,Physical Therapy,Other Ancillary,Total,Total Hospital,Anesthesiology,Recovery Room,Int & Res (non approved teaching program,Durable Medical Equipment Rented,Allowable Inpatient Cost Plus Incentive Pt,Medical Supplies Charged to Patients,Total Overhead Costs,CORF,ICF,Anesthesiology,Other Reimbursable,Blood Clotting Factors for Hemoph.,Radiology-Diagnostic,HHA 2 Provider Number,CT Scan,Total Subprovider I Interns & Residents,Nonpaid Workers,Cafeteria,Radiology-Diagnostic,Teaching Physician Salaries,Interns & Residents,Hospital Adlts & Ped Swing Bed SNF,Hospital Adults & Ped Swing Bed SNF,FQHC 10 Provider Number,Total,Radiology-Therapeutic,CT Scan,Recovery Room,Interns & Residents,Pharmacy,Laboratory,"Blood Storing, Processing, Trans",Intravenous Therapy,Payment to cost ratio,Hospice 1 Provider Number,Speech Pathology,Wage Related Costs Other,NOT IN THIS FILE,CT Scan,Cost of charity care (patients covered by public program + patients w/ coverage accepted by provider),ASC (Non Distinct Part),Whole Blood & Packed Red Blood Cells,Surgical Intensive Care Unit,Durable Medical Equipment Rented,Total,Other Ancillary,"Number of days in year dialysis 
furnished",Clinic,Other Outpatient Services,Radiology-Diagnostic,Home Program Dialysis,Non-Physician Anesthetist Part A,CMHC,Other Ancillary,Donations,Physical Therapy,Medical Supplies Charged to Patients,Total Outpatient Program Pass Thru Cost,Total Directly Assigned New Cap Rel Csts,"Blood Storing, Processing, Trans",Other Ancillary,Radiology-Therapeutic,Temporary Investments,Operation of Plant,Renal Dialysis,Total,Radiology-Diagnostic,"Blood Storing, Processing, Trans",Without Outliers:  Other Charges,SNF,Coronary Care Unit,Hospice,Laboratory,Heart Acquisition,Excluded Area Salaries,LUPA:  Total Non Routine Med Sup Chgs,Respiratory Therapy,Clinic,Total Charges,Respiratory Therapy,Anesthesiology,Whole Blood & Packed Red Blood Cells,Clinic,Physician Part A,RHC 9 Provider Number,Subtotal,Deductibles and coinsurance,Home Program Dialysis,Impl. Dev. Charged to Patients,FQHC,OOT,Burn Intensive Care Unit,Subprovider-IPF,"Anesthetist, and Medical Education Costs",Radioisotope,Drugs Charged to Patients,Total Facility FTEs,Whole Blood & Packed Red Blood Cells,Interns & Residents,Respiratory Therapy,Home Program Dialysis,Adults & Pediatrics,Total Other Medical Education,Employee Benefits,Research,Clinic,Cardiac Catheterization,Other Reimbursable,Ambulance Services,Total Inpatient Program Days,MRI,Related Organization Transactions,Physicians' Private Office,Kidney Acquisition,OLTC,Home Program Dialysis,Beds Total Hospital,MRI,Maintenance and Repairs,Medicaid (Title XIX) discharges,CMHC,Outpatient Rehab Provider,Physical Therapy,Housekeeping,Respiratory Therapy,Other Special Care Unit,Anesthesiology,Radiology-Therapeutic,CT Scan,Electroencephalography,Home Office Name,"Blood Storing, Processing, Trans",Observation Beds (Distinct Unit),Intravenous Therapy,PEP Episodes:  Total Visits,LUPA Episodes:  Total Number of Episodes,Durable Medical Equipment Rented,Radiology-Diagnostic,ICF,Medical and Other Services reimbursed by OPPS,ASC (Non Distinct Part),Medical Supplies Charged to Patients,Radiology-Therapeutic,Net Income from Service to Patients,Intensive Care Unit,Hospital Provider Number,Total Number of Outlier Episodes,Radioisotope,Negative Cost Centers,Laboratory,Organ Procurement,Dietary under contract,Durable Medical Equipment Sold,Radioisotope,Subtotal,CT Scan,Renal Dialysis,With Outliers:  Total Charges,Coronary Care Unit,Sale of medical and surgical supplies to,Cost of charity care (uninsured patients + patients w/ coverage not accepted by provider),Durable Medical Equipment Rented,Drugs Charged to Patients,Operating Room,Whole Blood & Packed Red Blood Cells,"Blood Storing, Processing, Trans",Does the facility operate an ICF/MR facility for purposes of Title XIX? (Y/N),Radiology-Diagnostic,Medicare Certified Islet TC term date,"Number of Times per week
 Patient receives Dialysis",Medicare Certified Heart TC term date,Subprovider I,CT Scan,Charity care charges and uninsured discounts for the entire facility,Anesthesiology,Wage Related Costs Other,Other Reimbursable,Drugs Charged to Patients,FQHC 9 Provider Number,MCP Physician Payment Method (Y/N),Durable Medical Equipment Sold,Interns & Residents,Observation Beds (Distinct Unit),Other Nonreimbursable,ASC (Non Distinct Part),Anesthesiology,Total,Total,Electroencephalography,Hospital Name,Home Office Salaries & Wage Related Csts,Physicians' Private Office,Emergency,HHA,Other Nonreimbursable,Anesthesiology,HVBP payment adjustment amount,Pancreas Acquisition,Intensive Care Unit,Impl. Dev. Charged to Patients,Radioisotope,RHC 8 Provider Number,Research,Emergency,Radiology-Therapeutic,ASC (Non Distinct Part),Labor and Delivery,Cost of patients approved for charity care and uninsured discounts,Subprovider I,Land,Total,OPT,MRI,Adults & Pediatrics,Respiratory Therapy,New Cap Related Csts Bldg & Fixtures,Interns & Residents,Ambulance Trips,Observation Beds (Distinct Unit),Recovery Room,Ending Date of SCH status,Subprovider II,Report Record Number,Nursing Administration,Whole Blood & Packed Red Blood Cells,Census Division Code,Liver Acquisition,Delivery Room and Labor Room,Utilization Review - Physician Compen,SNF,Total Nonphysician Anesthetist Cost,Kidney Acquisition,Other Ancillary,Occupational Therapy,Recovery Room,Organ acquisition,"Number of patients in program at 
end of cost reporting period",Whole Blood & Packed Red Blood Cells,Medical Supplies Charged to Patients,Delivery Room and Labor Room,Delivery Room and Labor Room,PEP Episodes:  Total Visits,Management and Administrative Services,"Number of patients in program at 
end of cost reporting period",Subprovider II,With Outliers:  Non Routine Med Sup Chgs,Delivery Room and Labor Room,Teaching Physician Salaries,PEP Episodes:  Total Visits,Electrocardiology,Other Special Care Unit,Other Organ Acquisition,Durable Medical Equipment Sold,FQHC 7 Provider Number,Hospital Adlts & Ped Swing Bed NF,Physical Therapy,IPF,Occupational Therapy,Occupational Therapy,Anesthesiology,Total,Renal Dialysis,Subtotal,SNF,Impl. Dev. Charged to Patients,Outpatient Revenue,Ambulance Services,Housekeeping,Other Ancillary,SNF,Other Outpatient Services,Other Special Purpose,Blood Clotting Factors for Hemoph.,Administrative and General under Contract,Other Reimbursable,Whole Blood & Packed Red Blood Cells,Impl. Dev. Charged to Patients,Ambulance Services,Fixed Equipment,Whole Blood & Packed Red Blood Cells,Recovery Room,Physical Therapy,ICF,Fiscal Year Begin Date,Home Office Salaries,Occupational Therapy,Operating Room,Total Adults & Peds,Drugs Charged to Patients,Recovery Room,Total,Drugs Charged to Patients,ASC (Non Distinct Part),Other Ancillary,With Outliers:  Total Visits,Laboratory,Total Other Medical Education,Other Ancillary,Subprovider-IPF,Renal Dialysis,Burn Intensive Care Unit,Nursing School,"Is this a New Hospital under
42 CFR 412.300 PPS capital
(Y/N)",Anesthesiology,RHC 18 Provider Number,Islet Acquisition,Excluded Area Salaries,Organ Procurement,Physical Therapy,Maintenance of Personnel,"Income from imposition of interest, finance",MRI,Speech Pathology,Teaching Physician Salaries,Islet Acquisition,Laundry and Linen Service,Physical Therapy,Laboratory,Total discharges,Nursing Administration,Adults and Pediatrics,Nonpaid Workers,CMHC,Surgical Intensive Care Unit,Operating Room,Impl. Dev. Charged to Patients,Other General Service,Electroencephalography,Telephone Services,Other Reimbursable,Buildings and Fixtures,Whole Blood & Packed Red Blood Cells,Report Status Code,Respiratory Therapy,Without Outliers:  Total Charges,Renal 10 Provider Number,Medicare Certified Kidney TC term date,Net Revenue from stand-alone SCHIP,Kidney Acquisition,ASC (Non Distinct Part),Social Service,Housekeeping,Lesser of cost or charges,Physician Part A,OPPS payments,Physicians' Private Office,Recovery Room,CMHC,Medical Supplies Charged to Patients,New Cap Related Csts Movable Equipment,Pancreas Acquisition,RHC 15 Provider Number,Pharmacy,Renal Dialysis,New Cap Related Csts Movable Equipment,Surgical Intensive Care Unit,Islet Acquisition,Total,Physical Therapy,Observation Beds (Distinct Unit),With Outliers:  Other Charges,certification date,NF Provider Number,Laboratory,Subtotal,SNF,Total Assets,Subprovider-IRF,Laundry and Linen Service,Occupational Therapy,New Capital Equipment,Renal Dialysis,Ambulance Services,Total,Ambulance Services,Subprovider-IRF,Durable Medical Equipment Sold,Medical Supplies Charged to Patients,LUPA Episodes:  Total Number of Episodes,ASC (Distinct Part),ASC (Non Distinct Part),Other Outpatient Services,Medical Supplies Charged to Patients,Intestinal Acquisition,Ending Balance,Blood Clotting Factors for Hemoph.,Self Insurance,Home Office Salaries & Wage Related Csts,Delivery Room and Labor Room,Durable Medical Equipment Sold,RHC/FQHC Combined,Balance due provider/program,SNF Provider Number,Management and Administrative Services,Total,NF,Cardiac Catheterization,Operating Room,Other Outpatient Services,Heart Acquisition,Drugs Charged to Patients,Radioisotope,Nursery,Hospital City,Outpatient Rehab Provider,Speech Pathology,Home Program Dialysis,Surgical Intensive Care Unit,Outlier payments,General Fund Balance,Coronary Care Unit,PBP Clinical Lab Services Program Only,Physical Therapy,Durable Medical Equipment Rented,CMHC,Land,CT Scan,Emergency,Deferred Income,Anesthesiology,Other Outpatient Services,MRI,Delivery Room and Labor Room,HHA,Assets,Speech Pathology,Cardiac Catheterization,Buildings and Fixtures,Medical Supplies Charged to Patients,Employee Benefits,Operation of Plant,Rental of quarters to employee and oths,Operating Room,Radiology-Diagnostic,Surgical Intensive Care Unit,Operation of Plant,Total Charges:  LUPA Episodes,Burn Intensive Care Unit,Movable Equipment,Home Program Dialysis,Other Capital,Electrocardiology,Other Special Care,Other General Service,Excluded Area Salaries,Subprovider-IPF,Total Program Excludable Costs,Other Reimbursable,TOTAL,Program Ancillary Services,FQHC,Blood Clotting Factors for Hemoph.,Parking Lot,With Outliers:  Total Charges,Other Reimbursable,MRI,Subtotal,Drugs Charged to Patients,Delivery Room and Labor Room,Coronary Care Unit,Other Special Care Unit,Drugs Charged to Patients,Liver Acquisition,ICF,Operating Room,SNF,Other Reimbursable,Emergency,Social Service,Total Long-term Liabilities,Speech Pathology,Durable Medical Equipment Sold,Utilization,Physical Therapy,Impl. Dev. Charged to Patients,NF,Coronary Care Unit,Durable Medical Equipment Rented,Land Improvements,Subprovider-IRF,Social Service,PEP:  Total Non Routine Med Supply Chgs,Subprovider II,MRI,MRI,Buildings and Fixtures,CT Scan,Other Special Care Unit,MRI,Occupational Therapy,Anesthesiology,Renal Dialysis,Subprovider-IRF,Speech Pathology,ASC (Non Distinct Part),Electrocardiology,CT Scan,"Blood Storing, Processing, Trans",Number of stations,Whole Blood & Packed Red Blood Cells,Electroencephalography,Nonphysician Anesthetists,Charity care charges and uninsured discounts for the entire facility,Central Services and Supply,Intravenous Therapy,Other Outpatient Services,Intensive Care Unit,Radioisotope,Respiratory Therapy,Intravenous Therapy,Total,Intravenous Therapy,Laboratory,Other Special Care Unit,Total Other Expenses,"Blood Storing, Processing, Trans","Gift, Flower, Coffee Shop, Canteen",SNF,RHC 12 Provider Number,Ambulance Services,Interest Expense,Observation Beds (Distinct Unit),Utilization,Medical Records & Med Records Library,ASC (Non Distinct Part),Lung  Acquisition,Liver Acquisition,Impl. Dev. Charged to Patients,Mortgage Payable,CORF,Cafeteria employees and guests,Islet Acquisition,RHC 16 Provider Number,"Is this a teaching hospital or
affiliated with a teaching hospital? (Y/N)",LUPA:  Total Non Routine Med Sup Chgs,Operating Room,Radiology-Therapeutic,"Blood Storing, Processing, Trans",OOT,"Blood Storing, Processing, Trans",OLTC,Radiology-Diagnostic,Delivery Room and Labor Room,Interest expense on Medicare Overpaymts,Adj for Occupational therapy in excess of li,MRI,"Blood Storing, Processing, Trans",Non-Physician Anesthetist Part B,Cost of patients approved for charity care and uninsured discounts,Intravenous Therapy,Interns & Res Other Program Costs,ASC (Non Distinct Part),"Blood Storing, Processing, Trans",Hospice,Paid Losses,Occupational Therapy,Total Hospital,Blood Clotting Factors for Hemoph.,HHA,Administrative and General,ASC (Non Distinct Part),Electroencephalography,FQHC 4 Provider Number,Emergency,Other Reimbursable,Recovery Room,Renal Dialysis,FQHC,Pharmacy,Anesthesiology,LUPA Episodes:  Total Number of Episodes,Clinic,Anesthesiology,Drugs Charged to Patients,NF,Other Ancillary,Heart Acquisition,Other Special Care Unit,W/Out Outliers:  Number of Episodes,Total Non Routine Medical  Supply Charges,NF,Other Outpatient Services,Ambulance Services,Physicians' Private Office,Physical Therapy,Maintenance of Personnel,Total Fixed Assets,Movable Equipment,Medical Supplies Charged to Patients,Other Special Purpose,CAPD exchanges per day,Central Services and Supply,Blood Clotting Factors for Hemoph.,Renal Dialysis,NF,Home Office:  Physician Part A,Renal 4 Provider Number,Renal Dialysis,Anesthesiology,CMHC,Without Outliers:  Other Charges,Electroencephalography,Other Reimbursable,RHC/FQHC Combined,OSP,Drugs Charged to Patients,Electrocardiology,New Capital Buildings and Fixtures,"Blood Storing, Processing, Trans",Paramedical Education,Intravenous Therapy,Excluded Area Salaries,Clinic,"Number of patients in program at 
end of cost reporting period",Less Observation Beds,Observation Beds (Distinct Unit),Burn Intensive Care Unit,Intensive Care Unit,Electroencephalography,CT Scan,Organ acquisition charges,FQHC,Coronary Care Unit,Renal Dialysis,Respiratory Therapy,Impl. Dev. Charged to Patients,Administrative and General,Paramedical Education,Emergency,HHA,HMO,Burn Intensive Care Unit,Land Improvements,MRI,HHA,Impl. Dev. Charged to Patients,Recovery Room,Aggregate amount collected from patients,FQHC 11 Provider Number,MRI,Operating Room,Subprovider 2,Nursery,Purchase,Intensive Care Unit,Paramedical Education,net of Swing Bed and Private Room Diff,Home Office Salaries,Clinic,Nonpaid Workers,Total,OLTC,MRI,Observation Beds (Distinct Unit),Nursing Administration,Laboratory,Delivery Room and Labor Room,MDH status beginning date (MM/DD/YY),Respiratory Therapy,Renal Dialysis,In State Medicaid eligible days,New Cap Related Csts Bldg & Fixtures,"Blood Storing, Processing, Trans",Other Special Care Unit,Administrative and General,HHA,Electrocardiology,Recovery Room,Cardiac Catheterization,Total costs for patients covered by a state or local government program,Subprovider I,Renal 2 Provider Number,Impl. Dev. Charged to Patients,Int & Res (non approved teaching program,Total Hospital Interns & Residents,RHC/FQHC Combined,Housekeeping under Contract,Cost of Uncompensated Care,Building Improvements,Ambulance Services,Other Reimbursable,OSP,Related Salaries,Other Reimbursable,Social Service,Renal Dialysis,Medical Supplies Charged to Patients,SNF,Speech Pathology,Whole Blood & Packed Red Blood Cells,Clinic,Cardiac Catheterization,"Are there any related organization or how office costs as defined in HCFA Pub. 15-I, chapter 10? (Y/N)",Impl. Dev. Charged to Patients,Delivery Room and Labor Room,Occupational Therapy,Other Ancillary,Hospice,Non-Physician Anesthetist Part A,Subprovider-IRF,Hospital Zip Code,Intravenous Therapy,Laboratory,Excluded Area Salaries,Total Program General Inpatient Routine,OLTC,Hospice,Intravenous Therapy,Total Adults & Peds,Cafeteria,Electroencephalography,CT Scan,OOT,Subprovider 1,FQHC,OPT,Land Improvements,Nursery,Whole Blood & Packed Red Blood Cells,Other Adjustments (Summed),PBP Clinical Lab Services Program Only,Cardiac Catheterization,Total Visits,Excluded Areas,Average times dialyzers re-used,ASC (Non Distinct Part),Electrocardiology,Int & Res (non approved teaching program,Inpatient Revenue,Speech Pathology,Radioisotope,Pancreas Acquisition,ICF,Laboratory,Drugs Charged to Patients,Operating Room,Total Subprovider I Interns & Residents,Subprovider I,Pancreas Acquisition,Blood Clotting Factors for Hemoph.,Electroencephalography,Durable Medical Equipment Sold,Medical Supplies Charged to Patients,Respiratory Therapy,Operating Room,New Cap Related Csts Movable Equipment,Intravenous Therapy,Impl. Dev. Charged to Patients,Total Operating Expense,Hospital Adults & Pediatrics,Contract Labor,Subprovider I,Title XVIII discharges,Emergency,Occupational Therapy,Are provider based physicians' costs included in Worksheet A? (Y/N),Respiratory Therapy,Cardiac Catheterization,Anesthesiology,Interns & Residents,Subprovider-IRF,Buildings and Fixtures,ASC (Non Distinct Part),ASC (Distinct Part),Cardiac Catheterization,Pharmacy,Drugs Charged to Patients,Occupational Therapy,Renal Dialysis,Renal 5 Provider Number,New Capital Buildings and Fixtures,"Blood Storing, Processing, Trans",Ambulance Services,Subprovider I,Is this a rural hospital qualifying for an exception to the certified registered nurse anesthetist the CRNA fee schedule? (Y/N),Operation of Plant,CT Scan,Other Special Care Unit,Medicare Certified Liver TC term date,Other Ancillary,Outpatient Rehab Provider,Subprovider-IRF,Clinic,Intravenous Therapy,Health Information Technology Designated Assets,HHA,Other Special Purpose,SNF,Intravenous Therapy,Whole Blood & Packed Red Blood Cells,Other Ancillary,SNF,Building Improvements,MRI,Speech Pathology,OLTC,Total,Medical Supplies Charged to Patients,"Number of Times per week 
Patient receives Dialysis",Television and Radio Service,RHC,Kidney Acquisition,Interns & Res Salary and Fringe Benefits,Liver Acquisition,Stand-alone CHIP -- Costs minus net revenue (0 min),Home Program Dialysis,Lung  Acquisition,Whole Blood & Packed Red Blood Cells,Renal Dialysis,Anesthesiology,Physician Part B,Total,Int & Res (non approved teaching program,Intravenous Therapy,Electroencephalography,Other Special Care,Respiratory Therapy,Interns & Res Other Program Costs,OLTC,Other Reimbursable,Total Number of Outlier Episodes,Electrocardiology,Clinic,interns and residents,Kidney Acquisition,Central Services and Supply,RHC 6 Provider Number,Other Special Purpose,Other Ancillary,TOTAL,Amounts expected under 42 CFR,Subtotal,Renal Dialysis,Lung  Acquisition,Whole Blood & Packed Red Blood Cells,Total,Clinic,Admin & Gen Under Contract,Pancreas Acquisition,Total,RHC/FQHC Combined,Electrocardiology,ASC (Distinct Part),Payments received from patients for amounts previously written off as charity care,Speech Pathology,Subprovider-IPF,Total reasonable charges,Anesthesiology,Laboratory,Occupational Therapy,Other Reimbursable,Other Special Care Unit,Laboratory,RHC,Observation Beds (Distinct Unit),Surgical Intensive Care Unit,ICF,Intravenous Therapy,Other Special Care Unit,Radiology-Therapeutic,Hospice,Interns & Residents,MRI,Other Outpatient Services,Intensive Care Unit,"Treatment capacity per day per
station",Observation Beds (Distinct Unit),Program Inpatient Ancillary Service Cost,Radioisotope,Total Hospital,Home Program Dialysis,Delivery Room and Labor Room,Speech Pathology,Emergency,Whole Blood & Packed Red Blood Cells,Subprovider II,Partial or full credits from manufacturers,SNF,Durable Medical Equipment Sold,certification date,Total,Surgical Intensive Care Unit,Non-physician Anesthetist,Other Current Assets,Excess of customary charges,Minor Equipment Depreciable,Intensive Care Unit,Total Liabilities,SNF,"Medical certified liver 
transplant center cert date",Total unreimbursed cost for Medicaid and CHIP and state and local indigent care programs,ASC (Distinct Part),Interns & Res Salary and Fringe Benefits,Durable Medical Equipment Sold,Medical Supplies Charged to Patients,With Outliers:  Number of Episodes,Other Organ Acquisition,Electrocardiology,Zip Code,Home Program Dialysis,Respiratory Therapy,Radiology-Diagnostic,Dietary,Surgical Intensive Care Unit,FQHC 3 Provider Number,Dietary,Delivery Room and Labor Room,Intravenous Therapy,Impl. Dev. Charged to Patients,Premiums,Total Allied Health,Hospital Adults & Pediatrics,Management and Administrative Services,Subprovider-IRF,Without Outliers:  Non Routine Med Sup Chgs,Total Salaries,CT Scan,Delivery Room and Labor Room,Deductibles and coinsurance related to line 24,Out of State Medicaid eligible days,Total discharges,Administrative and General under Contract,IPF,Dietary,Impl. Dev. Charged to Patients,Hospice,"Epoietin amount form worksheet A
for home dialysis program",Delivery Room and Labor Room,PBP Clinical Lab Services Program Only,New Capital Equipment,Radiology-Therapeutic,Drugs Charged to Patients,Nonphysician Anesthetists,CORF,ASC (Non Distinct Part),Ambulance Services,Medicaid charges,"Blood Storing, Processing, Trans",Land,Speech Pathology,Pancreas Acquisition,Nonphysician Anesthetists,Emergency,Other Ancillary,Medical Supplies Charged to Patients,Whole Blood & Packed Red Blood Cells,Coronary Care Unit,Subtotal,Drugs Charged to Patients,Labor and Delivery Days -  Title XIX,Observation Beds (Distinct Unit),Buildings and Fixtures,Beginning Date of SCH status,In State Medicaid paid days,Other General Service,Total Charges,Intensive Care Unit,Depreciation-New Movable Equipment,"Medicare certified heart
transplant center cert date",Intravenous Therapy,Durable Medical Equipment Sold,Electroencephalography,Home Program Dialysis,Observation Beds (Distinct Unit),Other Nonreimbursable,Intravenous Therapy,ASC (Non Distinct Part),Coronary Care Unit,Medical Supplies Charged to Patients,Medical Supplies Charged to Patients,Coronary Care Unit,MRI,Durable Medical Equipment Rented,Emergency,Emergency,Notes Payable,Radiology-Therapeutic,Radiology-Therapeutic,Electroencephalography,Title XVIII discharges,Dietary under Contract,Whole Blood & Packed Red Blood Cells,Non-Physician Part B,CT Scan,Operating Room,Organ Procurement,Labor and Delivery Days Title 18,Surgical Intensive Care Unit,Total Program General Inpatient Routine,"Blood Storing, Processing, Trans",Radiology-Therapeutic,ASC (Distinct Part),Other Outpatient Services,Recovery Room,Hospice 3 Provider Number,Medical Supplies Charged to Patients,Intensive Care Unit,Adults and Pediatrics,Employee Benefits,Other Special Purpose,Delivery Room and Labor Room,Total,NF,Medical Supplies Charged to Patients,ICF,Drugs Charged to Patients,Nursery,Pancreas Acquisition,Nursing School,Speech Pathology,Blood Clotting Factors for Hemoph.,Laundry and Linen Service,Blood Clotting Factors for Hemoph.,Land Improvements,RPCH/CAH Visits,Operating Room,Total Hospital,Maintenance of Personnel,Contract Labor,Title V discharges,Maintenance of Personnel,"Gift, Flower, Coffee Shop, Canteen",Home Program Dialysis,Physical Therapy,Laboratory,Electroencephalography,CT Scan,Other Special Care Unit,Recovery Room,Utilization Review SNF,Dietary under Contract,Operating Room,PBP Clinical Lab Services Program Only,Radiology-Diagnostic,Burn Intensive Care Unit,Without Outliers:  Other Charges,Movable Equipment,Subprovider-IRF,PEP:  Total Number of Outlier Episodes,Fixed Equipment,Durable Medical Equipment Sold,Coronary Care Unit,Respiratory Therapy,Hospice,Radiology-Therapeutic,Delivery Room and Labor Room,Drugs Charged to Patients,Hospice,Other Special Care,Less Contractual Allowance and Discounts on Patients' Accounts,Electroencephalography,Payroll taxes payable,"If this facility qualifies as a RPCH/CAH, has it elected the all inclusive payment for outpatient service? (Y/N)",Radiology-Therapeutic,Electroencephalography,Total Subprovider II Interns & Residents,Subprovider-IPF,"Gift, Flower, Coffee Shop, Canteen",Islet Acquisition,Have you established a new subprovider excluded unit under 42 CFR 413.40(f)(1)(I)?(Y/N),Physical Therapy,Recovery Room,Other adjustments,Operating Room,Recovery Room,Unsecured Loans,Cafeteria,OSP,Anesthesiology,RHC 3 Provider Number,OLTC,Coronary Care Unit,Drugs Charged to Patients,Observation Beds (Distinct Unit),Accounts Receivable,Impl. Dev. Charged to Patients,CT Scan,OSP,Administrative & General under contract,Non-Physician Part B,Anesthesiology,Housekeeping under Contract,Subprovider-IPF,Emergency,Speech Pathology,Ratio of line 15 to line 16,HHA,Subprovider-IPF,Cardiac Catheterization,Without Outliers:  Total Visits,OSP,Home Program Dialysis,NF,Intravenous Therapy,Radioisotope,Net Salaries,Coronary Care Unit,CT Scan,Other General Service,CT Scan,Other Organ Acquisition,Pass Through Cost for  Program Ancillary,Burn Intensive Care Unit,Observation Beds (Distinct Unit),Other Special Care,IRF,Durable Medical Equipment Rented,Laboratory,Subprovider 1,Wage Related Costs Core,ASC (Non Distinct Part),Sequestration adjustment,Blood Clotting Factors for Hemoph.,Net Revenue from Medicaid,Laboratory,Intestinal Acquisition,Radiology-Therapeutic,Laboratory,Total Number of Episodes,Delivery Room and Labor Room,Subprovider-IPF,Impl. Dev. Charged to Patients,Total Program General Inp. Rtn Service,State,Nonpaid Workers,Cardiac Catheterization,Intravenous Therapy,Total Hospital Interns & Residents,Private grants or donations or endowment income restricted to funding charity care,Ambulance Services,Other Special Purpose,PEP Episodes:  Total Number of Episodes,Speech Pathology,Renal Dialysis,Pancreas Acquisition,Radiology-Diagnostic,Medical Supplies Charged to Patients,Durable Medical Equipment Sold,Heart Acquisition,Total Outpatient Program Pass Thru Cost,Drugs Charged to Patients,RHC 1 Provider Number,OOT,RHC 10 Provider Number,Liver Acquisition,ASC (Distinct Part),Operating Room,Total,Subtotal Wage Related Csts,Other Special Care,Renal Dialysis,Intravenous Therapy,Operating Room,Without Outliers:  Total Visits,Durable Medical Equipment Rented,MRI,Recovery Room,Out of State Medicaid paid days,Physical Therapy,Total,OLTC,Operation of Plant,HHA 3 Provider Number,Whole Blood & Packed Red Blood Cells,RHC,Does the hospital elect a fully prospective payment method for capital costs? (Y/N),W/Out Outliers:  Number of Episodes,Other Reimbursable,Renal Dialysis,Other Reimbursable,Emergency,Research,Total,Hospital Adults & Pediatrics,NF,Operating Room,Clinic,Radioisotope,"Gift, Flower, Coffee Shop, Canteen",Drugs Charged to Patients,CT Scan,Other Outpatient Services,Emergency,"Percentage of patients re-using
dialyzers",Occupational Therapy,OPT,Electrocardiology,Total Non Routine Medical  Supply Charges,Electroencephalography,Recovery Room,Renal Dialysis,Islet Acquisition,Geographic MSA,Laboratory,Laboratory,Total unreimbursed and uncompensated care,Total Charges,Laundry and Linen Service,Pass through Cost for Program Inpatient,PBP Clinical Lab Services Program Only,Cardiac Catheterization,Int & Res (non approved teaching program,Total,Related  Salaries,Pass through Cost for Program Inpatient Routine,Other Outpatient Services,Maintenance of Personnel,Medical and Other Services reimbursed by OPPS,Non-Physician Part B,Total Costs,Lung  Acquisition,Title V discharges,Intestinal Acquisition,OPT,"Number of patients in program at 
end of cost reporting period",Heart Acquisition,Anesthesiology,MRI,Total cost,Renal Dialysis,Other General Service,Electroencephalography,Contract Labor,Medical and Other Services,With Outliers:  Number of Episodes,Organ Procurement,Emergency,Adults & Pediatrics,Surgical Intensive Care Unit,Clinic,Cardiac Catheterization,Other Outpatient Services,Medical Records & Med Records Library,IPF Provider Number,Intensive Care Unit,Speech Pathology,Operating Room,Total Other Income,Durable Medical Equipment Sold,Other Organ Acquisition,PBP Clinical Lab Services Program Only,Clinic,Drugs Charged to Patients,Cardiac Catheterization,ASC (Distinct Part),Burn Intensive Care Unit,Total Facility FTEs,Kidney Acquisition,Occupational Therapy,CMHC,net of Swing Bed and Private Room Diff,Line 2 times line 5,Hospital Street Address,RHC 25 Provider Number,Total,Clinic,Other Outpatient Services,Cardiac Catheterization,Program Inpatient Ancillary Service Cost,Other Outpatient Services,Subprovider-IRF,Operating Room,Clinic,Laboratory,Total Visits,Other Ancillary,Blood Clotting Factors for Hemoph.,Islet Acquisition,Emergency,Durable Medical Equipment Rented,Intestinal Acquisition,Radiology-Therapeutic,IPF,ASC (Non Distinct Part),Total discharges,Durable Medical Equipment Rented,MRI,Radiology-Therapeutic,CT Scan,"Blood Storing, Processing, Trans",Subprovider II,Cardiac Catheterization,Employee Benefits,"Average patient dialysis time 
including setup",Operating Room,Ending Date of SCH status,Delivery Room and Labor Room,Total,New Capital Buildings and Fixtures,Lung  Acquisition,"Blood Storing, Processing, Trans",ASC (Non Distinct Part),Other Reimbursable,Total,Other Nonreimbursable,Kidney Acquisition,Coronary Care Unit,Other Organ Acquisition,Medical Records and Medical Rec. Library,Delivery Room and Labor Room,Surgical Intensive Care Unit,SNF,Physical Therapy,LUPA Episodes:  Other Charges,Radiology-Therapeutic,FQHC,Admin & Gen Under Contract,State or local govt (not Medicaid or CHIP) -- Costs minus net revenue (0 min),Home Office Personnel,FQHC,NF,HHA,MRI,Medical Supplies Charged to Patients,Impl. Dev. Charged to Patients,Other Ancillary,"Number of patients in program at 
end of cost reporting period",Total Number of Episodes,New Cap Related Csts Bldg & Fixtures,Adults & Pediatrics,Recovery Room,Total,Delivery Room and Labor Room,Contract Labor:  Physician Part A,Payments received from patients for amounts previously written off as charity care,Nursery,Dietary under contract,"Gift, Flower, Coffee Shop, Canteen",Begin Balance,Radiology-Diagnostic,Ancillary service other pass through costs,Total Other Assets,Nonpaid Workers,PEP Episodes:  Other Charges,Nursing School,Cross Foot Adjustments,Other Ancillary,Total,Teaching Physician Salaries,Medical Records & Med Records Library,Physician-Part B,Pancreas Acquisition,Respiratory Therapy,Emergency,RHC 23 Provider Number,Interns & Residents,Subtotal Other Wages and Related Csts,Coronary Intensive Care Unit,Electrocardiology,Without Outliers:  Non Routine Med Sup Chgs,IPF Provider Number,Drugs Charged to Patients,Pass Through Cost for  Program Ancillary,Net Patient Revenue,Coronary Care Unit,Operating Room,Radioisotope,Other General Service,Total Visits,Subprovider II,Total Bad Debt expense,Physical Therapy,Other Outpatient Services,Recovery Room,Social Service,Emergency,Intestinal Acquisition,Lung  Acquisition,Building Improvements,Respiratory Therapy,Social Service,Medical Supplies Charged to Patients,Whole Blood & Packed Red Blood Cells,Other General Service,PBP Clinical Lab Services Program Only,Electroencephalography,Radiology-Therapeutic,Physical Therapy,Occupational Therapy,Cost of physicians svcs in a teaching hospita,Total customary charges,Laboratory,Electroencephalography,Fiscal Year End Date,Operating Room,TOTAL,Without Outliers:  Non Routine Med Sup Chgs,Laundry and Linen Service,Int & Res (non approved teaching program,Speech Pathology,Radiology-Therapeutic,Clinic,Cardiac Catheterization,"Blood Storing, Processing, Trans",Transitional corridor payment,Number of stations,Intravenous Therapy,Subprovider II,Occupational Therapy,MRI,Inventory,Vending Machines,Other Organ Acquisition,Adults and Pediatrics,Blood Clotting Factors for Hemoph.,Nursing Administration,Renal Dialysis,Radiology-Diagnostic,Clinic,With Outliers:  Total Charges,RHC 2 Provider Number,IRF,Blood Clotting Factors for Hemoph.,Electroencephalography,Radiology-Diagnostic,ASC (Distinct Part),Other Current Liabilities,Adults & Pediatrics,Interns and residents,Intensive Care Unit,Emergency,Physician Part A,Electroencephalography,Clinic,Observation Beds (Distinct Unit),City,Renal Dialysis,"Number of patients on transplant 
list",Intravenous Therapy,Adj for Speech therapy in excess of lim,Other Organ Acquisition,HHA,Lung  Acquisition,Durable Medical Equipment Rented,Radiology-Therapeutic,NF,Outpatient Rehab Provider,RHC,Other Ancillary,Speech Pathology,Observation Beds (Distinct Unit),Anesthesiology,Subtotal Other Wages and Related Csts,Home Program Dialysis,Physical Therapy,Hospital Adults & Pediatrics,Contract Labor:  Physician Part A,NF,"Number of patients transplanted 
during fiscal year",Excluded Area Salaries,RHC,Blood Clotting Factors for Hemoph.,Durable Medical Equipment Sold,HHA,Delivery Room and Labor Room,RHC 14 Provider Number,Other Outpatient Services,CORF,Impl. Dev. Charged to Patients,"Blood Storing, Processing, Trans","Net costs of Epoietin furnished to
all maintenance dialysis patients
by the provider",Other Ancillary,Provider's actual MSA or CBSA,Int & Res (non approved teaching program,Intravenous Therapy,Electrocardiology,Burn Intensive Care Unit,Other Reimbursable,Kidney Acquisition,Radioisotope,Interns & Res Salary and Fringe Benefits,RHC 19 Provider Number,Emergency,Radiology-Diagnostic,Radiology-Diagnostic,SNF,Durable Medical Equipment Rented,Electrocardiology,Intravenous Therapy,Electroencephalography,OSP,Whole Blood & Packed Red Blood Cells,Sale of drugs to other than patients,Other Nonreimbursable,Surgical Intensive Care Unit,Anesthesiology,Other Outpatient Services,Cost of patients approved for charity care and uninsured discounts,Other Reimbursable,Other Capital,MRI,Employee Benefits,Drugs Charged to Patients,OOT,Wage Related Costs RHC/FQHC,Durable Medical Equipment Sold,Provider-based physician adjustment,Physical Therapy,Subprovider-IPF,Laboratory,Impl. Dev. Charged to Patients,Surgical Intensive Care Unit,Intravenous Therapy,"Blood Storing, Processing, Trans",Central Services and Supply,Renal Dialysis,Total Number of Outlier Episodes,CT Scan,Other Assets,Respiratory Therapy,Subtotal Other Wages and Related Csts,Emergency,Speech Pathology,Emergency,ASC (Non Distinct Part),Subprovider 1,Medical Records and Medical Rec. Library,Total Number of Episodes,Physical Therapy,Whole Blood & Packed Red Blood Cells,ASC (Non Distinct Part),Disp. And Retirement,Respiratory Therapy,New Capital Equipment,Whole Blood & Packed Red Blood Cells,Allowable bad debts,Electroencephalography,Total Program Inpatient Costs,"Blood Storing, Processing, Trans",Occupational Therapy,Cost of charity care,Cardiac Catheterization,CMS Region Code,Subprovider-IPF,With Outliers:  Non Routine Med Sup Chgs,Major Movable Equipment,Central Services and Supply,Burn Intensive Care Unit,OOT,FQHC 6 Provider Number,Other Reimbursable,OPPS payments,Medical Supplies Charged to Patients,Maintenance of Personnel,Total Facility FTEs,Radioisotope,Operating Room,RHC,Medical Supplies Charged to Patients,LUPA:  Total Non Routine Med Sup Chgs,Electrocardiology,Operation of Plant,MRI,PEP:  Total Non Routine Med Supply Chgs,MRI,Clinic,Anesthesiology,Observation Beds (Distinct Unit),RHC/FQHC Combined,RHC,Radiology-Diagnostic,ICF,Intestinal Acquisition,Total Nonphysician Anesthetist Cost,Recovery Room,Drugs Charged to Patients,Title V discharges,Total Salaries,Durable Medical Equipment Rented,Intravenous Therapy,Recovery Room,MRI,Subprovider-IRF,Other Ancillary,New Cap Related Csts Bldg & Fixtures,net of Swing Bed Cost,Observation Beds (Distinct Unit),Hospice,NF,Blood Clotting Factors for Hemoph.,Surgical Intensive Care Unit,Delivery Room and Labor Room,Durable Medical Equipment Rented,MRI,PBP Clinical Lab Services Program Only,FQHC 2 Provider Number,Other Ancillary,Radiology-Therapeutic,HHA,Coronary Intensive Care Unit,Radioisotope,Impl. Dev. Charged to Patients,Interest Expense,Respiratory Therapy,TOTAL,Pharmacy,Drugs Charged to Patients,NF,Electroencephalography,Title XVIII discharges,Housekeeping under contract,Administrative and General,Total Nursing School,Renal 6 Provider Number,"If this Hospital is claiming cost for renal services on Worksheet A, are they inpatient services only? (Y/N)",Islet Acquisition,Hospice,Delivery Room and Labor Room,ESRD DME costs,Cash on Hand and in Banks,Other General Service,Subtotal Wage Related Csts,Intensive Care Unit,Intravenous Therapy,Whole Blood & Packed Red Blood Cells,Drugs Charged to Patients,Other Reimbursable,Impl. Dev. Charged to Patients,Delivery Room and Labor Room,Recovery Room,HAC reduction adjustment amount,Radiology-Therapeutic,Liver Acquisition,Burn Intensive Care Unit,Respiratory Therapy,net of Swing Bed Cost,IRF Provider Number,Radiology-Diagnostic,Title XVIII discharges,Anesthesiology,RHC 4 Provider Number,Interns & Residents,Durable Medical Equipment Rented,Without Outliers:  Total Visits,Intensive Care Unit,Laboratory,Laundry and Linen Service,Radiology-Diagnostic,Observation Beds (Distinct Unit),Subprovider I,Gross Revenue,Physical Therapy,Laboratory,Drugs Charged to Patients,PEP:  Total Non Routine Med Supply Chgs,Delivery Room and Labor Room,Surgical Intensive Care Unit,HHA,Medicare allowable bad debts for the entire hospital complex,Medical Supplies Charged to Patients,Total,Medicaid (Title XIX) discharges,RHC,Hospital Type,"If Line 32, Col 1 is yes, enter the method used: (A, B, or E only)",Subprovider-IPF,Radiology-Therapeutic,Renal Dialysis,Radiology-Diagnostic,"If an Organ Procurement Organization, enter the OPO number",Durable Medical Equipment Sold,Total,Emergency,Speech Pathology,Other Reimbursable,Coronary Care Unit,Electroencephalography,Physician-Part B,SNF,Movable Equipment,Subtotal Salaries,Radiology-Therapeutic,Intensive Care Unit,Whole Blood & Packed Red Blood Cells,Physical Therapy,Subprovider-IRF,Total,Drugs Charged to Patients,Dietary,"Average patient dialysis time 
including setup",Cardiac Catheterization,ASC (Non Distinct Part),Laboratory,Burn Intensive Care Unit,Physician-Part A,Primary payer payments,Physical Therapy,Liver Acquisition,Occupational Therapy,Speech Pathology,Subprovider-IPF,Radioisotope,Less: Allowances for uncollectible notes and accounts receivable,Central Services and Supply,Subtotal Wage Related Csts,Home Office Personnel,Occupational Therapy,Total Hospital,Occupational Therapy,Intravenous Therapy,Occupational Therapy,Impl. Dev. Charged to Patients,Delivery Room and Labor Room,Anesthesiology,Home Program Dialysis,Intravenous Therapy,Radiology-Diagnostic,Other Ancillary,Operating Room,Buildings,HHA 1 Provider Number,Negative Cost Centers,Total,Anesthesiology,Intravenous Therapy,Operation of Plant,Laboratory,Physical Therapy,Delivery Room and Labor Room,Medicare reimbursable bad debts for the entire hospital complex,CORF,Impl. Dev. Charged to Patients,or allied health costs?,HMO,Other Ancillary,Medical Supplies Charged to Patients,Housekeeping,Contract Labor: Pysician Part A,Other Long-term Liabilities,Electrocardiology,Physician Part A Teaching,Radiology-Therapeutic,Subtotal,Physical Therapy,Coronary Intensive Care Unit,New Cap Related Csts Bldg & Fixtures,With Outliers:  Total Visits,Physical Therapy,New Cap Related Csts Movable Equipment,Durable Medical Equipment Rented,Land,Liver Acquisition,RHC 24 Provider Number,SSA State County Code,Delivery Room and Labor Room,Utilization Review-physicians compens,Physician-Part B,PEP Episodes:  Total Charges:,Operating Room,net of Swing Bed Cost,Other Outpatient Services,Pharmacy,Radioisotope,Non-Physician Anesthetist Part A,Total Hospital,Subtotal Salaries,Clinic,Physician-Part A,FQHC,Respiratory Therapy,Organ Procurement,Utilization Code (L/N/F),Burn Intensive Care Unit,CMHC,RHC 22 Provider Number,MRI,Speech Pathology,Renal Dialysis,MRI,Net Income,Occupational Therapy,MRI,Radiology-Therapeutic,Emergency,Interns & Residents,RHC 13 Provider Number,Int & Res (non approved teaching program,Medical Supplies Charged to Patients,Total Liabilities and Fund Balances,OOT,Emergency,Impl. Dev. Charged to Patients,ASC (Non Distinct Part),Radiology-Therapeutic,Heart Acquisition,Total Program Inpatient Costs,PEP Episodes:  Total Charges:,Anesthesiology,Nonpaid Workers,Physical Therapy,Drugs Charged to Patients,Other Special Care Unit,Physical Therapy,Surgical Intensive Care Unit,Kidney Acquisition,Operating Room,Other Ancillary,Contract Labor:  Physician Part A,Total Non Routine Medical  Supply Charges,Renal Dialysis,RHC 5 Provider Number,PEP:  Total Number of Outlier Episodes,Investment Income-New Bldgs & Fixtures,Intravenous Therapy,Fixed Equipment,Excluded Area Salaries,CT Scan,Intensive Care Unit,Surgical Intensive Care Unit,New Cap Related Csts Bldg & Fixtures,Clinic,Medical Supplies Charged to Patients,"Average patient dialysis time 
including setup",Radiology-Diagnostic,CMHC,Cardiac Catheterization,Subprovider 2,Radioisotope,Other Nonreimbursable,Laundry and Linen Service,Other Ancillary,Operation of Plant,Drugs Charged to Patients,Radiology-Therapeutic,Subprovider-IRF,Emergency,Land,RHC 11 Provider Number,Adults and Pediatrics,Total,Burn Intensive Care Unit,Pass Through Cost for  Program Ancillary,Cafeteria,Adjusted reimburseable bad debts,OPT,Drugs Charged to Patients,Radioisotope,FI/Contractor's Name,Respiratory Therapy,Other Reimbursable,Medicaid (Title XIX) discharges,Recovery Room,Other Ancillary,Allowable bad debts for dual eligibles beneficiaries,Notes Receivable,Title V discharges,Electrocardiology,Operating Room,Surgical Intensive Care Unit,Adults and Pediatrics,Other Special Purpose,Kidney Acquisition,Radioisotope,Protested amounts,Total Other Medical Education Cost,Total Charges:  LUPA Episodes,Home Program Dialysis,Maintenance and Repairs,Whole Blood & Packed Red Blood Cells,OLTC,Cardiac Catheterization,Intensive Care Unit,Recovery Room,Occupational Therapy,Central Services and Supply,Interns & Res Salary and Fringe Benefits,Renal 7 Provider Number,Other Outpatient Services,Respiratory Therapy,"Salaries, Wages, and Fees Payable",LUPA Episodes:  Total Visits,Cardiac Catheterization,Coronary Care Unit,Radiology-Diagnostic,Cardiac Catheterization,Laboratory,Drugs Charged to Patients,Durable Medical Equipment Rented,Other Special Care Unit,Whole Blood & Packed Red Blood Cells,Other Ancillary,OSP,Speech Pathology,RHC,Occupational Therapy,"Blood Storing, Processing, Trans",Cardiac Catheterization,"Number of Times per week
 Patient receives Dialysis",Intravenous Therapy,SNF,Dietary,Drugs Charged to Patients,Renal Dialysis,Laboratory,Radiology-Therapeutic,Other Outpatient Services,Total Hospital Interns & Residents,Coronary Care Unit,CT Scan,Clinic,Observation Beds (Distinct Unit),MRI,Durable Medical Equipment Rented,Medical Supplies Charged to Patients,IPPS Interim payment,Anesthesiology,Other Reimbursable,Component rate ESRD,LUPA Episodes:  Total Visits,Total Charges:  LUPA Episodes,Adj for Respiratory therapy costs in excess,CAH Visits,Other Outpatient Services,OPT,Hospital Adults & Pediatrics,Nursing Administration,Speech Pathology,Operating Room,Program Inpatient Ancillary Service Cost,Adults & Pediatrics,Medicare Certified Lung TC term date,Recovery Room,Renal Dialysis,ASC (Distinct Part),Kidney Acquisition,OLTC,PEP Episodes:  Total Number of Episodes,Total Hospital,Total Hospital,Respiratory Therapy,Radioisotope,Electrocardiology,Drugs Charged to Patients,Title XVIII discharges,FQHC,Medical Supplies Charged to Patients,"Average patient dialysis time 
including setup",Radiology-Diagnostic,Speech Pathology,Charity care charges and uninsured discounts for the entire facility,Physical Therapy,Blood Clotting Factors for Hemoph.,Occupational Therapy,Hospice,"Treatment capacity per day per
station",IRF,ASC (Non Distinct Part),Observation Beds (Distinct Unit),MRI,"Blood Storing, Processing, Trans",Physical Therapy,"Anesthetist, and Medical Education Costs",Observation Beds (Distinct Unit),Interns & Residents,Total,Total,Intravenous Therapy,LUPA Episodes:  Other Charges,Other Organ Acquisition,Anesthesiology,Total Costs,Other Medicaid Days,Operating Room,Radiology-Diagnostic,Hospice,Beginning Date of SCH status,Heart Acquisition,Nursing Administration,Hospital State,Sale of medical records and abstracts,Hospital Adults & Pediatrics,Recovery Room,Physical Therapy,ASC (Non Distinct Part),Other Special Care,Other Special Care Unit,CT Scan,Coronary Care Unit,Emergency,Total Program General Inpatient Routine,OLTC,Clinic,HHA,Occupational Therapy,Radiology-Therapeutic,Durable Medical Equipment Sold,Durable Medical Equipment Sold,Received DSH or supplemental payments from Medicaid? (Y/N),HHA,Home Office Personnel,Is this a New Hospital under 42 CFR 413.40(f)(1)(I) (TEFRA)? (Y/N),Administrative and General,"Gift, Flower, Coffee Shop, Canteen",Home Office:  Physician Part A,Clinic,Medical Supplies Charged to Patients,Intravenous Therapy,SNF,Related Salaries,Total Nursing School,ICF,Cardiac Catheterization,"Blood Storing, Processing, Trans",Land,Observation Beds (Distinct Unit),Total Adults & Pediatrics,Total Overhead Costs,Laboratory,Electrocardiology,Physical Therapy,Other Ancillary,Anesthesiology,Cardiac Catheterization,Physician-Part A,MSP-LCC reconciliation amount,Radioisotope,Burn Intensive Care Unit,"Percentage of patients re-using
dialyzers",Subprovider 2,Electrocardiology,Tentative settlement,Cost To Charge Ratio,Speech Pathology,CORF,Interns & Residents,Social Service,Physicians' Private Office,NF,Maintenance and Repairs,Employee Benefits,Observation Beds (Distinct Unit),Occupational Therapy,Impl. Dev. Charged to Patients,Heart Acquisition,Subprovider I,Int & Res (non approved teaching program,Other Ancillary,With Outliers:  Number of Episodes,Home Program Dialysis,Radioisotope,Swing Bed NF Provider Number,Hospice,Renal 1 Provider Number,Research,Other Nonreimbursable,Total Current Assets,Respiratory Therapy,Target Amount per Discharge,Line 2 times line 5,Labor and Delivery,Electroencephalography,Other Ancillary,Intensive Care Unit,OSP,Whole Blood & Packed Red Blood Cells,Intensive Care Unit,RHC,Operating Room,Investments,Stand-alone CHIP Charges (Gross Revenue),Electroencephalography,Observation Beds (Distinct Unit),NF,SNF,Cafeteria,Electrocardiology,Home Office Salaries & Wage Related Csts,SSA State Code,Interns & Res Other Program Costs,CT Scan,Prepaid expenses,Does the hospital qualify as RPCH/CAH? (Y/N),Durable Medical Equipment Sold,Radiology-Therapeutic,Nonphysician Anesthetists,Blood Clotting Factors for Hemoph.,Intensive Care Unit Program Cost,"Blood Storing, Processing, Trans",Recovery Room,Total Allied Health Cost,Renal 3 Provider Number,Non-Physician Anesthetist Part B,CT Scan,Total Hospital,Other Outpatient Services,SNF,IRF,Respiratory Therapy,Excluded Area Salaries,Medical Supplies Charged to Patients,SNF,Radiology-Diagnostic,Occupational Therapy,OLTC,"Number of days in year dialysis 
furnished",Impl. Dev. Charged to Patients,Non-Physician Anesthetist Part A,Radiology-Diagnostic,ASC (Non Distinct Part),Drugs Charged to Patients,Whole Blood & Packed Red Blood Cells,Government grants or appropriations or transfers for support of hospital operations,Whole Blood & Packed Red Blood Cells,IRF,Cardiac Catheterization,Respiratory Therapy,Refunds and Rebates of Expenses,Electrocardiology,"Does this facility operate 
transplant center? (Y/N)",Other Ancillary,Total Salaries,New Cap Related Csts Movable Equipment,Adults and Pediatrics,Intravenous Therapy,Speech Pathology,Subprovider-IPF,Radiology-Diagnostic,Radiology-Diagnostic,Total Income,Other Reimbursable,Subprovider-IPF,Total Salaries,Electrocardiology,Drugs Charged to Patients,Radiology-Therapeutic,Nursing School,Non-Physician Anesthetist Part B,Anesthesiology,Delivery Room and Labor Room,Occupational Therapy,Subtotal,Intensive Care Unit,ASC (Non Distinct Part),TOTAL,Observation Beds (Distinct Unit),SNF,Electrocardiology,PEP Episodes:  Other Charges,Other Organ Acquisition,Burn Intensive Care Unit,Medical Supplies Charged to Patients,Laboratory,Radioisotope,OLTC,Radiology-Therapeutic,RHC 20 Provider Number,Total charges to state or local government programs for indigent care (not Medicaid or CHIP),Nursing School,Non-Physician Anesthetist Part B,CT Scan,Land Improvements,Other Reimbursable,Physical Therapy,Net Salaries,Subprovider I,Subprovider 2,OPT,Hospice,Laboratory,Anesthesiology,Impl. Dev. Charged to Patients,Total Patient Days,Whole Blood & Packed Red Blood Cells,Program Discharges,Burn Intensive Care Unit,Other Special Care,Anesthesiology,Nursing Administration,Occupational Therapy,CMHC,Occupational Therapy,Respiratory Therapy,Average times dialyzers re-used,Beds Total Facility,Hospital PO Box,Adults and Pediatrics,Hospice,Clinic,Net Salaries,Int & Res (non approved teaching program,Radiology-Diagnostic,Physical Therapy,Is this hospital classified as a referral center? (Y/N),Physicians' Private Office,Anesthesiology,IPF,Lung  Acquisition,Interns & Residents,Subprovider-IRF,Administrative and General,CMHC 1 Provider Number,Home Program Dialysis,Subtotal,Clinic,Hospital Adlts & Ped Swing Bed NF,Nursery,Electroencephalography,Cardiac Catheterization,Other Outpatient Services,Durable Medical Equipment Rented,Hospice,Cafeteria,Emergency,Other Outpatient Services,Delivery Room and Labor Room,Medical Supplies Charged to Patients,Speech Pathology,Operating Room,Islet Acquisition,Impl. Dev. Charged to Patients,Depreciation-New Bldgs & Fixtures,Other Special Care Unit,Payment to cost ratio,Electroencephalography,ICF Provider Number,Medical Supplies Charged to Patients,Observation Beds (Distinct Unit),Housekeeping,Accounts Payable,Laboratory,Cafeteria,MDH status ending date (MM/DD/YY),Outlier payments,Total,Electrocardiology,Fiscal Intermediary Number,Electrocardiology,Home Program Dialysis,"Number of patients in program at 
end of cost reporting period",Electroencephalography,Housekeeping,Pharmacy,Adults and Pediatrics,Interns & Res Salary and Fringe Benefits,Housekeeping under contract,CMHC,Cardiac Catheterization,New Cap Related Csts Movable Equipment,Recovery Room,Total Other Medical Education,Without Outliers:  Total Charges,Home Office Salaries & Wage Related Csts,Subprovider-IPF,Hospital Title 18 Payment System (P/T/O),Emergency,Lung  Acquisition,Initial Physician Payment Method (Y/N),Subprovider I,Speech Pathology,Recovery Room,Subprovider-IRF,Delivery Room and Labor Room,Total Other Charges,Fixed Equipment,Durable Medical Equipment Rented,Net revenue from state/local govt indigent care (not Medicaid or CHIP),ASC (Non Distinct Part),Radioisotope,Nursery,Radiology-Therapeutic,LUPA Episodes:  Total Visits,Intestinal Acquisition,With Outliers:  Total Visits,Liver Acquisition,Report_Period_Begin_Yr,,,,,,,,,,,,,,,,,,,,,,Hospital Type (From CMS Hospitals Data Archive),General Ownership Type,,Name and Num
,Curated Name and Num,Hospital type (modified),,Lon,Lat,,COST ALLOCATION,,APPORTIONMENT OF INPATIENT ROUTINE SERVICE CAPITAL COSTS,COMPUTATION OF INPATIENT OPERATING COSTS,HOSPITAL WAGE INDEX DATA,COST ALLOCATION,COMPUTATION OF RATIO OF COST TO CHARGES,HOSPITAL WAGE INDEX DATA,TRIAL BALANCE OF EXPENSE ACCOUNTS,HOSPITAL WAGE INDEX DATA,RENAL STATISTICAL DATA,APPORTIONMENT OF INPATIENT/OUTPATIENT ANCILLARY SERVICE OTHER PASS THROUGH COSTS,INPATIENT ANCILLARY SERVICE COST APPORTIONMENT,RENAL STATISTICAL DATA,TRIAL BALANCE OF EXPENSE ACCOUNTS,APPORTIONMENT OF INPATIENT/OUTPATIENT ANCILLARY SERVICE OTHER PASS THROUGH COSTS,,APPORTIONMENT OF INPATIENT/OUTPATIENT ANCILLARY SERVICE OTHER PASS THROUGH COSTS,COMPUTATION OF RATIO OF COST TO CHARGES,APPORTIONMENT OF MEDICAL AND OTHER HEALTH SERVICES,CALCULATION OF REIMBURSEMENT SETTLEMENT,,TRIAL BALANCE OF EXPENSE ACCOUNTS,COST ALLOCATION,COMPUTATION OF INPATIENT OPERATING COSTS,APPORTIONMENT OF INPATIENT/OUTPATIENT ANCILLARY SERVICE OTHER PASS THROUGH COSTS,Total Inpatient Days/Outpatient Visits,COMPUTATION OF RATIO OF COST TO CHARGES,COST ALLOCATION,ALLOCATION OF NEW CAPITAL COSTS,INPATIENT ANCILLARY SERVICE COST APPORTIONMENT,,HOSPITAL WAGE INDEX DATA,APPORTIONMENT OF INPATIENT/OUTPATIENT ANCILLARY SERVICE OTHER PASS THROUGH COSTS,TRIAL BALANCE OF EXPENSE ACCOUNTS,TRIAL BALANCE OF EXPENSE ACCOUNTS,Total Inpatient Days/Outpatient Visits,INPATIENT ANCILLARY SERVICE COST APPORTIONMENT,,RENAL STATISTICAL DATA,TRIAL BALANCE OF EXPENSE ACCOUNTS,COMPUTATION OF RATIO OF COST TO CHARGES,COST ALLOCATION,Total Inpatient Days/Outpatient Visits,HOSPITAL WAGE INDEX DATA,ALLOCATION OF NEW CAPITAL COSTS,APPORTIONMENT OF INPATIENT ROUTINE SERVICE OTHER PASS THROUGH COSTS,INPATIENT ANCILLARY SERVICE COST APPORTIONMENT,COMPUTATION OF RATIO OF COST TO CHARGES,INPATIENT ANCILLARY SERVICE COST APPORTIONMENT,COST ALLOCATION,TRIAL BALANCE OF EXPENSE ACCOUNTS,INPATIENT ANCILLARY SERVICE COST APPORTIONMENT,INPATIENT ANCILLARY SERVICE COST APPORTIONMENT,HOSPITAL WAGE INDEX DATA,COMPUTATION OF RATIO OF COST TO CHARGES,COMPUTATION OF INPATIENT OPERATING COSTS,TRIAL BALANCE OF EXPENSE ACCOUNTS,BALANCE SHEET,APPORTIONMENT OF MEDICAL AND OTHER HEALTH SERVICES,HHA STATISTICAL DATA,S-10 DATA,APPORTIONMENT OF INPATIENT/OUTPATIENT ANCILLARY SERVICE OTHER PASS THROUGH COSTS,NUMBER OF BEDS,,INPATIENT ANCILLARY SERVICE COST APPORTIONMENT,RECONCILIATION OF CAPITAL COST CENTERS,APPORTIONMENT OF MEDICAL AND OTHER HEALTH SERVICES,APPORTIONMENT OF MEDICAL AND OTHER HEALTH SERVICES,ANALYSIS OF CHANGES IN NEW CAPITAL BALANCES,COMPUTATION OF RATIO OF COST TO CHARGES,COMPUTATION OF RATIO OF COST TO CHARGES,APPORTIONMENT OF INPATIENT/OUTPATIENT ANCILLARY SERVICE OTHER PASS THROUGH COSTS,HHA STATISTICAL DATA,APPORTIONMENT OF INPATIENT/OUTPATIENT ANCILLARY SERVICE OTHER PASS THROUGH COSTS,COST ALLOCATION,INPATIENT ANCILLARY SERVICE COST APPORTIONMENT,COST ALLOCATION,APPORTIONMENT OF INPATIENT/OUTPATIENT ANCILLARY SERVICE OTHER PASS THROUGH COSTS,COMPUTATION OF RATIO OF COST TO CHARGES,APPORTIONMENT OF MEDICAL AND OTHER HEALTH SERVICES,HHA STATISTICAL DATA,BALANCE SHEET,Total Inpatient Days/Outpatient Visits,INPATIENT ANCILLARY SERVICE COST APPORTIONMENT,APPORTIONMENT OF MEDICAL AND OTHER HEALTH SERVICES,CALCULATION OF REIMBURSEMENT SETTLEMENT,APPORTIONMENT OF MEDICAL AND OTHER HEALTH SERVICES,Total Inpatient Days/Outpatient Visits,COST ALLOCATION,APPORTIONMENT OF INPATIENT/OUTPATIENT ANCILLARY SERVICE OTHER PASS THROUGH COSTS,APPORTIONMENT OF INPATIENT/OUTPATIENT ANCILLARY SERVICE OTHER PASS THROUGH COSTS,COMPUTATION OF RATIO OF COST TO CHARGES,APPORTIONMENT OF INPATIENT/OUTPATIENT ANCILLARY SERVICE OTHER PASS THROUGH COSTS,INPATIENT ANCILLARY SERVICE COST APPORTIONMENT,APPORTIONMENT OF INPATIENT/OUTPATIENT ANCILLARY SERVICE OTHER PASS THROUGH COSTS,INPATIENT ANCILLARY SERVICE COST APPORTIONMENT,HOSPITAL WAGE INDEX DATA,COMPUTATION OF RATIO OF COST TO CHARGES,,COMPUTATION OF RATIO OF COST TO CHARGES,TRIAL BALANCE OF EXPENSE ACCOUNTS,HOSPITAL WAGE INDEX DATA,COST ALLOCATION,INPATIENT ANCILLARY SERVICE COST APPORTIONMENT,HOSPITAL IDENTIFICATION INFORMATION,COST ALLOCATION,INPATIENT ANCILLARY SERVICE COST APPORTIONMENT,HOSPITAL WAGE INDEX DATA,Total Inpatient Days/Outpatient Visits,COMPUTATION OF RATIO OF COST TO CHARGES,RECONCILIATION OF CAPITAL COST CENTERS,APPORTIONMENT OF INPATIENT/OUTPATIENT ANCILLARY SERVICE OTHER PASS THROUGH COSTS,COMPUTATION OF RATIO OF COST TO CHARGES,COMPUTATION OF INPATIENT OPERATING COSTS,INPATIENT ANCILLARY SERVICE COST APPORTIONMENT,Total Inpatient Days/Outpatient Visits,APPORTIONMENT OF INPATIENT/OUTPATIENT ANCILLARY SERVICE OTHER PASS THROUGH COSTS,APPORTIONMENT OF INPATIENT/OUTPATIENT ANCILLARY SERVICE OTHER PASS THROUGH COSTS,TRIAL BALANCE OF EXPENSE ACCOUNTS,ANALYSIS OF CHANGES IN NEW CAPITAL BALANCES,ANALYSIS OF CHANGES IN NEW CAPITAL BALANCES,RENAL STATISTICAL DATA,APPORTIONMENT OF MEDICAL AND OTHER HEALTH SERVICES,APPORTIONMENT OF MEDICAL AND OTHER HEALTH SERVICES,APPORTIONMENT OF MEDICAL AND OTHER HEALTH SERVICES,TRIAL BALANCE OF EXPENSE ACCOUNTS,INPATIENT ANCILLARY SERVICE COST APPORTIONMENT,APPORTIONMENT OF INPATIENT ROUTINE SERVICE CAPITAL COSTS,COST ALLOCATION,CALCULATION OF REIMBURSEMENT SETTLEMENT (PPS),,ADJUSTMENTS,INPATIENT ANCILLARY SERVICE COST APPORTIONMENT,APPORTIONMENT OF MEDICAL AND OTHER HEALTH SERVICES,NUMBER OF BEDS,APPORTIONMENT OF MEDICAL AND OTHER HEALTH SERVICES,ALLOCATION OF NEW CAPITAL COSTS,APPORTIONMENT OF MEDICAL AND OTHER HEALTH SERVICES,INPATIENT ANCILLARY SERVICE COST APPORTIONMENT,APPORTIONMENT OF INPATIENT/OUTPATIENT ANCILLARY SERVICE OTHER PASS THROUGH COSTS,HOSPITAL WAGE INDEX DATA,APPORTIONMENT OF INPATIENT/OUTPATIENT ANCILLARY SERVICE OTHER PASS THROUGH COSTS,TRIAL BALANCE OF EXPENSE ACCOUNTS,INPATIENT ANCILLARY SERVICE COST APPORTIONMENT,APPORTIONMENT OF INPATIENT/OUTPATIENT ANCILLARY SERVICE OTHER PASS THROUGH COSTS,APPORTIONMENT OF INPATIENT/OUTPATIENT ANCILLARY SERVICE OTHER PASS THROUGH COSTS,APPORTIONMENT OF INPATIENT/OUTPATIENT ANCILLARY SERVICE OTHER PASS THROUGH COSTS,TRIAL BALANCE OF EXPENSE ACCOUNTS,APPORTIONMENT OF INPATIENT ROUTINE SERVICE CAPITAL COSTS,TRIAL BALANCE OF EXPENSE ACCOUNTS,APPORTIONMENT OF INPATIENT/OUTPATIENT ANCILLARY SERVICE OTHER PASS THROUGH COSTS,COST ALLOCATION,HHA STATISTICAL DATA,APPORTIONMENT OF INPATIENT/OUTPATIENT ANCILLARY SERVICE OTHER PASS THROUGH COSTS,Total Inpatient Days/Outpatient Visits,COMPUTATION OF RATIO OF COST TO CHARGES,,COST ALLOCATION,COST ALLOCATION,COST ALLOCATION,TRIAL BALANCE OF EXPENSE ACCOUNTS,HHA STATISTICAL DATA,APPORTIONMENT OF INPATIENT ROUTINE SERVICE CAPITAL COSTS,APPORTIONMENT OF INPATIENT/OUTPATIENT ANCILLARY SERVICE OTHER PASS THROUGH COSTS,HOSPITAL WAGE INDEX DATA,COST ALLOCATION,,COMPUTATION OF RATIO OF COST TO CHARGES,APPORTIONMENT OF INPATIENT/OUTPATIENT ANCILLARY SERVICE OTHER PASS THROUGH COSTS,BALANCE SHEET,APPORTIONMENT OF MEDICAL AND OTHER HEALTH SERVICES,CALCULATION OF REIMBURSEMENT SETTLEMENT,TRIAL BALANCE OF EXPENSE ACCOUNTS,COST ALLOCATION,Total Inpatient Days/Outpatient Visits,ALLOCATION OF NEW CAPITAL COSTS,APPORTIONMENT OF INPATIENT/OUTPATIENT ANCILLARY SERVICE OTHER PASS THROUGH COSTS,TRIAL BALANCE OF EXPENSE ACCOUNTS,APPORTIONMENT OF INPATIENT/OUTPATIENT ANCILLARY SERVICE OTHER PASS THROUGH COSTS,,APPORTIONMENT OF INPATIENT/OUTPATIENT ANCILLARY SERVICE OTHER PASS THROUGH COSTS,TRIAL BALANCE OF EXPENSE ACCOUNTS,Medicaid Inpatient Days/Outpatient Visits,INPATIENT ANCILLARY SERVICE COST APPORTIONMENT,APPORTIONMENT OF INPATIENT/OUTPATIENT ANCILLARY SERVICE OTHER PASS THROUGH COSTS,HOSPITAL WAGE INDEX DATA,TRIAL BALANCE OF EXPENSE ACCOUNTS,COST ALLOCATION,INPATIENT ANCILLARY SERVICE COST APPORTIONMENT,APPORTIONMENT OF INPATIENT/OUTPATIENT ANCILLARY SERVICE OTHER PASS THROUGH COSTS,INPATIENT ANCILLARY SERVICE COST APPORTIONMENT,ALLOCATION OF NEW CAPITAL COSTS,Total Inpatient Days/Outpatient Visits,TRIAL BALANCE OF EXPENSE ACCOUNTS,INPATIENT ANCILLARY SERVICE COST APPORTIONMENT,COMPUTATION OF RATIO OF COST TO CHARGES,COMPUTATION OF RATIO OF COST TO CHARGES,APPORTIONMENT OF INPATIENT/OUTPATIENT ANCILLARY SERVICE OTHER PASS THROUGH COSTS,CALCULATION OF REIMBURSEMENT SETTLEMENT,TRIAL BALANCE OF EXPENSE ACCOUNTS,COMPUTATION OF RATIO OF COST TO CHARGES,COST ALLOCATION,APPORTIONMENT OF INPATIENT/OUTPATIENT ANCILLARY SERVICE OTHER PASS THROUGH COSTS,APPORTIONMENT OF INPATIENT/OUTPATIENT ANCILLARY SERVICE OTHER PASS THROUGH COSTS,APPORTIONMENT OF MEDICAL AND OTHER HEALTH SERVICES,BED DAYS AVAILABLE,APPORTIONMENT OF INPATIENT/OUTPATIENT ANCILLARY SERVICE OTHER PASS THROUGH COSTS,TRIAL BALANCE OF EXPENSE ACCOUNTS,APPORTIONMENT OF MEDICAL AND OTHER HEALTH SERVICES,APPORTIONMENT OF MEDICAL AND OTHER HEALTH SERVICES,COST ALLOCATION,HOSPITAL WAGE INDEX DATA,COMPUTATION OF RATIO OF COST TO CHARGES,TRIAL BALANCE OF EXPENSE ACCOUNTS,COST ALLOCATION,APPORTIONMENT OF MEDICAL AND OTHER HEALTH SERVICES,COMPUTATION OF INPATIENT OPERATING COSTS,INPATIENT ANCILLARY SERVICE COST APPORTIONMENT,APPORTIONMENT OF MEDICAL AND OTHER HEALTH SERVICES,APPORTIONMENT OF MEDICAL AND OTHER HEALTH SERVICES,BED DAYS AVAILABLE,INPATIENT ANCILLARY SERVICE COST APPORTIONMENT,INPATIENT ANCILLARY SERVICE COST APPORTIONMENT,Medicaid Inpatient Days/Outpatient Visits,INPATIENT ANCILLARY SERVICE COST APPORTIONMENT,ADJUSTMENTS,COST ALLOCATION,TRIAL BALANCE OF EXPENSE ACCOUNTS,APPORTIONMENT OF INPATIENT/OUTPATIENT ANCILLARY SERVICE OTHER PASS THROUGH COSTS,COST ALLOCATION,COST ALLOCATION,APPORTIONMENT OF INPATIENT/OUTPATIENT ANCILLARY SERVICE OTHER PASS THROUGH COSTS,TRIAL BALANCE OF EXPENSE ACCOUNTS,APPORTIONMENT OF MEDICAL AND OTHER HEALTH SERVICES,HOSPITAL WAGE INDEX DATA,TRIAL BALANCE OF EXPENSE ACCOUNTS,APPORTIONMENT OF MEDICAL AND OTHER HEALTH SERVICES,INPATIENT ANCILLARY SERVICE COST APPORTIONMENT,APPORTIONMENT OF MEDICAL AND OTHER HEALTH SERVICES,APPORTIONMENT OF MEDICAL AND OTHER HEALTH SERVICES,COST ALLOCATION,APPORTIONMENT OF INPATIENT/OUTPATIENT ANCILLARY SERVICE OTHER PASS THROUGH COSTS,Total Inpatient Days/Outpatient Visits,APPORTIONMENT OF MEDICAL AND OTHER HEALTH SERVICES,APPORTIONMENT OF MEDICAL AND OTHER HEALTH SERVICES,,BED DAYS AVAILABLE,TRIAL BALANCE OF EXPENSE ACCOUNTS,APPORTIONMENT OF INPATIENT/OUTPATIENT ANCILLARY SERVICE OTHER PASS THROUGH COSTS,ALLOCATION OF NEW CAPITAL COSTS,COST ALLOCATION,INPATIENT ANCILLARY SERVICE COST APPORTIONMENT,BED DAYS AVAILABLE,INPATIENT ANCILLARY SERVICE COST APPORTIONMENT,HOSPITAL WAGE INDEX DATA,APPORTIONMENT OF INPATIENT/OUTPATIENT ANCILLARY SERVICE OTHER PASS THROUGH COSTS,INPATIENT ANCILLARY SERVICE COST APPORTIONMENT,HOSPITAL WAGE INDEX DATA,Total Inpatient Days/Outpatient Visits,ADJUSTMENTS,HOSPITAL WAGE INDEX DATA,APPORTIONMENT OF MEDICAL AND OTHER HEALTH SERVICES,INPATIENT ANCILLARY SERVICE COST APPORTIONMENT,HOSPITAL WAGE INDEX DATA,NUMBER OF BEDS,APPORTIONMENT OF INPATIENT/OUTPATIENT ANCILLARY SERVICE OTHER PASS THROUGH COSTS,APPORTIONMENT OF INPATIENT/OUTPATIENT ANCILLARY SERVICE OTHER PASS THROUGH COSTS,APPORTIONMENT OF MEDICAL AND OTHER HEALTH SERVICES,APPORTIONMENT OF INPATIENT/OUTPATIENT ANCILLARY SERVICE OTHER PASS THROUGH COSTS,,ANALYSIS OF CHANGES IN NEW CAPITAL BALANCES,APPORTIONMENT OF INPATIENT/OUTPATIENT ANCILLARY SERVICE OTHER PASS THROUGH COSTS,ALLOCATION OF NEW CAPITAL COSTS,COST ALLOCATION,,APPORTIONMENT OF INPATIENT/OUTPATIENT ANCILLARY SERVICE OTHER PASS THROUGH COSTS,HOSPITAL WAGE INDEX DATA,COST ALLOCATION,COMPUTATION OF INPATIENT OPERATING COSTS,HHA STATISTICAL DATA,INPATIENT ANCILLARY SERVICE COST APPORTIONMENT,COMPUTATION OF INPATIENT OPERATING COSTS,NUMBER OF BEDS,INPATIENT ANCILLARY SERVICE COST APPORTIONMENT,HOSPITAL WAGE INDEX DATA,APPORTIONMENT OF MEDICAL AND OTHER HEALTH SERVICES,COMPUTATION OF RATIO OF COST TO CHARGES,APPORTIONMENT OF INPATIENT/OUTPATIENT ANCILLARY SERVICE OTHER PASS THROUGH COSTS,APPORTIONMENT OF INPATIENT/OUTPATIENT ANCILLARY SERVICE OTHER PASS THROUGH COSTS,INPATIENT ANCILLARY SERVICE COST APPORTIONMENT,COMPUTATION OF INPATIENT OPERATING COSTS,APPORTIONMENT OF MEDICAL AND OTHER HEALTH SERVICES,APPORTIONMENT OF MEDICAL AND OTHER HEALTH SERVICES,HOSPITAL WAGE INDEX DATA,TRIAL BALANCE OF EXPENSE ACCOUNTS,APPORTIONMENT OF MEDICAL AND OTHER HEALTH SERVICES,RECONCILIATION OF CAPITAL COST CENTERS,APPORTIONMENT OF MEDICAL AND OTHER HEALTH SERVICES,APPORTIONMENT OF MEDICAL AND OTHER HEALTH SERVICES,INPATIENT ANCILLARY SERVICE COST APPORTIONMENT,TRIAL BALANCE OF EXPENSE ACCOUNTS,BED DAYS AVAILABLE,BED DAYS AVAILABLE,COMPUTATION OF RATIO OF COST TO CHARGES,APPORTIONMENT OF INPATIENT/OUTPATIENT ANCILLARY SERVICE OTHER PASS THROUGH COSTS,INPATIENT ANCILLARY SERVICE COST APPORTIONMENT,COMPUTATION OF RATIO OF COST TO CHARGES,Total Inpatient Days/Outpatient Visits,APPORTIONMENT OF INPATIENT/OUTPATIENT ANCILLARY SERVICE OTHER PASS THROUGH COSTS,INPATIENT ANCILLARY SERVICE COST APPORTIONMENT,INPATIENT ANCILLARY SERVICE COST APPORTIONMENT,COMPUTATION OF RATIO OF COST TO CHARGES,APPORTIONMENT OF MEDICAL AND OTHER HEALTH SERVICES,COST ALLOCATION,,COST ALLOCATION,APPORTIONMENT OF INPATIENT/OUTPATIENT ANCILLARY SERVICE OTHER PASS THROUGH COSTS,INPATIENT ANCILLARY SERVICE COST APPORTIONMENT,COMPUTATION OF RATIO OF COST TO CHARGES,ANALYSIS OF CHANGES IN NEW CAPITAL BALANCES,INPATIENT ANCILLARY SERVICE COST APPORTIONMENT,Medicare Inpatient Days/Outpatient Visits,CALCULATION OF REIMBURSEMENT SETTLEMENT,TRIAL BALANCE OF EXPENSE ACCOUNTS,HHA STATISTICAL DATA,APPORTIONMENT OF INPATIENT/OUTPATIENT ANCILLARY SERVICE OTHER PASS THROUGH COSTS,INPATIENT ANCILLARY SERVICE COST APPORTIONMENT,COST ALLOCATION,CALCULATION OF REIMBURSEMENT SETTLEMENT,APPORTIONMENT OF INPATIENT/OUTPATIENT ANCILLARY SERVICE OTHER PASS THROUGH COSTS,HOSPITAL WAGE INDEX DATA,TRIAL BALANCE OF EXPENSE ACCOUNTS,COMPUTATION OF INPATIENT OPERATING COSTS,INPATIENT ANCILLARY SERVICE COST APPORTIONMENT,TRIAL BALANCE OF EXPENSE ACCOUNTS,APPORTIONMENT OF MEDICAL AND OTHER HEALTH SERVICES,TRIAL BALANCE OF EXPENSE ACCOUNTS,APPORTIONMENT OF INPATIENT/OUTPATIENT ANCILLARY SERVICE OTHER PASS THROUGH COSTS,,COST ALLOCATION,Medicaid Inpatient Days/Outpatient Visits,COST ALLOCATION,APPORTIONMENT OF INPATIENT/OUTPATIENT ANCILLARY SERVICE OTHER PASS THROUGH COSTS,APPORTIONMENT OF INPATIENT/OUTPATIENT ANCILLARY SERVICE OTHER PASS THROUGH COSTS,INPATIENT ANCILLARY SERVICE COST APPORTIONMENT,COMPUTATION OF INPATIENT OPERATING COSTS,APPORTIONMENT OF MEDICAL AND OTHER HEALTH SERVICES,ALLOCATION OF NEW CAPITAL COSTS,TRIAL BALANCE OF EXPENSE ACCOUNTS,APPORTIONMENT OF INPATIENT/OUTPATIENT ANCILLARY SERVICE OTHER PASS THROUGH COSTS,COST ALLOCATION,APPORTIONMENT OF INPATIENT/OUTPATIENT ANCILLARY SERVICE OTHER PASS THROUGH COSTS,APPORTIONMENT OF MEDICAL AND OTHER HEALTH SERVICES,HOSPITAL WAGE INDEX DATA,HOSPITAL WAGE INDEX DATA,COMPUTATION OF INPATIENT OPERATING COSTS,INPATIENT ANCILLARY SERVICE COST APPORTIONMENT,APPORTIONMENT OF INPATIENT/OUTPATIENT ANCILLARY SERVICE OTHER PASS THROUGH COSTS,COMPUTATION OF RATIO OF COST TO CHARGES,HOSPITAL WAGE INDEX DATA,INPATIENT ANCILLARY SERVICE COST APPORTIONMENT,HOSPITAL WAGE INDEX DATA,INPATIENT ANCILLARY SERVICE COST APPORTIONMENT,TRIAL BALANCE OF EXPENSE ACCOUNTS,INPATIENT ANCILLARY SERVICE COST APPORTIONMENT,ALLOCATION OF NEW CAPITAL COSTS,COST ALLOCATION,APPORTIONMENT OF INPATIENT/OUTPATIENT ANCILLARY SERVICE OTHER PASS THROUGH COSTS,APPORTIONMENT OF INPATIENT/OUTPATIENT ANCILLARY SERVICE OTHER PASS THROUGH COSTS,COMPUTATION OF RATIO OF COST TO CHARGES,S-10 DATA,,INPATIENT ANCILLARY SERVICE COST APPORTIONMENT,COMPUTATION OF RATIO OF COST TO CHARGES,,HOSPITAL WAGE INDEX DATA,HOSPITAL WAGE INDEX DATA,APPORTIONMENT OF INPATIENT ROUTINE SERVICE OTHER PASS THROUGH COSTS,TRIAL BALANCE OF EXPENSE ACCOUNTS,HOSPITAL WAGE INDEX DATA,TRIAL BALANCE OF EXPENSE ACCOUNTS,COST ALLOCATION,APPORTIONMENT OF INPATIENT/OUTPATIENT ANCILLARY SERVICE OTHER PASS THROUGH COSTS,Total Inpatient Days/Outpatient Visits,ALLOCATION OF NEW CAPITAL COSTS,INPATIENT ANCILLARY SERVICE COST APPORTIONMENT,Medicare Inpatient Days/Outpatient Visits,HOSPITAL WAGE INDEX DATA,COST ALLOCATION,INPATIENT ANCILLARY SERVICE COST APPORTIONMENT,TRIAL BALANCE OF EXPENSE ACCOUNTS,HOSPITAL WAGE INDEX DATA,TRIAL BALANCE OF EXPENSE ACCOUNTS,HOSPITAL WAGE INDEX DATA,TRIAL BALANCE OF EXPENSE ACCOUNTS,INPATIENT ANCILLARY SERVICE COST APPORTIONMENT,RENAL STATISTICAL DATA,HOSPITAL WAGE INDEX DATA,HOSPITAL WAGE INDEX DATA,TRIAL BALANCE OF EXPENSE ACCOUNTS,APPORTIONMENT OF INPATIENT/OUTPATIENT ANCILLARY SERVICE OTHER PASS THROUGH COSTS,INPATIENT ANCILLARY SERVICE COST APPORTIONMENT,TRIAL BALANCE OF EXPENSE ACCOUNTS,COMPUTATION OF RATIO OF COST TO CHARGES,TRIAL BALANCE OF EXPENSE ACCOUNTS,INPATIENT ANCILLARY SERVICE COST APPORTIONMENT,APPORTIONMENT OF INPATIENT/OUTPATIENT ANCILLARY SERVICE OTHER PASS THROUGH COSTS,TRIAL BALANCE OF EXPENSE ACCOUNTS,APPORTIONMENT OF INPATIENT/OUTPATIENT ANCILLARY SERVICE OTHER PASS THROUGH COSTS,COMPUTATION OF RATIO OF COST TO CHARGES,COST ALLOCATION,BED DAYS AVAILABLE,TRIAL BALANCE OF EXPENSE ACCOUNTS,COMPUTATION OF RATIO OF COST TO CHARGES,APPORTIONMENT OF INPATIENT/OUTPATIENT ANCILLARY SERVICE OTHER PASS THROUGH COSTS,APPORTIONMENT OF INPATIENT/OUTPATIENT ANCILLARY SERVICE OTHER PASS THROUGH COSTS,APPORTIONMENT OF INPATIENT/OUTPATIENT ANCILLARY SERVICE OTHER PASS THROUGH COSTS,APPORTIONMENT OF MEDICAL AND OTHER HEALTH SERVICES,BALANCE SHEET,APPORTIONMENT OF INPATIENT/OUTPATIENT ANCILLARY SERVICE OTHER PASS THROUGH COSTS,COST ALLOCATION,APPORTIONMENT OF INPATIENT ROUTINE SERVICE OTHER PASS THROUGH COSTS,HOSPITAL WAGE INDEX DATA,COMPUTATION OF RATIO OF COST TO CHARGES,HOSPITAL WAGE INDEX DATA,APPORTIONMENT OF MEDICAL AND OTHER HEALTH SERVICES,INPATIENT ANCILLARY SERVICE COST APPORTIONMENT,HOSPITAL WAGE INDEX DATA,COMPUTATION OF RATIO OF COST TO CHARGES,COMPUTATION OF INPATIENT OPERATING COSTS,COST ALLOCATION,APPORTIONMENT OF MEDICAL AND OTHER HEALTH SERVICES,APPORTIONMENT OF INPATIENT/OUTPATIENT ANCILLARY SERVICE OTHER PASS THROUGH COSTS,COST ALLOCATION,COST ALLOCATION,HOSPITAL WAGE INDEX DATA,APPORTIONMENT OF INPATIENT/OUTPATIENT ANCILLARY SERVICE OTHER PASS THROUGH COSTS,,COMPUTATION OF RATIO OF COST TO CHARGES,COMPUTATION OF RATIO OF COST TO CHARGES,APPORTIONMENT OF INPATIENT ROUTINE SERVICE CAPITAL COSTS,APPORTIONMENT OF MEDICAL AND OTHER HEALTH SERVICES,INPATIENT ANCILLARY SERVICE COST APPORTIONMENT,TRIAL BALANCE OF EXPENSE ACCOUNTS,INPATIENT ANCILLARY SERVICE COST APPORTIONMENT,COMPUTATION OF RATIO OF COST TO CHARGES,ALLOCATION OF NEW CAPITAL COSTS,COST ALLOCATION,HOSPITAL WAGE INDEX DATA,APPORTIONMENT OF INPATIENT/OUTPATIENT ANCILLARY SERVICE OTHER PASS THROUGH COSTS,ALLOCATION OF NEW CAPITAL COSTS,COMPUTATION OF RATIO OF COST TO CHARGES,APPORTIONMENT OF INPATIENT/OUTPATIENT ANCILLARY SERVICE OTHER PASS THROUGH COSTS,BALANCE SHEET,ALLOCATION OF NEW CAPITAL COSTS,RENAL STATISTICAL DATA,TRIAL BALANCE OF EXPENSE ACCOUNTS,APPORTIONMENT OF MEDICAL AND OTHER HEALTH SERVICES,HOSPITAL WAGE INDEX DATA,ALLOCATION OF NEW CAPITAL COSTS,INPATIENT ANCILLARY SERVICE COST APPORTIONMENT,INPATIENT ANCILLARY SERVICE COST APPORTIONMENT,,ADJUSTMENTS,APPORTIONMENT OF MEDICAL AND OTHER HEALTH SERVICES,INPATIENT ANCILLARY SERVICE COST APPORTIONMENT,ALLOCATION OF NEW CAPITAL COSTS,COMPUTATION OF RATIO OF COST TO CHARGES,APPORTIONMENT OF INPATIENT/OUTPATIENT ANCILLARY SERVICE OTHER PASS THROUGH COSTS,APPORTIONMENT OF INPATIENT/OUTPATIENT ANCILLARY SERVICE OTHER PASS THROUGH COSTS,ADJUSTMENTS,APPORTIONMENT OF INPATIENT/OUTPATIENT ANCILLARY SERVICE OTHER PASS THROUGH COSTS,CALCULATION OF REIMBURSEMENT SETTLEMENT,COMPUTATION OF RATIO OF COST TO CHARGES,APPORTIONMENT OF MEDICAL AND OTHER HEALTH SERVICES,HOSPITAL WAGE INDEX DATA,TRIAL BALANCE OF EXPENSE ACCOUNTS,HOSPITAL WAGE INDEX DATA,COMPUTATION OF RATIO OF COST TO CHARGES,INPATIENT ANCILLARY SERVICE COST APPORTIONMENT,INPATIENT ANCILLARY SERVICE COST APPORTIONMENT,APPORTIONMENT OF INPATIENT/OUTPATIENT ANCILLARY SERVICE OTHER PASS THROUGH COSTS,COST ALLOCATION,APPORTIONMENT OF INPATIENT/OUTPATIENT ANCILLARY SERVICE OTHER PASS THROUGH COSTS,INPATIENT ANCILLARY SERVICE COST APPORTIONMENT,COST ALLOCATION,COMPUTATION OF RATIO OF COST TO CHARGES,APPORTIONMENT OF INPATIENT ROUTINE SERVICE OTHER PASS THROUGH COSTS,TRIAL BALANCE OF EXPENSE ACCOUNTS,,APPORTIONMENT OF MEDICAL AND OTHER HEALTH SERVICES,HOSPITAL WAGE INDEX DATA,APPORTIONMENT OF INPATIENT/OUTPATIENT ANCILLARY SERVICE OTHER PASS THROUGH COSTS,HOSPITAL WAGE INDEX DATA,,HOSPITAL WAGE INDEX DATA,,APPORTIONMENT OF INPATIENT/OUTPATIENT ANCILLARY SERVICE OTHER PASS THROUGH COSTS,HOSPITAL WAGE INDEX DATA,RENAL STATISTICAL DATA,APPORTIONMENT OF MEDICAL AND OTHER HEALTH SERVICES,COST ALLOCATION,APPORTIONMENT OF INPATIENT/OUTPATIENT ANCILLARY SERVICE OTHER PASS THROUGH COSTS,COST ALLOCATION,COMPUTATION OF INPATIENT OPERATING COSTS,ALLOCATION OF NEW CAPITAL COSTS,,INPATIENT ANCILLARY SERVICE COST APPORTIONMENT,APPORTIONMENT OF INPATIENT/OUTPATIENT ANCILLARY SERVICE OTHER PASS THROUGH COSTS,,APPORTIONMENT OF INPATIENT/OUTPATIENT ANCILLARY SERVICE OTHER PASS THROUGH COSTS,APPORTIONMENT OF MEDICAL AND OTHER HEALTH SERVICES,APPORTIONMENT OF MEDICAL AND OTHER HEALTH SERVICES,TRIAL BALANCE OF EXPENSE ACCOUNTS,COMPUTATION OF RATIO OF COST TO CHARGES,Medicaid Inpatient Days/Outpatient Visits,TRIAL BALANCE OF EXPENSE ACCOUNTS,APPORTIONMENT OF INPATIENT/OUTPATIENT ANCILLARY SERVICE OTHER PASS THROUGH COSTS,HOSPITAL WAGE INDEX DATA,APPORTIONMENT OF MEDICAL AND OTHER HEALTH SERVICES,APPORTIONMENT OF INPATIENT/OUTPATIENT ANCILLARY SERVICE OTHER PASS THROUGH COSTS,HOSPITAL WAGE INDEX DATA,,APPORTIONMENT OF INPATIENT/OUTPATIENT ANCILLARY SERVICE OTHER PASS THROUGH COSTS,COMPUTATION OF RATIO OF COST TO CHARGES,ALLOCATION OF NEW CAPITAL COSTS,TRIAL BALANCE OF EXPENSE ACCOUNTS,APPORTIONMENT OF MEDICAL AND OTHER HEALTH SERVICES,HOSPITAL WAGE INDEX DATA,ADJUSTMENTS,APPORTIONMENT OF INPATIENT/OUTPATIENT ANCILLARY SERVICE OTHER PASS THROUGH COSTS,RECONCILIATION OF CAPITAL COST CENTERS,COMPUTATION OF RATIO OF COST TO CHARGES,COST ALLOCATION,,TRIAL BALANCE OF EXPENSE ACCOUNTS,COMPUTATION OF RATIO OF COST TO CHARGES,COST ALLOCATION,CALCULATION OF REIMBURSEMENT SETTLEMENT (PPS),APPORTIONMENT OF INPATIENT/OUTPATIENT ANCILLARY SERVICE OTHER PASS THROUGH COSTS,HHA STATISTICAL DATA,TRIAL BALANCE OF EXPENSE ACCOUNTS,Medicaid Inpatient Days/Outpatient Visits,Total Inpatient Days/Outpatient Visits,APPORTIONMENT OF MEDICAL AND OTHER HEALTH SERVICES,,TRIAL BALANCE OF EXPENSE ACCOUNTS,TRIAL BALANCE OF EXPENSE ACCOUNTS,COMPUTATION OF INPATIENT OPERATING COSTS,COMPUTATION OF INPATIENT OPERATING COSTS,COMPUTATION OF RATIO OF COST TO CHARGES,INPATIENT ANCILLARY SERVICE COST APPORTIONMENT,APPORTIONMENT OF INPATIENT/OUTPATIENT ANCILLARY SERVICE OTHER PASS THROUGH COSTS,HOSPITAL WAGE INDEX DATA,COST ALLOCATION,INPATIENT ANCILLARY SERVICE COST APPORTIONMENT,ADJUSTMENTS,,APPORTIONMENT OF INPATIENT/OUTPATIENT ANCILLARY SERVICE OTHER PASS THROUGH COSTS,TRIAL BALANCE OF EXPENSE ACCOUNTS,COMPUTATION OF RATIO OF COST TO CHARGES,ANALYSIS OF CHANGES IN NEW CAPITAL BALANCES,TRIAL BALANCE OF EXPENSE ACCOUNTS,TRIAL BALANCE OF EXPENSE ACCOUNTS,COST ALLOCATION,INPATIENT ANCILLARY SERVICE COST APPORTIONMENT,RECONCILIATION OF CAPITAL COST CENTERS,Medicare Inpatient Days/Outpatient Visits,COMPUTATION OF RATIO OF COST TO CHARGES,INPATIENT ANCILLARY SERVICE COST APPORTIONMENT,COST ALLOCATION,TRIAL BALANCE OF EXPENSE ACCOUNTS,COMPUTATION OF INPATIENT OPERATING COSTS,COST ALLOCATION,HOSPITAL WAGE INDEX DATA,COST ALLOCATION,COST ALLOCATION,APPORTIONMENT OF INPATIENT/OUTPATIENT ANCILLARY SERVICE OTHER PASS THROUGH COSTS,APPORTIONMENT OF INPATIENT/OUTPATIENT ANCILLARY SERVICE OTHER PASS THROUGH COSTS,APPORTIONMENT OF INPATIENT/OUTPATIENT ANCILLARY SERVICE OTHER PASS THROUGH COSTS,APPORTIONMENT OF INPATIENT/OUTPATIENT ANCILLARY SERVICE OTHER PASS THROUGH COSTS,,INPATIENT ANCILLARY SERVICE COST APPORTIONMENT,Total Inpatient Days/Outpatient Visits,COST ALLOCATION,TRIAL BALANCE OF EXPENSE ACCOUNTS,COST ALLOCATION,HOSPITAL WAGE INDEX DATA,HOSPITAL WAGE INDEX DATA,Total Inpatient Days/Outpatient Visits,Medicare Inpatient Days/Outpatient Visits,,APPORTIONMENT OF INPATIENT/OUTPATIENT ANCILLARY SERVICE OTHER PASS THROUGH COSTS,INPATIENT ANCILLARY SERVICE COST APPORTIONMENT,COST ALLOCATION,APPORTIONMENT OF INPATIENT/OUTPATIENT ANCILLARY SERVICE OTHER PASS THROUGH COSTS,HOSPITAL WAGE INDEX DATA,HOSPITAL WAGE INDEX DATA,APPORTIONMENT OF INPATIENT/OUTPATIENT ANCILLARY SERVICE OTHER PASS THROUGH COSTS,INPATIENT ANCILLARY SERVICE COST APPORTIONMENT,INPATIENT ANCILLARY SERVICE COST APPORTIONMENT,CALCULATION OF REIMBURSEMENT SETTLEMENT,,INPATIENT ANCILLARY SERVICE COST APPORTIONMENT,HOSPITAL WAGE INDEX DATA,HOSPITAL IDENTIFICATION INFORMATION,APPORTIONMENT OF INPATIENT/OUTPATIENT ANCILLARY SERVICE OTHER PASS THROUGH COSTS,S-10 DATA,COMPUTATION OF RATIO OF COST TO CHARGES,COST ALLOCATION,INPATIENT ANCILLARY SERVICE COST APPORTIONMENT,APPORTIONMENT OF MEDICAL AND OTHER HEALTH SERVICES,APPORTIONMENT OF INPATIENT/OUTPATIENT ANCILLARY SERVICE OTHER PASS THROUGH COSTS,INPATIENT ANCILLARY SERVICE COST APPORTIONMENT,RENAL STATISTICAL DATA,APPORTIONMENT OF INPATIENT/OUTPATIENT ANCILLARY SERVICE OTHER PASS THROUGH COSTS,APPORTIONMENT OF MEDICAL AND OTHER HEALTH SERVICES,TRIAL BALANCE OF EXPENSE ACCOUNTS,INPATIENT ANCILLARY SERVICE COST APPORTIONMENT,HOSPITAL WAGE INDEX DATA,COST ALLOCATION,TRIAL BALANCE OF EXPENSE ACCOUNTS,ANALYSIS OF CHANGES IN NEW CAPITAL BALANCES,APPORTIONMENT OF INPATIENT/OUTPATIENT ANCILLARY SERVICE OTHER PASS THROUGH COSTS,APPORTIONMENT OF INPATIENT/OUTPATIENT ANCILLARY SERVICE OTHER PASS THROUGH COSTS,APPORTIONMENT OF INPATIENT/OUTPATIENT ANCILLARY SERVICE OTHER PASS THROUGH COSTS,ALLOCATION OF NEW CAPITAL COSTS,INPATIENT ANCILLARY SERVICE COST APPORTIONMENT,COST ALLOCATION,TRIAL BALANCE OF EXPENSE ACCOUNTS,BALANCE SHEET,TRIAL BALANCE OF EXPENSE ACCOUNTS,TRIAL BALANCE OF EXPENSE ACCOUNTS,ANALYSIS OF CHANGES IN NEW CAPITAL BALANCES,TRIAL BALANCE OF EXPENSE ACCOUNTS,INPATIENT ANCILLARY SERVICE COST APPORTIONMENT,HHA STATISTICAL DATA,COST ALLOCATION,Medicare Inpatient Days/Outpatient Visits,Total Inpatient Days/Outpatient Visits,APPORTIONMENT OF MEDICAL AND OTHER HEALTH SERVICES,COST ALLOCATION,HOSPITAL WAGE INDEX DATA,HHA STATISTICAL DATA,APPORTIONMENT OF INPATIENT/OUTPATIENT ANCILLARY SERVICE OTHER PASS THROUGH COSTS,APPORTIONMENT OF INPATIENT/OUTPATIENT ANCILLARY SERVICE OTHER PASS THROUGH COSTS,HHA STATISTICAL DATA,APPORTIONMENT OF MEDICAL AND OTHER HEALTH SERVICES,APPORTIONMENT OF MEDICAL AND OTHER HEALTH SERVICES,COST ALLOCATION,COST ALLOCATION,HOSPITAL WAGE INDEX DATA,,ANALYSIS OF CHANGES IN NEW CAPITAL BALANCES,CALCULATION OF REIMBURSEMENT SETTLEMENT,ALLOCATION OF NEW CAPITAL COSTS,APPORTIONMENT OF INPATIENT/OUTPATIENT ANCILLARY SERVICE OTHER PASS THROUGH COSTS,COST ALLOCATION,ALLOCATION OF NEW CAPITAL COSTS,BED DAYS AVAILABLE,APPORTIONMENT OF INPATIENT ROUTINE SERVICE CAPITAL COSTS,COMPUTATION OF INPATIENT OPERATING COSTS,APPORTIONMENT OF MEDICAL AND OTHER HEALTH SERVICES,APPORTIONMENT OF MEDICAL AND OTHER HEALTH SERVICES,Total Inpatient Days/Outpatient Visits,INPATIENT ANCILLARY SERVICE COST APPORTIONMENT,HOSPITAL WAGE INDEX DATA,APPORTIONMENT OF INPATIENT/OUTPATIENT ANCILLARY SERVICE OTHER PASS THROUGH COSTS,APPORTIONMENT OF MEDICAL AND OTHER HEALTH SERVICES,APPORTIONMENT OF INPATIENT ROUTINE SERVICE OTHER PASS THROUGH COSTS,APPORTIONMENT OF INPATIENT/OUTPATIENT ANCILLARY SERVICE OTHER PASS THROUGH COSTS,TRIAL BALANCE OF EXPENSE ACCOUNTS,COST ALLOCATION,APPORTIONMENT OF INPATIENT/OUTPATIENT ANCILLARY SERVICE OTHER PASS THROUGH COSTS,COST ALLOCATION,COST ALLOCATION,COMPUTATION OF RATIO OF COST TO CHARGES,APPORTIONMENT OF INPATIENT ROUTINE SERVICE OTHER PASS THROUGH COSTS,APPORTIONMENT OF MEDICAL AND OTHER HEALTH SERVICES,ADJUSTMENTS,COST ALLOCATION,COMPUTATION OF RATIO OF COST TO CHARGES,COST ALLOCATION,COST ALLOCATION,NUMBER OF BEDS,COST ALLOCATION,COST ALLOCATION,Total Inpatient Days/Outpatient Visits,Medicare Inpatient Days/Outpatient Visits,Medicaid Inpatient Days/Outpatient Visits,INPATIENT ANCILLARY SERVICE COST APPORTIONMENT,TRIAL BALANCE OF EXPENSE ACCOUNTS,APPORTIONMENT OF MEDICAL AND OTHER HEALTH SERVICES,INPATIENT ANCILLARY SERVICE COST APPORTIONMENT,APPORTIONMENT OF INPATIENT/OUTPATIENT ANCILLARY SERVICE OTHER PASS THROUGH COSTS,APPORTIONMENT OF MEDICAL AND OTHER HEALTH SERVICES,APPORTIONMENT OF MEDICAL AND OTHER HEALTH SERVICES,COST ALLOCATION,,INPATIENT ANCILLARY SERVICE COST APPORTIONMENT,APPORTIONMENT OF MEDICAL AND OTHER HEALTH SERVICES,APPORTIONMENT OF MEDICAL AND OTHER HEALTH SERVICES,HHA STATISTICAL DATA,HHA STATISTICAL DATA,COST ALLOCATION,COMPUTATION OF RATIO OF COST TO CHARGES,BED DAYS AVAILABLE,CALCULATION OF REIMBURSEMENT SETTLEMENT,APPORTIONMENT OF INPATIENT/OUTPATIENT ANCILLARY SERVICE OTHER PASS THROUGH COSTS,APPORTIONMENT OF MEDICAL AND OTHER HEALTH SERVICES,APPORTIONMENT OF MEDICAL AND OTHER HEALTH SERVICES,STATEMENT OF REVENUES AND EXPENSES,BED DAYS AVAILABLE,HOSPITAL IDENTIFICATION INFORMATION,HHA STATISTICAL DATA,APPORTIONMENT OF MEDICAL AND OTHER HEALTH SERVICES,ALLOCATION OF NEW CAPITAL COSTS,APPORTIONMENT OF INPATIENT/OUTPATIENT ANCILLARY SERVICE OTHER PASS THROUGH COSTS,,HOSPITAL WAGE INDEX DATA,APPORTIONMENT OF MEDICAL AND OTHER HEALTH SERVICES,APPORTIONMENT OF INPATIENT/OUTPATIENT ANCILLARY SERVICE OTHER PASS THROUGH COSTS,CALCULATION OF REIMBURSEMENT SETTLEMENT,APPORTIONMENT OF MEDICAL AND OTHER HEALTH SERVICES,APPORTIONMENT OF INPATIENT/OUTPATIENT ANCILLARY SERVICE OTHER PASS THROUGH COSTS,HHA STATISTICAL DATA,COST ALLOCATION,ADJUSTMENTS,S-10 DATA,INPATIENT ANCILLARY SERVICE COST APPORTIONMENT,COST ALLOCATION,TRIAL BALANCE OF EXPENSE ACCOUNTS,INPATIENT ANCILLARY SERVICE COST APPORTIONMENT,APPORTIONMENT OF INPATIENT/OUTPATIENT ANCILLARY SERVICE OTHER PASS THROUGH COSTS,,TRIAL BALANCE OF EXPENSE ACCOUNTS,,RENAL STATISTICAL DATA,,COMPUTATION OF RATIO OF COST TO CHARGES,INPATIENT ANCILLARY SERVICE COST APPORTIONMENT,S-10 DATA,COMPUTATION OF RATIO OF COST TO CHARGES,HOSPITAL WAGE INDEX DATA,COST ALLOCATION,APPORTIONMENT OF INPATIENT/OUTPATIENT ANCILLARY SERVICE OTHER PASS THROUGH COSTS,,RENAL STATISTICAL DATA,COMPUTATION OF RATIO OF COST TO CHARGES,HOSPITAL WAGE INDEX DATA,INPATIENT ANCILLARY SERVICE COST APPORTIONMENT,COST ALLOCATION,APPORTIONMENT OF INPATIENT/OUTPATIENT ANCILLARY SERVICE OTHER PASS THROUGH COSTS,INPATIENT ANCILLARY SERVICE COST APPORTIONMENT,HOSPITAL WAGE INDEX DATA,HOSPITAL WAGE INDEX DATA,APPORTIONMENT OF INPATIENT/OUTPATIENT ANCILLARY SERVICE OTHER PASS THROUGH COSTS,,HOSPITAL WAGE INDEX DATA,TRIAL BALANCE OF EXPENSE ACCOUNTS,COST ALLOCATION,Total Inpatient Days/Outpatient Visits,TRIAL BALANCE OF EXPENSE ACCOUNTS,APPORTIONMENT OF INPATIENT/OUTPATIENT ANCILLARY SERVICE OTHER PASS THROUGH COSTS,CALCULATION OF REIMBURSEMENT SETTLEMENT (PPS),COST ALLOCATION,TRIAL BALANCE OF EXPENSE ACCOUNTS,APPORTIONMENT OF INPATIENT/OUTPATIENT ANCILLARY SERVICE OTHER PASS THROUGH COSTS,TRIAL BALANCE OF EXPENSE ACCOUNTS,,COST ALLOCATION,COST ALLOCATION,APPORTIONMENT OF INPATIENT/OUTPATIENT ANCILLARY SERVICE OTHER PASS THROUGH COSTS,INPATIENT ANCILLARY SERVICE COST APPORTIONMENT,NUMBER OF BEDS,S-10 DATA,TRIAL BALANCE OF EXPENSE ACCOUNTS,BALANCE SHEET,HOSPITAL WAGE INDEX DATA,COST ALLOCATION,APPORTIONMENT OF INPATIENT/OUTPATIENT ANCILLARY SERVICE OTHER PASS THROUGH COSTS,COMPUTATION OF RATIO OF COST TO CHARGES,TRIAL BALANCE OF EXPENSE ACCOUNTS,RECONCILIATION OF CAPITAL COST CENTERS,HOSPITAL WAGE INDEX DATA,Medicare Inpatient Days/Outpatient Visits,APPORTIONMENT OF MEDICAL AND OTHER HEALTH SERVICES,APPORTIONMENT OF MEDICAL AND OTHER HEALTH SERVICES,,APPORTIONMENT OF INPATIENT ROUTINE SERVICE CAPITAL COSTS,HOSPITAL IDENTIFICATION INFORMATION,HOSPITAL WAGE INDEX DATA,APPORTIONMENT OF INPATIENT/OUTPATIENT ANCILLARY SERVICE OTHER PASS THROUGH COSTS,HOSPITAL IDENTIFICATION INFORMATION,COMPUTATION OF RATIO OF COST TO CHARGES,INPATIENT ANCILLARY SERVICE COST APPORTIONMENT,COMPUTATION OF INPATIENT OPERATING COSTS,TRIAL BALANCE OF EXPENSE ACCOUNTS,APPORTIONMENT OF INPATIENT/OUTPATIENT ANCILLARY SERVICE OTHER PASS THROUGH COSTS,COST ALLOCATION,INPATIENT ANCILLARY SERVICE COST APPORTIONMENT,APPORTIONMENT OF MEDICAL AND OTHER HEALTH SERVICES,TRIAL BALANCE OF EXPENSE ACCOUNTS,CALCULATION OF REIMBURSEMENT SETTLEMENT,RENAL STATISTICAL DATA,APPORTIONMENT OF INPATIENT/OUTPATIENT ANCILLARY SERVICE OTHER PASS THROUGH COSTS,APPORTIONMENT OF INPATIENT/OUTPATIENT ANCILLARY SERVICE OTHER PASS THROUGH COSTS,APPORTIONMENT OF MEDICAL AND OTHER HEALTH SERVICES,INPATIENT ANCILLARY SERVICE COST APPORTIONMENT,HHA STATISTICAL DATA,HOSPITAL WAGE INDEX DATA,RENAL STATISTICAL DATA,COMPUTATION OF RATIO OF COST TO CHARGES,HHA STATISTICAL DATA,COST ALLOCATION,HOSPITAL WAGE INDEX DATA,HHA STATISTICAL DATA,INPATIENT ANCILLARY SERVICE COST APPORTIONMENT,TRIAL BALANCE OF EXPENSE ACCOUNTS,TRIAL BALANCE OF EXPENSE ACCOUNTS,TRIAL BALANCE OF EXPENSE ACCOUNTS,,Medicaid Inpatient Days/Outpatient Visits,COMPUTATION OF RATIO OF COST TO CHARGES,BED DAYS AVAILABLE,APPORTIONMENT OF INPATIENT/OUTPATIENT ANCILLARY SERVICE OTHER PASS THROUGH COSTS,INPATIENT ANCILLARY SERVICE COST APPORTIONMENT,TRIAL BALANCE OF EXPENSE ACCOUNTS,COST ALLOCATION,APPORTIONMENT OF MEDICAL AND OTHER HEALTH SERVICES,ANALYSIS OF CHANGES IN NEW CAPITAL BALANCES,COMPUTATION OF RATIO OF COST TO CHARGES,INPATIENT ANCILLARY SERVICE COST APPORTIONMENT,STATEMENT OF PATIENT REVENUES AND OPERATING EXPENSES,TRIAL BALANCE OF EXPENSE ACCOUNTS,COST ALLOCATION,APPORTIONMENT OF INPATIENT/OUTPATIENT ANCILLARY SERVICE OTHER PASS THROUGH COSTS,HOSPITAL WAGE INDEX DATA,TRIAL BALANCE OF EXPENSE ACCOUNTS,COMPUTATION OF RATIO OF COST TO CHARGES,INPATIENT ANCILLARY SERVICE COST APPORTIONMENT,HOSPITAL WAGE INDEX DATA,TRIAL BALANCE OF EXPENSE ACCOUNTS,TRIAL BALANCE OF EXPENSE ACCOUNTS,COST ALLOCATION,COST ALLOCATION,ANALYSIS OF CHANGES IN NEW CAPITAL BALANCES,COST ALLOCATION,COST ALLOCATION,INPATIENT ANCILLARY SERVICE COST APPORTIONMENT,Total Inpatient Days/Outpatient Visits,HOSPITAL IDENTIFICATION INFORMATION,HOSPITAL WAGE INDEX DATA,COST ALLOCATION,COMPUTATION OF RATIO OF COST TO CHARGES,Medicaid Inpatient Days/Outpatient Visits,APPORTIONMENT OF MEDICAL AND OTHER HEALTH SERVICES,APPORTIONMENT OF MEDICAL AND OTHER HEALTH SERVICES,ADJUSTMENTS,COMPUTATION OF RATIO OF COST TO CHARGES,COMPUTATION OF RATIO OF COST TO CHARGES,APPORTIONMENT OF INPATIENT/OUTPATIENT ANCILLARY SERVICE OTHER PASS THROUGH COSTS,HHA STATISTICAL DATA,APPORTIONMENT OF INPATIENT/OUTPATIENT ANCILLARY SERVICE OTHER PASS THROUGH COSTS,APPORTIONMENT OF INPATIENT/OUTPATIENT ANCILLARY SERVICE OTHER PASS THROUGH COSTS,COST ALLOCATION,INPATIENT ANCILLARY SERVICE COST APPORTIONMENT,COMPUTATION OF RATIO OF COST TO CHARGES,COST ALLOCATION,TRIAL BALANCE OF EXPENSE ACCOUNTS,,ALLOCATION OF NEW CAPITAL COSTS,,COMPUTATION OF RATIO OF COST TO CHARGES,HOSPITAL WAGE INDEX DATA,,APPORTIONMENT OF INPATIENT/OUTPATIENT ANCILLARY SERVICE OTHER PASS THROUGH COSTS,HOSPITAL WAGE INDEX DATA,ADJUSTMENTS,COMPUTATION OF RATIO OF COST TO CHARGES,APPORTIONMENT OF INPATIENT/OUTPATIENT ANCILLARY SERVICE OTHER PASS THROUGH COSTS,HOSPITAL WAGE INDEX DATA,TRIAL BALANCE OF EXPENSE ACCOUNTS,HOSPITAL WAGE INDEX DATA,APPORTIONMENT OF INPATIENT/OUTPATIENT ANCILLARY SERVICE OTHER PASS THROUGH COSTS,COST ALLOCATION,Total Inpatient Days/Outpatient Visits,TRIAL BALANCE OF EXPENSE ACCOUNTS,TRIAL BALANCE OF EXPENSE ACCOUNTS,TRIAL BALANCE OF EXPENSE ACCOUNTS,COST ALLOCATION,APPORTIONMENT OF INPATIENT ROUTINE SERVICE CAPITAL COSTS,APPORTIONMENT OF INPATIENT/OUTPATIENT ANCILLARY SERVICE OTHER PASS THROUGH COSTS,INPATIENT ANCILLARY SERVICE COST APPORTIONMENT,HOSPITAL WAGE INDEX DATA,APPORTIONMENT OF INPATIENT/OUTPATIENT ANCILLARY SERVICE OTHER PASS THROUGH COSTS,ADJUSTMENTS,APPORTIONMENT OF INPATIENT/OUTPATIENT ANCILLARY SERVICE OTHER PASS THROUGH COSTS,ANALYSIS OF CHANGES IN NEW CAPITAL BALANCES,APPORTIONMENT OF INPATIENT/OUTPATIENT ANCILLARY SERVICE OTHER PASS THROUGH COSTS,HOSPITAL IDENTIFICATION INFORMATION,APPORTIONMENT OF INPATIENT/OUTPATIENT ANCILLARY SERVICE OTHER PASS THROUGH COSTS,HHA STATISTICAL DATA,,,S-10 DATA,TRIAL BALANCE OF EXPENSE ACCOUNTS,APPORTIONMENT OF INPATIENT/OUTPATIENT ANCILLARY SERVICE OTHER PASS THROUGH COSTS,HOSPITAL WAGE INDEX DATA,HOSPITAL WAGE INDEX DATA,CALCULATION OF REIMBURSEMENT SETTLEMENT,HOSPITAL WAGE INDEX DATA,CALCULATION OF REIMBURSEMENT SETTLEMENT,COST ALLOCATION,COST ALLOCATION,COST ALLOCATION,APPORTIONMENT OF INPATIENT/OUTPATIENT ANCILLARY SERVICE OTHER PASS THROUGH COSTS,RECONCILIATION OF CAPITAL COST CENTERS,TRIAL BALANCE OF EXPENSE ACCOUNTS,,HOSPITAL WAGE INDEX DATA,INPATIENT ANCILLARY SERVICE COST APPORTIONMENT,RECONCILIATION OF CAPITAL COST CENTERS,APPORTIONMENT OF INPATIENT ROUTINE SERVICE CAPITAL COSTS,COMPUTATION OF RATIO OF COST TO CHARGES,APPORTIONMENT OF INPATIENT/OUTPATIENT ANCILLARY SERVICE OTHER PASS THROUGH COSTS,TRIAL BALANCE OF EXPENSE ACCOUNTS,COST ALLOCATION,HHA STATISTICAL DATA,,,APPORTIONMENT OF INPATIENT/OUTPATIENT ANCILLARY SERVICE OTHER PASS THROUGH COSTS,ANALYSIS OF CHANGES IN NEW CAPITAL BALANCES,Medicare Inpatient Days/Outpatient Visits,BALANCE SHEET,COST ALLOCATION,HOSPITAL WAGE INDEX DATA,APPORTIONMENT OF INPATIENT/OUTPATIENT ANCILLARY SERVICE OTHER PASS THROUGH COSTS,TRIAL BALANCE OF EXPENSE ACCOUNTS,COMPUTATION OF RATIO OF COST TO CHARGES,COMPUTATION OF RATIO OF COST TO CHARGES,APPORTIONMENT OF MEDICAL AND OTHER HEALTH SERVICES,TRIAL BALANCE OF EXPENSE ACCOUNTS,COST ALLOCATION,TRIAL BALANCE OF EXPENSE ACCOUNTS,APPORTIONMENT OF INPATIENT/OUTPATIENT ANCILLARY SERVICE OTHER PASS THROUGH COSTS,HHA STATISTICAL DATA,COMPUTATION OF RATIO OF COST TO CHARGES,APPORTIONMENT OF MEDICAL AND OTHER HEALTH SERVICES,APPORTIONMENT OF INPATIENT/OUTPATIENT ANCILLARY SERVICE OTHER PASS THROUGH COSTS,INPATIENT ANCILLARY SERVICE COST APPORTIONMENT,COST ALLOCATION,ANALYSIS OF CHANGES IN NEW CAPITAL BALANCES,COST ALLOCATION,,HOSPITAL WAGE INDEX DATA,INPATIENT ANCILLARY SERVICE COST APPORTIONMENT,APPORTIONMENT OF INPATIENT/OUTPATIENT ANCILLARY SERVICE OTHER PASS THROUGH COSTS,Medicare Inpatient Days/Outpatient Visits,CALCULATION OF REIMBURSEMENT SETTLEMENT,,HOSPITAL WAGE INDEX DATA,ANALYSIS OF CHANGES IN NEW CAPITAL BALANCES,COMPUTATION OF RATIO OF COST TO CHARGES,APPORTIONMENT OF INPATIENT/OUTPATIENT ANCILLARY SERVICE OTHER PASS THROUGH COSTS,INPATIENT ANCILLARY SERVICE COST APPORTIONMENT,COMPUTATION OF RATIO OF COST TO CHARGES,TRIAL BALANCE OF EXPENSE ACCOUNTS,COST ALLOCATION,INPATIENT ANCILLARY SERVICE COST APPORTIONMENT,Medicaid Inpatient Days/Outpatient Visits,,Total Inpatient Days/Outpatient Visits,APPORTIONMENT OF MEDICAL AND OTHER HEALTH SERVICES,INPATIENT ANCILLARY SERVICE COST APPORTIONMENT,COST ALLOCATION,CALCULATION OF REIMBURSEMENT SETTLEMENT,BALANCE SHEET,BED DAYS AVAILABLE,COMPUTATION OF RATIO OF COST TO CHARGES,APPORTIONMENT OF MEDICAL AND OTHER HEALTH SERVICES,INPATIENT ANCILLARY SERVICE COST APPORTIONMENT,COMPUTATION OF RATIO OF COST TO CHARGES,ANALYSIS OF CHANGES IN NEW CAPITAL BALANCES,COST ALLOCATION,APPORTIONMENT OF INPATIENT/OUTPATIENT ANCILLARY SERVICE OTHER PASS THROUGH COSTS,BALANCE SHEET,INPATIENT ANCILLARY SERVICE COST APPORTIONMENT,INPATIENT ANCILLARY SERVICE COST APPORTIONMENT,APPORTIONMENT OF INPATIENT/OUTPATIENT ANCILLARY SERVICE OTHER PASS THROUGH COSTS,APPORTIONMENT OF MEDICAL AND OTHER HEALTH SERVICES,Medicaid Inpatient Days/Outpatient Visits,ANALYSIS OF CHANGES IN NEW CAPITAL BALANCES,INPATIENT ANCILLARY SERVICE COST APPORTIONMENT,APPORTIONMENT OF INPATIENT/OUTPATIENT ANCILLARY SERVICE OTHER PASS THROUGH COSTS,ANALYSIS OF CHANGES IN NEW CAPITAL BALANCES,INPATIENT ANCILLARY SERVICE COST APPORTIONMENT,HOSPITAL WAGE INDEX DATA,HOSPITAL WAGE INDEX DATA,ADJUSTMENTS,APPORTIONMENT OF MEDICAL AND OTHER HEALTH SERVICES,COST ALLOCATION,Medicaid Inpatient Days/Outpatient Visits,HOSPITAL WAGE INDEX DATA,HHA STATISTICAL DATA,INPATIENT ANCILLARY SERVICE COST APPORTIONMENT,ANALYSIS OF CHANGES IN NEW CAPITAL BALANCES,TRIAL BALANCE OF EXPENSE ACCOUNTS,TRIAL BALANCE OF EXPENSE ACCOUNTS,INPATIENT ANCILLARY SERVICE COST APPORTIONMENT,Medicaid Inpatient Days/Outpatient Visits,TRIAL BALANCE OF EXPENSE ACCOUNTS,HOSPITAL WAGE INDEX DATA,TRIAL BALANCE OF EXPENSE ACCOUNTS,COMPUTATION OF INPATIENT OPERATING COSTS,COST ALLOCATION,INPATIENT ANCILLARY SERVICE COST APPORTIONMENT,COMPUTATION OF INPATIENT OPERATING COSTS,TRIAL BALANCE OF EXPENSE ACCOUNTS,APPORTIONMENT OF MEDICAL AND OTHER HEALTH SERVICES,ADJUSTMENTS,HHA STATISTICAL DATA,INPATIENT ANCILLARY SERVICE COST APPORTIONMENT,TRIAL BALANCE OF EXPENSE ACCOUNTS,CALCULATION OF REIMBURSEMENT SETTLEMENT,APPORTIONMENT OF INPATIENT/OUTPATIENT ANCILLARY SERVICE OTHER PASS THROUGH COSTS,COMPUTATION OF RATIO OF COST TO CHARGES,COST ALLOCATION,COMPUTATION OF RATIO OF COST TO CHARGES,INPATIENT ANCILLARY SERVICE COST APPORTIONMENT,COMPUTATION OF RATIO OF COST TO CHARGES,Medicaid Inpatient Days/Outpatient Visits,APPORTIONMENT OF MEDICAL AND OTHER HEALTH SERVICES,ALLOCATION OF NEW CAPITAL COSTS,APPORTIONMENT OF INPATIENT/OUTPATIENT ANCILLARY SERVICE OTHER PASS THROUGH COSTS,COMPUTATION OF RATIO OF COST TO CHARGES,HOSPITAL WAGE INDEX DATA,BALANCE SHEET,APPORTIONMENT OF INPATIENT/OUTPATIENT ANCILLARY SERVICE OTHER PASS THROUGH COSTS,APPORTIONMENT OF MEDICAL AND OTHER HEALTH SERVICES,RENAL STATISTICAL DATA,TRIAL BALANCE OF EXPENSE ACCOUNTS,INPATIENT ANCILLARY SERVICE COST APPORTIONMENT,TRIAL BALANCE OF EXPENSE ACCOUNTS,TRIAL BALANCE OF EXPENSE ACCOUNTS,APPORTIONMENT OF INPATIENT/OUTPATIENT ANCILLARY SERVICE OTHER PASS THROUGH COSTS,BALANCE SHEET,TRIAL BALANCE OF EXPENSE ACCOUNTS,COST ALLOCATION,HHA STATISTICAL DATA,TRIAL BALANCE OF EXPENSE ACCOUNTS,INPATIENT ANCILLARY SERVICE COST APPORTIONMENT,APPORTIONMENT OF MEDICAL AND OTHER HEALTH SERVICES,ANALYSIS OF CHANGES IN NEW CAPITAL BALANCES,APPORTIONMENT OF INPATIENT/OUTPATIENT ANCILLARY SERVICE OTHER PASS THROUGH COSTS,COST ALLOCATION,APPORTIONMENT OF MEDICAL AND OTHER HEALTH SERVICES,COMPUTATION OF RATIO OF COST TO CHARGES,APPORTIONMENT OF INPATIENT/OUTPATIENT ANCILLARY SERVICE OTHER PASS THROUGH COSTS,TRIAL BALANCE OF EXPENSE ACCOUNTS,INPATIENT ANCILLARY SERVICE COST APPORTIONMENT,TRIAL BALANCE OF EXPENSE ACCOUNTS,APPORTIONMENT OF INPATIENT/OUTPATIENT ANCILLARY SERVICE OTHER PASS THROUGH COSTS,APPORTIONMENT OF INPATIENT/OUTPATIENT ANCILLARY SERVICE OTHER PASS THROUGH COSTS,APPORTIONMENT OF INPATIENT/OUTPATIENT ANCILLARY SERVICE OTHER PASS THROUGH COSTS,APPORTIONMENT OF MEDICAL AND OTHER HEALTH SERVICES,RENAL STATISTICAL DATA,INPATIENT ANCILLARY SERVICE COST APPORTIONMENT,TRIAL BALANCE OF EXPENSE ACCOUNTS,COST ALLOCATION,S-10 DATA,COST ALLOCATION,COST ALLOCATION,APPORTIONMENT OF INPATIENT/OUTPATIENT ANCILLARY SERVICE OTHER PASS THROUGH COSTS,INPATIENT ANCILLARY SERVICE COST APPORTIONMENT,COST ALLOCATION,INPATIENT ANCILLARY SERVICE COST APPORTIONMENT,APPORTIONMENT OF MEDICAL AND OTHER HEALTH SERVICES,APPORTIONMENT OF INPATIENT/OUTPATIENT ANCILLARY SERVICE OTHER PASS THROUGH COSTS,APPORTIONMENT OF INPATIENT/OUTPATIENT ANCILLARY SERVICE OTHER PASS THROUGH COSTS,APPORTIONMENT OF INPATIENT/OUTPATIENT ANCILLARY SERVICE OTHER PASS THROUGH COSTS,ALLOCATION OF NEW CAPITAL COSTS,STATEMENT OF REVENUES AND EXPENSES,APPORTIONMENT OF INPATIENT/OUTPATIENT ANCILLARY SERVICE OTHER PASS THROUGH COSTS,TRIAL BALANCE OF EXPENSE ACCOUNTS,HOSPITAL WAGE INDEX DATA,,COST ALLOCATION,TRIAL BALANCE OF EXPENSE ACCOUNTS,INPATIENT ANCILLARY SERVICE COST APPORTIONMENT,RENAL STATISTICAL DATA,HOSPITAL WAGE INDEX DATA,INPATIENT ANCILLARY SERVICE COST APPORTIONMENT,TRIAL BALANCE OF EXPENSE ACCOUNTS,COST ALLOCATION,APPORTIONMENT OF INPATIENT/OUTPATIENT ANCILLARY SERVICE OTHER PASS THROUGH COSTS,BALANCE SHEET,TRIAL BALANCE OF EXPENSE ACCOUNTS,ADJUSTMENTS,COMPUTATION OF RATIO OF COST TO CHARGES,,,HHA STATISTICAL DATA,APPORTIONMENT OF INPATIENT/OUTPATIENT ANCILLARY SERVICE OTHER PASS THROUGH COSTS,APPORTIONMENT OF INPATIENT/OUTPATIENT ANCILLARY SERVICE OTHER PASS THROUGH COSTS,APPORTIONMENT OF INPATIENT/OUTPATIENT ANCILLARY SERVICE OTHER PASS THROUGH COSTS,TRIAL BALANCE OF EXPENSE ACCOUNTS,APPORTIONMENT OF INPATIENT/OUTPATIENT ANCILLARY SERVICE OTHER PASS THROUGH COSTS,TRIAL BALANCE OF EXPENSE ACCOUNTS,APPORTIONMENT OF INPATIENT/OUTPATIENT ANCILLARY SERVICE OTHER PASS THROUGH COSTS,APPORTIONMENT OF INPATIENT/OUTPATIENT ANCILLARY SERVICE OTHER PASS THROUGH COSTS,ADJUSTMENTS,ADJUSTMENTS,COMPUTATION OF RATIO OF COST TO CHARGES,ALLOCATION OF NEW CAPITAL COSTS,HOSPITAL WAGE INDEX DATA,S-10 DATA,TRIAL BALANCE OF EXPENSE ACCOUNTS,TRIAL BALANCE OF EXPENSE ACCOUNTS,APPORTIONMENT OF MEDICAL AND OTHER HEALTH SERVICES,APPORTIONMENT OF INPATIENT/OUTPATIENT ANCILLARY SERVICE OTHER PASS THROUGH COSTS,COST ALLOCATION,,APPORTIONMENT OF INPATIENT/OUTPATIENT ANCILLARY SERVICE OTHER PASS THROUGH COSTS,Medicaid Inpatient Days/Outpatient Visits,APPORTIONMENT OF INPATIENT/OUTPATIENT ANCILLARY SERVICE OTHER PASS THROUGH COSTS,COST ALLOCATION,COST ALLOCATION,APPORTIONMENT OF INPATIENT/OUTPATIENT ANCILLARY SERVICE OTHER PASS THROUGH COSTS,INPATIENT ANCILLARY SERVICE COST APPORTIONMENT,,APPORTIONMENT OF INPATIENT/OUTPATIENT ANCILLARY SERVICE OTHER PASS THROUGH COSTS,ALLOCATION OF NEW CAPITAL COSTS,COST ALLOCATION,APPORTIONMENT OF INPATIENT/OUTPATIENT ANCILLARY SERVICE OTHER PASS THROUGH COSTS,TRIAL BALANCE OF EXPENSE ACCOUNTS,TRIAL BALANCE OF EXPENSE ACCOUNTS,COST ALLOCATION,HHA STATISTICAL DATA,COST ALLOCATION,APPORTIONMENT OF INPATIENT/OUTPATIENT ANCILLARY SERVICE OTHER PASS THROUGH COSTS,INPATIENT ANCILLARY SERVICE COST APPORTIONMENT,COST ALLOCATION,INPATIENT ANCILLARY SERVICE COST APPORTIONMENT,TRIAL BALANCE OF EXPENSE ACCOUNTS,TRIAL BALANCE OF EXPENSE ACCOUNTS,HHA STATISTICAL DATA,HHA STATISTICAL DATA,COST ALLOCATION,COMPUTATION OF RATIO OF COST TO CHARGES,ALLOCATION OF NEW CAPITAL COSTS,TRIAL BALANCE OF EXPENSE ACCOUNTS,COMPUTATION OF RATIO OF COST TO CHARGES,TRIAL BALANCE OF EXPENSE ACCOUNTS,BALANCE SHEET,ANALYSIS OF CHANGES IN NEW CAPITAL BALANCES,INPATIENT ANCILLARY SERVICE COST APPORTIONMENT,ALLOCATION OF NEW CAPITAL COSTS,RENAL STATISTICAL DATA,HOSPITAL WAGE INDEX DATA,APPORTIONMENT OF MEDICAL AND OTHER HEALTH SERVICES,APPORTIONMENT OF INPATIENT/OUTPATIENT ANCILLARY SERVICE OTHER PASS THROUGH COSTS,Medicaid Inpatient Days/Outpatient Visits,HOSPITAL WAGE INDEX DATA,,INPATIENT ANCILLARY SERVICE COST APPORTIONMENT,COST ALLOCATION,TRIAL BALANCE OF EXPENSE ACCOUNTS,HHA STATISTICAL DATA,INPATIENT ANCILLARY SERVICE COST APPORTIONMENT,INPATIENT ANCILLARY SERVICE COST APPORTIONMENT,Total Inpatient Days/Outpatient Visits,TRIAL BALANCE OF EXPENSE ACCOUNTS,APPORTIONMENT OF INPATIENT/OUTPATIENT ANCILLARY SERVICE OTHER PASS THROUGH COSTS,APPORTIONMENT OF INPATIENT/OUTPATIENT ANCILLARY SERVICE OTHER PASS THROUGH COSTS,COST ALLOCATION,COST ALLOCATION,TRIAL BALANCE OF EXPENSE ACCOUNTS,APPORTIONMENT OF INPATIENT/OUTPATIENT ANCILLARY SERVICE OTHER PASS THROUGH COSTS,HOSPITAL WAGE INDEX DATA,APPORTIONMENT OF INPATIENT/OUTPATIENT ANCILLARY SERVICE OTHER PASS THROUGH COSTS,RENAL STATISTICAL DATA,COMPUTATION OF RATIO OF COST TO CHARGES,INPATIENT ANCILLARY SERVICE COST APPORTIONMENT,Medicare Inpatient Days/Outpatient Visits,Medicaid Inpatient Days/Outpatient Visits,APPORTIONMENT OF INPATIENT/OUTPATIENT ANCILLARY SERVICE OTHER PASS THROUGH COSTS,COMPUTATION OF RATIO OF COST TO CHARGES,CALCULATION OF REIMBURSEMENT SETTLEMENT,COST ALLOCATION,INPATIENT ANCILLARY SERVICE COST APPORTIONMENT,APPORTIONMENT OF INPATIENT/OUTPATIENT ANCILLARY SERVICE OTHER PASS THROUGH COSTS,APPORTIONMENT OF MEDICAL AND OTHER HEALTH SERVICES,APPORTIONMENT OF INPATIENT/OUTPATIENT ANCILLARY SERVICE OTHER PASS THROUGH COSTS,HOSPITAL WAGE INDEX DATA,COST ALLOCATION,COMPUTATION OF RATIO OF COST TO CHARGES,TRIAL BALANCE OF EXPENSE ACCOUNTS,Medicare Inpatient Days/Outpatient Visits,Total Inpatient Days/Outpatient Visits,ANALYSIS OF CHANGES IN NEW CAPITAL BALANCES,COST ALLOCATION,COST ALLOCATION,INPATIENT ANCILLARY SERVICE COST APPORTIONMENT,APPORTIONMENT OF INPATIENT/OUTPATIENT ANCILLARY SERVICE OTHER PASS THROUGH COSTS,CALCULATION OF REIMBURSEMENT SETTLEMENT,,INPATIENT ANCILLARY SERVICE COST APPORTIONMENT,ALLOCATION OF NEW CAPITAL COSTS,Medicaid Inpatient Days/Outpatient Visits,TRIAL BALANCE OF EXPENSE ACCOUNTS,ANALYSIS OF CHANGES IN NEW CAPITAL BALANCES,COMPUTATION OF RATIO OF COST TO CHARGES,TRIAL BALANCE OF EXPENSE ACCOUNTS,COMPUTATION OF INPATIENT OPERATING COSTS,HOSPITAL WAGE INDEX DATA,INPATIENT ANCILLARY SERVICE COST APPORTIONMENT,COST ALLOCATION,COMPUTATION OF RATIO OF COST TO CHARGES,COMPUTATION OF RATIO OF COST TO CHARGES,APPORTIONMENT OF INPATIENT/OUTPATIENT ANCILLARY SERVICE OTHER PASS THROUGH COSTS,APPORTIONMENT OF MEDICAL AND OTHER HEALTH SERVICES,HOSPITAL WAGE INDEX DATA,COST ALLOCATION,TRIAL BALANCE OF EXPENSE ACCOUNTS,,APPORTIONMENT OF INPATIENT/OUTPATIENT ANCILLARY SERVICE OTHER PASS THROUGH COSTS,APPORTIONMENT OF INPATIENT/OUTPATIENT ANCILLARY SERVICE OTHER PASS THROUGH COSTS,,RECONCILIATION OF CAPITAL COST CENTERS,COMPUTATION OF RATIO OF COST TO CHARGES,APPORTIONMENT OF INPATIENT ROUTINE SERVICE CAPITAL COSTS,TRIAL BALANCE OF EXPENSE ACCOUNTS,COST ALLOCATION,APPORTIONMENT OF MEDICAL AND OTHER HEALTH SERVICES,INPATIENT ANCILLARY SERVICE COST APPORTIONMENT,APPORTIONMENT OF INPATIENT/OUTPATIENT ANCILLARY SERVICE OTHER PASS THROUGH COSTS,S-10 DATA,ALLOCATION OF NEW CAPITAL COSTS,,COST ALLOCATION,COMPUTATION OF RATIO OF COST TO CHARGES,Total Inpatient Days/Outpatient Visits,Total Inpatient Days/Outpatient Visits,HOSPITAL WAGE INDEX DATA,S-10 DATA,ANALYSIS OF CHANGES IN NEW CAPITAL BALANCES,COST ALLOCATION,TRIAL BALANCE OF EXPENSE ACCOUNTS,ALLOCATION OF NEW CAPITAL COSTS,HOSPITAL WAGE INDEX DATA,INPATIENT ANCILLARY SERVICE COST APPORTIONMENT,TRIAL BALANCE OF EXPENSE ACCOUNTS,COST ALLOCATION,TRIAL BALANCE OF EXPENSE ACCOUNTS,TRIAL BALANCE OF EXPENSE ACCOUNTS,TRIAL BALANCE OF EXPENSE ACCOUNTS,COMPUTATION OF RATIO OF COST TO CHARGES,APPORTIONMENT OF INPATIENT/OUTPATIENT ANCILLARY SERVICE OTHER PASS THROUGH COSTS,TRIAL BALANCE OF EXPENSE ACCOUNTS,,COST ALLOCATION,APPORTIONMENT OF MEDICAL AND OTHER HEALTH SERVICES,APPORTIONMENT OF MEDICAL AND OTHER HEALTH SERVICES,APPORTIONMENT OF INPATIENT/OUTPATIENT ANCILLARY SERVICE OTHER PASS THROUGH COSTS,Medicaid Inpatient Days/Outpatient Visits,HOSPITAL WAGE INDEX DATA,TRIAL BALANCE OF EXPENSE ACCOUNTS,,ALLOCATION OF NEW CAPITAL COSTS,INPATIENT ANCILLARY SERVICE COST APPORTIONMENT,HOSPITAL WAGE INDEX DATA,COMPUTATION OF INPATIENT OPERATING COSTS,COST ALLOCATION,Total Inpatient Days/Outpatient Visits,INPATIENT ANCILLARY SERVICE COST APPORTIONMENT,Medicare Inpatient Days/Outpatient Visits,TRIAL BALANCE OF EXPENSE ACCOUNTS,TRIAL BALANCE OF EXPENSE ACCOUNTS,APPORTIONMENT OF INPATIENT/OUTPATIENT ANCILLARY SERVICE OTHER PASS THROUGH COSTS,COMPUTATION OF RATIO OF COST TO CHARGES,Total Inpatient Days/Outpatient Visits,APPORTIONMENT OF INPATIENT/OUTPATIENT ANCILLARY SERVICE OTHER PASS THROUGH COSTS,COMPUTATION OF RATIO OF COST TO CHARGES,ANALYSIS OF CHANGES IN NEW CAPITAL BALANCES,COST ALLOCATION,APPORTIONMENT OF MEDICAL AND OTHER HEALTH SERVICES,ADJUSTMENTS,INPATIENT ANCILLARY SERVICE COST APPORTIONMENT,INPATIENT ANCILLARY SERVICE COST APPORTIONMENT,HHA STATISTICAL DATA,HOSPITAL WAGE INDEX DATA,RENAL STATISTICAL DATA,COST ALLOCATION,APPORTIONMENT OF MEDICAL AND OTHER HEALTH SERVICES,TRIAL BALANCE OF EXPENSE ACCOUNTS,STATEMENT OF PATIENT REVENUES AND OPERATING EXPENSES,COST ALLOCATION,INPATIENT ANCILLARY SERVICE COST APPORTIONMENT,COST ALLOCATION,Total Inpatient Days/Outpatient Visits,INPATIENT ANCILLARY SERVICE COST APPORTIONMENT,APPORTIONMENT OF INPATIENT/OUTPATIENT ANCILLARY SERVICE OTHER PASS THROUGH COSTS,COMPUTATION OF RATIO OF COST TO CHARGES,Total Inpatient Days/Outpatient Visits,INPATIENT ANCILLARY SERVICE COST APPORTIONMENT,TRIAL BALANCE OF EXPENSE ACCOUNTS,APPORTIONMENT OF INPATIENT/OUTPATIENT ANCILLARY SERVICE OTHER PASS THROUGH COSTS,APPORTIONMENT OF INPATIENT/OUTPATIENT ANCILLARY SERVICE OTHER PASS THROUGH COSTS,INPATIENT ANCILLARY SERVICE COST APPORTIONMENT,APPORTIONMENT OF INPATIENT/OUTPATIENT ANCILLARY SERVICE OTHER PASS THROUGH COSTS,COST ALLOCATION,APPORTIONMENT OF INPATIENT/OUTPATIENT ANCILLARY SERVICE OTHER PASS THROUGH COSTS,RECONCILIATION OF CAPITAL COST CENTERS,COMPUTATION OF RATIO OF COST TO CHARGES,TRIAL BALANCE OF EXPENSE ACCOUNTS,STATEMENT OF REVENUES AND EXPENSES,Medicaid Inpatient Days/Outpatient Visits,HOSPITAL WAGE INDEX DATA,APPORTIONMENT OF INPATIENT ROUTINE SERVICE CAPITAL COSTS,Total Inpatient Days/Outpatient Visits,INPATIENT ANCILLARY SERVICE COST APPORTIONMENT,INPATIENT ANCILLARY SERVICE COST APPORTIONMENT,,APPORTIONMENT OF INPATIENT/OUTPATIENT ANCILLARY SERVICE OTHER PASS THROUGH COSTS,INPATIENT ANCILLARY SERVICE COST APPORTIONMENT,TRIAL BALANCE OF EXPENSE ACCOUNTS,HOSPITAL WAGE INDEX DATA,COMPUTATION OF RATIO OF COST TO CHARGES,ANALYSIS OF CHANGES IN NEW CAPITAL BALANCES,COST ALLOCATION,ALLOCATION OF NEW CAPITAL COSTS,APPORTIONMENT OF MEDICAL AND OTHER HEALTH SERVICES,HOSPITAL WAGE INDEX DATA,APPORTIONMENT OF INPATIENT/OUTPATIENT ANCILLARY SERVICE OTHER PASS THROUGH COSTS,APPORTIONMENT OF INPATIENT/OUTPATIENT ANCILLARY SERVICE OTHER PASS THROUGH COSTS,APPORTIONMENT OF INPATIENT/OUTPATIENT ANCILLARY SERVICE OTHER PASS THROUGH COSTS,,TRIAL BALANCE OF EXPENSE ACCOUNTS,TRIAL BALANCE OF EXPENSE ACCOUNTS,COST ALLOCATION,COMPUTATION OF RATIO OF COST TO CHARGES,,HOSPITAL WAGE INDEX DATA,APPORTIONMENT OF INPATIENT/OUTPATIENT ANCILLARY SERVICE OTHER PASS THROUGH COSTS,COMPUTATION OF RATIO OF COST TO CHARGES,,APPORTIONMENT OF MEDICAL AND OTHER HEALTH SERVICES,Total Inpatient Days/Outpatient Visits,INPATIENT ANCILLARY SERVICE COST APPORTIONMENT,INPATIENT ANCILLARY SERVICE COST APPORTIONMENT,INPATIENT ANCILLARY SERVICE COST APPORTIONMENT,BALANCE SHEET,TRIAL BALANCE OF EXPENSE ACCOUNTS,COMPUTATION OF RATIO OF COST TO CHARGES,TRIAL BALANCE OF EXPENSE ACCOUNTS,APPORTIONMENT OF INPATIENT/OUTPATIENT ANCILLARY SERVICE OTHER PASS THROUGH COSTS,COST ALLOCATION,INPATIENT ANCILLARY SERVICE COST APPORTIONMENT,BED DAYS AVAILABLE,ANALYSIS OF CHANGES IN NEW CAPITAL BALANCES,APPORTIONMENT OF INPATIENT/OUTPATIENT ANCILLARY SERVICE OTHER PASS THROUGH COSTS,APPORTIONMENT OF INPATIENT/OUTPATIENT ANCILLARY SERVICE OTHER PASS THROUGH COSTS,Total Inpatient Days/Outpatient Visits,RECONCILIATION OF CAPITAL COST CENTERS,COMPUTATION OF RATIO OF COST TO CHARGES,RENAL STATISTICAL DATA,ADJUSTMENTS,COMPUTATION OF RATIO OF COST TO CHARGES,COMPUTATION OF RATIO OF COST TO CHARGES,COST ALLOCATION,TRIAL BALANCE OF EXPENSE ACCOUNTS,S-10 DATA,INPATIENT ANCILLARY SERVICE COST APPORTIONMENT,ALLOCATION OF NEW CAPITAL COSTS,APPORTIONMENT OF INPATIENT/OUTPATIENT ANCILLARY SERVICE OTHER PASS THROUGH COSTS,APPORTIONMENT OF MEDICAL AND OTHER HEALTH SERVICES,INPATIENT ANCILLARY SERVICE COST APPORTIONMENT,HOSPITAL WAGE INDEX DATA,ANALYSIS OF CHANGES IN NEW CAPITAL BALANCES,COST ALLOCATION,INPATIENT ANCILLARY SERVICE COST APPORTIONMENT,COST ALLOCATION,NUMBER OF BEDS,TRIAL BALANCE OF EXPENSE ACCOUNTS,TRIAL BALANCE OF EXPENSE ACCOUNTS,COST ALLOCATION,APPORTIONMENT OF MEDICAL AND OTHER HEALTH SERVICES,HHA STATISTICAL DATA,APPORTIONMENT OF INPATIENT/OUTPATIENT ANCILLARY SERVICE OTHER PASS THROUGH COSTS,TRIAL BALANCE OF EXPENSE ACCOUNTS,CALCULATION OF REIMBURSEMENT SETTLEMENT,TRIAL BALANCE OF EXPENSE ACCOUNTS,TRIAL BALANCE OF EXPENSE ACCOUNTS,,COMPUTATION OF RATIO OF COST TO CHARGES,APPORTIONMENT OF MEDICAL AND OTHER HEALTH SERVICES,INPATIENT ANCILLARY SERVICE COST APPORTIONMENT,CALCULATION OF REIMBURSEMENT SETTLEMENT,CALCULATION OF REIMBURSEMENT SETTLEMENT,INPATIENT ANCILLARY SERVICE COST APPORTIONMENT,COMPUTATION OF RATIO OF COST TO CHARGES,APPORTIONMENT OF INPATIENT/OUTPATIENT ANCILLARY SERVICE OTHER PASS THROUGH COSTS,APPORTIONMENT OF INPATIENT/OUTPATIENT ANCILLARY SERVICE OTHER PASS THROUGH COSTS,INPATIENT ANCILLARY SERVICE COST APPORTIONMENT,HOSPITAL WAGE INDEX DATA,ALLOCATION OF NEW CAPITAL COSTS,ANALYSIS OF CHANGES IN NEW CAPITAL BALANCES,Total Inpatient Days/Outpatient Visits,COST ALLOCATION,COMPUTATION OF RATIO OF COST TO CHARGES,S-10 DATA,APPORTIONMENT OF MEDICAL AND OTHER HEALTH SERVICES,COMPUTATION OF RATIO OF COST TO CHARGES,CALCULATION OF REIMBURSEMENT SETTLEMENT,APPORTIONMENT OF MEDICAL AND OTHER HEALTH SERVICES,INPATIENT ANCILLARY SERVICE COST APPORTIONMENT,COMPUTATION OF RATIO OF COST TO CHARGES,INPATIENT ANCILLARY SERVICE COST APPORTIONMENT,APPORTIONMENT OF INPATIENT ROUTINE SERVICE CAPITAL COSTS,APPORTIONMENT OF MEDICAL AND OTHER HEALTH SERVICES,TRIAL BALANCE OF EXPENSE ACCOUNTS,APPORTIONMENT OF INPATIENT/OUTPATIENT ANCILLARY SERVICE OTHER PASS THROUGH COSTS,Medicare Inpatient Days/Outpatient Visits,TRIAL BALANCE OF EXPENSE ACCOUNTS,INPATIENT ANCILLARY SERVICE COST APPORTIONMENT,COST ALLOCATION,APPORTIONMENT OF INPATIENT/OUTPATIENT ANCILLARY SERVICE OTHER PASS THROUGH COSTS,COMPUTATION OF RATIO OF COST TO CHARGES,HOSPITAL WAGE INDEX DATA,APPORTIONMENT OF INPATIENT/OUTPATIENT ANCILLARY SERVICE OTHER PASS THROUGH COSTS,INPATIENT ANCILLARY SERVICE COST APPORTIONMENT,COMPUTATION OF RATIO OF COST TO CHARGES,RENAL STATISTICAL DATA,APPORTIONMENT OF INPATIENT/OUTPATIENT ANCILLARY SERVICE OTHER PASS THROUGH COSTS,COMPUTATION OF INPATIENT OPERATING COSTS,COST ALLOCATION,Total Inpatient Days/Outpatient Visits,APPORTIONMENT OF MEDICAL AND OTHER HEALTH SERVICES,APPORTIONMENT OF INPATIENT/OUTPATIENT ANCILLARY SERVICE OTHER PASS THROUGH COSTS,APPORTIONMENT OF INPATIENT/OUTPATIENT ANCILLARY SERVICE OTHER PASS THROUGH COSTS,INPATIENT ANCILLARY SERVICE COST APPORTIONMENT,APPORTIONMENT OF MEDICAL AND OTHER HEALTH SERVICES,COMPUTATION OF RATIO OF COST TO CHARGES,CALCULATION OF REIMBURSEMENT SETTLEMENT,Medicaid Inpatient Days/Outpatient Visits,APPORTIONMENT OF MEDICAL AND OTHER HEALTH SERVICES,,HOSPITAL WAGE INDEX DATA,TRIAL BALANCE OF EXPENSE ACCOUNTS,ADJUSTMENTS,BALANCE SHEET,CALCULATION OF REIMBURSEMENT SETTLEMENT,BALANCE SHEET,INPATIENT ANCILLARY SERVICE COST APPORTIONMENT,BALANCE SHEET,COST ALLOCATION,,S-10 DATA,TRIAL BALANCE OF EXPENSE ACCOUNTS,TRIAL BALANCE OF EXPENSE ACCOUNTS,COST ALLOCATION,APPORTIONMENT OF INPATIENT/OUTPATIENT ANCILLARY SERVICE OTHER PASS THROUGH COSTS,HHA STATISTICAL DATA,COST ALLOCATION,APPORTIONMENT OF INPATIENT/OUTPATIENT ANCILLARY SERVICE OTHER PASS THROUGH COSTS,,TRIAL BALANCE OF EXPENSE ACCOUNTS,APPORTIONMENT OF MEDICAL AND OTHER HEALTH SERVICES,INPATIENT ANCILLARY SERVICE COST APPORTIONMENT,TRIAL BALANCE OF EXPENSE ACCOUNTS,BED DAYS AVAILABLE,,HOSPITAL WAGE INDEX DATA,APPORTIONMENT OF INPATIENT/OUTPATIENT ANCILLARY SERVICE OTHER PASS THROUGH COSTS,APPORTIONMENT OF INPATIENT/OUTPATIENT ANCILLARY SERVICE OTHER PASS THROUGH COSTS,INPATIENT ANCILLARY SERVICE COST APPORTIONMENT,,APPORTIONMENT OF INPATIENT/OUTPATIENT ANCILLARY SERVICE OTHER PASS THROUGH COSTS,BED DAYS AVAILABLE,HOSPITAL WAGE INDEX DATA,INPATIENT ANCILLARY SERVICE COST APPORTIONMENT,HHA STATISTICAL DATA,TRIAL BALANCE OF EXPENSE ACCOUNTS,APPORTIONMENT OF MEDICAL AND OTHER HEALTH SERVICES,COST ALLOCATION,CALCULATION OF REIMBURSEMENT SETTLEMENT,,Total Inpatient Days/Outpatient Visits,HOSPITAL WAGE INDEX DATA,BED DAYS AVAILABLE,HOSPITAL WAGE INDEX DATA,APPORTIONMENT OF INPATIENT/OUTPATIENT ANCILLARY SERVICE OTHER PASS THROUGH COSTS,NUMBER OF BEDS,RENAL STATISTICAL DATA,APPORTIONMENT OF MEDICAL AND OTHER HEALTH SERVICES,TRIAL BALANCE OF EXPENSE ACCOUNTS,COST ALLOCATION,INPATIENT ANCILLARY SERVICE COST APPORTIONMENT,APPORTIONMENT OF INPATIENT/OUTPATIENT ANCILLARY SERVICE OTHER PASS THROUGH COSTS,TRIAL BALANCE OF EXPENSE ACCOUNTS,COST ALLOCATION,ALLOCATION OF NEW CAPITAL COSTS,COMPUTATION OF RATIO OF COST TO CHARGES,S-10 DATA,APPORTIONMENT OF MEDICAL AND OTHER HEALTH SERVICES,ANALYSIS OF CHANGES IN NEW CAPITAL BALANCES,INPATIENT ANCILLARY SERVICE COST APPORTIONMENT,TRIAL BALANCE OF EXPENSE ACCOUNTS,TRIAL BALANCE OF EXPENSE ACCOUNTS,APPORTIONMENT OF INPATIENT/OUTPATIENT ANCILLARY SERVICE OTHER PASS THROUGH COSTS,TRIAL BALANCE OF EXPENSE ACCOUNTS,APPORTIONMENT OF INPATIENT/OUTPATIENT ANCILLARY SERVICE OTHER PASS THROUGH COSTS,ALLOCATION OF NEW CAPITAL COSTS,COMPUTATION OF RATIO OF COST TO CHARGES,COMPUTATION OF RATIO OF COST TO CHARGES,COMPUTATION OF RATIO OF COST TO CHARGES,Total Inpatient Days/Outpatient Visits,INPATIENT ANCILLARY SERVICE COST APPORTIONMENT,ANALYSIS OF CHANGES IN NEW CAPITAL BALANCES,,,TRIAL BALANCE OF EXPENSE ACCOUNTS,HHA STATISTICAL DATA,TRIAL BALANCE OF EXPENSE ACCOUNTS,ADJUSTMENTS,,APPORTIONMENT OF INPATIENT/OUTPATIENT ANCILLARY SERVICE OTHER PASS THROUGH COSTS,APPORTIONMENT OF INPATIENT/OUTPATIENT ANCILLARY SERVICE OTHER PASS THROUGH COSTS,ALLOCATION OF NEW CAPITAL COSTS,COST ALLOCATION,APPORTIONMENT OF MEDICAL AND OTHER HEALTH SERVICES,COST ALLOCATION,INPATIENT ANCILLARY SERVICE COST APPORTIONMENT,APPORTIONMENT OF MEDICAL AND OTHER HEALTH SERVICES,INPATIENT ANCILLARY SERVICE COST APPORTIONMENT,COMPUTATION OF RATIO OF COST TO CHARGES,COST ALLOCATION,COST ALLOCATION,APPORTIONMENT OF MEDICAL AND OTHER HEALTH SERVICES,TRIAL BALANCE OF EXPENSE ACCOUNTS,APPORTIONMENT OF MEDICAL AND OTHER HEALTH SERVICES,APPORTIONMENT OF MEDICAL AND OTHER HEALTH SERVICES,BALANCE SHEET,APPORTIONMENT OF INPATIENT/OUTPATIENT ANCILLARY SERVICE OTHER PASS THROUGH COSTS,APPORTIONMENT OF MEDICAL AND OTHER HEALTH SERVICES,APPORTIONMENT OF MEDICAL AND OTHER HEALTH SERVICES,Total Inpatient Days/Outpatient Visits,HOSPITAL WAGE INDEX DATA,APPORTIONMENT OF INPATIENT/OUTPATIENT ANCILLARY SERVICE OTHER PASS THROUGH COSTS,HOSPITAL WAGE INDEX DATA,APPORTIONMENT OF INPATIENT/OUTPATIENT ANCILLARY SERVICE OTHER PASS THROUGH COSTS,COST ALLOCATION,,Medicare Inpatient Days/Outpatient Visits,INPATIENT ANCILLARY SERVICE COST APPORTIONMENT,COMPUTATION OF INPATIENT OPERATING COSTS,APPORTIONMENT OF MEDICAL AND OTHER HEALTH SERVICES,INPATIENT ANCILLARY SERVICE COST APPORTIONMENT,COST ALLOCATION,APPORTIONMENT OF INPATIENT/OUTPATIENT ANCILLARY SERVICE OTHER PASS THROUGH COSTS,APPORTIONMENT OF INPATIENT/OUTPATIENT ANCILLARY SERVICE OTHER PASS THROUGH COSTS,,APPORTIONMENT OF INPATIENT/OUTPATIENT ANCILLARY SERVICE OTHER PASS THROUGH COSTS,APPORTIONMENT OF INPATIENT ROUTINE SERVICE CAPITAL COSTS,COST ALLOCATION,TRIAL BALANCE OF EXPENSE ACCOUNTS,COST ALLOCATION,COMPUTATION OF RATIO OF COST TO CHARGES,ANALYSIS OF CHANGES IN NEW CAPITAL BALANCES,TRIAL BALANCE OF EXPENSE ACCOUNTS,INPATIENT ANCILLARY SERVICE COST APPORTIONMENT,COST ALLOCATION,APPORTIONMENT OF MEDICAL AND OTHER HEALTH SERVICES,APPORTIONMENT OF INPATIENT ROUTINE SERVICE CAPITAL COSTS,COST ALLOCATION,TRIAL BALANCE OF EXPENSE ACCOUNTS,APPORTIONMENT OF MEDICAL AND OTHER HEALTH SERVICES,APPORTIONMENT OF MEDICAL AND OTHER HEALTH SERVICES,ADJUSTMENTS,TRIAL BALANCE OF EXPENSE ACCOUNTS,ANALYSIS OF CHANGES IN NEW CAPITAL BALANCES,Medicare Inpatient Days/Outpatient Visits,APPORTIONMENT OF INPATIENT/OUTPATIENT ANCILLARY SERVICE OTHER PASS THROUGH COSTS,BED DAYS AVAILABLE,HOSPITAL WAGE INDEX DATA,HOSPITAL WAGE INDEX DATA,Total Inpatient Days/Outpatient Visits,HOSPITAL WAGE INDEX DATA,TRIAL BALANCE OF EXPENSE ACCOUNTS,COMPUTATION OF RATIO OF COST TO CHARGES,APPORTIONMENT OF INPATIENT/OUTPATIENT ANCILLARY SERVICE OTHER PASS THROUGH COSTS,APPORTIONMENT OF MEDICAL AND OTHER HEALTH SERVICES,APPORTIONMENT OF INPATIENT/OUTPATIENT ANCILLARY SERVICE OTHER PASS THROUGH COSTS,COMPUTATION OF RATIO OF COST TO CHARGES,INPATIENT ANCILLARY SERVICE COST APPORTIONMENT,APPORTIONMENT OF INPATIENT/OUTPATIENT ANCILLARY SERVICE OTHER PASS THROUGH COSTS,TRIAL BALANCE OF EXPENSE ACCOUNTS,HOSPITAL WAGE INDEX DATA,APPORTIONMENT OF INPATIENT/OUTPATIENT ANCILLARY SERVICE OTHER PASS THROUGH COSTS,COMPUTATION OF RATIO OF COST TO CHARGES,APPORTIONMENT OF INPATIENT/OUTPATIENT ANCILLARY SERVICE OTHER PASS THROUGH COSTS,BED DAYS AVAILABLE,HHA STATISTICAL DATA,ANALYSIS OF CHANGES IN NEW CAPITAL BALANCES,INPATIENT ANCILLARY SERVICE COST APPORTIONMENT,HHA STATISTICAL DATA,ANALYSIS OF CHANGES IN NEW CAPITAL BALANCES,COMPUTATION OF RATIO OF COST TO CHARGES,BED DAYS AVAILABLE,COST ALLOCATION,ALLOCATION OF NEW CAPITAL COSTS,COMPUTATION OF RATIO OF COST TO CHARGES,TRIAL BALANCE OF EXPENSE ACCOUNTS,ALLOCATION OF NEW CAPITAL COSTS,COST ALLOCATION,Medicare Inpatient Days/Outpatient Visits,STATEMENT OF REVENUES AND EXPENSES,COMPUTATION OF RATIO OF COST TO CHARGES,BALANCE SHEET,,TRIAL BALANCE OF EXPENSE ACCOUNTS,APPORTIONMENT OF INPATIENT/OUTPATIENT ANCILLARY SERVICE OTHER PASS THROUGH COSTS,Total Inpatient Days/Outpatient Visits,COMPUTATION OF RATIO OF COST TO CHARGES,COST ALLOCATION,COST ALLOCATION,,INPATIENT ANCILLARY SERVICE COST APPORTIONMENT,INPATIENT ANCILLARY SERVICE COST APPORTIONMENT,CALCULATION OF REIMBURSEMENT SETTLEMENT,COST ALLOCATION,ALLOCATION OF NEW CAPITAL COSTS,BALANCE SHEET,TRIAL BALANCE OF EXPENSE ACCOUNTS,COMPUTATION OF RATIO OF COST TO CHARGES,APPORTIONMENT OF MEDICAL AND OTHER HEALTH SERVICES,,Total Inpatient Days/Outpatient Visits,COMPUTATION OF RATIO OF COST TO CHARGES,APPORTIONMENT OF INPATIENT/OUTPATIENT ANCILLARY SERVICE OTHER PASS THROUGH COSTS,APPORTIONMENT OF INPATIENT/OUTPATIENT ANCILLARY SERVICE OTHER PASS THROUGH COSTS,BALANCE SHEET,COMPUTATION OF RATIO OF COST TO CHARGES,INPATIENT ANCILLARY SERVICE COST APPORTIONMENT,TRIAL BALANCE OF EXPENSE ACCOUNTS,HOSPITAL WAGE INDEX DATA,HOSPITAL WAGE INDEX DATA,INPATIENT ANCILLARY SERVICE COST APPORTIONMENT,HOSPITAL WAGE INDEX DATA,COST ALLOCATION,APPORTIONMENT OF MEDICAL AND OTHER HEALTH SERVICES,APPORTIONMENT OF INPATIENT/OUTPATIENT ANCILLARY SERVICE OTHER PASS THROUGH COSTS,CALCULATION OF REIMBURSEMENT SETTLEMENT,ALLOCATION OF NEW CAPITAL COSTS,APPORTIONMENT OF INPATIENT ROUTINE SERVICE CAPITAL COSTS,INPATIENT ANCILLARY SERVICE COST APPORTIONMENT,HHA STATISTICAL DATA,COST ALLOCATION,INPATIENT ANCILLARY SERVICE COST APPORTIONMENT,COST ALLOCATION,COST ALLOCATION,APPORTIONMENT OF MEDICAL AND OTHER HEALTH SERVICES,HOSPITAL WAGE INDEX DATA,NUMBER OF BEDS,APPORTIONMENT OF MEDICAL AND OTHER HEALTH SERVICES,HOSPITAL WAGE INDEX DATA,APPORTIONMENT OF INPATIENT/OUTPATIENT ANCILLARY SERVICE OTHER PASS THROUGH COSTS,TRIAL BALANCE OF EXPENSE ACCOUNTS,COMPUTATION OF INPATIENT OPERATING COSTS,Medicaid Inpatient Days/Outpatient Visits,APPORTIONMENT OF MEDICAL AND OTHER HEALTH SERVICES,BED DAYS AVAILABLE,Medicare Inpatient Days/Outpatient Visits,APPORTIONMENT OF MEDICAL AND OTHER HEALTH SERVICES,APPORTIONMENT OF INPATIENT/OUTPATIENT ANCILLARY SERVICE OTHER PASS THROUGH COSTS,NUMBER OF BEDS,HOSPITAL WAGE INDEX DATA,INPATIENT ANCILLARY SERVICE COST APPORTIONMENT,CALCULATION OF REIMBURSEMENT SETTLEMENT,INPATIENT ANCILLARY SERVICE COST APPORTIONMENT,S-10 DATA,COMPUTATION OF RATIO OF COST TO CHARGES,COST ALLOCATION,COST ALLOCATION,COMPUTATION OF RATIO OF COST TO CHARGES,HHA STATISTICAL DATA,COST ALLOCATION,COST ALLOCATION,TRIAL BALANCE OF EXPENSE ACCOUNTS,COMPUTATION OF INPATIENT OPERATING COSTS,,COST ALLOCATION,COMPUTATION OF RATIO OF COST TO CHARGES,INPATIENT ANCILLARY SERVICE COST APPORTIONMENT,Total Inpatient Days/Outpatient Visits,S-10 DATA,APPORTIONMENT OF MEDICAL AND OTHER HEALTH SERVICES,TRIAL BALANCE OF EXPENSE ACCOUNTS,HHA STATISTICAL DATA,INPATIENT ANCILLARY SERVICE COST APPORTIONMENT,INPATIENT ANCILLARY SERVICE COST APPORTIONMENT,COMPUTATION OF RATIO OF COST TO CHARGES,APPORTIONMENT OF INPATIENT/OUTPATIENT ANCILLARY SERVICE OTHER PASS THROUGH COSTS,ALLOCATION OF NEW CAPITAL COSTS,APPORTIONMENT OF INPATIENT/OUTPATIENT ANCILLARY SERVICE OTHER PASS THROUGH COSTS,COST ALLOCATION,APPORTIONMENT OF INPATIENT/OUTPATIENT ANCILLARY SERVICE OTHER PASS THROUGH COSTS,INPATIENT ANCILLARY SERVICE COST APPORTIONMENT,,COMPUTATION OF RATIO OF COST TO CHARGES,,COST ALLOCATION,COST ALLOCATION,COMPUTATION OF RATIO OF COST TO CHARGES,ANALYSIS OF CHANGES IN NEW CAPITAL BALANCES,HOSPITAL WAGE INDEX DATA,Total Inpatient Days/Outpatient Visits,APPORTIONMENT OF INPATIENT/OUTPATIENT ANCILLARY SERVICE OTHER PASS THROUGH COSTS,APPORTIONMENT OF INPATIENT/OUTPATIENT ANCILLARY SERVICE OTHER PASS THROUGH COSTS,APPORTIONMENT OF INPATIENT/OUTPATIENT ANCILLARY SERVICE OTHER PASS THROUGH COSTS,HHA STATISTICAL DATA,INPATIENT ANCILLARY SERVICE COST APPORTIONMENT,TRIAL BALANCE OF EXPENSE ACCOUNTS,INPATIENT ANCILLARY SERVICE COST APPORTIONMENT,,APPORTIONMENT OF INPATIENT/OUTPATIENT ANCILLARY SERVICE OTHER PASS THROUGH COSTS,APPORTIONMENT OF MEDICAL AND OTHER HEALTH SERVICES,Total Inpatient Days/Outpatient Visits,COST ALLOCATION,,APPORTIONMENT OF MEDICAL AND OTHER HEALTH SERVICES,COST ALLOCATION,,HHA STATISTICAL DATA,APPORTIONMENT OF INPATIENT/OUTPATIENT ANCILLARY SERVICE OTHER PASS THROUGH COSTS,COST ALLOCATION,APPORTIONMENT OF MEDICAL AND OTHER HEALTH SERVICES,APPORTIONMENT OF MEDICAL AND OTHER HEALTH SERVICES,TRIAL BALANCE OF EXPENSE ACCOUNTS,RECONCILIATION OF CAPITAL COST CENTERS,NUMBER OF BEDS,ALLOCATION OF NEW CAPITAL COSTS,INPATIENT ANCILLARY SERVICE COST APPORTIONMENT,APPORTIONMENT OF INPATIENT/OUTPATIENT ANCILLARY SERVICE OTHER PASS THROUGH COSTS,TRIAL BALANCE OF EXPENSE ACCOUNTS,COST ALLOCATION,TRIAL BALANCE OF EXPENSE ACCOUNTS,COMPUTATION OF RATIO OF COST TO CHARGES,APPORTIONMENT OF INPATIENT/OUTPATIENT ANCILLARY SERVICE OTHER PASS THROUGH COSTS,APPORTIONMENT OF INPATIENT/OUTPATIENT ANCILLARY SERVICE OTHER PASS THROUGH COSTS,RENAL STATISTICAL DATA,TRIAL BALANCE OF EXPENSE ACCOUNTS,ALLOCATION OF NEW CAPITAL COSTS,ALLOCATION OF NEW CAPITAL COSTS,HHA STATISTICAL DATA,INPATIENT ANCILLARY SERVICE COST APPORTIONMENT,TRIAL BALANCE OF EXPENSE ACCOUNTS,TRIAL BALANCE OF EXPENSE ACCOUNTS,TRIAL BALANCE OF EXPENSE ACCOUNTS,HOSPITAL IDENTIFICATION INFORMATION,COMPUTATION OF RATIO OF COST TO CHARGES,INPATIENT ANCILLARY SERVICE COST APPORTIONMENT,S-10 DATA,HHA STATISTICAL DATA,TRIAL BALANCE OF EXPENSE ACCOUNTS,COMPUTATION OF INPATIENT OPERATING COSTS,TRIAL BALANCE OF EXPENSE ACCOUNTS,TRIAL BALANCE OF EXPENSE ACCOUNTS,ALLOCATION OF NEW CAPITAL COSTS,RECONCILIATION OF CAPITAL COST CENTERS,HOSPITAL WAGE INDEX DATA,COMPUTATION OF INPATIENT OPERATING COSTS,INPATIENT ANCILLARY SERVICE COST APPORTIONMENT,COST ALLOCATION,CALCULATION OF REIMBURSEMENT SETTLEMENT,HOSPITAL WAGE INDEX DATA,APPORTIONMENT OF INPATIENT ROUTINE SERVICE OTHER PASS THROUGH COSTS,COST ALLOCATION,Total Inpatient Days/Outpatient Visits,COST ALLOCATION,COST ALLOCATION,RENAL STATISTICAL DATA,ALLOCATION OF NEW CAPITAL COSTS,APPORTIONMENT OF MEDICAL AND OTHER HEALTH SERVICES,TRIAL BALANCE OF EXPENSE ACCOUNTS,CALCULATION OF REIMBURSEMENT SETTLEMENT,APPORTIONMENT OF INPATIENT/OUTPATIENT ANCILLARY SERVICE OTHER PASS THROUGH COSTS,TRIAL BALANCE OF EXPENSE ACCOUNTS,TRIAL BALANCE OF EXPENSE ACCOUNTS,HOSPITAL WAGE INDEX DATA,CALCULATION OF REIMBURSEMENT SETTLEMENT,HHA STATISTICAL DATA,,APPORTIONMENT OF INPATIENT/OUTPATIENT ANCILLARY SERVICE OTHER PASS THROUGH COSTS,COMPUTATION OF RATIO OF COST TO CHARGES,COST ALLOCATION,TRIAL BALANCE OF EXPENSE ACCOUNTS,TRIAL BALANCE OF EXPENSE ACCOUNTS,INPATIENT ANCILLARY SERVICE COST APPORTIONMENT,HOSPITAL WAGE INDEX DATA,,NUMBER OF BEDS,APPORTIONMENT OF MEDICAL AND OTHER HEALTH SERVICES,TRIAL BALANCE OF EXPENSE ACCOUNTS,STATEMENT OF REVENUES AND EXPENSES,APPORTIONMENT OF MEDICAL AND OTHER HEALTH SERVICES,COST ALLOCATION,COST ALLOCATION,APPORTIONMENT OF MEDICAL AND OTHER HEALTH SERVICES,INPATIENT ANCILLARY SERVICE COST APPORTIONMENT,ALLOCATION OF NEW CAPITAL COSTS,TRIAL BALANCE OF EXPENSE ACCOUNTS,TRIAL BALANCE OF EXPENSE ACCOUNTS,Total Inpatient Days/Outpatient Visits,COST ALLOCATION,COMPUTATION OF RATIO OF COST TO CHARGES,COMPUTATION OF RATIO OF COST TO CHARGES,COMPUTATION OF INPATIENT OPERATING COSTS,CALCULATION OF REIMBURSEMENT SETTLEMENT,,,APPORTIONMENT OF INPATIENT ROUTINE SERVICE CAPITAL COSTS,APPORTIONMENT OF MEDICAL AND OTHER HEALTH SERVICES,APPORTIONMENT OF INPATIENT/OUTPATIENT ANCILLARY SERVICE OTHER PASS THROUGH COSTS,APPORTIONMENT OF MEDICAL AND OTHER HEALTH SERVICES,COMPUTATION OF INPATIENT OPERATING COSTS,INPATIENT ANCILLARY SERVICE COST APPORTIONMENT,ALLOCATION OF NEW CAPITAL COSTS,COST ALLOCATION,APPORTIONMENT OF INPATIENT/OUTPATIENT ANCILLARY SERVICE OTHER PASS THROUGH COSTS,INPATIENT ANCILLARY SERVICE COST APPORTIONMENT,HHA STATISTICAL DATA,COST ALLOCATION,APPORTIONMENT OF MEDICAL AND OTHER HEALTH SERVICES,COST ALLOCATION,INPATIENT ANCILLARY SERVICE COST APPORTIONMENT,INPATIENT ANCILLARY SERVICE COST APPORTIONMENT,TRIAL BALANCE OF EXPENSE ACCOUNTS,INPATIENT ANCILLARY SERVICE COST APPORTIONMENT,Medicaid Inpatient Days/Outpatient Visits,APPORTIONMENT OF INPATIENT/OUTPATIENT ANCILLARY SERVICE OTHER PASS THROUGH COSTS,Total Inpatient Days/Outpatient Visits,INPATIENT ANCILLARY SERVICE COST APPORTIONMENT,ALLOCATION OF NEW CAPITAL COSTS,APPORTIONMENT OF INPATIENT/OUTPATIENT ANCILLARY SERVICE OTHER PASS THROUGH COSTS,APPORTIONMENT OF MEDICAL AND OTHER HEALTH SERVICES,APPORTIONMENT OF INPATIENT/OUTPATIENT ANCILLARY SERVICE OTHER PASS THROUGH COSTS,ALLOCATION OF NEW CAPITAL COSTS,INPATIENT ANCILLARY SERVICE COST APPORTIONMENT,HOSPITAL WAGE INDEX DATA,RENAL STATISTICAL DATA,APPORTIONMENT OF INPATIENT/OUTPATIENT ANCILLARY SERVICE OTHER PASS THROUGH COSTS,,APPORTIONMENT OF INPATIENT/OUTPATIENT ANCILLARY SERVICE OTHER PASS THROUGH COSTS,APPORTIONMENT OF MEDICAL AND OTHER HEALTH SERVICES,TRIAL BALANCE OF EXPENSE ACCOUNTS,COST ALLOCATION,COMPUTATION OF RATIO OF COST TO CHARGES,INPATIENT ANCILLARY SERVICE COST APPORTIONMENT,COMPUTATION OF RATIO OF COST TO CHARGES,APPORTIONMENT OF MEDICAL AND OTHER HEALTH SERVICES,TRIAL BALANCE OF EXPENSE ACCOUNTS,COMPUTATION OF RATIO OF COST TO CHARGES,Medicaid Inpatient Days/Outpatient Visits,ALLOCATION OF NEW CAPITAL COSTS,TRIAL BALANCE OF EXPENSE ACCOUNTS,COST ALLOCATION,COST ALLOCATION,NUMBER OF BEDS,INPATIENT ANCILLARY SERVICE COST APPORTIONMENT,HHA STATISTICAL DATA,COST ALLOCATION,COST ALLOCATION,HOSPITAL WAGE INDEX DATA,S-10 DATA,HOSPITAL WAGE INDEX DATA,COST ALLOCATION,BED DAYS AVAILABLE,Total Inpatient Days/Outpatient Visits,INPATIENT ANCILLARY SERVICE COST APPORTIONMENT,APPORTIONMENT OF INPATIENT/OUTPATIENT ANCILLARY SERVICE OTHER PASS THROUGH COSTS,INPATIENT ANCILLARY SERVICE COST APPORTIONMENT,COMPUTATION OF RATIO OF COST TO CHARGES,RENAL STATISTICAL DATA,HHA STATISTICAL DATA,RECONCILIATION OF CAPITAL COST CENTERS,ALLOCATION OF NEW CAPITAL COSTS,TRIAL BALANCE OF EXPENSE ACCOUNTS,APPORTIONMENT OF INPATIENT/OUTPATIENT ANCILLARY SERVICE OTHER PASS THROUGH COSTS,INPATIENT ANCILLARY SERVICE COST APPORTIONMENT,HOSPITAL WAGE INDEX DATA,S-10 DATA,COST ALLOCATION,HOSPITAL WAGE INDEX DATA,ALLOCATION OF NEW CAPITAL COSTS,ANALYSIS OF CHANGES IN NEW CAPITAL BALANCES,COST ALLOCATION,CALCULATION OF REIMBURSEMENT SETTLEMENT,BALANCE SHEET,COST ALLOCATION,HHA STATISTICAL DATA,TRIAL BALANCE OF EXPENSE ACCOUNTS,ALLOCATION OF NEW CAPITAL COSTS,APPORTIONMENT OF INPATIENT/OUTPATIENT ANCILLARY SERVICE OTHER PASS THROUGH COSTS,APPORTIONMENT OF INPATIENT ROUTINE SERVICE CAPITAL COSTS,HOSPITAL WAGE INDEX DATA,HOSPITAL WAGE INDEX DATA,HOSPITAL WAGE INDEX DATA,COST ALLOCATION,COST ALLOCATION,APPORTIONMENT OF INPATIENT/OUTPATIENT ANCILLARY SERVICE OTHER PASS THROUGH COSTS,,HOSPITAL WAGE INDEX DATA,HOSPITAL WAGE INDEX DATA,APPORTIONMENT OF INPATIENT ROUTINE SERVICE CAPITAL COSTS,INPATIENT ANCILLARY SERVICE COST APPORTIONMENT,HHA STATISTICAL DATA,,APPORTIONMENT OF INPATIENT/OUTPATIENT ANCILLARY SERVICE OTHER PASS THROUGH COSTS,COMPUTATION OF INPATIENT OPERATING COSTS,STATEMENT OF REVENUES AND EXPENSES,ALLOCATION OF NEW CAPITAL COSTS,APPORTIONMENT OF INPATIENT/OUTPATIENT ANCILLARY SERVICE OTHER PASS THROUGH COSTS,COST ALLOCATION,COST ALLOCATION,HHA STATISTICAL DATA,TRIAL BALANCE OF EXPENSE ACCOUNTS,S-10 DATA,APPORTIONMENT OF INPATIENT/OUTPATIENT ANCILLARY SERVICE OTHER PASS THROUGH COSTS,APPORTIONMENT OF INPATIENT/OUTPATIENT ANCILLARY SERVICE OTHER PASS THROUGH COSTS,APPORTIONMENT OF MEDICAL AND OTHER HEALTH SERVICES,HOSPITAL WAGE INDEX DATA,INPATIENT ANCILLARY SERVICE COST APPORTIONMENT,ALLOCATION OF NEW CAPITAL COSTS,TRIAL BALANCE OF EXPENSE ACCOUNTS,ANALYSIS OF CHANGES IN NEW CAPITAL BALANCES,INPATIENT ANCILLARY SERVICE COST APPORTIONMENT,HOSPITAL WAGE INDEX DATA,APPORTIONMENT OF MEDICAL AND OTHER HEALTH SERVICES,APPORTIONMENT OF MEDICAL AND OTHER HEALTH SERVICES,HOSPITAL WAGE INDEX DATA,APPORTIONMENT OF MEDICAL AND OTHER HEALTH SERVICES,APPORTIONMENT OF INPATIENT/OUTPATIENT ANCILLARY SERVICE OTHER PASS THROUGH COSTS,APPORTIONMENT OF MEDICAL AND OTHER HEALTH SERVICES,APPORTIONMENT OF INPATIENT/OUTPATIENT ANCILLARY SERVICE OTHER PASS THROUGH COSTS,COMPUTATION OF RATIO OF COST TO CHARGES,CALCULATION OF REIMBURSEMENT SETTLEMENT,CALCULATION OF REIMBURSEMENT SETTLEMENT,INPATIENT ANCILLARY SERVICE COST APPORTIONMENT,APPORTIONMENT OF INPATIENT/OUTPATIENT ANCILLARY SERVICE OTHER PASS THROUGH COSTS,HOSPITAL IDENTIFICATION INFORMATION,APPORTIONMENT OF MEDICAL AND OTHER HEALTH SERVICES,INPATIENT ANCILLARY SERVICE COST APPORTIONMENT,HHA STATISTICAL DATA,TRIAL BALANCE OF EXPENSE ACCOUNTS,COST ALLOCATION,APPORTIONMENT OF INPATIENT/OUTPATIENT ANCILLARY SERVICE OTHER PASS THROUGH COSTS,APPORTIONMENT OF INPATIENT/OUTPATIENT ANCILLARY SERVICE OTHER PASS THROUGH COSTS,COMPUTATION OF RATIO OF COST TO CHARGES,INPATIENT ANCILLARY SERVICE COST APPORTIONMENT,INPATIENT ANCILLARY SERVICE COST APPORTIONMENT,CALCULATION OF REIMBURSEMENT SETTLEMENT,RENAL STATISTICAL DATA,APPORTIONMENT OF INPATIENT/OUTPATIENT ANCILLARY SERVICE OTHER PASS THROUGH COSTS,COST ALLOCATION,APPORTIONMENT OF INPATIENT/OUTPATIENT ANCILLARY SERVICE OTHER PASS THROUGH COSTS,APPORTIONMENT OF INPATIENT/OUTPATIENT ANCILLARY SERVICE OTHER PASS THROUGH COSTS,BALANCE SHEET,ADJUSTMENTS,COST ALLOCATION,INPATIENT ANCILLARY SERVICE COST APPORTIONMENT,COMPUTATION OF RATIO OF COST TO CHARGES,HOSPITAL WAGE INDEX DATA,INPATIENT ANCILLARY SERVICE COST APPORTIONMENT,APPORTIONMENT OF MEDICAL AND OTHER HEALTH SERVICES,APPORTIONMENT OF MEDICAL AND OTHER HEALTH SERVICES,HHA STATISTICAL DATA,,BED DAYS AVAILABLE,TRIAL BALANCE OF EXPENSE ACCOUNTS,INPATIENT ANCILLARY SERVICE COST APPORTIONMENT,APPORTIONMENT OF INPATIENT/OUTPATIENT ANCILLARY SERVICE OTHER PASS THROUGH COSTS,COST ALLOCATION,BALANCE SHEET,APPORTIONMENT OF INPATIENT ROUTINE SERVICE CAPITAL COSTS,CALCULATION OF REIMBURSEMENT SETTLEMENT,BED DAYS AVAILABLE,COMPUTATION OF RATIO OF COST TO CHARGES,HOSPITAL WAGE INDEX DATA,APPORTIONMENT OF INPATIENT/OUTPATIENT ANCILLARY SERVICE OTHER PASS THROUGH COSTS,APPORTIONMENT OF MEDICAL AND OTHER HEALTH SERVICES,APPORTIONMENT OF MEDICAL AND OTHER HEALTH SERVICES,,APPORTIONMENT OF MEDICAL AND OTHER HEALTH SERVICES,RENAL STATISTICAL DATA,APPORTIONMENT OF MEDICAL AND OTHER HEALTH SERVICES,ADJUSTMENTS,COMPUTATION OF RATIO OF COST TO CHARGES,Total Inpatient Days/Outpatient Visits,COST ALLOCATION,INPATIENT ANCILLARY SERVICE COST APPORTIONMENT,TRIAL BALANCE OF EXPENSE ACCOUNTS,Total Inpatient Days/Outpatient Visits,Total Inpatient Days/Outpatient Visits,TRIAL BALANCE OF EXPENSE ACCOUNTS,APPORTIONMENT OF INPATIENT/OUTPATIENT ANCILLARY SERVICE OTHER PASS THROUGH COSTS,COMPUTATION OF RATIO OF COST TO CHARGES,ALLOCATION OF NEW CAPITAL COSTS,COMPUTATION OF RATIO OF COST TO CHARGES,HOSPITAL WAGE INDEX DATA,COST ALLOCATION,APPORTIONMENT OF MEDICAL AND OTHER HEALTH SERVICES,Total Inpatient Days/Outpatient Visits,HOSPITAL WAGE INDEX DATA,NUMBER OF BEDS,RENAL STATISTICAL DATA,HOSPITAL WAGE INDEX DATA,APPORTIONMENT OF INPATIENT/OUTPATIENT ANCILLARY SERVICE OTHER PASS THROUGH COSTS,COMPUTATION OF RATIO OF COST TO CHARGES,APPORTIONMENT OF INPATIENT/OUTPATIENT ANCILLARY SERVICE OTHER PASS THROUGH COSTS,COMPUTATION OF RATIO OF COST TO CHARGES,INPATIENT ANCILLARY SERVICE COST APPORTIONMENT,,TRIAL BALANCE OF EXPENSE ACCOUNTS,TRIAL BALANCE OF EXPENSE ACCOUNTS,INPATIENT ANCILLARY SERVICE COST APPORTIONMENT,INPATIENT ANCILLARY SERVICE COST APPORTIONMENT,RENAL STATISTICAL DATA,APPORTIONMENT OF MEDICAL AND OTHER HEALTH SERVICES,,TRIAL BALANCE OF EXPENSE ACCOUNTS,TRIAL BALANCE OF EXPENSE ACCOUNTS,COMPUTATION OF RATIO OF COST TO CHARGES,COMPUTATION OF RATIO OF COST TO CHARGES,TRIAL BALANCE OF EXPENSE ACCOUNTS,COST ALLOCATION,APPORTIONMENT OF INPATIENT/OUTPATIENT ANCILLARY SERVICE OTHER PASS THROUGH COSTS,TRIAL BALANCE OF EXPENSE ACCOUNTS,,APPORTIONMENT OF INPATIENT/OUTPATIENT ANCILLARY SERVICE OTHER PASS THROUGH COSTS,APPORTIONMENT OF MEDICAL AND OTHER HEALTH SERVICES,APPORTIONMENT OF INPATIENT/OUTPATIENT ANCILLARY SERVICE OTHER PASS THROUGH COSTS,Total Inpatient Days/Outpatient Visits,COMPUTATION OF RATIO OF COST TO CHARGES,APPORTIONMENT OF INPATIENT/OUTPATIENT ANCILLARY SERVICE OTHER PASS THROUGH COSTS,APPORTIONMENT OF INPATIENT/OUTPATIENT ANCILLARY SERVICE OTHER PASS THROUGH COSTS,APPORTIONMENT OF INPATIENT/OUTPATIENT ANCILLARY SERVICE OTHER PASS THROUGH COSTS,COST ALLOCATION,APPORTIONMENT OF INPATIENT/OUTPATIENT ANCILLARY SERVICE OTHER PASS THROUGH COSTS,ADJUSTMENTS,COST ALLOCATION,ALLOCATION OF NEW CAPITAL COSTS,INPATIENT ANCILLARY SERVICE COST APPORTIONMENT,COST ALLOCATION,S-10 DATA,COMPUTATION OF RATIO OF COST TO CHARGES,TRIAL BALANCE OF EXPENSE ACCOUNTS,APPORTIONMENT OF INPATIENT/OUTPATIENT ANCILLARY SERVICE OTHER PASS THROUGH COSTS,TRIAL BALANCE OF EXPENSE ACCOUNTS,APPORTIONMENT OF MEDICAL AND OTHER HEALTH SERVICES,TRIAL BALANCE OF EXPENSE ACCOUNTS,HOSPITAL WAGE INDEX DATA,COST ALLOCATION,ADJUSTMENTS,APPORTIONMENT OF INPATIENT/OUTPATIENT ANCILLARY SERVICE OTHER PASS THROUGH COSTS,ALLOCATION OF NEW CAPITAL COSTS,APPORTIONMENT OF MEDICAL AND OTHER HEALTH SERVICES,COMPUTATION OF RATIO OF COST TO CHARGES,NUMBER OF BEDS,APPORTIONMENT OF INPATIENT/OUTPATIENT ANCILLARY SERVICE OTHER PASS THROUGH COSTS,TRIAL BALANCE OF EXPENSE ACCOUNTS,HOSPITAL WAGE INDEX DATA,APPORTIONMENT OF INPATIENT/OUTPATIENT ANCILLARY SERVICE OTHER PASS THROUGH COSTS,HHA STATISTICAL DATA,INPATIENT ANCILLARY SERVICE COST APPORTIONMENT,BALANCE SHEET,INPATIENT ANCILLARY SERVICE COST APPORTIONMENT,HOSPITAL WAGE INDEX DATA,TRIAL BALANCE OF EXPENSE ACCOUNTS,APPORTIONMENT OF INPATIENT/OUTPATIENT ANCILLARY SERVICE OTHER PASS THROUGH COSTS,INPATIENT ANCILLARY SERVICE COST APPORTIONMENT,APPORTIONMENT OF INPATIENT/OUTPATIENT ANCILLARY SERVICE OTHER PASS THROUGH COSTS,BED DAYS AVAILABLE,TRIAL BALANCE OF EXPENSE ACCOUNTS,HHA STATISTICAL DATA,APPORTIONMENT OF INPATIENT/OUTPATIENT ANCILLARY SERVICE OTHER PASS THROUGH COSTS,APPORTIONMENT OF INPATIENT/OUTPATIENT ANCILLARY SERVICE OTHER PASS THROUGH COSTS,APPORTIONMENT OF INPATIENT/OUTPATIENT ANCILLARY SERVICE OTHER PASS THROUGH COSTS,ANALYSIS OF CHANGES IN NEW CAPITAL BALANCES,COST ALLOCATION,TRIAL BALANCE OF EXPENSE ACCOUNTS,TRIAL BALANCE OF EXPENSE ACCOUNTS,CALCULATION OF REIMBURSEMENT SETTLEMENT,APPORTIONMENT OF MEDICAL AND OTHER HEALTH SERVICES,COMPUTATION OF INPATIENT OPERATING COSTS,APPORTIONMENT OF INPATIENT/OUTPATIENT ANCILLARY SERVICE OTHER PASS THROUGH COSTS,APPORTIONMENT OF INPATIENT/OUTPATIENT ANCILLARY SERVICE OTHER PASS THROUGH COSTS,S-10 DATA,COMPUTATION OF RATIO OF COST TO CHARGES,HOSPITAL IDENTIFICATION INFORMATION,TRIAL BALANCE OF EXPENSE ACCOUNTS,HHA STATISTICAL DATA,BALANCE SHEET,TRIAL BALANCE OF EXPENSE ACCOUNTS,COST ALLOCATION,COST ALLOCATION,,APPORTIONMENT OF INPATIENT/OUTPATIENT ANCILLARY SERVICE OTHER PASS THROUGH COSTS,CALCULATION OF REIMBURSEMENT SETTLEMENT,INPATIENT ANCILLARY SERVICE COST APPORTIONMENT,HOSPITAL WAGE INDEX DATA,Total Inpatient Days/Outpatient Visits,APPORTIONMENT OF INPATIENT/OUTPATIENT ANCILLARY SERVICE OTHER PASS THROUGH COSTS,APPORTIONMENT OF MEDICAL AND OTHER HEALTH SERVICES,COST ALLOCATION,APPORTIONMENT OF MEDICAL AND OTHER HEALTH SERVICES,HHA STATISTICAL DATA,TRIAL BALANCE OF EXPENSE ACCOUNTS,HOSPITAL WAGE INDEX DATA,INPATIENT ANCILLARY SERVICE COST APPORTIONMENT,HHA STATISTICAL DATA,INPATIENT ANCILLARY SERVICE COST APPORTIONMENT,ALLOCATION OF NEW CAPITAL COSTS,COST ALLOCATION,INPATIENT ANCILLARY SERVICE COST APPORTIONMENT,Total Inpatient Days/Outpatient Visits,COST ALLOCATION,INPATIENT ANCILLARY SERVICE COST APPORTIONMENT,ALLOCATION OF NEW CAPITAL COSTS,COMPUTATION OF RATIO OF COST TO CHARGES,APPORTIONMENT OF INPATIENT/OUTPATIENT ANCILLARY SERVICE OTHER PASS THROUGH COSTS,INPATIENT ANCILLARY SERVICE COST APPORTIONMENT,APPORTIONMENT OF INPATIENT/OUTPATIENT ANCILLARY SERVICE OTHER PASS THROUGH COSTS,Total Inpatient Days/Outpatient Visits,HOSPITAL WAGE INDEX DATA,TRIAL BALANCE OF EXPENSE ACCOUNTS,COST ALLOCATION,APPORTIONMENT OF INPATIENT/OUTPATIENT ANCILLARY SERVICE OTHER PASS THROUGH COSTS,APPORTIONMENT OF MEDICAL AND OTHER HEALTH SERVICES,INPATIENT ANCILLARY SERVICE COST APPORTIONMENT,INPATIENT ANCILLARY SERVICE COST APPORTIONMENT,RECONCILIATION OF CAPITAL COST CENTERS,COMPUTATION OF INPATIENT OPERATING COSTS,APPORTIONMENT OF INPATIENT/OUTPATIENT ANCILLARY SERVICE OTHER PASS THROUGH COSTS,TRIAL BALANCE OF EXPENSE ACCOUNTS,Total Inpatient Days/Outpatient Visits,COST ALLOCATION,COST ALLOCATION,APPORTIONMENT OF MEDICAL AND OTHER HEALTH SERVICES,COMPUTATION OF RATIO OF COST TO CHARGES,APPORTIONMENT OF INPATIENT/OUTPATIENT ANCILLARY SERVICE OTHER PASS THROUGH COSTS,COST ALLOCATION,,INPATIENT ANCILLARY SERVICE COST APPORTIONMENT,INPATIENT ANCILLARY SERVICE COST APPORTIONMENT,Medicare Inpatient Days/Outpatient Visits,APPORTIONMENT OF INPATIENT ROUTINE SERVICE CAPITAL COSTS,INPATIENT ANCILLARY SERVICE COST APPORTIONMENT,COMPUTATION OF RATIO OF COST TO CHARGES,TRIAL BALANCE OF EXPENSE ACCOUNTS,APPORTIONMENT OF INPATIENT/OUTPATIENT ANCILLARY SERVICE OTHER PASS THROUGH COSTS,INPATIENT ANCILLARY SERVICE COST APPORTIONMENT,TRIAL BALANCE OF EXPENSE ACCOUNTS,INPATIENT ANCILLARY SERVICE COST APPORTIONMENT,TRIAL BALANCE OF EXPENSE ACCOUNTS,COST ALLOCATION,Total Inpatient Days/Outpatient Visits,HOSPITAL WAGE INDEX DATA,HOSPITAL WAGE INDEX DATA,APPORTIONMENT OF INPATIENT/OUTPATIENT ANCILLARY SERVICE OTHER PASS THROUGH COSTS,,,COST ALLOCATION,COMPUTATION OF RATIO OF COST TO CHARGES,APPORTIONMENT OF INPATIENT/OUTPATIENT ANCILLARY SERVICE OTHER PASS THROUGH COSTS,CALCULATION OF REIMBURSEMENT SETTLEMENT,BALANCE SHEET,HOSPITAL WAGE INDEX DATA,HOSPITAL WAGE INDEX DATA,APPORTIONMENT OF INPATIENT ROUTINE SERVICE OTHER PASS THROUGH COSTS,INPATIENT ANCILLARY SERVICE COST APPORTIONMENT,APPORTIONMENT OF INPATIENT/OUTPATIENT ANCILLARY SERVICE OTHER PASS THROUGH COSTS,APPORTIONMENT OF INPATIENT/OUTPATIENT ANCILLARY SERVICE OTHER PASS THROUGH COSTS,INPATIENT ANCILLARY SERVICE COST APPORTIONMENT,APPORTIONMENT OF INPATIENT/OUTPATIENT ANCILLARY SERVICE OTHER PASS THROUGH COSTS,ALLOCATION OF NEW CAPITAL COSTS,COMPUTATION OF RATIO OF COST TO CHARGES,CALCULATION OF REIMBURSEMENT SETTLEMENT (PPS),APPORTIONMENT OF INPATIENT/OUTPATIENT ANCILLARY SERVICE OTHER PASS THROUGH COSTS,COMPUTATION OF RATIO OF COST TO CHARGES,APPORTIONMENT OF INPATIENT ROUTINE SERVICE CAPITAL COSTS,APPORTIONMENT OF INPATIENT/OUTPATIENT ANCILLARY SERVICE OTHER PASS THROUGH COSTS,COMPUTATION OF INPATIENT OPERATING COSTS,,APPORTIONMENT OF INPATIENT/OUTPATIENT ANCILLARY SERVICE OTHER PASS THROUGH COSTS,Total Inpatient Days/Outpatient Visits,COST ALLOCATION,,HOSPITAL WAGE INDEX DATA,APPORTIONMENT OF INPATIENT/OUTPATIENT ANCILLARY SERVICE OTHER PASS THROUGH COSTS,HHA STATISTICAL DATA,TRIAL BALANCE OF EXPENSE ACCOUNTS,APPORTIONMENT OF INPATIENT/OUTPATIENT ANCILLARY SERVICE OTHER PASS THROUGH COSTS,TRIAL BALANCE OF EXPENSE ACCOUNTS,INPATIENT ANCILLARY SERVICE COST APPORTIONMENT,APPORTIONMENT OF INPATIENT/OUTPATIENT ANCILLARY SERVICE OTHER PASS THROUGH COSTS,TRIAL BALANCE OF EXPENSE ACCOUNTS,STATEMENT OF REVENUES AND EXPENSES,COST ALLOCATION,APPORTIONMENT OF INPATIENT/OUTPATIENT ANCILLARY SERVICE OTHER PASS THROUGH COSTS,TRIAL BALANCE OF EXPENSE ACCOUNTS,HHA STATISTICAL DATA,APPORTIONMENT OF MEDICAL AND OTHER HEALTH SERVICES,APPORTIONMENT OF INPATIENT ROUTINE SERVICE CAPITAL COSTS,COMPUTATION OF RATIO OF COST TO CHARGES,S-10 DATA,INPATIENT ANCILLARY SERVICE COST APPORTIONMENT,ALLOCATION OF NEW CAPITAL COSTS,Total Inpatient Days/Outpatient Visits,ALLOCATION OF NEW CAPITAL COSTS,,,APPORTIONMENT OF INPATIENT ROUTINE SERVICE CAPITAL COSTS,APPORTIONMENT OF INPATIENT/OUTPATIENT ANCILLARY SERVICE OTHER PASS THROUGH COSTS,INPATIENT ANCILLARY SERVICE COST APPORTIONMENT,COMPUTATION OF RATIO OF COST TO CHARGES,,APPORTIONMENT OF INPATIENT/OUTPATIENT ANCILLARY SERVICE OTHER PASS THROUGH COSTS,APPORTIONMENT OF INPATIENT/OUTPATIENT ANCILLARY SERVICE OTHER PASS THROUGH COSTS,TRIAL BALANCE OF EXPENSE ACCOUNTS,INPATIENT ANCILLARY SERVICE COST APPORTIONMENT,APPORTIONMENT OF MEDICAL AND OTHER HEALTH SERVICES,TRIAL BALANCE OF EXPENSE ACCOUNTS,INPATIENT ANCILLARY SERVICE COST APPORTIONMENT,HOSPITAL WAGE INDEX DATA,HOSPITAL WAGE INDEX DATA,ANALYSIS OF CHANGES IN NEW CAPITAL BALANCES,HOSPITAL WAGE INDEX DATA,APPORTIONMENT OF INPATIENT/OUTPATIENT ANCILLARY SERVICE OTHER PASS THROUGH COSTS,INPATIENT ANCILLARY SERVICE COST APPORTIONMENT,INPATIENT ANCILLARY SERVICE COST APPORTIONMENT,COST ALLOCATION,APPORTIONMENT OF INPATIENT ROUTINE SERVICE CAPITAL COSTS,RECONCILIATION OF CAPITAL COST CENTERS,APPORTIONMENT OF MEDICAL AND OTHER HEALTH SERVICES,TRIAL BALANCE OF EXPENSE ACCOUNTS,RENAL STATISTICAL DATA,COST ALLOCATION,TRIAL BALANCE OF EXPENSE ACCOUNTS,TRIAL BALANCE OF EXPENSE ACCOUNTS,COST ALLOCATION,HOSPITAL WAGE INDEX DATA,CALCULATION OF REIMBURSEMENT SETTLEMENT,TRIAL BALANCE OF EXPENSE ACCOUNTS,TRIAL BALANCE OF EXPENSE ACCOUNTS,COST ALLOCATION,COST ALLOCATION,APPORTIONMENT OF INPATIENT ROUTINE SERVICE OTHER PASS THROUGH COSTS,APPORTIONMENT OF INPATIENT/OUTPATIENT ANCILLARY SERVICE OTHER PASS THROUGH COSTS,BALANCE SHEET,TRIAL BALANCE OF EXPENSE ACCOUNTS,HOSPITAL WAGE INDEX DATA,HOSPITAL WAGE INDEX DATA,APPORTIONMENT OF MEDICAL AND OTHER HEALTH SERVICES,BED DAYS AVAILABLE,INPATIENT ANCILLARY SERVICE COST APPORTIONMENT,APPORTIONMENT OF MEDICAL AND OTHER HEALTH SERVICES,INPATIENT ANCILLARY SERVICE COST APPORTIONMENT,APPORTIONMENT OF INPATIENT/OUTPATIENT ANCILLARY SERVICE OTHER PASS THROUGH COSTS,APPORTIONMENT OF INPATIENT/OUTPATIENT ANCILLARY SERVICE OTHER PASS THROUGH COSTS,APPORTIONMENT OF INPATIENT/OUTPATIENT ANCILLARY SERVICE OTHER PASS THROUGH COSTS,COMPUTATION OF RATIO OF COST TO CHARGES,APPORTIONMENT OF INPATIENT/OUTPATIENT ANCILLARY SERVICE OTHER PASS THROUGH COSTS,APPORTIONMENT OF INPATIENT/OUTPATIENT ANCILLARY SERVICE OTHER PASS THROUGH COSTS,APPORTIONMENT OF MEDICAL AND OTHER HEALTH SERVICES,APPORTIONMENT OF INPATIENT/OUTPATIENT ANCILLARY SERVICE OTHER PASS THROUGH COSTS,BALANCE SHEET,,COST ALLOCATION,COMPUTATION OF RATIO OF COST TO CHARGES,APPORTIONMENT OF INPATIENT/OUTPATIENT ANCILLARY SERVICE OTHER PASS THROUGH COSTS,COST ALLOCATION,TRIAL BALANCE OF EXPENSE ACCOUNTS,COST ALLOCATION,COST ALLOCATION,APPORTIONMENT OF INPATIENT/OUTPATIENT ANCILLARY SERVICE OTHER PASS THROUGH COSTS,S-10 DATA,TRIAL BALANCE OF EXPENSE ACCOUNTS,APPORTIONMENT OF INPATIENT/OUTPATIENT ANCILLARY SERVICE OTHER PASS THROUGH COSTS,,Medicaid Inpatient Days/Outpatient Visits,APPORTIONMENT OF INPATIENT/OUTPATIENT ANCILLARY SERVICE OTHER PASS THROUGH COSTS,APPORTIONMENT OF MEDICAL AND OTHER HEALTH SERVICES,TRIAL BALANCE OF EXPENSE ACCOUNTS,HOSPITAL WAGE INDEX DATA,BALANCE SHEET,APPORTIONMENT OF INPATIENT/OUTPATIENT ANCILLARY SERVICE OTHER PASS THROUGH COSTS,HOSPITAL WAGE INDEX DATA,COMPUTATION OF RATIO OF COST TO CHARGES,ANALYSIS OF CHANGES IN NEW CAPITAL BALANCES,COMPUTATION OF RATIO OF COST TO CHARGES,APPORTIONMENT OF INPATIENT ROUTINE SERVICE CAPITAL COSTS,RECONCILIATION OF CAPITAL COST CENTERS,HHA STATISTICAL DATA,APPORTIONMENT OF MEDICAL AND OTHER HEALTH SERVICES,RECONCILIATION OF CAPITAL COST CENTERS,ALLOCATION OF NEW CAPITAL COSTS,ANALYSIS OF CHANGES IN NEW CAPITAL BALANCES,COST ALLOCATION,,HOSPITAL IDENTIFICATION INFORMATION,COMPUTATION OF RATIO OF COST TO CHARGES,ADJUSTMENTS,HOSPITAL WAGE INDEX DATA,HHA STATISTICAL DATA,APPORTIONMENT OF INPATIENT/OUTPATIENT ANCILLARY SERVICE OTHER PASS THROUGH COSTS,COMPUTATION OF INPATIENT OPERATING COSTS,INPATIENT ANCILLARY SERVICE COST APPORTIONMENT,COST ALLOCATION,APPORTIONMENT OF INPATIENT/OUTPATIENT ANCILLARY SERVICE OTHER PASS THROUGH COSTS,HOSPITAL WAGE INDEX DATA,BED DAYS AVAILABLE,HOSPITAL WAGE INDEX DATA,COST ALLOCATION,HOSPITAL WAGE INDEX DATA,COMPUTATION OF RATIO OF COST TO CHARGES,INPATIENT ANCILLARY SERVICE COST APPORTIONMENT,,HOSPITAL IDENTIFICATION INFORMATION,TRIAL BALANCE OF EXPENSE ACCOUNTS,ALLOCATION OF NEW CAPITAL COSTS,,APPORTIONMENT OF INPATIENT/OUTPATIENT ANCILLARY SERVICE OTHER PASS THROUGH COSTS,APPORTIONMENT OF MEDICAL AND OTHER HEALTH SERVICES,APPORTIONMENT OF MEDICAL AND OTHER HEALTH SERVICES,APPORTIONMENT OF MEDICAL AND OTHER HEALTH SERVICES,STATEMENT OF REVENUES AND EXPENSES,INPATIENT ANCILLARY SERVICE COST APPORTIONMENT,COST ALLOCATION,ALLOCATION OF NEW CAPITAL COSTS,APPORTIONMENT OF INPATIENT/OUTPATIENT ANCILLARY SERVICE OTHER PASS THROUGH COSTS,HOSPITAL WAGE INDEX DATA,,TRIAL BALANCE OF EXPENSE ACCOUNTS,APPORTIONMENT OF INPATIENT/OUTPATIENT ANCILLARY SERVICE OTHER PASS THROUGH COSTS,BALANCE SHEET,TRIAL BALANCE OF EXPENSE ACCOUNTS,APPORTIONMENT OF INPATIENT/OUTPATIENT ANCILLARY SERVICE OTHER PASS THROUGH COSTS,APPORTIONMENT OF INPATIENT/OUTPATIENT ANCILLARY SERVICE OTHER PASS THROUGH COSTS,INPATIENT ANCILLARY SERVICE COST APPORTIONMENT,APPORTIONMENT OF INPATIENT/OUTPATIENT ANCILLARY SERVICE OTHER PASS THROUGH COSTS,COMPUTATION OF RATIO OF COST TO CHARGES,COMPUTATION OF INPATIENT OPERATING COSTS,HHA STATISTICAL DATA,APPORTIONMENT OF INPATIENT/OUTPATIENT ANCILLARY SERVICE OTHER PASS THROUGH COSTS,TRIAL BALANCE OF EXPENSE ACCOUNTS,APPORTIONMENT OF MEDICAL AND OTHER HEALTH SERVICES,APPORTIONMENT OF INPATIENT/OUTPATIENT ANCILLARY SERVICE OTHER PASS THROUGH COSTS,APPORTIONMENT OF INPATIENT ROUTINE SERVICE OTHER PASS THROUGH COSTS,APPORTIONMENT OF MEDICAL AND OTHER HEALTH SERVICES,COMPUTATION OF RATIO OF COST TO CHARGES,ALLOCATION OF NEW CAPITAL COSTS,APPORTIONMENT OF MEDICAL AND OTHER HEALTH SERVICES,APPORTIONMENT OF INPATIENT/OUTPATIENT ANCILLARY SERVICE OTHER PASS THROUGH COSTS,HOSPITAL WAGE INDEX DATA,HHA STATISTICAL DATA,COMPUTATION OF RATIO OF COST TO CHARGES,,HHA STATISTICAL DATA,ADJUSTMENTS,COMPUTATION OF RATIO OF COST TO CHARGES,ANALYSIS OF CHANGES IN NEW CAPITAL BALANCES,HOSPITAL WAGE INDEX DATA,ALLOCATION OF NEW CAPITAL COSTS,COST ALLOCATION,COMPUTATION OF RATIO OF COST TO CHARGES,RECONCILIATION OF CAPITAL COST CENTERS,INPATIENT ANCILLARY SERVICE COST APPORTIONMENT,APPORTIONMENT OF MEDICAL AND OTHER HEALTH SERVICES,RENAL STATISTICAL DATA,INPATIENT ANCILLARY SERVICE COST APPORTIONMENT,TRIAL BALANCE OF EXPENSE ACCOUNTS,APPORTIONMENT OF INPATIENT/OUTPATIENT ANCILLARY SERVICE OTHER PASS THROUGH COSTS,BED DAYS AVAILABLE,INPATIENT ANCILLARY SERVICE COST APPORTIONMENT,ALLOCATION OF NEW CAPITAL COSTS,HOSPITAL WAGE INDEX DATA,APPORTIONMENT OF INPATIENT/OUTPATIENT ANCILLARY SERVICE OTHER PASS THROUGH COSTS,TRIAL BALANCE OF EXPENSE ACCOUNTS,INPATIENT ANCILLARY SERVICE COST APPORTIONMENT,APPORTIONMENT OF INPATIENT/OUTPATIENT ANCILLARY SERVICE OTHER PASS THROUGH COSTS,APPORTIONMENT OF INPATIENT ROUTINE SERVICE CAPITAL COSTS,APPORTIONMENT OF INPATIENT/OUTPATIENT ANCILLARY SERVICE OTHER PASS THROUGH COSTS,ANALYSIS OF CHANGES IN NEW CAPITAL BALANCES,,COST ALLOCATION,APPORTIONMENT OF INPATIENT/OUTPATIENT ANCILLARY SERVICE OTHER PASS THROUGH COSTS,APPORTIONMENT OF INPATIENT ROUTINE SERVICE CAPITAL COSTS,COMPUTATION OF INPATIENT OPERATING COSTS,HOSPITAL WAGE INDEX DATA,CALCULATION OF REIMBURSEMENT SETTLEMENT,COMPUTATION OF RATIO OF COST TO CHARGES,APPORTIONMENT OF INPATIENT/OUTPATIENT ANCILLARY SERVICE OTHER PASS THROUGH COSTS,COMPUTATION OF RATIO OF COST TO CHARGES,,COMPUTATION OF RATIO OF COST TO CHARGES,APPORTIONMENT OF MEDICAL AND OTHER HEALTH SERVICES,Total Inpatient Days/Outpatient Visits,APPORTIONMENT OF MEDICAL AND OTHER HEALTH SERVICES,COMPUTATION OF RATIO OF COST TO CHARGES,CALCULATION OF REIMBURSEMENT SETTLEMENT,BALANCE SHEET,Total Inpatient Days/Outpatient Visits,APPORTIONMENT OF INPATIENT/OUTPATIENT ANCILLARY SERVICE OTHER PASS THROUGH COSTS,TRIAL BALANCE OF EXPENSE ACCOUNTS,BED DAYS AVAILABLE,COST ALLOCATION,TRIAL BALANCE OF EXPENSE ACCOUNTS,TRIAL BALANCE OF EXPENSE ACCOUNTS,TRIAL BALANCE OF EXPENSE ACCOUNTS,CALCULATION OF REIMBURSEMENT SETTLEMENT,APPORTIONMENT OF INPATIENT ROUTINE SERVICE OTHER PASS THROUGH COSTS,HHA STATISTICAL DATA,INPATIENT ANCILLARY SERVICE COST APPORTIONMENT,TRIAL BALANCE OF EXPENSE ACCOUNTS,TRIAL BALANCE OF EXPENSE ACCOUNTS,Total Inpatient Days/Outpatient Visits,APPORTIONMENT OF MEDICAL AND OTHER HEALTH SERVICES,APPORTIONMENT OF INPATIENT ROUTINE SERVICE CAPITAL COSTS,COMPUTATION OF RATIO OF COST TO CHARGES,APPORTIONMENT OF MEDICAL AND OTHER HEALTH SERVICES,HOSPITAL WAGE INDEX DATA,COST ALLOCATION,,COST ALLOCATION,COMPUTATION OF RATIO OF COST TO CHARGES,BALANCE SHEET,HHA STATISTICAL DATA,INPATIENT ANCILLARY SERVICE COST APPORTIONMENT,INPATIENT ANCILLARY SERVICE COST APPORTIONMENT,APPORTIONMENT OF MEDICAL AND OTHER HEALTH SERVICES,INPATIENT ANCILLARY SERVICE COST APPORTIONMENT,ALLOCATION OF NEW CAPITAL COSTS,INPATIENT ANCILLARY SERVICE COST APPORTIONMENT,APPORTIONMENT OF MEDICAL AND OTHER HEALTH SERVICES,COST ALLOCATION,COMPUTATION OF RATIO OF COST TO CHARGES,APPORTIONMENT OF INPATIENT/OUTPATIENT ANCILLARY SERVICE OTHER PASS THROUGH COSTS,TRIAL BALANCE OF EXPENSE ACCOUNTS,APPORTIONMENT OF INPATIENT/OUTPATIENT ANCILLARY SERVICE OTHER PASS THROUGH COSTS,TRIAL BALANCE OF EXPENSE ACCOUNTS,TRIAL BALANCE OF EXPENSE ACCOUNTS,APPORTIONMENT OF MEDICAL AND OTHER HEALTH SERVICES,APPORTIONMENT OF INPATIENT/OUTPATIENT ANCILLARY SERVICE OTHER PASS THROUGH COSTS,RENAL STATISTICAL DATA,TRIAL BALANCE OF EXPENSE ACCOUNTS,COST ALLOCATION,HOSPITAL WAGE INDEX DATA,COST ALLOCATION,COST ALLOCATION,APPORTIONMENT OF INPATIENT/OUTPATIENT ANCILLARY SERVICE OTHER PASS THROUGH COSTS,COMPUTATION OF RATIO OF COST TO CHARGES,APPORTIONMENT OF INPATIENT/OUTPATIENT ANCILLARY SERVICE OTHER PASS THROUGH COSTS,Total Inpatient Days/Outpatient Visits,TRIAL BALANCE OF EXPENSE ACCOUNTS,APPORTIONMENT OF INPATIENT/OUTPATIENT ANCILLARY SERVICE OTHER PASS THROUGH COSTS,APPORTIONMENT OF INPATIENT/OUTPATIENT ANCILLARY SERVICE OTHER PASS THROUGH COSTS,INPATIENT ANCILLARY SERVICE COST APPORTIONMENT,APPORTIONMENT OF INPATIENT/OUTPATIENT ANCILLARY SERVICE OTHER PASS THROUGH COSTS,COST ALLOCATION,COMPUTATION OF RATIO OF COST TO CHARGES,CALCULATION OF REIMBURSEMENT SETTLEMENT (PPS),TRIAL BALANCE OF EXPENSE ACCOUNTS,COST ALLOCATION,CALCULATION OF REIMBURSEMENT SETTLEMENT,HHA STATISTICAL DATA,HHA STATISTICAL DATA,ADJUSTMENTS,Total Inpatient Days/Outpatient Visits,APPORTIONMENT OF INPATIENT/OUTPATIENT ANCILLARY SERVICE OTHER PASS THROUGH COSTS,TRIAL BALANCE OF EXPENSE ACCOUNTS,BED DAYS AVAILABLE,COST ALLOCATION,TRIAL BALANCE OF EXPENSE ACCOUNTS,INPATIENT ANCILLARY SERVICE COST APPORTIONMENT,COMPUTATION OF INPATIENT OPERATING COSTS,APPORTIONMENT OF INPATIENT ROUTINE SERVICE CAPITAL COSTS,,COST ALLOCATION,INPATIENT ANCILLARY SERVICE COST APPORTIONMENT,COST ALLOCATION,COST ALLOCATION,BED DAYS AVAILABLE,HHA STATISTICAL DATA,BED DAYS AVAILABLE,BED DAYS AVAILABLE,APPORTIONMENT OF INPATIENT/OUTPATIENT ANCILLARY SERVICE OTHER PASS THROUGH COSTS,COMPUTATION OF RATIO OF COST TO CHARGES,INPATIENT ANCILLARY SERVICE COST APPORTIONMENT,COST ALLOCATION,Total Inpatient Days/Outpatient Visits,COMPUTATION OF RATIO OF COST TO CHARGES,APPORTIONMENT OF INPATIENT/OUTPATIENT ANCILLARY SERVICE OTHER PASS THROUGH COSTS,RENAL STATISTICAL DATA,APPORTIONMENT OF INPATIENT/OUTPATIENT ANCILLARY SERVICE OTHER PASS THROUGH COSTS,INPATIENT ANCILLARY SERVICE COST APPORTIONMENT,S-10 DATA,APPORTIONMENT OF INPATIENT/OUTPATIENT ANCILLARY SERVICE OTHER PASS THROUGH COSTS,ALLOCATION OF NEW CAPITAL COSTS,APPORTIONMENT OF MEDICAL AND OTHER HEALTH SERVICES,Medicare Inpatient Days/Outpatient Visits,RENAL STATISTICAL DATA,NUMBER OF BEDS,APPORTIONMENT OF INPATIENT/OUTPATIENT ANCILLARY SERVICE OTHER PASS THROUGH COSTS,APPORTIONMENT OF INPATIENT/OUTPATIENT ANCILLARY SERVICE OTHER PASS THROUGH COSTS,INPATIENT ANCILLARY SERVICE COST APPORTIONMENT,APPORTIONMENT OF INPATIENT/OUTPATIENT ANCILLARY SERVICE OTHER PASS THROUGH COSTS,INPATIENT ANCILLARY SERVICE COST APPORTIONMENT,COMPUTATION OF INPATIENT OPERATING COSTS,COMPUTATION OF RATIO OF COST TO CHARGES,HOSPITAL WAGE INDEX DATA,COMPUTATION OF RATIO OF COST TO CHARGES,COST ALLOCATION,APPORTIONMENT OF MEDICAL AND OTHER HEALTH SERVICES,HHA STATISTICAL DATA,TRIAL BALANCE OF EXPENSE ACCOUNTS,APPORTIONMENT OF MEDICAL AND OTHER HEALTH SERVICES,COMPUTATION OF RATIO OF COST TO CHARGES,,INPATIENT ANCILLARY SERVICE COST APPORTIONMENT,INPATIENT ANCILLARY SERVICE COST APPORTIONMENT,Total Inpatient Days/Outpatient Visits,,COMPUTATION OF RATIO OF COST TO CHARGES,TRIAL BALANCE OF EXPENSE ACCOUNTS,,ADJUSTMENTS,Medicare Inpatient Days/Outpatient Visits,INPATIENT ANCILLARY SERVICE COST APPORTIONMENT,APPORTIONMENT OF INPATIENT/OUTPATIENT ANCILLARY SERVICE OTHER PASS THROUGH COSTS,INPATIENT ANCILLARY SERVICE COST APPORTIONMENT,BED DAYS AVAILABLE,INPATIENT ANCILLARY SERVICE COST APPORTIONMENT,INPATIENT ANCILLARY SERVICE COST APPORTIONMENT,INPATIENT ANCILLARY SERVICE COST APPORTIONMENT,INPATIENT ANCILLARY SERVICE COST APPORTIONMENT,COMPUTATION OF INPATIENT OPERATING COSTS,ALLOCATION OF NEW CAPITAL COSTS,COMPUTATION OF RATIO OF COST TO CHARGES,COST ALLOCATION,APPORTIONMENT OF INPATIENT/OUTPATIENT ANCILLARY SERVICE OTHER PASS THROUGH COSTS,INPATIENT ANCILLARY SERVICE COST APPORTIONMENT,INPATIENT ANCILLARY SERVICE COST APPORTIONMENT,ALLOCATION OF NEW CAPITAL COSTS,S-10 DATA,TRIAL BALANCE OF EXPENSE ACCOUNTS,HOSPITAL WAGE INDEX DATA,,HOSPITAL WAGE INDEX DATA,TRIAL BALANCE OF EXPENSE ACCOUNTS,HOSPITAL WAGE INDEX DATA,TRIAL BALANCE OF EXPENSE ACCOUNTS,APPORTIONMENT OF INPATIENT/OUTPATIENT ANCILLARY SERVICE OTHER PASS THROUGH COSTS,COMPUTATION OF RATIO OF COST TO CHARGES,Total Inpatient Days/Outpatient Visits,HOSPITAL WAGE INDEX DATA,APPORTIONMENT OF INPATIENT/OUTPATIENT ANCILLARY SERVICE OTHER PASS THROUGH COSTS,NUMBER OF BEDS,COMPUTATION OF RATIO OF COST TO CHARGES,COMPUTATION OF RATIO OF COST TO CHARGES,ANALYSIS OF CHANGES IN NEW CAPITAL BALANCES,APPORTIONMENT OF INPATIENT/OUTPATIENT ANCILLARY SERVICE OTHER PASS THROUGH COSTS,Total Inpatient Days/Outpatient Visits,HOSPITAL WAGE INDEX DATA,APPORTIONMENT OF MEDICAL AND OTHER HEALTH SERVICES,APPORTIONMENT OF MEDICAL AND OTHER HEALTH SERVICES,APPORTIONMENT OF MEDICAL AND OTHER HEALTH SERVICES,APPORTIONMENT OF INPATIENT/OUTPATIENT ANCILLARY SERVICE OTHER PASS THROUGH COSTS,APPORTIONMENT OF INPATIENT/OUTPATIENT ANCILLARY SERVICE OTHER PASS THROUGH COSTS,INPATIENT ANCILLARY SERVICE COST APPORTIONMENT,HOSPITAL WAGE INDEX DATA,CALCULATION OF REIMBURSEMENT SETTLEMENT,INPATIENT ANCILLARY SERVICE COST APPORTIONMENT,COST ALLOCATION,RENAL STATISTICAL DATA,NUMBER OF BEDS,COMPUTATION OF RATIO OF COST TO CHARGES,CALCULATION OF REIMBURSEMENT SETTLEMENT,S-10 DATA,APPORTIONMENT OF MEDICAL AND OTHER HEALTH SERVICES,COMPUTATION OF RATIO OF COST TO CHARGES,HOSPITAL WAGE INDEX DATA,TRIAL BALANCE OF EXPENSE ACCOUNTS,TRIAL BALANCE OF EXPENSE ACCOUNTS,COST ALLOCATION,TRIAL BALANCE OF EXPENSE ACCOUNTS,HOSPITAL WAGE INDEX DATA,COMPUTATION OF RATIO OF COST TO CHARGES,ALLOCATION OF NEW CAPITAL COSTS,APPORTIONMENT OF INPATIENT/OUTPATIENT ANCILLARY SERVICE OTHER PASS THROUGH COSTS,COST ALLOCATION,COST ALLOCATION,COST ALLOCATION,APPORTIONMENT OF INPATIENT/OUTPATIENT ANCILLARY SERVICE OTHER PASS THROUGH COSTS,HHA STATISTICAL DATA,APPORTIONMENT OF MEDICAL AND OTHER HEALTH SERVICES,INPATIENT ANCILLARY SERVICE COST APPORTIONMENT,,COMPUTATION OF RATIO OF COST TO CHARGES,,COST ALLOCATION,COST ALLOCATION,BALANCE SHEET,INPATIENT ANCILLARY SERVICE COST APPORTIONMENT,COMPUTATION OF INPATIENT OPERATING COSTS,CALCULATION OF REIMBURSEMENT SETTLEMENT,BED DAYS AVAILABLE,APPORTIONMENT OF MEDICAL AND OTHER HEALTH SERVICES,INPATIENT ANCILLARY SERVICE COST APPORTIONMENT,COST ALLOCATION,COMPUTATION OF RATIO OF COST TO CHARGES,APPORTIONMENT OF MEDICAL AND OTHER HEALTH SERVICES,COST ALLOCATION,APPORTIONMENT OF INPATIENT/OUTPATIENT ANCILLARY SERVICE OTHER PASS THROUGH COSTS,INPATIENT ANCILLARY SERVICE COST APPORTIONMENT,BALANCE SHEET,S-10 DATA,APPORTIONMENT OF MEDICAL AND OTHER HEALTH SERVICES,APPORTIONMENT OF INPATIENT/OUTPATIENT ANCILLARY SERVICE OTHER PASS THROUGH COSTS,Total Inpatient Days/Outpatient Visits,COMPUTATION OF RATIO OF COST TO CHARGES,HOSPITAL WAGE INDEX DATA,APPORTIONMENT OF MEDICAL AND OTHER HEALTH SERVICES,HOSPITAL WAGE INDEX DATA,HOSPITAL IDENTIFICATION INFORMATION,TRIAL BALANCE OF EXPENSE ACCOUNTS,APPORTIONMENT OF INPATIENT/OUTPATIENT ANCILLARY SERVICE OTHER PASS THROUGH COSTS,BALANCE SHEET,,COMPUTATION OF RATIO OF COST TO CHARGES,COST ALLOCATION,TRIAL BALANCE OF EXPENSE ACCOUNTS,COMPUTATION OF RATIO OF COST TO CHARGES,COMPUTATION OF INPATIENT OPERATING COSTS,COST ALLOCATION,APPORTIONMENT OF INPATIENT/OUTPATIENT ANCILLARY SERVICE OTHER PASS THROUGH COSTS,APPORTIONMENT OF INPATIENT ROUTINE SERVICE OTHER PASS THROUGH COSTS,,HOSPITAL WAGE INDEX DATA,INPATIENT ANCILLARY SERVICE COST APPORTIONMENT,BED DAYS AVAILABLE,COST ALLOCATION,Total Inpatient Days/Outpatient Visits,Medicaid Inpatient Days/Outpatient Visits,INPATIENT ANCILLARY SERVICE COST APPORTIONMENT,HOSPITAL WAGE INDEX DATA,COST ALLOCATION,COST ALLOCATION,INPATIENT ANCILLARY SERVICE COST APPORTIONMENT,INPATIENT ANCILLARY SERVICE COST APPORTIONMENT,TRIAL BALANCE OF EXPENSE ACCOUNTS,RENAL STATISTICAL DATA,COST ALLOCATION,HOSPITAL WAGE INDEX DATA,COST ALLOCATION,APPORTIONMENT OF MEDICAL AND OTHER HEALTH SERVICES,APPORTIONMENT OF INPATIENT/OUTPATIENT ANCILLARY SERVICE OTHER PASS THROUGH COSTS,APPORTIONMENT OF INPATIENT/OUTPATIENT ANCILLARY SERVICE OTHER PASS THROUGH COSTS,S-10 DATA,INPATIENT ANCILLARY SERVICE COST APPORTIONMENT,BED DAYS AVAILABLE,APPORTIONMENT OF INPATIENT/OUTPATIENT ANCILLARY SERVICE OTHER PASS THROUGH COSTS,APPORTIONMENT OF INPATIENT/OUTPATIENT ANCILLARY SERVICE OTHER PASS THROUGH COSTS,ADJUSTMENTS,COST ALLOCATION,,TRIAL BALANCE OF EXPENSE ACCOUNTS,HOSPITAL WAGE INDEX DATA,RECONCILIATION OF CAPITAL COST CENTERS,COST ALLOCATION,APPORTIONMENT OF MEDICAL AND OTHER HEALTH SERVICES,COMPUTATION OF RATIO OF COST TO CHARGES,COST ALLOCATION,APPORTIONMENT OF INPATIENT/OUTPATIENT ANCILLARY SERVICE OTHER PASS THROUGH COSTS,ALLOCATION OF NEW CAPITAL COSTS,STATEMENT OF REVENUES AND EXPENSES,COMPUTATION OF RATIO OF COST TO CHARGES,TRIAL BALANCE OF EXPENSE ACCOUNTS,HOSPITAL WAGE INDEX DATA,APPORTIONMENT OF MEDICAL AND OTHER HEALTH SERVICES,TRIAL BALANCE OF EXPENSE ACCOUNTS,APPORTIONMENT OF MEDICAL AND OTHER HEALTH SERVICES,COST ALLOCATION,HOSPITAL WAGE INDEX DATA,INPATIENT ANCILLARY SERVICE COST APPORTIONMENT,APPORTIONMENT OF INPATIENT/OUTPATIENT ANCILLARY SERVICE OTHER PASS THROUGH COSTS,INPATIENT ANCILLARY SERVICE COST APPORTIONMENT,CALCULATION OF REIMBURSEMENT SETTLEMENT,COST ALLOCATION,COST ALLOCATION,INPATIENT ANCILLARY SERVICE COST APPORTIONMENT,TRIAL BALANCE OF EXPENSE ACCOUNTS,BED DAYS AVAILABLE,COST ALLOCATION,HHA STATISTICAL DATA,COST ALLOCATION,APPORTIONMENT OF INPATIENT ROUTINE SERVICE OTHER PASS THROUGH COSTS,COST ALLOCATION,APPORTIONMENT OF INPATIENT/OUTPATIENT ANCILLARY SERVICE OTHER PASS THROUGH COSTS,INPATIENT ANCILLARY SERVICE COST APPORTIONMENT,COMPUTATION OF RATIO OF COST TO CHARGES,INPATIENT ANCILLARY SERVICE COST APPORTIONMENT,,S-10 DATA,ADJUSTMENTS,HOSPITAL WAGE INDEX DATA,APPORTIONMENT OF INPATIENT/OUTPATIENT ANCILLARY SERVICE OTHER PASS THROUGH COSTS,ANALYSIS OF CHANGES IN NEW CAPITAL BALANCES,APPORTIONMENT OF INPATIENT/OUTPATIENT ANCILLARY SERVICE OTHER PASS THROUGH COSTS,INPATIENT ANCILLARY SERVICE COST APPORTIONMENT,HOSPITAL WAGE INDEX DATA,TRIAL BALANCE OF EXPENSE ACCOUNTS,Total Inpatient Days/Outpatient Visits,TRIAL BALANCE OF EXPENSE ACCOUNTS,TRIAL BALANCE OF EXPENSE ACCOUNTS,APPORTIONMENT OF MEDICAL AND OTHER HEALTH SERVICES,APPORTIONMENT OF INPATIENT/OUTPATIENT ANCILLARY SERVICE OTHER PASS THROUGH COSTS,TRIAL BALANCE OF EXPENSE ACCOUNTS,APPORTIONMENT OF INPATIENT ROUTINE SERVICE OTHER PASS THROUGH COSTS,INPATIENT ANCILLARY SERVICE COST APPORTIONMENT,COMPUTATION OF INPATIENT OPERATING COSTS,BED DAYS AVAILABLE,BED DAYS AVAILABLE,APPORTIONMENT OF INPATIENT/OUTPATIENT ANCILLARY SERVICE OTHER PASS THROUGH COSTS,TRIAL BALANCE OF EXPENSE ACCOUNTS,APPORTIONMENT OF INPATIENT/OUTPATIENT ANCILLARY SERVICE OTHER PASS THROUGH COSTS,COST ALLOCATION,APPORTIONMENT OF INPATIENT/OUTPATIENT ANCILLARY SERVICE OTHER PASS THROUGH COSTS,APPORTIONMENT OF MEDICAL AND OTHER HEALTH SERVICES,RENAL STATISTICAL DATA,NUMBER OF BEDS,,TRIAL BALANCE OF EXPENSE ACCOUNTS,TRIAL BALANCE OF EXPENSE ACCOUNTS,INPATIENT ANCILLARY SERVICE COST APPORTIONMENT,HOSPITAL WAGE INDEX DATA,COMPUTATION OF RATIO OF COST TO CHARGES,INPATIENT ANCILLARY SERVICE COST APPORTIONMENT,INPATIENT ANCILLARY SERVICE COST APPORTIONMENT,,COST ALLOCATION,APPORTIONMENT OF INPATIENT/OUTPATIENT ANCILLARY SERVICE OTHER PASS THROUGH COSTS,Total Inpatient Days/Outpatient Visits,COMPUTATION OF RATIO OF COST TO CHARGES,HOSPITAL WAGE INDEX DATA,COST ALLOCATION,TRIAL BALANCE OF EXPENSE ACCOUNTS,,APPORTIONMENT OF INPATIENT/OUTPATIENT ANCILLARY SERVICE OTHER PASS THROUGH COSTS,CALCULATION OF REIMBURSEMENT SETTLEMENT,APPORTIONMENT OF MEDICAL AND OTHER HEALTH SERVICES,Total Inpatient Days/Outpatient Visits,TRIAL BALANCE OF EXPENSE ACCOUNTS,COMPUTATION OF RATIO OF COST TO CHARGES,APPORTIONMENT OF INPATIENT/OUTPATIENT ANCILLARY SERVICE OTHER PASS THROUGH COSTS,COST ALLOCATION,APPORTIONMENT OF MEDICAL AND OTHER HEALTH SERVICES,COST ALLOCATION,HOSPITAL WAGE INDEX DATA,APPORTIONMENT OF INPATIENT/OUTPATIENT ANCILLARY SERVICE OTHER PASS THROUGH COSTS,INPATIENT ANCILLARY SERVICE COST APPORTIONMENT,TRIAL BALANCE OF EXPENSE ACCOUNTS,INPATIENT ANCILLARY SERVICE COST APPORTIONMENT,COST ALLOCATION,INPATIENT ANCILLARY SERVICE COST APPORTIONMENT,ALLOCATION OF NEW CAPITAL COSTS,APPORTIONMENT OF MEDICAL AND OTHER HEALTH SERVICES,ADJUSTMENTS,APPORTIONMENT OF INPATIENT ROUTINE SERVICE CAPITAL COSTS,CALCULATION OF REIMBURSEMENT SETTLEMENT,APPORTIONMENT OF INPATIENT/OUTPATIENT ANCILLARY SERVICE OTHER PASS THROUGH COSTS,,TRIAL BALANCE OF EXPENSE ACCOUNTS,INPATIENT ANCILLARY SERVICE COST APPORTIONMENT,HOSPITAL WAGE INDEX DATA,BALANCE SHEET,INPATIENT ANCILLARY SERVICE COST APPORTIONMENT,HOSPITAL WAGE INDEX DATA,,CALCULATION OF REIMBURSEMENT SETTLEMENT,APPORTIONMENT OF INPATIENT/OUTPATIENT ANCILLARY SERVICE OTHER PASS THROUGH COSTS,COMPUTATION OF RATIO OF COST TO CHARGES,HOSPITAL IDENTIFICATION INFORMATION,COST ALLOCATION,COST ALLOCATION,RENAL STATISTICAL DATA,INPATIENT ANCILLARY SERVICE COST APPORTIONMENT,HOSPITAL WAGE INDEX DATA,HOSPITAL WAGE INDEX DATA,INPATIENT ANCILLARY SERVICE COST APPORTIONMENT,TRIAL BALANCE OF EXPENSE ACCOUNTS,HOSPITAL WAGE INDEX DATA,COMPUTATION OF RATIO OF COST TO CHARGES,COST ALLOCATION,RECONCILIATION OF CAPITAL COST CENTERS,APPORTIONMENT OF INPATIENT/OUTPATIENT ANCILLARY SERVICE OTHER PASS THROUGH COSTS,APPORTIONMENT OF INPATIENT/OUTPATIENT ANCILLARY SERVICE OTHER PASS THROUGH COSTS,HHA STATISTICAL DATA,HOSPITAL WAGE INDEX DATA,COST ALLOCATION,,APPORTIONMENT OF MEDICAL AND OTHER HEALTH SERVICES,COST ALLOCATION,RENAL STATISTICAL DATA,COST ALLOCATION,INPATIENT ANCILLARY SERVICE COST APPORTIONMENT,INPATIENT ANCILLARY SERVICE COST APPORTIONMENT,APPORTIONMENT OF INPATIENT ROUTINE SERVICE OTHER PASS THROUGH COSTS,APPORTIONMENT OF INPATIENT/OUTPATIENT ANCILLARY SERVICE OTHER PASS THROUGH COSTS,HHA STATISTICAL DATA,ANALYSIS OF CHANGES IN NEW CAPITAL BALANCES,APPORTIONMENT OF MEDICAL AND OTHER HEALTH SERVICES,S-10 DATA,INPATIENT ANCILLARY SERVICE COST APPORTIONMENT,APPORTIONMENT OF MEDICAL AND OTHER HEALTH SERVICES,Total Inpatient Days/Outpatient Visits,INPATIENT ANCILLARY SERVICE COST APPORTIONMENT,HHA STATISTICAL DATA,TRIAL BALANCE OF EXPENSE ACCOUNTS,HHA STATISTICAL DATA,ALLOCATION OF NEW CAPITAL COSTS,Report_Period_Begin_Yr,Financial Indicators,Financial Indicators,Financial Indicators,Financial Indicators,Financial Indicators,Financial Indicators,Financial Indicators,Financial Indicators,Financial Indicators,Financial Indicators,Financial Indicators,Financial Indicators,Financial Indicators,Financial Indicators,Financial Indicators,Financial Indicators,Financial Indicators,Financial Indicators,Financial Indicators,Financial Indicators,Financial Indicators,Hospital Type (From CMS Hospitals Data Archive),,HOSPITAL IDENTIFICATION INFORMATION,Name and Num
,Curated Name and Num,Hospital type (modified),Type of Control of Hospital (See Table I) (S2_1_C1_21),Lon,Lat,MDH status beginning date  (MM/DD/YY) (S2_1_C1_3801),Physicians' Private Office (B_1_C21_192),"Medicare certified kidney 
transplant center cert date (S2_1_C1_126)",Adults & Pediatrics (D_1_HOS_C6_30),Target Amount (D1_HOS_C1_56),"AVERAGE HOURLY WAGE, Management and Administrative Services (S3_2_C6_12)",Other Special Purpose (B_1_C21_117),FQHC (C_1_C7_89),"AMOUNT REPORTED, Teaching Physician Salaries (S3_2_C2_16)",ASC (Non Distinct Part) (A_C1_75),"PAID HOURS RELATED TO SALARIES, SNF (S3_2_C5_9)",Number of stations (S5_C2_6),Laboratory (D_4_HOS_C2_60),Emergency (D3_HOS_C3_91),"Number of days in year dialysis 
furnished (S5_C2_5)",Other Outpatient Services (A_C6_93),Renal Dialysis (D_4_IRF_C11_74),RHC 17 Provider Number (S2_1_C2_1516),Emergency (D_4_HOS_C1_91),Intestinal Acquisition (C_1_C7_110),"COST REIMBURSED SERVICES NOT SUBJECT TO DEDUCTIBLES AND COINSURANCE - CHARGES, Total (D_5_HOS_C4_200)",Interim payments (E_B_HOS_C1_41),Hospital County (S2_1_C4_2),Islet Acquisition (A_C1_111),Subprovider II (B_1_C26_4201),Pass through Cost for Program Inpatient (D1_IRF_C1_50),Total Allied Health (D_4_IPF_C3_200),Total discharges (S3_1_C15_14),Durable Medical Equipment Rented (C_1_C7_96),"Allocation of Interns & Residents Salary and Fringes, CT Scan (B_1_C21_57)","TOTAL CAPITAL COSTS AFTER COST ALLOCATION, Nursery (B_2_C26_43)",Whole Blood & Packed Red Blood Cells (D3_IPF_C2_62),Urban (1) or Rural (2) (S2_1_C1_27),"ADJUSTED SALARIES, Related Salaries (S3_2_C4_1402)",RHC (D_4_HOS_C3_88),Laboratory (A_C1_60),Blood Clotting Factors for Hemoph. (A_C1_6250),Title XVIII discharges (S3_1_C13_16),MRI (D3_IRF_C3_58),"If (SCH), enter the # of periods. (S2_1_C1_35)",CAPD exchanges per day (S5_C4_4),Research (A_C1_191),Clinic (C_1_C5_90),Emergency (B_1_C26_91),Medicaid (Title XIX) discharges (S3_1_C14_16),"AVERAGE HOURLY WAGE, Dietary (S3_2_C6_34)",Physicians' Private Office (B_2_C26_192),SNF (D_3_HOS_C9_44),CT Scan (D3_SNF_C3_57),Int & Res (non approved teaching program (C_1_C6_100),Impl. Dev. Charged to Patients (D3_SNF_C3_72),Nursery (B_1_C26_43),Social Service (A_C2_17),TOTAL (D3_SNF_C3_200),MRI (D3_SNF_C2_58),"ADJUSTED SALARIES, Administrative and General (S3_2_C4_27)",Burn Intensive Care Unit (C_1_C5_33),Relief Payment (D1_HOS_C1_62),Intestinal Acquisition (A_C6_110),Notes and Loans Payable (short term) (G_C1THRU4_40),"COST SERVICES SUBJECT TO DEDUCTIBLES AND COINSURANCE - COST, Electrocardiology (D_5_HOS_C6_69)","HHA III, PEP:  Total Number of Outlier Episodes (S4_HHA3_C4_37)",Payments received from patients for amounts previously written off as charity care (S10_C2_22),Cardiac Catheterization (D_4_IRF_C13_59),OLTC (S3_1_C2_21),Swing Bed SNF Provider Number (S2_1_C2_7),Electrocardiology (D3_IPF_C2_69),"Taxes, Total (A7_3_C6_3)","COST REIMBURSED SERVICES NOT SUBJECT TO DEDUCTIBLES AND COINSURANCE - CHARGES, Other Ancillary (D_5_HOS_C4_76)","COST SERVICES NOT SUBJECT TO DEDUCTIBLES AND COINSURANCE - COST, Blood Storing, Processing, Trans (D_5_HOS_C7_63)","Donations, Building Improvements (A7_1_C3_4)",OOT (C_1_C5_9930),ASC (Distinct Part) (C_1_C5_115),Laboratory (D_4_IRF_C11_60),"HHA III, Total Other Charges (S4_HHA3_C5_34)",Respiratory Therapy (D_4_IPF_C11_65),"Net Expense for Cost Allocation, Emergency (B_1_C0_91)",Operating Room (D3_SNF_C3_50),Cross Foot Adjustments (B_1_C26_200),Impl. Dev. Charged to Patients (D_4_HOS_C10_72),Drugs Charged to Patients (C_1_C7_73),"COST SERVICES NOT SUBJECT TO DEDUCTIBLES AND COINSURANCE - COST, Respiratory Therapy (D_5_HOS_C7_65)","HHA I, W/Out Outliers:  Number of Episodes (S4_HHA1_C1_36)",Fixed Equipment (G_C1THRU4_19),SNF (S3_1_C9_19),Electroencephalography (D3_SNF_C3_70),"COST REIMBURSED SERVICES NOT SUBJECT TO DEDUCTIBLES AND COINSURANCE - CHARGES, Electroencephalography (D_5_HOS_C4_70)",Total prospective payment (E_B_HOS_C1_24),"COST REIMBURSED SERVICES SUBJECT TO DEDUCTIBLES  AND COINSURANCE - CHARGES, Drugs Charged to Patients (D_5_HOS_C3_73)",Total discharges (S3_1_C15_1),"Allocation of Interns & Residents Program Costs, Occupational Therapy (B_1_C22_67)",Whole Blood & Packed Red Blood Cells (D_4_HOS_C10_62),"Blood Storing, Processing, Trans (D_4_IPF_C11_63)",ICF (C_1_C5_4501),Recovery Room (D_4_IPF_C13_51),Home Program Dialysis (D3_IPF_C2_94),Observation Beds (Distinct Unit) (D_4_IPF_C11_9201),Drugs Charged to Patients (D3_IPF_C2_73),"PAID HOURS RELATED TO SALARIES, Medical Records & Med Records Library (S3_2_C5_41)",Other Outpatient Services (C_1_C7_93),Is this hospital an All-Inclusive rate provider? (Y/N) (S2_1_C1_115),Total Charges (C_1_C8_202),Total Salaries (A_C2_200),"AVERAGE HOURLY WAGE, Total Salaries (S3_2_C6_1)",Liver Acquisition (B_1_C21_107),Home Program Dialysis (D3_SNF_C3_94),Fiscal Intermediary/MAC Create Date (FI_CREAT_DT),"Net Expense for Cost Allocation, Medical Records and Medical Rec. Library (B_1_C0_16)",PBP Clinical Lab Services Program Only (D3_HOS_C2_61),"AMOUNT REPORTED, Interns & Residents (S3_2_C3_2550)",Intensive Care Unit (S3_1_C8_8),Respiratory Therapy (C_1_C2_65),"Lease, New Cap Related Csts Bldg & Fixtures (A7_3_C10_1)",Observation Beds (Distinct Unit) (D_4_SNF_C11_9201),Observation Beds (Distinct Unit) (C_1_C7_9201),Bonus Payment (D1_HOS_C1_58),Clinic (D3_IRF_C3_90),Surgical Intensive Care Unit (S3_1_C8_11),Occupational Therapy (D_4_HOS_C13_67),Intravenous Therapy (D_4_IRF_C13_64),CT Scan (A_C2_57),"Disposals and Retirements, Fixed Equipment (A7_1_C5_5)","Disposals and Retirements, Building Improvements (A7_1_C7_4)",Number of Times per week Patient receives Dialysis (S5_C1_2),"PPS REIMBURSED SERVICES -  CHARGES, Cardiac Catheterization (D_5_HOS_C2_59)","COST REIMBURSED SERVICES SUBJECT TO DEDUCTIBLES  AND COINSURANCE - CHARGES, Clinic (D_5_HOS_C3_90)","COST REIMBURSED SERVICES NOT SUBJECT TO DEDUCTIBLES AND COINSURANCE - CHARGES, Cardiac Catheterization (D_5_HOS_C4_59)",Ambulance Services (A_C2_95),Physical Therapy (D3_HOS_C2_66),Intensive Care Unit (D_1_HOS_C7_31),"Allocation of Interns & Residents Program Costs, Blood Storing, Processing, Trans (B_1_C22_63)",IPPS Payment amount (unadjusted) (E_A_HOS_C1_59),ASC 1 Provider Number (S2_1_C2_13),Investment Income-New Movable Equip (A8_C2_2),PBP Clinical Lab Services Program Only (D3_IRF_C2_61),"COST SERVICES SUBJECT TO DEDUCTIBLES AND COINSURANCE - COST, Blood Clotting Factors for Hemoph. (D_5_HOS_C6_6250)",Total (S3_1_C2_7),"PPS REIMBURSED SERVICES -  CHARGES, Medical Supplies Charged to Patients (D_5_HOS_C2_71)",Respiratory Therapy (B_2_C26_65),"COST SERVICES NOT SUBJECT TO DEDUCTIBLES AND COINSURANCE - COST, Impl. Dev. Charged to Patients (D_5_HOS_C7_72)",Blood Clotting Factors for Hemoph. (D3_HOS_C3_6250),Radioisotope (D_4_HOS_C13_56),"AVERAGE HOURLY WAGE, Admin & Gen Under Contract (S3_2_C6_29)",Clinic (D_4_HOS_C13_90),Occupational Therapy (A_C1_67),Surgical Intensive Care Unit (D3_IPF_C2_34),Anesthesiology (D_4_SNF_C11_53),Operating Room (D_4_HOS_C10_50),Recovery Room (D_4_HOS_C10_51),ICF (A_C1_4501),Burn Intensive Care Unit (D_1_HOS_C6_33),ICF (A_C2_4501),Recovery Room (D_4_HOS_C3_51),"Net Expense for Cost Allocation, Research (B_1_C0_191)","HHA III, PEP Episodes:  Total Number of Episodes (S4_HHA3_C4_36)",Delivery Room and Labor Room (D_4_HOS_C4_52),Coronary Care Unit (S3_1_C8_9),OPT (C_1_C5_9920),RHC 21 Provider Number (S2_1_C2_1520),"Gift, Flower, Coffee Shop, Canteen (B_1_C22_190)","Net Expense for Cost Allocation, Speech Pathology (B_1_C0_68)","Net Expense for Cost Allocation, CT Scan (B_1_C0_57)",CT Scan (A_C6_57),"HHA II, Total Other Charges (S4_HHA2_C5_34)",Total (D_1_HOS_C6_200),Speech Pathology (D_4_IRF_C11_68),"ADJUSTED SALARIES, Teaching Physician Salaries (S3_2_C4_16)",OOT (B_1_C26_9930),MDH status ending date (MM/DD/YY) (S2_1_C2_38),Other Organ Acquisition (C_1_C5_112),FQHC (D_4_HOS_C3_89),Total Current Liabilities (G_C1THRU4_45),"COST REIMBURSED SERVICES SUBJECT TO DEDUCTIBLES  AND COINSURANCE - CHARGES, Anesthesiology (D_5_HOS_C3_53)",Transitional corridor payment (E_B_HOS_C101_8),Maintenance of Personnel (A_C6_12),"Allocation of Interns & Residents Salary and Fringes, Subprovider I (B_1_C21_42)",Medicaid (Title XIX) discharges (S3_1_C14_18),FQHC (B_2_C26_89),Total Allied Health (D_4_HOS_C3_200),Home Program Dialysis (A_C2_94),CT Scan (D_4_HOS_C2_57),Medicaid HMO Days (S2_1_C5_24),Electrocardiology (D_4_IPF_C11_69),Surgical Intensive Care Unit (A_C1_34),Subprovider 1 (S3_1_C7_18),Observation Beds (Distinct Unit) (D3_IPF_C3_9201),Recovery Room (D_4_HOS_C12_51),"ADJUSTED SALARIES, Physician Part A (S3_2_C4_22)",Observation Beds (Distinct Unit) (A_C6_9201),"Net Expense for Cost Allocation, Employee Benefits (B_1_C0_4)","Blood Storing, Processing, Trans (D3_HOS_C3_63)",Speech Pathology (D_4_HOS_C12_68),Other Reimbursable (D3_IPF_C3_98),Research (B_2_C26_191),IRF (S3_1_C8_17),FQHC (A_C6_89),Other Special Care Unit (D3_IPF_C2_35),Subprovider-IRF (C_1_C5_41),RHC (C_1_C5_88),Clinic (D_4_HOS_C12_90),Excess of reasonable cost over reasonable charges (E_B_HOS_C1_20),Laboratory (A_C2_60),Other Ancillary (C_1_C7_76),Observation Beds (Distinct Unit) (B_1_C26_9201),Radioisotope (D_4_HOS_C4_56),MRI (D_4_IRF_C13_58),"COST REIMBURSED SERVICES NOT SUBJECT TO DEDUCTIBLES AND COINSURANCE - CHARGES, Radiology-Therapeutic (D_5_HOS_C4_55)",NF (S3_1_C5_20),Cardiac Catheterization (D_4_SNF_C11_59),Durable Medical Equipment Sold (A_C6_97),"COST REIMBURSED SERVICES NOT SUBJECT TO DEDUCTIBLES AND COINSURANCE - CHARGES, Impl. Dev. Charged to Patients (D_5_HOS_C4_72)","COST SERVICES NOT SUBJECT TO DEDUCTIBLES AND COINSURANCE - COST, Other Reimbursable (D_5_HOS_C7_98)",Occupational Therapy (B_1_C26_67),"AVERAGE HOURLY WAGE, Home Office Salaries & Wage Related Csts (S3_2_C6_14)",Heart Acquisition (C_1_C7_106),Emergency (A_C6_91),Renal Dialysis (B_1_C21_74),"PPS REIMBURSED SERVICES -  CHARGES, Impl. Dev. Charged to Patients (D_5_HOS_C2_72)","Difference between Adjusted Inpatient, Operating Cost and Target Amount (D1_HOS_C1_57)",Burn Intensive Care Unit (D3_HOS_C2_33),"COST REIMBURSED SERVICES NOT SUBJECT TO DEDUCTIBLES AND COINSURANCE - CHARGES, Blood Clotting Factors for Hemoph. (D_5_HOS_C4_6250)","PPS SERVICES COST, Renal Dialysis (D_5_HOS_C5_74)",Hospital Adults & Pediatrics (S3_1_C4_1),Clinic (D3_IPF_C2_90),Renal Dialysis (D3_IPF_C2_74),Labor and Delivery Days -  Title XIX (S3_1_C7_32),Radiology-Diagnostic (D3_IRF_C2_54),Investment Income-Other (A8_C2_3),"Net Expense for Cost Allocation, Observation Beds (Distinct Unit) (B_1_C0_9201)",Burn Intensive Care Unit (A_C1_33),CT Scan (D_4_IRF_C11_57),"Net Expense for Cost Allocation, Coronary Care Unit (B_1_C0_32)","Allocation of Interns & Residents Salary and Fringes, MRI (B_1_C21_58)",Other Outpatient Services (D_4_IRF_C11_93),CMHC (A_C1_99),"COST REIMBURSED SERVICES NOT SUBJECT TO DEDUCTIBLES AND COINSURANCE - CHARGES, Radiology-Diagnostic (D_5_HOS_C4_54)","ADJUSTED SALARIES, Physician Part B (S3_2_C4_23)",Lung  Acquisition (A_C1_108),"COST REIMBURSED SERVICES SUBJECT TO DEDUCTIBLES  AND COINSURANCE - CHARGES, Operating Room (D_5_HOS_C3_50)",TOTAL (D3_IRF_C3_200),"PPS REIMBURSED SERVICES -  CHARGES, ASC (Non Distinct Part) (D_5_HOS_C2_75)","PPS SERVICES COST, Impl. Dev. Charged to Patients (D_5_HOS_C5_72)","Allocation of Interns & Residents Program Costs, Nursery (B_1_C22_43)",Electrocardiology (D_4_SNF_C11_69),Total discharges (S3_1_C15_17),"COST SERVICES SUBJECT TO DEDUCTIBLES AND COINSURANCE - COST, Radioisotope (D_5_HOS_C6_56)","COST SERVICES SUBJECT TO DEDUCTIBLES AND COINSURANCE - COST, Impl. Dev. Charged to Patients (D_5_HOS_C6_72)","Does the facility qualify and is it receiving payments for 
disproportionate share? (Y/N) (S2_1_C1_22)",Surgical Intensive Care Unit (S3_1_C3_11),OPT (A_C1_9920),Other Ancillary (D_4_HOS_C13_76),Other Outpatient Services (B_2_C26_93),OLTC (B_1_C26_46),Electrocardiology (D3_IRF_C3_69),Coronary Care Unit (S3_1_C3_9),Anesthesiology (D3_HOS_C3_53),"PAID HOURS RELATED TO SALARIES, Physician-Part A (S3_2_C5_4)",Operating Room (D_4_HOS_C3_50),Recovery Room (D3_IRF_C2_51),"AMOUNT REPORTED, Excluded Areas (S3_2_C2_19)",NF (S3_1_C10_20),Rental of Provider space by suppliers (A8_C2_6),"ADJUSTED SALARIES, Wage Related Costs Core (S3_2_C4_17)","COST SERVICES NOT SUBJECT TO DEDUCTIBLES AND COINSURANCE - COST, Durable Medical Equipment Rented (D_5_HOS_C7_96)",Subprovider I (D3_HOS_C2_42),"AMOUNT REPORTED, Interns & Residents (S3_2_C2_2551)",IPF (S3_1_C2_16),ASC (Non Distinct Part) (D_4_IRF_C13_75),Home Program Dialysis (D_4_HOS_C3_94),"COST SERVICES SUBJECT TO DEDUCTIBLES AND COINSURANCE - COST, Renal Dialysis (D_5_HOS_C6_74)",Other Outpatient Services (D_4_HOS_C4_93),Urban/Rural Indicator at beginning (S2_1_C1_26),"Purchases, Movable Equipment (A7_1_C2_6)","Blood Storing, Processing, Trans (D_4_HOS_C2_63)",Physical Therapy (B_2_C26_66),ASC (Non Distinct Part) (B_1_C21_75),RHC 7 Provider Number (S2_1_C2_1506),Delivery Room and Labor Room (D_4_IRF_C11_52),"ADJUSTED SALARIES, Home Office:  Physician Part A (S3_2_C4_15)","Blood Storing, Processing, Trans (B_1_C26_63)",Coronary Care Unit Program Cost (D1_HOS_C5_44),"HHA III, With Outliers:  Non Routine Med Sup Chgs (S4_HHA3_C2_38)",Emergency (D3_IRF_C3_91),Total Program Excludable Costs (D1_IPF_C1_52),Burn Intensive Care Unit (S3_1_C2_10),CT Scan (D3_HOS_C3_57),"ADJUSTED SALARIES, Wage Related Costs RHC/FQHC (S3_2_C4_24)","PPS SERVICES COST, Other Outpatient Services (D_5_HOS_C5_93)",Whole Blood & Packed Red Blood Cells (C_1_C5_62),Cardiac Catheterization (D_4_IPF_C11_59),Radioisotope (D_4_HOS_C12_56),Home Program Dialysis (D3_IRF_C3_94),Total Program Excludable Costs (D1_HOS_C1_52),"COST REIMBURSED SERVICES NOT SUBJECT TO DEDUCTIBLES AND COINSURANCE - CHARGES, ASC (Non Distinct Part) (D_5_HOS_C4_75)","COST SERVICES SUBJECT TO DEDUCTIBLES AND COINSURANCE - COST, Ambulance Services (D_5_HOS_C6_95)","ADJUSTED SALARIES, Non-Physician Anesthetist Part A (S3_2_C4_20)","Blood Storing, Processing, Trans (A_C2_63)","PPS SERVICES COST, Radioisotope (D_5_HOS_C5_56)","Depreciation, New Cap Related Csts Movable Equipment (A7_3_C9_2)","PPS REIMBURSED SERVICES -  CHARGES, Recovery Room (D_5_HOS_C2_51)","COST SERVICES SUBJECT TO DEDUCTIBLES AND COINSURANCE - COST, Home Program Dialysis (D_5_HOS_C6_94)","Blood Storing, Processing, Trans (D3_SNF_C3_63)",Nursery (A_C6_43),Hospice (S3_1_C3_24),Nursery (S3_1_C5_13),"Total Outpatient Charges, PBP Clinical Lab Services Program Only (C_1_C7_61)",Electrocardiology (D_4_HOS_C11_69),Electrocardiology (D3_IRF_C2_69),Home Program Dialysis (C_1_C5_94),HHA (S3_1_C9_22),Drugs Charged to Patients (D_4_SNF_C13_73),Operating Room (D3_IRF_C2_50),Subprovider-IPF (D3_IPF_C2_40),"Total Inpatient Charges, ICF (C_1_C6_4501)","PPS SERVICES COST, Whole Blood & Packed Red Blood Cells (D_5_HOS_C5_62)",Other Special Purpose (B_1_C26_117),Renal 8 Provider Number (S2_1_C2_1807),Heart Acquisition (B_1_C22_106),Clinic (D_4_IPF_C11_90),Electroencephalography (D3_IPF_C2_70),Electroencephalography (C_1_C6_70),"Beginning Balances, Land Improvements (A7_1_C1_2)",Anesthesiology (D3_SNF_C2_53),IPF (S3_1_C6_16),"Sum of lines 3,4 divided by line 6 (E_B_HOS_C101_7)",Utilization Review SNF (A_C6_114),"HHA I, Without Outliers:  Total Charges (S4_HHA1_C1_35)",Renal Dialysis (D_4_SNF_C11_74),Respiratory Therapy (D3_SNF_C3_65),"Net Expense for Cost Allocation, Clinic (B_1_C0_90)",Ancillary service charges (E_B_HOS_C1_12),Radioisotope (D_4_IPF_C13_56),"ADJUSTED SALARIES, Non-Physician Anesthetist Part A (S3_2_C4_2)",OLTC (A_C1_46),Total Program Inpatient Costs (D1_IPF_C1_49),Occupational Therapy (D3_IPF_C3_67),Research (A_C2_191),"COST SERVICES NOT SUBJECT TO DEDUCTIBLES AND COINSURANCE - COST, Occupational Therapy (D_5_HOS_C7_67)",Other Special Care Unit (A_C6_35),Recovery Room (D_4_HOS_C4_51),"Medical certified lung
transplant center cert date (S2_1_C1_129)","Net Expense for Cost Allocation, Cafeteria (B_1_C0_11)",RHC/FQHC Combined (S3_1_C7_26),RHC (B_1_C26_88),Radioisotope (D_4_SNF_C11_56),Radiology-Diagnostic (D_4_HOS_C4_54),Medical Supplies Charged to Patients (D3_IRF_C2_71),Burn Intensive Care Unit Program Cost (D1_HOS_C5_45),"PPS REIMBURSED SERVICES -  CHARGES, Other Outpatient Services (D_5_HOS_C2_93)",Renal Dialysis (B_2_C26_74),Utilization Review SNF (A_C2_114),Occupational Therapy (D_4_IRF_C11_67),"Net Expense for Cost Allocation, Subprovider-IRF (B_1_C0_41)",Electrocardiology (D_4_HOS_C2_69),"COST SERVICES NOT SUBJECT TO DEDUCTIBLES AND COINSURANCE - COST, Total (D_5_HOS_C7_200)","AMOUNT REPORTED, Home Office Salaries (S3_2_C3_1401)","AVERAGE HOURLY WAGE, Subtotal Other Wages and Related Csts (S3_3_C6_4)","Total Program Inpatient Operating Cost excluding Capital Related, Nonphysician, Anesthetist, and Medical Education Costs (D1_IRF_C1_53)",Other Reimbursable (D3_IRF_C3_98),Operating Room (D_4_IPF_C11_50),"Total Inpatient Charges, MRI (C_1_C6_58)","AVERAGE HOURLY WAGE, Total Overhead Costs (S3_3_C6_7)",Clinic (D3_HOS_C3_90),"AVERAGE HOURLY WAGE, Subtotal Salaries (S3_3_C6_3)",Whole Blood & Packed Red Blood Cells (D3_SNF_C3_62),Heart Acquisition (A_C2_106),Delivery Room and Labor Room (D3_HOS_C2_52),Emergency (B_2_C26_91),"Allocation of Interns & Residents Program Costs, Other Special Care Unit (B_1_C22_35)",ASC (Non Distinct Part) (D_4_IRF_C11_75),Clinic (D_4_IRF_C11_90),HHA (C_1_C5_101),Stand-alone CHIP cost (S10_C1_11),Home Office Street (S2_1_C1_142),Other Reimbursable (D3_IRF_C2_98),Pancreas Acquisition (C_1_C5_109),FQHC 5 Provider Number (S2_1_C2_1604),"PAID HOURS RELATED TO SALARIES, Physician-Part B (S3_2_C5_5)","AMOUNT REPORTED, Non-Physician Anesthetist Part B (S3_2_C2_3)",Coronary Care Unit (D_3_HOS_C9_32),ASC (Distinct Part) (A_C6_115),"AMOUNT REPORTED, Net Salaries (S3_3_C2_1)",Medical Supplies Charged to Patients (A_C6_71),"Allocation of Interns & Residents Program Costs, Subprovider I (B_1_C22_42)",Physical Therapy (D_4_HOS_C3_66),Medicaid Observation Days (S3_1_C8_28),Other Ancillary (B_2_C26_76),Other Outpatient Services (D3_HOS_C3_93),Intensive Care Unit (S3_1_C6_8),"ADJUSTED SALARIES, Non-Physician Anesthetist Part B (S3_2_C4_21)","Net Expense for Cost Allocation, Interns & Res Other Program Costs (B_1_C0_22)",Blood Clotting Factors for Hemoph. (D3_IPF_C2_6250),Total Salaries (A_C1_200),"ADJUSTED SALARIES, Interns & Residents (S3_2_C4_2550)",Liver Acquisition (A_C2_107),"AMOUNT REPORTED, Home Office Personnel (S3_2_C2_8)",Electrocardiology (A_C2_69),Subprovider-IPF (D3_HOS_C2_40),Number of stations (S5_C4_6),"AMOUNT REPORTED, Laundry and Linen Service (S3_2_C2_31)","AMOUNT REPORTED, Housekeeping (S3_2_C2_32)",Subprovider-IRF (A_C1_41),Other Outpatient Services (D_4_HOS_C3_93),ASC (Non Distinct Part) (D3_IRF_C3_75),Respiratory Therapy (A_C2_65),OSP (C_1_C6_9940),Medical Records and Medical Rec. Library (A_C6_16),Surgical Intensive Care Unit (D3_IRF_C2_34),Durable Medical Equipment Rented (D_4_HOS_C12_96),Other Nonreimbursable (A_C6_194),Total (D_4_IPF_C13_200),Speech Pathology (C_1_C2_68),Radiology-Therapeutic (B_1_C26_55),Intensive Care Unit (S3_1_C5_8),Adults and Pediatrics (A_C1_30),Lung  Acquisition (C_1_C7_108),Total Nursing School (D_4_IRF_C2_200),Other Reimbursable (D_4_HOS_C3_98),Other Ancillary (D_4_HOS_C11_76),"PPS REIMBURSED SERVICES -  CHARGES, Blood Storing, Processing, Trans (D_5_HOS_C2_63)",Leasehold Improvements (G_C1THRU4_17),Emergency (D_4_HOS_C13_91),"Allocation of Interns & Residents Salary and Fringes, Radioisotope (B_1_C21_56)",Surgical Intensive Care Unit (D_3_HOS_C9_34),"PAID HOURS RELATED TO SALARIES, Subtotal Salaries (S3_3_C5_3)",Other Organ Acquisition (C_1_C6_112),"AMOUNT REPORTED, Central Services and Supply (S3_2_C2_39)","COST SERVICES NOT SUBJECT TO DEDUCTIBLES AND COINSURANCE - COST, Other Outpatient Services (D_5_HOS_C7_93)",Blood Clotting Factors for Hemoph. (D3_HOS_C2_6250),"AMOUNT REPORTED, Interns & Residents (S3_2_C3_25)",Nursery (C_1_C5_43),"General Inpatient Routine Service Cost, net of Swing Bed and Private Room Diff (D1_HOS_C1_37)","Net Expense for Cost Allocation, Laundry and Linen Service (B_1_C0_8)","COST SERVICES NOT SUBJECT TO DEDUCTIBLES AND COINSURANCE - COST, CT Scan (D_5_HOS_C7_57)",Cardiac Catheterization (D_4_HOS_C13_59),Hospice (B_1_C22_116),Other Ancillary (B_1_C22_76),"AMOUNT REPORTED, Physician Part A Teaching (S3_2_C3_2201)",Cardiac Catheterization (D_4_HOS_C4_59),Medicare Certified Pancreas TC term date (S2_1_C2_130),CORF (C_1_C5_9910),Respiratory Therapy (C_1_C5_65),Subprovider-IRF (D_1_HOS_C7_41),"COST SERVICES SUBJECT TO DEDUCTIBLES AND COINSURANCE - COST, Other Ancillary (D_5_HOS_C6_76)",Intensive Care Unit (D3_HOS_C2_31),Surgical Intensive Care Unit (A_C6_34),Delivery Room and Labor Room (D3_IPF_C2_52),Speech Pathology (C_1_C7_68),"TOTAL CAPITAL COSTS AFTER COST ALLOCATION, Burn Intensive Care Unit (B_2_C26_33)","Allocation of Interns & Residents Salary and Fringes, Laboratory (B_1_C21_60)","ADJUSTED SALARIES, Interns & Residents (S3_2_C4_7)",Radiology-Therapeutic (D_4_IRF_C11_55),"TOTAL CAPITAL COSTS AFTER COST ALLOCATION, Intensive Care Unit (B_2_C26_31)",Radiology-Diagnostic (C_1_C5_54),Electroencephalography (D_4_IPF_C11_70),Total Fund Balances (G_C1THRU4_53),Impl. Dev. Charged to Patients (B_2_C26_72),"Number of Times per week
 Patient receives Dialysis (S5_C2_2)",Maintenance and Repairs (A_C1_6),"PPS SERVICES COST, Emergency (D_5_HOS_C5_91)","AVERAGE HOURLY WAGE, Home Office:  Physician Part A (S3_2_C6_15)",Nonpaid Workers (B_2_C26_193),Speech Pathology (D3_HOS_C3_68),Durable Medical Equipment Rented (D3_IPF_C2_96),Organ Procurement (D4_LIVER_C1_69),Adj for Physical therapy costs in excess (A8_C2_24),"COST SERVICES SUBJECT TO DEDUCTIBLES AND COINSURANCE - COST, Other Outpatient Services (D_5_HOS_C6_93)",Laboratory (D3_IRF_C3_60),Speech Pathology (B_2_C26_68),CORF (C_1_C7_9910),Radioisotope (D_4_IRF_C11_56),MRI (D_4_SNF_C11_58),"Trade, Quantity, and Time Discounts (A8_C2_4)","Blood Storing, Processing, Trans (D_4_HOS_C11_63)","Sum of lines 3,4 divided by line 6 (E_B_HOS_C1_7)",Physical Therapy (C_1_C7_66),"COST REIMBURSED SERVICES SUBJECT TO DEDUCTIBLES  AND COINSURANCE - CHARGES, Electroencephalography (D_5_HOS_C3_70)","AMOUNT REPORTED, Administrative & General under contract (S3_2_C2_28)",Electrocardiology (A_C6_69),"PAID HOURS RELATED TO SALARIES, Nursing Administration (S3_2_C5_38)","Total Inpatient Charges, Nursery (C_1_C6_43)",Radioisotope (D3_IPF_C2_56),Electrocardiology (D3_IPF_C3_69),Other Outpatient Services (D_4_HOS_C2_93),Other Special Purpose (B_1_C22_117),Home Program Dialysis (D_4_HOS_C2_94),Respiratory Therapy (D3_HOS_C2_65),Observation Beds (Distinct Unit) (B_1_C22_9201),"Total Inpatient Charges, Recovery Room (C_1_C6_51)",Total (D_3_HOS_C9_200),Other Special Purpose (A_C6_117),FQHC 8 Provider Number (S2_1_C2_1607),"COST REIMBURSED SERVICES SUBJECT TO DEDUCTIBLES  AND COINSURANCE - CHARGES, Other Outpatient Services (D_5_HOS_C3_93)","AMOUNT REPORTED, Physician Part B (S3_2_C3_23)",Respiratory Therapy (D_4_HOS_C4_65),"ADJUSTED SALARIES, Home Office Salaries (S3_2_C4_1401)",FQHC 12 Provider Number (S2_1_C2_1611),"AMOUNT REPORTED, Maintenance and Repairs (S3_2_C2_29)",Home Office PO Box (S2_1_C2_142),ASC (Non Distinct Part) (D_4_HOS_C4_75),"ADJUSTED SALARIES, Interns & Residents (S3_2_C4_2552)",Number of EPO units furnished for Line 13 (S5_C1_15),"COST REIMBURSED SERVICES SUBJECT TO DEDUCTIBLES  AND COINSURANCE - CHARGES, Recovery Room (D_5_HOS_C3_51)","Net Expense for Cost Allocation, Operating Room (B_1_C0_50)",Speech Pathology (D_4_HOS_C10_68),"Net Expense for Cost Allocation, Electroencephalography (B_1_C0_70)","General Inpatient Routine Service Cost, net of Swing Bed and Private Room Diff (D1_IPF_C1_37)",CORF (B_2_C26_9910),Number of periods hospital was in MDH status (S2_1_C1_37),Delivery Room and Labor Room (D3_IRF_C3_52),Impl. Dev. Charged to Patients (D_4_HOS_C11_72),IRF Provider Number (S2_1_C1_5),Delivery Room and Labor Room (D_4_HOS_C10_52),"PPS REIMBURSED SERVICES -  CHARGES, Other Reimbursable (D_5_HOS_C2_98)","PPS REIMBURSED SERVICES -  CHARGES, Radiology-Diagnostic (D_5_HOS_C2_54)",Dietary (A_C2_10),ASC (Non Distinct Part) (C_1_C6_75),RPCH/CAH Visits (S3_1_C7_15),Housekeeping (A_C1_9),Respiratory Therapy (D_4_IRF_C13_65),"PAID HOURS RELATED TO SALARIES, Contract Labor (S3_2_C5_11)","COST SERVICES SUBJECT TO DEDUCTIBLES AND COINSURANCE - COST, PBP Clinical Lab Services Program Only (D_5_HOS_C6_61)",Electrocardiology (D_4_HOS_C4_69),"AMOUNT REPORTED, Wage Related Costs RHC/FQHC (S3_2_C2_24)",Renal 9 Provider Number (S2_1_C2_1808),Intravenous Therapy (D_4_HOS_C13_64),NF (C_1_C5_45),"TOTAL CAPITAL COSTS AFTER COST ALLOCATION, Radioisotope (B_2_C26_56)",Administrative and General (A_C6_5),"COST SERVICES SUBJECT TO DEDUCTIBLES AND COINSURANCE - COST, Cardiac Catheterization (D_5_HOS_C6_59)","AVERAGE HOURLY WAGE, Employee Benefits (S3_2_C6_26)","Sale of scrap, waste, etc. (A8_C2_11)",Total Outpatient Program Pass Thru Cost (D_4_HOS_C6_200),"Other Capital Related Costs, Total (A7_3_C7_3)",RHC (C_1_C6_88),"Net Expense for Cost Allocation, Dietary (B_1_C0_10)",Hospice 2 Provider Number (S2_1_C2_1401),Pharmacy (A_C1_15),Intestinal Acquisition (C_1_C5_110),"Net Expense for Cost Allocation, Gift, Flower, Coffee Shop, Canteen (B_1_C0_190)",HRR adjustment amount (E_A_HOS_C1_7094),Radioisotope (D_4_HOS_C3_56),"HHA III, PEP Episodes:  Total Charges: (S4_HHA3_C4_35)",Paramedical Education (A_C1_23),Hospital Adlts & Ped Swing Bed SNF (S3_1_C7_5),Hospice (S3_1_C11_24),"COST SERVICES NOT SUBJECT TO DEDUCTIBLES AND COINSURANCE - COST, Radiology-Diagnostic (D_5_HOS_C7_54)",Organ Procurement (D4_HEART_C1_69),Nonpaid Workers (A_C1_193),Maintenance of Personnel (A_C2_12),Total Swing Bed Cost (D1_HOS_C1_26),Surgical Intensive Care Unit Program Cost (D1_HOS_C5_46),"Total Inpatient Charges, Radioisotope (C_1_C6_56)",PBP Clinical Lab Services Program Only (D3_IRF_C3_61),Radiology-Diagnostic (D_4_IPF_C11_54),"AVERAGE HOURLY WAGE, Non-Physician Part B (S3_2_C6_6)","Allocation of Interns & Residents Program Costs, Cardiac Catheterization (B_1_C22_59)",Durable Medical Equipment Rented (D3_SNF_C3_96),Physicians' Assistant (A8_C2_29),FQHC 1 Provider Number (S2_1_C2_16),Speech Pathology (D_4_HOS_C4_68),ASC (Non Distinct Part) (A_C2_75),Pancreas Acquisition (C_1_C6_109),"Beginning Balances, Subtotal (A7_1_C1_8)",Subprovider II (A_C2_4201),CT Scan (A_C1_57),Physical Therapy (B_1_C26_66),Other Ancillary (D3_HOS_C2_76),"Insurance, Total (A7_3_C5_3)",Total Hospital (S3_1_C6_14),"Total Outpatient Charges, Anesthesiology (C_1_C7_53)",Recovery Room (D3_IPF_C3_51),"Net Expense for Cost Allocation, Int & Res (non approved teaching program (B_1_C0_100)",Durable Medical Equipment Rented (A_C6_96),Allowable Inpatient Cost Plus Incentive Pt (D1_HOS_C1_63),"Allocation of Interns & Residents Program Costs, Medical Supplies Charged to Patients (B_1_C22_71)","ADJUSTED SALARIES, Total Overhead Costs (S3_3_C4_7)","Net Expense for Cost Allocation, CORF (B_1_C0_9910)",ICF (B_1_C26_4501),Anesthesiology (D_4_HOS_C10_53),Other Reimbursable (D_4_IRF_C11_98),Blood Clotting Factors for Hemoph. (D_4_HOS_C12_6250),Radiology-Diagnostic (D_4_HOS_C10_54),HHA 2 Provider Number (S2_1_C2_1201),CT Scan (D3_IPF_C3_57),Total Subprovider I Interns & Residents (S3_1_C9_18),Nonpaid Workers (B_1_C21_193),Cafeteria (A_C6_11),"Net Expense for Cost Allocation, Radiology-Diagnostic (B_1_C0_54)","ADJUSTED SALARIES, Teaching Physician Salaries (S3_2_C4_1602)","AMOUNT REPORTED, Interns & Residents (S3_2_C3_2553)",Hospital Adlts & Ped Swing Bed SNF (S3_1_C8_5),Hospital Adults & Ped Swing Bed SNF (S3_1_C6_5),FQHC 10 Provider Number (S2_1_C2_1609),Total (D_4_HOS_C12_200),Radiology-Therapeutic (D3_IRF_C2_55),"Allocation of Interns & Residents Program Costs, CT Scan (B_1_C22_57)",Recovery Room (D_4_IRF_C11_51),"AMOUNT REPORTED, Interns & Residents (S3_2_C3_2552)","PAID HOURS RELATED TO SALARIES, Pharmacy (S3_2_C5_40)",Laboratory (D_4_HOS_C12_60),"Blood Storing, Processing, Trans (D3_SNF_C2_63)",Intravenous Therapy (D3_SNF_C2_64),Payment to cost ratio (E_B_HOS_C1_5),Hospice 1 Provider Number (S2_1_C2_14),Speech Pathology (D3_SNF_C2_68),"ADJUSTED SALARIES, Wage Related Costs Other (S3_2_C4_18)",NOT IN THIS FILE (TRNSMTL_NUM),CT Scan (D_4_HOS_C4_57),Cost of charity care (patients covered by public program + patients w/ coverage accepted by provider) (S10_C2_23),ASC (Non Distinct Part) (C_1_C7_75),Whole Blood & Packed Red Blood Cells (B_1_C26_62),Surgical Intensive Care Unit (D3_SNF_C2_34),"PPS SERVICES COST, Durable Medical Equipment Rented (D_5_HOS_C5_96)",Total (D_4_SNF_C13_200),Other Ancillary (D3_IRF_C3_76),"Number of days in year dialysis 
furnished (S5_C5_2)",Clinic (D_4_HOS_C2_90),"COST REIMBURSED SERVICES NOT SUBJECT TO DEDUCTIBLES AND COINSURANCE - CHARGES, Other Outpatient Services (D_5_HOS_C4_93)",Radiology-Diagnostic (A_C2_54),Home Program Dialysis (D3_HOS_C2_94),"PAID HOURS RELATED TO SALARIES, Non-Physician Anesthetist Part A (S3_2_C5_2)",CMHC (B_1_C26_99),Other Ancillary (A_C2_76),"Fully Depreciated Assets, Donations (A7_1_C3_7)",Physical Therapy (D_4_HOS_C11_66),Medical Supplies Charged to Patients (D_4_SNF_C11_71),Total Outpatient Program Pass Thru Cost (D_4_IPF_C6_200),"TOTAL CAPITAL COSTS AFTER COST ALLOCATION, Total Directly Assigned New Cap Rel Csts (B_2_C0_202)","Blood Storing, Processing, Trans (D3_IPF_C2_63)",Other Ancillary (B_1_C21_76),Radiology-Therapeutic (A_C1_55),Temporary Investments (G_C1THRU4_2),Operation of Plant (A_C2_7),Renal Dialysis (A_C1_74),"Disposals and Retirements, Total (A7_1_C5_10)",Radiology-Diagnostic (A_C6_54),"Blood Storing, Processing, Trans (D3_IRF_C3_63)","HHA III, Without Outliers:  Other Charges (S4_HHA3_C1_34)","Allocation of Interns & Residents Program Costs, SNF (B_1_C22_44)",Coronary Care Unit (S3_1_C6_9),Hospice (S3_1_C9_24),"COST REIMBURSED SERVICES NOT SUBJECT TO DEDUCTIBLES AND COINSURANCE - CHARGES, Laboratory (D_5_HOS_C4_60)","Net Expense for Cost Allocation, Heart Acquisition (B_1_C0_106)","ADJUSTED SALARIES, Excluded Area Salaries (S3_3_C4_2)","HHA III, LUPA:  Total Non Routine Med Sup Chgs (S4_HHA3_C3_38)",Respiratory Therapy (D_4_HOS_C10_65),Clinic (D_4_SNF_C11_90),"HHA III, Total Charges (S4_HHA3_C5_35)","COST REIMBURSED SERVICES SUBJECT TO DEDUCTIBLES  AND COINSURANCE - CHARGES, Respiratory Therapy (D_5_HOS_C3_65)","COST SERVICES NOT SUBJECT TO DEDUCTIBLES AND COINSURANCE - COST, Anesthesiology (D_5_HOS_C7_53)","Allocation of Interns & Residents Salary and Fringes, Whole Blood & Packed Red Blood Cells (B_1_C21_62)",Clinic (B_1_C21_90),"AMOUNT REPORTED, Physician Part A (S3_2_C2_2201)",RHC 9 Provider Number (S2_1_C2_1508),"Disposals and Retirements, Subtotal (A7_1_C5_8)",Deductibles and coinsurance (E_B_HOS_C1_25),Home Program Dialysis (B_2_C26_94),Impl. Dev. Charged to Patients (D_4_SNF_C11_72),FQHC (B_1_C26_89),OOT (B_2_C26_9930),Burn Intensive Care Unit (S3_1_C5_10),Subprovider-IPF (D_1_HOS_C7_40),"Total Program Inpatient Operating Cost excluding Capital Related, Nonphysician, Anesthetist, and Medical Education Costs (D1_HOS_C1_53)","PPS REIMBURSED SERVICES -  CHARGES, Radioisotope (D_5_HOS_C2_56)","COST SERVICES NOT SUBJECT TO DEDUCTIBLES AND COINSURANCE - COST, Drugs Charged to Patients (D_5_HOS_C7_73)",Total Facility FTEs (S3_1_C9_27),Whole Blood & Packed Red Blood Cells (D3_IRF_C2_62),"AMOUNT REPORTED, Interns & Residents (S3_2_C3_2551)",Respiratory Therapy (D_4_HOS_C2_65),"COST REIMBURSED SERVICES NOT SUBJECT TO DEDUCTIBLES AND COINSURANCE - CHARGES, Home Program Dialysis (D_5_HOS_C4_94)",Adults & Pediatrics (D_3_HOS_C9_30),Total Other Medical Education (D_4_IPF_C4_200),Employee Benefits (A_C6_4),Research (B_1_C21_191),Clinic (D_4_IPF_C13_90),Cardiac Catheterization (B_1_C26_59),Other Reimbursable (B_1_C26_98),Ambulance Services (C_1_C7_95),Total Inpatient Program Days (D_3_HOS_C8_200),"COST REIMBURSED SERVICES NOT SUBJECT TO DEDUCTIBLES AND COINSURANCE - CHARGES, MRI (D_5_HOS_C4_58)",Related Organization Transactions (A8_C2_12),"Net Expense for Cost Allocation, Physicians' Private Office (B_1_C0_192)",Kidney Acquisition (C_1_C5_105),"Net Expense for Cost Allocation, OLTC (B_1_C0_46)",Home Program Dialysis (B_1_C26_94),Beds Total Hospital (S3_1_C2_14),"Allocation of Interns & Residents Program Costs, MRI (B_1_C22_58)","Net Expense for Cost Allocation, Maintenance and Repairs (B_1_C0_6)",Medicaid (Title XIX) discharges (S3_1_C14_17),CMHC (S3_1_C6_25),Outpatient Rehab Provider (S3_1_C7_25),Physical Therapy (D3_IRF_C2_66),Housekeeping (A_C6_9),"PPS SERVICES COST, Respiratory Therapy (D_5_HOS_C5_65)",Other Special Care Unit (D3_HOS_C2_35),Anesthesiology (D_4_IRF_C13_53),"COST SERVICES SUBJECT TO DEDUCTIBLES AND COINSURANCE - COST, Radiology-Therapeutic (D_5_HOS_C6_55)","PPS REIMBURSED SERVICES -  CHARGES, CT Scan (D_5_HOS_C2_57)","Allocation of Interns & Residents Program Costs, Electroencephalography (B_1_C22_70)",Home Office Name (S2_1_C1_141),"Blood Storing, Processing, Trans (D3_IPF_C3_63)","COST SERVICES SUBJECT TO DEDUCTIBLES AND COINSURANCE - COST, Observation Beds (Distinct Unit) (D_5_HOS_C6_9201)","COST REIMBURSED SERVICES NOT SUBJECT TO DEDUCTIBLES AND COINSURANCE - CHARGES, Intravenous Therapy (D_5_HOS_C4_64)","HHA I, PEP Episodes:  Total Visits (S4_HHA1_C4_33)","HHA I, LUPA Episodes:  Total Number of Episodes (S4_HHA1_C3_36)",Durable Medical Equipment Rented (B_1_C26_96),"Total Outpatient Charges, Radiology-Diagnostic (C_1_C7_54)",ICF (S3_1_C3_2001),Medical and Other Services reimbursed by OPPS (E_B_HOS_C1_2),ASC (Non Distinct Part) (D_4_IPF_C13_75),"COST REIMBURSED SERVICES NOT SUBJECT TO DEDUCTIBLES AND COINSURANCE - CHARGES, Medical Supplies Charged to Patients (D_5_HOS_C4_71)","COST SERVICES NOT SUBJECT TO DEDUCTIBLES AND COINSURANCE - COST, Radiology-Therapeutic (D_5_HOS_C7_55)",Net Income from Service to Patients (G3_C1_5),Intensive Care Unit (S3_1_C3_8),Hospital Provider Number (PRVDR_NUM),"HHA I, Total Number of Outlier Episodes (S4_HHA1_C5_37)","COST REIMBURSED SERVICES SUBJECT TO DEDUCTIBLES  AND COINSURANCE - CHARGES, Radioisotope (D_5_HOS_C3_56)",Negative Cost Centers (B_2_C26_201),Laboratory (D_4_HOS_C11_60),Organ Procurement (D4_INTESTINE_C1_69),"AMOUNT REPORTED, Dietary under contract (S3_2_C2_35)","PPS REIMBURSED SERVICES -  CHARGES, Durable Medical Equipment Sold (D_5_HOS_C2_97)",Radioisotope (D_4_HOS_C11_56),Subtotal (E_B_HOS_C1_27),"COST SERVICES SUBJECT TO DEDUCTIBLES AND COINSURANCE - COST, CT Scan (D_5_HOS_C6_57)",Renal Dialysis (D_4_HOS_C13_74),"HHA II, With Outliers:  Total Charges (S4_HHA2_C2_35)","Allocation of Interns & Residents Program Costs, Coronary Care Unit (B_1_C22_32)",Sale of medical and surgical supplies to (A8_C2_16),Cost of charity care (uninsured patients + patients w/ coverage not accepted by provider) (S10_C1_23),Durable Medical Equipment Rented (D3_IPF_C3_96),Drugs Charged to Patients (B_1_C26_73),Operating Room (A_C2_50),Whole Blood & Packed Red Blood Cells (D3_HOS_C3_62),"Blood Storing, Processing, Trans (D_4_SNF_C11_63)",Does the facility operate an ICF/MR facility for purposes of Title XIX? (Y/N) (S2_1_C1_93),Radiology-Diagnostic (A_C1_54),Medicare Certified Islet TC term date (S2_1_C2_132),"Number of Times per week
 Patient receives Dialysis (S5_C4_2)",Medicare Certified Heart TC term date (S2_1_C2_127),"Total Inpatient Charges, Subprovider I (C_1_C6_42)",CT Scan (D3_HOS_C2_57),Charity care charges and uninsured discounts for the entire facility (S10_C1_20),Anesthesiology (C_1_C5_53),"AMOUNT REPORTED, Wage Related Costs Other (S3_2_C2_18)",Other Reimbursable (B_1_C21_98),Drugs Charged to Patients (D_4_SNF_C11_73),FQHC 9 Provider Number (S2_1_C2_1608),MCP Physician Payment Method (Y/N) (S5_C1_21),Durable Medical Equipment Sold (C_1_C5_97),"AMOUNT REPORTED, Interns & Residents (S3_2_C2_2550)",Observation Beds (Distinct Unit) (D3_HOS_C3_9201),"Net Expense for Cost Allocation, Other Nonreimbursable (B_1_C0_194)",ASC (Non Distinct Part) (D_4_HOS_C11_75),Anesthesiology (D3_IRF_C3_53),"PAID HOURS RELATED TO SALARIES, Total (S3_3_C5_6)","AMOUNT REPORTED, Total (S3_3_C2_6)",Electroencephalography (D_4_SNF_C11_70),Hospital Name (S2_1_C1_3),"AMOUNT REPORTED, Home Office Salaries & Wage Related Csts (S3_2_C3_14)",Physicians' Private Office (A_C1_192),Emergency (B_1_C22_91),HHA (S3_1_C11_22),Other Nonreimbursable (A_C2_194),Anesthesiology (D_4_IPF_C11_53),HVBP payment adjustment amount (E_A_HOS_C1_7093),Pancreas Acquisition (B_1_C26_109),Intensive Care Unit (A_C2_31),Impl. Dev. Charged to Patients (D_4_HOS_C2_72),Radioisotope (A_C1_56),RHC 8 Provider Number (S2_1_C2_1507),Research (B_1_C22_191),Emergency (B_1_C21_91),Radiology-Therapeutic (D_4_IPF_C11_55),ASC (Non Distinct Part) (D3_SNF_C3_75),Labor and Delivery (S3_1_C2_32),Cost of patients approved for charity care and uninsured discounts (S10_C2_21),Subprovider I (A_C1_42),Land (G_C1THRU4_12),"ADJUSTED SALARIES, Total (S3_3_C4_6)",OPT (B_1_C26_9920),MRI (D_4_IPF_C13_58),Adults & Pediatrics (C_1_C5_30),Respiratory Therapy (A_C6_65),"Total, New Cap Related Csts Bldg & Fixtures (A7_3_C15_1)","ADJUSTED SALARIES, Interns & Residents (S3_2_C4_2551)",Ambulance Trips (S3_1_C6_29),"COST SERVICES NOT SUBJECT TO DEDUCTIBLES AND COINSURANCE - COST, Observation Beds (Distinct Unit) (D_5_HOS_C7_9201)","PPS SERVICES COST, Recovery Room (D_5_HOS_C5_51)",Ending Date of SCH status (S2_1_C2_36),Subprovider II (D_1_HOS_C4_4201),Report Record Number (RPT_REC_NUM),"ADJUSTED SALARIES, Nursing Administration (S3_2_C4_38)",Whole Blood & Packed Red Blood Cells (D_4_IPF_C11_62),Census Division Code (CENSUS),Liver Acquisition (C_1_C6_107),Delivery Room and Labor Room (D3_IPF_C3_52),Utilization Review - Physician Compen (D1_SNF_C1_85),SNF (A_C2_44),Total Nonphysician Anesthetist Cost (D_4_IPF_C1_200),"Net Expense for Cost Allocation, Kidney Acquisition (B_1_C0_105)",Other Ancillary (D3_SNF_C3_76),"PPS SERVICES COST, Occupational Therapy (D_5_HOS_C5_67)",Recovery Room (A_C6_51),Organ acquisition (E_B_HOS_C1_10),"Number of patients in program at 
end of cost reporting period (S5_C1_1)",Whole Blood & Packed Red Blood Cells (D_4_SNF_C11_62),Medical Supplies Charged to Patients (D_4_IRF_C11_71),"PPS REIMBURSED SERVICES -  CHARGES, Delivery Room and Labor Room (D_5_HOS_C2_52)",Delivery Room and Labor Room (D3_HOS_C3_52),"HHA III, PEP Episodes:  Total Visits (S4_HHA3_C4_33)","AMOUNT REPORTED, Management and Administrative Services (S3_2_C2_12)","Number of patients in program at 
end of cost reporting period (S5_C2_1)",Subprovider II (C_1_C5_4201),"HHA I, With Outliers:  Non Routine Med Sup Chgs (S4_HHA1_C2_38)","Net Expense for Cost Allocation, Delivery Room and Labor Room (B_1_C0_52)","PAID HOURS RELATED TO SALARIES, Teaching Physician Salaries (S3_2_C5_16)","HHA II, PEP Episodes:  Total Visits (S4_HHA2_C4_33)",Electrocardiology (D3_HOS_C3_69),Other Special Care Unit (A_C2_35),Other Organ Acquisition (A_C6_112),Durable Medical Equipment Sold (A_C1_97),FQHC 7 Provider Number (S2_1_C2_1606),Hospital Adlts & Ped Swing Bed NF (S3_1_C7_6),Physical Therapy (C_1_C2_66),IPF (S3_1_C5_16),Occupational Therapy (D_4_IPF_C11_67),Occupational Therapy (D3_HOS_C2_67),Anesthesiology (A_C2_53),"Net Expense for Cost Allocation, Total (B_1_C0_200)","COST SERVICES NOT SUBJECT TO DEDUCTIBLES AND COINSURANCE - COST, Renal Dialysis (D_5_HOS_C7_74)","Fully Depreciated Assets, Subtotal (A7_1_C7_8)",SNF (C_1_C5_44),Impl. Dev. Charged to Patients (D3_IPF_C2_72),Outpatient Revenue (G2_C2_28),Ambulance Services (A_C6_95),"Net Expense for Cost Allocation, Housekeeping (B_1_C0_9)",Other Ancillary (D_4_HOS_C1_76),"AMOUNT REPORTED, SNF (S3_2_C2_9)",Other Outpatient Services (A_C2_93),Other Special Purpose (C_1_C6_117),Blood Clotting Factors for Hemoph. (D3_IRF_C2_6250),"AVERAGE HOURLY WAGE, Administrative and General under Contract (S3_2_C6_28)",Other Reimbursable (A_C1_98),Whole Blood & Packed Red Blood Cells (A_C6_62),"Net Expense for Cost Allocation, Impl. Dev. Charged to Patients (B_1_C0_72)","Net Expense for Cost Allocation, Ambulance Services (B_1_C0_95)","Beginning Balances, Fixed Equipment (A7_1_C1_5)","Allocation of Interns & Residents Program Costs, Whole Blood & Packed Red Blood Cells (B_1_C22_62)","Net Expense for Cost Allocation, Recovery Room (B_1_C0_51)",Physical Therapy (D3_HOS_C3_66),ICF (S3_1_C10_2001),Fiscal Year Begin Date (FY_BGN_DT),"AVERAGE HOURLY WAGE, Home Office Salaries (S3_2_C6_1401)","Allocation of Interns & Residents Salary and Fringes, Occupational Therapy (B_1_C21_67)","Total Outpatient Charges, Operating Room (C_1_C7_50)",Total Adults & Peds (S3_1_C7_7),"PPS REIMBURSED SERVICES -  CHARGES, Drugs Charged to Patients (D_5_HOS_C2_73)","COST SERVICES SUBJECT TO DEDUCTIBLES AND COINSURANCE - COST, Recovery Room (D_5_HOS_C6_51)",Total (A8_C2_50),Drugs Charged to Patients (C_1_C5_73),ASC (Non Distinct Part) (C_1_C5_75),Other Ancillary (D_4_IRF_C13_76),"HHA III, With Outliers:  Total Visits (S4_HHA3_C2_33)",Laboratory (D_4_HOS_C4_60),Total Other Medical Education (D_4_IRF_C4_200),Other Ancillary (B_1_C26_76),Subprovider-IPF (D3_SNF_C2_40),Renal Dialysis (C_1_C6_74),"Net Expense for Cost Allocation, Burn Intensive Care Unit (B_1_C0_33)",Nursing School (A_C6_20),"Is this a New Hospital under
42 CFR 412.300 PPS capital
(Y/N) (S2_1_C1_47)","TOTAL CAPITAL COSTS AFTER COST ALLOCATION, Anesthesiology (B_2_C26_53)",RHC 18 Provider Number (S2_1_C2_1517),Islet Acquisition (C_1_C6_111),"PAID HOURS RELATED TO SALARIES, Excluded Area Salaries (S3_2_C5_10)",Organ Procurement (D4_LUNG_C1_69),Physical Therapy (D_4_HOS_C12_66),"PAID HOURS RELATED TO SALARIES, Maintenance of Personnel (S3_2_C5_37)","Income from imposition of interest, finance (A8_C2_21)","Total Outpatient Charges, MRI (C_1_C7_58)",Speech Pathology (D_4_HOS_C2_68),"ADJUSTED SALARIES, Teaching Physician Salaries (S3_2_C4_1601)",Islet Acquisition (A_C2_111),"PAID HOURS RELATED TO SALARIES, Laundry and Linen Service (S3_2_C5_31)",Physical Therapy (D_4_IRF_C11_66),Laboratory (B_1_C26_60),Total discharges (S3_1_C15_21),Nursing Administration (A_C2_13),Adults and Pediatrics (A_C2_30),Nonpaid Workers (A_C6_193),CMHC (B_1_C22_99),Surgical Intensive Care Unit (D_1_HOS_C7_34),Operating Room (D_4_HOS_C11_50),Impl. Dev. Charged to Patients (D3_SNF_C2_72),"AMOUNT REPORTED, Other General Service (S3_2_C2_43)",Electroencephalography (D_4_IRF_C11_70),Telephone Services (A8_C2_7),Other Reimbursable (D_4_HOS_C11_98),"Beginning Balances, Buildings and Fixtures (A7_1_C1_3)",Whole Blood & Packed Red Blood Cells (D_4_HOS_C3_62),Report Status Code (RPT_STUS_CD),Respiratory Therapy (D_4_IPF_C13_65),"HHA III, Without Outliers:  Total Charges (S4_HHA3_C1_35)",Renal 10 Provider Number (S2_1_C2_1809),Medicare Certified Kidney TC term date (S2_1_C2_126),Net Revenue from stand-alone SCHIP (S10_C1_9),Kidney Acquisition (A_C2_105),ASC (Non Distinct Part) (D_4_HOS_C12_75),"AVERAGE HOURLY WAGE, Social Service (S3_2_C6_42)","ADJUSTED SALARIES, Housekeeping (S3_2_C4_32)",Lesser of cost or charges (E_B_HOS_C1_21),"AMOUNT REPORTED, Physician Part A (S3_2_C2_22)",OPPS payments (E_B_HOS_C1_3),Physicians' Private Office (B_1_C22_192),Recovery Room (B_1_C26_51),"Net Expense for Cost Allocation, CMHC (B_1_C0_99)",Medical Supplies Charged to Patients (D_4_HOS_C11_71),"Taxes, New Cap Related Csts Movable Equipment (A7_3_C6_2)",Pancreas Acquisition (A_C2_109),RHC 15 Provider Number (S2_1_C2_1514),"ADJUSTED SALARIES, Pharmacy (S3_2_C4_40)",Renal Dialysis (D3_IRF_C2_74),"Insurance, New Cap Related Csts Movable Equipment (A7_3_C5_2)",Surgical Intensive Care Unit (D_1_HOS_C6_34),Islet Acquisition (C_1_C7_111),Total (D_4_IRF_C13_200),Physical Therapy (A_C6_66),Observation Beds (Distinct Unit) (B_1_C21_9201),"HHA I, With Outliers:  Other Charges (S4_HHA1_C2_34)",certification date (S2_1_C1_131),NF Provider Number (S2_1_C2_10),Laboratory (D_4_HOS_C10_60),"Purchases, Subtotal (A7_1_C2_8)",SNF (S3_1_C6_19),Total Assets (G_C1THRU4_36),Subprovider-IRF (B_1_C26_41),"ADJUSTED SALARIES, Laundry and Linen Service (S3_2_C4_31)",Occupational Therapy (D_4_SNF_C11_67),New Capital Equipment (A_C6_2),Renal Dialysis (C_1_C5_74),Ambulance Services (C_1_C6_95),"PPS REIMBURSED SERVICES -  CHARGES, Total (D_5_HOS_C2_200)",Ambulance Services (A_C1_95),"Allocation of Interns & Residents Salary and Fringes, Subprovider-IRF (B_1_C21_41)",Durable Medical Equipment Sold (A_C2_97),Medical Supplies Charged to Patients (D_4_HOS_C10_71),"HHA III, LUPA Episodes:  Total Number of Episodes (S4_HHA3_C3_36)",ASC (Distinct Part) (C_1_C6_115),"COST SERVICES NOT SUBJECT TO DEDUCTIBLES AND COINSURANCE - COST, ASC (Non Distinct Part) (D_5_HOS_C7_75)",Other Outpatient Services (D_4_HOS_C12_93),Medical Supplies Charged to Patients (D3_HOS_C2_71),Intestinal Acquisition (B_1_C22_110),"Fully Depreciated Assets, Ending Balance (A7_1_C6_7)",Blood Clotting Factors for Hemoph. (B_1_C26_6250),Self Insurance (S2_1_C3_11801),"PAID HOURS RELATED TO SALARIES, Home Office Salaries & Wage Related Csts (S3_2_C5_14)",Delivery Room and Labor Room (D3_SNF_C2_52),Durable Medical Equipment Sold (D_4_HOS_C13_97),RHC/FQHC Combined (S3_1_C6_26),Balance due provider/program (E_B_HOS_C1_43),SNF Provider Number (S2_1_C2_9),"ADJUSTED SALARIES, Management and Administrative Services (S3_2_C4_12)","Beginning Balances, Total (A7_1_C1_10)","Total Inpatient Charges, NF (C_1_C6_45)",Cardiac Catheterization (D_4_IPF_C13_59),Operating Room (D3_HOS_C2_50),Other Outpatient Services (C_1_C5_93),Heart Acquisition (A_C1_106),Drugs Charged to Patients (B_1_C22_73),Radioisotope (D3_HOS_C2_56),Nursery (S3_1_C7_13),Hospital City (S2_1_C1_2),Outpatient Rehab Provider (S3_1_C8_25),"PPS SERVICES COST, Speech Pathology (D_5_HOS_C5_68)",Home Program Dialysis (D3_IRF_C2_94),"Net Expense for Cost Allocation, Surgical Intensive Care Unit (B_1_C0_34)",Outlier payments (E_B_HOS_C1_4),General Fund Balance (G_C1THRU4_52),Coronary Care Unit (S3_1_C5_9),"Total Inpatient Charges, PBP Clinical Lab Services Program Only (C_1_C6_61)","COST SERVICES SUBJECT TO DEDUCTIBLES AND COINSURANCE - COST, Physical Therapy (D_5_HOS_C6_66)",Durable Medical Equipment Rented (D3_IRF_C2_96),CMHC (C_1_C6_99),"Disposals and Retirements, Land (A7_1_C5_1)",CT Scan (B_1_C26_57),Emergency (D_4_IPF_C13_91),Deferred Income (G_C1THRU4_41),Anesthesiology (D3_HOS_C2_53),Other Outpatient Services (D3_SNF_C2_93),MRI (D_4_HOS_C3_58),"COST SERVICES NOT SUBJECT TO DEDUCTIBLES AND COINSURANCE - COST, Delivery Room and Labor Room (D_5_HOS_C7_52)",HHA (S3_1_C7_22),"Fully Depreciated Assets, Assets (A7_1_C7_7)",Speech Pathology (D3_IRF_C3_68),Cardiac Catheterization (D_4_HOS_C2_59),"Disposals and Retirements, Buildings and Fixtures (A7_1_C7_3)",Medical Supplies Charged to Patients (D3_SNF_C3_71),"PAID HOURS RELATED TO SALARIES, Employee Benefits (S3_2_C5_26)","AVERAGE HOURLY WAGE, Operation of Plant (S3_2_C6_30)",Rental of quarters to employee and oths (A8_C2_15),"COST SERVICES SUBJECT TO DEDUCTIBLES AND COINSURANCE - COST, Operating Room (D_5_HOS_C6_50)","Allocation of Interns & Residents Program Costs, Radiology-Diagnostic (B_1_C22_54)",Surgical Intensive Care Unit (S3_1_C7_11),"AMOUNT REPORTED, Operation of Plant (S3_2_C2_30)","HHA III, Total Charges:  LUPA Episodes (S4_HHA3_C3_35)",Burn Intensive Care Unit (D3_IPF_C2_33),"Disposals and Retirements, Movable Equipment (A7_1_C5_6)",Home Program Dialysis (A_C1_94),Other Capital (A_C2_3),Electrocardiology (D3_HOS_C2_69),Other Special Care (S3_1_C7_12),Other General Service (A_C2_18),"ADJUSTED SALARIES, Excluded Area Salaries (S3_2_C4_10)",Subprovider-IPF (A_C6_40),Total Program Excludable Costs (D1_IRF_C1_52),Other Reimbursable (B_1_C22_98),TOTAL (D3_IPF_C2_200),Program Ancillary Services (D1_SNF_C1_84),FQHC (A_C1_89),"COST REIMBURSED SERVICES SUBJECT TO DEDUCTIBLES  AND COINSURANCE - CHARGES, Blood Clotting Factors for Hemoph. (D_5_HOS_C3_6250)",Parking Lot (A8_C2_9),"HHA III, With Outliers:  Total Charges (S4_HHA3_C2_35)",Other Reimbursable (D3_IPF_C2_98),MRI (A_C1_58),Subtotal (E_B_HOS_C1_40),Drugs Charged to Patients (D_4_HOS_C2_73),Delivery Room and Labor Room (C_1_C5_52),"Allocation of Interns & Residents Salary and Fringes, Coronary Care Unit (B_1_C21_32)",Other Special Care Unit (C_1_C5_35),Drugs Charged to Patients (D3_IRF_C2_73),Liver Acquisition (C_1_C7_107),ICF (S3_1_C7_2001),"PPS REIMBURSED SERVICES -  CHARGES, Operating Room (D_5_HOS_C2_50)","TOTAL CAPITAL COSTS AFTER COST ALLOCATION, SNF (B_2_C26_44)",Other Reimbursable (D_4_HOS_C12_98),Emergency (C_1_C5_91),"PAID HOURS RELATED TO SALARIES, Social Service (S3_2_C5_42)",Total Long-term Liabilities (G_C1THRU4_50),Speech Pathology (D_4_HOS_C11_68),"COST REIMBURSED SERVICES SUBJECT TO DEDUCTIBLES  AND COINSURANCE - CHARGES, Durable Medical Equipment Sold (D_5_HOS_C3_97)",Utilization (S5_C1_8),Physical Therapy (A_C1_66),Impl. Dev. Charged to Patients (D3_IRF_C3_72),NF (A_C1_45),Coronary Care Unit (A_C1_32),Durable Medical Equipment Rented (D_4_HOS_C10_96),Land Improvements (G_C1THRU4_13),Subprovider-IRF (A_C2_41),"Net Expense for Cost Allocation, Social Service (B_1_C0_17)","HHA I, PEP:  Total Non Routine Med Supply Chgs (S4_HHA1_C4_38)",Subprovider II (A_C1_4201),MRI (D3_SNF_C3_58),"PPS SERVICES COST, MRI (D_5_HOS_C5_58)","Disposals and Retirements, Buildings and Fixtures (A7_1_C5_3)",CT Scan (D_4_HOS_C3_57),"Net Expense for Cost Allocation, Other Special Care Unit (B_1_C0_35)","COST SERVICES SUBJECT TO DEDUCTIBLES AND COINSURANCE - COST, MRI (D_5_HOS_C6_58)",Occupational Therapy (C_1_C2_67),Anesthesiology (D_4_IRF_C11_53),Renal Dialysis (A_C6_74),Subprovider-IRF (D3_IRF_C2_40),Speech Pathology (A_C6_68),ASC (Non Distinct Part) (D_4_IPF_C11_75),Electrocardiology (D_4_HOS_C10_69),CT Scan (D_4_IRF_C13_57),"PPS SERVICES COST, Blood Storing, Processing, Trans (D_5_HOS_C5_63)",Number of stations (S5_C3_6),Whole Blood & Packed Red Blood Cells (D3_IPF_C3_62),Electroencephalography (A_C6_70),"Net Expense for Cost Allocation, Nonphysician Anesthetists (B_1_C0_19)",Charity care charges and uninsured discounts for the entire facility (S10_C2_20),"Net Expense for Cost Allocation, Central Services and Supply (B_1_C0_14)","Allocation of Interns & Residents Program Costs, Intravenous Therapy (B_1_C22_64)",Other Outpatient Services (D_4_HOS_C11_93),Intensive Care Unit (D3_IRF_C2_31),Radioisotope (B_1_C26_56),Respiratory Therapy (D3_IRF_C3_65),"COST SERVICES SUBJECT TO DEDUCTIBLES AND COINSURANCE - COST, Intravenous Therapy (D_5_HOS_C6_64)",Total (D_4_HOS_C1_200),Intravenous Therapy (D_4_HOS_C11_64),Laboratory (D_4_IRF_C13_60),"TOTAL CAPITAL COSTS AFTER COST ALLOCATION, Other Special Care Unit (B_2_C26_35)",Total Other Expenses (G3_C1_28),"Blood Storing, Processing, Trans (D_4_HOS_C10_63)","Gift, Flower, Coffee Shop, Canteen (A_C6_190)","ADJUSTED SALARIES, SNF (S3_2_C4_9)",RHC 12 Provider Number (S2_1_C2_1511),Ambulance Services (B_1_C21_95),Interest Expense (A_C6_113),Observation Beds (Distinct Unit) (D3_SNF_C3_9201),Utilization (S5_C2_8),"AMOUNT REPORTED, Medical Records & Med Records Library (S3_2_C2_41)",ASC (Non Distinct Part) (D3_IPF_C3_75),Lung  Acquisition (A_C6_108),Liver Acquisition (B_1_C26_107),Impl. Dev. Charged to Patients (D_4_IPF_C11_72),Mortgage Payable (G_C1THRU4_46),CORF (A_C1_9910),Cafeteria employees and guests (A8_C2_14),Islet Acquisition (C_1_C5_111),RHC 16 Provider Number (S2_1_C2_1515),"Is this a teaching hospital or
affiliated with a teaching hospital? (Y/N) (S2_1_C1_56)","HHA I, LUPA:  Total Non Routine Med Sup Chgs (S4_HHA1_C3_38)",Operating Room (D_4_IRF_C11_50),Radiology-Therapeutic (D_4_HOS_C11_55),"Blood Storing, Processing, Trans (D_4_IRF_C13_63)",OOT (A_C1_9930),"Blood Storing, Processing, Trans (D_4_HOS_C13_63)",OLTC (A_C6_46),Radiology-Diagnostic (D_4_IPF_C13_54),Delivery Room and Labor Room (D_4_IPF_C11_52),Interest expense on Medicare Overpaymts (A8_C2_22),Adj for Occupational therapy in excess of li (A8_C2_30),MRI (C_1_C5_58),"Blood Storing, Processing, Trans (B_2_C26_63)","ADJUSTED SALARIES, Non-Physician Anesthetist Part B (S3_2_C4_3)",Cost of patients approved for charity care and uninsured discounts (S10_C3_21),Intravenous Therapy (A_C2_64),Interns & Res Other Program Costs (A_C6_22),"COST REIMBURSED SERVICES SUBJECT TO DEDUCTIBLES  AND COINSURANCE - CHARGES, ASC (Non Distinct Part) (D_5_HOS_C3_75)","Blood Storing, Processing, Trans (D_4_HOS_C3_63)",Hospice (B_1_C21_116),Paid Losses (S2_1_C2_11801),Occupational Therapy (D_4_IPF_C13_67),Total Hospital (S3_1_C7_14),Blood Clotting Factors for Hemoph. (D_4_HOS_C10_6250),HHA (B_1_C22_101),"Net Expense for Cost Allocation, Administrative and General (B_1_C0_5)",ASC (Non Distinct Part) (D_4_SNF_C11_75),Electroencephalography (D3_HOS_C2_70),FQHC 4 Provider Number (S2_1_C2_1603),Emergency (D_4_HOS_C2_91),Other Reimbursable (B_2_C26_98),"Allocation of Interns & Residents Salary and Fringes, Recovery Room (B_1_C21_51)",Renal Dialysis (D_4_HOS_C11_74),FQHC (A_C2_89),Pharmacy (A_C6_15),"Net Expense for Cost Allocation, Anesthesiology (B_1_C0_53)","HHA II, LUPA Episodes:  Total Number of Episodes (S4_HHA2_C3_36)",Clinic (B_1_C22_90),Anesthesiology (D_4_HOS_C1_53),Drugs Charged to Patients (D3_IRF_C3_73),NF (B_1_C26_45),Other Ancillary (D3_HOS_C3_76),Heart Acquisition (A_C6_106),Other Special Care Unit (A_C1_35),"HHA II, W/Out Outliers:  Number of Episodes (S4_HHA2_C1_36)","HHA III, Total Non Routine Medical  Supply Charges (S4_HHA3_C5_38)","Net Expense for Cost Allocation, NF (B_1_C0_45)",Other Outpatient Services (C_1_C6_93),Ambulance Services (B_2_C26_95),Physicians' Private Office (A_C2_192),Physical Therapy (C_1_C6_66),Maintenance of Personnel (A_C1_12),Total Fixed Assets (G_C1THRU4_30),"Disposals and Retirements, Movable Equipment (A7_1_C7_6)",Medical Supplies Charged to Patients (D3_IPF_C3_71),Other Special Purpose (B_2_C26_117),CAPD exchanges per day (S5_C6_4),"ADJUSTED SALARIES, Central Services and Supply (S3_2_C4_39)","PPS SERVICES COST, Blood Clotting Factors for Hemoph. (D_5_HOS_C5_6250)",Renal Dialysis (D_4_HOS_C3_74),NF (S3_1_C7_20),"PAID HOURS RELATED TO SALARIES, Home Office:  Physician Part A (S3_2_C5_15)",Renal 4 Provider Number (S2_1_C2_1803),Renal Dialysis (D3_HOS_C2_74),"Allocation of Interns & Residents Salary and Fringes, Anesthesiology (B_1_C21_53)",CMHC (A_C6_99),"HHA I, Without Outliers:  Other Charges (S4_HHA1_C1_34)",Electroencephalography (D3_HOS_C3_70),Other Reimbursable (D3_HOS_C2_98),RHC/FQHC Combined (S3_1_C10_26),OSP (A_C6_9940),Drugs Charged to Patients (D_4_IRF_C11_73),Electrocardiology (D_4_IPF_C13_69),"Net Expense for Cost Allocation, New Capital Buildings and Fixtures (B_1_C0_1)","Allocation of Interns & Residents Salary and Fringes, Blood Storing, Processing, Trans (B_1_C21_63)",Paramedical Education (A_C2_23),Intravenous Therapy (D_4_HOS_C2_64),"AVERAGE HOURLY WAGE, Excluded Area Salaries (S3_2_C6_10)",Clinic (D_4_HOS_C11_90),"Number of patients in program at 
end of cost reporting period (S5_C5_1)",Less Observation Beds (C_1_C5_201),Observation Beds (Distinct Unit) (D3_IRF_C2_9201),Burn Intensive Care Unit (S3_1_C6_10),Intensive Care Unit (S3_1_C7_8),Electroencephalography (D_4_HOS_C11_70),CT Scan (C_1_C5_57),Organ acquisition charges (E_B_HOS_C1_13),FQHC (B_1_C21_89),Coronary Care Unit (D3_IPF_C2_32),Renal Dialysis (D_4_IPF_C11_74),"PPS REIMBURSED SERVICES -  CHARGES, Respiratory Therapy (D_5_HOS_C2_65)",Impl. Dev. Charged to Patients (D_4_IRF_C11_72),"AMOUNT REPORTED, Administrative and General (S3_2_C2_27)","Net Expense for Cost Allocation, Paramedical Education (B_1_C0_23)",Emergency (C_1_C7_91),HHA (A_C6_101),HMO (S3_1_C6_2),Burn Intensive Care Unit (S3_1_C8_10),"Disposals and Retirements, Land Improvements (A7_1_C7_2)",MRI (B_1_C26_58),HHA (B_1_C21_101),Impl. Dev. Charged to Patients (D3_HOS_C3_72),Recovery Room (D_4_HOS_C2_51),Aggregate amount collected from patients (E_B_HOS_C1_15),FQHC 11 Provider Number (S2_1_C2_1610),MRI (D3_HOS_C2_58),"TOTAL CAPITAL COSTS AFTER COST ALLOCATION, Operating Room (B_2_C26_50)",Subprovider 2 (S3_1_C7_1801),Nursery (A_C2_43),"Fully Depreciated Assets, Purchase (A7_1_C2_7)",Intensive Care Unit (C_1_C5_31),Paramedical Education (A_C6_23),"General Inpatient Routine Service Cost, net of Swing Bed and Private Room Diff (D1_SNF_C1_37)","AMOUNT REPORTED, Home Office Salaries (S3_2_C2_1401)",Clinic (D3_IRF_C2_90),"Net Expense for Cost Allocation, Nonpaid Workers (B_1_C0_193)",Total (C_1_C7_202),"Total Inpatient Charges, OLTC (C_1_C6_46)",MRI (D_4_HOS_C10_58),"COST REIMBURSED SERVICES NOT SUBJECT TO DEDUCTIBLES AND COINSURANCE - CHARGES, Observation Beds (Distinct Unit) (D_5_HOS_C4_9201)","AVERAGE HOURLY WAGE, Nursing Administration (S3_2_C6_38)","Allocation of Interns & Residents Program Costs, Laboratory (B_1_C22_60)",Delivery Room and Labor Room (A_C2_52),MDH status beginning date (MM/DD/YY) (S2_1_C1_38),Respiratory Therapy (D_4_HOS_C3_65),Renal Dialysis (D_4_HOS_C4_74),In State Medicaid eligible days (S2_1_C2_24),"Interest, New Cap Related Csts Bldg & Fixtures (A7_3_C11_1)","Blood Storing, Processing, Trans (C_1_C7_63)",Other Special Care Unit (D_1_HOS_C4_35),Administrative and General (A_C1_5),HHA (B_1_C26_101),"PPS SERVICES COST, Electrocardiology (D_5_HOS_C5_69)",Recovery Room (D3_SNF_C2_51),Cardiac Catheterization (D_4_HOS_C11_59),Total costs for patients covered by a state or local government program (S10_C1_15),"TOTAL CAPITAL COSTS AFTER COST ALLOCATION, Subprovider I (B_2_C26_42)",Renal 2 Provider Number (S2_1_C2_1801),Impl. Dev. Charged to Patients (B_1_C26_72),Int & Res (non approved teaching program (C_1_C7_100),Total Hospital Interns & Residents (S3_1_C11_14),RHC/FQHC Combined (S3_1_C8_26),"PAID HOURS RELATED TO SALARIES, Housekeeping under Contract (S3_2_C5_33)",Cost of Uncompensated Care (S10_C1_30),"Beginning Balances, Building Improvements (A7_1_C1_4)",Ambulance Services (B_1_C22_95),Other Reimbursable (A_C6_98),OSP (B_2_C26_9940),"AMOUNT REPORTED, Related Salaries (S3_2_C3_1402)",Other Reimbursable (D3_HOS_C3_98),Social Service (A_C1_17),"Net Expense for Cost Allocation, Renal Dialysis (B_1_C0_74)",Medical Supplies Charged to Patients (A_C1_71),SNF (A_C6_44),Speech Pathology (A_C2_68),"Total Inpatient Charges, Whole Blood & Packed Red Blood Cells (C_1_C6_62)",Clinic (D_4_HOS_C4_90),Cardiac Catheterization (A_C1_59),"Are there any related organization or how office costs as defined in HCFA Pub. 15-I, chapter 10? (Y/N) (S2_1_C1_140)","Allocation of Interns & Residents Program Costs, Impl. Dev. Charged to Patients (B_1_C22_72)","PPS SERVICES COST, Delivery Room and Labor Room (D_5_HOS_C5_52)","COST SERVICES SUBJECT TO DEDUCTIBLES AND COINSURANCE - COST, Occupational Therapy (D_5_HOS_C6_67)",Other Ancillary (D_4_HOS_C10_76),Hospice (S3_1_C7_24),"AMOUNT REPORTED, Non-Physician Anesthetist Part A (S3_2_C2_20)",Subprovider-IRF (A_C6_41),Hospital Zip Code (S2_1_C3_2),Intravenous Therapy (B_2_C26_64),Laboratory (D3_IPF_C2_60),"PAID HOURS RELATED TO SALARIES, Excluded Area Salaries (S3_3_C5_2)",Total Program General Inpatient Routine (D1_IRF_C1_41),"Allocation of Interns & Residents Salary and Fringes, OLTC (B_1_C21_46)",Hospice (S3_1_C10_24),Intravenous Therapy (D3_IRF_C3_64),Total Adults & Peds (S3_1_C6_7),Cafeteria (A_C2_11),Electroencephalography (A_C1_70),CT Scan (D_4_HOS_C12_57),OOT (C_1_C6_9930),Subprovider 1 (S3_1_C8_18),FQHC (D_4_HOS_C4_89),OPT (C_1_C7_9920),"Disposals and Retirements, Land Improvements (A7_1_C5_2)","Allocation of Interns & Residents Salary and Fringes, Nursery (B_1_C21_43)","COST REIMBURSED SERVICES NOT SUBJECT TO DEDUCTIBLES AND COINSURANCE - CHARGES, Whole Blood & Packed Red Blood Cells (D_5_HOS_C4_62)",Other Adjustments (Summed) (A8_C2_33),PBP Clinical Lab Services Program Only (D3_HOS_C3_61),Cardiac Catheterization (D3_IPF_C2_59),"HHA II, Total Visits (S4_HHA2_C5_33)","ADJUSTED SALARIES, Excluded Areas (S3_2_C4_19)",Average times dialyzers re-used (S5_C1_9),ASC (Non Distinct Part) (B_1_C22_75),"PPS REIMBURSED SERVICES -  CHARGES, Electrocardiology (D_5_HOS_C2_69)",Int & Res (non approved teaching program (A_C6_100),Inpatient Revenue (G2_C1_28),"Allocation of Interns & Residents Salary and Fringes, Speech Pathology (B_1_C21_68)",Radioisotope (D3_SNF_C3_56),"Net Expense for Cost Allocation, Pancreas Acquisition (B_1_C0_109)",ICF (S3_1_C8_2001),Laboratory (D3_SNF_C2_60),Drugs Charged to Patients (D_4_HOS_C10_73),"Total Inpatient Charges, Operating Room (C_1_C6_50)",Total Subprovider I Interns & Residents (S3_1_C10_18),Subprovider I (D3_IPF_C2_42),Pancreas Acquisition (A_C1_109),Blood Clotting Factors for Hemoph. (D_4_HOS_C3_6250),Electroencephalography (D_4_IRF_C13_70),Durable Medical Equipment Sold (D3_HOS_C2_97),Medical Supplies Charged to Patients (D_4_HOS_C2_71),"Allocation of Interns & Residents Program Costs, Respiratory Therapy (B_1_C22_65)",Operating Room (D_4_HOS_C2_50),"Other Capital Related Costs, New Cap Related Csts Movable Equipment (A7_3_C7_2)",Intravenous Therapy (C_1_C6_64),Impl. Dev. Charged to Patients (A_C1_72),Total Operating Expense (G3_C1_4),Hospital Adults & Pediatrics (S3_1_C7_1),"AVERAGE HOURLY WAGE, Contract Labor (S3_2_C6_11)",Subprovider I (D_1_HOS_C4_42),Title XVIII discharges (S3_1_C13_17),Emergency (D3_IPF_C2_91),Occupational Therapy (D3_SNF_C3_67),Are provider based physicians' costs included in Worksheet A? (Y/N) (S2_1_C1_144),Respiratory Therapy (D_4_SNF_C11_65),Cardiac Catheterization (D3_IPF_C3_59),Anesthesiology (A_C1_53),"ADJUSTED SALARIES, Interns & Residents (S3_2_C4_2553)","Total Inpatient Charges, Subprovider-IRF (C_1_C6_41)","Donations, Buildings and Fixtures (A7_1_C3_3)",ASC (Non Distinct Part) (B_1_C26_75),ASC (Distinct Part) (B_2_C26_115),"PPS SERVICES COST, Cardiac Catheterization (D_5_HOS_C5_59)","AMOUNT REPORTED, Pharmacy (S3_2_C2_40)",Drugs Charged to Patients (D_4_HOS_C1_73),Occupational Therapy (D_4_HOS_C3_67),Renal Dialysis (D_4_HOS_C12_74),Renal 5 Provider Number (S2_1_C2_1804),New Capital Buildings and Fixtures (A_C2_1),"Blood Storing, Processing, Trans (A_C1_63)",Ambulance Services (B_1_C26_95),Subprovider I (C_1_C5_42),Is this a rural hospital qualifying for an exception to the certified registered nurse anesthetist the CRNA fee schedule? (Y/N) (S2_1_C1_108),"PAID HOURS RELATED TO SALARIES, Operation of Plant (S3_2_C5_30)",CT Scan (D_4_IPF_C11_57),"Total Inpatient Charges, Other Special Care Unit (C_1_C6_35)",Medicare Certified Liver TC term date (S2_1_C2_128),"PPS REIMBURSED SERVICES -  CHARGES, Other Ancillary (D_5_HOS_C2_76)",Outpatient Rehab Provider (S3_1_C10_25),Subprovider-IRF (D3_HOS_C2_41),Clinic (D3_SNF_C3_90),Intravenous Therapy (D3_IRF_C2_64),Health Information Technology Designated Assets (G_C1THRU4_27),HHA (A_C1_101),Other Special Purpose (C_1_C7_117),SNF (A_C1_44),Intravenous Therapy (D_4_HOS_C12_64),"Net Expense for Cost Allocation, Whole Blood & Packed Red Blood Cells (B_1_C0_62)",Other Ancillary (D3_SNF_C2_76),SNF (S3_1_C5_19),"Disposals and Retirements, Building Improvements (A7_1_C5_4)",MRI (D_4_HOS_C13_58),Speech Pathology (D_4_HOS_C13_68),OLTC (S3_1_C10_21),"Lease, Total (A7_3_C10_3)",Medical Supplies Charged to Patients (C_1_C7_71),"Number of Times per week 
Patient receives Dialysis (S5_C3_2)",Television and Radio Service (A8_C2_8),RHC (C_1_C7_88),Kidney Acquisition (C_1_C6_105),"Allocation of Interns & Residents Salary and Fringes, Interns & Res Salary and Fringe Benefits (B_1_C21_21)",Liver Acquisition (A_C1_107),Stand-alone CHIP -- Costs minus net revenue (0 min) (S10_C1_12),Home Program Dialysis (D3_IPF_C3_94),Lung  Acquisition (B_2_C26_108),Whole Blood & Packed Red Blood Cells (D_4_HOS_C13_62),"COST REIMBURSED SERVICES SUBJECT TO DEDUCTIBLES  AND COINSURANCE - CHARGES, Renal Dialysis (D_5_HOS_C3_74)",Anesthesiology (D3_IPF_C2_53),"AMOUNT REPORTED, Physician Part B (S3_2_C2_23)","Purchases, Total (A7_1_C2_10)",Int & Res (non approved teaching program (B_1_C21_100),Intravenous Therapy (D3_HOS_C2_64),Electroencephalography (B_1_C26_70),Other Special Care (S3_1_C2_12),Respiratory Therapy (A_C1_65),Interns & Res Other Program Costs (A_C2_22),"Allocation of Interns & Residents Program Costs, OLTC (B_1_C22_46)","COST SERVICES SUBJECT TO DEDUCTIBLES AND COINSURANCE - COST, Other Reimbursable (D_5_HOS_C6_98)","HHA III, Total Number of Outlier Episodes (S4_HHA3_C5_37)",Electrocardiology (D_4_HOS_C12_69),Clinic (A_C1_90),interns and residents (E_B_HOS_C1_28),Kidney Acquisition (A_C6_105),Central Services and Supply (A_C2_14),RHC 6 Provider Number (S2_1_C2_1505),Other Special Purpose (C_1_C5_117),"COST SERVICES NOT SUBJECT TO DEDUCTIBLES AND COINSURANCE - COST, Other Ancillary (D_5_HOS_C7_76)",TOTAL (D3_SNF_C2_202),Amounts expected under 42 CFR (E_B_HOS_C1_16),Subtotal (E_B_HOS_C1_32),Renal Dialysis (D3_SNF_C2_74),Lung  Acquisition (C_1_C6_108),Whole Blood & Packed Red Blood Cells (D_4_IPF_C13_62),Total (D_4_SNF_C11_200),Clinic (D3_SNF_C2_90),"ADJUSTED SALARIES, Admin & Gen Under Contract (S3_2_C4_29)",Pancreas Acquisition (B_2_C26_109),"Donations, Total (A7_1_C3_10)",RHC/FQHC Combined (S3_1_C9_26),"Allocation of Interns & Residents Program Costs, Electrocardiology (B_1_C22_69)",ASC (Distinct Part) (C_1_C7_115),Payments received from patients for amounts previously written off as charity care (S10_C3_22),"COST REIMBURSED SERVICES NOT SUBJECT TO DEDUCTIBLES AND COINSURANCE - CHARGES, Speech Pathology (D_5_HOS_C4_68)",Subprovider-IPF (C_1_C5_40),Total reasonable charges (E_B_HOS_C1_14),"PPS REIMBURSED SERVICES -  CHARGES, Anesthesiology (D_5_HOS_C2_53)",Laboratory (D3_HOS_C2_60),Occupational Therapy (C_1_C7_67),Other Reimbursable (D3_SNF_C3_98),Other Special Care Unit (D_1_HOS_C7_35),"COST SERVICES SUBJECT TO DEDUCTIBLES AND COINSURANCE - COST, Laboratory (D_5_HOS_C6_60)",RHC (A_C2_88),Observation Beds (Distinct Unit) (D_4_HOS_C13_9201),Surgical Intensive Care Unit (S3_1_C6_11),ICF (A_C6_4501),Intravenous Therapy (D3_SNF_C3_64),"Allocation of Interns & Residents Salary and Fringes, Other Special Care Unit (B_1_C21_35)",Radiology-Therapeutic (D_4_IPF_C13_55),Hospice (C_1_C5_116),"ADJUSTED SALARIES, Interns & Residents (S3_2_C4_25)",MRI (D_4_HOS_C2_58),Other Outpatient Services (D3_HOS_C2_93),"Total Inpatient Charges, Intensive Care Unit (C_1_C6_31)","Treatment capacity per day per
station (S5_C1_7)",Observation Beds (Distinct Unit) (D_4_IPF_C13_9201),Program Inpatient Ancillary Service Cost (D1_HOS_C1_48),"Net Expense for Cost Allocation, Radioisotope (B_1_C0_56)",Total Hospital (S3_1_C8_14),"COST REIMBURSED SERVICES SUBJECT TO DEDUCTIBLES  AND COINSURANCE - CHARGES, Home Program Dialysis (D_5_HOS_C3_94)",Delivery Room and Labor Room (D_4_HOS_C12_52),Speech Pathology (D_4_SNF_C11_68),Emergency (D3_HOS_C2_91),"COST SERVICES NOT SUBJECT TO DEDUCTIBLES AND COINSURANCE - COST, Whole Blood & Packed Red Blood Cells (D_5_HOS_C7_62)","Total Inpatient Charges, Subprovider II (C_1_C6_4201)",Partial or full credits from manufacturers (E_B_HOS_C1_3998),SNF (S3_1_C7_19),"COST SERVICES SUBJECT TO DEDUCTIBLES AND COINSURANCE - COST, Durable Medical Equipment Sold (D_5_HOS_C6_97)",certification date (S2_1_C1_132),"AVERAGE HOURLY WAGE, Total (S3_3_C6_6)",Surgical Intensive Care Unit (A_C2_34),Non-physician Anesthetist (A8_C2_28),Other Current Assets (G_C1THRU4_9),Excess of customary charges (E_B_HOS_C1_19),Minor Equipment Depreciable (G_C1THRU4_25),Intensive Care Unit (D3_IPF_C2_31),Total Liabilities (G_C1THRU4_51),"Allocation of Interns & Residents Salary and Fringes, SNF (B_1_C21_44)","Medical certified liver 
transplant center cert date (S2_1_C1_128)",Total unreimbursed cost for Medicaid and CHIP and state and local indigent care programs (S10_C1_19),ASC (Distinct Part) (A_C2_115),Interns & Res Salary and Fringe Benefits (A_C6_21),Durable Medical Equipment Sold (B_1_C26_97),Medical Supplies Charged to Patients (D_4_HOS_C3_71),"HHA I, With Outliers:  Number of Episodes (S4_HHA1_C2_37)",Other Organ Acquisition (B_1_C26_112),Electrocardiology (D_4_IRF_C11_69),Zip Code (S2_1_C3_143),Home Program Dialysis (A_C6_94),"COST REIMBURSED SERVICES NOT SUBJECT TO DEDUCTIBLES AND COINSURANCE - CHARGES, Respiratory Therapy (D_5_HOS_C4_65)",Radiology-Diagnostic (D3_IPF_C2_54),Dietary (A_C6_10),Surgical Intensive Care Unit (S3_1_C4_11),FQHC 3 Provider Number (S2_1_C2_1602),"ADJUSTED SALARIES, Dietary (S3_2_C4_34)",Delivery Room and Labor Room (D_4_HOS_C3_52),Intravenous Therapy (D_4_SNF_C11_64),Impl. Dev. Charged to Patients (D3_HOS_C2_72),Premiums (S2_1_C1_11801),Total Allied Health (D_4_IRF_C3_200),Hospital Adults & Pediatrics (S3_1_C3_1),"PAID HOURS RELATED TO SALARIES, Management and Administrative Services (S3_2_C5_12)",Subprovider-IRF (D3_IPF_C2_41),"HHA I, Without Outliers:  Non Routine Med Sup Chgs (S4_HHA1_C1_38)",Total Salaries (A_C6_200),"COST REIMBURSED SERVICES NOT SUBJECT TO DEDUCTIBLES AND COINSURANCE - CHARGES, CT Scan (D_5_HOS_C4_57)","Allocation of Interns & Residents Salary and Fringes, Delivery Room and Labor Room (B_1_C21_52)",Deductibles and coinsurance related to line 24 (E_B_HOS_C1_26),Out of State Medicaid eligible days (S2_1_C4_24),Total discharges (S3_1_C15_18),"PAID HOURS RELATED TO SALARIES, Administrative and General under Contract (S3_2_C5_28)",IPF (S3_1_C3_16),"PAID HOURS RELATED TO SALARIES, Dietary (S3_2_C5_34)",Impl. Dev. Charged to Patients (D_4_HOS_C13_72),Hospice (S3_1_C2_24),"Epoietin amount form worksheet A
for home dialysis program (S5_C1_14)","COST REIMBURSED SERVICES SUBJECT TO DEDUCTIBLES  AND COINSURANCE - CHARGES, Delivery Room and Labor Room (D_5_HOS_C3_52)",PBP Clinical Lab Services Program Only (A_C2_61),"Net Expense for Cost Allocation, New Capital Equipment (B_1_C0_2)",Radiology-Therapeutic (D3_SNF_C2_55),Drugs Charged to Patients (D_4_HOS_C13_73),Nonphysician Anesthetists (A_C1_19),CORF (B_1_C26_9910),ASC (Non Distinct Part) (B_2_C26_75),Ambulance Services (C_1_C5_95),Medicaid charges (S10_C1_6),"COST SERVICES SUBJECT TO DEDUCTIBLES AND COINSURANCE - COST, Blood Storing, Processing, Trans (D_5_HOS_C6_63)","Donations, Land (A7_1_C3_1)",Speech Pathology (D3_IRF_C2_68),Pancreas Acquisition (A_C6_109),Nonphysician Anesthetists (A_C6_19),Emergency (D_4_IRF_C13_91),Other Ancillary (A_C6_76),Medical Supplies Charged to Patients (D_4_HOS_C4_71),"TOTAL CAPITAL COSTS AFTER COST ALLOCATION, Whole Blood & Packed Red Blood Cells (B_2_C26_62)",Coronary Care Unit (C_1_C5_32),Subtotal (C_1_C5_200),Drugs Charged to Patients (C_1_C6_73),Labor and Delivery Days -  Title XIX (S3_1_C8_32),Observation Beds (Distinct Unit) (D3_IRF_C3_9201),"Purchases, Buildings and Fixtures (A7_1_C2_3)",Beginning Date of SCH status (S2_1_C1_36),In State Medicaid paid days (S2_1_C1_24),Other General Service (A_C1_18),"HHA I, Total Charges (S4_HHA1_C5_35)",Intensive Care Unit (A_C6_31),Depreciation-New Movable Equipment (A8_C2_27),"Medicare certified heart
transplant center cert date (S2_1_C1_127)",Intravenous Therapy (D_4_IPF_C13_64),Durable Medical Equipment Sold (D_4_HOS_C2_97),Electroencephalography (B_2_C26_70),Home Program Dialysis (B_1_C21_94),"COST REIMBURSED SERVICES SUBJECT TO DEDUCTIBLES  AND COINSURANCE - CHARGES, Observation Beds (Distinct Unit) (D_5_HOS_C3_9201)",Other Nonreimbursable (B_1_C22_194),Intravenous Therapy (D3_HOS_C3_64),"COST SERVICES SUBJECT TO DEDUCTIBLES AND COINSURANCE - COST, ASC (Non Distinct Part) (D_5_HOS_C6_75)",Coronary Care Unit (D3_IRF_C2_32),Medical Supplies Charged to Patients (C_1_C5_71),"Net Expense for Cost Allocation, Medical Supplies Charged to Patients (B_1_C0_71)",Coronary Care Unit (B_1_C26_32),"PPS REIMBURSED SERVICES -  CHARGES, MRI (D_5_HOS_C2_58)",Durable Medical Equipment Rented (A_C1_96),"COST REIMBURSED SERVICES NOT SUBJECT TO DEDUCTIBLES AND COINSURANCE - CHARGES, Emergency (D_5_HOS_C4_91)","COST SERVICES NOT SUBJECT TO DEDUCTIBLES AND COINSURANCE - COST, Emergency (D_5_HOS_C7_91)",Notes Payable (G_C1THRU4_47),Radiology-Therapeutic (D_4_HOS_C12_55),"PPS REIMBURSED SERVICES -  CHARGES, Radiology-Therapeutic (D_5_HOS_C2_55)","PPS REIMBURSED SERVICES -  CHARGES, Electroencephalography (D_5_HOS_C2_70)",Title XVIII discharges (S3_1_C13_1),"PAID HOURS RELATED TO SALARIES, Dietary under Contract (S3_2_C5_35)",Whole Blood & Packed Red Blood Cells (D_4_IRF_C13_62),"AMOUNT REPORTED, Non-Physician Part B (S3_2_C2_6)",CT Scan (D_4_HOS_C13_57),Operating Room (B_1_C26_50),Organ Procurement (D4_ISLET_C1_69),Labor and Delivery Days Title 18 (S3_1_C6_32),Surgical Intensive Care Unit (D3_HOS_C2_34),Total Program General Inpatient Routine (D1_HOS_C1_41),"COST REIMBURSED SERVICES SUBJECT TO DEDUCTIBLES  AND COINSURANCE - CHARGES, Blood Storing, Processing, Trans (D_5_HOS_C3_63)",Radiology-Therapeutic (D3_HOS_C3_55),"Net Expense for Cost Allocation, ASC (Distinct Part) (B_1_C0_115)",Other Outpatient Services (D_4_IPF_C13_93),Recovery Room (D_4_HOS_C13_51),Hospice 3 Provider Number (S2_1_C2_1402),Medical Supplies Charged to Patients (D_4_HOS_C12_71),Intensive Care Unit (D_1_HOS_C4_31),Adults and Pediatrics (B_1_C26_30),Employee Benefits (A_C1_4),"Net Expense for Cost Allocation, Other Special Purpose (B_1_C0_117)","Total Inpatient Charges, Delivery Room and Labor Room (C_1_C6_52)","Fully Depreciated Assets, Total (A7_1_C4_7)",NF (A_C2_45),Medical Supplies Charged to Patients (D3_IPF_C2_71),"Net Expense for Cost Allocation, ICF (B_1_C0_4501)","COST REIMBURSED SERVICES NOT SUBJECT TO DEDUCTIBLES AND COINSURANCE - CHARGES, Drugs Charged to Patients (D_5_HOS_C4_73)",Nursery (D_1_HOS_C4_43),Pancreas Acquisition (B_1_C22_109),Nursing School (A_C2_20),"COST SERVICES NOT SUBJECT TO DEDUCTIBLES AND COINSURANCE - COST, Speech Pathology (D_5_HOS_C7_68)","PPS REIMBURSED SERVICES -  CHARGES, Blood Clotting Factors for Hemoph. (D_5_HOS_C2_6250)",Laundry and Linen Service (A8_C2_13),Blood Clotting Factors for Hemoph. (A_C2_6250),"Donations, Land Improvements (A7_1_C3_2)",RPCH/CAH Visits (S3_1_C6_15),Operating Room (D_4_HOS_C12_50),Total Hospital (S3_1_C4_7),"AMOUNT REPORTED, Maintenance of Personnel (S3_2_C2_37)","ADJUSTED SALARIES, Contract Labor (S3_2_C4_11)",Title V discharges (S3_1_C12_17),"AVERAGE HOURLY WAGE, Maintenance of Personnel (S3_2_C6_37)","Gift, Flower, Coffee Shop, Canteen (A_C1_190)",Home Program Dialysis (C_1_C7_94),Physical Therapy (D_4_HOS_C4_66),"COST SERVICES NOT SUBJECT TO DEDUCTIBLES AND COINSURANCE - COST, Laboratory (D_5_HOS_C7_60)",Electroencephalography (D_4_HOS_C2_70),"Total Outpatient Charges, CT Scan (C_1_C7_57)",Other Special Care Unit (D3_IRF_C2_35),Recovery Room (D_4_SNF_C11_51),Utilization Review SNF (A_C1_114),"AVERAGE HOURLY WAGE, Dietary under Contract (S3_2_C6_35)",Operating Room (D_4_HOS_C1_50),PBP Clinical Lab Services Program Only (C_1_C5_61),Radiology-Diagnostic (D_4_HOS_C12_54),Burn Intensive Care Unit (S3_1_C3_10),"HHA II, Without Outliers:  Other Charges (S4_HHA2_C1_34)","Donations, Movable Equipment (A7_1_C3_6)",Subprovider-IRF (D3_IRF_C2_41),"HHA I, PEP:  Total Number of Outlier Episodes (S4_HHA1_C4_37)","Disposals and Retirements, Fixed Equipment (A7_1_C7_5)",Durable Medical Equipment Sold (C_1_C7_97),Coronary Care Unit (S3_1_C4_9),Respiratory Therapy (B_1_C26_65),Hospice (B_2_C26_116),"Total Inpatient Charges, Radiology-Therapeutic (C_1_C6_55)",Delivery Room and Labor Room (A_C6_52),Drugs Charged to Patients (B_2_C26_73),"Net Expense for Cost Allocation, Hospice (B_1_C0_116)",Other Special Care (S3_1_C6_12),Less Contractual Allowance and Discounts on Patients' Accounts (G3_C1_2),Electroencephalography (C_1_C7_70),Payroll taxes payable (G_C1THRU4_39),"If this facility qualifies as a RPCH/CAH, has it elected the all inclusive payment for outpatient service? (Y/N) (S2_1_C1_106)",Radiology-Therapeutic (A_C2_55),Electroencephalography (D_4_HOS_C13_70),Total Subprovider II Interns & Residents (S3_1_C10_1801),"Total Inpatient Charges, Subprovider-IPF (C_1_C6_40)","Gift, Flower, Coffee Shop, Canteen (B_1_C26_190)","Net Expense for Cost Allocation, Islet Acquisition (B_1_C0_111)",Have you established a new subprovider excluded unit under 42 CFR 413.40(f)(1)(I)?(Y/N) (S2_1_C1_86),Physical Therapy (D3_SNF_C3_66),Recovery Room (D3_HOS_C2_51),Other adjustments (E_B_HOS_C1_39),"Allocation of Interns & Residents Salary and Fringes, Operating Room (B_1_C21_50)","TOTAL CAPITAL COSTS AFTER COST ALLOCATION, Recovery Room (B_2_C26_51)",Unsecured Loans (G_C1THRU4_48),Cafeteria (A_C1_11),OSP (C_1_C7_9940),"COST REIMBURSED SERVICES NOT SUBJECT TO DEDUCTIBLES AND COINSURANCE - CHARGES, Anesthesiology (D_5_HOS_C4_53)",RHC 3 Provider Number (S2_1_C2_1502),OLTC (S3_1_C11_21),"Total Inpatient Charges, Coronary Care Unit (C_1_C6_32)",Drugs Charged to Patients (D_4_IPF_C13_73),Observation Beds (Distinct Unit) (D_4_IRF_C11_9201),Accounts Receivable (G_C1THRU4_4),Impl. Dev. Charged to Patients (C_1_C7_72),CT Scan (D3_IRF_C3_57),OSP (A_C1_9940),"ADJUSTED SALARIES, Administrative & General under contract (S3_2_C4_28)","PAID HOURS RELATED TO SALARIES, Non-Physician Part B (S3_2_C5_6)",Anesthesiology (D3_IPF_C3_53),"AVERAGE HOURLY WAGE, Housekeeping under Contract (S3_2_C6_33)","Allocation of Interns & Residents Salary and Fringes, Subprovider-IPF (B_1_C21_40)","COST SERVICES SUBJECT TO DEDUCTIBLES AND COINSURANCE - COST, Emergency (D_5_HOS_C6_91)",Speech Pathology (D_4_HOS_C3_68),Ratio of line 15 to line 16 (E_B_HOS_C1_17),HHA (B_2_C26_101),Subprovider-IPF (D_1_HOS_C6_40),Cardiac Catheterization (D3_HOS_C3_59),"HHA I, Without Outliers:  Total Visits (S4_HHA1_C1_33)",OSP (B_1_C26_9940),Home Program Dialysis (D3_SNF_C2_94),"Allocation of Interns & Residents Program Costs, NF (B_1_C22_45)",Intravenous Therapy (B_1_C26_64),"COST SERVICES NOT SUBJECT TO DEDUCTIBLES AND COINSURANCE - COST, Radioisotope (D_5_HOS_C7_56)","ADJUSTED SALARIES, Net Salaries (S3_3_C4_1)",Coronary Care Unit (S3_1_C2_9),"COST REIMBURSED SERVICES SUBJECT TO DEDUCTIBLES  AND COINSURANCE - CHARGES, CT Scan (D_5_HOS_C3_57)","PAID HOURS RELATED TO SALARIES, Other General Service (S3_2_C5_43)",CT Scan (D_4_HOS_C11_57),Other Organ Acquisition (A_C2_112),Pass Through Cost for  Program Ancillary (D1_HOS_C1_51),Burn Intensive Care Unit (S3_1_C7_10),"PPS SERVICES COST, Observation Beds (Distinct Unit) (D_5_HOS_C5_9201)",Other Special Care (S3_1_C3_12),IRF (S3_1_C6_17),"COST REIMBURSED SERVICES SUBJECT TO DEDUCTIBLES  AND COINSURANCE - CHARGES, Durable Medical Equipment Rented (D_5_HOS_C3_96)",Laboratory (D_4_HOS_C3_60),Subprovider 1 (S3_1_C2_18),"AMOUNT REPORTED, Wage Related Costs Core (S3_2_C2_17)",ASC (Non Distinct Part) (D3_IPF_C2_75),Sequestration adjustment (E_B_HOS_C1_4001),Blood Clotting Factors for Hemoph. (D3_IRF_C3_6250),Net Revenue from Medicaid (S10_C1_2),"Total Inpatient Charges, Laboratory (C_1_C6_60)",Intestinal Acquisition (B_1_C26_110),"Allocation of Interns & Residents Salary and Fringes, Radiology-Therapeutic (B_1_C21_55)","Total Outpatient Charges, Laboratory (C_1_C7_60)","HHA II, Total Number of Episodes (S4_HHA2_C5_36)",Delivery Room and Labor Room (B_1_C26_52),"Net Expense for Cost Allocation, Subprovider-IPF (B_1_C0_40)",Impl. Dev. Charged to Patients (A_C2_72),Total Program General Inp. Rtn Service (D1_SNF_C1_74),State (S2_1_C2_143),Nonpaid Workers (B_1_C26_193),"Total Outpatient Charges, Cardiac Catheterization (C_1_C7_59)",Intravenous Therapy (D3_IPF_C2_64),Total Hospital Interns & Residents (S3_1_C10_14),Private grants or donations or endowment income restricted to funding charity care (S10_C1_17),"COST REIMBURSED SERVICES SUBJECT TO DEDUCTIBLES  AND COINSURANCE - CHARGES, Ambulance Services (D_5_HOS_C3_95)",Other Special Purpose (A_C2_117),"HHA II, PEP Episodes:  Total Number of Episodes (S4_HHA2_C4_36)",Speech Pathology (D3_HOS_C2_68),Renal Dialysis (D3_IRF_C3_74),Pancreas Acquisition (C_1_C7_109),Radiology-Diagnostic (D_4_HOS_C13_54),Medical Supplies Charged to Patients (B_2_C26_71),Durable Medical Equipment Sold (D_4_HOS_C10_97),Heart Acquisition (B_1_C21_106),Total Outpatient Program Pass Thru Cost (D_4_IRF_C6_200),Drugs Charged to Patients (D3_IPF_C3_73),RHC 1 Provider Number (S2_1_C2_15),OOT (C_1_C7_9930),RHC 10 Provider Number (S2_1_C2_1509),"Net Expense for Cost Allocation, Liver Acquisition (B_1_C0_107)",ASC (Distinct Part) (B_1_C21_115),Operating Room (C_1_C5_50),"Fully Depreciated Assets, Total (A7_1_C7_10)","ADJUSTED SALARIES, Subtotal Wage Related Csts (S3_3_C4_5)",Other Special Care (S3_1_C8_12),Renal Dialysis (D_4_HOS_C2_74),Intravenous Therapy (D_4_HOS_C4_64),Operating Room (D_4_SNF_C11_50),"HHA II, Without Outliers:  Total Visits (S4_HHA2_C1_33)",Durable Medical Equipment Rented (D3_HOS_C2_96),MRI (A_C2_58),Recovery Room (D3_SNF_C3_51),Out of State Medicaid paid days (S2_1_C3_24),Physical Therapy (D_4_HOS_C13_66),"COST REIMBURSED SERVICES SUBJECT TO DEDUCTIBLES  AND COINSURANCE - CHARGES, Total (D_5_HOS_C3_200)",OLTC (S3_1_C9_21),"Net Expense for Cost Allocation, Operation of Plant (B_1_C0_7)",HHA 3 Provider Number (S2_1_C2_1202),"PPS REIMBURSED SERVICES -  CHARGES, Whole Blood & Packed Red Blood Cells (D_5_HOS_C2_62)",RHC (B_1_C22_88),Does the hospital elect a fully prospective payment method for capital costs? (Y/N) (S2_1_C1_48),"HHA III, W/Out Outliers:  Number of Episodes (S4_HHA3_C1_36)",Other Reimbursable (D_4_HOS_C2_98),Renal Dialysis (B_1_C26_74),"PPS SERVICES COST, Other Reimbursable (D_5_HOS_C5_98)","PPS REIMBURSED SERVICES -  CHARGES, Emergency (D_5_HOS_C2_91)",Research (A_C6_191),"Interest, Total (A7_3_C11_3)",Hospital Adults & Pediatrics (S3_1_C2_1),"TOTAL CAPITAL COSTS AFTER COST ALLOCATION, NF (B_2_C26_45)",Operating Room (D3_IPF_C2_50),Clinic (D_4_HOS_C3_90),Radioisotope (A_C6_56),"Gift, Flower, Coffee Shop, Canteen (B_1_C21_190)",Drugs Charged to Patients (A_C6_73),"Total Inpatient Charges, CT Scan (C_1_C6_57)",Other Outpatient Services (D_4_SNF_C11_93),Emergency (D_4_HOS_C10_91),"Percentage of patients re-using
dialyzers (S5_C1_10)",Occupational Therapy (A_C6_67),OPT (B_2_C26_9920),Electrocardiology (B_2_C26_69),"HHA I, Total Non Routine Medical  Supply Charges (S4_HHA1_C5_38)",Electroencephalography (D3_IRF_C3_70),Recovery Room (A_C2_51),Renal Dialysis (A_C2_74),Islet Acquisition (A_C6_111),Geographic MSA (MSA),Laboratory (C_1_C5_60),Laboratory (D3_SNF_C3_60),Total unreimbursed and uncompensated care (S10_C1_31),"HHA II, Total Charges (S4_HHA2_C5_35)",Laundry and Linen Service (A_C2_8),Pass through Cost for Program Inpatient (D1_IPF_C1_50),PBP Clinical Lab Services Program Only (A_C6_61),Cardiac Catheterization (A_C6_59),Int & Res (non approved teaching program (B_2_C26_100),"Total, Total (A7_3_C15_3)","AMOUNT REPORTED, Related  Salaries (S3_2_C2_1402)",Pass through Cost for Program Inpatient Routine (D1_HOS_C1_50),Other Outpatient Services (D3_IPF_C2_93),"Net Expense for Cost Allocation, Maintenance of Personnel (B_1_C0_12)",Medical and Other Services reimbursed by OPPS (E_B_HOS_C101_2),"ADJUSTED SALARIES, Non-Physician Part B (S3_2_C4_6)",Total Costs (D_3_HOS_C5_200),Lung  Acquisition (B_1_C22_108),Title V discharges (S3_1_C12_1),"Net Expense for Cost Allocation, Intestinal Acquisition (B_1_C0_110)","Net Expense for Cost Allocation, OPT (B_1_C0_9920)","Number of patients in program at 
end of cost reporting period (S5_C6_1)",Heart Acquisition (B_2_C26_106),"COST SERVICES SUBJECT TO DEDUCTIBLES AND COINSURANCE - COST, Anesthesiology (D_5_HOS_C6_53)",MRI (A_C6_58),Total cost (E_B_HOS_C1_11),Renal Dialysis (D_4_IRF_C13_74),Other General Service (A_C6_18),Electroencephalography (A_C2_70),"AMOUNT REPORTED, Contract Labor (S3_2_C2_11)",Medical and Other Services (E_B_HOS_C1_1),"HHA III, With Outliers:  Number of Episodes (S4_HHA3_C2_37)",Organ Procurement (D4_PANCREAS_C1_69),Emergency (D_4_HOS_C3_91),"Total Inpatient Charges, Adults & Pediatrics (C_1_C6_30)","Allocation of Interns & Residents Salary and Fringes, Surgical Intensive Care Unit (B_1_C21_34)",Clinic (A_C6_90),Cardiac Catheterization (A_C2_59),Other Outpatient Services (D3_SNF_C3_93),"AVERAGE HOURLY WAGE, Medical Records & Med Records Library (S3_2_C6_41)",IPF Provider Number (S2_1_C2_4),Intensive Care Unit (S3_1_C2_8),"PPS REIMBURSED SERVICES -  CHARGES, Speech Pathology (D_5_HOS_C2_68)",Operating Room (A_C1_50),Total Other Income (G3_C1_25),"PPS SERVICES COST, Durable Medical Equipment Sold (D_5_HOS_C5_97)",Other Organ Acquisition (B_1_C22_112),"Net Expense for Cost Allocation, PBP Clinical Lab Services Program Only (B_1_C0_61)","PPS SERVICES COST, Clinic (D_5_HOS_C5_90)",Drugs Charged to Patients (D3_HOS_C3_73),"TOTAL CAPITAL COSTS AFTER COST ALLOCATION, Cardiac Catheterization (B_2_C26_59)",ASC (Distinct Part) (A_C1_115),Burn Intensive Care Unit (A_C2_33),Total Facility FTEs (S3_1_C11_27),Kidney Acquisition (B_1_C26_105),Occupational Therapy (C_1_C5_67),CMHC (C_1_C7_99),"General Inpatient Routine Service Cost, net of Swing Bed and Private Room Diff (D1_IRF_C1_37)",Line 2 times line 5 (E_B_HOS_C101_6),Hospital Street Address (S2_1_C1_1),RHC 25 Provider Number (S2_1_C2_1524),Total (D_1_HOS_C7_200),"PPS REIMBURSED SERVICES -  CHARGES, Clinic (D_5_HOS_C2_90)",Other Outpatient Services (D_4_IPF_C11_93),"COST SERVICES NOT SUBJECT TO DEDUCTIBLES AND COINSURANCE - COST, Cardiac Catheterization (D_5_HOS_C7_59)",Program Inpatient Ancillary Service Cost (D1_IPF_C1_48),Other Outpatient Services (D3_IRF_C2_93),"TOTAL CAPITAL COSTS AFTER COST ALLOCATION, Subprovider-IRF (B_2_C26_41)","Allocation of Interns & Residents Program Costs, Operating Room (B_1_C22_50)",Clinic (D_4_IRF_C13_90),Laboratory (D3_HOS_C3_60),"HHA III, Total Visits (S4_HHA3_C5_33)","Net Expense for Cost Allocation, Other Ancillary (B_1_C0_76)","COST SERVICES NOT SUBJECT TO DEDUCTIBLES AND COINSURANCE - COST, Blood Clotting Factors for Hemoph. (D_5_HOS_C7_6250)",Islet Acquisition (B_1_C22_111),Emergency (D3_IPF_C3_91),Durable Medical Equipment Rented (D3_HOS_C3_96),Intestinal Acquisition (A_C1_110),Radiology-Therapeutic (D3_IRF_C3_55),IPF (S3_1_C7_16),ASC (Non Distinct Part) (D_4_HOS_C13_75),Total discharges (S3_1_C15_16),Durable Medical Equipment Rented (D3_IRF_C3_96),"TOTAL CAPITAL COSTS AFTER COST ALLOCATION, MRI (B_2_C26_58)",Radiology-Therapeutic (D_4_HOS_C13_55),"PPS SERVICES COST, CT Scan (D_5_HOS_C5_57)","Blood Storing, Processing, Trans (D_4_IPF_C13_63)","TOTAL CAPITAL COSTS AFTER COST ALLOCATION, Subprovider II (B_2_C26_4201)",Cardiac Catheterization (D3_IRF_C2_59),"ADJUSTED SALARIES, Employee Benefits (S3_2_C4_26)","Average patient dialysis time 
including setup (S5_C2_3)",Operating Room (D_4_HOS_C4_50),Ending Date of SCH status (S2_1_C2_3601),Delivery Room and Labor Room (D_4_HOS_C2_52),"COST SERVICES SUBJECT TO DEDUCTIBLES AND COINSURANCE - COST, Total (D_5_HOS_C6_200)",New Capital Buildings and Fixtures (A_C6_1),Lung  Acquisition (B_1_C21_108),"Blood Storing, Processing, Trans (C_1_C6_63)",ASC (Non Distinct Part) (D3_HOS_C2_75),Other Reimbursable (C_1_C5_98),"PPS SERVICES COST, Total (D_5_HOS_C5_200)",Other Nonreimbursable (A_C1_194),Kidney Acquisition (C_1_C7_105),Coronary Care Unit (S3_1_C7_9),Other Organ Acquisition (B_2_C26_112),Medical Records and Medical Rec. Library (A_C2_16),"Allocation of Interns & Residents Program Costs, Delivery Room and Labor Room (B_1_C22_52)",Surgical Intensive Care Unit (B_1_C26_34),SNF (S3_1_C2_19),Physical Therapy (D3_IPF_C3_66),"HHA II, LUPA Episodes:  Other Charges (S4_HHA2_C3_34)","Net Expense for Cost Allocation, Radiology-Therapeutic (B_1_C0_55)","Net Expense for Cost Allocation, FQHC (B_1_C0_89)","PAID HOURS RELATED TO SALARIES, Admin & Gen Under Contract (S3_2_C5_29)",State or local govt (not Medicaid or CHIP) -- Costs minus net revenue (0 min) (S10_C1_16),"AVERAGE HOURLY WAGE, Home Office Personnel (S3_2_C6_8)",FQHC (B_1_C22_89),NF (S3_1_C3_20),HHA (S3_1_C8_22),MRI (D3_IRF_C2_58),Medical Supplies Charged to Patients (D_4_IRF_C13_71),Impl. Dev. Charged to Patients (D3_IRF_C2_72),Other Ancillary (C_1_C6_76),"Number of patients in program at 
end of cost reporting period (S5_C4_1)","HHA I, Total Number of Episodes (S4_HHA1_C5_36)","Insurance, New Cap Related Csts Bldg & Fixtures (A7_3_C5_1)","TOTAL CAPITAL COSTS AFTER COST ALLOCATION, Adults & Pediatrics (B_2_C26_30)",Recovery Room (A_C1_51),Total (D_4_IRF_C11_200),Delivery Room and Labor Room (D3_SNF_C3_52),"PAID HOURS RELATED TO SALARIES, Contract Labor:  Physician Part A (S3_2_C5_13)",Payments received from patients for amounts previously written off as charity care (S10_C1_22),"Net Expense for Cost Allocation, Nursery (B_1_C0_43)","ADJUSTED SALARIES, Dietary under contract (S3_2_C4_35)","Gift, Flower, Coffee Shop, Canteen (B_2_C26_190)","Fully Depreciated Assets, Begin Balance (A7_1_C1_7)",Radiology-Diagnostic (B_1_C26_54),Ancillary service other pass through costs (E_B_HOS_C1_9),Total Other Assets (G_C1THRU4_35),Nonpaid Workers (B_1_C22_193),"HHA I, PEP Episodes:  Other Charges (S4_HHA1_C4_34)",Nursing School (A_C1_20),Cross Foot Adjustments (B_2_C26_200),Other Ancillary (D_4_HOS_C3_76),Total (D_1_HOS_C4_200),"AVERAGE HOURLY WAGE, Teaching Physician Salaries (S3_2_C6_16)","ADJUSTED SALARIES, Medical Records & Med Records Library (S3_2_C4_41)","AVERAGE HOURLY WAGE, Physician-Part B (S3_2_C6_5)",Pancreas Acquisition (B_1_C21_109),"Net Expense for Cost Allocation, Respiratory Therapy (B_1_C0_65)",Emergency (D_4_SNF_C11_91),RHC 23 Provider Number (S2_1_C2_1522),"AMOUNT REPORTED, Interns & Residents (S3_2_C2_2552)","PAID HOURS RELATED TO SALARIES, Subtotal Other Wages and Related Csts (S3_3_C5_4)",Coronary Intensive Care Unit (D_1_HOS_C7_32),Electrocardiology (D3_SNF_C3_69),"HHA III, Without Outliers:  Non Routine Med Sup Chgs (S4_HHA3_C1_38)",IPF Provider Number (S2_1_C1_4),Drugs Charged to Patients (D_4_HOS_C4_73),Pass Through Cost for  Program Ancillary (D1_IPF_C1_51),Net Patient Revenue (G3_C1_3),"TOTAL CAPITAL COSTS AFTER COST ALLOCATION, Coronary Care Unit (B_2_C26_32)",Operating Room (D_4_IRF_C13_50),"Allocation of Interns & Residents Program Costs, Radioisotope (B_1_C22_56)","Net Expense for Cost Allocation, Other General Service (B_1_C0_18)","HHA I, Total Visits (S4_HHA1_C5_33)",Subprovider II (A_C6_4201),Total Bad Debt expense (S10_C1_26),Physical Therapy (D_4_IPF_C11_66),Other Outpatient Services (D_4_IRF_C13_93),"COST SERVICES NOT SUBJECT TO DEDUCTIBLES AND COINSURANCE - COST, Recovery Room (D_5_HOS_C7_51)","ADJUSTED SALARIES, Social Service (S3_2_C4_42)",Emergency (D3_SNF_C3_91),Intestinal Acquisition (B_2_C26_110),Lung  Acquisition (A_C2_108),"Purchases, Building Improvements (A7_1_C2_4)",Respiratory Therapy (D3_IPF_C2_65),"AMOUNT REPORTED, Social Service (S3_2_C2_42)","COST REIMBURSED SERVICES SUBJECT TO DEDUCTIBLES  AND COINSURANCE - CHARGES, Medical Supplies Charged to Patients (D_5_HOS_C3_71)","COST SERVICES SUBJECT TO DEDUCTIBLES AND COINSURANCE - COST, Whole Blood & Packed Red Blood Cells (D_5_HOS_C6_62)","ADJUSTED SALARIES, Other General Service (S3_2_C4_43)","COST REIMBURSED SERVICES SUBJECT TO DEDUCTIBLES  AND COINSURANCE - CHARGES, PBP Clinical Lab Services Program Only (D_5_HOS_C3_61)",Electroencephalography (D_4_HOS_C10_70),"COST REIMBURSED SERVICES SUBJECT TO DEDUCTIBLES  AND COINSURANCE - CHARGES, Radiology-Therapeutic (D_5_HOS_C3_55)",Physical Therapy (D_4_IPF_C13_66),Occupational Therapy (C_1_C6_67),Cost of physicians svcs in a teaching hospita (E_B_HOS_C1_23),Total customary charges (E_B_HOS_C1_18),Laboratory (D3_IPF_C3_60),Electroencephalography (D_4_HOS_C12_70),Fiscal Year End Date (FY_END_DT),"COST SERVICES NOT SUBJECT TO DEDUCTIBLES AND COINSURANCE - COST, Operating Room (D_5_HOS_C7_50)",TOTAL (D3_IRF_C2_200),"HHA II, Without Outliers:  Non Routine Med Sup Chgs (S4_HHA2_C1_38)",Laundry and Linen Service (A_C6_8),Int & Res (non approved teaching program (B_1_C26_100),Speech Pathology (D_4_IPF_C11_68),Radiology-Therapeutic (D_4_HOS_C4_55),Clinic (C_1_C6_90),Cardiac Catheterization (D3_IRF_C3_59),"Blood Storing, Processing, Trans (D3_HOS_C2_63)",Transitional corridor payment (E_B_HOS_C1_8),Number of stations (S5_C1_6),Intravenous Therapy (D_4_IRF_C11_64),"Net Expense for Cost Allocation, Subprovider II (B_1_C0_4201)",Occupational Therapy (D_4_HOS_C12_67),MRI (D_4_IRF_C11_58),Inventory (G_C1THRU4_7),Vending Machines (A8_C2_20),Other Organ Acquisition (B_1_C21_112),Adults and Pediatrics (D3_HOS_C2_30),"Total Inpatient Charges, Blood Clotting Factors for Hemoph. (C_1_C6_6250)","AMOUNT REPORTED, Nursing Administration (S3_2_C2_38)",Renal Dialysis (D3_SNF_C3_74),"PPS SERVICES COST, Radiology-Diagnostic (D_5_HOS_C5_54)","COST SERVICES NOT SUBJECT TO DEDUCTIBLES AND COINSURANCE - COST, Clinic (D_5_HOS_C7_90)","HHA I, With Outliers:  Total Charges (S4_HHA1_C2_35)",RHC 2 Provider Number (S2_1_C2_1501),IRF (S3_1_C5_17),Blood Clotting Factors for Hemoph. (A_C6_6250),Electroencephalography (D3_IPF_C3_70),Radiology-Diagnostic (D_4_HOS_C11_54),ASC (Distinct Part) (B_1_C22_115),Other Current Liabilities (G_C1THRU4_44),Adults & Pediatrics (D_1_HOS_C7_30),Interns and residents (E_B_HOS_C1_22),Intensive Care Unit (S3_1_C4_8),Emergency (C_1_C6_91),"AMOUNT REPORTED, Physician Part A (S3_2_C3_22)",Electroencephalography (D_4_HOS_C3_70),"COST REIMBURSED SERVICES NOT SUBJECT TO DEDUCTIBLES AND COINSURANCE - CHARGES, Clinic (D_5_HOS_C4_90)","PPS REIMBURSED SERVICES -  CHARGES, Observation Beds (Distinct Unit) (D_5_HOS_C2_9201)",City (S2_1_C1_143),"COST REIMBURSED SERVICES NOT SUBJECT TO DEDUCTIBLES AND COINSURANCE - CHARGES, Renal Dialysis (D_5_HOS_C4_74)","Number of patients on transplant 
list (S5_C1_11)","COST REIMBURSED SERVICES SUBJECT TO DEDUCTIBLES  AND COINSURANCE - CHARGES, Intravenous Therapy (D_5_HOS_C3_64)",Adj for Speech therapy in excess of lim (A8_C2_31),Other Organ Acquisition (C_1_C7_112),HHA (S3_1_C10_22),"Net Expense for Cost Allocation, Lung  Acquisition (B_1_C0_108)",Durable Medical Equipment Rented (D3_SNF_C2_96),Radiology-Therapeutic (A_C6_55),NF (S3_1_C11_20),Outpatient Rehab Provider (S3_1_C11_25),RHC (A_C6_88),Other Ancillary (D_4_IPF_C13_76),Speech Pathology (C_1_C5_68),Observation Beds (Distinct Unit) (B_2_C26_9201),"Total Inpatient Charges, Anesthesiology (C_1_C6_53)","AMOUNT REPORTED, Subtotal Other Wages and Related Csts (S3_3_C2_4)",Home Program Dialysis (B_1_C22_94),"PPS REIMBURSED SERVICES -  CHARGES, Physical Therapy (D_5_HOS_C2_66)",Hospital Adults & Pediatrics (S3_1_C8_1),"ADJUSTED SALARIES, Contract Labor:  Physician Part A (S3_2_C4_13)",NF (S3_1_C2_20),"Number of patients transplanted 
during fiscal year (S5_C1_12)","AMOUNT REPORTED, Excluded Area Salaries (S3_3_C2_2)",RHC (D_4_HOS_C2_88),Blood Clotting Factors for Hemoph. (C_1_C5_6250),Durable Medical Equipment Sold (D_4_HOS_C3_97),HHA (C_1_C7_101),Delivery Room and Labor Room (D3_IRF_C2_52),RHC 14 Provider Number (S2_1_C2_1513),Other Outpatient Services (A_C1_93),CORF (A_C6_9910),Impl. Dev. Charged to Patients (D3_IPF_C3_72),"Blood Storing, Processing, Trans (D3_IRF_C2_63)","Net costs of Epoietin furnished to
all maintenance dialysis patients
by the provider (S5_C1_13)","COST REIMBURSED SERVICES SUBJECT TO DEDUCTIBLES  AND COINSURANCE - CHARGES, Other Ancillary (D_5_HOS_C3_76)",Provider's actual MSA or CBSA (S2_1_C3_3),Int & Res (non approved teaching program (A_C1_100),Intravenous Therapy (A_C6_64),Electrocardiology (C_1_C7_69),"Total Inpatient Charges, Burn Intensive Care Unit (C_1_C6_33)",Other Reimbursable (A_C2_98),Kidney Acquisition (B_1_C21_105),Radioisotope (D_4_IPF_C11_56),Interns & Res Salary and Fringe Benefits (A_C1_21),RHC 19 Provider Number (S2_1_C2_1518),Emergency (D_4_HOS_C4_91),"COST SERVICES SUBJECT TO DEDUCTIBLES AND COINSURANCE - COST, Radiology-Diagnostic (D_5_HOS_C6_54)",Radiology-Diagnostic (D_4_HOS_C2_54),SNF (S3_1_C10_19),Durable Medical Equipment Rented (C_1_C6_96),Electrocardiology (D_4_IRF_C13_69),Intravenous Therapy (D_4_HOS_C3_64),Electroencephalography (D_4_IPF_C13_70),"Net Expense for Cost Allocation, OSP (B_1_C0_9940)",Whole Blood & Packed Red Blood Cells (D_4_IRF_C11_62),Sale of drugs to other than patients (A8_C2_17),Other Nonreimbursable (B_1_C21_194),"TOTAL CAPITAL COSTS AFTER COST ALLOCATION, Surgical Intensive Care Unit (B_2_C26_34)",Anesthesiology (D3_SNF_C3_53),"Net Expense for Cost Allocation, Other Outpatient Services (B_1_C0_93)",Cost of patients approved for charity care and uninsured discounts (S10_C1_21),Other Reimbursable (C_1_C6_98),Other Capital (A_C6_3),MRI (D_4_HOS_C11_58),Employee Benefits (A_C2_4),"PPS SERVICES COST, Drugs Charged to Patients (D_5_HOS_C5_73)",OOT (A_C6_9930),"AMOUNT REPORTED, Wage Related Costs RHC/FQHC (S3_2_C3_24)","Net Expense for Cost Allocation, Durable Medical Equipment Sold (B_1_C0_97)",Provider-based physician adjustment (A8_C2_10),Physical Therapy (D_4_HOS_C2_66),"TOTAL CAPITAL COSTS AFTER COST ALLOCATION, Subprovider-IPF (B_2_C26_40)","PPS REIMBURSED SERVICES -  CHARGES, Laboratory (D_5_HOS_C2_60)",Impl. Dev. Charged to Patients (C_1_C5_72),Surgical Intensive Care Unit (S3_1_C2_11),Intravenous Therapy (D_4_HOS_C10_64),"Blood Storing, Processing, Trans (A_C6_63)","AVERAGE HOURLY WAGE, Central Services and Supply (S3_2_C6_39)",Renal Dialysis (D_4_IPF_C13_74),"HHA II, Total Number of Outlier Episodes (S4_HHA2_C5_37)",CT Scan (D3_IPF_C2_57),Other Assets (G_C1THRU4_34),Respiratory Therapy (D3_HOS_C3_65),"ADJUSTED SALARIES, Subtotal Other Wages and Related Csts (S3_3_C4_4)",Emergency (A_C2_91),Speech Pathology (D_4_IRF_C13_68),Emergency (D3_SNF_C2_91),ASC (Non Distinct Part) (D_4_HOS_C3_75),Subprovider 1 (S3_1_C3_18),Medical Records and Medical Rec. Library (A_C1_16),"HHA III, Total Number of Episodes (S4_HHA3_C5_36)",Physical Therapy (D_4_HOS_C10_66),Whole Blood & Packed Red Blood Cells (D_4_HOS_C2_62),ASC (Non Distinct Part) (D_4_HOS_C2_75),"Fully Depreciated Assets, Disp. And Retirement (A7_1_C5_7)","Allocation of Interns & Residents Salary and Fringes, Respiratory Therapy (B_1_C21_65)",New Capital Equipment (A_C2_2),Whole Blood & Packed Red Blood Cells (A_C2_62),Allowable bad debts (E_B_HOS_C1_34),"PPS SERVICES COST, Electroencephalography (D_5_HOS_C5_70)",Total Program Inpatient Costs (D1_HOS_C1_49),"Blood Storing, Processing, Trans (D_4_HOS_C12_63)",Occupational Therapy (D_4_HOS_C2_67),Cost of charity care (S10_C3_23),"Total Inpatient Charges, Cardiac Catheterization (C_1_C6_59)",CMS Region Code (REGION),Subprovider-IPF (A_C1_40),"HHA II, With Outliers:  Non Routine Med Sup Chgs (S4_HHA2_C2_38)",Major Movable Equipment (G_C1THRU4_23),Central Services and Supply (A_C1_14),"Allocation of Interns & Residents Salary and Fringes, Burn Intensive Care Unit (B_1_C21_33)","Net Expense for Cost Allocation, OOT (B_1_C0_9930)",FQHC 6 Provider Number (S2_1_C2_1605),Other Reimbursable (D_4_HOS_C13_98),OPPS payments (E_B_HOS_C101_3),Medical Supplies Charged to Patients (D3_HOS_C3_71),"ADJUSTED SALARIES, Maintenance of Personnel (S3_2_C4_37)",Total Facility FTEs (S3_1_C10_27),Radioisotope (D_4_IRF_C13_56),"COST REIMBURSED SERVICES NOT SUBJECT TO DEDUCTIBLES AND COINSURANCE - CHARGES, Operating Room (D_5_HOS_C4_50)","Net Expense for Cost Allocation, RHC (B_1_C0_88)","COST SERVICES SUBJECT TO DEDUCTIBLES AND COINSURANCE - COST, Medical Supplies Charged to Patients (D_5_HOS_C6_71)","HHA II, LUPA:  Total Non Routine Med Sup Chgs (S4_HHA2_C3_38)",Electrocardiology (A_C1_69),"ADJUSTED SALARIES, Operation of Plant (S3_2_C4_30)",MRI (D3_HOS_C3_58),"HHA II, PEP:  Total Non Routine Med Supply Chgs (S4_HHA2_C4_38)",MRI (D3_IPF_C3_58),Clinic (B_2_C26_90),Anesthesiology (B_1_C26_53),Observation Beds (Distinct Unit) (D3_SNF_C2_9201),RHC/FQHC Combined (S3_1_C11_26),RHC (B_1_C21_88),Radiology-Diagnostic (D3_HOS_C2_54),"TOTAL CAPITAL COSTS AFTER COST ALLOCATION, ICF (B_2_C26_4501)",Intestinal Acquisition (C_1_C6_110),Total Nonphysician Anesthetist Cost (D_4_IRF_C1_102),Recovery Room (D3_IPF_C2_51),Drugs Charged to Patients (D_4_HOS_C12_73),Title V discharges (S3_1_C12_14),"AMOUNT REPORTED, Total Salaries (S3_2_C2_1)",Durable Medical Equipment Rented (A_C2_96),"Net Expense for Cost Allocation, Intravenous Therapy (B_1_C0_64)",Recovery Room (D_4_IPF_C11_51),"COST REIMBURSED SERVICES SUBJECT TO DEDUCTIBLES  AND COINSURANCE - CHARGES, MRI (D_5_HOS_C3_58)",Subprovider-IRF (D3_SNF_C2_41),Other Ancillary (D3_IRF_C2_76),"Taxes, New Cap Related Csts Bldg & Fixtures (A7_3_C6_1)","General Inpatient Routine Service Cost, net of Swing Bed Cost (D1_IRF_C1_27)",Observation Beds (Distinct Unit) (D_4_HOS_C3_9201),Hospice (A_C2_116),NF (S3_1_C8_20),"Net Expense for Cost Allocation, Blood Clotting Factors for Hemoph. (B_1_C0_6250)","Allocation of Interns & Residents Program Costs, Surgical Intensive Care Unit (B_1_C22_34)","COST REIMBURSED SERVICES NOT SUBJECT TO DEDUCTIBLES AND COINSURANCE - CHARGES, Delivery Room and Labor Room (D_5_HOS_C4_52)",Durable Medical Equipment Rented (C_1_C5_96),MRI (D_4_HOS_C12_58),PBP Clinical Lab Services Program Only (B_1_C26_61),FQHC 2 Provider Number (S2_1_C2_1601),Other Ancillary (D3_IPF_C3_76),Radiology-Therapeutic (D3_HOS_C2_55),HHA (S3_1_C6_22),Coronary Intensive Care Unit (D_1_HOS_C6_32),Radioisotope (D3_IRF_C3_56),Impl. Dev. Charged to Patients (C_1_C6_72),Interest Expense (A_C2_113),Respiratory Therapy (D_4_HOS_C12_65),TOTAL (D3_IPF_C3_200),Pharmacy (A_C2_15),Drugs Charged to Patients (D3_HOS_C2_73),NF (A_C6_45),"Allocation of Interns & Residents Salary and Fringes, Electroencephalography (B_1_C21_70)",Title XVIII discharges (S3_1_C13_18),"AMOUNT REPORTED, Housekeeping under contract (S3_2_C2_33)","AVERAGE HOURLY WAGE, Administrative and General (S3_2_C6_27)",Total Nursing School (D_4_IPF_C2_200),Renal 6 Provider Number (S2_1_C2_1805),"If this Hospital is claiming cost for renal services on Worksheet A, are they inpatient services only? (Y/N) (S2_1_C1_145)",Islet Acquisition (B_1_C26_111),Hospice (C_1_C6_116),Delivery Room and Labor Room (D_4_SNF_C11_52),ESRD DME costs (E_B_HOS_C1_29),Cash on Hand and in Banks (G_C1THRU4_1),"AVERAGE HOURLY WAGE, Other General Service (S3_2_C6_43)","AMOUNT REPORTED, Subtotal Wage Related Csts (S3_3_C2_5)",Intensive Care Unit (D_3_HOS_C9_31),Intravenous Therapy (D3_IPF_C3_64),Whole Blood & Packed Red Blood Cells (D_4_HOS_C11_62),Drugs Charged to Patients (D_4_HOS_C11_73),Other Reimbursable (D3_SNF_C2_98),Impl. Dev. Charged to Patients (D_4_IPF_C13_72),"TOTAL CAPITAL COSTS AFTER COST ALLOCATION, Delivery Room and Labor Room (B_2_C26_52)",Recovery Room (C_1_C5_51),HAC reduction adjustment amount (E_A_HOS_C1_7099),Radiology-Therapeutic (D_4_IRF_C13_55),Liver Acquisition (C_1_C5_107),Burn Intensive Care Unit (D_1_HOS_C7_33),Respiratory Therapy (D_4_HOS_C11_65),"General Inpatient Routine Service Cost, net of Swing Bed Cost (D1_IPF_C1_27)",IRF Provider Number (S2_1_C2_5),Radiology-Diagnostic (D_4_IRF_C11_54),Title XVIII discharges (S3_1_C13_2),"Allocation of Interns & Residents Program Costs, Anesthesiology (B_1_C22_53)",RHC 4 Provider Number (S2_1_C2_1503),"AVERAGE HOURLY WAGE, Interns & Residents (S3_2_C6_7)",Durable Medical Equipment Rented (D_4_HOS_C3_96),"HHA III, Without Outliers:  Total Visits (S4_HHA3_C1_33)",Intensive Care Unit (A_C1_31),Laboratory (D_4_IPF_C13_60),Laundry and Linen Service (A_C1_8),Radiology-Diagnostic (D3_SNF_C3_54),Observation Beds (Distinct Unit) (D_4_HOS_C2_9201),Subprovider I (A_C6_42),Gross Revenue (G3_C1_1),"Allocation of Interns & Residents Program Costs, Physical Therapy (B_1_C22_66)",Laboratory (D_4_IPF_C11_60),Drugs Charged to Patients (A_C1_73),"HHA III, PEP:  Total Non Routine Med Supply Chgs (S4_HHA3_C4_38)","COST SERVICES SUBJECT TO DEDUCTIBLES AND COINSURANCE - COST, Delivery Room and Labor Room (D_5_HOS_C6_52)",Surgical Intensive Care Unit (D_1_HOS_C4_34),HHA (C_1_C6_101),Medicare allowable bad debts for the entire hospital complex (S10_C1_2701),Medical Supplies Charged to Patients (D3_IRF_C3_71),Total (B_2_C26_202),Medicaid (Title XIX) discharges (S3_1_C14_14),RHC (B_2_C26_88),Hospital Type (S2_1_C4_3),"If Line 32, Col 1 is yes, enter the method used: (A, B, or E only) (S2_1_C2_115)",Subprovider-IPF (D_1_HOS_C4_40),Radiology-Therapeutic (D_4_HOS_C10_55),Renal Dialysis (D3_IPF_C3_74),"Total Inpatient Charges, Radiology-Diagnostic (C_1_C6_54)","If an Organ Procurement Organization, enter the OPO number (S2_1_C1_134)",Durable Medical Equipment Sold (D_4_HOS_C12_97),Total (D_4_IPF_C11_200),Emergency (A_C1_91),Speech Pathology (D3_IPF_C3_68),"COST REIMBURSED SERVICES NOT SUBJECT TO DEDUCTIBLES AND COINSURANCE - CHARGES, Other Reimbursable (D_5_HOS_C4_98)",Coronary Care Unit (A_C6_32),Electroencephalography (D3_IRF_C2_70),"ADJUSTED SALARIES, Physician-Part B (S3_2_C4_5)","AVERAGE HOURLY WAGE, SNF (S3_2_C6_9)","Beginning Balances, Movable Equipment (A7_1_C1_6)","AMOUNT REPORTED, Subtotal Salaries (S3_3_C2_3)",Radiology-Therapeutic (D_4_SNF_C11_55),Intensive Care Unit (D3_SNF_C2_31),Whole Blood & Packed Red Blood Cells (D3_HOS_C2_62),"Allocation of Interns & Residents Salary and Fringes, Physical Therapy (B_1_C21_66)",Subprovider-IRF (D_1_HOS_C4_41),"Depreciation, Total (A7_3_C9_3)","COST SERVICES SUBJECT TO DEDUCTIBLES AND COINSURANCE - COST, Drugs Charged to Patients (D_5_HOS_C6_73)",Dietary (A_C1_10),"Average patient dialysis time 
including setup (S5_C3_3)","Allocation of Interns & Residents Salary and Fringes, Cardiac Catheterization (B_1_C21_59)",ASC (Non Distinct Part) (A_C6_75),Laboratory (A_C6_60),"Allocation of Interns & Residents Program Costs, Burn Intensive Care Unit (B_1_C22_33)","AMOUNT REPORTED, Physician-Part A (S3_2_C2_4)",Primary payer payments (E_B_HOS_C1_31),Physical Therapy (A_C2_66),Liver Acquisition (A_C6_107),"Net Expense for Cost Allocation, Occupational Therapy (B_1_C0_67)",Speech Pathology (B_1_C26_68),Subprovider-IPF (D_3_HOS_C9_40),Radioisotope (D_4_HOS_C2_56),Less: Allowances for uncollectible notes and accounts receivable (G_C1THRU4_6),Central Services and Supply (A_C6_14),"AVERAGE HOURLY WAGE, Subtotal Wage Related Csts (S3_3_C6_5)","ADJUSTED SALARIES, Home Office Personnel (S3_2_C4_8)","PPS REIMBURSED SERVICES -  CHARGES, Occupational Therapy (D_5_HOS_C2_67)",Total Hospital (S3_1_C3_7),Occupational Therapy (D3_IRF_C3_67),"PPS REIMBURSED SERVICES -  CHARGES, Intravenous Therapy (D_5_HOS_C2_64)",Occupational Therapy (D3_HOS_C3_67),Impl. Dev. Charged to Patients (D_4_HOS_C12_72),Delivery Room and Labor Room (D_4_HOS_C13_52),Anesthesiology (D_4_HOS_C13_53),Home Program Dialysis (C_1_C6_94),Intravenous Therapy (D_4_IPF_C11_64),Radiology-Diagnostic (D_4_SNF_C11_54),"PPS SERVICES COST, Other Ancillary (D_5_HOS_C5_76)",Operating Room (D_4_IPF_C13_50),Buildings (G_C1THRU4_15),HHA 1 Provider Number (S2_1_C2_12),Negative Cost Centers (B_1_C26_201),Total (C_1_C6_202),Anesthesiology (D_4_HOS_C12_53),"Allocation of Interns & Residents Salary and Fringes, Intravenous Therapy (B_1_C21_64)",Operation of Plant (A_C6_7),"Net Expense for Cost Allocation, Laboratory (B_1_C0_60)","Net Expense for Cost Allocation, Physical Therapy (B_1_C0_66)",Delivery Room and Labor Room (D_4_HOS_C11_52),Medicare reimbursable bad debts for the entire hospital complex (S10_C1_27),CORF (A_C2_9910),Impl. Dev. Charged to Patients (D_4_HOS_C3_72),or allied health costs? (S2_1_C1_60),HMO (S3_1_C7_2),Other Ancillary (D_4_SNF_C11_76),"PPS SERVICES COST, Medical Supplies Charged to Patients (D_5_HOS_C5_71)",Housekeeping (A_C2_9),"AMOUNT REPORTED, Contract Labor: Pysician Part A (S3_2_C2_13)",Other Long-term Liabilities (G_C1THRU4_49),Electrocardiology (D_4_HOS_C3_69),"ADJUSTED SALARIES, Physician Part A Teaching (S3_2_C4_2201)",Radiology-Therapeutic (C_1_C5_55),"Donations, Subtotal (A7_1_C3_8)",Physical Therapy (C_1_C5_66),Coronary Intensive Care Unit (D_1_HOS_C4_32),"Depreciation, New Cap Related Csts Bldg & Fixtures (A7_3_C9_1)","HHA II, With Outliers:  Total Visits (S4_HHA2_C2_33)","COST SERVICES NOT SUBJECT TO DEDUCTIBLES AND COINSURANCE - COST, Physical Therapy (D_5_HOS_C7_66)","Total, New Cap Related Csts Movable Equipment (A7_3_C15_2)",Durable Medical Equipment Rented (B_2_C26_96),"Disposals and Retirements, Land (A7_1_C7_1)",Liver Acquisition (B_1_C22_107),RHC 24 Provider Number (S2_1_C2_1523),SSA State County Code (ST_CTY_CD),"Total Outpatient Charges, Delivery Room and Labor Room (C_1_C7_52)",Utilization Review-physicians compens (A8_C2_25),"AMOUNT REPORTED, Physician-Part B (S3_2_C2_5)","HHA II, PEP Episodes:  Total Charges: (S4_HHA2_C4_35)",Operating Room (D_4_HOS_C13_50),"General Inpatient Routine Service Cost, net of Swing Bed Cost (D1_HOS_C1_27)",Other Outpatient Services (D3_IRF_C3_93),"Net Expense for Cost Allocation, Pharmacy (B_1_C0_15)",Radioisotope (D_4_HOS_C10_56),"AMOUNT REPORTED, Non-Physician Anesthetist Part A (S3_2_C2_2)",Total Hospital (S3_1_C4_14),"ADJUSTED SALARIES, Subtotal Salaries (S3_3_C4_3)",Clinic (B_1_C26_90),"AVERAGE HOURLY WAGE, Physician-Part A (S3_2_C6_4)",FQHC (C_1_C5_89),Respiratory Therapy (D3_IRF_C2_65),Organ Procurement (D4_KIDNEY_C1_69),Utilization Code (L/N/F) (UTIL_CODE),Burn Intensive Care Unit (A_C6_33),CMHC (B_2_C26_99),RHC 22 Provider Number (S2_1_C2_1521),MRI (D_4_IPF_C11_58),"COST REIMBURSED SERVICES SUBJECT TO DEDUCTIBLES  AND COINSURANCE - CHARGES, Speech Pathology (D_5_HOS_C3_68)","PPS REIMBURSED SERVICES -  CHARGES, Renal Dialysis (D_5_HOS_C2_74)","COST SERVICES NOT SUBJECT TO DEDUCTIBLES AND COINSURANCE - COST, MRI (D_5_HOS_C7_58)",Net Income (G3_C1_29),Occupational Therapy (D3_IRF_C2_67),"Net Expense for Cost Allocation, MRI (B_1_C0_58)","TOTAL CAPITAL COSTS AFTER COST ALLOCATION, Radiology-Therapeutic (B_2_C26_55)",Emergency (D_4_HOS_C11_91),"AMOUNT REPORTED, Interns & Residents (S3_2_C2_2553)",RHC 13 Provider Number (S2_1_C2_1512),Int & Res (non approved teaching program (A_C2_100),Medical Supplies Charged to Patients (D_4_HOS_C13_71),Total Liabilities and Fund Balances (G_C1THRU4_54),OOT (A_C2_9930),Emergency (D_4_HOS_C12_91),Impl. Dev. Charged to Patients (D_4_HOS_C4_72),ASC (Non Distinct Part) (D3_HOS_C3_75),Radiology-Therapeutic (D_4_HOS_C2_55),Heart Acquisition (C_1_C6_106),Total Program Inpatient Costs (D1_IRF_C1_49),"HHA I, PEP Episodes:  Total Charges: (S4_HHA1_C4_35)",Anesthesiology (D_4_IPF_C13_53),Nonpaid Workers (A_C2_193),"COST REIMBURSED SERVICES NOT SUBJECT TO DEDUCTIBLES AND COINSURANCE - CHARGES, Physical Therapy (D_5_HOS_C4_66)",Drugs Charged to Patients (D_4_HOS_C3_73),Other Special Care Unit (D_3_HOS_C9_35),"COST REIMBURSED SERVICES SUBJECT TO DEDUCTIBLES  AND COINSURANCE - CHARGES, Physical Therapy (D_5_HOS_C3_66)","Total Inpatient Charges, Surgical Intensive Care Unit (C_1_C6_34)",Kidney Acquisition (B_2_C26_105),"PPS SERVICES COST, Operating Room (D_5_HOS_C5_50)",Other Ancillary (D_4_IPF_C11_76),"AVERAGE HOURLY WAGE, Contract Labor:  Physician Part A (S3_2_C6_13)","HHA II, Total Non Routine Medical  Supply Charges (S4_HHA2_C5_38)",Renal Dialysis (C_1_C7_74),RHC 5 Provider Number (S2_1_C2_1504),"HHA II, PEP:  Total Number of Outlier Episodes (S4_HHA2_C4_37)",Investment Income-New Bldgs & Fixtures (A8_C2_1),Intravenous Therapy (C_1_C7_64),"Purchases, Fixed Equipment (A7_1_C2_5)","AMOUNT REPORTED, Excluded Area Salaries (S3_2_C2_10)","TOTAL CAPITAL COSTS AFTER COST ALLOCATION, CT Scan (B_2_C26_57)",Intensive Care Unit (B_1_C26_31),Surgical Intensive Care Unit (C_1_C5_34),"Other Capital Related Costs, New Cap Related Csts Bldg & Fixtures (A7_3_C7_1)",Clinic (D3_HOS_C2_90),"COST SERVICES NOT SUBJECT TO DEDUCTIBLES AND COINSURANCE - COST, Medical Supplies Charged to Patients (D_5_HOS_C7_71)","Average patient dialysis time 
including setup (S5_C1_3)",Radiology-Diagnostic (D3_IRF_C3_54),CMHC (A_C2_99),Cardiac Catheterization (D_4_HOS_C3_59),Subprovider 2 (S3_1_C3_1801),Radioisotope (D3_HOS_C3_56),Other Nonreimbursable (B_2_C26_194),"AVERAGE HOURLY WAGE, Laundry and Linen Service (S3_2_C6_31)",Other Ancillary (D_4_IRF_C11_76),Operation of Plant (A_C1_7),Drugs Charged to Patients (D3_SNF_C3_73),Radiology-Therapeutic (D_4_HOS_C3_55),Subprovider-IRF (D_1_HOS_C6_41),Emergency (D_4_IPF_C11_91),"Purchases, Land (A7_1_C2_1)",RHC 11 Provider Number (S2_1_C2_1510),"Allocation of Interns & Residents Salary and Fringes, Adults and Pediatrics (B_1_C21_30)",Total (D_4_HOS_C11_200),Burn Intensive Care Unit (D_1_HOS_C4_33),Pass Through Cost for  Program Ancillary (D1_IRF_C1_51),"PAID HOURS RELATED TO SALARIES, Cafeteria (S3_2_C5_36)",Adjusted reimburseable bad debts (E_B_HOS_C1_35),OPT (C_1_C6_9920),Drugs Charged to Patients (D_4_IPF_C11_73),"Total Outpatient Charges, Radioisotope (C_1_C7_56)",FI/Contractor's Name (S2_1_C2_140),Respiratory Therapy (C_1_C7_65),"COST REIMBURSED SERVICES SUBJECT TO DEDUCTIBLES  AND COINSURANCE - CHARGES, Other Reimbursable (D_5_HOS_C3_98)",Medicaid (Title XIX) discharges (S3_1_C14_1),"COST REIMBURSED SERVICES NOT SUBJECT TO DEDUCTIBLES AND COINSURANCE - CHARGES, Recovery Room (D_5_HOS_C4_51)",Other Ancillary (C_1_C5_76),Allowable bad debts for dual eligibles beneficiaries (E_B_HOS_C1_36),Notes Receivable (G_C1THRU4_3),Title V discharges (S3_1_C12_16),Electrocardiology (D_4_HOS_C13_69),Operating Room (A_C6_50),Surgical Intensive Care Unit (S3_1_C5_11),"Net Expense for Cost Allocation, Adults and Pediatrics (B_1_C0_30)",Other Special Purpose (A_C1_117),Kidney Acquisition (A_C1_105),Radioisotope (A_C2_56),Protested amounts (E_B_HOS_C1_44),Total Other Medical Education Cost (D_3_HOS_C3_200),"HHA I, Total Charges:  LUPA Episodes (S4_HHA1_C3_35)",Home Program Dialysis (D3_HOS_C3_94),Maintenance and Repairs (A_C6_6),Whole Blood & Packed Red Blood Cells (A_C1_62),OLTC (S3_1_C8_21),"COST REIMBURSED SERVICES SUBJECT TO DEDUCTIBLES  AND COINSURANCE - CHARGES, Cardiac Catheterization (D_5_HOS_C3_59)",Intensive Care Unit (D_1_HOS_C6_31),"Total Outpatient Charges, Recovery Room (C_1_C7_51)","COST REIMBURSED SERVICES SUBJECT TO DEDUCTIBLES  AND COINSURANCE - CHARGES, Occupational Therapy (D_5_HOS_C3_67)","PAID HOURS RELATED TO SALARIES, Central Services and Supply (S3_2_C5_39)","Net Expense for Cost Allocation, Interns & Res Salary and Fringe Benefits (B_1_C0_21)",Renal 7 Provider Number (S2_1_C2_1806),Other Outpatient Services (B_1_C26_93),Respiratory Therapy (C_1_C6_65),"Salaries, Wages, and Fees Payable (G_C1THRU4_38)","HHA III, LUPA Episodes:  Total Visits (S4_HHA3_C3_33)",Cardiac Catheterization (D3_SNF_C2_59),Coronary Care Unit (D3_SNF_C2_32),"COST REIMBURSED SERVICES SUBJECT TO DEDUCTIBLES  AND COINSURANCE - CHARGES, Radiology-Diagnostic (D_5_HOS_C3_54)",Cardiac Catheterization (D3_HOS_C2_59),"TOTAL CAPITAL COSTS AFTER COST ALLOCATION, Laboratory (B_2_C26_60)",Drugs Charged to Patients (D3_SNF_C2_73),"COST REIMBURSED SERVICES NOT SUBJECT TO DEDUCTIBLES AND COINSURANCE - CHARGES, Durable Medical Equipment Rented (D_5_HOS_C4_96)",Other Special Care Unit (B_1_C26_35),"Total Outpatient Charges, Whole Blood & Packed Red Blood Cells (C_1_C7_62)",Other Ancillary (D_4_HOS_C12_76),OSP (A_C2_9940),Speech Pathology (D_4_IPF_C13_68),RHC (A_C1_88),Occupational Therapy (A_C2_67),"COST REIMBURSED SERVICES NOT SUBJECT TO DEDUCTIBLES AND COINSURANCE - CHARGES, Blood Storing, Processing, Trans (D_5_HOS_C4_63)",Cardiac Catheterization (D_4_HOS_C10_59),"Number of Times per week
 Patient receives Dialysis (S5_C6_2)",Intravenous Therapy (A_C1_64),"Net Expense for Cost Allocation, SNF (B_1_C0_44)","AMOUNT REPORTED, Dietary (S3_2_C2_34)",Drugs Charged to Patients (B_1_C21_73),Renal Dialysis (B_1_C22_74),Laboratory (D_4_SNF_C11_60),"Total Outpatient Charges, Radiology-Therapeutic (C_1_C7_55)",Other Outpatient Services (D_4_HOS_C10_93),Total Hospital Interns & Residents (S3_1_C9_14),Coronary Care Unit (A_C2_32),CT Scan (D_4_SNF_C11_57),Clinic (D_4_HOS_C10_90),Observation Beds (Distinct Unit) (D3_IPF_C2_9201),MRI (D_4_HOS_C4_58),"Net Expense for Cost Allocation, Durable Medical Equipment Rented (B_1_C0_96)",Medical Supplies Charged to Patients (C_1_C6_71),IPPS Interim payment (E_A_HOS_C1_72),Anesthesiology (A_C6_53),"Net Expense for Cost Allocation, Other Reimbursable (B_1_C0_98)",Component rate ESRD (E_B_HOS_C1_33),"HHA I, LUPA Episodes:  Total Visits (S4_HHA1_C3_33)","HHA II, Total Charges:  LUPA Episodes (S4_HHA2_C3_35)",Adj for Respiratory therapy costs in excess (A8_C2_23),CAH Visits (S3_1_C8_15),Other Outpatient Services (D_4_HOS_C13_93),OPT (A_C2_9920),Hospital Adults & Pediatrics (S3_1_C5_1),"Net Expense for Cost Allocation, Nursing Administration (B_1_C0_13)",Speech Pathology (A_C1_68),Operating Room (D3_SNF_C2_50),Program Inpatient Ancillary Service Cost (D1_IRF_C1_48),Adults & Pediatrics (D_1_HOS_C4_30),Medicare Certified Lung TC term date (S2_1_C2_129),"Allocation of Interns & Residents Program Costs, Recovery Room (B_1_C22_51)",Renal Dialysis (D3_HOS_C3_74),ASC (Distinct Part) (B_1_C26_115),Kidney Acquisition (B_1_C22_105),OLTC (S3_1_C3_21),"HHA I, PEP Episodes:  Total Number of Episodes (S4_HHA1_C4_36)",Total Hospital (S3_1_C5_7),Total Hospital (S3_1_C5_14),Respiratory Therapy (D_4_IRF_C11_65),Radioisotope (C_1_C5_56),Electrocardiology (D3_SNF_C2_69),"Net Expense for Cost Allocation, Drugs Charged to Patients (B_1_C0_73)",Title XVIII discharges (S3_1_C13_14),FQHC (C_1_C6_89),Medical Supplies Charged to Patients (D_4_IPF_C13_71),"Average patient dialysis time 
including setup (S5_C4_3)",Radiology-Diagnostic (D_4_HOS_C3_54),Speech Pathology (D3_SNF_C3_68),Charity care charges and uninsured discounts for the entire facility (S10_C3_20),Physical Therapy (D_4_SNF_C11_66),"TOTAL CAPITAL COSTS AFTER COST ALLOCATION, Blood Clotting Factors for Hemoph. (B_2_C26_6250)","COST REIMBURSED SERVICES NOT SUBJECT TO DEDUCTIBLES AND COINSURANCE - CHARGES, Occupational Therapy (D_5_HOS_C4_67)",Hospice (S3_1_C6_24),"Treatment capacity per day per
station (S5_C2_7)",IRF (S3_1_C2_17),ASC (Non Distinct Part) (D_4_HOS_C10_75),Observation Beds (Distinct Unit) (D_4_HOS_C11_9201),MRI (D3_IPF_C2_58),"Blood Storing, Processing, Trans (D_4_IRF_C11_63)",Physical Therapy (D3_IRF_C3_66),"Total Program Inpatient Operating Cost excluding Capital Related, Nonphysician, Anesthetist, and Medical Education Costs (D1_IPF_C1_53)",Observation Beds (Distinct Unit) (C_1_C5_9201),"AMOUNT REPORTED, Interns & Residents (S3_2_C2_7)",Total (C_1_C5_202),Total (B_1_C26_202),"COST SERVICES NOT SUBJECT TO DEDUCTIBLES AND COINSURANCE - COST, Intravenous Therapy (D_5_HOS_C7_64)","HHA I, LUPA Episodes:  Other Charges (S4_HHA1_C3_34)",Other Organ Acquisition (A_C1_112),"PPS SERVICES COST, Anesthesiology (D_5_HOS_C5_53)",Total Costs (C_1_C3_202),Other Medicaid Days (S2_1_C6_24),Operating Room (D3_HOS_C3_50),Radiology-Diagnostic (D3_IPF_C3_54),Hospice (S3_1_C8_24),Beginning Date of SCH status (S2_1_C1_3601),Heart Acquisition (C_1_C5_106),Nursing Administration (A_C1_13),Hospital State (S2_1_C2_2),Sale of medical records and abstracts (A8_C2_18),Hospital Adults & Pediatrics (S3_1_C6_1),Recovery Room (D3_HOS_C3_51),Physical Therapy (D_4_IRF_C13_66),ASC (Non Distinct Part) (D3_SNF_C2_75),Other Special Care (S3_1_C4_12),Other Special Care Unit (D3_SNF_C2_35),CT Scan (D3_SNF_C2_57),Coronary Care Unit (D3_HOS_C2_32),Emergency (D3_IRF_C2_91),Total Program General Inpatient Routine (D1_IPF_C1_41),"TOTAL CAPITAL COSTS AFTER COST ALLOCATION, OLTC (B_2_C26_46)",Clinic (C_1_C7_90),"Net Expense for Cost Allocation, HHA (B_1_C0_101)",Occupational Therapy (D_4_HOS_C4_67),Radiology-Therapeutic (D3_IPF_C2_55),Durable Medical Equipment Sold (D3_HOS_C3_97),Durable Medical Equipment Sold (B_2_C26_97),Received DSH or supplemental payments from Medicaid? (Y/N) (S10_C1_3),HHA (A_C2_101),"PAID HOURS RELATED TO SALARIES, Home Office Personnel (S3_2_C5_8)",Is this a New Hospital under 42 CFR 413.40(f)(1)(I) (TEFRA)? (Y/N) (S2_1_C1_85),"PAID HOURS RELATED TO SALARIES, Administrative and General (S3_2_C5_27)","Gift, Flower, Coffee Shop, Canteen (A_C2_190)","AMOUNT REPORTED, Home Office:  Physician Part A (S3_2_C2_15)",Clinic (A_C2_90),Medical Supplies Charged to Patients (D_4_IPF_C11_71),Intravenous Therapy (C_1_C5_64),SNF (S3_1_C11_19),"AVERAGE HOURLY WAGE, Related Salaries (S3_2_C6_1402)",Total Nursing School (D_4_HOS_C2_200),ICF (S3_1_C2_2001),Cardiac Catheterization (C_1_C5_59),"Blood Storing, Processing, Trans (C_1_C5_63)","Beginning Balances, Land (A7_1_C1_1)",Observation Beds (Distinct Unit) (D_4_HOS_C10_9201),Total Adults & Pediatrics (S3_1_C8_7),"PAID HOURS RELATED TO SALARIES, Total Overhead Costs (S3_3_C5_7)","COST REIMBURSED SERVICES SUBJECT TO DEDUCTIBLES  AND COINSURANCE - CHARGES, Laboratory (D_5_HOS_C3_60)","COST SERVICES NOT SUBJECT TO DEDUCTIBLES AND COINSURANCE - COST, Electrocardiology (D_5_HOS_C7_69)","PPS SERVICES COST, Physical Therapy (D_5_HOS_C5_66)",Other Ancillary (D_4_HOS_C2_76),Anesthesiology (D_4_HOS_C3_53),Cardiac Catheterization (D3_SNF_C3_59),"ADJUSTED SALARIES, Physician-Part A (S3_2_C4_4)",MSP-LCC reconciliation amount (E_B_HOS_C1_38),Radioisotope (D3_IPF_C3_56),Burn Intensive Care Unit (B_1_C26_33),"Percentage of patients re-using
dialyzers (S5_C2_10)",Subprovider 2 (S3_1_C2_1801),Electrocardiology (C_1_C6_69),Tentative settlement (E_B_HOS_C1_42),Cost To Charge Ratio (S10_C1_1),"COST SERVICES SUBJECT TO DEDUCTIBLES AND COINSURANCE - COST, Speech Pathology (D_5_HOS_C6_68)",CORF (C_1_C6_9910),"AMOUNT REPORTED, Interns & Residents (S3_2_C2_25)",Social Service (A_C6_17),Physicians' Private Office (A_C6_192),"Allocation of Interns & Residents Salary and Fringes, NF (B_1_C21_45)",Maintenance and Repairs (A_C2_6),"AMOUNT REPORTED, Employee Benefits (S3_2_C2_26)",Observation Beds (Distinct Unit) (C_1_C6_9201),Occupational Therapy (B_2_C26_67),Impl. Dev. Charged to Patients (D_4_IRF_C13_72),Heart Acquisition (B_1_C26_106),Subprovider I (B_1_C26_42),Int & Res (non approved teaching program (B_1_C22_100),Other Ancillary (D_4_HOS_C4_76),"HHA II, With Outliers:  Number of Episodes (S4_HHA2_C2_37)","COST SERVICES NOT SUBJECT TO DEDUCTIBLES AND COINSURANCE - COST, Home Program Dialysis (D_5_HOS_C7_94)",Radioisotope (D3_SNF_C2_56),Swing Bed NF Provider Number (S2_1_C2_8),Hospice (C_1_C7_116),Renal 1 Provider Number (S2_1_C2_18),Research (B_1_C26_191),Other Nonreimbursable (B_1_C26_194),Total Current Assets (G_C1THRU4_11),Respiratory Therapy (D3_IPF_C3_65),Target Amount per Discharge (D1_HOS_C1_55),Line 2 times line 5 (E_B_HOS_C1_6),Labor and Delivery (S3_1_C3_32),"COST SERVICES NOT SUBJECT TO DEDUCTIBLES AND COINSURANCE - COST, Electroencephalography (D_5_HOS_C7_70)",Other Ancillary (D3_IPF_C2_76),"Allocation of Interns & Residents Program Costs, Intensive Care Unit (B_1_C22_31)",OSP (C_1_C5_9940),"COST REIMBURSED SERVICES SUBJECT TO DEDUCTIBLES  AND COINSURANCE - CHARGES, Whole Blood & Packed Red Blood Cells (D_5_HOS_C3_62)","Allocation of Interns & Residents Salary and Fringes, Intensive Care Unit (B_1_C21_31)",RHC (D_4_HOS_C4_88),Operating Room (D3_IPF_C3_50),Investments (G_C1THRU4_31),Stand-alone CHIP Charges (Gross Revenue) (S10_C1_10),"COST SERVICES SUBJECT TO DEDUCTIBLES AND COINSURANCE - COST, Electroencephalography (D_5_HOS_C6_70)",Observation Beds (Distinct Unit) (D_4_HOS_C12_9201),NF (S3_1_C9_20),"Total Inpatient Charges, SNF (C_1_C6_44)","AMOUNT REPORTED, Cafeteria (S3_2_C2_36)","COST REIMBURSED SERVICES SUBJECT TO DEDUCTIBLES  AND COINSURANCE - CHARGES, Electrocardiology (D_5_HOS_C3_69)","ADJUSTED SALARIES, Home Office Salaries & Wage Related Csts (S3_2_C4_14)",SSA State Code (STATE),Interns & Res Other Program Costs (A_C1_22),CT Scan (D_4_HOS_C10_57),Prepaid expenses (G_C1THRU4_8),Does the hospital qualify as RPCH/CAH? (Y/N) (S2_1_C1_105),Durable Medical Equipment Sold (C_1_C6_97),"Allocation of Interns & Residents Program Costs, Radiology-Therapeutic (B_1_C22_55)",Nonphysician Anesthetists (A_C2_19),"Total Outpatient Charges, Blood Clotting Factors for Hemoph. (C_1_C7_6250)",Intensive Care Unit Program Cost (D1_HOS_C5_43),"Net Expense for Cost Allocation, Blood Storing, Processing, Trans (B_1_C0_63)",Recovery Room (D_4_IRF_C13_51),Total Allied Health Cost (D_3_HOS_C2_200),Renal 3 Provider Number (S2_1_C2_1802),"AMOUNT REPORTED, Non-Physician Anesthetist Part B (S3_2_C2_21)",CT Scan (D3_IRF_C2_57),Total Hospital (S3_1_C3_14),Other Outpatient Services (B_1_C22_93),SNF (S3_1_C8_19),IRF (S3_1_C7_17),Respiratory Therapy (D3_SNF_C2_65),"AVERAGE HOURLY WAGE, Excluded Area Salaries (S3_3_C6_2)",Medical Supplies Charged to Patients (B_1_C26_71),SNF (B_1_C26_44),Radiology-Diagnostic (D3_HOS_C3_54),Occupational Therapy (D3_SNF_C2_67),OLTC (A_C2_46),"Number of days in year dialysis 
furnished (S5_C1_5)","Allocation of Interns & Residents Salary and Fringes, Impl. Dev. Charged to Patients (B_1_C21_72)","AVERAGE HOURLY WAGE, Non-Physician Anesthetist Part A (S3_2_C6_2)","Allocation of Interns & Residents Salary and Fringes, Radiology-Diagnostic (B_1_C21_54)","PPS SERVICES COST, ASC (Non Distinct Part) (D_5_HOS_C5_75)",Drugs Charged to Patients (D_4_IRF_C13_73),Whole Blood & Packed Red Blood Cells (D_4_HOS_C12_62),Government grants or appropriations or transfers for support of hospital operations (S10_C1_18),Whole Blood & Packed Red Blood Cells (D3_IRF_C3_62),IRF (S3_1_C3_17),Cardiac Catheterization (D_4_IRF_C11_59),Respiratory Therapy (D_4_HOS_C13_65),Refunds and Rebates of Expenses (A8_C2_5),"Net Expense for Cost Allocation, Electrocardiology (B_1_C0_69)","Does this facility operate 
transplant center? (Y/N) (S2_1_C1_125)",Other Ancillary (A_C1_76),"ADJUSTED SALARIES, Total Salaries (S3_2_C4_1)","Interest, New Cap Related Csts Movable Equipment (A7_3_C11_2)","Allocation of Interns & Residents Program Costs, Adults and Pediatrics (B_1_C22_30)","PPS SERVICES COST, Intravenous Therapy (D_5_HOS_C5_64)",Speech Pathology (C_1_C6_68),Subprovider-IPF (B_1_C26_40),Radiology-Diagnostic (D_4_IRF_C13_54),"TOTAL CAPITAL COSTS AFTER COST ALLOCATION, Radiology-Diagnostic (B_2_C26_54)",Total Income (G3_C1_26),Other Reimbursable (C_1_C7_98),Subprovider-IPF (A_C2_40),"PAID HOURS RELATED TO SALARIES, Total Salaries (S3_2_C5_1)","COST REIMBURSED SERVICES NOT SUBJECT TO DEDUCTIBLES AND COINSURANCE - CHARGES, Electrocardiology (D_5_HOS_C4_69)",Drugs Charged to Patients (A_C2_73),"PPS SERVICES COST, Radiology-Therapeutic (D_5_HOS_C5_55)","Net Expense for Cost Allocation, Nursing School (B_1_C0_20)","AVERAGE HOURLY WAGE, Non-Physician Anesthetist Part B (S3_2_C6_3)",Anesthesiology (D3_IRF_C2_53),Delivery Room and Labor Room (D_4_IPF_C13_52),Occupational Therapy (D3_IPF_C2_67),Subtotal (E_B_HOS_C1_37),"Net Expense for Cost Allocation, Intensive Care Unit (B_1_C0_31)","Net Expense for Cost Allocation, ASC (Non Distinct Part) (B_1_C0_75)",TOTAL (D3_HOS_C3_200),Observation Beds (Distinct Unit) (A_C1_9201),SNF (S3_1_C3_19),"Allocation of Interns & Residents Salary and Fringes, Electrocardiology (B_1_C21_69)","HHA II, PEP Episodes:  Other Charges (S4_HHA2_C4_34)","Net Expense for Cost Allocation, Other Organ Acquisition (B_1_C0_112)",Burn Intensive Care Unit (D_3_HOS_C9_33),"Allocation of Interns & Residents Salary and Fringes, Medical Supplies Charged to Patients (B_1_C21_71)",Laboratory (D_4_HOS_C13_60),Radioisotope (D3_IRF_C2_56),OLTC (C_1_C5_46),Radiology-Therapeutic (D3_IPF_C3_55),RHC 20 Provider Number (S2_1_C2_1519),Total charges to state or local government programs for indigent care (not Medicaid or CHIP) (S10_C1_14),Nursing School (A8_C2_19),"PAID HOURS RELATED TO SALARIES, Non-Physician Anesthetist Part B (S3_2_C5_3)",CT Scan (D_4_IPF_C13_57),"Purchases, Land Improvements (A7_1_C2_2)",Other Reimbursable (D_4_HOS_C10_98),Physical Therapy (D3_IPF_C2_66),"AVERAGE HOURLY WAGE, Net Salaries (S3_3_C6_1)",Subprovider I (A_C2_42),Subprovider 2 (S3_1_C8_1801),OPT (A_C6_9920),Hospice (A_C6_116),"PPS SERVICES COST, Laboratory (D_5_HOS_C5_60)",Anesthesiology (D_4_HOS_C2_53),Impl. Dev. Charged to Patients (A_C6_72),Total Patient Days (D_3_HOS_C6_200),Whole Blood & Packed Red Blood Cells (D3_SNF_C2_62),Program Discharges (D1_HOS_C1_54),Burn Intensive Care Unit (S3_1_C4_10),Other Special Care (S3_1_C5_12),Anesthesiology (D_4_HOS_C4_53),Nursing Administration (A_C6_13),Occupational Therapy (D_4_HOS_C10_67),CMHC (B_1_C21_99),Occupational Therapy (D_4_HOS_C11_67),"COST SERVICES SUBJECT TO DEDUCTIBLES AND COINSURANCE - COST, Respiratory Therapy (D_5_HOS_C6_65)",Average times dialyzers re-used (S5_C2_9),Beds Total Facility (S3_1_C2_27),Hospital PO Box (S2_1_C2_1),Adults and Pediatrics (A_C6_30),Hospice (A_C1_116),Clinic (D3_IPF_C3_90),"PAID HOURS RELATED TO SALARIES, Net Salaries (S3_3_C5_1)",Int & Res (non approved teaching program (C_1_C5_100),Radiology-Diagnostic (D3_SNF_C2_54),Physical Therapy (D3_SNF_C2_66),Is this hospital classified as a referral center? (Y/N) (S2_1_C1_116),Physicians' Private Office (B_1_C26_192),Anesthesiology (D_4_HOS_C11_53),IPF (S3_1_C8_16),Lung  Acquisition (C_1_C5_108),"PAID HOURS RELATED TO SALARIES, Interns & Residents (S3_2_C5_7)","Allocation of Interns & Residents Program Costs, Subprovider-IRF (B_1_C22_41)",Administrative and General (A_C2_5),CMHC 1 Provider Number (S2_1_C2_17),Home Program Dialysis (D_4_HOS_C11_94),Subtotal (E_B_HOS_C1_30),"COST SERVICES SUBJECT TO DEDUCTIBLES AND COINSURANCE - COST, Clinic (D_5_HOS_C6_90)",Hospital Adlts & Ped Swing Bed NF (S3_1_C8_6),Nursery (A_C1_43),Electroencephalography (C_1_C5_70),Cardiac Catheterization (D_4_HOS_C12_59),Other Outpatient Services (B_1_C21_93),"PPS REIMBURSED SERVICES -  CHARGES, Durable Medical Equipment Rented (D_5_HOS_C2_96)",Hospice (B_1_C26_116),"ADJUSTED SALARIES, Cafeteria (S3_2_C4_36)",Emergency (D_4_IRF_C11_91),Other Outpatient Services (D3_IPF_C3_93),Delivery Room and Labor Room (A_C1_52),Medical Supplies Charged to Patients (D3_SNF_C2_71),"Allocation of Interns & Residents Program Costs, Speech Pathology (B_1_C22_68)",Operating Room (D3_IRF_C3_50),Islet Acquisition (B_2_C26_111),"COST REIMBURSED SERVICES SUBJECT TO DEDUCTIBLES  AND COINSURANCE - CHARGES, Impl. Dev. Charged to Patients (D_5_HOS_C3_72)",Depreciation-New Bldgs & Fixtures (A8_C2_26),Other Special Care Unit (D_1_HOS_C6_35),Payment to cost ratio (E_B_HOS_C101_5),Electroencephalography (D_4_HOS_C4_70),ICF Provider Number (S2_1_C2_1001),Medical Supplies Charged to Patients (A_C2_71),Observation Beds (Distinct Unit) (D3_HOS_C2_9201),"PAID HOURS RELATED TO SALARIES, Housekeeping (S3_2_C5_32)",Accounts Payable (G_C1THRU4_37),Laboratory (D3_IRF_C2_60),"AVERAGE HOURLY WAGE, Cafeteria (S3_2_C6_36)",MDH status ending date (MM/DD/YY) (S2_1_C2_3801),Outlier payments (E_B_HOS_C101_4),Total (D_4_HOS_C13_200),Electrocardiology (C_1_C5_69),Fiscal Intermediary Number (FI_NUM),Electrocardiology (B_1_C26_69),"Net Expense for Cost Allocation, Home Program Dialysis (B_1_C0_94)","Number of patients in program at 
end of cost reporting period (S5_C3_1)",Electroencephalography (D3_SNF_C2_70),"AVERAGE HOURLY WAGE, Housekeeping (S3_2_C6_32)","AVERAGE HOURLY WAGE, Pharmacy (S3_2_C6_40)",Adults and Pediatrics (D3_SNF_C2_30),Interns & Res Salary and Fringe Benefits (A_C2_21),"ADJUSTED SALARIES, Housekeeping under contract (S3_2_C4_33)",CMHC (C_1_C5_99),"Net Expense for Cost Allocation, Cardiac Catheterization (B_1_C0_59)","Lease, New Cap Related Csts Movable Equipment (A7_3_C10_2)",Recovery Room (D_4_HOS_C11_51),Total Other Medical Education (D_4_HOS_C4_200),"HHA II, Without Outliers:  Total Charges (S4_HHA2_C1_35)","AMOUNT REPORTED, Home Office Salaries & Wage Related Csts (S3_2_C2_14)","Allocation of Interns & Residents Program Costs, Subprovider-IPF (B_1_C22_40)",Hospital Title 18 Payment System (P/T/O) (S2_1_C7_3),"COST REIMBURSED SERVICES SUBJECT TO DEDUCTIBLES  AND COINSURANCE - CHARGES, Emergency (D_5_HOS_C3_91)",Lung  Acquisition (B_1_C26_108),Initial Physician Payment Method (Y/N) (S5_C2_21),"Net Expense for Cost Allocation, Subprovider I (B_1_C0_42)",Speech Pathology (D3_IPF_C2_68),Recovery Room (D3_IRF_C3_51),Subprovider-IRF (D_3_HOS_C9_41),Delivery Room and Labor Room (D_4_IRF_C13_52),"HHA I, Total Other Charges (S4_HHA1_C5_34)","Donations, Fixed Equipment (A7_1_C3_5)","COST SERVICES SUBJECT TO DEDUCTIBLES AND COINSURANCE - COST, Durable Medical Equipment Rented (D_5_HOS_C6_96)",Net revenue from state/local govt indigent care (not Medicaid or CHIP) (S10_C1_13),ASC (Non Distinct Part) (D3_IRF_C2_75),"COST REIMBURSED SERVICES NOT SUBJECT TO DEDUCTIBLES AND COINSURANCE - CHARGES, Radioisotope (D_5_HOS_C4_56)",Nursery (S3_1_C8_13),Radiology-Therapeutic (D3_SNF_C3_55),"HHA II, LUPA Episodes:  Total Visits (S4_HHA2_C3_33)",Intestinal Acquisition (A_C2_110),"HHA I, With Outliers:  Total Visits (S4_HHA1_C2_33)",Liver Acquisition (B_2_C26_107),Report_Period_Begin_Yr,Ratio of Charity Care to Total Operating Expense,Total Net Assets,Medicaid Costs,Medicaid Shortfall,Cash Reserves,Total charitable care,Net Profit Margin,Operating Profit,Operating Profit Margin,LIQUIDITY current ratio,LIQUIDITY acid-test ratio,LIQUIDITY acid-test ratio (variation),LIQUIDITY cash ratio,Equity,SOLVENCY Debt-to-Equity Ratio,SOLVENCY Debt Ratio,SOLVENCY Equity Ratio,SOLVENCY Interest Coverage Ratio,SOLVENCY total assets less total liabilities,EFFICIENCY asset turnover ratio,EFFICIENCY Accounts Receivable Turnover Ratio,Hospital Type (From CMS Hospitals Data Archive),General Ownership Type,Medicaid Expansion State,Name and Num
8432,SOUTHWEST GENERAL HEALTH CENTER (360155),General Short Term (Acute Care Hospitals),Voluntary Nonprofit-Other,-81.83291,41.37208,,,,22829.0,,67.5,,,,,34245.39,,,1387798.0,,,,,,,108637.0,14067066.0,CUYAHOGA,,,100894.0,108240.0,13674.0,,,67566.0,,1.0,,,3505635.0,,376.0,1348.0,,,71612.0,2711641.0,12530229.0,41.0,14.85,1077067.0,,,,,1400569.0,1225709.0,640116.0,,13253966.0,,,,5747491.0,,,639683.0,,,,90514.0,,,,,,,250.0,,,6787794.0,1628.0,,11545323.0,51120175.0,,1037.0,15181741.0,,,,17971381.0,,13674.0,,,,,,,,900646.0,104563.43,,N,975094341.0,156053745.0,26.07,,,2024-09-20 00:00:00,2928383.0,,,6344.0,,,,,,,,,,772761.0,175117.0,368708.0,,,,,,2029572.0,184274.0,,42636135.0,,-16853.0,,,212.0,1782450.0,98614.0,,,,26.6,,894844.0,,,21927290.0,3135760.0,,,,,77745.0,,,4531.0,,,,252946.0,927022.0,,,36371.0,,,,,,,36044962.0,,,,,,,108240.0,,,3442.0,,,,,4015468.0,,,29225262.0,335556.0,1627.0,,2660.0,4035.0,,,2891890.0,,524025.0,,6562638.0,,,,,,,,,,,1628277.0,,,,,4217193.0,,,,,,101157.0,,2.0,102526.0,-39026.0,,,,2978756.0,,,,,,,,1096562.0,,1840016.0,,,315.0,,,N,,,,,,2797.0,5840.0,320034.0,,,3007.0,4018548.0,,,25995415.0,,,,36.0,,,,,1.0,5498022.0,,501185.0,,,,,2116858.0,2919870.0,,198.0,205657.0,,270143.0,246714.0,,,,1271438.0,,2621598.0,,,,1461384.0,144936.0,6718585.0,4015468.0,,3325.0,-127645.0,3650.0,,,,22178.0,,,,24120.0,5838628.0,,,508482.0,,,,,,8563080.0,,3814.0,,,2986434.0,,32605.0,1584110.0,114459.0,,,,3379821.0,4759.0,16247.0,,,,,206943.0,,,,,156092.0,,,,,,1491007.0,,23227.0,,69.53,2680542.0,,,5892320.0,24.96,3906.0,26.49,,,4751.0,868819.0,,,,4685541.0,,,,,,,,,,101204674.0,,,,2563.0,,,3059.0,,,,100592836.0,,,,1498987.0,,,75732.0,1363450.0,878609.0,,,607972.0,,-71859.0,,,-6494.0,,,,,13570737.0,,,,,356846.0,421789.0,,,,3324354.79,,725233.0,,,,1401651.0,32774623.0,-36047.0,,,,,,,,,2187481.0,100894.0,,7506786.0,,,695942.0,,,,,382177.0,11981720.0,,,230842.0,,1903597.0,1297955.0,,,89109.0,,,,,29801.0,8037.0,,,,-41489.0,,,16690863.0,,842825.0,-45922.0,41711.25,2989291.0,,11415.0,,,,3592178.0,,7097288.0,,,,,,,,,1903597.0,,,,,,13277569.0,357726.0,,6434988.0,,,,,1 S ACUTE REHAB,4751.0,,6932818.0,,,,1363450.0,,14327.77,,,246714.0,,,,41265.0,-2271113.0,,28.79,,108240.0,,,1757404.0,,3165690.0,,346684.0,,,,68296.0,,,,,,,,,1397336.0,,,48.07,,,,,,,,306661912.0,,652121.0,8207094.0,,74932.0,28132.0,38413222.0,145.0,,,,,31424087.0,,,4643043.0,,,8573005.0,,3529.0,,,-825687.0,6422091.0,,,,,,91883618.0,,,,,87728.02,2046833.0,9837.0,,,361530,9654.0,,A,,2241242.0,,,,,,,,,,5281800.0,,,,,,,,108240.0,,1105.0,,,,3993854.0,,1938912.0,-164011.0,181.0,,,2244.0,,,,13390851.0,,3592178.0,,,,,,,,,1938912.0,1088.0,,,,,,188907.0,44907322.0,1271438.0,23227.0,,,,,,,,-98495.0,,,,,,36371.0,,,4647405.0,,,,248.0,,5541558.0,,,,1396744.0,-4933.0,58198.0,,,,10784758.0,,,373.0,,,651.0,154.0,,42063760.0,,16708856.0,,,,25359354.0,7300.0,360155,8.0,,10597.0,19473.0,,6347.0,,,14009163.0,,,,,,1465121.0,,21074498.0,28322450.0,,,N,4390495.0,,,,,8399706.0,6555115.0,6422882.0,,,,,,,,,9112017.0,,1015.0,3368572.56,117160817.0,,SOUTHWEST GENERAL HEALTH CENTER,,194668.0,,,5529550.0,,,,1587799.0,,219048.0,,,,,,,2880925.0,,7255650.0,117127146.0,,,32774623.0,-9320.0,8536613.0,,,,956661.0,,,784730,1323087.0,,3.0,,,,548756.0,,,,,,,,,,20747.0,2573.0,,4050.0,,,2297.0,1656796.0,,,808683.0,,,,,,,,,829624.0,3699827.0,244717766.0,,116550642.0,2498139.0,,521257137.0,,2711105.0,,949009.0,,,,160.39,,,15434582.0,,15310725.0,,2649745.0,674557.0,,2011-01-01 00:00:00,,,79360931.0,979.0,18738010.0,,-11928815.0,21074498.0,,,,,,,,,,,N,632456.0,,,535288.35,,592106.0,,-29531.0,12861298.0,,,,6205.95,,12905593.0,,1543517.0,6048652.0,,,,,,4382.0,,,,173396357.0,,4,,,,,,,,29.04,1363450.0,25069.0,,17946855.0,,4546823.0,,,,,,3091172.0,,24895.0,,,,-279070.0,,,,,26565694.0,6969739.0,2002.0,356880136.0,2891890.0,75732.0,,-23274.0,,,91883618.0,,,,7817429.0,,,,,7817429.0,,,,,,,,,,365919,4050.0,303822821.0,,,21927290.0,,,,731391.0,87.0,MIDDLEBURG HEIGHTS,,405.0,,,23026.0,149783738.0,,,1809.0,,,,2079832.0,,,4643043.0,,,,162.0,,35558.0,,50523878.0,36838.0,52857.44,21.65,,,,,1127782.0,,,1763366.0,,74932.0,6412270.0,,3892940.0,12445599.0,-15272.0,152584.0,,2407153.0,640116.0,,,-20836.0,,,426689.0,14000555.0,,2923306.0,,,688679.0,,,16398628.0,152603.0,,12530229.0,65285.47,171051436.0,,,,4350181.0,3414.0,,2816208.0,,8568392.0,789874.0,2661678.0,2135.0,,,270332.0,429.0,,,,,,,,-245.0,,6412270.0,,120609.0,,,,,2880925.0,1071188.0,,,,538227.0,12344.0,,,,,,13240941.0,992809.0,,945252.0,,,-1303752.0,,,2002700.0,,,,,7467204.0,,-750292.0,,,N,2472.0,,,,,,,,,,,1618095.0,45246.0,,4346046.0,,,,,,,,1267.0,,,29493443.0,,,,,,,,,-93500.0,3218413.0,,,,147240.0,,,,,,,,,,5111458.0,8003317.0,,94527850.0,59396543.0,2163.0,23152.0,,725233.0,,,,,,,,,,,,,,,,8536613.0,,27125.0,,23.25,,,1662823.0,,,117.0,,2079832.0,,,,,244327.0,,13266273.0,67751.0,45888564.0,-50735.0,10849.0,,4266868.0,1618095.0,,5037375.0,,,,2468040.0,2630242.0,,455981.0,,8787553.0,-7960.0,2498139.0,,,,514379982.0,,2468040.0,,31.72,,778857.0,,,,9.0,202043.0,1673328.0,,13266273.0,4685541.0,420672.0,,,,,,18329393.0,,,,36889.76,25106843.0,421788.0,,,,,,1896206.0,,,-50599.0,58380.0,,,,N,,11237.0,,,,,-47157.0,44130-3497,,689408.0,569533.74,1736564.0,,33.99,,22829.0,2031444.0,,10784758.0,,,,,,,,-5071201.0,,,,4018548.0,,,3370880.0,,461788271.0,,,,,299693.0,21168156.0,62872148.0,,,,,,,,,,,,,256646581.0,979.0,53.42,,206.0,312575.0,114825.0,Y,,,1577201.0,,6736780.0,,,,,3165690.0,,,,,4592447.0,280990.0,,,N,51746.36,,,,,,,190.0,,,2031156.0,1031962.0,949009.0,,,,,,,,,,8901185.0,,,,,,,,,,,,,,6969739.0,,,,,1112157.0,,,,,3370880.0,1421547.0,,,1242039.0,,508482.0,,2635890.0,,14000071.0,,,,220.0,779.0,1903597.0,,,,,,639683.0,,6434988.0,114459.0,9543065.0,26565694.0,1839042.0,,,33.0,,,,,,,,3880496.0,,,,17263287.0,,,25560785.0,256018.0,61350.0,,20747.0,,6852171.0,,,,,,,34.77,,,,89390.0,,,207096398.0,,,2868459.0,,,,,8.0,,,,,,39631.0,,,,1059303.0,,,11545323.0,,108240.0,77380.0,60.0,,67277.0,-11928815.0,,,3986199.0,1.0,,5254.8,13140.0,71334.0,,10.0,,,,6948963.0,,,,,,,55100498.0,,,142749.0,,,,,,,5895682.0,220148833.0,47450495.0,596.0,,1420271.0,,1498.0,4382.0,3235321.0,,,,,,,,,,,,,6522443.0,5375577.0,5895682.0,3133121.0,,,,,,,,5673.0,200.2,,822115.0,,26652407.0,,,,14810999.0,,,,,,,1782450.0,6344.0,32774623.0,1245552.0,330615.0,4137481.0,,,9443.0,,108637.0,2521.0,,,,,-3540.0,,,,16398628.0,,,765348.0,,,,,,,,46441266.0,,,,31.7,,,6932818.0,,,,4046410.0,,1994645.0,,,2183927.0,264279.0,,,279976.0,1970612.0,,701039473.0,,10011944.0,N,,,,12851039.0,782569.0,,,261815.0,3135760.0,,,251154.0,,1921733.0,,,,,11148663.0,,,53289923.0,12980163.0,1421.0,,842825.0,17103.94,,15.85,,,,,88113.0,3814.0,,17160.0,,,,,,101448309.0,16.0,,,,,1311866.0,,,,2423.0,,108240.0,,25995415.0,,,,9446943.0,53830166.0,,,93885987.0,,2923306.0,3187346.0,,1348787.0,,,,,1714.23,,,202109.0,,357726.0,,,,106476.0,,,108240.0,192559.0,,,,,,26652407.0,113711551.0,25995415.0,,,,,,,802118.0,,24.0,,5822.0,,4566884.0,,,,N,,,,,6408579.0,,413947.0,212.0,,7401.0,,,,,18228630.0,,6852171.0,,,,321026.0,74181.0,,929766.0,,,1680,12931429.0,26184.0,27975302.0,,-94122.0,188907.0,,,,15485576.0,,1309732.0,,,,822115.0,,,,,,,,,-87690.0,25069.0,,-3809902.0,,765348.0,25069.0,,,,71593377.0,,-5488.0,,,19.15,36S155,20.0,1627.0,7763417.0,6606859.0,,,,201257.0,4525773.0,,,,,,1628277.0,,2891890.0,,18697 BAGLEY ROAD,,1681935.0,524025.0,,,410660.0,,168001.0,,,2325614.0,,,,,63307.0,,,,238.0,,1139.0,,257858.0,,346849.0,,,,1521696.0,,,,,1842.0,-652422.0,,4589831.0,,,16710356.0,4668271.0,,84.0,,1793476.0,,,13.0,27477.0,,,,71575.1,,,,,30414.0,15626.0,,7825.0,,,1243.0,50037.0,2072426.0,1857119.0,250.0,,29830.0,,683992.0,6347.0,96544.0,,11932935.0,1500.0,211922029.0,,,,2748.0,,79922.0,,2002700.0,,,1346309.0,,,,44217.77,189012.0,1566.0,,SWGHC MENTAL HEALTH SERVICES,,16750.0,282005935.0,381625.0,,,,18589.0,,95932150.0,,,,1896206.0,,,,,35360.0,1896206.0,,,,,,,,4742880.0,,114459.0,60352.0,,2011-12-31,,4362153.0,,-3540.0,,,,187105.0,,992809.0,,,,,,,2549564.0,-37749.0,,34328337.0,,1323087.0,,1423737.0,,63350.0,,,,,,,7760197.0,936446.0,,,15978778.0,,,,,,,,,,,33.75,,,,,,,,401575.0,,13133534.0,3074273.0,,592106.0,47954.0,2304875.0,,,13113545.0,,,,4775062.0,,,,,,535.0,,,17460,,,13859670.0,,,,,,,,,,16.77,,,,,,,-15760.0,,,,,1465121.0,,,,2977209.0,4006205.0,,,,-5605223.0,,409453.0,2046833.0,18329393.0,,,,17.55,,,109744.0,9323994.0,857036.0,3074273.0,3370162.0,,,,,2002700.0,,2029572.0,,,,,,,2251.0,,47528920.0,356846.0,,3706363.0,,5.0,2461550.0,,105448969.0,725233.0,,,,,,1790895.0,,1863.16,,,,,,965237.0,1120531.0,212947.0,,,156178.0,6027096.0,,,,8573005.0,,,,609.0,18738010.0,,100592836.0,,,,,,,,2891890.0,,1242328.0,,,,,,3133121.0,,,,,18589.0,2244.0,903.0,29029583.0,2034518.0,244327.0,410660.0,19014568.0,21168156.0,,,,584781.0,28.4,,,,,9304.0,,,13913575.0,,25995415.0,,,,,,,150877.0,4546823.0,,,,,,6434988.0,36T155,,2189.0,,,,,,4282505.0,,75732.0,13747.0,,,983045408.0,,505.0,,,,,,262840.0,35759.0,15485576.0,211.0,,General Short Term,,8266.0,,,16042968.0,,,505.0,5183372.0,1906.0,,-17171.0,,,27.6,101714312.0,88091129.0,,,,,4035.0,12717009.0,,,,,,-192379.0,,,9092.0,1749782.0,,954677.0,401575.0,,,-24686168.0,-33820.0,29.52,,,77380.0,333979.0,,205237.0,4217193.0,,,,,,,,174816198.0,367253,,460714359.0,9543065.0,,-21233.0,8621055.0,4476792.0,,183989.0,,,Y,1711.0,,408341.0,1903839.0,2304875.0,163584232.0,,,,,8207449.0,4531.0,5998424.0,,,6948963.0,,,,,36170,1259627.0,,,,,32774623.0,,3293280.0,731391.0,,,88057458.0,2707585.0,,,51740.0,,F,,,,,,,,18725272.0,1350032.0,787662.0,,,,,,,,,6408579.0,,,,,2833126.0,112770.0,,,,,,5442.0,,,3072857.0,,77.27,,,,,-25074.0,,46134.0,12164536.0,350313.0,8787553.0,,,15952.0,,,21141.0,,,,83374.0,1381003.0,12.2,,1127782.0,144988.0,,2423.0,,,,,19473.0,,51690.0,44000.75,1576.0,,,3324213.0,,860587.0,,211.0,,,,,,,-2875.0,,15083827.0,184204.0,,341416.0,,,72767.0,,-80899.0,,,,3059.0,11987435.0,,41325.5,,,,8308031.0,2085293.0,,,,,,502334.0,678146.0,,,,,,,,297595.0,,,,,1194707.0,,,,220.0,,,,1211482.0,,15952.0,,,,19569942.0,38324890.0,-616846.0,,,416.0,,,,,,,1559159.0,251610.0,8688.0,1096562.0,50517.0,,,,,,,52.0,,,,538227.0,12546.0,17536804.0,5673.0,,,,,2405.0,9436040.0,,,,1384.0,,19.0,,,,,464227.0,3174164.0,,,218486010.0,244717766.0,,,,1427722.0,217941035.0,,4108845.0,8172.0,1538.0,,,1323087.0,OH,-13008.0,22829.0,747076.0,,,,,,5501868.0,978.0,2969161.0,,9533128.0,3231476.0,,,,,Y,1820808.0,,N,466754.69,,,544045.0,,,,,,,,2116858.0,7255650.0,,47954.0,1258995.84,380.0,,196786.0,,,,,1092.0,,,,,12484536.0,-66511.0,0.223508,,,,-53790.0,,,4640448.0,1245552.0,,69255.0,,,,,,,,,,7376441.0,,122342.0,17889195.0,50430257.0,8436.0,,,,,,,,,,,1387.0,202598035.0,,,,,4149252.0,1921733.0,,,36,,8399706.0,3786174.0,N,,,,,4237266.0,1644919.0,,,,,44199.0,90520.0,,3708.0,,136882.0,23.51,6522443.0,2498139.0,1767771.0,464152.0,,,,,,,,,809414.0,,6935.0,,,-259233.0,1926474.0,N,,100836471.0,211904.0,,,916173.0,6404204.0,,1403409.0,31966213.0,,1523691.0,3868647.71,,,,,,6788.0,,19239.0,14001647.0,4710655.0,,25560785.0,,4745.0,,,,,,1500.0,7918.0,,,,,,,,5312.0,,82671.0,26.05,,,,-212069.0,178828.0,,,79922.0,,,,,,,829624.0,,,,,326.0,,-641648.0,1606170.0,24680.0,3893888.53,,66940.0,787772.0,N,7982625.0,,8266.0,,,,21991127.0,,,14009163.0,,,545656.0,,,,,3880496.0,653461.0,,,1391105.0,160801.0,,4520.0,,,,,,,,,,111563.12,10440037.0,340417.0,14.85,,,1500.0,3322400.0,15201,3287663.0,,,,12.22,35.24,,,584781.0,,,,,,,,,P,,,,,7650.0,716.0,,,,,,,,,2521.0,,,,362.0,,2011,0.014441505456875734,149783738.0,12315402.106984,2868459.1069840007,13913575.0,7214505.106984001,0.06640027629205747,25359354.0,0.0899248946657807,1.3990930826893366,1.8644352572767313,1.2233198914178354,0.3860060942774749,149783738.0,1.382636064270208,0.580296791861792,0.41970320813820805,18.71517627270931,149783738.0,0.790197902749062,5.291918605324312,Acute Care Hospitals,non-profit,0,SOUTHWEST GENERAL HEALTH CENTER (360155)
14091,SOUTHWEST GENERAL HEALTH CENTER (360155),General Short Term (Acute Care Hospitals),Voluntary Nonprofit-Other,-81.83291,41.37208,,,,21749.0,,37.5,,,,,31670.19,,,1610599.0,,,,,,,121383.0,14667803.0,CUYAHOGA,,,93697.0,111498.0,14088.0,,,63051.0,,1.0,,,3568819.0,,381.0,2389.0,,,73484.0,2627243.0,13400871.0,47.0,13.26,899625.0,,46.0,,,1284300.0,1341289.0,567419.0,,13642964.0,,,,12004884.0,,,623204.0,,,,79681.0,,,,,,,238.0,,,7172946.0,1811.0,,12125282.0,58354886.0,,911.0,14936825.0,,,,18593189.0,,14088.0,,,,,,,,819456.0,72155.03,,N,1064006838.0,164786828.0,27.15,,,2024-08-14 00:00:00,2866311.0,,,6220.0,,,,,,,,,,716510.0,254265.0,368708.0,,,,,,2286603.0,167013.0,,43099550.0,,-26178.0,,,207.0,1816502.0,96347.0,,,,27.69,,967908.0,,,25733027.0,3208339.0,,,,,76666.0,,,4636.0,,,,243239.0,965819.0,,,34809.0,,,,,,,50164197.0,,,,,,,111498.0,,,3459.0,,,,,4112284.0,,,31621505.0,392739.0,,,2737.0,4011.0,,,3016455.0,,562934.0,,7124430.0,,,,,,,,,,,1760537.0,,,-255725.0,,5373945.0,,,,,,79853.0,,,94815.0,-3885.0,,,,3122121.0,,,,,218605.0,,,1080866.0,,2356238.0,,,286.0,,,N,,,,,,1262.0,5856.0,280493.0,,,1536.0,3947665.0,,,24988097.0,,,,36.0,,,,,1.0,11533010.0,,456734.0,,,,,2291876.0,3045565.0,,319.0,172519.0,,258268.0,,,,,1247749.0,,2344644.0,,,,1574040.0,129106.0,6586828.0,4112284.0,,1383.0,-159367.0,3660.0,,,,16520.0,,,,37824.0,5794110.0,,,498375.0,,,,,,8568392.0,,3789.0,,,2698709.0,,18083.0,1513676.0,121490.0,,,,3290823.0,2231.0,14276.0,,,,,419919.0,,,,,145353.0,,,,,,1544182.0,,24145.0,,58.0,2756381.0,,,4710663.0,26.45,6049.0,27.33,,,15239.0,826296.0,,,,4911916.0,,,,,,14186.0,,,,104762082.0,,,,3629.0,,,2894.0,,,,102123416.0,,,,1674214.0,13770.0,,88530.0,116212.0,945086.0,,,621024.0,,-54023.0,,,-67387.0,,,,,14289977.0,,,,,326645.0,421789.0,,,,3335180.56,,740318.0,,,,1315830.0,34448354.0,66133.0,,,,,,,,,2214854.0,93697.0,,8098694.0,,,700725.0,,,,,358941.0,11768320.0,,,264243.0,,1987266.0,1410142.0,,,83146.0,,,,,29431.0,7318.0,,,,-37393.0,,,18872355.0,,976696.0,-1136611.0,39500.44,2721374.0,,6087.0,,,,3448355.0,,7355800.0,,,,,,,,,1987266.0,,,,,,12633130.0,363017.0,,7313141.0,,,,,1 S ACUTE REHAB,15239.0,,7787755.0,,,,116212.0,,28427.88,,,,,,,34380.0,-4314939.0,,34.49,,111498.0,,,1652930.0,,3494451.0,,332543.0,-56872.0,,,70078.0,,,,,,,,,1541243.0,,,,,,,,,,,311692739.0,,645205.0,8497046.0,,63426.0,26912.0,41817979.0,1046.0,,,,,32483352.0,,,5400342.0,,,8244985.0,,2968.0,,,-838844.0,6436060.0,,,,,,101527998.0,,,,,96040.37,2292965.0,4143.0,,,361530,2918.0,,E,,2678555.0,,,,,,,,,,5363659.0,,,,,,,,111498.0,,122.0,,,,3790662.0,,3747182.0,-327440.0,2069.0,,,2269.0,,,,13845828.0,,3448355.0,,,,,,,,,3747182.0,,,,,,,158418.0,45265788.0,1247749.0,24145.0,,,,,,,,2516636.0,,,,,,34809.0,,,4258251.0,,,,243.0,,5811983.0,,,,1528555.0,-7308.0,65414.0,,,,11056499.0,,,41.0,,,484.0,167.0,,44466000.0,,17544186.0,,,,28952719.0,7320.0,360155,10.0,,,19225.0,,214940.0,,,14560833.0,,,,,,1465326.0,,21240006.0,31692906.0,,,N,4375675.0,,,,,8561555.0,6894191.0,6323897.0,,,,,,,,,9232741.0,,7786.0,3400185.44,119934210.0,,SOUTHWEST GENERAL HEALTH CENTER,,202395.0,,,5835901.0,,376.0,,1662047.0,,222986.0,,,,,,,3301759.0,,7255649.0,119922887.0,,,34448354.0,-9049.0,7208692.0,,,,986557.0,,,780927,1304895.0,,3.0,,,,544116.0,,,,,,,,,,37001.0,8427.0,,7238.0,,,1213.0,1654482.0,,,479461.0,,,,,,,,,992985.0,3430287.0,252657301.0,,125617128.0,2419261.0,,579748378.0,,3082252.0,,904092.0,,,,145.53,,,17696850.0,,15181741.0,,2816601.0,695601.0,,2012-01-01 00:00:00,,,92484123.0,809.0,19799128.0,,-14252943.0,21240006.0,,,,,,,,,,,N,627691.0,,,548549.28,,523130.0,,-16291.0,10540969.0,,,,7314.13,,13802439.0,,1791471.0,10113557.0,,,,,,,,,,174816199.0,,4,,,,,,,,29.85,116212.0,24154.0,,18566441.0,,4906531.0,,,,,,3455360.0,,21984.0,,,,-277745.0,,,,,28650731.0,16919134.0,1695.0,438016377.0,3016455.0,88530.0,,-31281.0,,,101527998.0,,,,8187809.0,,,,,8187809.0,,1582678.0,,3643345.0,,,,,,365919,7238.0,308853648.0,,,25733027.0,,,,703165.0,82.0,MIDDLEBURG HEIGHTS,,,,,25209.0,161137386.0,,,,,,,2006813.0,,,5400342.0,,,,232.0,,40333.0,,54000224.0,37561.0,47380.39,22.74,,,,,1166251.0,,,3442678.0,,63426.0,6276405.0,,,12946376.0,3561.0,139182.0,,2438490.0,567419.0,,,-21609.0,,,424205.0,14671959.0,,2924617.0,,,630890.0,,,20063817.0,136324.0,,13434596.0,62877.25,226714794.0,,,,4480964.0,689.0,,2959520.0,,8568392.0,842835.0,2743546.0,3043.0,,,254980.0,50239.0,,,,,,,,-1171.0,,6276405.0,,109045.0,,,,,3301759.0,1217428.0,,,,511608.0,8602.0,,,,,,11527290.0,1176456.0,,899452.0,,,-2394.0,,,1469019.0,,,,,,,-774873.0,,,N,1200.0,,,,,,,,,,,1675550.0,45354.0,,4767085.0,,,,,,8990110.0,,1034.0,,,31364647.0,,,,,,,,,-118240.0,3254181.0,,,,125492.0,,,,,,,,,,4713930.0,9060576.0,,94785291.0,64434522.0,5056.0,18536.0,,740318.0,,,,,,,,,,,,,,,,7208692.0,,20758.0,,23.6,,,2429035.0,,,92.0,,2006813.0,,,,,274177.0,,13656550.0,68101.0,54147710.0,-50068.0,12609.0,,4268111.0,1675550.0,,5316403.0,,,,1981925.0,2402150.0,,430384.0,1582678.0,9131437.0,-9160.0,2419261.0,,,,572814230.0,,1981925.0,,33.03,,773963.0,,,,1.0,1533317.0,2110997.0,,13656550.0,4911916.0,276131.0,,,,,,21100537.0,,,,148198.0,21794278.0,421788.0,,,,,,1876588.0,,,-53846.0,60545.0,,,,Y,,20461.0,,,,,-43640.0,44130-3497,,766428.0,580219.47,1814697.0,,33.69,,21749.0,2167758.0,,11056499.0,,,,,,,,-5647247.0,,,,3947665.0,,,3669960.0,,492922310.0,,,,,238283.0,21124195.0,69248741.0,,,,,,,,,,,,,266910244.0,809.0,45.02,,176.0,394178.0,122174.0,Y,,,1620651.0,,6696700.0,,,,,3494451.0,,,,,3900117.0,300117.0,,,N,50959.64,,,,,,,,,1582678.0,2134878.0,1108038.0,904092.0,,,,,,,,,,9048049.0,,,,,,,,,,,,3399.0,218605.0,15901416.0,,,,,1109194.0,,,,,3669960.0,1325395.0,,,1380155.0,,498375.0,,2392484.0,,14555001.0,,,,160.0,,1987266.0,,,,,,623204.0,,7313141.0,121490.0,9751440.0,28650731.0,1989501.0,,,9.0,,,,,,,,3749934.0,,,,17086128.0,,,25758767.0,258181.0,60956.0,,37001.0,,9134161.0,,,,,,,35.27,,,5835171.0,97336.0,,,276878991.0,,,3923983.0,,,,,10.0,,,,,,58705.0,,,,917205.0,,,12125282.0,,111498.0,75762.0,193.0,,46643.0,-14252943.0,,,4056510.0,17.0,,6711.22,13176.0,69165.0,,10.0,,,,6864215.0,,,,,,,61742401.0,,,176097.0,,,,,,,6222659.0,228891716.0,48425376.0,521.0,,3794097.0,,1329.0,,2960558.0,,,,,,,,,,,,,7134712.0,5878619.0,6222659.0,2320954.0,,,,,,,,5724.0,4455.36,,,,26487672.0,,,,14557476.0,,,,,,,1816502.0,6220.0,34448354.0,1385039.0,324335.0,3940230.0,1582678.0,,20847.0,,121383.0,2263.0,,,,,-2810.0,,,,20063817.0,,,1279935.0,,,,,,,,46982704.0,,,,48.24,,,7787755.0,,,,4064030.0,,2545563.0,,,2211471.0,230370.0,,,279926.0,1919512.0,,776807725.0,,3206161.0,N,,,,14740150.0,752421.0,,,266572.0,3208339.0,,,284824.0,,1787468.0,,,,,11379160.0,,,54284081.0,16340824.0,1357.0,,976696.0,,141.0,14.94,,,,,102347.0,3789.0,,14673.0,,,,,,105010164.0,16.0,,,,,1192821.0,,,,2413.0,,111498.0,,24988097.0,,,,9077573.0,60347559.0,,,105696995.0,,2924617.0,3614583.0,,1215366.0,,,,,1657.67,13932.0,,203883.0,,363017.0,,,,109778.0,,,111498.0,163000.0,,,,,,26616000.0,122778037.0,24988097.0,,,,,,,802240.0,,6.0,,107.0,,4400632.0,,,,N,,,,,8017455.0,,1793823.0,207.0,,22216.0,,,,,19541951.0,,9134161.0,,,,223442.0,52099.0,,1036213.0,,,1680,13802439.0,19807.0,25718261.0,,-4756.0,158418.0,,,,14072907.0,,1151823.0,,,,,,,,,,,,,,24154.0,,,,1279935.0,24154.0,,,,70720652.0,,-7436.0,,,20.36,36S155,20.0,,8063973.0,8831183.0,,,,182581.0,4201877.0,,,,,,1760537.0,,3016455.0,,18697 BAGLEY ROAD,,1472416.0,562934.0,,,368178.0,,155765.0,,,2381592.0,,,,,69504.0,,,,296.0,,1133.0,,289150.0,,333530.0,,,,1634336.0,,,,,9.0,-1669024.0,,4754361.0,,,17545725.0,4555447.0,,51.0,,2090154.0,,,13.0,18343.0,,,,71764.89,,,,,30698.0,21746.0,,1571.0,,,1120.0,41442.0,1921326.0,1978331.0,238.0,,36384.0,,587685.0,214940.0,82777.0,,11735180.0,1539.0,278128656.0,,,,2570.0,,81451.0,,1469019.0,54.11,,1351478.0,,,,65004.88,172920.0,773.0,,SWGHC MENTAL HEALTH SERVICES,,14101.0,295862963.0,353318.0,,,,16096.0,,83457425.0,,,,1876588.0,,,,,14415.0,1876588.0,,,,,,,,5496944.0,,121490.0,63709.0,,2012-12-31,,4577333.0,,-2810.0,,,,143688.0,,1176456.0,,,,,,,2892168.0,-22694.0,,32537704.0,,1304895.0,,1479284.0,,90555.0,,,,,,,11008718.0,811890.0,,,22043755.0,,,,,,,,,,,35.82,,,,,,,,388384.0,,14374290.0,3770454.0,,523130.0,47837.0,2483281.0,,,13586423.0,,,,4530284.0,,,,,,6199.0,,,17460,,,15343394.0,,,,,,,,,,15.52,,,,,,,-7103.0,,,,,1465326.0,,,,2457365.0,3938304.0,,,,-6833368.0,,396385.0,2292965.0,21100537.0,,,,18.21,,,98384.0,32451505.0,823978.0,3770454.0,3621439.0,,,,,1469019.0,,2286603.0,,,,,,,167865.0,,47610432.0,326645.0,,4143881.0,,5.0,2875572.0,,113539301.0,740318.0,,,,,,1985757.0,,1815.96,,,,,,887764.0,1158656.0,217734.0,,,137703.0,6287237.0,,,,8244985.0,,,,4359.0,19799128.0,,102123416.0,,,,,,,,3016455.0,,1179113.0,,,,,,2320954.0,,,,,16096.0,2269.0,450.0,31783856.0,2087194.0,274177.0,368178.0,19240243.0,21124195.0,,,,2214631.0,29.64,,,,,,,,17799553.0,,24988097.0,,,,,,,147560.0,4906531.0,,,,,,7313141.0,36T155,,2609.0,,,,,,4410878.0,,88530.0,9926.0,,,1072670688.0,,514.0,,,,,,591886.0,35252.0,14072907.0,209.0,,General Short Term,,9481.0,,,17314310.0,,,514.0,5732658.0,1525.0,,,,767601.0,28.4,105448969.0,91175659.0,,,,,4011.0,11423812.0,,,,,,-156656.0,,,5832.0,1713105.0,,1022267.0,388384.0,,,-24199425.0,-33820.0,27.41,,,75762.0,335784.0,,233513.0,5373945.0,,,,,,,,178560057.0,367253,,491192608.0,9751440.0,,-21785.0,9235872.0,4579621.0,,414321.0,,,Y,1837.0,,440549.0,3057019.0,2483281.0,226714794.0,,,,,8497401.0,4636.0,4836984.0,,,6864215.0,,,,,36170,1348451.0,,767601.0,,,34448354.0,,3689059.0,703165.0,,,91164336.0,2621649.0,,,36001.0,,F,,,,,,,,26256612.0,1427879.0,806042.0,,,,,,,,,8017455.0,,,,,2895563.0,88739.0,,,,,,,,,3285932.0,,68.25,,,,,-236570.0,,9349.0,12682331.0,251095.0,9131437.0,,,29746.0,,,18061.0,,,,72757.0,1233414.0,12.1,,1166251.0,88615.0,,2413.0,,,,,19225.0,,45485.0,41063.03,117506.0,,,3403230.0,,1169158.0,,209.0,,,99134.0,,,,-1787985.0,,15774709.0,171893.0,,327460.0,,,82555.0,,-72732.0,,,,2894.0,13096183.0,,40651.9,,,,8100030.0,10087586.0,,,,,,506050.0,445496.0,,,,,,,,311653.0,,,,,1147293.0,,,,160.0,,,,1272091.0,,29746.0,,,,20370249.0,38568760.0,-318992.0,,,445.0,,,,,,,1627773.0,227139.0,11060.0,1080866.0,51466.0,,,,,,,42.0,,,,511608.0,10270.0,17603047.0,5724.0,,,,,668.0,10195950.0,,,,,,19.0,,,,,464997.0,3118304.0,,,226462681.0,252657301.0,,,,1389715.0,226149721.0,,4234833.0,11183.0,,,,1304895.0,OH,-5875.0,21749.0,769697.0,,,,,1541.0,5568126.0,1811.0,2922645.0,,10986622.0,3203787.0,,,,,Y,1701506.0,,N,460276.58,,,543094.0,,,,,,,,2291876.0,7255650.0,,47837.0,1227972.58,107.0,,159134.0,,,,,548.0,,,,,13578816.0,4156.0,0.212545,,,,-57614.0,,,4858653.0,1385039.0,,63471.0,,,,,,,,,,7962288.0,,124512.0,18216045.0,65102430.0,3444.0,,,,,,,,,,,3656.0,245677151.0,,,,,3775506.0,1787468.0,,,36,,8561555.0,3636751.0,N,,,,,4248624.0,1773683.0,,,,,44980.0,88938.0,,3374.0,,75794.0,23.86,7134712.0,2419261.0,1570562.0,519531.0,,,,,,,,,753088.0,,6954.0,,,-617047.0,1056495.0,N,,102371498.0,260506.0,,,994969.0,7306152.0,,1061909.0,37783902.0,,1627031.0,3770221.45,,,,,,47148.0,,9488.0,14672507.0,4861478.0,,25758767.0,,4758.0,,,,,,1539.0,4353.0,,,,,,,,,,60299.0,26.82,,,,-250201.0,190603.0,,,81451.0,,,,,,,992985.0,,,,,321.0,,-4635847.0,1653498.0,16244.0,3915400.03,,52254.0,876318.0,N,7414602.0,,9481.0,,,,25017868.0,,,14560833.0,,,494136.0,,,,,3749934.0,685736.0,,,1378911.0,154876.0,,6225.0,,,,,,,,,,9459.35,13856848.0,354055.0,16.7,,,1539.0,2209398.0,15201,2176142.0,,,,12.29,35.98,,,2214631.0,,,,,,,,,P,,,,,6660.0,368.0,,,,,,,,,2263.0,,,,494.0,,2012,0.015525372641748438,161137386.0,13123038.620545,4045465.620545,17799553.0,8812550.620545,0.08874585630375101,28952719.0,0.0978585447344418,1.297786746192708,1.436953809905499,1.1676357741757533,0.35482583325314665,161137386.0,1.7182790280587026,0.6321201798351938,0.3678798201648063,19.344886483958845,161137386.0,0.6754609611320538,5.450271194606758,Acute Care Hospitals,non-profit,0,SOUTHWEST GENERAL HEALTH CENTER (360155)
20356,SOUTHWEST GENERAL HEALTH CENTER (360155),General Short Term (Acute Care Hospitals),Voluntary Nonprofit-Other,-81.83291,41.37208,,,,20835.0,,,,,,,31430.43,,,1675901.0,,,,,,,121150.0,16249250.0,CUYAHOGA,,,83167.0,104170.0,14136.0,,,99943.0,,1.0,,,3652678.0,,356.0,1044.0,,,79745.0,2548209.0,13921792.0,30.0,14.5,2280458.0,,51.0,,,1556237.0,1496538.0,529779.0,,13684307.0,,,,12954153.0,,,40867.0,,,,126142.0,,,,,,,175.0,,,8156987.0,228.0,,10696048.0,73822328.0,,894.0,13824970.0,,,,20810413.0,,14136.0,,,,,,,,863701.0,71006.99,,N,1136001959.0,171164770.0,27.51,,,2024-08-14 00:00:00,3137812.0,,,6305.0,,,,,,,,,,476334.0,1111855.0,368708.0,,5675166.0,,,,2441478.0,158053.0,,43394768.0,,-191016.0,,,202.0,2190293.0,96689.0,,,,28.04,,986672.0,,,20152905.0,2984797.0,,,,,80836.0,,,4761.0,,,,228313.0,967075.0,,,33187.0,,,,,,,66240196.0,,,,,,,104170.0,,,3835.0,,,,,4251486.0,,,26903976.0,530561.0,,,3878.0,3861.0,,,2991379.0,,734656.0,,7414252.0,,,,,,,,,,,1735377.0,,,-246868.0,,4685113.0,,,,,,117445.0,,3.0,84193.0,-26599.0,,,,3514307.0,,,,,279446.0,,,951109.0,,2004526.0,,,273.0,,,N,,,,,,942.0,5840.0,185743.0,,,6900.0,3633368.0,,,23633263.0,,,,36.0,,,,,1.0,8128194.0,,396245.0,,,,,1847678.0,3015229.0,,,205782.0,,222858.0,,,,,1281283.0,,2769033.0,,,,1268674.0,120028.0,,4251486.0,,2577.0,-165679.0,3650.0,,,,9447.0,,,,25823.0,5299920.0,,,623824.0,,,,,,8568392.0,,3474.0,,,2423264.0,,15977.0,1556548.0,148576.0,,,,3232547.0,4354.0,16932.0,,,,,106245.0,,,,,122691.0,,,,,,1563854.0,,22687.0,,68.73,2505216.0,,,4980260.0,27.29,4373.0,27.77,,,19165.0,1116842.0,,,,4459471.0,,,,,,19680.95,,,,109244017.0,,,,4521.0,,,2946.0,,,,106267631.0,,,,1942792.0,,,87910.0,65062.0,1003030.0,,,623107.0,,-30804.0,,,-54804.0,,,5840976.0,,14990652.0,,,,,251597.0,421789.0,,,,3444131.75,,792719.0,,,,1589660.0,35716863.0,89545.0,,,,,,,,,2173759.0,83167.0,,7229484.0,,,722151.0,,,,,338240.0,12830270.0,,,300780.0,,1957958.0,1469103.0,,,79071.0,,,,,23543.0,7320.0,,,,-45392.0,,,20614556.0,,1504367.0,-903051.0,49832.14,2730643.0,2543.0,12573.0,,,,4080467.0,,6914203.0,,,,,,,,,1957958.0,,,,,,13091335.0,425765.0,,7272629.0,,,,,1 S ACUTE REHAB,19165.0,,8238671.0,,,,65062.0,,20579.75,,,,,,,28003.0,-4415841.0,,45.09,,104170.0,,,1844613.0,,3934413.0,,515314.0,-182348.0,,,72063.0,,,,,,,,,1223517.0,,,,,,,,,,,324864691.0,,656305.0,8501701.0,,100323.0,25992.0,21504323.0,1149.0,,,,,34667176.0,,,5071042.0,,,7629395.0,,3104.0,,,-913232.0,8084770.0,,,,,,120009359.0,,,,,106840.18,2371833.0,9129.0,,,361530,7401.0,,D,,13953958.0,,,,,,,,,,5307602.0,,,,,,,,104170.0,15778820.0,1184.0,,1569062.0,,4358634.0,,16188044.0,-80385.0,5471.0,,,2211.0,,,,14097173.0,,4080467.0,,,,,,,,,16188044.0,4917.0,,,,,,185407.0,44424899.0,1281283.0,22687.0,,,,,,,,-2301773.0,,,3834771.0,,,33187.0,,,3936055.0,,,,238.0,,6149356.0,,,,1407199.0,-8898.0,47280.0,,,,12789659.0,,,334.0,,,468.0,153.0,,46987586.0,,20142176.0,,,,5538442.0,7300.0,360155,18.0,,,16975.0,,216598.0,,,16415378.0,,,,,,4179889.0,,22998767.0,26086543.0,,,N,4603972.0,,,,,9528324.0,20559296.0,1749032.0,,,,,,,,,9527051.0,,207.0,3471949.5,121029832.0,,SOUTHWEST GENERAL HEALTH CENTER,,196519.0,,,6186929.0,,17410.0,,1452376.0,,214704.0,,,,,,9.0,13994825.0,,7147094.0,121181910.0,,,35716863.0,-5024.0,3322184.0,,,,1059419.0,,,780928,1734107.0,,3.0,,,,538798.0,,,,,,,,,,77114.0,11637.0,,,,,9129.0,1983996.0,,,628698.0,,,,,,,,,1082375.0,1903985.0,257533923.0,,124539816.0,2355356.0,,635828084.0,,3089796.0,,906742.0,,,,139.69,,,15916157.0,,14936825.0,,3070545.0,684876.0,,2013-01-01 00:00:00,,,79149709.0,1112.0,28021926.0,,-19898478.0,22998767.0,,,,,,,,,,,N,204940.0,,,549445.07,,920476.0,,-11883.0,14992568.0,,,,7232.25,,13996166.0,,1752628.0,6750727.0,,,,,,,,,,178560057.0,,4,,,,,,,,30.64,65062.0,24910.0,,20767616.0,,5028288.0,,,,,,3895531.0,,33880.0,,,,-291896.0,,,,,28151321.0,13214371.0,1558.0,469648855.0,2989553.0,87910.0,,-195295.0,,,120009359.0,,,,8195843.0,,,,,8195843.0,,4619393.0,,2590299.0,,,,,,365919,,321007882.0,,,20152905.0,,,,596441.0,63.0,MIDDLEBURG HEIGHTS,,,,,41367.0,211497773.0,,,,,,108555.0,1755171.0,,,5071042.0,,,,134.0,,29849.0,,59695236.0,38220.0,40537.2,22.9,,,,,1294184.0,,,14963368.0,,100323.0,6307732.0,,3939224.0,13195993.0,2843.0,121721.0,,2869285.0,529779.0,,,-24802.0,,,415818.0,16594826.0,,3249702.0,,,590487.0,,,16980228.0,125069.0,,13953160.0,75109.97,191910886.0,,,,4639733.0,2961.0,,3029598.0,,8568392.0,815703.0,3213956.0,9013.0,,,304035.0,4266.0,,,,,,,,-312.0,,6307732.0,,71035.0,,,,,13994825.0,1376314.0,,,,474782.0,8505.0,,,,,,,1879183.0,,901180.0,,,-27377.0,,,1457255.0,,,,,,,-828653.0,,,N,1440.0,,,,,,,,,,,1791280.0,41410.0,,18204505.0,215774.0,,,,,102885.0,,1264.0,,,34639644.0,,,,,,,,,-17685.0,1302874.0,,,,110576.0,,,,,,,,,,4378812.0,9693939.0,,89971065.0,56288473.0,1523.0,19241.0,,792719.0,,,,,,,,,,,,,,,,3322184.0,,24107.0,,24.02,,,3115557.0,,,60.0,,1755171.0,,,,,238115.0,,13664513.0,66564.0,59477029.0,-46696.0,13076.0,,4424673.0,1791280.0,,4576304.0,,,,2029185.0,2672426.0,,461203.0,3036715.0,8371281.0,-12554.0,2355356.0,,,,629097249.0,,2029185.0,,34.8,,810254.0,,,,,874265.0,1647655.0,,13664513.0,4459471.0,396857.0,,,,,,18899159.0,,,,148715.87,23236375.0,421788.0,,,,,,2301383.0,,,-51674.0,44441.0,,,1533546.0,Y,,46823.0,,,23.0,,-67710.0,44130-3497,81915.0,899163.0,580875.5,1675828.0,,33.66,33656.0,20835.0,2219753.0,,12789659.0,,,,,,,,-9872972.0,,,,3633368.0,,,4009875.0,,508461771.0,,386.0,,,189479.0,20168654.0,51225588.0,,,,,,,,,,,1431924.0,,277432401.0,1112.0,47.21,,159.0,459683.0,106899.0,Y,,,159127.0,,6456843.0,,,,546649.0,3934413.0,,,,,5953060.0,249530.0,,,N,56180.15,,,,,,,,62016.0,3019456.0,2398278.0,1476626.0,906742.0,72145.0,,,,,,,,,10044874.0,,,,,,,,,,,,,279446.0,13118003.0,,1026010.0,,,1132489.0,,,,,4009875.0,1353794.0,,,1592363.0,,623824.0,,2349237.0,,16401332.0,,,,114.0,,1957958.0,,,,,,70658.0,,7272629.0,148576.0,4303947.0,28151321.0,2479257.0,,,2223.0,,,,,,,,3484516.0,,,,16025530.0,,,25909216.0,253066.0,60610.0,,77114.0,,10281036.0,,,,,,,34.9,,,12893738.0,123666.0,,,258151082.0,,,5000517.0,,,,,17.0,,,,,,53830.0,,,,957154.0,,,10696048.0,,104170.0,73730.0,,,53157.0,-19898478.0,,,4415028.0,9.0,,10769.66,13140.0,66011.0,,10.0,,,,258314.0,4947.0,,,,,,69669834.0,,,160726.0,,,,,,,6492762.0,236042941.0,48993140.0,506.0,,2049462.0,,1538.0,,2708703.0,,,,,,,,,,556818.0,,,8244057.0,6854865.0,6492762.0,3389994.0,,,,,7156842.0,7156842.0,,5571.0,4420.17,,,,23791384.0,,,,14358024.0,,102720.0,,,,,2190293.0,6305.0,35716863.0,1371125.0,442443.0,4012520.0,3036715.0,,5543.0,,121150.0,2236.0,,,,,-6281.0,,,,16980228.0,,,971661.0,,,,,,,,52617416.0,,,,49.0,,,8238671.0,,,,3612210.0,1.0,3762726.0,,,2170205.0,385315.0,945014.0,-4472.0,383080.0,1901868.0,,861319012.0,,2375823.0,N,2074826.0,,,14057682.0,945946.0,,,258099.0,2984797.0,,,304776.0,,1784404.0,,,,,11936111.0,,,58527245.0,15286492.0,952.0,,1504367.0,,,15.73,,,,,116919.0,3474.0,680557.0,13163.0,,,,817034.0,,109733946.0,16.0,,,,,1547238.0,,,,2163.0,,104170.0,,23633263.0,,250582.0,,9264939.0,61631988.0,,,111032056.0,,3249702.0,3768834.0,,1146049.0,,,18532133.0,18772.0,1701.88,7068.0,,292211.0,,425765.0,,,,143599.0,,,104170.0,161739.0,,,,,,23924673.0,121700725.0,23633263.0,,,,,,,838490.0,,9.0,,27426.0,,5322329.0,,,,N,,,,,9032738.0,,1102978.0,202.0,,26323.0,,,,,22425399.0,,10281036.0,,,,405241.0,72739.0,,1077899.0,,,1680,13996166.0,15359.0,28236892.0,,29904.0,185407.0,,-55563.0,,3580498.0,,1221795.0,,,,,,,,,,,,,,24910.0,,-3855261.0,,971661.0,24910.0,,,,70593334.0,,-2788.0,5276151.0,,20.52,36S155,20.0,,7306183.0,16514318.0,,,,211493.0,3776843.0,477255.0,,,,,1735377.0,,2991379.0,,18697 BAGLEY ROAD,,1551224.0,734656.0,,,412458.0,,148473.0,,,2281946.0,,,,,74932.0,,,,271.0,,1125.0,,416866.0,,299137.0,,,,1827689.0,,,,,2223.0,-1688742.0,,4896608.0,,,20143606.0,4315649.0,,29.0,,2123579.0,,,12.0,26024.0,,3195957.0,,69828.87,,,,,28283.0,11639.0,,6921.0,,,1089.0,66443.0,2046244.0,2103527.0,175.0,,7238.0,29791.0,776828.0,216598.0,56480.0,1582678.0,12804431.0,1430.0,301768714.0,,,,8529.0,,81153.0,,1457255.0,55.09,,1435661.0,,,,27817.75,241176.0,644.0,,SWGHC MENTAL HEALTH SERVICES,,20375.0,282970843.0,519346.0,,,,14717.0,,25456893.0,,,,2301383.0,,,,,32096.0,2301383.0,,,,,,,,5861794.0,,148576.0,72886.0,,2013-12-31,,4240946.0,,-6281.0,,,,195236.0,,1879183.0,,,,,,,3297292.0,-15662.0,,31088935.0,,1734107.0,,1640031.0,,122798.0,,,,,,,10027069.0,822566.0,,,26120530.0,,,,,,,,,,,38.91,,,-75545.0,,,,,350253.0,,13697219.0,1911874.0,,920476.0,47308.0,940213.0,,,13759322.0,,,,4372049.0,,,,,,19376.0,,,17460,,,15740309.0,,,,,,,,,,15.41,,,,,,,-627.0,,,,,4209680.0,,,,2931554.0,5247470.0,,,,-6994813.0,,478155.0,2371833.0,18899159.0,,1026010.0,,19.19,,,132702.0,90278619.0,811540.0,1911874.0,4098827.0,,,,,1457255.0,,2441478.0,,,,,,,298040.0,,47193932.0,251597.0,,18133847.0,21279369.0,5.0,2924557.0,,108304066.0,792719.0,,,,,,2251996.0,,1865.62,,,,,,1008961.0,1286256.0,181989.0,,284.0,112353.0,1749032.0,,,,7629395.0,,,,4610.0,28021926.0,,106267631.0,,436402.0,,,,,,2991379.0,,1082184.0,,,,,,3389994.0,,,,468923.0,14717.0,2211.0,,28885921.0,2533754.0,238115.0,412458.0,20869145.0,20168654.0,,,,2339647.0,28.55,,,,,2788026.0,,,17435279.0,,23633263.0,,10188.0,,,,,206961.0,5028288.0,,,,,,7272629.0,36T155,,2760.0,,,,,,4083290.0,,87910.0,12434.0,,,1144289855.0,,542.0,,,,,,826297.0,33712.0,19359318.0,230.0,,General Short Term,,8959.0,468923.0,,17335249.0,,,542.0,5630542.0,1613.0,,,,1084226.0,28.67,113539301.0,95484695.0,,,,,3861.0,-1410713.0,,,,,,-229481.0,,,14046.0,1737124.0,,1075891.0,350253.0,,,-23957495.0,-33819.0,24.71,,,73730.0,281696.0,72145.0,225191.0,4685113.0,,,,,,,,180605253.0,367253,,506904710.0,4303947.0,,-26845.0,9880642.0,4990747.0,,537094.0,,,Y,2170.0,,601833.0,3052454.0,940213.0,191910886.0,,,5907089.0,,8502056.0,4761.0,-1410713.0,,,258314.0,,,,,36170,1339498.0,,1084226.0,,,35716863.0,,4721140.0,596441.0,,,95636773.0,2546097.0,,,42763.0,,F,,,,,,,,22052760.0,1353963.0,1140975.0,1109058.0,,,,,,,,9032738.0,,,,,2626937.0,85928.0,,,,,,,,,3098620.0,,129.9,,,,,-1165837.0,73568.0,,12852580.0,88232.0,8371281.0,,,26218.0,,,16794.0,,,,55873.0,1662536.0,12.16,,1294184.0,76459.0,,2163.0,,,,,16975.0,,38554.0,38551.0,193726.0,,,3844712.0,,1252250.0,,230.0,,,177463.0,,,,-2154207.0,,17191627.0,205177.0,,369560.0,,,76713.0,,-91754.0,,,,2946.0,13264478.0,,41317.58,,,,9677546.0,10612534.0,,,,,7065360.0,630233.0,408299.0,,,,,,,,311972.0,,7065360.0,,327823.0,1169907.0,,,,114.0,26021200.0,,,1302561.0,,26218.0,,,,19958231.0,38103795.0,-706343.0,,,413.0,,,,,,,3090413.0,222093.0,1248.0,951109.0,51829.0,,,,,,,42.0,,,,474782.0,6504.0,19135038.0,5571.0,,,,,1374.0,34554121.0,,,,1669.0,,15.0,,,3163.0,,394743.0,3026765.0,,,232927384.0,257533923.0,,,,277328.0,232605576.0,,3698179.0,10737.0,1825.0,,,1734107.0,OH,2526.0,20835.0,743776.0,,,,,2161.0,5425794.0,,2820089.0,,12496221.0,3019157.0,,,,,Y,1290652.0,,N,479243.41,,,529228.0,,817034.0,,,,,3834771.0,1847678.0,7255650.0,,47308.0,1270331.19,27426.0,,258199.0,,,,,232.0,238.0,,,,13946430.0,94994.0,0.204758,,,,-56925.0,,,4791572.0,1371125.0,,52424.0,,,,,,,,4120.0,,6837172.0,,127186.0,17440238.0,77909076.0,6383.0,,,3285.0,,,,,,,,4830.0,211490095.0,,,,,3592133.0,1784404.0,,,36,,9528324.0,4935965.0,N,,,,,3911463.0,1445807.0,,,,,40688.0,86870.0,,3202.0,,80463.0,24.27,8244057.0,2354343.0,1521813.0,513808.0,,,,,,,,,783331.0,,5475.0,,,-702189.0,1868504.0,N,,106757560.0,228713.0,,39153.0,1163825.0,7270516.0,,1793844.0,22052760.0,,1524159.0,3880782.5,,,1550193.0,,,5680.0,,20926.0,16595058.0,4503023.0,,25909216.0,,4380.0,,,,,,1430.0,,,,,,,,,,,92773.0,27.26,,,,-445387.0,192261.0,,,81153.0,,,,,,,1082375.0,,,,,311.0,,-630350.0,1657562.0,19567.0,4025007.25,,62462.0,920119.0,N,6414977.0,,8959.0,,,,24895096.0,,,16415378.0,,,626973.0,,5675166.0,,,3484516.0,559233.0,,,1566204.0,139097.0,,4739.0,,,-14278.0,,,,,,,4734.75,30270617.0,290434.0,14.51,,,1430.0,2958910.0,15201,2938107.0,,,,13.74,36.46,,,2339647.0,,2218463.0,,,,,,,P,,,,,8686.0,1719.0,,,,,,,,,2236.0,1072.0,,,673.0,,2013,0.06536311885214878,211497773.0,14265455.870172,5000516.870172,17435279.0,23205021.870172,0.07793297629607726,5538442.0,0.019572482950125005,1.1761601067726308,1.1467738410677408,1.0518661357825692,0.26321297418866335,211497773.0,1.2205853439411865,0.5496682878104749,0.4503317121895251,1.6290961948160714,211497773.0,0.6025157731939962,4.834856706479179,Acute Care Hospitals,non-profit,0,SOUTHWEST GENERAL HEALTH CENTER (360155)
24389,SOUTHWEST GENERAL HEALTH CENTER (360155),General Short Term (Acute Care Hospitals),Voluntary Nonprofit-Other,-81.83291,41.37208,,,,20412.0,,,,,,,30551.5,,,1839557.0,,-5506.0,6.0,,,,154457.0,18646200.0,CUYAHOGA,,,83531.0,105642.0,14236.0,,,97520.0,,1.0,,,3589565.0,,385.0,1570.0,,,75816.0,911334.0,16009447.0,43.0,14.42,2548441.0,196.0,38.0,,,1415572.0,1258621.0,493018.0,,14492230.0,,,,16271143.0,,,14083.0,,,,125701.0,,,,,,,65.0,,,8502540.0,697.0,,11385920.0,81397523.0,,934.0,13582734.0,,,,23717422.0,,14236.0,,,,,,,,728514.0,61697.12,8656177.0,N,1192854855.0,185356011.0,27.61,,,2018-01-31 00:00:00,2707693.0,,,8810.0,,,,,,,,,,489114.0,235352.0,368707.0,,6465474.0,,,,2477810.0,410901.0,,44109407.0,,-7196.0,,,201.0,2197795.0,105195.0,,,263.0,28.48,8.0,997789.0,,,20458388.0,3036966.0,,,,,77214.0,,,1685.0,,,,241892.0,1031131.0,,,31291.0,,,,,,,58751228.0,,,,,,,107065.0,,,3641.0,,,,,4499137.0,,,32647030.0,581625.0,,,4457.0,3679.0,,,2730816.0,,759053.0,,6975848.0,3393805.0,,,,,,,,,,1869992.0,,,-201476.0,,5027611.0,,,,,,,10128.0,,69522.0,-1905.0,,,,961250.0,,,,,299706.0,,,605984.0,,2268936.0,,,246.0,,,N,,,,172383.0,,589.0,1825.0,210617.0,,33657.0,1581.0,4113918.0,,,25758159.0,,,,36.0,,,,,1.0,22338753.0,,608905.0,,,,,1992196.0,914784.0,,,295105.0,,244371.0,,28191.0,,,1496840.0,,3582177.0,,,,1342121.0,286148.0,,4499137.0,,12461.0,-184617.0,3650.0,,,,6165.0,,,,13346.0,5367494.0,,,560810.0,,,,,,8568392.0,,3437.0,,,2684928.0,,17444.0,568186.0,,,,,3476699.0,6294.0,22262.0,,,,,108125.0,,,,,84383.0,,145986.0,86334.0,,,1149067.0,,31598.0,,95.11,1553106.0,,10.0,5279148.0,27.24,1076.0,27.55,,,14469.0,2139723.0,,,,4849368.0,,,,,,19813.45,,510.0,,108259494.0,,,99.0,5866.0,10189.0,5435.0,3926.0,,,,105862726.0,,,,1929734.0,,,89215.0,63953.0,991393.0,,,595744.0,,-1275.0,,,-69659.0,10.0,,5944438.0,,14969823.0,,,,,390435.0,368708.0,905.0,,,3412332.17,,722854.0,,,,1454677.0,38244642.0,86135.0,,207.0,,,,,,,2295515.0,83445.0,,10208898.0,,,772537.0,,,,,934504.0,12590407.0,,,378805.0,,2078098.0,1669728.0,,,71999.0,,,,,16302.0,15996.0,,,,-64654.0,,,20852942.0,,913355.0,-962046.0,52530.57,2852636.0,13480.0,12014.0,,,,4030965.0,,7543794.0,8983.0,-200.0,,,,,,,2078098.0,,,,,,13835447.0,335443.0,,7549102.0,,,,,ACUTE REHAB,14469.0,,8488318.0,,,,63953.0,,15887.51,,,,,,,56768.0,-4517541.0,,36.69,,107065.0,,,1774289.0,,4001783.0,,498857.0,-50552.0,1025.0,,114418.0,,,,,,,,,1453720.0,,2.0,,,,,,,,,321891018.0,,707465.0,8410368.0,20366.0,117908.0,25018.0,15792809.0,2159.0,,,,,34768751.0,,,4527548.0,,,7399337.0,,4922.0,,,-945275.0,7226003.0,,,,,,140671563.0,,,,,104744.08,14642383.0,42381.0,,,361530,10333.0,,F,,12042385.0,,,,,,,,,,4403386.0,,,,459840.0,,7.0,,105642.0,15904628.0,145.0,,1593226.0,,4814359.0,326071.0,11570378.0,-99780.0,1139.0,,,680.0,,,,14464181.0,,4030965.0,,,,,,,,,11570378.0,690.0,,,,,,261178.0,44534577.0,1496840.0,31598.0,,,,,,4899.0,,4805943.0,,,4046734.0,,,31291.0,,,3821489.0,,,,238.0,,6937241.0,,,,886831.0,-3833.0,47848.0,,,,19843542.0,,,43.0,,,608.0,126.0,,49668025.0,,22595158.0,,,,5981439.0,11680.0,360155,10.0,,,8895.0,,213294.0,,120.0,18875254.0,,,,,,1201927.0,,26565375.0,29636818.0,,,N,4414084.0,,,,,10655382.0,5945571.0,1344958.0,,,,,,,,,9435429.0,,198.0,3437315.68,122299479.0,,SOUTHWEST GENERAL HEALTH CENTER,,168424.0,,,5747807.0,,48617.0,,2075590.0,,234173.0,,,,,,9.0,12056468.0,,7147094.0,122148265.0,,,38436950.0,-10435.0,8993471.0,,,,1227000.0,,,617558,1879942.0,,3.0,,,,474712.0,,,,,,,,,,5277.0,8598.0,,,,,5990.0,2147785.0,,,598896.0,,,,,,,,,1208940.0,1666616.0,278332308.0,,146335517.0,2429830.0,20931.0,674159110.0,,3431328.0,,835054.0,339224.0,,,122.05,,,18280313.0,,13824970.0,,3256344.0,677451.0,,2014-01-01 00:00:00,,,80137263.0,1624.0,27814813.0,,-12886429.0,26565375.0,,,,,,557395.0,,1259468.0,,,N,338777.0,,,565062.68,,762603.0,,-6339.0,16102617.0,,,,7612.06,3.0,13852427.0,,2766225.0,10091102.0,,,,5069.0,,,,,,180605253.0,,2,,,,,,,,30.37,63953.0,31942.0,,23680414.0,,5848643.0,,,,,,3965441.0,6567.0,35110.0,,,,-202493.0,,,,,28236937.0,126526770.0,1401.0,471036683.0,2690198.0,89215.0,,-11961.0,748527.0,,140671563.0,,,,7474104.0,,,,145986.0,7474104.0,,7180871.0,,3125892.0,,,,,-2425.0,365919,,317937841.0,,,20458388.0,1714834.0,,,679807.0,74.0,MIDDLEBURG HEIGHTS,,,,,26179.0,190339309.0,,,,,,,1946997.0,,,4527548.0,,,,272.0,,27178.0,,69004205.0,35800.0,38076.48,23.33,,,,,1401857.0,,,3367654.0,,117908.0,6265975.0,,,13627205.0,-65814.0,118035.0,,3261645.0,493018.0,,,-21683.0,,,401722.0,19047772.0,,3646652.0,,,349549.0,,,17043908.0,194070.0,,16039923.0,80519.88,221946146.0,,,,4194011.0,,,870436.0,,8553892.0,393992.0,3175345.0,3523.0,,,260461.0,7899791.0,3.0,,,,,,,-155.0,,6265975.0,,114793.0,,,,,12056468.0,1373389.0,,,,1116494.0,11283.0,,,,,,869767.0,1978223.0,,836976.0,,,-400997.0,,,1299029.0,,,,,,,-850038.0,,,N,5000.0,3.0,30.0,,,,,,,,,1605871.0,55437.0,,13310365.0,,,,,,1692633.0,,1941.0,,,38359669.0,,,,,,,711.0,,-24216.0,968845.0,,,,71509.0,,3318.0,,,,,,195559.0,,4272830.0,9909725.0,,191683532.0,65726779.0,4527.0,24526.0,,722854.0,,1209.0,,,,740726.0,,,,,,,,,,8993471.0,,27932.0,,24.12,,,4185332.0,,,200.0,,1946997.0,,,,10.0,254411.0,,14471258.0,119549.0,64137350.0,-48436.0,12911.0,,4639675.0,1605871.0,,5138409.0,,,,2175869.0,3600525.0,,424202.0,2561478.0,12850913.0,-5000.0,2429830.0,,,,665596507.0,,2175869.0,,35.79,,1052376.0,,,,81.0,3862620.0,1917207.0,,14471258.0,4849368.0,448117.0,,207.0,,,,21862884.0,,,,173668.35,16040310.0,421788.0,,,,,,2445682.0,422833.0,,-52261.0,44116.0,,,1542000.0,Y,,3136.0,,20366.0,,,-58617.0,44130-3497,33734.0,1126015.0,595614.18,1065157.0,,33.52,87.0,20412.0,2100428.0,,19843542.0,,,,,14500.0,,,-3648650.0,,,,4113918.0,,,4729422.0,,528810401.0,,,,,202023.0,19680487.0,56294410.0,,,,,,,,,,,242595.0,,291218737.0,1624.0,67.63,,111.0,570391.0,99243.0,Y,,,161692.0,,6273771.0,,,,625948.0,4001783.0,,,,,8960884.0,256196.0,,,N,59704.96,,,,1047983.0,,,,349.0,7180871.0,2558641.0,1372749.0,835054.0,1629610.0,,,,53081.0,,,,,9660026.0,,-13721.0,,,,,,,,,,5739.0,299706.0,126517510.0,,89610.0,,,1141361.0,,,,,4729422.0,576377.0,,,1623969.0,,560810.0,,2201299.0,,18860327.0,,,,69.0,,2078098.0,,,,,,66053.0,,7549102.0,158791.0,3172316.0,28236937.0,2522295.0,,,344.0,,,,,,,,4196763.0,,,28054.0,23768598.0,,,26930570.0,720483.0,60816.0,,5277.0,,10581226.0,,,,,,,35.54,,,9832187.0,126849.0,,,280697374.0,,,8890152.0,,,,,10.0,,,,,,103580.0,,,,976954.0,1768.0,,11385920.0,,105642.0,73365.0,,,98010.0,-12886429.0,,,4873420.0,9.0,,7483.62,13140.0,67750.0,,10.0,,,,390255.0,,,,,,,89299098.0,,,126620.0,,,,,,,2266780.0,256144056.0,48458957.0,500.0,,101626539.0,,1945.0,,2943270.0,,,,,,,,,,22331.0,,,7310577.0,6006570.0,2266780.0,3467955.0,,,,,2647376.0,2647376.0,,5435.0,4159.92,,,,27420439.0,,,,14563758.0,,134156.0,,,,,2197795.0,8810.0,38436950.0,1211100.0,367793.0,4702574.0,2561478.0,,18380.0,,154457.0,2315.0,,,,,-1920.0,,,,17043908.0,,,1074533.0,,,,,,,,60566457.0,,,,51.27,,,8488318.0,,,,2444246.0,,6596151.0,,,2288361.0,487588.0,1181288.0,-6630.0,477557.0,2177282.0,,905769335.0,,2605411.0,N,2051144.0,,,13822723.0,1007035.0,,,229025.0,3036966.0,,,432621.0,,1778542.0,,,,,4570526.0,,,59820883.0,15075851.0,924.0,,913355.0,,267.0,13.38,,,,,147388.0,3437.0,624875.0,14677.0,,,,1414670.0,,108478164.0,5.0,,,,,1895389.0,,,,1435.0,,55089.0,,25758159.0,,380955.0,,9942671.0,63470485.0,,,111189781.0,,3646652.0,3629631.0,,1062476.0,,,21246151.0,4086.0,1692.09,12294.0,,244814.0,,335443.0,3903.0,,178.0,152043.0,,,105642.0,149036.0,,,,,,27552053.0,143496426.0,25758159.0,,,,1.0,,,610961.0,,51.0,2.0,4334.0,,5861271.0,,,,N,,,748527.0,,9622629.0,,4222530.0,201.0,,40018.0,31.0,-72123.0,,,24327840.0,,10581226.0,,,,408356.0,112523.0,,1110655.0,208239.0,,1680,13852427.0,16023.0,24930462.0,,21415.0,262106.0,,-138807.0,,9383726.0,,1686788.0,7119.0,,,,23193.0,,,,,,,,,31942.0,,,,1074533.0,31942.0,,,8664.0,73253567.0,,-6548.0,5470079.0,,21.05,36S155,32.0,,6882557.0,16056549.0,,,,228886.0,4026136.0,552339.0,,,,,1869992.0,,2730816.0,,18697 BAGLEY ROAD,,2108497.0,759053.0,,,462484.0,,213946.0,,,2239500.0,,459840.0,,,99163.0,,,,313.0,,1177.0,,424020.0,138.0,455092.0,,,,1397078.0,,,,,344.0,-912632.0,,4858645.0,,,22605987.0,4656830.0,,43.0,,1747440.0,,,12.0,33374.0,,3204425.0,,72974.25,,,,,32131.0,20899.0,,,27344.0,,1120.0,82798.0,3155419.0,2021083.0,78.0,,9096.0,51970.0,642804.0,213294.0,98628.0,4619393.0,12565843.0,10829.0,205431133.0,,,,6214.0,,82173.0,,1299029.0,53.18,,1461086.0,,,,24983.51,72583.0,2038.0,,SWGHC MENTAL HEALTH SERVICES,,32999.0,297200176.0,179861.0,,,,16093.0,,12759450.0,,,,2445682.0,,,,,33801.0,2445682.0,,,,,,,,6095129.0,,158791.0,89305.0,,2014-12-31,,2764179.0,,-1920.0,,,,10027.0,,1978223.0,,,,,,,3296460.0,-17772.0,,32461322.0,,1879942.0,,1590278.0,,82591.0,,,,,155.0,,9723217.0,1195531.0,,,28125137.0,,,,,,,,,,,42.32,,,-10747.0,,,,,407413.0,,13119455.0,2376123.0,,762603.0,48006.0,1301590.0,,,14094297.0,,,,4466325.0,,,739194.0,,9446.0,3875.0,,,17460,,,16908633.0,,,,2.0,,,,,,14.85,,,,,,,-1005.0,,,,905099.0,1253897.0,,,,3990409.0,5690215.0,,,,-7588820.0,,654114.0,14642383.0,21862884.0,,89610.0,,18.19,,,214598.0,17125657.0,760486.0,2376123.0,4501184.0,,,,,1299029.0,,2477810.0,,,,,,,293424.0,,48116754.0,390435.0,,13244312.0,20553029.0,5.0,2808596.0,,125682111.0,722854.0,,,,,,1840849.0,,1856.5,,,,,,923818.0,1392700.0,163419.0,,5419.0,27653.0,1344958.0,,,,7399337.0,,,,7916.0,27814813.0,,105862726.0,,1126364.0,,,,,,2730816.0,,1095064.0,,,,,,3467955.0,,,,586527.0,16093.0,680.0,,33368870.0,4804635.0,254411.0,462484.0,23727623.0,19680487.0,,,,2323861.0,31.14,,,Y,,,,,16218237.0,,25758159.0,2364.0,1018.0,,,,,418545.0,5848643.0,,,,,,7549102.0,36T155,1.0,2759.0,,,,,,5844632.0,10.0,89215.0,11719.0,,,1202969511.0,,355.0,,,,,,755418.0,20783.0,25288354.0,442.0,,General Short Term,,8608.0,586527.0,6019.0,17403914.0,,,433.0,5718671.0,1669.0,,,,1053742.0,27.4,106704127.0,94165197.0,,,,,3679.0,1267812.0,,,,,,-229555.0,,,14927.0,1388076.0,,1071974.0,407413.0,928.0,,-27869540.0,-33820.0,27.4,,,73365.0,191956.0,1629610.0,262341.0,5027611.0,2.0,,,,1.0,170744.0,,274332001.0,367253,,527258348.0,3172316.0,,-23645.0,9465089.0,4478093.0,4.0,491022.0,,,Y,3089.0,,541310.0,3388392.0,1301590.0,221946146.0,2.0,,5944438.0,,8410723.0,1685.0,1267812.0,,,390255.0,,,,,36170,1433854.0,,1053742.0,,4207.0,38436950.0,,4819562.0,679807.0,,,94013983.0,911334.0,,,59804.0,,F,,,,,,,,21168221.0,884588.0,898753.0,1268186.0,995.0,,,,,,,9622629.0,,,,,1671141.0,111093.0,,,,,,,,,3513255.0,,143.09,,,,,-79666.0,5434251.0,,13259243.0,121012.0,12850913.0,,,3569.0,,,13050.0,,1324.0,,138352.0,2005544.0,11.72,,1401857.0,66312.0,1354.0,1435.0,54.0,,,,16403.0,,34504.0,35712.83,190726.0,,,4386676.0,,1524367.0,,442.0,,557395.0,194253.0,,,,-2812562.0,,16414344.0,204910.0,,610898.0,,,64658.0,,-98625.0,,,,3926.0,13901910.0,,39748.89,,,1709328.0,10643051.0,11258911.0,,,,,6454383.0,764000.0,324146.0,,,,1047983.0,,,,275555.0,,6454383.0,,,1056577.0,,,,64.0,24807620.0,28054.0,,342359.0,,3569.0,,,,20021951.0,38754946.0,-776963.0,,,357.0,,,,,,,4230878.0,240671.0,3573.0,605984.0,53872.0,,,440228.0,,,,60.0,,,,1188617.0,21508.0,22010323.0,5435.0,,,,1417.0,2218.0,18002039.0,3.0,,,1561.0,,15.0,,,72158.0,,242466.0,3181594.0,,,251958724.0,278332308.0,,,,147573.0,251567952.0,,4059263.0,19444.0,1700.0,,,1879942.0,OH,-1275.0,20412.0,828238.0,,,,,1637.0,1770640.0,,3014215.0,,2931029.0,3052292.0,,98.0,,,Y,1191547.0,,N,465363.71,,,130892.0,,1414670.0,,,,,4046734.0,1992196.0,7147095.0,,48006.0,1276394.72,4334.0,,208492.0,,,,,3281.0,2743.0,,,,14097850.0,23042.0,0.210896,,,,-58241.0,,,5429052.0,1211100.0,,91133.0,,,,,,,,,,9333657.0,,130575.0,18575368.0,73922018.0,6377.0,,,3285.0,,,,,,,,7844.0,188305476.0,,,,,4109163.0,1778542.0,,,36,,10655382.0,6427257.0,N,,,,,2547539.0,1528276.0,,23193.0,,,40293.0,86870.0,,3204.0,,92749.0,24.28,7310577.0,2421746.0,1388967.0,457341.0,,,,,,,,,779145.0,,5475.0,,,-568589.0,1751940.0,N,,106081396.0,359910.0,,406099.0,1125592.0,7543596.0,,1795898.0,22037988.0,,1465797.0,3842447.91,,,605534.0,,,4256.0,,29004.0,19051053.0,6342655.0,,26930570.0,,4380.0,,,,,,4612.0,,,22.0,,,,,,,,122067.0,27.07,,,,-235243.0,1161302.0,,,82173.0,,,,,,,1208940.0,,,,,311.0,,-4402718.0,1680215.0,,4007946.35,,62550.0,837706.0,N,7051378.0,,8608.0,,,,27442021.0,,,18875254.0,,,507201.0,,6465474.0,,,4196763.0,515065.0,,1379.0,1471298.0,145352.0,,2616.0,,,-13196.0,,,,,,,4648.0,18892546.0,205551.0,14.42,,,10829.0,2963560.0,15201,2937893.0,,,,13.76,37.86,,,2323861.0,,2120760.0,,,,,,,P,,,,,7776.0,431.0,86.0,,,,,,,,2315.0,,,,451.0,,2014,0.04547891435982706,190339309.0,18832822.571808,8890151.571808,16218237.0,22200516.571808,0.07122546589609018,5981439.0,0.020125960490682885,1.2582208154015095,1.2942558409162104,1.0927141982462052,0.2760493278540493,190339309.0,1.4747209889261497,0.5959140426436809,0.4040859573563191,1.5088036864402812,190339309.0,0.6309491101779009,4.968167654763638,Acute Care Hospitals,non-profit,1,SOUTHWEST GENERAL HEALTH CENTER (360155)
33260,SOUTHWEST GENERAL HEALTH CENTER (360155),General Short Term (Acute Care Hospitals),Voluntary Nonprofit-Other,-81.83291,41.37208,,,,17075.0,,,,,,,5938.2,,,1688325.0,,-547.0,14.0,,,,203349.0,20316809.0,CUYAHOGA,,,63182.0,106296.0,13571.0,,,96063.0,,1.0,,,3656730.0,,404.0,1128.0,,,81178.0,923140.0,16423463.0,39.0,15.0,2627543.0,8.0,,,,1376727.0,1042291.0,42790.0,,12612095.0,,,,16100041.0,,,17417.0,,,,150594.0,,,,,,,,,9.0,8461646.0,,,9104758.0,88095643.0,,1005.0,12859302.0,,,,25666677.0,,13571.0,,,,,,,,251400.0,65834.84,9078068.0,N,1185590210.0,191681933.0,28.12,,,2024-02-14 00:00:00,2468043.0,,,10329.0,,,,6485307.0,,,,,,489072.0,723432.0,368707.0,,7846136.0,,,,2377150.0,623152.0,,40497690.0,,-26741.0,,,189.0,2618683.0,115121.0,,,399.0,29.73,11.0,992758.0,,,17913591.0,2529944.0,,,,24.0,82964.0,,,,,,,245917.0,1071760.0,,,26364.0,,,,,,,52797162.0,,,,,,,107551.0,,,3830.0,,,,,4389726.0,,,29695476.0,560527.0,,,5731.0,3617.0,,,2721524.0,,762629.0,,7095720.0,2985537.0,3031704.0,,,,,,,,,1816505.0,,,-197995.0,,5968715.0,,,,,,289.0,2990.0,1.0,56356.0,-5853.0,1724871.0,,,,,,,,314197.0,,,603811.0,,2513026.0,,,240.0,,,N,,,,140290.0,,705.0,,217278.0,,77360.0,866.0,3684824.0,,,25166777.0,,,,36.0,,,,,1.0,9279779.0,,615298.0,,,,,1884374.0,,,736.0,289847.0,,219120.0,,85991.0,,,1614758.0,,4208084.0,,,,1251245.0,398842.0,,4389726.0,,,-185602.0,3650.0,,,,9241.0,,,,3872.0,5476281.0,,,546371.0,,,,,,8553892.0,,3508.0,,,2971888.0,,1151.0,602754.0,203921.0,,,,3305190.0,10316.0,23122.0,,,,,170155.0,,,,,96349.0,,505909.0,97712.0,,,1264791.0,,42589.0,,73.59,1608893.0,,18.0,4974720.0,28.35,673.0,28.27,,,8425.0,2374398.0,,,,5778709.0,,,,,,21634.25,,,,109673932.0,,,540.0,5306.0,8078.0,94.0,4183.0,,,,105736528.0,,,,1999865.0,,,79597.0,43490.0,1068222.0,,,594995.0,,-51540.0,,,-94766.0,,,7211433.0,,13897462.0,,,,,284659.0,368708.0,1094.0,,,3428994.95,,806880.0,,,,1416817.0,38362665.0,75184.0,,157.0,,,,,,,2372897.0,62932.0,,11271146.0,,,786611.0,,,,1.0,1530816.0,11376920.0,,,288021.0,,2205761.0,1844218.0,,,74825.0,,,,,14581.0,17807.0,,1.0,,-38282.0,,,21532027.0,,2367532.0,-1463008.0,48506.26,2821910.0,21502.0,11488.0,,,,3814282.0,,6863734.0,8493.0,-200.0,,,,,,,2205761.0,,,,,,14390246.0,362224.0,,8520143.0,,,,,ACUTE REHAB,8425.0,,8443132.0,,,,43490.0,,21025.66,,,,,,,111863.0,-4506979.0,,53.98,,107551.0,,,1793022.0,,4304395.0,,519978.0,-43798.0,1448.0,,82440.0,,,,,,,,,1332361.0,,4.0,,,,,,,157103.0,,436847410.0,,758232.0,8253550.0,10258.0,104708.0,21258.0,15765922.0,8427.0,,,,,36091323.0,,,4009263.0,,,6565107.0,,4718.0,,,-950322.0,6496104.0,,,,,,154761077.0,4751.0,,,,108176.9,15900332.0,,,,361530,869.0,,F,,1064524.0,,,,,,,,,,3751821.0,,,,396830.0,,43.0,,106296.0,16099015.0,,,2130981.0,,4974255.0,312018.0,9725295.0,-126675.0,2228.0,,,,,,,13449343.0,,3814282.0,,,,,,,,,9725295.0,,,,,,,255593.0,39854605.0,1614758.0,42589.0,,,,,,4098.0,,-325660.0,,,3996065.0,,,26364.0,,,3826967.0,,,,236.0,,7254272.0,2.0,,,889684.0,-4670.0,212607.0,,,,15422448.0,,,,,,755.0,126.0,,47985732.0,,27071757.0,,,,6525447.0,14275.0,360155,15.0,,,,,221662.0,,135.0,20582115.0,,,,,,555576.0,,26685680.0,27542918.0,,,N,4115302.0,,,,,9678008.0,2599793.0,1520444.0,,,,,,,,,7199295.0,,52.0,3457232.61,123857854.0,,SOUTHWEST GENERAL HEALTH CENTER,,175951.0,,,4265593.0,,19215.0,,2846545.0,,240585.0,,,,2.0,,9.0,1081941.0,,7147094.0,124186045.0,,,39506056.0,-12788.0,11631834.0,,,,1256910.0,,,763767,1595377.0,,3.0,,,,89068.0,,,,92.0,,,,,,4341.0,4994.0,,,,,12653.0,2374741.0,,,447793.0,,,,,,,,,1206082.0,1915988.0,277067996.0,,159774942.0,200761.0,702.0,704858866.0,,3603267.0,,11750.0,310562.0,,,84.71,,,14841449.0,,13589618.0,,3354165.0,661535.0,,2015-01-01 00:00:00,,,87753997.0,1392.0,33364662.0,,-20350465.0,26685680.0,,,,,,480614.0,,1026380.0,,,N,520845.0,,,540309.42,,41752.0,,-11541.0,17468139.0,,,,7105.25,16.0,13812594.0,,2863235.0,10698523.0,,,,8813.0,,,,,,274332001.0,,4,,,,,,,,34.06,43490.0,42695.0,,25634806.0,,5963284.0,,,,,,4288989.0,11981.0,31267.0,,,,-201645.0,,,,,24947388.0,19942727.0,129.0,473162344.0,2666542.0,79597.0,,-35380.0,782604.0,,154761077.0,,,,4690760.0,,,,505909.0,4690760.0,,8674248.0,,3698880.0,,,,,,365919,,432884973.0,,,17913591.0,1637609.0,,,547948.0,624.0,MIDDLEBURG HEIGHTS,,,,,15251.0,185483153.0,,,,,,,1981988.0,,,4009263.0,,,,267.0,,39861.0,,81640961.0,3807.0,37190.5,24.41,,,,,1470865.0,,,7351540.0,,104708.0,5869842.0,,,13436985.0,-187577.0,100238.0,,2869604.0,42790.0,,,-28910.0,,,427716.0,20791086.0,,3905638.0,,,147081.0,,,17677295.0,29585.0,,16455458.0,85104.72,234882029.0,,,,4252980.0,,,,,8580364.0,537462.0,3363682.0,1241.0,,,279875.0,1650323.0,9.0,,,,,,,-100.0,,5869842.0,,85889.0,,,,,1081941.0,1432338.0,,,,1447975.0,8907.0,,,,,,3465554.0,1857729.0,,12358.0,,,-549703.0,,,1453149.0,,,,,,,-870194.0,,,N,4947.0,6.0,293.0,,,,,,,,,1555852.0,53408.0,,1642831.0,,,,,,1685000.0,,2016.0,,,38985260.0,,,,,,,512.0,,-72474.0,1127068.0,,,,30805.0,,1632.0,,,,,,556390.0,,4247573.0,8127385.0,,188081246.0,65544988.0,4235.0,24736.0,,806880.0,,1170.0,,,,449025.0,,,,,,,,,,11631834.0,,31193.0,,24.87,,,4435551.0,,,,,1981988.0,,,,3.0,999204.0,,12592986.0,99097.0,69610157.0,-43203.0,13565.0,,4900104.0,1555852.0,,3833404.0,,,,1969523.0,3932864.0,,431750.0,1493377.0,16177151.0,,200761.0,,,,701034206.0,,1969523.0,,32.89,,1245930.0,,1611.0,,51.0,4816502.0,1883352.0,,12592986.0,5778709.0,362669.0,,110.0,,,,17757602.0,,,,179191.92,6637552.0,368707.0,,,,,,2898381.0,422038.0,,-2016.0,38815.0,,,1547550.0,Y,,2573.0,,10258.0,,,-115520.0,44130-3497,21991.0,1134664.0,546247.62,1105320.0,,32.13,227.0,17075.0,2108924.0,,15422448.0,,,,,,,,-10068106.0,,13086.0,,3684824.0,,,4784546.0,,486044429.0,,,,,19044.0,14926005.0,54406960.0,,,,,,,,,,,204525.0,,297418461.0,1392.0,52.22,,104.0,535131.0,10049.0,Y,1.0,1262.0,175492.0,,6169313.0,,,,756626.0,4304395.0,,,,,11008563.0,271817.0,,,N,59786.88,,,,867756.0,,,,1053.0,8674248.0,2966950.0,1151170.0,11750.0,1712497.0,,,,,,,,,10484921.0,,-33252.0,,,,,,,,,,29795.0,314197.0,19942727.0,,80609.0,,,1184031.0,,,,,4784546.0,568327.0,,,1524323.0,,546371.0,,181475.0,,20578887.0,,,,2.0,,2205761.0,,,,,,22731.0,,8520143.0,203921.0,2978975.0,24947388.0,2597650.0,,,,,1.0,,,,,,4282113.0,,,551.0,28836385.0,,,23222533.0,991861.0,54510.0,,4341.0,,9800916.0,,,23250.0,,,,35.92,,,10975779.0,161226.0,,,287679191.0,,,10568489.0,,,,,11.0,,,,,,133260.0,,,,1014470.0,2459.0,,9104758.0,,106296.0,68985.0,,,86738.0,-20350465.0,,,5127257.0,19.0,,27947.63,13140.0,67631.0,,10.0,,,,543395.0,,,,,,,116534230.0,,,192963.0,,,,,,,,260535911.0,39318765.0,433.0,,9143098.0,,1492.0,,3243237.0,,,,,,,,,,17394.0,,,7581817.0,6256550.0,,4037146.0,,,,,8295896.0,8295896.0,,4891.0,4159.92,,,,30148556.0,,,,14273846.0,,260019.0,,,4.0,,2618683.0,10329.0,39506056.0,1317307.0,362543.0,5221942.0,1493377.0,,13342.0,,203349.0,2228.0,,,,,-523.0,,,,17677295.0,,,1097857.0,,,,,,,,63044511.0,,,,53.29,,,8443132.0,,,,2503176.0,4.0,7320182.0,,,2362474.0,553445.0,4868885.0,-3941.0,442358.0,2282995.0,,886959387.0,,2757934.0,N,2640778.0,,,16071427.0,999781.0,,,22172.0,2529944.0,23250.0,,476930.0,,1867923.0,,,,,,,,61521315.0,16247269.0,919.0,,2367532.0,,1615.0,13.92,,,,,179923.0,3508.0,528811.0,16241.0,,,,1328025.0,,110390482.0,,,,,,1813967.0,,2552.0,,1469.0,,,,25166777.0,,415822.0,,14573072.0,61027770.0,,,119220672.0,,3905638.0,3896486.0,,118257.0,,,23072166.0,3077.0,1659.58,8734.0,,229585.0,,362224.0,9135.0,,262.0,148747.0,,,106296.0,52653.0,,,,,,30245781.0,156935851.0,25166777.0,,,,,,,560025.0,,18.0,1.0,572.0,,6045885.0,,,,N,,,782604.0,,10726690.0,,5337269.0,189.0,,25147.0,39.0,,,,24493673.0,,9800916.0,,-748.0,,402906.0,105579.0,,1135358.0,188020.0,,1680,13834363.0,1459.0,17206041.0,,17457.0,256540.0,,-103465.0,,12175229.0,,2394117.0,5005.0,,,,22600.0,,,,,,,,,42695.0,,,,1097857.0,42695.0,,,9701.0,68795125.0,,-580.0,5517949.0,,22.07,36S155,47.0,,7045844.0,10012658.0,,,,233540.0,3126102.0,567635.0,,,,,1816505.0,,2721524.0,,18697 BAGLEY ROAD,,2722781.0,762629.0,,,377238.0,,154965.0,,,1914762.0,,396830.0,,,92183.0,,,1121.0,320.0,,1395.0,,391873.0,2207.0,349180.0,,,204.0,2007594.0,,,,,106.0,-1214038.0,,4361950.0,,,27088377.0,3787168.0,,,,1442047.0,,,12.0,44195.0,,3896426.0,,74187.97,,,,,36568.0,16277.0,,,34635.0,,1177.0,73441.0,4881452.0,2220491.0,46.0,,7212.0,5314.0,630612.0,221662.0,105510.0,7180871.0,11376920.0,16620.0,202477083.0,,,,5008.0,,73860.0,,1453149.0,53.01,,1481661.0,,,,28237.66,,229.0,,SWGHC MENTAL HEALTH SERVICES,,33307.0,303943908.0,,,,,17739.0,,22761183.0,3.0,,,2898381.0,,,,,60630.0,2898381.0,,,,,,,,5150739.0,,203921.0,87088.0,,2015-12-31,,2582774.0,,-523.0,,,,7441.0,20.0,1857729.0,,,,,394.0,,4618274.0,-11944.0,,28905598.0,,1595377.0,,1563736.0,,72317.0,,,,,204.0,,8127502.0,1763677.0,,,25915331.0,,,,6308.0,,,,,,,46.23,,,-43546.0,,,,,414046.0,203794.0,12289488.0,2078129.0,,41752.0,41953.0,980272.0,,,13060984.0,,,,5194417.0,,,799044.0,,296.0,7383.0,,,17460,,,18387289.0,,,,5.0,,,,106.0,,2.86,,,,,,,-1786.0,,,,935361.0,560890.0,,,,5282515.0,6987895.0,,,,-8489758.0,,743800.0,15900332.0,17757602.0,,80609.0,,18.41,,,208398.0,21622665.0,815169.0,2078129.0,4217011.0,,,,,1453149.0,,2377150.0,,,,,,,326533.0,,44062689.0,284659.0,,1620100.0,18366463.0,5.0,3049703.0,,127610351.0,806880.0,,,,,,1488993.0,,1818.45,,,,,,989523.0,1459643.0,136537.0,,2084.0,23050.0,1520444.0,,,,6565107.0,,,,29430.0,33364662.0,,105736528.0,,1102180.0,,,,,,2721524.0,1008.0,1148371.0,,,,,,4037146.0,,,,1102043.0,17739.0,,606.0,25928985.0,6284506.0,999204.0,377238.0,24038248.0,14926005.0,,,,2495007.0,29.68,,,Y,,,,,19174777.0,,25166777.0,3190.0,664.0,,,,,723871.0,5963284.0,,,,,553.0,8520143.0,36T155,2.0,2947.0,,,,,,6911177.0,,79597.0,1173.0,,,1190903295.0,,,,,,,,795968.0,30584.0,28274244.0,349.0,,General Short Term,,10208.0,1102043.0,2280.0,13442166.0,,,99.0,6106171.0,2145.0,,,,1146797.0,2.08,125675226.0,96612948.0,,,,,3617.0,2764757.0,,,,,-157103.0,-228319.0,,,3228.0,1392333.0,,1057499.0,414046.0,947.0,,-27305400.0,-41820.0,25.96,,394.0,68985.0,202736.0,1712497.0,282749.0,5968715.0,2.0,,,,,138090.0,,281824775.0,367253,,484556004.0,2978975.0,,-29960.0,9602130.0,4488916.0,3.0,517379.0,,,Y,3394.0,,831251.0,3578267.0,980272.0,234882029.0,,,7254839.0,,8253885.0,,2764757.0,,,543395.0,,,,,36170,1366717.0,,1146797.0,,11930.0,39506056.0,,5133698.0,547948.0,,,96941139.0,923140.0,,,41678.0,,F,,,,,,,,13072551.0,864781.0,870245.0,1261335.0,1000.0,,,,,,,10726690.0,,,,,1709131.0,137350.0,,,,,,,,,4039298.0,,135.92,,,,,-253918.0,5949924.0,,13049234.0,121194.0,16177151.0,,,2198.0,,,10438.0,,813.0,,135342.0,1682816.0,11.2,,1470865.0,2570.0,8194.0,1469.0,55.0,,,,11886.0,,37056.0,36151.42,212246.0,,,4529936.0,,1580657.0,,349.0,,480614.0,168993.0,,,,-3288342.0,,15628563.0,215216.0,,805577.0,,,61682.0,,-96807.0,,,,4183.0,13962909.0,,43833.61,,,1637609.0,9522431.0,10977947.0,,,,572.0,5483718.0,739298.0,12271.0,,,,867756.0,,,,283177.0,,5483718.0,,,78969.0,,,,,25879433.0,551.0,,35.0,,2198.0,,,,13400027.0,35550806.0,-873798.0,,,351.0,,,,,,,4055810.0,245072.0,,603811.0,47259.0,,,342377.0,,,,46.0,,,6.0,1447975.0,3015.0,22137891.0,4891.0,,,,1920.0,180.0,3681734.0,1.0,,,1437.0,,15.0,,,30068.0,,247589.0,3015343.0,3031704.0,,256100360.0,277067996.0,,,,161443.0,255783527.0,1.0,3757095.0,24681.0,1576.0,,,1595377.0,OH,-51540.0,17075.0,724399.0,,,,,,,4270.0,2927952.0,,2988089.0,3737592.0,,7899.0,,,Y,1612253.0,,N,425003.5,,,161135.0,,1328025.0,,,,,3996065.0,1884374.0,7147095.0,,41953.0,1272943.57,,,11619.0,,,,,47.0,5311.0,,,,13880563.0,58455.0,0.215744,,,,-7727.0,,,5678956.0,1317307.0,1008213.0,96073.0,,,,,,,,,,3577806.0,,140450.0,13001318.0,82604015.0,12958.0,,,3285.0,,,,,,,,5836.0,180854418.0,,,6308.0,,281547.0,1867923.0,,,36,,9678008.0,7586929.0,N,,,,,261830.0,1443810.0,,22600.0,,,40590.0,83260.0,,219.0,31.0,5409.0,24.62,7581817.0,199852.0,1215910.0,42864.0,,,,,,,,,779862.0,,5475.0,,145.0,-454729.0,1367555.0,N,,106453078.0,520767.0,,369528.0,1217756.0,8520143.0,,1756091.0,16538105.0,,1671650.0,3785577.35,,,1945645.0,,,965.0,,44004.0,20791133.0,7887534.0,,23222533.0,1190988.0,372.0,,,,,,,2453.0,,1864.0,,,,,,26473.0,,158809.0,27.77,,,,-117991.0,1218458.0,,,73860.0,,,,,,-15.0,1206082.0,,,,,309.0,,-5013372.0,1622406.0,88.0,3975242.57,,6335.0,79674.0,N,7142920.0,,10208.0,,,,29433378.0,,,20582115.0,,,507345.0,,7846136.0,,,4282113.0,541696.0,,851.0,1491797.0,11994.0,,1185.0,,,-3388.0,,,,,,,3131.25,14833738.0,189976.0,14.98,,,16620.0,2461606.0,15201,2445907.0,,,,13.89,39.65,,,2495007.0,,2176615.0,,3.0,,,,,P,,,,,10382.0,248.0,250.0,,,,,,,,2228.0,,,,392.0,,2015,0.005447207259942079,185483153.0,25141560.91712,10568488.917119998,19174777.0,12211319.917119998,0.04300974836449099,6525447.0,0.021469247542872286,1.5645540758421825,1.5284172281835906,1.3333825026428503,0.3631781761299973,185483153.0,1.5509720766931323,0.6079925730522631,0.392007426947737,1.4782711640342137,185483153.0,0.6423670688384281,4.94046507295886,Acute Care Hospitals,non-profit,1,SOUTHWEST GENERAL HEALTH CENTER (360155)
39408,SOUTHWEST GENERAL HEALTH CENTER (360155),General Short Term (Acute Care Hospitals),Voluntary Nonprofit-Other,-81.83291,41.37208,,,,18181.0,,,,,,1279564.0,,,,1781753.0,,-39492.0,12.0,,,,64238.0,23942392.0,CUYAHOGA,,,112560.0,118487.0,14168.0,,,94576.0,,1.0,,,3758046.0,,356.0,1363.0,,,82969.0,896651.0,17835965.0,43.0,15.64,2472602.0,,,,,1160407.0,928939.0,,,9789555.0,,,,12840902.0,,,43076.0,,,,142372.0,,,,,,,,,13.0,8917800.0,,,10128705.0,102053482.0,,1035.0,13323092.0,,,,30102778.0,,14168.0,,,,,,,,181262.0,65434.86,10199420.0,N,1246046101.0,198635290.0,29.03,,,2024-02-14 00:00:00,2349646.0,,,9485.0,,,,9718498.0,,,,,,597486.0,72149.0,368708.0,,8399060.0,,,,2526397.0,634674.0,,44109688.0,,,,,154.0,2838807.0,131577.0,,,258.0,26.45,71.0,1015776.0,,,18905211.0,2683893.0,,,,366.0,83831.0,,,,,,,247598.0,1185017.0,,,27547.0,,,,,,,55391609.0,,,,,,,118815.0,,,3991.0,,,,,6477354.0,,-26412.0,37396389.0,566693.0,23393.0,,6210.0,3839.0,,,3314016.0,,879946.0,,6815979.0,3086936.0,3779923.0,,,,,,,,,1924758.0,,,-186164.0,,6656606.0,,,,,,,,,68506.0,,1852129.0,,,,,,,,338805.0,,,816827.0,,2760747.0,,,256.0,,,N,,,,199645.0,,765.0,,249985.0,,82405.0,1070.0,4251168.0,,,27817381.0,,,,36.0,,,,,1.0,9718069.0,,709332.0,,,,,1964114.0,,,1745.0,310815.0,,246454.0,,210025.0,,,1488550.0,,4876502.0,,,,1302273.0,307146.0,,6477354.0,,,-188294.0,3660.0,,,,9654.0,,,,9187.0,6220585.0,,,643159.0,,,,,,8580365.0,,3987.0,,,3210555.0,,,554202.0,64238.0,,,,3626465.0,9027.0,20788.0,,,,,57275.0,,,,,117394.0,,1155245.0,98187.0,,,1435986.0,,13388.0,,80.9,2269921.0,,54.0,4941710.0,32.11,1009.0,30.24,,,487.0,2471425.0,,,,6649949.0,,,,,,20882.0,,,,117372294.0,,,142.0,2132.0,9759.0,7648.0,3503.0,,,,105563447.0,,,,1862073.0,24976.0,,83347.0,43664.0,1200185.0,,,602902.0,,-1927.0,,,-41140.0,,,7675645.0,,13362355.0,,,,,638410.0,368708.0,1558.0,,,3431532.5,,853831.0,,,,1203189.0,39473070.0,116180.0,,185.0,,,,,,,2498857.0,112297.0,,9603700.0,,,826472.0,,,,2.0,1718471.0,10949193.0,,,347090.0,,2056118.0,2307718.0,,,77606.0,,,,,19355.0,19816.0,,,,-36074.0,,,23046598.0,,9987534.0,-1415352.0,45874.24,2837730.0,,11275.0,,,,3809726.0,,6425534.0,6318.0,-200.0,,,,,,,2056118.0,,,,,,15166376.0,351281.0,,9415694.0,,,,,ACUTE REHAB,487.0,,11722110.0,,24810.0,,43664.0,,16087.83,,,,,,,119838.0,-5373917.0,,37.48,,118815.0,,,1612879.0,,4396267.0,,884798.0,-49769.0,840.0,,81501.0,,,,,,,,,1334384.0,,2.0,,,,,,,5213637.0,,447064842.0,,802857.0,8844013.0,10589.0,106278.0,21684.0,17784180.0,23793.0,,,,,40910724.0,,,4735812.0,,,6663325.0,,4583.0,,,-937287.0,5886644.0,,,,,,183663689.0,4246.0,,,,110506.01,17955607.0,,,,361530,,,I,,480609.0,36911663.0,,,,,,,,,3165849.0,,,,420700.0,,13.0,,118487.0,17595948.0,534.0,,2239867.0,,5109578.0,340113.0,5658752.0,-157046.0,,,,,,,,13884520.0,,3809726.0,,,,,,,,,5658752.0,,,,,,,272950.0,42525208.0,1488550.0,13388.0,,,,,,2727.0,,8894425.0,,,3803978.0,,,27547.0,,,3385885.0,,,,194.0,,7025431.0,,,,1200874.0,-5216.0,92438.0,,,,20457039.0,,,160.0,,,968.0,118.0,,49577098.0,,31350604.0,,,,11437393.0,14640.0,360155,30.0,,,,,220282.0,,109.0,24238963.0,,,,,,479220.0,,29685760.0,26782660.0,,,N,4177717.0,,,,,9511909.0,2212157.0,1630771.0,,,,,,,,,5482243.0,,148.0,3454842.33,133796433.0,,SOUTHWEST GENERAL HEALTH CENTER,,197559.0,,,2913591.0,,172457.0,,2758478.0,,221806.0,,,,4.0,,9.0,523685.0,,6255347.0,133471441.0,,,39473070.0,-13403.0,12339355.0,,,,1974971.0,,,763768,1574008.0,,3.0,,,,,,,,13538.0,,,,,,8966.0,323.0,,,,,6797.0,2626239.0,,,466075.0,,,,,,,,,1408848.0,1810221.0,292472520.0,,161584597.0,,,762331102.0,,3628801.0,,,423250.0,,,64.49,,,15543109.0,,12866186.0,,3272695.0,718025.0,,2016-01-01 00:00:00,,,90182468.0,909.0,29875657.0,,-11726217.0,29685760.0,7182345.0,,,,,504544.0,,1229839.0,,,N,579400.0,,,541064.16,,1036815.0,,-30579.0,18117139.0,,,,7036.86,6.0,13932578.0,,2836956.0,9978495.0,,,,9208.0,,,,,,281824776.0,,4,,,,,,,,36.0,43664.0,13388.0,,30048672.0,,6093421.0,,,,,,4381473.0,23903.0,33145.0,,,,-186034.0,,,,,26130068.0,29178125.0,,478507452.0,3201399.0,83347.0,,-9560.0,849081.0,,183663689.0,,,,4792241.0,,,,1155245.0,4792241.0,,13295421.0,,3655254.0,,,,,,,,443102405.0,,,18905211.0,2004423.0,,,629041.0,646.0,MIDDLEBURG HEIGHTS,,5168.0,,,34836.0,197425876.0,,,,,,891748.0,2170543.0,,,4735812.0,,9.0,,178.0,,56456.0,,82709391.0,,43790.28,25.47,,,,,1576502.0,,,3860921.0,,106278.0,5885161.0,,,13884520.0,-733657.0,166363.0,,2782213.0,,,,-31964.0,,,431234.0,24423483.0,,4551732.0,,,187896.0,,,31049929.0,,,17860519.0,87888.96,225689967.0,,,,4341190.0,,,,,9089528.0,570861.0,3475475.0,3812.0,,,359503.0,818044.0,,,,,,,,-180.0,,5885161.0,,191086.0,,,,,911794.0,1646537.0,,,,1002123.0,12951.0,,,,,,2211241.0,1893300.0,,,,,-581202.0,,,1433040.0,,,,,,,-847542.0,,,N,2830.0,12.0,573.0,,,,,,,,,1616238.0,60750.0,,1009548.0,,,,,,124500.0,,1664.0,,,39308010.0,,,,,,,370.0,,-270145.0,1210209.0,,,,39160.0,,1690.0,,,,,,825966.0,,3692659.0,8072614.0,,191307601.0,65923681.0,5917.0,27169.0,,853831.0,,629.0,,,,723550.0,,,,,,,,,,12339355.0,,32702.0,,25.66,,,1989710.0,,,109.0,,2170543.0,,,,,394852.0,,9769249.0,96311.0,71338085.0,-172442.0,11998.0,,5190341.0,1616238.0,,4200759.0,,,,1952206.0,4557568.0,,377127.0,4621173.0,16170007.0,,,,,,760785430.0,,1952206.0,,34.31,,1273943.0,,2614.0,,16.0,5139520.0,2292635.0,,9769249.0,6649949.0,478935.0,,137.0,,,,18432303.0,,,,188075.0,1744150.0,368707.0,,,,,,3163638.0,448042.0,,,34613.0,,,1499431.0,Y,,5939.0,,10589.0,,,-112617.0,44130-3497,24783.0,1055707.0,541064.16,1619457.0,,32.84,568.0,18181.0,2132101.0,,20457039.0,,,,,15890.0,,,-1702284.0,,281.0,,4251168.0,,,6105130.0,,486422846.0,,,,,,16044900.0,53531752.0,,,,,,,,,,,265738.0,,304198737.0,909.0,55.29,,132.0,537247.0,,Y,,24.0,189293.0,,6600669.0,,7182345.0,,716121.0,4396267.0,,,,,11376961.0,277512.0,,,N,61582.41,,,,1183184.0,,,,2324.0,13295421.0,3222768.0,1344139.0,,1653647.0,,,,,,,,,10345437.0,,-19617.0,,,,,,,,,,91733.0,338805.0,29178125.0,,103637.0,,,1175382.0,,,,,6105130.0,531442.0,,,1710202.0,,643159.0,,,,24232529.0,,,,,,2056118.0,,,,,,49719.0,,9415694.0,64238.0,4114147.0,26130068.0,2469486.0,,,,,224.0,,,,,,4856939.0,,,42066.0,25384160.0,,,24462196.0,643907.0,51910.0,,8966.0,,9763564.0,,,25187.0,,,,38.63,,,6252362.0,50850.0,,,281081576.0,,,11719081.0,,,,,22.0,,,,,,100125.0,,,,928115.0,3617.0,,10128705.0,,118487.0,56364.0,,,104681.0,-11726217.0,,,5877203.0,10.0,,154877.45,13176.0,59342.0,,10.0,,,,586643.0,,,,,144639.0,,123053486.0,,,255548.0,,,,,,,,276052233.0,40384674.0,400.0,,13784774.0,,1087.0,,3599479.0,,,,,,,,,,25347.0,,,6159166.0,5107636.0,,5129018.0,,,,,7439217.0,7439217.0,,4991.0,4191.0,,,,31855614.0,,,,16967600.0,,352009.0,,,117.0,,2838807.0,9485.0,39473070.0,1389928.0,438268.0,5703012.0,4621173.0,,22056.0,,64238.0,2261.0,,,,,-2449.0,,,,31049929.0,,,889561.0,,,,,,,,60348604.0,,,,52.56,,,11722110.0,,,,3239589.0,8.0,7392476.0,,,2488179.0,637647.0,4799559.0,-946.0,568486.0,2523097.0,,933117818.0,,7614389.0,N,2509087.0,,,17995208.0,1546279.0,,,,2683893.0,25187.0,,528772.0,,1934379.0,,,,,,,,71669497.0,17315519.0,2066.0,,9987534.0,,4842.0,14.4,,,,,259325.0,3987.0,531796.0,17441.0,,,,1300724.0,,117652833.0,,,,,,2076299.0,,1020342.0,,1876.0,,3.0,,27817381.0,,488470.0,,15307525.0,62049221.0,,,122035374.0,,4551732.0,4206869.0,,,,,24018100.0,1895.0,1588.19,10063.0,,325181.0,,351281.0,16503.0,,223.0,142999.0,,,118487.0,37777.0,,,,,,31927076.0,160529868.0,27817381.0,,,,,,,610043.0,,14.0,5.0,,,6276174.0,,,,N,,,849081.0,,12663141.0,,5702578.0,154.0,,90576.0,230.0,,,,23424373.0,,9763564.0,,,,439219.0,118120.0,,1055732.0,182760.0,,1680,13967512.0,,13463231.0,,58949.0,274106.0,,-323927.0,,12925998.0,,2800203.0,1070.0,,,,17109.0,,,,,,,,,13388.0,,,,889561.0,13388.0,,,12068.0,67631723.0,,-2239.0,6093733.0,,21.9,36S155,40.0,23393.0,7205106.0,3667960.0,,,,258485.0,3343950.0,587838.0,,,,,1924758.0,,3314016.0,,18697 BAGLEY ROAD,,3180551.0,879946.0,,,373950.0,,229791.0,,,1982645.0,,420700.0,,,98042.0,,,1007.0,376.0,,1346.0,,457051.0,2872.0,530042.0,,,142.0,1641425.0,,,,,,-559867.0,,4269388.0,,,31369874.0,3172905.0,,,,1262427.0,,,,38716.0,,3939375.0,,77730.21,,,,,38206.0,19452.0,,,74127.0,,1216.0,73133.0,5026584.0,2159438.0,48.0,,7222.0,6643.0,452550.0,220282.0,123322.0,8674248.0,10949193.0,19270.0,201216346.0,,,,5590.0,,69423.0,,1433040.0,52.99,,1485498.0,,,,23309.83,,,,SWGHC MENTAL HEALTH SERVICES,,36709.0,315636130.0,,,,,19570.0,,3166927.0,1.0,,,3163638.0,,,,1.0,52871.0,3163638.0,,,,,,,,5473994.0,,64238.0,80103.0,,2016-12-31,,3445582.0,,-2449.0,,,,11821.0,12.0,1893300.0,,,,,55870.0,,7224433.0,-11338.0,,30913446.0,,1574008.0,,2053081.0,,152611.0,,,,,127.0,,7076084.0,2160630.0,,,26533251.0,,,,3021106.0,,,,,,,48.9,,,-44354.0,,,,,434811.0,394807.0,13110076.0,1885747.0,,1036815.0,40164.0,996186.0,,,13278989.0,,,,5361176.0,,,856918.0,,,,,,17460,,,18631175.0,,,,,,,,,,,,,,,,,-2660.0,,,,1089456.0,485863.0,,,,4874658.0,6226445.0,,,,-8302026.0,,790126.0,17955607.0,18432303.0,,103637.0,,19.05,,,176875.0,10010702.0,895716.0,1885747.0,4184833.0,,,,,1433040.0,,2526397.0,,,,,,,293090.0,,47401710.0,638410.0,,959829.0,20597224.0,5.0,3367213.0,,133460613.0,853831.0,,,,,,1285557.0,,1754.41,,,,,,1083626.0,1568349.0,136834.0,,3919.0,27042.0,1630771.0,,,,6663325.0,,,,78035.0,29875657.0,,105563447.0,,1091500.0,1.0,,,,,3314016.0,831.0,1288831.0,,,,,,5129018.0,,,,1484400.0,19570.0,,,27127733.0,6402081.0,394852.0,373950.0,26739033.0,16044900.0,,,,2707586.0,33.86,,,Y,,,,,27454120.0,,27817381.0,2172.0,463.0,,,,,800230.0,6093421.0,,,,,937.0,9415694.0,36T155,1.0,2715.0,,,,,,6530249.0,,83347.0,,,,1248753948.0,,,,,,,,680851.0,31492.0,30521946.0,229.0,,General Short Term,,11542.0,1484400.0,,12937644.0,,,141.0,6565580.0,2291.0,,,,1106555.0,,127603465.0,104093305.0,,,,,3839.0,2942912.0,,,,,-376869.0,-175064.0,,,6434.0,1339736.0,,1078914.0,434811.0,1156.0,,-39599553.0,-41820.0,26.81,,55870.0,56364.0,276979.0,1653647.0,341374.0,6656606.0,5.0,,,,,188850.0,,294791506.0,367253,,485260671.0,4114147.0,,-31996.0,9505089.0,4633646.0,,442554.0,,,Y,3454.0,,761533.0,3635328.0,996186.0,225689967.0,,,7719939.0,,8844348.0,,2942912.0,,,586643.0,,,,,36170,1168883.0,,1106555.0,,13600.0,39473070.0,,5042385.0,629041.0,,,103768313.0,896651.0,,,55085.0,,F,,,,,,,,12894112.0,1143090.0,943074.0,1323433.0,1201.0,,,,,,,12663141.0,,,,,2436284.0,176933.0,,,,,,,,,6545160.0,,137.94,,,,,,5052639.0,529055.0,13278989.0,173626.0,16170007.0,,,3435.0,,,11999.0,,984.0,,129796.0,1631625.0,11.84,,1576502.0,,12551.0,1876.0,66.0,,,,12812.0,,53803.0,30611.36,190509.0,,,3522294.0,,1353144.0,,229.0,,504544.0,271392.0,,,,-3024213.0,,15221574.0,200510.0,,460596.0,,,59380.0,,-180643.0,,,,3503.0,13559169.0,,44831.9,,,2004423.0,9275198.0,11695140.0,,,,,6237204.0,755194.0,,,,,1183184.0,,,,269711.0,,6237204.0,,,,,,,,27754865.0,42066.0,,,,3435.0,,,,12614447.0,38923056.0,-698730.0,,,320.0,,,,,,,4050509.0,244307.0,,816827.0,42296.0,,,499539.0,,,,63.0,,,14.0,1002123.0,,24859147.0,4991.0,,,,1198.0,,3123951.0,,,,1706.0,,15.0,,,55917.0,,341299.0,3315650.0,3804235.0,,274062523.0,292472520.0,,,,217169.0,273672429.0,,4091587.0,17536.0,1875.0,,,1574008.0,OH,-1927.0,18181.0,818330.0,,,,,,,9560.0,3252515.0,,3036248.0,3788434.0,,9807.0,,,Y,1496050.0,,N,289095.73,,,151826.0,,1300724.0,,,,,3803978.0,1964114.0,7147095.0,,40164.0,1274010.02,,,294661.0,,,,,-445.0,,,,,13660393.0,-7379.0,0.219633,,,,-2877.0,,,5630487.0,1389928.0,1473384.0,106067.0,,,,,,,,,,4425200.0,,146744.0,10512714.0,85983505.0,12431.0,,,3294.0,,,,,,,,20530.0,191205644.0,,,3021106.0,,,1934379.0,,,36,,9511909.0,8868378.0,N,,,,,5971914.0,1502340.0,,17109.0,,,79754.0,71004.0,,,,,25.66,6159166.0,,1167055.0,,,,,,,,,,789016.0,,5490.0,,97.0,-737757.0,1351517.0,N,,105843986.0,563058.0,,404436.0,1141691.0,9415694.0,,1720335.0,15105353.0,,2243313.0,3646335.21,,,1754011.0,,,2804.0,,37253.0,24423038.0,7564042.0,5539676.0,24462196.0,1591131.0,,,,,,,,,,2326.0,,,,,,525053.0,,136225.0,29.62,,,,-157254.0,1358988.0,,,69423.0,,,,,,-306.0,1408848.0,,,,,255.0,,-4545401.0,1753379.0,,3972596.66,,,,N,6594354.0,,11542.0,,,,32311923.0,,,24238963.0,,,347130.0,,8399060.0,,,4856939.0,478759.0,1.0,195.0,1783417.0,,,2633.0,,,,,,,,,,3141.75,16165094.0,255093.0,15.64,,,19270.0,2557335.0,15201,2533209.0,,,,13.9,39.65,,,2707586.0,,1895408.0,,48.0,,,,,P,,,,,10372.0,326.0,263.0,,,,,,,,2261.0,,,,841.0,,2016,0.0031552695105371196,197425876.0,27026606.290638,11719081.290638,27454120.0,12728629.290638,0.04085119152867576,11437393.0,0.03623600694888763,1.5522839388904555,1.7895060062256,1.2617559818491642,0.4956368030399695,197425876.0,1.4237321960774787,0.5874131632123464,0.4125868367876536,2.2461922927872986,197425876.0,0.6596263625169206,4.404051140473332,Acute Care Hospitals,non-profit,1,SOUTHWEST GENERAL HEALTH CENTER (360155)
45530,SOUTHWEST GENERAL HEALTH CENTER (360155),General Short Term (Acute Care Hospitals),Voluntary Nonprofit-Other,-81.83291,41.37208,,,,17472.0,,,,,,2445137.0,,,,1888209.0,,-210617.0,4.0,,,,41355.0,23634009.0,CUYAHOGA,,,135146.0,126372.0,14358.0,,,96689.0,,1.0,,,3943768.0,,303.0,1113.0,,,82103.0,1043586.0,18086580.0,64.0,15.86,2431854.0,,,,,1196782.0,905299.0,,,10525624.0,,,,12701125.0,,,-8098.0,,,,113869.0,,,,,,,,,2.0,8798348.0,,,7821276.0,108615977.0,,1031.0,15623955.0,,,,29508647.0,,14358.0,,,,,,,,147197.0,65212.0,10843942.0,N,1314585310.0,213708728.0,29.79,,,2024-02-14 00:00:00,2201560.0,,,9523.0,,,,12091987.0,,,,,,553543.0,1127046.0,368708.0,,6145127.0,,,,2143955.0,547122.0,,42080492.0,,,,,154.0,2269127.0,120488.0,,,100.0,28.13,,1143004.0,,,19626834.0,2621835.0,,,,102.0,83441.0,,,,,,,275245.0,1191942.0,,,25397.0,,,,,,,54620264.0,,,,,,,126759.0,,,3954.0,,,,,5985541.0,,-29546.0,39305145.0,571605.0,41334.0,,4507.0,3614.0,,,3455453.0,,1767616.0,,7161439.0,4170095.0,4348663.0,,,,,,,,,2170702.0,,,-216697.0,,5442171.0,,,,,,,23688.0,,66378.0,,2075228.0,,,,,,,,337084.0,,,798984.0,,2533652.0,,,245.0,,,N,,,,225975.0,,487.0,,202510.0,,93785.0,8288.0,4657915.0,,,30825713.0,,,,36.0,,,,,1.0,5369518.0,,754928.0,,,,,1964588.0,,,2080.0,250555.0,,244523.0,,161614.0,,,1334927.0,,4439799.0,,,,1249969.0,336642.0,,5985541.0,,,-188294.0,3650.0,,,,5900.0,,,,44447.0,5279486.0,,,568504.0,,,,,,9089528.0,,3381.0,,,3096447.0,,,584455.0,41355.0,,,,3100804.0,7161.0,18487.0,,,,,92364.0,,,,,101611.0,,617248.0,80456.0,,,1303089.0,,8480.0,,79.13,2025039.0,,63.0,5079533.0,33.52,1210.0,31.2,,,4698.0,2397040.0,,,,6803138.0,,,,,,18706.43,,,,123538555.0,,,64.0,2706.0,24687.0,9644.0,3067.0,,,,110878111.0,,,,1911244.0,62440.0,,77632.0,47259.0,1096930.0,,,634670.0,,2738.0,,,-67568.0,,,7305305.0,,14035879.0,,,,,657727.0,368708.0,1554.0,,,3500991.72,,961132.0,,,,1239564.0,41197176.0,85574.0,,178.0,,,,,,,2570040.0,135013.0,,8417280.0,,,955680.0,,,,9.0,1698854.0,12381909.0,,,331483.0,,2215205.0,2117311.0,,,84389.0,,,,,18970.0,20521.0,,,,-19100.0,,,23720702.0,,10361080.0,-1396732.0,45742.48,4240575.0,10502.0,9399.0,,,,5471572.0,,6335460.0,5182.0,-200.0,,,,,,,2215205.0,,,,,,16473772.0,415933.0,,9483257.0,,,,,ACUTE REHAB,4698.0,,11756313.0,,44261.0,,47259.0,,17605.26,,,,,,,126491.0,-5036504.0,,35.59,,126759.0,,,1697341.0,,4496893.0,,978417.0,-20168.0,462.0,,82901.0,,,,,,,,,1279762.0,,2.0,,,,,,,9744492.0,,470584215.0,,816812.0,9417468.0,7241.0,98165.0,20539.0,19465984.0,22110.0,,,,,42593446.0,,,4688825.0,,,7337422.0,,5089.0,,,-942194.0,6642028.0,,,,,,179625346.0,33188.0,,,,109693.09,15633958.0,,,,361530,,,L,,3180737.0,56810443.0,,,,,,,,,3504675.0,,,,752999.0,,4.0,,126372.0,17677886.0,893.0,,1948247.0,,5438412.0,366249.0,15491159.0,-154550.0,4039.0,,,,,,,14435889.0,,5471572.0,,,,,,,,,15491159.0,,,,,,,217872.0,41377314.0,1334927.0,8480.0,,,,,,2446.0,,8910335.0,,,4000264.0,,,25397.0,,,3598767.0,,,,194.0,,7431543.0,,,,1025261.0,-2956.0,122002.0,,,,19249367.0,,,213.0,,,609.0,143.0,,53768467.0,,32178976.0,,,,10432237.0,14600.0,360155,55.0,,,,,212319.0,,42.0,23953713.0,,,,,,1000854.0,,30694662.0,28356281.0,,,N,4787419.0,,,,,10363319.0,4508783.0,1397301.0,,,,,,,,327.0,5119611.0,,487.0,3526463.73,142673285.0,,SOUTHWEST GENERAL HEALTH CENTER,,193677.0,,,2572464.0,,367286.0,,2490321.0,,221404.0,,,,,,9.0,3172639.0,,6255346.0,142081935.0,,,41197176.0,-11127.0,12250398.0,,,,1858343.0,,,763769,1573063.0,,3.0,,,,,,,,16974.0,,,,,,10814.0,3310.0,,,,,22501.0,2675284.0,,,450469.0,,,,,,,,,1259690.0,1674843.0,313002794.0,,179341766.0,,,814764346.0,,3847421.0,,,1234823.0,,,66.6,,,15176187.0,,13316208.0,,3169635.0,647410.0,,2017-01-01 00:00:00,,,99026930.0,928.0,36820739.0,,-11584045.0,30694662.0,12732715.0,,,,,935651.0,,1962505.0,,,N,360876.0,,,547588.67,,863318.0,,-18722.0,20424771.0,,,,6397.11,2.0,14962865.0,,2619080.0,9969121.0,,,,9845.0,,,,,,294791505.0,,4,,,,,,,,36.55,47259.0,8480.0,,29433061.0,,6040223.0,,,,,,4482357.0,21460.0,29248.0,,,,-205194.0,,,,,24862748.0,11355542.0,,498170646.0,3341287.0,77632.0,,-7876.0,867802.0,,179625346.0,,,,4351496.0,,,,617248.0,4351496.0,,14503895.0,,3753048.0,,,,,,,,466621778.0,,,19626834.0,3049723.0,,,564827.0,648.0,MIDDLEBURG HEIGHTS,,8386.0,,,46586.0,231728513.0,,,,,,,2219108.0,,,4688825.0,,38.0,,90.0,,45486.0,,94654316.0,,38529.29,25.13,,,,,1556923.0,,,14364113.0,,98165.0,5457252.0,,,14435889.0,-652016.0,186149.0,,2593994.0,,,,-32448.0,,,426106.0,24218610.0,,4959122.0,,,162091.0,,,33087375.0,,,18111134.0,86706.11,211821869.0,,,,4564811.0,13338.0,,,,9123805.0,512861.0,3531856.0,6579.0,,,262479.0,,,,,,,,,-45.0,,5457252.0,,156874.0,,,,,3172639.0,1721229.0,,,,1557317.0,14031.0,,,,,,2605407.0,2396565.0,,,,,-591816.0,,,1431356.0,,,,,,,-833928.0,,,N,3059.0,41.0,87.0,,,,,,,,,1358970.0,58595.0,,4180406.0,,,,,,725000.0,,1756.0,,,46391700.0,,,,,,,202.0,,-235294.0,1001594.0,,,,33237.0,,1132.0,,,,,,777322.0,,3897758.0,7468727.0,,177580757.0,69385769.0,1402.0,24076.0,,961132.0,,402.0,,,,983446.0,,,,,,,,,,12250398.0,,26061.0,,26.36,,,2577681.0,,,180.0,,2219108.0,,,,5.0,759523.0,,10508211.0,91555.0,76123761.0,-131672.0,16951.0,,5403234.0,1358970.0,,3641265.0,,,,1901234.0,4628505.0,,390265.0,1208474.0,16493804.0,,,,,,813214689.0,,1901234.0,,34.39,,1146953.0,,986.0,,9.0,5134186.0,2482583.0,,10508211.0,6803138.0,454719.0,,171.0,,,,18267123.0,,,,181174.15,7853485.0,368708.0,,,,,,3168936.0,454322.0,,,34672.0,,,1535107.0,Y,,7618.0,,7241.0,2.0,,-114612.0,44130-3497,24767.0,932731.0,547588.67,1412204.0,,32.71,989.0,17472.0,2151686.0,,19249367.0,,,,,,,,-1066989.0,,468.0,,4657915.0,,,5553815.0,,502861620.0,,,,,,14881111.0,56197930.0,,,,,,,,,,,234859.0,,324586839.0,928.0,53.16,,109.0,562064.0,,Y,,47.0,175854.0,,6216801.0,,12732715.0,,622557.0,4496893.0,,,,,11627956.0,293022.0,,,N,61613.93,,,,1284529.0,,,,3973.0,14503895.0,3550921.0,1354046.0,,1353853.0,,,,,5.0,,,,10077630.0,,-1080.0,,,,,,,,,,93168.0,337084.0,11355542.0,,61545.0,,,1194507.0,,,,,5553815.0,619857.0,,,1683815.0,,568504.0,,,,23942548.0,,,,,,2215205.0,,,,,,-1185.0,,9483257.0,41355.0,4352126.0,24862748.0,2704401.0,,,,,235.0,,,,,,5327923.0,,,36750.0,25391246.0,,,23861591.0,1107601.0,52443.0,,10814.0,,11250926.0,,,3165.0,,,,40.29,,,6309761.0,32875.0,,,266442133.0,,,14579172.0,,,,,51.0,,,,,,97460.0,,,,992305.0,6889.0,,7821276.0,,126372.0,56210.0,,,97154.0,-11584045.0,,,5563414.0,3.0,,155576.58,13140.0,62567.0,,10.0,,,,615888.0,,,,,500143.0,,132660196.0,,,224188.0,,,,,,,,296811395.0,41076551.0,408.0,,1308480.0,,1183.0,,3640510.0,,,,,,,,,,15320.0,,,7756645.0,6364543.0,,4926033.0,,,,,2321855.0,2321855.0,,4745.0,3813.48,,,,34810666.0,,,,16643478.0,,98680.0,,,30.0,,2269127.0,9523.0,41197176.0,1256411.0,361319.0,5982665.0,1208474.0,,4066.0,,41355.0,2378.0,,,,,-1649.0,,,,33087375.0,,,935858.0,,,,,,,,67012930.0,,,,55.68,,,11756313.0,,,,2535042.0,4.0,9529739.0,,,2559773.0,643727.0,1002744.0,,564985.0,2635587.0,,982606890.0,,8565463.0,N,2515881.0,,,18190065.0,1714531.0,,,,2621835.0,3165.0,,463516.0,,2080305.0,,,,,,,,76919761.0,15273898.0,1146.0,,10361080.0,,4024.0,17.29,,,,,202407.0,3381.0,596203.0,16857.0,,,,1351368.0,,123676604.0,,,,,,1870046.0,,1056181.0,,1477.0,,,,30825713.0,,484372.0,,15071974.0,62353905.0,,,119758623.0,,4959122.0,4141064.0,,,,,20066819.0,3391.0,1624.23,8188.0,,228777.0,,415933.0,9489.0,,294.0,167018.0,,,126372.0,30183.0,,,,,,34891276.0,177163692.0,30825713.0,,,,,,,377751.0,,28.0,2.0,,,6620902.0,,,,N,,,867802.0,,12633121.0,,5728702.0,154.0,,98433.0,,,,,27037528.0,,11250926.0,,,,515529.0,129293.0,,926218.0,141931.0,,1680,15003246.0,,22432657.0,,32951.0,218481.0,,-238810.0,,12866286.0,,2569753.0,543.0,,,,16160.0,,,,,,,,,8480.0,,,,935858.0,8480.0,,,13307.0,68118604.0,,-16608.0,4804791.0,,21.95,36S155,40.0,41334.0,7682596.0,12054555.0,,,,353987.0,3051387.0,588815.0,,,,,2170702.0,,3455453.0,,18697 BAGLEY ROAD,,2918198.0,1767616.0,,,342956.0,,330367.0,,,2048293.0,,752969.0,,,94330.0,,,10542.0,701.0,,1284.0,,294172.0,648.0,454189.0,,,362.0,1371096.0,,,,,,-621969.0,,5754344.0,,,32207976.0,3089830.0,,,,1076318.0,,,,27165.0,,3924095.0,,78755.82,,,,,40642.0,20889.0,,28650.0,60216.0,,1225.0,68917.0,4995582.0,2101441.0,65.0,,7866.75,6913.0,448506.0,212319.0,124914.0,13295421.0,12381909.0,29000.0,241355060.0,,,,5437.0,,70389.0,,1431356.0,55.85,,1562581.0,,,,25472.01,,,,SWGHC MENTAL HEALTH SERVICES,,32074.0,335019076.0,,,,,19817.0,,15890821.0,,,,3168936.0,,,,,37056.0,3168936.0,,,,,,,,5543066.0,,41355.0,76842.0,,2017-12-31,,3192422.0,,-1649.0,,,,14434.0,37.0,2396565.0,,,,,64490.0,,8309778.0,-16959.0,,29740191.0,,1573063.0,,2068923.0,,359310.0,,,,,183.0,,7826228.0,2018191.0,,,31791481.0,,,,3266663.0,,,,,,,52.71,,,-36718.0,,,,,487726.0,439606.0,12886080.0,2015507.0,,863318.0,40542.0,1079649.0,,,13706490.0,,,,5786791.0,,,991759.0,,,16933.0,,,17460,,,19824403.0,,,,1.0,,,,,,,,,,,,,-39.0,,,,1861743.0,1007767.0,,,2.0,8047030.0,7550129.0,,,,-8690465.0,,749158.0,15633958.0,18267123.0,,61545.0,,18.59,,,215681.0,9178796.0,882422.0,2015507.0,4032279.0,,,,,1431356.0,,2143955.0,,,,,,,424831.0,,45817113.0,657727.0,,4181591.0,19419119.0,5.0,3553567.0,,124472904.0,961132.0,,,,,,1500339.0,,1793.83,,,,,,1107532.0,1548476.0,101305.0,,2746.0,58349.0,1397301.0,,,,7337422.0,,,,71214.0,36820739.0,,110878111.0,,1117132.0,,,,,,3455453.0,967.0,1289330.0,,,,,,4926033.0,,,,310671.0,19817.0,,517.0,23963051.0,6438383.0,759523.0,342956.0,27191267.0,14881111.0,,,,3131740.0,36.45,,,Y,,,,,21391668.0,,30825713.0,1994.0,844.0,,,,,679431.0,6040223.0,,,,,339.0,9483257.0,36T155,2.0,3151.0,,,,,,6513749.0,,77632.0,,,,1317625966.0,,,,,,,,949531.0,35034.0,30544172.0,255.0,,General Short Term,,11626.0,310671.0,10475.0,16589654.0,,,142.0,6569651.0,2602.0,,,,1044695.0,,133467499.0,109832065.0,,,,,3614.0,2606663.0,,,,,-416976.0,-129893.0,,,11165.0,1295072.0,,1212054.0,487726.0,609.0,,-44402531.0,,28.22,,64490.0,56210.0,272997.0,1353853.0,331545.0,5442171.0,11.0,,,,,196196.0,,296099985.0,367253,,501370621.0,4352126.0,,-32448.0,10156703.0,4844380.0,5.0,617195.0,,,Y,3970.0,,782365.0,3816723.0,1079649.0,211821869.0,,,7342003.0,,9418283.0,,2606663.0,,,615888.0,,,,,36170,1056594.0,,1044695.0,,25838.0,41197176.0,,5252434.0,564827.0,,,109240715.0,1043586.0,,,87003.0,,F,,,,,,,,19881385.0,1037240.0,705330.0,1495486.0,1384.0,,,,,,,12633121.0,,,,,2211188.0,112202.0,,,,,,,,,7897605.0,,137.24,,,,,,5194064.0,3434793.0,13706490.0,168383.0,16493804.0,,,6043.0,,,11681.0,,1134.0,,142438.0,1575485.0,12.14,,1556923.0,,6442.0,1477.0,69.0,,,,12362.0,,51003.0,31133.05,276140.0,,,4895664.0,,2143103.0,,255.0,,935651.0,257517.0,,,,-3143636.0,,15850530.0,217432.0,,922488.0,,,72551.0,,-42477.0,,,,3067.0,13119493.0,,51691.29,,,3042790.0,13792740.0,12574771.0,,,,,5885000.0,759385.0,,,,,1284529.0,,,,263516.0,,5885000.0,,,,,,,,22111841.0,36750.0,,,,6043.0,,,,12419293.0,37356169.0,-757208.0,,,391.0,,,,,,,3871110.0,274943.0,,798984.0,43248.0,,,434871.0,,,,51.0,,,5.0,1557317.0,,25315988.0,4745.0,,,,1794.0,,7681422.0,,,,1693.0,,15.0,,,51527.0,,309598.0,2850249.0,4378209.0,,294233714.0,313002794.0,,,,187968.0,293824943.0,,4246525.0,17151.0,1748.0,,,1573063.0,OH,2738.0,17472.0,814006.0,,,,,,,12394.0,2757848.0,,4650646.0,4187593.0,,51.0,,,Y,1525740.0,,N,288771.42,,,177307.0,,1351368.0,,,,,4000264.0,1964588.0,6255346.0,1005.0,40542.0,1270508.8,,,260674.0,,,,,78.0,2648.0,,,,13057034.0,100229.0,0.223512,,,,,,,5686805.0,1256411.0,1358006.0,109133.0,,,,,,,,,,4419484.0,,143381.0,10340155.0,79234829.0,5976.0,,,3285.0,,,,,,,,22391.0,232176264.0,,,3266663.0,,,2080305.0,,,36,,10363319.0,9181297.0,N,,,,,5312044.0,1467952.0,,16160.0,,,48570.0,70810.0,,,,,26.36,7756645.0,,1291269.0,,,,,,,,,,847235.0,,5475.0,,47.0,-905404.0,1449227.0,N,,111016160.0,594516.0,,337001.0,1448203.0,9483257.0,,1702352.0,22486792.0,,1905204.0,3726722.61,,,733815.0,,,11278.0,,27207.0,24218688.0,7484587.0,9461165.0,23861591.0,1787656.0,,,,,,,,2050.0,,16.0,,,,,,34277.0,,89958.0,30.55,,,,-154772.0,1284533.0,,,70389.0,,,,,,-14.0,1259690.0,,,,,255.0,,-4708430.0,1839129.0,,4048580.39,,,,N,6979784.0,,11626.0,,,,37967544.0,,,23953713.0,,,315506.0,,6145127.0,,,5327923.0,493866.0,2.0,142.0,1936279.0,,,11113.0,,,,,,,,,1005.0,3132.0,12952677.0,230268.0,15.86,,,29000.0,2714199.0,15201,2692180.0,,,,15.09,40.86,,,3131740.0,,1980760.0,,13.0,,,,,P,,,,,12827.0,2573.0,133.0,,,,,,,,2378.0,,,,1960.0,,2017,0.012882811308316786,231728513.0,29651145.728352,14579171.728352,21391668.0,18759577.728352,0.0593440386660251,10432237.0,0.031139232799985397,1.450648956951215,1.7999076130426612,1.1304184468972907,0.39164343841325994,231728513.0,1.149802972239329,0.5348410933871042,0.46515890661289583,2.025182409931189,231728513.0,0.6724986281106575,4.355435737768348,Acute Care Hospitals,non-profit,1,SOUTHWEST GENERAL HEALTH CENTER (360155)
51593,SOUTHWEST GENERAL HEALTH CENTER (360155),General Short Term (Acute Care Hospitals),Voluntary Nonprofit-Other,-81.83291,41.37208,,,,16076.0,,,,,,2486588.0,,,,1680229.0,,-176631.0,11.0,,,,34999.0,25204088.0,CUYAHOGA,,,126048.0,139519.0,14506.0,,,90988.0,,1.0,,,4094887.0,,290.0,533.0,,,85791.0,945617.0,17181588.0,27.0,15.82,2362485.0,,,,,1147981.0,1153127.0,,,10554866.0,,,,13726781.0,,,86.0,,,,94862.0,,,,,,,,,,8610531.0,,,8050977.0,119850425.0,,993.0,15754120.0,,,,31284481.0,,14506.0,,,,,,,,138048.0,65954.14,11194755.0,N,1357504074.0,219388137.0,30.34,,,2024-02-14 00:00:00,2168952.0,,,9302.0,,,,14021217.0,,,,,,526893.0,11549.0,,,6304828.0,,,,1926248.0,448086.0,,40659777.0,,,,,157.0,2137781.0,100387.0,,,121.0,29.34,,1263265.0,,,19690412.0,2613653.0,,,,1.0,86669.0,,,,,,,314794.0,1211705.0,,,23732.0,,,,,,,69761777.0,,,,,,,140117.0,,,4716.0,,,,,5668304.0,,-35907.0,34339389.0,488954.0,45162.0,,3969.0,3540.0,,,3409341.0,,1501334.0,,7605431.0,6379299.0,4575674.0,,,,,,,,,2277846.0,,,-188574.0,,5345982.0,,,,38746.0,,316.0,28861.0,,60099.0,,2314709.0,,,,,,,,372001.0,,,763400.0,5917.0,2528361.0,,,228.0,,,N,,,2.0,96674.0,,1947.0,,157906.0,,106729.0,6291.0,4699359.0,,,31379541.0,,,,36.0,,,,,1.0,9231940.0,,818988.0,,,,,1913728.0,,,1800.0,272689.0,,245183.0,,233448.0,,,1048687.0,,3841260.0,,,,1221192.0,244736.0,,5668304.0,,,-203877.0,3650.0,,,15.0,21579.0,,,,18877.0,5644576.0,,,572990.0,,,,,,9123805.0,,3621.0,,,3111725.0,,,539551.0,35573.0,,,,3466573.0,7176.0,20321.0,,,,,95831.0,,,,,91418.0,,926718.0,73120.0,,,1312086.0,,7319.0,,77.85,1985628.0,,44.0,5425170.0,33.43,1443.0,31.44,,,5132.0,2262683.0,,,,6524393.0,,,,,,21461.97,,,,126503296.0,,,95.0,3233.0,41129.0,10908.0,2588.0,,,,115018634.0,,,,1997322.0,1561.0,,83714.0,38808.0,1119742.0,271.0,,688696.0,,-360.0,,,-63209.0,,,7097301.0,,13841150.0,,,,,478324.0,401443.0,1550.0,,,3556031.52,,985560.0,,,,1195137.0,40188962.0,95021.0,,158.0,,,,,,,2624996.0,126005.0,,7430536.0,,118.0,1135823.0,,,,3.0,1610543.0,12109176.0,,,307869.0,,2343838.0,2049039.0,,,80541.0,,,,,14535.0,19976.0,,,,-39215.0,,,28828337.0,,9515118.0,-1268050.0,50422.06,4662374.0,9.0,8561.0,,,,4977697.0,,6141975.0,5783.0,-200.0,,,,,,,2343838.0,,,,,,17585411.0,395565.0,,10166148.0,,,,,ACUTE REHAB,5132.0,,12083052.0,,61632.0,,38808.0,,14316.34,,,,,,,116739.0,-4187689.0,,36.72,,140117.0,,,1833650.0,,4813263.0,,858731.0,,586.0,,88225.0,,,,,,,,,1258826.0,,4.0,,,,,,,9562037.0,,466448598.0,,847977.0,10712546.0,726.0,109438.0,18664.0,22509460.0,10613.0,,,,,42770310.0,,,4603416.0,,,5667064.0,,3737.0,,,-992190.0,6485228.0,,,,,,182726673.0,25804.0,,,,111810.3,14808626.0,,,,361530,,,M,,907770.0,52763099.0,,,,,,,,,3300865.0,,,,1438724.0,,6.0,,139519.0,15624311.0,,,2149697.0,,5720837.0,359935.0,6842476.0,-223642.0,3851.0,,,,,,,14847187.0,,4977697.0,,,,,,,,,6842476.0,,,,,,,248147.0,38748830.0,1048687.0,7319.0,,,,,,2894.0,,4409348.0,,,3365592.0,,,23732.0,,,3342475.0,,,,197.0,,7722141.0,,,,1029191.0,-2631.0,99553.0,,,,20598363.0,,,,,,776.0,138.0,,56045895.0,,32928896.0,,,,12684477.0,14600.0,360155,48.0,,,,,107351.0,,61.0,25456125.0,,52.0,,,,1540888.0,,34221463.0,28812008.0,,,N,4937760.0,,,,,10798170.0,7047621.0,1198004.0,,,,,,,,,5703672.0,,233.0,3577751.44,145354424.0,,SOUTHWEST GENERAL HEALTH CENTER,,203559.0,,,3014777.0,,409973.0,,2543399.0,,223419.0,,,,,,,907856.0,,6255346.0,144871148.0,,,40188962.0,-10292.0,12063608.0,,,,1614038.0,,,763770,1830201.0,,3.0,,68.0,,,,,,22312.0,,,,,,5400.0,2941.0,,,,,17417.0,2520390.0,,,437898.0,,,,,,,,,1192347.0,1564746.0,318234659.0,,,,,864746798.0,,3724483.0,,,1459813.0,,,61.24,,,16090818.0,,15623955.0,,3255719.0,572319.0,,2018-01-01 00:00:00,,,105393899.0,706.0,38797694.0,,-16172112.0,34221463.0,12803791.0,,,,,1779397.0,,1859379.0,,,N,147670.0,,,548765.4,,1045224.0,,-42341.0,20659597.0,,,,6267.39,3.0,15427080.0,,2637785.0,10610929.0,,,,10544.0,,,,,,296099985.0,,4,,,,,,,5917.0,36.9,38808.0,7414.0,,31213419.0,,5849139.0,,,,,,4799469.0,18228.0,32748.0,,,,-184595.0,,,,,20993738.0,13298613.0,,494997718.0,3296810.0,83714.0,,-9514.0,870815.0,,182726673.0,,,,4333984.0,,,,926718.0,4333984.0,,14503895.0,,463089.0,,,,,,,,462486161.0,,,19690412.0,3000556.0,,,531473.0,743.0,MIDDLEBURG HEIGHTS,,9195.0,,,36126.0,226251560.0,,,,,,,2190259.0,,,4603416.0,,4.0,,119.0,,47379.0,,,,38569.96,26.02,,,,,1535753.0,,,6699312.0,,109438.0,4852166.0,,,14847187.0,-308169.0,171363.0,,2211574.0,,,,-36433.0,,,362019.0,25756134.0,,4747635.0,,,166468.0,,,32158718.0,,,17206142.0,92846.95,198984381.0,,,,5262197.0,565.0,,,,9125405.0,512892.0,3985745.0,4886.0,,,233756.0,131615.0,,,,,,,,,,4852166.0,,110134.0,,,,,907856.0,1899551.0,,1.0,,1185930.0,12357.0,,,,,,6217900.0,2123586.0,,,,,-536257.0,,,1481274.0,,,,,,,-862689.0,,,N,1958.0,9.0,47.0,,,,,,,,,1131585.0,52745.0,,2461786.0,,,,,,4150000.0,,1536.0,,,48034134.0,,,,,,,517.0,,-82051.0,843488.0,,,,34811.0,,309.0,,,,,,675933.0,,3612521.0,7229514.0,,180286793.0,,4856.0,27257.0,,985560.0,,1169.0,,,,859417.0,,,,,,,,,,12063608.0,,29647.0,,27.06,,,3051176.0,,,87.0,,2190259.0,,,,17.0,624461.0,,10530651.0,102541.0,79685652.0,-49190.0,15355.0,,,1131585.0,,3807677.0,,,,2158863.0,4305694.0,,396448.0,,15977880.0,,,,,,862395774.0,,2158863.0,,36.3,,968685.0,,,,38.0,5118686.0,2379832.0,,10530651.0,6524393.0,460525.0,,139.0,,,,19377358.0,,,,172685.0,6929971.0,368708.0,,,,,,3425730.0,446644.0,,,40117.0,,,1616651.0,Y,,3094.0,,726.0,,,-112805.0,44130-3497,22277.0,773241.0,548765.4,1393591.0,,33.75,480.0,16076.0,2173261.0,,20598363.0,,,,,,,,-5132365.0,,2796.0,,4699359.0,,,5136349.0,,497046741.0,,,,,,15736912.0,52652269.0,,,,,,,,,,,216981.0,,334406771.0,706.0,48.63,,105.0,473734.0,,Y,,219.0,177536.0,,6010986.0,,12803791.0,,493138.0,4813263.0,,,86583.0,,11575624.0,291022.0,,,N,58388.28,,,,1135868.0,,,,2163.0,12091603.0,3505311.0,1244191.0,,1465451.0,,,,,,,,,10843178.0,,-1080.0,,,,,,,,,,56415.0,372001.0,13298613.0,,60837.0,,,1285847.0,,,,,5136349.0,549912.0,,,1828622.0,,572990.0,,,,25452767.0,,,,,,2343838.0,,,,,,13128.0,,10166148.0,35573.0,4700569.0,20993738.0,3066661.0,,,,,234.0,,,,,,4920085.0,,,43152.0,25689891.0,,,22972848.0,806555.0,51367.0,,5400.0,,10758631.0,,,396.0,,,,40.49,,,5730641.0,28159.0,,,268746158.0,,,14934174.0,,,,,44.0,,,,,,82973.0,,,,1089517.0,8692.0,,8050977.0,,139519.0,57305.0,,,66477.0,-16172112.0,,,5835770.0,14.0,,155384.0,13140.0,68870.0,,10.0,,,,676039.0,,,,,644061.0,,129347735.0,,,232694.0,,,,,,,,302750686.0,43796239.0,455.0,,3890624.0,,856.0,,3641257.0,,,,,,,,,,13504.0,,,7596007.0,6226407.0,,5388439.0,,,,,2517713.0,2517713.0,,4525.0,1924.28,,,,37374262.0,,,,15171886.0,,107356.0,,,,,2137781.0,9302.0,40188962.0,1308364.0,357529.0,7238140.0,,,14888.0,,34999.0,2714.0,,,,,-1099.0,,,,32158718.0,,,696150.0,,,,,,,,68463914.0,,,,55.79,,,12083052.0,,,,2465688.0,4.0,,,,2614704.0,477584.0,972979.0,,550506.0,2448372.0,,1014702291.0,,8474107.0,N,2393100.0,,,18162235.0,1508649.0,,,,2613653.0,396.0,,399811.0,,2159170.0,,,,,,,,82006425.0,18594053.0,1070.0,,9515118.0,,1935.0,17.59,,,,,180822.0,3621.0,434154.0,16903.0,,,,1386863.0,,126647879.0,,,,,,1579789.0,,973122.0,,1447.0,,,,31379541.0,,515123.0,,13585708.0,56943025.0,,,121448496.0,,4747635.0,4543669.0,,,,,22897773.0,4005.0,1656.68,20374.0,,208943.0,,395565.0,8157.0,,568.0,146484.0,,,139519.0,28868.0,,,,,,37427156.0,,31379541.0,,,,,,,313840.0,,3.0,3.0,574.0,,6852761.0,,,,N,,,870815.0,,13138910.0,,5771491.0,157.0,,53905.0,,,,,27999030.0,,10758631.0,,,,571100.0,90738.0,,914346.0,138434.0,,1680,15451692.0,,21864145.0,,40960.0,249052.0,,-720814.0,,12739647.0,,2261471.0,119044.0,,,,18319.0,,,,,,,,,7414.0,,,,696150.0,7414.0,,,13026.0,66608267.0,,-20329.0,6123665.0,,22.46,36S155,40.0,45162.0,8671118.0,12657561.0,,,,303283.0,3290872.0,473280.0,,,,,2277846.0,,3409341.0,,18697 BAGLEY ROAD,,2630788.0,1501334.0,3.0,,303774.0,522.0,308277.0,,,1818415.0,,1438680.0,,,73985.0,,,6989.0,348.0,,1160.0,,217821.0,297.0,467706.0,,,,1416473.0,,,,,95.0,-532223.0,,5931743.0,,,32963832.0,3386958.0,,,,1019730.0,,,,15652.0,,3926642.0,,79891.06,,,,,37767.0,12280.0,,1195.0,53502.0,,1189.0,76690.0,4790808.0,2069022.0,30.0,,7403.58,13042.0,422772.0,107351.0,116621.0,14503895.0,12109176.0,34936.0,229898194.0,,,,5198.0,5.0,69779.0,,1481274.0,54.76,,1689670.0,,,,21719.92,,,,SWGHC MENTAL HEALTH SERVICES,,23637.0,347091248.0,,,,,19803.0,,19727280.0,,,,3425730.0,,,,32735.0,36229.0,3425730.0,,,,,,,,5687618.0,,35573.0,66976.0,,2018-12-31,,3078973.0,,-1099.0,,,,17660.0,,2123586.0,,,,,85750.0,,8956097.0,-20164.0,,27590031.0,,1830201.0,,2007780.0,,319139.0,,,,,266.0,,12090179.0,1808550.0,,,30486571.0,,,,3290766.0,,,,,,,51.53,,,-94516.0,,,,,531043.0,420337.0,12416054.0,1690915.0,,1045224.0,39351.0,994765.0,,,14219328.0,,,,5420364.0,,,1018649.0,,,16726.0,,,17460,,,21279487.0,,,,,,,,95.0,,,,,,,,,-2911.0,,,,2138452.0,1553930.0,,,,6455811.0,8113296.0,,,,-9089070.0,,797599.0,14808626.0,19377358.0,,60837.0,,19.09,,,164563.0,4802004.0,796675.0,1690915.0,3940575.0,,,131.0,,1481274.0,,1926248.0,,,,,,,466931.0,,42590090.0,478324.0,,2448658.0,20131627.0,5.0,3629873.0,,141509428.0,985560.0,,,,,,1413741.0,,1825.44,,,,,,1237181.0,1519376.0,93654.0,,1644.0,53259.0,1198004.0,,,,5667064.0,,,,37270.0,38797694.0,,115018634.0,,1144799.0,,,,,,3409341.0,1099.0,1156756.0,,,,,,5388439.0,,,9.0,396373.0,19803.0,,590.0,22377513.0,6424695.0,624461.0,303774.0,29926565.0,15736912.0,,,,3037494.0,36.64,,,Y,,,,,24551502.0,,31379541.0,1941.0,889.0,,,,,358369.0,5849139.0,,,,,,10166148.0,36T155,3.0,3468.0,,,,,,6382038.0,,83714.0,,,,1361793539.0,,,,,,,,1016487.0,29820.0,28363958.0,177.0,,General Short Term,,11639.0,396373.0,12915.0,16828431.0,,,124.0,6462624.0,2401.0,,,,1175301.0,,124472904.0,112283968.0,,,,,3540.0,2229433.0,,,,,-577351.0,-94357.0,,,3358.0,1821077.0,,1328925.0,531043.0,905.0,,-48479416.0,,28.07,,85750.0,57305.0,276452.0,1465451.0,310246.0,5345982.0,6.0,,,,,483754.0,,299858993.0,367253,,495108300.0,4700569.0,,-32140.0,10745441.0,5960085.0,5.0,660717.0,,,Y,4089.0,,697342.0,3701207.0,994765.0,198984381.0,112.0,,7142097.0,,10713361.0,,2229433.0,,,676039.0,,,,,36170,1047638.0,,1175301.0,,31801.0,40188962.0,132.0,5517433.0,531473.0,,,111800692.0,945617.0,,,77206.0,,F,,,,,,86583.0,,19124138.0,1062466.0,578286.0,1450161.0,1270.0,,,,,,,13138910.0,,,,,2156991.0,141678.0,,,,,,,,,8469834.0,,134.36,,86583.0,,,,6031143.0,141714.0,14219328.0,159121.0,15977880.0,,,7145.0,,,9986.0,,1070.0,,124032.0,1526497.0,13.36,,1535753.0,,3122.0,1447.0,56.0,,,,12986.0,,45315.0,34255.79,303505.0,,,3822849.0,,2470875.0,,177.0,,1779397.0,259760.0,,,15.0,-3416876.0,,15503777.0,215928.0,,622203.0,,,68715.0,,-60458.0,,,,2588.0,14399461.0,,51618.98,,,2990326.0,13930297.0,13125800.0,,,,574.0,5550705.0,676282.0,,,,,1135868.0,,,,272045.0,,5550705.0,,,,,,,,25396466.0,43152.0,,,,7145.0,,,,12443232.0,36215214.0,-797199.0,,,370.0,,,,21.0,,,4117471.0,313724.0,,763400.0,42584.0,,,384587.0,,,,58.0,,,,1185930.0,,28228782.0,4525.0,,,,3407.0,,7955477.0,,,,981.0,,15.0,,,37903.0,,305789.0,3193884.0,4611581.0,,299699510.0,318234659.0,,,,161239.0,299315630.0,,4426833.0,13787.0,1061.0,,,1830201.0,OH,-360.0,16076.0,744232.0,,,,,,,11526.0,3162799.0,,4393854.0,4167093.0,,321.0,,,,1453875.0,,N,288064.85,,,137125.0,,1386863.0,,,,,3365592.0,1913728.0,6255346.0,,39351.0,1279436.27,,,310529.0,,,,,138.0,2.0,,,,12912297.0,36923.0,0.22049,,,,-8852.0,,,5894697.0,1308364.0,1452162.0,106787.0,,,,,,,,,,3833018.0,,143469.0,10600375.0,84812731.0,5798.0,,,,,20.0,,,,,,13388.0,225096190.0,,,3290766.0,,,2159170.0,,,36,,10798170.0,7959952.0,N,,,,,4445356.0,1442617.0,,18319.0,,,47103.0,71905.0,,,,,27.06,7596007.0,,941668.0,,,,,,,1869.0,,,786167.0,,5475.0,,,-944385.0,1780846.0,N,,115163217.0,652805.0,,325279.0,1472332.0,10166148.0,,1471980.0,25342038.0,,1915860.0,3796265.61,,,677640.0,,,6798.0,,27580.0,25756272.0,7405550.0,9649574.0,22972848.0,2008013.0,,,,,,,,2526.0,,87.0,,,,,,1600.0,,52679.0,30.85,,,,-329324.0,1280635.0,,,69779.0,,,,,,,1192347.0,,,,,258.0,,-5260089.0,1983941.0,117.0,4104796.92,,,,N,6666536.0,,11639.0,,,,38645876.0,,,25456125.0,,,284407.0,,6304828.0,,,4920085.0,541521.0,1.0,30091.0,2066342.0,,,4133.0,,,,,,,,,,2483.23,22344910.0,167813.0,15.81,,,34936.0,3085745.0,15201,3065652.0,,,,15.63,42.93,,,3037494.0,,1548765.0,,,,,,,P,,,,,11794.0,1791.0,43.0,,,,,,,,2714.0,,,,1754.0,,2018,0.00732239360069656,226251560.0,28519882.09015,14934174.090149999,24551502.0,17395960.09015,0.05509830083644172,12684477.0,0.036545078774213285,1.2157478586017096,1.527454310689362,0.9732648008665261,0.351933437704719,226251560.0,1.1878201325993067,0.54292403424777,0.45707596575223,2.321341324374153,226251560.0,0.701197672996141,4.232488466604903,Acute Care Hospitals,non-profit,1,SOUTHWEST GENERAL HEALTH CENTER (360155)
57624,SOUTHWEST GENERAL HEALTH CENTER (360155),General Short Term (Acute Care Hospitals),Voluntary Nonprofit-Other,-81.83291,41.37208,,,,15478.0,,,,,,2539212.0,,,,1724682.0,,-236774.0,,,,,37353.0,25699634.0,CUYAHOGA,,,122945.0,171383.0,14977.0,,,80997.0,,1.0,,,4307935.0,,304.0,866.0,,,87199.0,1127491.0,17646785.0,36.0,16.38,2272002.0,,,,,1061559.0,1280312.0,,,11739532.0,,,,,,,714.0,,,,141958.0,,,,,,,,,,8165700.0,,,5914902.0,130576000.0,,914.0,15688568.0,,,,31857866.0,,14977.0,,,,,,,,145517.0,65954.14,8891288.0,N,1435264091.0,244125628.0,31.66,,,2024-02-14 00:00:00,2318693.0,,,10410.0,,,,15922707.0,,54.0,,,,567667.0,65553.0,368708.0,,7463602.0,,,,1869255.0,414512.0,,40064577.0,,,,,142.0,2584784.0,100187.0,,,231.0,30.85,,1318772.0,,,20212740.0,2313586.0,,,,321.0,88078.0,,,,,,,360740.0,1255461.0,,,23120.0,,,,,,,66241778.0,,,,,,,171931.0,,,4749.0,,,,,6237921.0,,-34388.0,44463657.0,449707.0,49783.0,,4503.0,3609.0,,,3916781.0,,1283046.0,,7685250.0,7409546.0,7394386.0,,,,,,,,,2504638.0,,,-118454.0,,3216003.0,,,,,,,7595.0,,60439.0,,3795267.0,,,,,,,,394685.0,,,672649.0,16799.0,2054273.0,,,215.0,,,N,,,,80949.0,,1349.0,,164668.0,,129176.0,4311.0,4804429.0,,,33810901.0,,,,36.0,,,,,1.0,6433870.0,,1001837.0,,,,,1865875.0,,,803.0,262022.0,,267731.0,,150342.0,,,1214106.0,,3487636.0,,,,1134474.0,280041.0,,6237921.0,,,-103898.0,3650.0,,,,15253.0,,,,21505.0,5836884.0,,,665339.0,,,,,,9125405.0,,3601.0,,,2672837.0,,,614180.0,37353.0,,,,3633591.0,5595.0,23851.0,,,,,149483.0,,,,,73548.0,,584844.0,81520.0,,,1504663.0,,7665.0,,87.75,1884492.0,,47.0,6191186.0,35.03,2155.0,32.68,,,6383.0,1971387.0,,,,6470597.0,,,,,,22361.65,,,,130505630.0,,,264.0,2700.0,39515.0,6781.0,2776.0,,,,119519324.0,,,,1736826.0,6336.0,,92121.0,31266.0,1245074.0,,,671460.0,,-2311.0,,,-85537.0,,,7221044.0,,13756350.0,,,,,478466.0,639139.0,2343.0,,,3562653.98,,984208.0,,,,1085575.0,41343002.0,93724.0,,82.0,,,,,,,2653533.0,122781.0,,9253958.0,,,1245151.0,,,,,1554405.0,13500813.0,,,257530.0,,2464660.0,1983687.0,,,92550.0,,,,,13325.0,19464.0,,,,-20356.0,,,34863750.0,,8904896.0,-1089137.0,50422.06,4628984.0,3440.0,12554.0,,,,4183515.0,,5624547.0,6667.0,-200.0,,,,,,,2464660.0,,,,,,18661537.0,431310.0,,10608882.0,,,,,ACUTE REHAB,6383.0,,12204047.0,,79710.0,,31266.0,,8017.44,,,,,,,113126.0,-6653376.0,,50.64,,171931.0,,,1911805.0,,5079850.0,,870396.0,-5670.0,1074.0,,99976.0,,,,,,,,,1237230.0,,4.0,,,,,,,10126674.0,,472904734.0,,871532.0,12434238.0,29457.0,99908.0,18254.0,24218734.0,12875.0,-414.0,,,,44356130.0,,,4475758.0,,,6127216.0,,5057.0,,,-1008168.0,7002147.0,,,,,,184916421.0,27.0,,,,111810.3,13977928.0,,,,361530,,,N,,249013.0,53541959.0,,,,,2.0,,,,3803757.0,,,,1712216.0,,11.0,,171383.0,14910843.0,,,2138909.0,,5785440.0,329099.0,1316912.0,-221895.0,,,,,,,,14809389.0,,4183515.0,,,,,,,,,3101275.0,,,,,,,238638.0,39555376.0,1214106.0,7665.0,,,,,,3096.0,,2040403.0,,,4038228.0,,,23120.0,,,3524829.0,,,,182.0,,7577606.0,1.0,,,912169.0,-2714.0,126951.0,,,,16021594.0,,,,,,626.0,121.0,,56782797.0,,34139483.0,,,,3642672.0,14600.0,360155,50.0,,,,,126574.0,,94.0,25937929.0,,,,,,1676818.0,,35964008.0,31866170.0,,,N,5122573.0,,,,,11181547.0,7502021.0,1389192.0,,,,,,,,423.0,6089120.0,,256.0,3577217.42,151565069.0,,SOUTHWEST GENERAL HEALTH CENTER,,215394.0,,,3678920.0,,226236.0,,2611958.0,,230413.0,,,,,,,249727.0,,6255346.0,151512030.0,,,41343002.0,-10742.0,11297489.0,,,,2194781.0,,,763771,1821630.0,,3.0,,,,,,,,15848.0,,,,,,10182.0,3504.0,,,,,8480.0,2385930.0,,,439907.0,,,,,,,,,1255416.0,1909866.0,342518721.0,,217331144.0,,,909107451.0,,3635765.0,,,1399470.0,,,67.27,,,16918486.0,,15754120.0,,3604511.0,549210.0,,2019-01-01 00:00:00,,,123456890.0,558.0,39413566.0,,-21126231.0,35964008.0,13313483.0,,,,,2138111.0,,1957247.0,,,N,130913.0,,,530096.01,,1205259.0,,-44121.0,21680795.0,,,,6267.39,5.0,16260504.0,,3129195.0,10838738.0,,,,11228.0,,,,,,299858993.0,,4,,,,,,,16799.0,33.7,31266.0,7665.0,,31802775.0,,6745839.0,,,,,,5066621.0,,31243.0,,,,-196295.0,,,,,20235802.0,16489538.0,,532276123.0,3782310.0,92121.0,,-10997.0,879863.0,,184916421.0,,,,4273255.0,,,,584844.0,4273255.0,,21655519.0,,186500.0,,,,,,,,468942297.0,,,20212740.0,2458356.0,,,495218.0,784.0,MIDDLEBURG HEIGHTS,,10682.0,,,23146.0,244381528.0,,,,,,,2381793.0,,,4475758.0,,,,,12138599.0,46750.0,,114194189.0,,38569.96,28.64,,,,,1689217.0,,,3024601.0,,99908.0,4974412.0,,,14809389.0,-298160.0,161036.0,,2336295.0,,,,-48654.0,,,389279.0,26236193.0,,4791093.0,,,179917.0,,,34102599.0,,,17671339.0,92846.95,221652817.0,,,,5867227.0,,,,,9216800.0,620106.0,3835960.0,1440.0,,,213622.0,11121.0,114.0,,,,,,,,,4974412.0,,128394.0,,,,,249727.0,1994292.0,,,,1303589.0,7175.0,,,,,,7859869.0,1675852.0,,,,,-507659.0,,,1513650.0,,,,,,,-899674.0,,,N,1159.0,19.0,39.0,,,,,,,,,1210032.0,44954.0,,1934546.0,,,,,,4470957.0,,1598.0,,,54664690.0,,,,,,,399.0,,-35814.0,951279.0,,,,36920.0,,10328.0,,,,,,631559.0,,3770057.0,7459415.0,,170424210.0,74574011.0,5203.0,25269.0,,984208.0,,970.0,,,,803954.0,,,,,,,,,,11297489.0,,36443.0,,27.94,,,2686608.0,,,256.0,,2381793.0,,,,4.0,764004.0,,11708457.0,118446.0,77730532.0,-6370.0,17385.0,,5676855.0,1210032.0,,3778238.0,,,,2238383.0,3862479.0,,279298.0,7151624.0,17919863.0,,,,200.0,,906744509.0,,2238383.0,,36.13,,973758.0,,,,17.0,5099732.0,2093747.0,,11708457.0,6470597.0,505116.0,,61.0,,,,20624499.0,,,,182111.0,7382585.0,401443.0,,,,,,3128535.0,439108.0,,,51574.0,,,1686668.0,Y,,5590.0,,29457.0,,,-134471.0,44130-3497,21729.0,880611.0,530096.01,1372879.0,,32.67,,15478.0,2386978.0,,16021594.0,,,,,,,,-10316571.0,,2779.0,,4804429.0,,,5711789.0,-414.0,530646951.0,,,,,,15304589.0,63152539.0,,,,,,,,,,,309203.0,,363644952.0,558.0,38.91,,85.0,546147.0,,Y,,235.0,182682.0,,6448456.0,,13313483.0,,629809.0,5079850.0,,,,,13961398.0,290451.0,,,N,58388.28,,,,2749038.0,,,,,7167818.0,3156842.0,1715651.0,,2523897.0,,,,,,,,,12006746.0,,-1920.0,,,,,,,,,,47583.0,394685.0,16489538.0,,77665.0,,,1237630.0,,,,,5711789.0,635190.0,,,1907514.0,,665339.0,,,,25924039.0,,,,,,2464660.0,,,,,,8715.0,,10608882.0,37353.0,5085120.0,20235802.0,3160141.0,,,,,286.0,,,,,,5331493.0,,,26266.0,33659031.0,,,22863149.0,855056.0,51913.0,,10182.0,,10820652.0,,,18287.0,,,,42.35,,,7906777.0,29688.0,,,287894595.0,,,15856406.0,,,,,43.0,,,,,,95683.0,,,,1127948.0,9167.0,,5914902.0,,171383.0,51830.0,,,49265.0,-21126231.0,,,5927602.0,3.0,,132383.36,13140.0,68870.0,,10.0,,,,696343.0,,,,,380295.0,,130796446.0,,,217869.0,,,,,,,,325412325.0,44683983.0,489.0,,2574953.0,,865.0,,3147827.0,,,,,,,,,,9815.0,,,9081538.0,7359984.0,,4920582.0,,,,,6225958.0,6225958.0,,4495.0,2293.53,,,16.0,40563910.0,,,,15401229.0,,118209.0,,,106.0,,2584784.0,10410.0,41343002.0,1411186.0,410221.0,7383428.0,7151624.0,,14556.0,,37353.0,2654.0,,,,,-1224.0,,,,34102599.0,,,311986.0,,,,,,,,69129119.0,,,,55.19,,,12204047.0,,,,2241600.0,7.0,10378782.0,,,2642791.0,436805.0,960994.0,,471453.0,2496173.0,,1072466778.0,,9204504.0,N,2399143.0,,,18134640.0,1597940.0,,,,2313586.0,18287.0,,410040.0,,2216445.0,,,,,,,,97479183.0,13864691.0,1577.0,,8904896.0,,1751.0,17.41,,,,,165856.0,3601.0,465241.0,13856.0,,,,1588116.0,,131232528.0,,,,11.0,,1393302.0,,1029410.0,,1265.0,,,,33810901.0,,524724.0,,13518121.0,58322105.0,,,123292487.0,,4791093.0,4472983.0,,,,,26027643.0,5265.0,1672.26,7761.0,,294876.0,,431310.0,,,500.0,139573.0,,,171383.0,29861.0,,,,,,40618902.0,215153070.0,33810901.0,,,,,,,299334.0,,9.0,7.0,,,6957816.0,,,,N,,,879863.0,,12462931.0,,5775829.0,142.0,,65550.0,,,,,30343284.0,,10820652.0,,,,538020.0,60344.0,,1012940.0,153428.0,,1680,16296115.0,,23238991.0,,38440.0,239574.0,,-485650.0,,11993832.0,,2094334.0,,,,,21229.0,,,,,,,,,7665.0,,,,311986.0,7665.0,,,20839.0,69541942.0,,-11401.0,5765327.0,,22.95,36S155,40.0,49783.0,9153309.0,38682065.0,,,,346208.0,3140563.0,510608.0,,,,,2504638.0,,3916781.0,,18697 BAGLEY ROAD,,2450186.0,1283046.0,,,296832.0,475.0,350303.0,,,1815738.0,,1712216.0,,,87049.0,,,8.0,305.0,1.0,1252.0,,192049.0,579.0,383621.0,,,154.0,1953198.0,,,,,,-722992.0,,4859525.0,,,34171428.0,3242064.0,,,,1199362.0,,,,13635.0,,3842761.0,,79891.06,,,,,33621.0,19938.0,,,51650.0,,1078.0,68665.0,4494283.0,2181060.0,27.0,,6546.0,8001.0,356847.0,126574.0,111292.0,14503895.0,13500813.0,31945.0,280186055.0,,,,4962.0,,69671.0,,1513650.0,54.41,,1608658.0,,,,14563.44,,,,SWGHC MENTAL HEALTH SERVICES,,22448.0,367287624.0,,,,,16329.0,,23658035.0,,,,3128535.0,,,,237696.0,9211.0,3128535.0,,,,,,,,6200036.0,,37353.0,79016.0,,2019-12-31,,2715066.0,,-1224.0,-414.0,,,20091.0,13.0,1675852.0,,,,,59227.0,,4983816.0,-21938.0,,28010632.0,,1821630.0,,2234524.0,,291430.0,,,,,251.0,,25129427.0,1674255.0,,,33139190.0,,,,2952550.0,,,,,,,44.92,,,-97393.0,,,,,644528.0,488096.0,13539893.0,1277990.0,,1205259.0,38849.0,966004.0,,,14029452.0,,,,5184242.0,,,960042.0,,,,,,17460,,,20971740.0,,,,1.0,,,,,,,,,,,,,6205.0,,,,1669728.0,1684819.0,,,,15900120.0,8087821.0,,,,-9178030.0,,758690.0,13977928.0,20624499.0,,77665.0,,19.07,,,211212.0,19131061.0,697982.0,1277990.0,3612857.0,,,1415.0,,1513650.0,,1869255.0,,,,,,,480199.0,,43043012.0,478466.0,,1925831.0,21827898.0,5.0,3709386.0,,152070321.0,984208.0,,,,,,1527343.0,,1833.71,,,,,,1197247.0,1671980.0,97177.0,,1584.0,52060.0,1373795.0,,,,6127216.0,,,,36593.0,39413566.0,,119519324.0,,1281170.0,1.0,,,4.0,,3916781.0,2067.0,1159429.0,,,,,,4920582.0,,,,422013.0,16329.0,,,18423327.0,6399641.0,764004.0,296832.0,30734871.0,15304589.0,,,,3171431.0,40.75,,,Y,,216.0,,,18233204.0,,33810901.0,2471.0,665.0,,,,,339606.0,6745839.0,,,,,,10608882.0,36T155,2.0,3877.0,,,,,,6881323.0,,92121.0,,,,1439754402.0,,,,,,,,1144847.0,26287.0,26904675.0,181.0,,General Short Term,,11449.0,422013.0,3414.0,16952893.0,,,160.0,6265667.0,4020.0,,,,1216595.0,,127005532.0,116476178.0,,,,,3609.0,-969993.0,,,,,-619368.0,-74839.0,,,13890.0,2154444.0,,1374415.0,644528.0,936.0,,-57970030.0,,29.04,,59227.0,51830.0,251504.0,2523897.0,335929.0,3216003.0,11.0,,,,,796821.0,,302422825.0,367253,,528519582.0,5085120.0,,-46684.0,10857448.0,6620056.0,7.0,744150.0,,,Y,4045.0,,923851.0,3620362.0,966004.0,221652817.0,,,7267147.0,,12435053.0,,-969993.0,,,696343.0,,,,,36170,1343929.0,,1216595.0,,27715.0,41343002.0,123.0,5496099.0,495218.0,,,116423139.0,1127491.0,,,43005.0,,F,,,,,,,,34464868.0,939907.0,589226.0,1391186.0,2034.0,,,,,,,12462931.0,,,,,2045528.0,120136.0,,,,,,,,,7837150.0,,147.57,,,,,,12256746.0,,14029452.0,123180.0,17919863.0,,,7986.0,,,11066.0,,515.0,,114225.0,1554893.0,14.7,,1689217.0,,2413.0,1265.0,103.0,,,,14305.0,,38091.0,34255.79,312129.0,,,4414417.0,,2593394.0,,181.0,,2138111.0,236330.0,,,,-3582368.0,,15058668.0,238034.0,,674543.0,,,63424.0,,-49234.0,,,,2776.0,13548184.0,,51618.98,,,2447977.0,13311160.0,14583804.0,,,,,5513377.0,634098.0,,,,,2749038.0,,,,295525.0,,5513377.0,,,,,,,,24983157.0,26266.0,,,,7986.0,,,,13401898.0,35411270.0,-1016171.0,,,326.0,,,,,,,4587439.0,359083.0,,672649.0,41549.0,,,361410.0,,,,43.0,,,,1303589.0,,29246926.0,4495.0,,,,3048.0,,7751748.0,,,,800.0,,15.0,,,36495.0,,268006.0,3371569.0,7428774.0,,322725717.0,342518721.0,,,,185017.0,322334249.0,,4111388.0,17519.0,800.0,,,1821630.0,OH,-2311.0,15478.0,814024.0,,,,,,,5041.0,3336759.0,,3987489.0,3936830.0,,51.0,,,,1577148.0,,N,288064.85,,,147862.0,,1588116.0,,,,,4038228.0,1865875.0,6255346.0,1208.0,38849.0,1266230.88,,,354097.0,,,,,-25.0,793.0,,,,13604011.0,11835.0,0.224582,,,,-3039.0,,,5676579.0,1411186.0,5285860.0,109116.0,,,,,,,,,,4048321.0,,156621.0,11496415.0,81665858.0,1537.0,,,,,,,,,,,14455.0,261054994.0,,,2952550.0,,,2216445.0,,,36,,11181547.0,8842676.0,N,,,,,4778634.0,1363180.0,,21229.0,,,65849.0,66430.0,,,14.0,,27.94,9081538.0,,1121875.0,,,,,,,4814.0,,,870418.0,,5475.0,,,-597637.0,1666343.0,N,,120246222.0,676097.0,,318975.0,1758556.0,10608882.0,,1579632.0,42324737.0,,1831100.0,3798323.75,,,1732871.0,,,6950.0,,20908.0,26236168.0,7880030.0,9641651.0,22863149.0,3249037.0,,,,,,,,,,14.0,,,,,,91395.0,,46407.0,32.06,,,,-271324.0,1251486.0,,,69671.0,,,,,,,1255416.0,,,,,243.0,,-5427173.0,2035483.0,,4092749.99,,,,N,6933910.0,,11449.0,,,,43975592.0,,,25937929.0,,,225201.0,,7463602.0,,,5331493.0,557880.0,1.0,,1972756.0,,,5048.0,,,,,,,,,1208.0,2483.23,17324043.0,148505.0,16.29,,,31945.0,3057664.0,15201,3057664.0,,,,12.59,45.31,,,3171431.0,,1908726.0,,39.0,,,,,P,,,,,18734.0,1517.0,164.0,,,,,,,,2654.0,,,,1521.0,,2019,0.005295910171193577,244381528.0,29374527.435572002,15856406.435572002,18233204.0,17790952.435572002,0.09383618109604477,3642672.0,0.00991776406819523,1.2328451992940166,1.746818858032464,1.0241175289709161,0.27525233395758186,244381528.0,1.1780538298295606,0.5408745246308935,0.4591254753691065,0.41762952015589627,244381528.0,0.6900321245482582,3.767857020303504,Acute Care Hospitals,non-profit,1,SOUTHWEST GENERAL HEALTH CENTER (360155)
61618,SOUTHWEST GENERAL HEALTH CENTER (360155),General Short Term (Acute Care Hospitals),Voluntary Nonprofit-Other,-81.83291,41.37208,,,,13491.0,,,,,,2353314.0,,,,1732641.0,,-261961.0,2.0,,,,41975.0,22605784.0,CUYAHOGA,,,138281.0,156326.0,14111.0,,,83068.0,,1.0,,,4266109.0,,290.0,722.0,,,78686.0,1572158.0,16229940.0,26.0,17.33,2193126.0,,,,,918525.0,1486773.0,,,12059186.0,,,,,,,2196.0,,,,114478.0,,,,,,,,,2.0,7703662.0,,,6181012.0,132982617.0,,1123.0,11708298.0,,,,27354345.0,,14111.0,,,,,,,,145420.0,62723.25,7745185.0,N,1291719872.0,238597486.0,32.3,,,2023-12-21 00:00:00,2257259.0,,,8244.0,,,,9489276.0,,85.0,,,,508174.0,3980269.0,388097.0,,7152150.0,,,,1606244.0,449253.0,,38438180.0,,,,,155.0,2438775.0,98003.0,,,31.0,31.37,,1264344.0,,,16024085.0,1939724.0,,,,187.0,80467.0,,,,,,,316808.0,1203717.0,,,20963.0,,,,,,,84689159.0,,,,,,,156469.0,,,4576.0,,,,,5844384.0,,-40917.0,34728217.0,426382.0,27613.0,,4041.0,3143.0,,,3667801.0,,1078020.0,,8820280.0,5567520.0,6761523.0,,,,,,,,,2298631.0,,,-56924.0,,3975914.0,,,,12946.0,,,16709.0,,75437.0,,3520231.0,,,,,,,,372061.0,,,698811.0,3567.0,2726034.0,,,211.0,,,N,,,,79224.0,,324.0,,142154.0,,96468.0,10629.0,4421979.0,,,32101250.0,,,,38.0,,,,,1.0,10158061.0,,1007167.0,,,,,1941707.0,,,2703.0,378753.0,,265074.0,,128085.0,,1.0,787130.0,,3306161.0,,,,1188754.0,181754.0,,5844384.0,,,,3660.0,,,,4278.0,,,,22416.0,5386956.0,,,618058.0,,,,,,9216800.0,,3089.0,,,2041554.0,,,926158.0,41975.0,,,,3403483.0,7043.0,24155.0,,,,,-51032.0,,,,,10891.0,,444969.0,78357.0,,,1451965.0,,8600.0,,77.15,1955099.0,,97.0,5676378.0,35.13,2486.0,33.0,,,497.0,1949811.0,,,,6013798.0,,,,,,21876.28,,,,126243418.0,,,173.0,3107.0,27977.0,6557.0,3150.0,,,,117307847.0,,,,1356208.0,,,97986.0,33847.0,1182579.0,,,959887.0,,40.0,,,-30521.0,,,8383594.0,,16523496.0,,,,,305991.0,666511.0,1740.0,,,3410671.24,,946223.0,,,,918525.0,47459602.0,126799.0,,72.0,,,,,,,2972364.0,138232.0,,11235061.0,,,941986.0,,,,,1175793.0,12478737.0,,,220722.0,,2498550.0,1526967.0,,,74872.0,,,,,18214.0,16839.0,,,,-9840.0,,,29965478.0,,7300603.0,-1015601.0,48408.56,4562472.0,5439.0,8668.0,,,,3336978.0,,4489554.0,1569.0,-80.0,,,,,,,2498550.0,,,,,,17277263.0,341631.0,,11371956.0,,,,,ACUTE REHAB,497.0,,9746840.0,2284020.0,59445.0,,33847.0,,14359.24,,,,,,,59613.0,-4019797.0,,45.91,,156469.0,,,2263562.0,,5072295.0,,867339.0,-19342.0,157.0,,93610.0,,,,,,,,,1046651.0,,6.0,,,,,,,9752189.0,,486292997.0,,888757.0,11382013.0,31683.0,83128.0,16641.0,21271328.0,19218.0,,,,,42350198.0,,,3821542.0,,,5855212.0,,4877.0,,,-786301.0,6509454.0,,,,,,153386861.0,161.0,,,,115270.06,8617956.0,,,,361530,,,N,,238894.0,47101253.0,,,,,7.0,,,,3490752.0,,,,1074547.0,,8.0,,156326.0,15203297.0,,,1982999.0,,5486555.0,302110.0,17340267.0,-210560.0,3234.0,,,,,,,14132867.0,,3336978.0,,,,,,,,,17340267.0,,,,,,,354247.0,40023279.0,787130.0,8600.0,,,,,,675.0,,2196182.0,,,4275894.0,,,20963.0,,,3351097.0,,,,188.0,,8156239.0,1.0,,,903036.0,-349376.0,124525.0,,,,13075674.0,,,,,,238.0,223.0,,48103034.0,,32006579.0,,,,-3907482.0,12078.0,360155,96.0,,11744.0,,,131089.0,,14.0,22449684.0,,1.0,,,,1484213.0,,37378376.0,28811312.0,,,N,4840727.0,,,,,10925494.0,6097359.0,1214897.0,,,,,,,,,5655454.0,,249.0,3431156.73,146533073.0,,SOUTHWEST GENERAL HEALTH CENTER,,206619.0,,,3450450.0,,102054.0,,1859349.0,,198766.0,,,,,,9.0,241090.0,,6255346.0,146239472.0,,,47459602.0,-10767.0,11674092.0,,,,2218709.0,,,760896,1982936.0,,3.0,,,,,,,,22958.0,,,,,,9392.0,260.0,,,,,17676.0,2299913.0,,,333128.0,,,,,,,,,1214254.0,1916284.0,336509287.0,,216075523.0,,4860.0,787459684.0,,3337264.0,,,1422255.0,,,53.89,,,16396826.0,,15688567.0,,3528650.0,500384.0,,2020-01-01 00:00:00,,,106601553.0,880.0,33875853.0,,-19396046.0,37378376.0,13190974.0,,,,,1371454.0,,2070025.0,,,N,106534.0,,,496041.33,,858852.0,,-50945.0,17270402.0,,,,6502.17,5.0,17172258.0,,3230569.0,15260193.0,,,,6706.0,,,,,,302422825.0,,2,,,,,,,3567.0,37.1,33847.0,8600.0,,27278264.0,,6390722.0,,,,,,5059363.0,39494.0,25270.0,,,,-76605.0,,,,,15304732.0,22855656.0,,593328591.0,3541512.0,97986.0,,-10657.0,853075.0,,153386861.0,,,,3013960.0,,,,444969.0,3013960.0,,22278895.0,,4369928.0,,,,,199.0,,,484114923.0,,,16024085.0,2399415.0,,,354917.0,634.0,MIDDLEBURG HEIGHTS,,6052.0,,,37589.0,250466758.0,,,,,,,2246016.0,,,3821542.0,,,,30.0,12905725.0,44628.0,,121614989.0,,36519.34,28.79,,,,,1747144.0,,,13348819.0,,83128.0,4399420.0,,,14132867.0,-187766.0,182586.0,,2226922.0,,,,-21608.0,,,353296.0,22669906.0,,4231255.0,,,166242.0,,,31692230.0,,,16254494.0,81551.5,258172674.0,,,,5304907.0,258.0,,,,9372171.0,628561.0,3904304.0,912.0,,,173381.0,11179.0,16.0,,,,,,,,,4399420.0,,82807.0,,,,,241090.0,1924213.0,,,,908114.0,7689.0,,,,,,10336912.0,1575573.0,,,,,-2417370.0,,,1449480.0,,,,,,,-704536.0,,,N,2167.0,52.0,283.0,,,,,,,,,1061752.0,42128.0,,1738918.0,,,,,,4678000.0,,1694.0,,,57036955.0,,,,,,,34.0,,-118670.0,820973.0,,,,34061.0,,8789.0,,,,,,555021.0,,3584112.0,6573746.0,,169961026.0,68286476.0,1969.0,23387.0,,946223.0,,84.0,,,,840317.0,,,,,,,,,,11674092.0,,35567.0,,28.49,,,3485743.0,,,180.0,,2246016.0,,,,1.0,552448.0,,12038632.0,105207.0,62155110.0,-4076.0,18895.0,,5691726.0,1061752.0,,4237931.0,,,,1924356.0,4206699.0,,142162.0,623376.0,14765077.0,,,,177.0,,785348871.0,,1924356.0,,40.96,,948421.0,,811.0,,107.0,4861704.0,2259983.0,,12038632.0,6013798.0,313792.0,,76.0,,,,20168068.0,,,,145667.78,6714196.0,639139.0,,,,,,3025740.0,483096.0,,,36552.0,,,1675506.0,Y,,4914.0,,31683.0,,,-145147.0,44130-3497,19618.0,748911.0,496041.33,1438874.0,,33.08,47.0,13491.0,,,13075674.0,,,,,,,,-9162907.0,,50118.0,,4421979.0,,,4144050.0,,508532739.0,,,,,,15350685.0,50614967.0,,,,,,,,,,,428989.0,,355905333.0,880.0,47.73,,93.0,496181.0,,Y,,4083.0,165474.0,,6030880.0,,13190974.0,,582686.0,5072295.0,,,31899.0,,14745033.0,297356.0,,,N,60090.83,,,,1920595.0,,,,328.0,5579095.0,3080671.0,1451280.0,,1945291.0,,,,,,,,,11406083.0,,-2160.0,,,,,,,,,,57984.0,372061.0,22855656.0,,78110.0,,,1264668.0,,,,,4144050.0,891449.0,,,1769773.0,,618058.0,,,,22437797.0,,,,,,2498550.0,,,,,,15811.0,,11371956.0,41975.0,4694837.0,15304732.0,2646655.0,,,,,44.0,,,,,,5900176.0,,,22682.0,28695275.0,,,22552205.0,589082.0,49662.0,,9392.0,,10320464.0,,,,,,,42.62,,,10387979.0,33375.0,,,342861833.0,,,15662079.0,,,,,93.0,,,,,,98259.0,,,,1212857.0,2558.0,,6181012.0,,156326.0,56730.0,,,55459.0,-19396046.0,,,4913261.0,2.0,,135476.37,13908.0,69998.54,,10.0,,,,526727.0,,,,,443394.0,,121048621.0,,,203631.0,,,,,,,,321142727.0,49448228.0,460.0,,11891476.0,,1005.0,,2593342.0,,,,,,,,,,11117.0,,,8082115.0,6487128.0,,3747164.0,,,,,4477191.0,4477191.0,,4021.0,2304.73,,,,37204558.0,,,,15135553.0,,86133.0,,,64.0,,2438775.0,8244.0,47459602.0,1385062.0,389512.0,7052443.0,623376.0,,4954.0,,41975.0,2222.0,,,,,-1455.0,,,,31692230.0,,,685307.0,,,,,,,,59908397.0,,,,56.88,,,9746840.0,,,,2360350.0,3.0,7188510.0,,,2961597.0,486321.0,747315.0,,437420.0,2508534.0,,943994572.0,,14074897.0,N,2682852.0,,,19619259.0,1553744.0,,,,1939724.0,,,404035.0,,,,,,,,,,95095914.0,13912433.0,1390.0,,7300603.0,,2157.0,18.47,,,,,146108.0,3089.0,621201.0,10612.0,,,,1610637.0,,126690717.0,,,,,,1388385.0,,678289.0,,1233.0,,7.0,,32101250.0,,149621.0,,14073757.0,47335893.0,,,88788727.0,,4231255.0,4874542.0,,,,,28311686.0,28901.0,1591.95,5584.0,,240937.0,,341631.0,16029.0,,604.0,114655.0,,,156326.0,29795.0,,,,,,37218629.0,213897449.0,32101250.0,,,,,,,254266.0,,,4.0,,,6723883.0,,,,N,,,853075.0,,9109151.0,,5373818.0,155.0,,57917.0,,,,,32663395.0,,10320464.0,,,,264307.0,76214.0,,933281.0,220435.0,,1680,17209938.0,,22376275.0,,67502.0,354525.0,,-330776.0,,12200819.0,,1917776.0,,,,,4757.0,,,,,,,,,8600.0,,,,685307.0,8600.0,,,18510.0,79655909.0,,4270.0,6876467.0,,23.11,36S155,33.0,27613.0,8824351.0,33210655.0,,,,516328.0,3145217.0,561416.0,,,,,2298631.0,,3667801.0,,18697 BAGLEY ROAD,,2409013.0,1078020.0,,,330978.0,,352365.0,,,1934947.0,,1074547.0,,,83301.0,,,57.0,265.0,1.0,1437.0,,172355.0,5189.0,317242.0,,,5544.0,1676432.0,,,,,,-240865.0,,4915051.0,,,32045071.0,2767533.0,,,,1175441.0,,,,10274.0,,3964638.0,,79635.84,,,,,29231.0,15609.0,,376.0,67102.0,,1372.0,57858.0,4600822.0,2013666.0,69.0,,6126.25,13615.0,300905.0,131089.0,108974.0,21655519.0,12478737.0,38492.0,313544789.0,,,,4235.0,,67345.0,,1449480.0,54.27,,1913303.0,,,,20485.49,,,,SWGHC MENTAL HEALTH SERVICES,,24228.0,351997851.0,,,,,13466.0,,19904535.0,,,,3025740.0,,,,27372.0,28906.0,3025740.0,,,,,,,,5731758.0,,41975.0,94683.0,,2020-12-31,,2661732.0,,-1455.0,,,,15545.0,452.0,1575573.0,,,,,83681.0,,6933941.0,-15975.0,,25847481.0,,1982936.0,,1901180.0,,421391.0,,,,,363.0,,39319858.0,1467281.0,,,34664795.0,,,,1676411.0,,,,,,,42.75,,,-116667.0,,,,,543926.0,514316.0,11389362.0,1580372.0,,858852.0,39196.0,895065.0,,,13391967.0,,,,4535595.0,,,912109.0,,3332.0,11952.0,,,17460,,,15658334.0,,,,,,,,,,,,,,,,,-9055.0,,,,1680985.0,1497828.0,,,,6647461.0,6940857.0,,,,-9057187.0,,1311092.0,8617956.0,20168068.0,,78110.0,,19.87,,,200999.0,18555525.0,754905.0,1580372.0,3508354.0,,,4721.0,,1449480.0,,1606244.0,,,,,,,357365.0,,43329440.0,305991.0,,1723107.0,24172649.0,5.0,3709428.0,,149511890.0,946223.0,,,,,,1198016.0,,1750.06,,,,,,882519.0,1729850.0,89040.0,,2015.0,67220.0,1191749.0,,,,5855212.0,,,,50624.0,33875853.0,,117307847.0,,1289546.0,1.0,,,19.0,,3667801.0,437.0,1162485.0,,,,,,3747164.0,,,,243789.0,13466.0,,1129.0,15502656.0,7901750.0,552448.0,330978.0,32052599.0,15350685.0,,,,2691125.0,42.27,,,Y,,216.0,,,39757910.0,,32101250.0,567.0,4113.0,,,,,337996.0,6390722.0,,,,,207.0,11371956.0,36T155,5.0,4127.0,,,,,,5124086.0,,97986.0,,,,1295992423.0,,,,,,,,972711.0,4329.0,27404116.0,183.0,,General Short Term,,11433.0,243789.0,6781.0,15872015.0,,,203.0,5684277.0,3051.0,,,,1187246.0,,130414801.0,112851451.0,,,,,3143.0,-1425434.0,,2189273.0,,,-623381.0,-64010.0,,,11887.0,2247280.0,,1316574.0,543926.0,278.0,,-52504684.0,,28.52,,83681.0,56730.0,254730.0,1945291.0,333133.0,3975914.0,3.0,,,,,517811.0,,314303122.0,367253,,506371001.0,4694837.0,,-20805.0,11929370.0,6302472.0,,632262.0,,,Y,3996.0,,969386.0,3665604.0,895065.0,258172674.0,,,8435220.0,,11382828.0,,-1425434.0,,,526727.0,,,,,36170,1034799.0,,1187246.0,,30693.0,47459602.0,,5863019.0,354917.0,,,112557850.0,1572158.0,,,33989.0,,F,,,,,,31899.0,,18966261.0,928478.0,512756.0,1438473.0,1971.0,,,,,,,9109151.0,,,,,2137685.0,46180.0,,,,,,,,,8403460.0,,146.1,,31899.0,,,,10887326.0,,13391967.0,119537.0,14765077.0,,,5190.0,,,14714.0,,538.0,,81953.0,1720726.0,15.07,,1747144.0,,27673.0,1233.0,95.0,,,,9715.0,,44305.0,26251.0,232287.0,,,2886157.0,,2141422.0,,183.0,,1371454.0,151669.0,,,,-3381497.0,,20290999.0,230213.0,,436512.0,,,84217.0,,-39235.0,,,,3150.0,12344496.0,,47629.0,,,2389234.0,10997594.0,11538334.0,,,,,7624910.0,590500.0,,,,,1920595.0,,,,299309.0,,7624910.0,,,,2189273.0,,,,23127548.0,22682.0,,,,5190.0,,,,8926828.0,34636369.0,-1144188.0,,,436.0,,,,,,,4828570.0,315871.0,,698811.0,42303.0,,,341046.0,,,,26.0,,,2.0,908114.0,,30104995.0,4021.0,,,,3986.0,,6338449.0,,,,698.0,,15.0,,,43549.0,,281317.0,3024730.0,6802440.0,,317656984.0,336509287.0,,,,171310.0,317314190.0,,3542653.0,19166.0,698.0,,,1982936.0,OH,40.0,13491.0,736379.0,,,,,,,16101.0,3072505.0,,3226113.0,3802559.0,,141.0,,,,1470043.0,,N,285263.51,,,197921.0,,1610637.0,,,,,4275894.0,1941707.0,6255346.0,,39196.0,1205430.73,,,267533.0,,,,,178.0,1256.0,,,,12388637.0,-85698.0,0.245652,,,,-6195.0,,,6207509.0,1385062.0,7222000.0,101953.0,,,,,,,,,,4363903.0,,136655.0,10765213.0,109822776.0,6539.0,,,3294.0,,,,,,,,18607.0,294989264.0,,,1676411.0,,,,,,36,,10925494.0,8096578.0,N,,,,,5641682.0,1431857.0,,4757.0,,,57302.0,68808.0,,,19.0,,28.49,8082115.0,,1142094.0,,,,,,,1270.0,,,842312.0,,5490.0,,34.0,-360418.0,1096791.0,N,,117755146.0,512114.0,,276871.0,1539895.0,11369210.0,,1697933.0,29303173.0,,2142401.0,3645139.97,,,1572152.0,,,6685.0,,25670.0,22670084.0,6842266.0,9585276.0,22552205.0,3030987.0,,,,,,,,4891.0,,50.0,,,,,,155371.0,,32981.0,32.43,,,,-270129.0,1087164.0,,,67345.0,,,,,,-12.0,1214254.0,,,,,251.0,,-5614227.0,2042628.0,,3906712.57,,,,N,6739485.0,,11433.0,,,,42761013.0,,,22449684.0,,,193738.0,,7152150.0,,,5900176.0,454931.0,3.0,,1893830.0,,,8408.0,,,,,,,,,,2138.25,19756070.0,144066.0,17.33,,,38492.0,2123751.0,15201,2123751.0,,,,15.83,43.89,,,2691125.0,,2196608.0,,21.0,,,,,P,,,,,13921.0,4035.0,49.0,,,,,,,,2222.0,,,,2180.0,,2020,0.004841475640377662,250466758.0,29735835.845892,15662078.845892001,39757910.0,17400996.845892,0.05388175224967496,-3907482.0,-0.011100868908429784,1.2967749036213714,1.5923386841047742,1.1192962371960737,0.46945689943620766,250466758.0,1.3688915676386884,0.5778616405828992,0.4221383594171008,-0.6749031543645395,250466758.0,0.5932595467997598,3.7015034210618136,Acute Care Hospitals,non-profit,1,SOUTHWEST GENERAL HEALTH CENTER (360155)
65145,SOUTHWEST GENERAL HEALTH CENTER (360155),General Short Term (Acute Care Hospitals),Voluntary Nonprofit-Other,-81.83291,41.37208,,,,14332.0,,,,,,2744341.0,,,,1635785.0,,-244606.0,,,,,70271.0,24835235.0,CUYAHOGA,,,110292.0,129124.0,14596.0,,,81010.0,,1.0,,,4629289.0,,243.0,1054.0,,,79233.0,2422033.0,16803955.0,30.0,18.89,1890692.0,,,,,741241.0,1228753.0,,,13142397.0,,,,,,,,,,,116767.0,,,,,,,,,,8340265.0,,,6182153.0,153333946.0,,918.0,9862627.0,,,,29551407.0,,14596.0,,,,,,,,103064.0,59629.32,7617846.0,N,1432556888.0,265049177.0,34.54,,,2022-05-26 00:00:00,2261630.0,,,7151.0,,,,9226107.0,,,,,,602776.0,1845671.0,604106.0,,8076795.0,,,,1493073.0,334188.0,,40205386.0,,,,,155.0,3234256.0,110719.0,,,335.0,32.73,,1438865.0,,,16055648.0,2016857.0,,,,,79965.0,,,,,,,412263.0,1385858.0,,,21021.0,,,,,,,105947019.0,,,,,,,129166.0,,,4919.0,,,,,5776584.0,,-53391.0,39214306.0,426918.0,33738.0,,3902.0,3424.0,,,3779156.0,,1036654.0,,9709848.0,6199802.0,8191766.0,,,,,,,,,2532042.0,,,-74577.0,,4034710.0,,,,,,,8435.0,,39227.0,,4352901.0,,,,,,,,391575.0,,,621067.0,420.0,2960049.0,,,220.0,,,N,,,,94402.0,,645.0,,127555.0,,61801.0,3127.0,4272941.0,,,33204857.0,,,,38.0,,,,,1.0,12130172.0,,940361.0,,,,,1896610.0,,,,322473.0,,268591.0,,152799.0,,,1001679.0,,2828182.0,,,,1168892.0,219602.0,,5776584.0,,,-8197.0,3650.0,,,,9561.0,,,,21500.0,4888280.0,,,570250.0,,,,,,9372171.0,,2797.0,,,1520211.0,,,1485626.0,84533.0,,,,3139981.0,4352.0,24125.0,,,,,-10279.0,,,,,6504.0,,544927.0,66436.0,,,1536896.0,,13487.0,,85.7,1819287.0,,49.0,6494261.0,37.38,4785.0,35.23,,,4435.0,1765909.0,,,,6081564.0,,,,,,21559.92,,,,139533543.0,,,145.0,2192.0,23637.0,8701.0,2678.0,,18300.0,,129029432.0,,,,1159736.0,22321.0,,104584.0,31408.0,1291890.0,,,955142.0,,8224.0,,,-48476.0,,,8981308.0,,18482236.0,,,,,221643.0,748373.0,1059.0,,,3556536.4,,1013475.0,,,,749438.0,49072980.0,112725.0,,32.0,,,,,,,2984551.0,110292.0,,9563138.0,,,1329216.0,,4548.0,31944.0,,892401.0,13493008.0,,,205753.0,,2519723.0,1470537.0,,,88734.0,,,,,11456.0,15330.0,,1.0,,-3871.0,,,39730033.0,,8061512.0,-805462.0,50315.7,4170556.0,966.0,7875.0,,,,4482742.0,,4727042.0,449.0,,,,,,,,2519723.0,,,,,,18326460.0,380760.0,,11624867.0,,,,,ACUTE REHAB,4435.0,,10186494.0,2457702.0,46322.0,,31408.0,,10754.55,,,,,,,47820.0,-11142081.0,,43.82,,129166.0,,,2380463.0,,5487730.0,,825076.0,-40495.0,1644.0,,83155.0,,,,,,,,,1105581.0,,8.0,,,,,,,10545823.0,,491808386.0,,1002738.0,13477616.0,35519.0,108225.0,17010.0,24724204.0,18229.0,,,,,46207089.0,,,3831056.0,,,5674593.0,,4735.0,,,-892745.0,7245140.0,12500.0,,,,,166001841.0,87.0,,,,116765.5,9234320.0,,,,361530,,,O,,140222.0,49155374.0,,,,,,,,,3864930.0,,,,1174868.0,,4.0,,129124.0,16492104.0,,,2283173.0,,5785922.0,345671.0,37562750.0,-192661.0,981.0,,,,,,,14600657.0,,4482742.0,,,,,,,,,37562750.0,,,,,,,305209.0,39279932.0,1001679.0,13487.0,0.5,,,,,287.0,,-6169206.0,,,4743831.0,,,21021.0,,,3266835.0,,,,188.0,,8254767.0,,,,888311.0,-2642.0,125451.0,,,,13841917.0,,,,,,153.0,177.0,,54776615.0,,32415316.0,,,,306503.0,12045.0,360155,97.0,,1984.0,,,146277.0,,118.0,24602229.0,,,,,,1402718.0,,41287647.0,30885062.0,,,N,5362400.0,,,,,11322459.0,5952344.0,1225327.0,,,,,,,,,5557132.0,,148.0,3573268.95,160277147.0,,SOUTHWEST GENERAL HEALTH CENTER,,225350.0,,,3343607.0,,63430.0,,2068219.0,,238067.0,,,,,,9.0,140222.0,,6525404.0,159942181.0,,,49072980.0,-19111.0,10024705.0,,,,2122762.0,,,741726,2224538.0,,3.0,,,,,,,,26871.0,,,,,,12385.0,2860.0,,,,,6272.0,2990243.0,,,300122.0,,,,,,,,,1227156.0,2050663.0,358141420.0,,193435005.0,,,884520832.0,,4267685.0,,,1466143.0,,,59.37,,,20349532.0,,11708298.0,,3739623.0,432264.0,,2021-01-01 00:00:00,,,113344366.0,634.0,40499692.0,,-35937189.0,41287647.0,15141670.0,,,,,1464433.0,,2228616.0,,,N,60889.0,,,484058.86,,1010813.0,,-49009.0,19814782.0,,,,6360.0,3.0,18309013.0,,3511052.0,13233738.0,,,,2699.0,,,,,,314303122.0,,1,,,,,,,420.0,38.71,31408.0,15226.0,,29502002.0,,6637359.0,,,,,,5472521.0,10122.0,32133.0,,,,-63641.0,,,,,15563431.0,31248121.0,,614338132.0,3652212.0,104584.0,,-14457.0,826189.0,,166001841.0,,,,2747476.0,,,,544927.0,2747476.0,,20691530.0,,4308715.0,,,,,-41355.0,,,489630312.0,,,16055648.0,2319508.0,,,352204.0,541.0,MIDDLEBURG HEIGHTS,,7862.0,,,25350.0,287678330.0,,,,,,,2469842.0,,,3831056.0,,,,,15165994.0,46558.0,,106145228.0,,36295.82,29.35,,,1962.0,,1820300.0,,,15899919.0,,108225.0,4450280.0,,,14600657.0,-267192.0,141708.0,,1814897.0,,,,-40932.0,,,453171.0,24793880.0,,5162005.0,,,138058.0,,,30671204.0,,,16828509.0,82624.36,220712783.0,,,,6417423.0,,,,,9242690.0,640758.0,3794468.0,3881.0,,,268361.0,18041234.0,,,,,,,,-75.0,,4450280.0,,59298.0,,,,,140222.0,1962846.0,,,,1077712.0,2970.0,,,,,,12859504.0,1595729.0,,,,,-2115358.0,,,1470967.0,,,,,,,-768823.0,,,Y,1958.0,93.0,213.0,,,,,,,,,1542754.0,34701.0,,1547993.0,,,,,,950000.0,,1392.0,,,54927747.0,,,,,,,,,-248300.0,824473.0,,,,26498.0,,6690.0,,,,,,645263.0,,3385397.0,6825574.0,,177664257.0,60562683.0,359.0,18889.0,,1013475.0,,,,,,788008.0,4851.0,,,,,,,,,10024705.0,,35329.0,,30.16,,,2322687.0,,,217.0,,2469842.0,,,,,766281.0,,13128996.0,97150.0,67978269.0,-12422.0,22124.0,,5534892.0,1542754.0,,4535512.0,,,,1814074.0,4514918.0,,197393.0,,13355489.0,,,,,,880687267.0,,1814074.0,,44.21,1962.0,1339941.0,,,,152.0,3821580.0,2147943.0,,13128996.0,6081564.0,293017.0,,32.0,,,,24520562.0,,,,177075.68,5794617.0,666511.0,,,,,,3197978.0,473215.0,,,60646.0,,,1827734.0,Y,,7987.0,,35519.0,80.0,,-142944.0,44130-3497,15943.0,602759.0,484058.86,1339928.0,,33.09,,14332.0,,,13841917.0,,,,,170461.0,,,-25358375.0,,108.0,,4272941.0,,,4344918.0,,553478619.0,,,,,,17605600.0,53351153.0,,,,,,,,,,,503730.0,,394078609.0,634.0,48.47,,91.0,400293.0,,Y,,9.0,186570.0,,6577600.0,,15141670.0,,646386.0,5487730.0,,,,,18325564.0,310072.0,,,N,61345.22,,,,1917318.0,,,,,5015749.0,2863543.0,1196787.0,,1959500.0,,,,18100.0,,,,,14685813.0,,-2160.0,,,50936.0,,,,,,,61937.0,391575.0,31248121.0,,99941.0,,,1371195.0,30106.0,,,,4344918.0,1396213.0,4804.0,,1895938.0,,570250.0,,,,24602962.0,,,,,,2519723.0,,,,,,5053.0,,11624867.0,84533.0,5002074.0,15563431.0,3080804.0,,,1739.0,,,,,,,,6636176.0,9349.0,,30996.0,25201215.0,,,21920100.0,662185.0,53327.0,,12385.0,,10228389.0,,,,,,,44.76,,,9544379.0,69307.0,,,326659802.0,,,13764551.0,,,,,94.0,,,,,,91509.0,,,,1285989.0,66.0,,6182153.0,,129124.0,56575.0,,,74887.0,-35937189.0,,,4964404.0,21.0,,135781.7,13870.0,68095.49,,10.0,,,,418044.0,,,,,611420.0,,132632013.0,,,199783.0,,,,,,,,341519844.0,61780533.0,627.0,,18706949.0,,706.0,,1999527.0,,,,,,,,,,14872.0,,,7744898.0,6336699.0,,4576410.0,,,,,6286375.0,6286375.0,,3918.0,2549.07,,,,37068469.0,,,,15186474.0,,65355.0,,,,,3234256.0,7151.0,49072980.0,1339488.0,359062.0,6830234.0,,,1111.0,,70271.0,2056.0,,,,,-1934.0,,,,30671204.0,,,521261.0,,,,,,,,67522897.0,,,,57.38,,,10186494.0,,,,2328452.0,3.0,5422102.0,,,2965440.0,524730.0,647199.0,,376423.0,2675455.0,,1043614339.0,,12652499.0,N,2888857.0,,,19267893.0,1456008.0,,,,2016857.0,,,340772.0,,,,,,,,,,97403248.0,16098005.0,1129.0,,8061512.0,,2062.0,20.52,,,,,126028.0,2797.0,648814.0,7861.0,,,,1694157.0,,139903920.0,,,,,,1242676.0,,672848.0,,1214.0,,,,33204857.0,,,,17603848.0,51261370.0,,,98937976.0,,5162005.0,5265137.0,,,,,34415091.0,7398.0,1647.6,11443.0,,206621.0,,380760.0,3752.0,,845.0,88599.0,,,129124.0,19781.0,,,,,,37076038.0,191256931.0,33204857.0,,,,,,,534099.0,,,3.0,14262.0,,7020735.0,,,,N,,,826189.0,,9208526.0,,4221948.0,155.0,,44137.0,,,,,36592287.0,,10228389.0,,,,253255.0,86998.0,,957903.0,182055.0,,1680,18362146.0,,19559168.0,,51007.0,305237.0,,-270103.0,,10442749.0,,1585506.0,3250.0,,,,1353.0,,,,,,,,,15226.0,,,,521261.0,15226.0,,,12123.0,88174922.0,,-53400.0,9789891.0,,24.67,36S155,33.0,33738.0,9461250.0,38338896.0,,,,799857.0,3379096.0,622529.0,,,,,2532042.0,,3779156.0,,18697 BAGLEY ROAD,,2000586.0,1036654.0,,,247212.0,,311063.0,,,1902661.0,,1174857.0,,,64017.0,,,26.0,295.0,1.0,1484.0,,421337.0,6167.0,328358.0,,,1292.0,1590453.0,,,,,1739.0,-883631.0,,4941177.0,,,32439371.0,2811745.0,,,,1169196.0,,,,7099.0,,4205963.0,,76990.58,,,,,24976.0,17981.0,,,51290.0,,1111.0,76092.0,4042089.0,2198585.0,100.0,,5978.0,5053.0,249168.0,146277.0,91646.0,22278895.0,13493008.0,24055.0,329556031.0,,,,3955.0,,70183.0,,1470967.0,62.06,,1948174.0,,,,16732.55,,,,SWGHC MENTAL HEALTH SERVICES,,17236.0,394385112.0,,,,,10366.0,,17582867.0,,,,3197978.0,,,,99963.0,33494.0,3197978.0,,,,,,,,6179739.0,,84533.0,73688.0,,2021-12-31,,2404471.0,,-1934.0,,,,12323.0,103.0,1595729.0,,,,,98278.0,,7963798.0,-44409.0,,27464381.0,,2224538.0,,1901798.0,,386530.0,,,,,471.0,,43874738.0,1250897.0,,,37248670.0,,,,1634499.0,,,,,,,39.52,,,-330798.0,,,,,686607.0,533614.0,12078194.0,1434061.0,,1010813.0,44120.0,912800.0,,,13895314.0,,,,3977774.0,,,905388.0,,,3666.0,,,17460,,,16749256.0,,,,,,,,,,,,,,,,,47599.0,,,,1661667.0,1407771.0,,,,16747630.0,7773227.0,,,,-9319562.0,,1226457.0,9234320.0,24520562.0,,99941.0,,21.34,,,199588.0,19808144.0,738617.0,1434061.0,3583019.0,,,17724.0,,1470967.0,,1493073.0,,,1587365.0,,,,293785.0,,42108114.0,221643.0,,1542940.0,24860725.0,5.0,4069775.0,,144300675.0,1013475.0,,,,,,887995.0,,1800.99,,,,,,866412.0,1800491.0,106377.0,,2362.0,70512.0,1183308.0,,,,5674593.0,,,,49607.0,40499692.0,,129029432.0,,1387680.0,,,,,,3779156.0,,1368672.0,,,,,,4576410.0,,,,216987.0,10366.0,,632.0,17324890.0,6398642.0,766281.0,247212.0,36294240.0,17605600.0,,,,3634337.0,46.02,,,Y,,3888.0,,,34332552.0,,33204857.0,134.0,1101.0,,,,,691645.0,6637359.0,,,,,,11624867.0,36T155,3.0,4655.0,2093.0,,31.44,,,5679177.0,,104584.0,,,,1437999451.0,,,,,,,,821241.0,2102.0,26934853.0,189.0,,General Short Term,,11240.0,216987.0,3127.0,17495233.0,,,103.0,6338727.0,2263.0,,,,1338015.0,,127224043.0,125638229.0,,,,,3424.0,-5484329.0,,2273671.0,,,-761315.0,-76606.0,,,4071.0,2885620.0,,1487643.0,686607.0,28.0,,-54277859.0,,26.5,,98278.0,56575.0,245694.0,1959500.0,335533.0,4034710.0,,,,,,435863.0,,314968838.0,367253,,551869621.0,5002074.0,,-40932.0,13018935.0,7806184.0,,533806.0,,,Y,4406.0,,1045324.0,4254927.0,912800.0,220712783.0,,,9025156.0,,13478431.0,,-5484329.0,,,418044.0,,,,,36170,1173827.0,,1338015.0,,15610.0,49072980.0,,6483134.0,352204.0,,,125303263.0,2422033.0,,,18026.0,,F,,,,,,,,25785895.0,898587.0,897916.0,1467187.0,1176.0,,,,,,,9208526.0,,,,,1960995.0,29132.0,,,,,,,,,7159849.0,,152.69,,,,,,10881184.0,,13895314.0,103374.0,13355489.0,,,6202.0,,,7324.0,,225.0,,77215.0,1754382.0,16.44,,1820300.0,,29383.0,1214.0,46.0,270057.0,,36989.0,4723.0,,31416.0,27036.0,190960.0,,,3810218.0,,2547011.0,,189.0,,1464433.0,142864.0,,,,-3696864.0,,20983389.0,235568.0,,475698.0,,,63654.0,,-66026.0,,,,2678.0,13334953.0,,47481.64,32444.0,,2316996.0,15566490.0,14366496.0,,,,,8107133.0,634731.0,,,,,1917318.0,,,,319285.0,,8107133.0,,,,2273671.0,,,,29317441.0,30996.0,0.5,,,6202.0,,,,9277057.0,36407193.0,-1287627.0,,,327.0,,,,,,,5291228.0,411687.0,,621067.0,46312.0,,,292129.0,,,,16.0,,,,1077712.0,,33943974.0,3918.0,,,,6013.0,,6092566.0,,,,441.0,,15.0,,,40282.0,,257178.0,2817508.0,8245157.0,,339197157.0,358068506.0,,,,160832.0,338809467.0,,3309216.0,17085.0,521.0,,,2224538.0,OH,8224.0,14332.0,741149.0,,,,,,,,2892769.0,,3084503.0,3967106.0,,44.0,,,,1836037.0,,N,285565.32,,,316256.0,,1694157.0,,,,,4743831.0,1896610.0,6255346.0,,44120.0,1236008.4,14262.0,,292625.0,,,,,42.0,212.0,,,,13690996.0,,0.236507,,,9349.0,-6615.0,,,6359965.0,1339488.0,10673509.0,89336.0,,,,,,,,,,4566854.0,,137479.0,10859004.0,107117844.0,5519.0,,,3285.0,,,,,,,,12412.0,309747887.0,,,1634499.0,,,,,,36,32444.0,11322459.0,7515698.0,N,,,,,5001540.0,1422334.0,,1353.0,,,47613.0,68620.0,,,,,30.16,7744898.0,,1059435.0,,,,,,4548.0,175.0,,,877612.0,,5475.0,,,-403937.0,1073472.0,N,,129431753.0,400368.0,15961.0,291587.0,1617037.0,11619270.0,,1760271.0,38645399.0,,2363197.0,3747764.73,,,1884215.0,,,4433.0,,15915.0,24793922.0,6394286.0,10578921.0,21920100.0,3800459.0,,,,,,,,2881.0,,13.0,,,,,,40980.0,,24521.0,34.62,,,,-244991.0,1125645.0,,,70183.0,,,,,,,1227156.0,,,,,251.0,,-5707027.0,2235055.0,,4040595.26,,,,N,6806548.0,,11240.0,,1016.0,,43549250.0,,,24607033.0,,,109230.0,,8076795.0,,,6636176.0,510439.0,,912.0,2228743.0,,,11668.0,,,,,,,,,,2097.0,35053286.0,93712.0,18.88,,,24055.0,2052875.0,15201,2052875.0,,,,14.98,46.87,,,3634337.0,,2624110.0,,,,,,,P,,,,,9712.0,1149.0,,,,,,,,,2056.0,,,,2025.0,,2021,0.003915310206548156,287678330.0,31368399.498591,13764551.498590998,34332552.0,15312544.498590998,0.06538252640733558,306503.0,0.000777166760798009,1.0110510424082815,1.2434120491865845,0.8649450344610451,0.32405396889930427,287678330.0,1.1355036787094808,0.5317263978658581,0.468273602134142,-0.8092070161137316,287678330.0,0.641967495515971,4.048993438083297,Acute Care Hospitals,non-profit,1,SOUTHWEST GENERAL HEALTH CENTER (360155)
70723,SOUTHWEST GENERAL HEALTH CENTER (360155),General Short Term (Acute Care Hospitals),Voluntary Nonprofit-Other,-81.83291,41.37208,,,,13324.0,,,,,,2767383.0,,,,1682998.0,,-264739.0,,,,,27789.0,26251653.0,CUYAHOGA,,,121029.0,152353.0,13802.0,,,133287.0,,1.0,,,4924028.0,,190.0,1016.0,,,64457.0,1914273.0,18152079.0,,19.7,1907967.0,,,,,976539.0,1334940.0,,,12107843.0,,,,,,,888.0,,,,61312.0,,,,,,,,,1.0,9388772.0,,,5956523.0,149749815.0,,1053.0,9710719.0,,,,31861949.0,,13802.0,,,,,,,,80229.0,59629.32,8753694.0,N,1418506013.0,265212986.0,36.33,,,2023-06-02 00:00:00,2118002.0,,,6023.0,,,,7967076.0,,,,,,743845.0,151908.0,657498.0,,8508886.0,,,,1315996.0,270718.0,,38143852.0,,,,,167.0,3806238.0,141894.0,,,,32.29,,1547385.0,,,15080336.0,1692610.0,,,,,64999.0,,,,,,,487311.0,1671396.0,,,18771.0,,,,,,,82614518.0,,,,,,,152353.0,,,5201.0,,,,,6443662.0,,-64407.0,42453791.0,356596.0,21167.0,,2892.0,3153.0,,,3850190.0,,955957.0,,9236158.0,5758836.0,8653416.0,,,,,,,,,2758691.0,,,-75330.0,,5297496.0,,,,,,,,,53221.0,,4730658.0,,,,,,,,400888.0,,,704988.0,3320.0,3785373.0,,,211.0,,,N,,,,86602.0,,1474.0,,139028.0,,94910.0,,3920984.0,,,32979686.0,,,,34.0,,,,,1.0,11591498.0,,808552.0,,,,,1967139.0,,,865.0,260984.0,,300297.0,,144678.0,,,911681.0,,2438391.0,,,,1199638.0,221272.0,,6443662.0,,,,3650.0,,,,20630.0,,,,6705.0,3867323.0,,,632723.0,,,,,,9242690.0,,2123.0,,,1668725.0,,,1122816.0,27789.0,,,,2685636.0,4400.0,20471.0,,,,,100586.0,,,,,6289.0,,551859.0,75363.0,,,1636474.0,,5473.0,,103.33,2118800.0,,182.0,6914809.0,37.84,3059.0,37.15,,,4815.0,1658143.0,,,,6236606.0,,,,,,23834.7,,,,142828369.0,,,117.0,1869.0,25492.0,5263.0,2043.0,,51125.0,,131460560.0,,,,963629.0,9120.0,,88785.0,33097.0,1388052.0,,,1020820.0,,7047.0,,,-54323.0,,,9318100.0,,18938051.0,,,,,368365.0,924128.0,148.0,,,3485890.04,,1056055.0,,,,976539.0,51292468.0,100372.0,,9.0,,,,,,,3428149.0,121029.0,,7639551.0,,,1376895.0,,4587.0,95384.0,37.0,798092.0,14383927.0,,,169606.0,,2485693.0,1694004.0,,,100989.0,,,,,12143.0,14874.0,,,,-3530.0,,,46097790.0,,8435872.0,-644660.0,50315.7,4997477.0,2777.0,4380.0,,,,4174667.0,,4347827.0,62.0,28620.0,,,,,,,2485693.0,,,,,,21878502.0,361531.0,,11101092.0,,,,,ACUTE REHAB,4815.0,,11150357.0,2526838.0,38338.0,,33097.0,,48468.05,,,,,,,35532.0,-10477841.0,,48.3,,152353.0,,,2539168.0,,5644678.0,,664588.0,-120541.0,,,95344.0,,,,,,,,,848857.0,,4.0,,,,,,,11003257.0,,485493757.0,,1153912.0,15859127.0,25640.0,160315.0,15367.0,26945745.0,19491.0,,,,,46543641.0,,,3609345.0,,,5405931.0,,4307.0,,,-937578.0,7679557.0,37500.0,,,,,175107662.0,27206.0,,,,116765.5,9458731.0,,,,361530,,,Q,,162235.0,50929190.0,,,,,,,,,4160705.0,,,,1191321.0,,3.0,,152353.0,16512267.0,,,2276172.0,,5827412.0,374828.0,9860746.0,-201337.0,,,,,,,,13882971.0,,4174667.0,,,,,,8600.0,,,9860746.0,,,,,,,246947.0,37389494.0,911681.0,5473.0,1.5,,,,,,,7061240.0,,,4681568.0,,,18771.0,,,3321231.0,,,,191.0,,8731917.0,1.0,,,911457.0,-2214.0,149952.0,,,,15021064.0,,,,,,235.0,244.0,,54695547.0,,36914102.0,,,,10191347.0,8760.0,360155,83.0,,,,,141802.0,,,26404698.0,,,,,,1079420.0,,38782415.0,37217547.0,,,N,5631482.0,,,,,11072484.0,4275674.0,1490954.0,,,,,,,,,4019962.0,,,3540048.59,167535304.0,,SOUTHWEST GENERAL HEALTH CENTER,,221257.0,,,2362059.0,,,,2120053.0,,224978.0,,,,,,,163123.0,,6525404.0,168070263.0,,,51292468.0,-10217.0,9718245.0,,,,2819998.0,,,743408,2162890.0,,3.0,,,,,,,,38268.0,,,,,,6053.0,3787.0,,,,,,4060203.0,,,303637.0,,,,,,,,,1094853.0,2510360.0,374841955.0,,193183960.0,,,909861884.0,,4820736.0,,,1484639.0,,,74.84,,,21373643.0,,9862627.0,,4707363.0,399118.0,,2022-01-01 00:00:00,,,125924466.0,973.0,42285768.0,,-21831591.0,38782415.0,15958683.0,,,,,1492539.0,,2248168.0,,,N,138534.0,,,426410.22,,1097062.0,,-66872.0,20646915.0,,,,6360.0,2.0,18405895.0,,3244071.0,14008974.0,,,,5029.0,,,,,,314968837.0,,1,,,,,,,3320.0,37.23,33097.0,5473.0,,31783112.0,,8111731.0,,,,,,5623647.0,,60525.0,,,,-115094.0,,,,,13863040.0,20951287.0,,543076192.0,3830283.0,88785.0,,-15171.0,945632.0,,175107662.0,,,,2811248.0,,,,551859.0,2811248.0,,20646906.0,,719731.0,,,,,-6057.0,,,483315683.0,,,15080336.0,2446972.0,,,277661.0,121.0,MIDDLEBURG HEIGHTS,,5913.0,,,49635.0,273199930.0,,,,,,,2877147.0,,,3609345.0,,,,1253.0,17501820.0,58936.0,,108540546.0,,42365.21,29.63,,,1844.0,,1836745.0,,,8544889.0,,160315.0,4250182.0,,,13882971.0,-243760.0,150443.0,,1407186.0,,,,-45503.0,,,498038.0,26580510.0,,7289490.0,,,130547.0,,,33413333.0,,,18176633.0,82624.36,187261744.0,,,,7618495.0,,,,,9390164.0,680392.0,3794777.0,,,,304124.0,,,,,,,,,-235.0,,4250182.0,,101822.0,,,,,163123.0,2066053.0,,,,958871.0,11793.0,,,,,,27389039.0,1290074.0,,,,,-520973.0,,,1332458.0,,,,,,,-869573.0,,,Y,,108.0,376.0,,,,,,,,,1769771.0,31442.0,,1242543.0,,,,,,5850000.0,,1151.0,,,58458435.0,,,,,,,,,-294845.0,984352.0,,3458.0,,25709.0,,6452.0,,,,,,580033.0,,3446197.0,6198178.0,,173544139.0,55432882.0,93.0,23823.0,,1056055.0,,,,,,665569.0,4300.0,,,,,,,,,9718245.0,,23114.0,,32.56,,,1990149.0,,,57.0,,2877147.0,,,,,766216.0,,12097796.0,99464.0,68873082.0,-29034.0,20785.0,,5546347.0,1769771.0,,4256287.0,,,,2105584.0,5021983.0,,219183.0,1119325.0,12717870.0,,,,,,905417468.0,,2105584.0,,42.99,1844.0,2369287.0,,1795.0,,423.0,3699422.0,2488739.0,,12097796.0,6236606.0,306662.0,,7.0,,,,25819905.0,,,,187817.41,5047682.0,748374.0,,,,,,3076331.0,549766.0,,,74545.0,,,1776215.0,Y,,4760.0,,25640.0,9.0,,-178272.0,44130-3497,13714.0,434972.0,426410.22,1564255.0,,30.58,214.0,13324.0,,,15021064.0,,,,,,,,-9395155.0,,199.0,,3920984.0,,,4292522.0,,515972638.0,,,,,,14149121.0,51275302.0,,,,,,,,,,,389961.0,,396673546.0,973.0,96.41,,95.0,314932.0,,Y,,17.0,188249.0,,6051342.0,,15958683.0,,707199.0,5644678.0,,,,,18619933.0,328695.0,,,N,61345.22,,,,1453152.0,,,,1158.0,2822078.0,2892516.0,1983068.0,,1680488.0,,,,,,,,,15937687.0,,-2040.0,,,153084.0,,,,,,,53910.0,400888.0,20951287.0,,103805.0,,,1508662.0,91203.0,,,,4292522.0,1163966.0,20616.0,,1978309.0,,632723.0,,,,26422838.0,,,,,,2485693.0,,,,,,888.0,,11101092.0,27789.0,5850326.0,13863040.0,3238764.0,,,,,,,,,,,5461894.0,9022.0,,20074.0,22218909.0,,,21326326.0,637173.0,54655.0,,6053.0,,9775663.0,,,15957.0,,,,47.48,,,34544938.0,22316.0,,,269876262.0,,,17319246.0,,,,,80.0,,,,,,50136.0,,,,1341817.0,89.0,,5956523.0,,152353.0,60955.0,,,,-21831591.0,,,5462724.0,,,112714.35,12410.0,68095.49,,10.0,,,,587514.0,,,,,637160.0,,128381854.0,,,210985.0,,,,,,,,360429279.0,47182618.0,658.0,,7917235.0,,728.0,,2098823.0,,,,,,,,,,19156.0,,,9096704.0,7439578.0,,4736322.0,,,,,5161341.0,5161341.0,,3637.0,2831.31,,,,44212034.0,,,,14187662.0,,107784.0,,,,,3806238.0,6023.0,51264800.0,1519345.0,389800.0,8028826.0,1119325.0,,268.0,,27789.0,2331.0,,,,,-1657.0,,,,33413333.0,,,4672975.0,,,,,,,,71121165.0,,,,50.08,,,11150357.0,,,,2457363.0,3.0,5504867.0,,,3417932.0,440296.0,767856.0,,281852.0,2010673.0,,1018969629.0,,,N,3152353.0,,,17459572.0,1242331.0,,,,1692610.0,15880.0,16627.0,328141.0,,,,,,,,,,106497234.0,19772223.0,1247.0,,8435872.0,,2077.0,22.41,,,,,123402.0,2123.0,545371.0,8605.0,,,,1868858.0,,143377455.0,,,,,,1191803.0,,558498.0,,1281.0,,,,32979686.0,,334914.0,,15091523.0,46261381.0,,,101413476.0,,7289490.0,5079505.0,,,,,33218183.0,1163.0,1605.13,5817.0,,325069.0,,361531.0,,,970.0,83033.0,,,152353.0,15800.0,,,,,,44216523.0,191005886.0,32979686.0,,,,,,,744521.0,,,2.0,,,7116036.0,,,,N,,,945632.0,,9852868.0,,4241582.0,167.0,,35806.0,,,,,34964958.0,,9775663.0,,,,214257.0,,,1368599.0,228368.0,,1680,18425202.0,,22366928.0,,54481.0,246989.0,,-388153.0,,10305759.0,,1246588.0,87765.0,,,,214.0,,,,,,,,,5473.0,,,,4672975.0,5473.0,,,1552.0,82040173.0,,-42871.0,9095208.0,,22.35,36S155,24.0,21167.0,9790595.0,-32084376.0,,,,652881.0,2786429.0,700705.0,,,,,2758691.0,,3850190.0,,18697 BAGLEY ROAD,,1614544.0,955957.0,,,224782.0,714.0,297911.0,6686.0,,1729678.0,,1191321.0,,,54219.0,,,10743.0,,3.0,1389.0,,580497.0,7112.0,407386.0,,,405.0,2046156.0,,,,,,-541318.0,,4627873.0,,,36943304.0,2113209.0,,,,1119529.0,,,,4569.0,,4215363.0,,76990.58,,,,,28757.0,15825.0,,,51360.0,,1326.0,99790.0,3527819.0,2404841.0,158.0,,5690.5,,326959.0,141802.0,86086.0,20691530.0,14383927.0,29202.0,259656465.0,,,,4614.0,,69254.0,,1332458.0,59.55,,2160111.0,,,,54158.55,,,,SWGHC MENTAL HEALTH SERVICES,,13995.0,406864893.0,,,,,10829.0,,14824581.0,,,,3076331.0,,,,175755.0,9868.0,3076331.0,,,,,,,,5708126.0,,27789.0,54271.0,,2022-12-31,,2509004.0,,-1657.0,,,,12969.0,34.0,1290074.0,,,,,124110.0,,6372270.0,-42357.0,,25432492.0,,2162890.0,,2232524.0,,305177.0,,,,,470.0,,42593932.0,975850.0,,,36705379.0,,,,1252546.0,,,,,,,36.86,,,-578652.0,,,,,818520.0,485794.0,11761478.0,5596093.0,,1097062.0,46301.0,923118.0,,,13868844.0,,,,6220605.0,,,970781.0,,,,,,17460,,,16612389.0,,,,,,,,,,,,,,,,,-284.0,,,,1730360.0,1079420.0,,,,6678062.0,8327463.0,,,,-10753739.0,,1113951.0,9458731.0,25819905.0,,103805.0,,22.24,,,158792.0,22885136.0,819445.0,5596093.0,3822068.0,,,14908.0,,1332458.0,,1315996.0,,,1163949.0,,,,242195.0,,39827885.0,368365.0,,1241655.0,23109230.0,5.0,4641494.0,,147149719.0,1056055.0,,,,,,979771.0,,1743.34,,,,,,938220.0,1817442.0,135202.0,,2032.0,57928.0,1385752.0,,,,5405931.0,,,,44537.0,42285768.0,,131460560.0,,1532568.0,,,,,,3850190.0,,1082282.0,,,,,,4736322.0,,,,272943.0,10829.0,,,16361821.0,4808491.0,766216.0,224782.0,33911364.0,14149121.0,,,,4209554.0,42.4,,,Y,,3240.0,,,7836846.0,,32979686.0,20.0,215.0,,,,,1681823.0,8111731.0,,,,,430.0,11101092.0,36T155,5.0,4563.0,1729.0,,30.57,,,5253408.0,,88785.0,,,,1425834522.0,,,,,,,,650706.0,2192.0,26818026.0,300.0,,General Short Term,,9577.0,272943.0,,17145067.0,,,192.0,7265250.0,2650.0,,,,1419419.0,,123454296.0,128959525.0,,,,,3153.0,-6370934.0,,2299995.0,,,,-40432.0,,,2476.0,3332316.0,,1603238.0,818520.0,42.0,,-58866844.0,,25.47,,124110.0,60955.0,282270.0,1680488.0,337588.0,5297496.0,,,,,,367394.0,,322886073.0,367253,,513088545.0,5850326.0,,-43503.0,12881711.0,9067116.0,,422959.0,,,Y,5201.0,,1326542.0,4808981.0,923118.0,187261744.0,,,9365902.0,,15860422.0,,-6370934.0,,,587514.0,,,,,36170,1240501.0,,1419419.0,,20879.0,51292468.0,187.0,6660623.0,277661.0,,,129494484.0,1914273.0,,,60082.0,,F,,,,,,,,-49282068.0,915448.0,1119946.0,1335338.0,147.0,,,,,,,9852868.0,,,,,2269243.0,45751.0,,,,,,,,,8549555.0,,162.22,,,,,,9737441.0,,13868844.0,236521.0,12717870.0,,,4486.0,,,10656.0,,75.0,,67391.0,1097610.0,13.96,,1836745.0,,32679.0,1281.0,5.0,,,114383.0,6462.0,,29414.0,27036.0,157427.0,,,3101867.0,,2752013.0,,300.0,,1492539.0,150768.0,,,,-4145551.0,,21961154.0,276884.0,,464315.0,,,79170.0,,-52987.0,,,,2043.0,14187400.0,,47481.64,95384.0,,2446972.0,14712662.0,11635424.0,,,,,6561803.0,612036.0,,,,,1453152.0,,,,353028.0,,6561803.0,,,,2299995.0,,,,22949682.0,20074.0,1.5,,,4486.0,,,,10163451.0,33856894.0,-1592576.0,,,409.0,,,,,,,4992283.0,484646.0,,704988.0,48170.0,,,279954.0,,,,29.0,,,6.0,958871.0,,31829205.0,3637.0,,,,6228.0,,4438797.0,,,,1710.0,,15.0,,,31647.0,,276429.0,2424652.0,8717823.0,,358439130.0,374627311.0,,,,209448.0,358110431.0,,3545884.0,10038.0,2011.0,,,2162890.0,OH,7047.0,13324.0,740752.0,,,,,,,5027.0,2460854.0,,2557442.0,3959395.0,,50.0,,,,1807792.0,,N,285565.32,,,274584.0,,1868858.0,,,,,4681568.0,1967139.0,6525403.0,,46301.0,1230034.41,,,332692.0,,,,,-322.0,674.0,,,,13457249.0,,0.252456,,,9022.0,-2779.0,,,6869057.0,1519345.0,11439991.0,85290.0,,,,,,,,,,3925079.0,,115336.0,8575363.0,109875588.0,1937.0,,,,,,,,,,,20583.0,236771329.0,,,1252546.0,,,,,,36,95384.0,11072484.0,6700860.0,N,,,,,4313897.0,1463920.0,,214.0,,,45980.0,69715.0,,,23.0,,32.56,9096704.0,,1082376.0,,,,,,4587.0,1156.0,,,860864.0,,5475.0,,79.0,-657928.0,1099390.0,N,,132105030.0,542160.0,45999.0,310109.0,1553328.0,11097241.0,,1714968.0,-21893029.0,,2623222.0,3635891.89,,,2027777.0,,,,,14271.0,26580265.0,6202772.0,11270531.0,21326326.0,3357166.0,,,,,,,,,,20.0,,,,,,147474.0,,15066.0,36.65,,,,-692273.0,1178917.0,,,69254.0,,,,,,-10156.0,1094853.0,,,,,250.0,,-6665560.0,2175631.0,,3912300.26,,,,N,6583850.0,,9577.0,,3120.0,,46417565.0,,,26425314.0,,,142603.0,,8508886.0,,,5461894.0,584199.0,,23009.0,2334415.0,,,9080.0,,,,,,,,,,2097.0,28385162.0,97325.0,21.61,,,29202.0,2148216.0,15201,2148216.0,,,,15.78,48.16,,,4209554.0,,2549729.0,,,,,,,P,,,,,9486.0,,,,,,,,,,2331.0,,,,1580.0,,2022,0.0031301684030121835,273199930.0,32410769.333424002,17319246.333424002,7836846.0,18561789.333424002,-0.12112637105802097,10191347.0,0.025048479668163457,1.3299791690366092,1.383946584303742,1.1717366431890337,0.09486039729724018,273199930.0,0.9878343014216732,0.49693996160303044,0.5030600383969696,0.7945139129926624,273199930.0,0.7491856557026164,3.820426857283448,Acute Care Hospitals,non-profit,1,SOUTHWEST GENERAL HEALTH CENTER (360155)
78591,SOUTHWEST GENERAL HEALTH CENTER (360155),General Short Term (Acute Care Hospitals),Voluntary Nonprofit-Other,-81.83291,41.37208,,,,13179.0,,,,,,2983350.0,,,,1629782.0,,-208994.0,,,,,18695.0,23985869.0,CUYAHOGA,,,87362.0,122788.0,15473.0,,,186419.0,,1.0,,,4917366.0,,115.0,774.0,,,,742131.0,17927598.0,,19.93,1875747.0,,,,,1639066.0,1551606.0,,,10718703.0,,,,,,,,,,,36459.0,,,,,,,,,,9756964.0,,,6239347.0,158711591.0,,1447.0,9106426.0,,,,29522429.0,,15473.0,,,,,,,,59917.0,56077.82,9275004.0,N,1614211672.0,276249342.0,37.81,,,2024-06-18 00:00:00,2275922.0,,,6332.0,,,,8947177.0,,,,,,855660.0,604293.0,692803.0,,6597997.0,,,,1726573.0,250594.0,,41850857.0,,,,,175.0,3071581.0,144409.0,,,46.0,34.52,,1720231.0,,,18631804.0,1894686.0,,,,,636.0,,,,,,,543424.0,1823845.0,,,17701.0,,,,,,,78639257.0,,,,,,,122788.0,,,7387.0,,,,,6724622.0,,-73615.0,39526831.0,305045.0,32260.0,,179.0,3342.0,,,4060410.0,,931694.0,,9403177.0,7549147.0,8404056.0,,,,,,,,,2930228.0,,,-124094.0,,5000591.0,,,,,,,6021.0,116.0,35028.0,,4919198.0,,,,,,,,394798.0,,,475989.0,2127.0,3234152.0,,,204.0,,,Y,,,9.0,69682.0,,1101.0,,203421.0,,115722.0,930.0,3651372.0,,,34558312.0,,,,20.0,,,,,1.0,6261449.0,,802954.0,,,,,2055830.0,,,854.0,126493.0,,299191.0,,139890.0,,,862456.0,,2609545.0,,,,1293708.0,172475.0,,6724622.0,,,,3650.0,,,,11251.0,,,,14254.0,3120648.0,,,3850154.0,,,,,,9390164.0,,1547.0,,,2259312.0,,,485657.0,18695.0,,,,1990437.0,6856.0,636.0,,,,,500003.0,,,,,3316.0,,575931.0,72949.0,,,1798172.0,,3273.0,,109.19,1546037.0,,179.0,7450106.0,37.7,1082.0,38.36,,,15809.0,1640510.0,,,,7834412.0,,,,,,20650.33,,,,146596626.0,,,199.0,2263.0,42219.0,8414.0,2007.0,,74415.0,,134530915.0,,,,628457.0,952736.0,,99965.0,20162.0,1506546.0,,,1012382.0,,4519.0,,,-76808.0,,,7696005.0,,20914209.0,,,,,455887.0,1666077.0,22.0,,,3502356.11,,1140922.0,,,,1639066.0,55210701.0,99176.0,,13.0,,,,,,,3413542.0,87362.0,,8540169.0,,,1700489.0,,,223484.0,,790639.0,12802957.0,,,177743.0,,2620889.0,1514306.0,,,97030.0,,,,,9422.0,15545.0,,,,-3426.0,,,57256267.0,,8707423.0,-57769.0,56390.13,6560310.0,1563.0,3568.0,,,,4156154.0,,5386511.0,31.0,7320.0,,,,,,,2620889.0,,,,,,23589314.0,394869.0,,6338467.0,,,,,ACUTE REHAB,15809.0,,9993337.0,2661807.0,82033.0,,20162.0,,66979.82,,,,,,,35438.0,-10927671.0,,57.47,,122788.0,,,2485069.0,,5992963.0,,341517.0,-151334.0,236.0,,85078.0,,,,,,,,,1044761.0,,1.0,,,,,,,12458917.0,,496584298.0,,1190682.0,16300058.0,20832.0,122728.0,15186.0,28501362.0,12777.0,,,,,47536730.0,,,4341783.0,,,5889896.0,,2875.0,,,-1074533.0,7092418.0,87500.0,,,,,182532787.0,48.0,,,,121914.63,11746972.0,,,,361530,,,T,,,63984978.0,,,,,,,,,3849897.0,,,,1455273.0,,5.0,,122788.0,17621867.0,,,2365064.0,,5785925.0,373728.0,2785295.0,-297681.0,413.0,,,,,,,12776054.0,,4156154.0,,,,,,14769.0,,,3477492.0,,,,,,,116814.0,36905368.0,862456.0,3273.0,3.51,,,,,,,-1315570.0,,,5351114.0,,,17701.0,,,3763280.0,,,,199.0,,9689775.0,1.0,,,710093.0,-2444.0,162820.0,,,,16280055.0,,,,,,171.0,267.0,,57463148.0,,34088732.0,,,,2727850.0,8760.0,360155,98.0,,,,,133586.0,,18.0,24310855.0,,,,,,,,36929041.0,41076461.0,,,N,5343747.0,,,,,12247369.0,,2026470.0,,,,,,,,,4298404.0,,62.0,3575778.43,176766680.0,,SOUTHWEST GENERAL HEALTH CENTER,,226753.0,1816.0,,2755000.0,,-18610.0,,2013518.0,,253481.0,,,7130.0,,,10.0,,,6525404.0,176940864.0,,,55210701.0,-13981.0,9755623.0,,,,2628117.0,,,775738,2433099.0,,3.0,,,,,,,,36712.0,,,,,,11110.0,11061.0,,,,,,4816806.0,,,416285.0,,,,,,,,,1389594.0,2934728.0,379610191.0,,206981014.0,,,1019654447.0,,4877058.0,,,1377693.0,,,77.94,,,22474401.0,,9710719.0,,4764725.0,432959.0,,2023-01-01 00:00:00,,,139657283.0,1005.0,45152477.0,,-31170066.0,36929041.0,16310393.0,,,,,1794370.0,,2811555.0,,,N,225399.0,,,372965.0,,1360174.0,,-37328.0,21692830.0,,,,5819.5,2.0,18023980.0,,3479093.0,15927922.0,,,,5970.0,,,,,,322886072.0,,1,,,,,,,2127.0,40.26,20162.0,3273.0,,29382326.0,,8076571.0,,,,,,5973493.0,16056.0,45737.0,,,,-74938.0,,,,,16076997.0,11161981.0,,535759043.0,4034684.0,99965.0,,-62571.0,937665.0,,182532787.0,,,,3426185.0,,,,575931.0,3426185.0,,20646021.0,,7068600.0,,,,,2274.0,,,494406224.0,,,18631804.0,2361807.0,,,335287.0,64.0,MIDDLEBURG HEIGHTS,,7927.0,,,110155.0,276333452.0,,,,,,,2980837.0,,,4341783.0,,,,1403.0,18275778.0,36035.0,,118384977.0,,38240.11,33.72,,,908.0,,2056843.0,,,2691902.0,,122728.0,4253313.0,,,12776054.0,-183433.0,106033.0,,1078322.0,,,,-48381.0,,,609056.0,24477697.0,,8082421.0,,,136306.0,,,35742290.0,,,17952152.0,80407.52,180786334.0,,,,8177249.0,,,,,9640175.0,768257.0,4137119.0,,,,329246.0,171589.0,,,,,,,,-225.0,,4253313.0,,91757.0,,,,,,2094556.0,,,,896837.0,4785.0,,,,,,31200921.0,1515588.0,,,,,-556514.0,,,1474674.0,,,,,,,-939741.0,,,Y,,151.0,,,,,,,,,,1906140.0,31813.0,,,,-30702.0,,,,54755.0,,1069.0,,,52907854.0,,,,,,,8.0,,-411236.0,1471864.0,,3762.0,,23863.0,,7491.0,,,,,,448592.0,,3839627.0,7751120.0,,160074398.0,58860217.0,368.0,354149.0,,1140922.0,,30.0,,,,741307.0,3565.0,,,,,,,,,9755623.0,,23357.0,,34.26,,,2395001.0,,,,,2980837.0,,,,,913604.0,,10707702.0,90831.0,85807539.0,-8043.0,22068.0,,5538389.0,1906140.0,,4035323.0,,,,2199154.0,5874316.0,,278700.0,,13108967.0,,,,,,1013672627.0,,2199154.0,,43.15,,3036050.0,,,,346.0,3894193.0,3416943.0,,10707702.0,7834412.0,391978.0,,13.0,,,,26569683.0,,,,210790.21,,924129.0,,,,,,3237572.0,566719.0,,,74432.0,,,2154112.0,Y,,7773.0,,20832.0,,,-196350.0,44130-3497,13960.0,321767.0,372965.0,1176081.0,,29.98,,13179.0,,,16280055.0,,,,,7958.0,,,-16778632.0,,1107.0,,3651372.0,,,4069114.0,,604486285.0,,,,,,14694849.0,64653240.0,,,,,,,,,,,485056.0,,410780257.0,1005.0,103.77,,76.0,225209.0,,Y,,116.0,241688.0,,7263348.0,-15486.0,16310393.0,137004.0,693548.0,5992963.0,,,,,18692686.0,353642.0,,,N,60472.5,,,,2503103.0,,,,,2149306.0,3892981.0,397350.0,,1976629.0,,,,865.0,,,,,14565945.0,,-2349.0,,,344275.0,,,,,,,39948.0,394798.0,11161981.0,,129290.0,,,1649346.0,187533.0,,,,4069114.0,449441.0,56759.0,,1966785.0,,3850154.0,,,,24357767.0,,,,,,2620889.0,,-60602.0,,,,,,6338467.0,18695.0,5801744.0,16076997.0,3716388.0,,,,,,,,,,,4784461.0,63871.0,,34641.0,24839902.0,,,21412150.0,585557.0,58910.0,,11110.0,,11964071.0,,,3820.0,,,,49.48,,,9130360.0,15422.0,,,259425591.0,,,,,,,,94.0,,,,,,43036.0,,,,1271174.0,,,6239347.0,,122788.0,63875.0,,,,-31170066.0,,,5214847.0,,,111713.49,7300.0,63774.75,,10.0,,,,815712.0,,,,,797890.0,,,,,146646.0,,,,,,,,364977765.0,52231633.0,757.0,,3899749.0,,723.0,,2733301.0,,,,,,,,,,17850.0,,,9124457.0,7627537.0,,5033802.0,,,,,4377557.0,4377557.0,,3735.0,2279.03,,,,45816819.0,,,,13947731.0,,53073.0,,,,,3071581.0,6332.0,55174584.0,1556411.0,115968.0,10159060.0,,,1084.0,,18695.0,2673.0,,,,,-1923.0,,,,35742290.0,,,6950190.0,,,,,,,,80723957.0,,,,58.62,,,9993337.0,,,-45116.0,2029584.0,4.0,5228850.0,,,3399561.0,221964.0,761214.0,-1000.0,271517.0,2712693.0,,1210632625.0,,,N,3435511.0,,,10878876.0,767976.0,,,,1894686.0,3775.0,33867.0,323571.0,,,,,,,,,,120385968.0,21837410.0,693.0,,8707423.0,,1872.0,21.85,,,,,158340.0,1547.0,685798.0,11634.0,,,,1833330.0,,147141764.0,,,,,,1317415.0,,550155.0,,968.0,,,,34558312.0,,489554.0,,,54937102.0,,,124857854.0,,8082421.0,3138136.0,,,,,26890292.0,8854.0,1591.14,,,99310.0,,394869.0,5355.0,,200.0,84060.0,,,122788.0,10489.0,,,,,,45824388.0,205495137.0,34558312.0,,,,,,,702108.0,,,4.0,,,7288167.0,,,,N,,,937665.0,,11131571.0,,4726739.0,175.0,,30271.0,,,,,41294250.0,,11964071.0,,,,240495.0,,,1171198.0,242967.0,,1680,18035469.0,,,,51984.0,116845.0,,-111889.0,,10571335.0,,1292130.0,63925.0,,,,139.0,,,,,,,,,3273.0,,,,6950190.0,3273.0,,,206.0,104167587.0,,,8046642.0,,26.3,36S155,24.0,32260.0,10668960.0,32730477.0,,,,267143.0,2572568.0,692851.0,,,,,2930228.0,,4060410.0,,18697 BAGLEY ROAD,,1496306.0,931694.0,,,156592.0,,301614.0,8626.0,,1612700.0,,1455269.0,,,30679.0,,,16.0,,,372.0,,585742.0,,397705.0,,,,2197512.0,,,,,,-717550.0,,6797250.0,,,34118680.0,2021092.0,,,,1169155.0,,,,6595.0,,4536893.0,,75933.73,,,,,39207.0,11827.0,,,63279.0,,1731.0,76991.0,4122701.0,2614151.0,154.0,,6442.5,,603209.0,133586.0,83670.0,20646906.0,12802957.0,29948.0,274189490.0,,,,6182.0,24.0,69862.0,,1474674.0,66.89,,2283740.0,,,,73422.32,,,,SWGHC MENTAL HEALTH SERVICES,,9648.0,413508107.0,,,,,14089.0,,,,,,3237572.0,,,,742814.0,17618.0,3237572.0,,,,,,,,6860518.0,,18695.0,32277.0,,2023-12-31,,1949459.0,,-1923.0,,,,10800.0,,1515588.0,,,,,132515.0,,7133322.0,-61146.0,,27440073.0,,2433099.0,,1678511.0,,362392.0,,,,,118.0,,25671211.0,1041536.0,,,45977355.0,,,,1319463.0,,,,,,,45.92,,,-595911.0,,,,,875237.0,472527.0,14750965.0,8016842.0,,1360174.0,49905.0,1066652.0,,,12405100.0,,,,8320640.0,,,1001565.0,,,2051.0,,,17460,,,16602789.0,,,,,,,,,,,,,,,,,-34.0,,,,1713115.0,,,,,11664177.0,7904664.0,,,,-12196741.0,,403763.0,11746972.0,26569683.0,,129290.0,,24.3,,,117679.0,16082813.0,743744.0,8016842.0,4681663.0,,,4757.0,,1474674.0,,1726573.0,,,885.0,,,,184713.0,,39514913.0,455887.0,,,24016858.0,5.0,2336697.0,,150704469.0,1140922.0,,,,,,1164389.0,,1715.93,,,,,,1438212.0,2039164.0,143840.0,,1055.0,18739.0,1950182.0,,,,5889896.0,,,,32693.0,45152477.0,,134530915.0,,1531944.0,,,,,,4060410.0,,1137945.0,,,,,,5033802.0,,,,164032.0,14089.0,,,19244171.0,5331761.0,913604.0,156592.0,33129089.0,14694849.0,,,,4606091.0,37.51,,,Y,,4536.0,,,14076141.0,,34558312.0,,1222.0,,,,,1986546.0,8076571.0,,,,,,6338467.0,36T155,1.0,5231.0,908.0,,31.05,,,5838195.0,,99965.0,,,,1624140732.0,,,,,,,,,1127.0,28193202.0,225.0,,General Short Term,,5347.0,164032.0,2008.0,18761855.0,,,180.0,6719657.0,967.0,,,,1381389.0,,126500905.0,134191526.0,,,,,3342.0,-6421354.0,,2320508.0,,,,-33964.0,,,9847.0,3359418.0,,1777025.0,875237.0,31.0,,-62271423.0,,25.72,,132515.0,63875.0,195317.0,1976629.0,384973.0,5000591.0,,,,,,638134.0,,326598746.0,367253,,600539045.0,5801744.0,,-41641.0,12959292.0,9666851.0,,,,,Y,7387.0,,1043877.0,4887510.0,1066652.0,180786334.0,,,7739430.0,-60602.0,16301353.0,,-6421354.0,,,815712.0,,,,,36170,1392956.0,,1381389.0,,29654.0,55210701.0,,6812988.0,335287.0,,,134365710.0,742131.0,,,26738.0,,F,,,,,,,,4257406.0,705014.0,1241276.0,1031018.0,24.0,,,,,,,11131571.0,,,,,1652070.0,33012.0,,,,,,,,,8587110.0,,165.56,,,,,,12793910.0,,12405100.0,345937.0,13108967.0,,,3814.0,,,5883.0,,115.0,,67051.0,1173517.0,17.18,,2056843.0,,,968.0,,,,281379.0,6156.0,,18671.0,43266.0,120063.0,,,3439840.0,,3239820.0,,225.0,,1794370.0,74148.0,,,,-5354188.0,,24572940.0,55544.0,,389712.0,,,78585.0,,-56971.0,,,,2007.0,15279169.0,,46955.96,223484.0,,2361807.0,15835564.0,22355531.0,,,,,6524268.0,635546.0,,,,,2503103.0,,,,381128.0,,6524268.0,,,,2320508.0,,,,23159000.0,34641.0,3.51,,,3814.0,,,,12282551.0,34937080.0,-1561477.0,,,403.0,,,,,,,5318832.0,541352.0,,475989.0,52168.0,,,247229.0,,,,17.0,,,,896837.0,,30960264.0,3735.0,,,,1499.0,,,,,,,,15.0,,,16131.0,,178064.0,1863944.0,8477671.0,,362582764.0,379178230.0,,,,261589.0,362216930.0,116.0,3901245.0,7228.0,,,,2433099.0,OH,4519.0,13179.0,740481.0,,,,,,,6272.0,1833845.0,,2375949.0,5096073.0,,57.0,,,,2125476.0,,N,285748.67,,,132131.0,,1833330.0,,,,,5351114.0,2055830.0,6525403.0,,49905.0,1261050.3,,,341053.0,,,,,88.0,313.0,,,,14313143.0,,,,,63871.0,-639.0,,,7727459.0,1556411.0,11208640.0,85656.0,,,,,,,,,,3999841.0,,1912.0,9040577.0,101495155.0,3153.0,,,3650.0,,,,,,,,16629.0,258106677.0,,,1319463.0,,,,,,36,223484.0,12247369.0,6367388.0,N,,,,,4155032.0,1569008.0,,139.0,,,28387.0,72635.0,,,4.0,,34.26,9124457.0,,989285.0,,,,,,3565.0,537.0,,,,,5475.0,,,-1104884.0,1699840.0,N,,135299537.0,832546.0,71666.0,272899.0,1861331.0,6334418.0,,1655073.0,35458327.0,,1425789.0,3578385.21,,,1408418.0,,,1318.0,,24747.0,24477830.0,6550008.0,12330071.0,21412150.0,2829723.0,,,,,,,,,,18.0,,,,,,257969.0,,26299.0,37.97,,,,-182551.0,1177599.0,,,69862.0,,,,,,-26807.0,1389594.0,,,,,244.0,,-6798222.0,2280409.0,,3875321.11,,,,N,7150835.0,,5347.0,,7196.5,,42782871.0,,,24367614.0,,,370470.0,,6597997.0,,,4784461.0,862301.0,,15527.0,2521944.0,,,11862.0,,,,,,,,,,1266.25,30612515.0,93924.0,19.93,,,29948.0,3025849.0,15201,2978123.0,,,,15.92,49.0,,,4606091.0,,3116311.0,,,,,,,P,,,,,3937.0,363.0,,,,,,,,,2673.0,,,,1881.0,,2023,,276333452.0,,,14076141.0,,0.01029582232592117,2727850.0,0.006596847688889447,1.2906423441920363,1.709859860451123,1.11896333150757,0.1789963631014469,276333452.0,0.9388135570354327,0.48422064804979875,0.5157793519502012,-0.6927362272990106,276333452.0,0.7718173167634241,3.4348530303797533,Acute Care Hospitals,non-profit,1,SOUTHWEST GENERAL HEALTH CENTER (360155)
