,Curated Name and Num,Hospital type (modified),S2_1_C1_21,Lon,Lat,E_B_HOS_C101_3,D3_SNF_C3_51,S3_2_C6_10,B_1_C0_193,A_C2_95,B_1_C22_100,A_C2_59,D3_HOS_C3_94,B_1_C22_190,D3_IPF_C2_50,A_C6_14,S3_1_C7_10,D3_SNF_C3_55,D_4_IPF_C13_74,C_1_C5_9920,B_1_C22_89,S3_1_C2_7,D_4_HOS_C13_52,E_B_HOS_C1_8,S2_1_C1_37,D_4_HOS_C10_55,D3_IPF_C3_9201,D_4_HOS_C3_70,D_5_HOS_C3_57,D_3_HOS_C9_44,S2_1_C2_1607,B_2_C26_59,A7_1_C7_5,D_4_HOS_C12_94,E_B_HOS_C1_13,S3_1_C2_1,A7_1_C5_10,D_5_HOS_C5_57,D3_HOS_C2_50,D3_IRF_C2_63,A_C6_19,B_1_C22_101,D3_SNF_C3_62,D_1_HOS_C4_40,D_4_HOS_C12_59,A_C2_108,S3_2_C5_4,S3_1_C7_22,D3_SNF_C2_53,B_1_C26_67,D_5_HOS_C2_70,G_C1THRU4_8,S3_2_C4_25,D_4_HOS_C12_56,D3_IPF_C3_51,D_4_HOS_C2_98,D_4_HOS_C2_74,C_1_C5_63,D_4_HOS_C3_76,D_4_HOS_C11_71,A7_1_C7_2,D_5_HOS_C5_50,B_1_C22_45,A7_3_C5_1,D_4_HOS_C11_66,D_5_HOS_C4_96,B_2_C26_44,D_5_HOS_C5_69,S3_2_C6_1401,C_1_C6_4201,B_1_C21_65,D3_SNF_C2_202,B_1_C21_95,D3_IRF_C2_75,D_5_HOS_C4_58,B_1_C0_192,S10_C1_13,B_1_C22_71,A_C6_11,D_1_HOS_C7_31,E_B_HOS_C1_44,S4_HHA3_C1_36,D_4_IPF_C13_70,D_4_HOS_C4_52,A_C1_11,D_5_HOS_C5_60,A_C6_88,D_4_IRF_C13_64,A_C1_15,E_B_HOS_C1_14,D3_SNF_C3_60,D_4_HOS_C13_71,B_2_C26_9940,S4_HHA1_C5_37,S3_1_C5_10,D3_SNF_C3_94,D_4_HOS_C3_68,D_4_SNF_C11_60,D_1_HOS_C7_32,D_4_IPF_C13_71,D3_HOS_C3_56,C_1_C6_45,S3_1_C2_19,S3_2_C2_24,D_1_HOS_C4_32,S3_2_C4_21,A7_3_C6_3,D3_IPF_C3_63,A7_3_C15_3,D3_IRF_C3_96,S2_1_C2_1522,S3_2_C2_30,D_1_HOS_C4_33,B_1_C0_54,S2_1_C2_1601,S3_1_C8_7,D_4_HOS_C10_70,S4_HHA2_C1_38,D_5_HOS_C4_76,S3_2_C5_40,E_B_HOS_C1_41,D3_SNF_C2_74,D_5_HOS_C5_62,S3_1_C6_29,S3_1_C8_11,D_4_HOS_C2_72,S3_2_C4_42,B_1_C22_30,D_4_HOS_C12_50,S2_1_C2_130,A7_3_C7_1,B_1_C0_9940,D_5_HOS_C7_66,A_C2_115,S3_2_C4_16,S4_HHA2_C1_36,D1_IRF_C1_52,D_5_HOS_C2_65,B_1_C0_107,D_4_HOS_C2_62,S3_1_C2_2001,D_4_SNF_C11_62,D3_SNF_C3_64,E_B_HOS_C1_9,D_4_IPF_C11_67,D_4_SNF_C11_54,B_1_C26_32,S5_C5_1,D_4_HOS_C4_90,A_C6_34,A_C2_110,D3_HOS_C2_90,D_5_HOS_C5_74,S4_HHA2_C5_35,B_1_C26_93,D3_SNF_C3_68,D_5_HOS_C5_63,S2_1_C2_1517,D_4_IRF_C11_55,B_1_C22_110,A7_1_C1_10,S3_1_C4_9,D3_HOS_C2_72,D3_IRF_C2_200,D_1_HOS_C4_30,S4_HHA3_C5_34,B_2_C26_202,B_1_C0_101,A7_1_C3_10,D_4_SNF_C11_52,S3_2_C5_28,A_C1_59,E_A_HOS_C1_7093,S3_1_C8_8,B_1_C22_107,S2_1_C1_47,D3_IPF_C2_60,A_C6_115,D_4_HOS_C4_55,A_C6_117,B_1_C0_9,B_1_C21_193,A_C2_7,E_B_HOS_C1_23,S10_C1_2701,D_4_HOS_C10_54,B_2_C26_58,S3_1_C3_12,B_2_C26_45,A8_C2_2,A_C6_114,C_1_C6_9930,A_C1_10,B_1_C22_59,S2_1_C2_140,B_2_C26_52,D_5_HOS_C2_62,D_3_HOS_C9_33,D3_HOS_C3_63,S2_1_C2_126,A7_1_C1_3,D3_IPF_C3_96,S2_1_C1_143,B_1_C0_7,S3_1_C8_21,A_C2_4201,D_4_HOS_C10_58,B_1_C0_110,S3_2_C3_2550,D_5_HOS_C4_59,S3_2_C2_35,D_4_HOS_C2_53,D_4_HOS_C10_60,D_4_SNF_C11_64,C_1_C5_108,B_1_C22_69,B_1_C0_8,D_4_HOS_C11_98,B_2_C26_69,D_4_IRF_C13_72,D_5_HOS_C3_51,S3_1_C15_1,D3_HOS_C3_55,C_1_C5_33,B_1_C26_73,B_1_C0_15,A7_1_C1_6,A_C1_4501,B_1_C26_60,S3_1_C3_16,C_1_C5_109,B_1_C21_35,D_4_HOS_C12_72,S3_2_C4_3,D_4_HOS_C10_6250,A_C6_97,S5_C3_1,D_1_HOS_C7_33,D_4_HOS_C10_97,S5_C2_5,D3_IPF_C2_98,D3_IPF_C2_69,S4_HHA2_C4_34,D_4_HOS_C12_9201,S3_1_C3_14,S5_C3_6,S3_2_C5_32,S4_HHA1_C4_35,D3_SNF_C3_70,B_2_C26_71,A_C6_55,S3_1_C6_11,A_C6_95,B_1_C0_200,D1_IPF_C1_52,S3_1_C3_2001,D_4_HOS_C11_68,D_4_HOS_C2_66,A_C1_115,C_1_C5_58,D_4_HOS_C2_75,E_B_HOS_C1_32,S3_2_C5_1,S3_1_C6_14,D_4_HOS_C13_75,D_4_IRF_C2_200,D_5_HOS_C5_93,D_5_HOS_C3_76,D_4_IRF_C11_69,B_1_C21_33,S3_2_C3_2553,B_2_C26_101,S3_1_C6_24,D_4_HOS_C3_88,B_1_C0_6,D3_HOS_C2_41,A_C1_107,D3_IRF_C2_52,D_3_HOS_C8_200,G_C1THRU4_37,S3_1_C6_22,G_C1THRU4_15,C_1_C6_9910,A_C1_5,D_4_HOS_C12_63,D_4_HOS_C11_90,A7_1_C2_8,D_5_HOS_C5_65,G_C1THRU4_47,S3_1_C10_25,A_C1_50,B_1_C26_58,A_C6_8,S10_C3_21,C_1_C5_117,S3_2_C4_23,D_5_HOS_C2_98,UTIL_CODE,B_2_C26_30,D_4_HOS_C11_60,C_1_C7_58,D_4_HOS_C10_50,D3_SNF_C2_98,A_C6_89,E_B_HOS_C101_8,C_1_C5_50,S3_2_C2_10,A_C1_101,B_1_C0_55,B_1_C22_65,A_C1_67,S4_HHA1_C4_36,D_5_HOS_C3_75,S3_1_C8_22,B_1_C0_93,B_2_C26_42,S2_1_C2_1806,S3_1_C6_26,D_4_IPF_C13_53,D_4_HOS_C12_65,A_C6_20,B_1_C22_91,S3_1_C2_20,A_C2_6250,S2_1_C2_1801,A_C2_67,D_4_IRF_C11_91,D_4_IPF_C13_68,D3_IPF_C2_71,B_1_C26_46,G3_C1_28,B_2_C26_116,C_1_C5_201,D_4_HOS_C3_55,D_5_HOS_C2_97,S4_HHA2_C4_38,C_1_C6_107,D_4_SNF_C11_69,A_C6_71,B_1_C21_116,D_4_HOS_C11_53,D_4_IRF_C11_65,D3_IPF_C3_90,D_4_HOS_C4_65,S10_C2_23,D_5_HOS_C4_65,S2_1_C1_35,A_C2_64,D_5_HOS_C3_67,S3_1_C4_12,S4_HHA1_C1_36,A_C1_8,A7_1_C5_6,S3_1_C2_24,B_2_C26_9201,A_C6_53,S3_2_C6_27,D_4_HOS_C3_96,S2_1_C2_3801,S3_2_C4_33,C_1_C5_73,A7_1_C5_3,S3_1_C8_6,D_4_HOS_C11_50,D_5_HOS_C4_91,D1_SNF_C1_74,S3_3_C4_3,D_5_HOS_C6_73,C_1_C6_68,S4_HHA3_C1_38,D_4_HOS_C2_200,A_C2_4,A_C2_15,S3_2_C4_34,A_C6_43,C_1_C5_46,B_1_C22_33,S2_1_C1_5,D3_HOS_C2_32,D3_IPF_C3_54,B_1_C0_32,S2_1_C2_129,D3_IRF_C2_57,D_4_IPF_C13_65,B_1_C0_60,D_4_HOS_C13_97,D_5_HOS_C5_200,S3_2_C2_31,D_4_HOS_C12_98,S3_2_C6_12,D_4_HOS_C13_72,B_1_C0_72,D_5_HOS_C7_64,G_C1THRU4_23,G3_C1_29,D3_IRF_C3_98,A_C6_22,S3_2_C5_42,D_4_IPF_C13_60,D_5_HOS_C3_62,D3_HOS_C2_70,D3_SNF_C2_52,C_1_C6_70,D_5_HOS_C6_64,S3_1_C13_18,S2_1_C2_1520,B_1_C0_190,S3_1_C8_20,S4_HHA3_C1_34,S3_1_C14_18,D_4_HOS_C12_66,D_5_HOS_C6_53,D_5_HOS_C7_94,S4_HHA1_C5_38,S3_1_C6_10,D_5_HOS_C6_96,C_1_C6_58,B_1_C0_70,S3_2_C6_14,B_1_C21_69,S4_HHA3_C3_35,S2_1_C1_11801,G3_C1_26,D3_IPF_C2_74,D_5_HOS_C3_55,D3_IPF_C2_58,A_C6_193,D3_HOS_C2_57,S3_2_C3_2552,E_B_HOS_C1_1,B_2_C26_90,A_C2_76,S2_1_C1_24,D_5_HOS_C3_66,D3_IRF_C2_76,D_4_IPF_C4_200,D_4_IPF_C11_56,S4_HHA3_C5_33,D_1_HOS_C6_33,D3_IPF_C2_31,C_1_C6_34,D_4_HOS_C13_73,S3_2_C2_17,B_2_C26_62,D3_HOS_C2_67,S3_1_C10_19,S3_2_C6_8,D3_SNF_C2_40,D3_HOS_C3_54,S4_HHA2_C4_35,B_1_C22_9201,D_5_HOS_C6_52,S3_1_C5_11,S3_1_C6_2,C_1_C5_32,D_1_HOS_C6_30,D_5_HOS_C3_69,S3_2_C5_41,E_B_HOS_C1_17,G_C1THRU4_49,C_1_C6_110,S3_1_C14_17,D_5_HOS_C3_91,D_4_IPF_C11_91,S3_1_C8_32,D3_IRF_C2_91,B_1_C0_96,A7_1_C2_4,D_4_IRF_C13_58,C_1_C5_89,D_5_HOS_C6_200,S3_1_C2_17,D_4_SNF_C11_56,S3_1_C3_19,D_5_HOS_C7_74,A7_1_C5_5,A7_3_C11_3,A8_C2_5,S2_1_C1_22,B_1_C26_33,A_C1_35,B_1_C26_108,S2_1_C2_16,D_4_HOS_C10_98,B_1_C22_116,B_2_C26_46,B_1_C22_46,E_B_HOS_C1_43,S3_1_C2_9,D3_HOS_C2_42,S3_1_C13_1,B_1_C0_50,S3_3_C2_5,D_5_HOS_C6_61,D_4_HOS_C10_59,S3_3_C5_6,D_4_IPF_C11_54,B_1_C21_112,D_5_HOS_C2_96,A7_1_C2_2,A_C1_111,E_B_HOS_C101_5,S3_1_C7_20,C_1_C7_74,S3_2_C4_30,E_B_HOS_C1_21,A_C1_40,D_4_IRF_C13_60,S3_1_C15_16,B_1_C26_57,S3_1_C2_21,A_C2_89,A_C2_72,B_1_C0_20,D_4_IPF_C11_9201,D_4_IRF_C11_200,S3_2_C4_11,A_C6_4501,D_4_IPF_C11_64,A7_1_C1_8,C_1_C7_75,S2_1_C3_24,D1_HOS_C1_54,C_1_C6_109,D_5_HOS_C4_74,B_1_C26_202,S2_1_C1_93,S3_2_C6_9,A8_C2_24,B_1_C21_100,D3_SNF_C2_32,A_C1_106,A_C2_192,D_4_HOS_C10_53,B_1_C0_18,D3_IRF_C2_40,B_1_C22_55,D_4_HOS_C4_51,S3_2_C2_21,D_4_IPF_C11_63,A8_C2_50,D3_SNF_C2_9201,C_1_C6_55,E_B_HOS_C1_27,B_1_C21_191,D_4_HOS_C11_55,B_1_C0_22,C_1_C7_106,D3_HOS_C2_33,S3_2_C5_5,C_1_C5_41,D_4_HOS_C13_65,D3_IRF_C2_35,G3_C1_3,A_C6_64,D_4_HOS_C13_93,S3_2_C2_23,A7_1_C5_1,D3_IPF_C2_90,S3_2_C3_22,S3_2_C6_30,A_C1_76,B_1_C26_9201,D4_PANCREAS_C1_69,D_4_IRF_C3_200,S3_1_C8_12,D_4_HOS_C13_91,B_1_C26_50,A_C1_13,E_B_HOS_C1_28,D_4_HOS_C10_68,S3_1_C6_7,S3_1_C2_18,B_1_C22_62,D_4_HOS_C11_200,S4_HHA1_C5_33,A_C2_33,S3_2_C6_36,B_2_C26_6250,B_1_C0_64,B_1_C21_44,A_C1_9201,D_4_HOS_C11_75,D_4_IRF_C11_52,D3_IRF_C2_65,D_4_HOS_C11_54,A_C2_57,E_B_HOS_C1_16,A7_1_C3_2,S10_C3_23,A7_1_C5_2,C_1_C6_46,A_C6_4,A8_C2_14,D1_SNF_C1_85,A_C1_200,B_2_C26_98,D_4_HOS_C10_76,A_C6_42,D_4_IRF_C11_67,E_B_HOS_C1_35,C_1_C7_72,A8_C2_23,S3_1_C8_9,D_4_IPF_C13_50,D3_SNF_C3_65,B_1_C21_99,D_5_HOS_C5_58,S3_2_C2_12,A_C6_35,A_C6_192,A7_3_C10_3,D_5_HOS_C3_65,D_4_HOS_C3_90,A_C2_93,B_1_C21_194,A_C6_91,D_1_HOS_C4_35,S3_2_C6_43,S3_2_C4_4,S3_2_C5_35,A_C1_97,S3_1_C10_20,D3_IRF_C2_51,S2_1_C7_3,A_C6_63,S3_2_C6_42,S2_1_C1_128,S10_C1_26,D_4_HOS_C4_70,B_1_C22_51,D_5_HOS_C5_66,S3_1_C3_7,S3_2_C6_28,S3_1_C9_19,S2_1_C2_1503,A_C6_65,D_4_HOS_C1_76,D_5_HOS_C5_71,S3_1_C5_13,A8_C2_6,D_4_IPF_C11_58,A7_1_C3_1,C_1_C7_110,D3_IRF_C3_91,A_C2_31,D3_IRF_C3_57,S3_1_C9_18,S4_HHA3_C3_33,D3_IRF_C2_69,D_4_IPF_C13_76,B_1_C0_11,D_4_SNF_C11_59,D3_IRF_C3_61,G_C1THRU4_35,A_C6_68,D4_LIVER_C1_69,D_1_HOS_C6_31,D_4_IPF_C1_200,S3_3_C2_6,B_1_C22_66,D_4_IRF_C13_71,S3_1_C8_26,G_C1THRU4_4,C_1_C5_96,A_C6_111,B_1_C21_73,A_C2_23,D3_HOS_C2_58,B_1_C26_200,C_1_C5_91,C_1_C8_202,S3_2_C2_13,A_C6_9940,B_1_C0_33,A_C1_6250,A_C1_112,D_5_HOS_C2_59,B_1_C22_54,D_4_HOS_C12_52,A_C2_111,E_B_HOS_C1_33,A_C6_32,A7_3_C9_3,D_5_HOS_C6_70,S3_2_C5_37,D_4_IPF_C13_59,C_1_C5_68,D_4_HOS_C13_90,D_5_HOS_C7_93,D_4_HOS_C10_69,A_C6_69,A_C2_194,G_C1THRU4_3,B_1_C0_56,D_4_HOS_C13_200,D_1_HOS_C6_200,D3_SNF_C3_73,S4_HHA3_C2_33,D_4_HOS_C3_6250,D_4_HOS_C3_56,B_1_C21_63,C_1_C5_88,S3_1_C11_27,D_4_HOS_C13_67,S3_2_C3_1401,C_1_C7_69,B_1_C0_67,S4_HHA2_C4_33,S4_HHA3_C4_37,D_4_HOS_C3_53,S3_2_C2_7,A7_3_C5_3,S2_1_C2_1502,D_5_HOS_C3_50,S4_HHA3_C3_38,C_1_C7_112,B_2_C26_106,C_1_C5_71,D1_HOS_C1_26,A7_3_C9_1,B_1_C21_91,S3_2_C5_34,D_4_IPF_C3_200,A7_1_C1_4,C_1_C6_72,D_4_IRF_C11_90,S10_C1_16,D_4_HOS_C12_200,G_C1THRU4_44,E_B_HOS_C1_34,A_C2_66,D_4_IPF_C11_57,S2_1_C2_1514,S2_1_C2_1804,B_1_C22_41,D_4_IRF_C13_62,S10_C2_22,C_1_C7_9930,S3_1_C8_19,D3_HOS_C3_73,S4_HHA1_C4_37,A_C6_73,D_4_HOS_C2_76,D3_HOS_C3_51,S2_1_C1_131,B_1_C0_16,D3_HOS_C2_63,B_1_C0_105,B_1_C26_201,D_5_HOS_C6_66,S3_2_C3_24,S3_2_C2_39,B_1_C21_76,A_C2_107,D_4_HOS_C11_70,S2_1_C2_1510,D_4_HOS_C2_55,D_4_HOS_C13_70,D_4_HOS_C2_51,S10_C1_20,G_C1THRU4_54,A_C2_90,S2_1_C1_3801,C_1_C6_6250,A8_C2_29,D_4_HOS_C11_58,A_C6_106,D_5_HOS_C7_98,B_1_C26_74,D_3_HOS_C2_200,S3_3_C5_2,S3_1_C7_1,D3_IPF_C2_96,D_4_HOS_C3_63,D3_HOS_C2_56,A7_1_C7_1,D_4_HOS_C13_58,S3_2_C5_30,B_1_C21_56,D_5_HOS_C6_63,A_C1_52,B_1_C21_59,D_4_IRF_C11_9201,D3_HOS_C3_76,E_B_HOS_C1_19,A_C2_113,D3_IPF_C3_56,A_C1_57,A_C6_45,S3_1_C7_15,A_C2_44,S3_2_C2_33,C_1_C6_9940,B_1_C22_63,B_1_C0_62,D3_IRF_C2_34,A_C6_72,B_1_C21_115,B_2_C26_4201,D_4_HOS_C4_53,S3_3_C4_1,D_5_HOS_C4_72,A_C1_14,B_1_C0_194,D_5_HOS_C7_68,A_C6_58,D1_HOS_C5_43,C_1_C6_97,S3_1_C3_1801,S4_HHA1_C1_33,C_1_C5_62,D_4_SNF_C11_51,D3_IRF_C3_9201,A_C1_16,B_1_C21_9201,S3_2_C4_20,D_4_IRF_C4_200,S2_1_C2_1201,B_1_C22_72,A_C2_191,C_1_C2_66,D4_INTESTINE_C1_69,S3_2_C2_1,D_5_HOS_C6_69,D1_HOS_C1_58,S5_C6_1,B_1_C0_75,D3_IRF_C3_69,B_1_C26_68,B_1_C26_106,A_C6_94,A_C2_109,RPT_STUS_CD,D_3_HOS_C9_35,B_2_C26_9930,D_4_IPF_C13_93,D_5_HOS_C2_93,B_1_C26_61,S2_1_C2_38,S3_1_C11_22,B_2_C26_97,D_1_HOS_C4_42,S3_1_C6_9,C_1_C6_108,S3_2_C2_2550,S3_2_C6_6,D_4_HOS_C12_64,C_1_C7_99,D_4_HOS_C10_65,S3_2_C2_1402,D3_IPF_C2_63,D3_IRF_C2_58,B_1_C26_35,S4_HHA3_C3_34,B_2_C26_193,D3_IRF_C2_72,D3_HOS_C2_65,S3_2_C5_27,C_1_C6_99,S10_C1_31,D1_HOS_C1_53,S3_2_C2_34,B_1_C21_57,D_4_HOS_C13_50,D_4_SNF_C11_55,C_1_C6_42,S4_HHA1_C3_36,D3_IRF_C3_50,S3_1_C11_21,D_5_HOS_C4_60,S5_C1_6,D_5_HOS_C5_53,G3_C1_25,C_1_C5_69,S3_1_C13_14,D_5_HOS_C2_55,S4_HHA3_C1_33,D3_HOS_C2_43,D1_IRF_C1_27,S3_2_C2_36,D_5_HOS_C3_98,S3_2_C4_2551,D_4_HOS_C10_67,D3_HOS_C2_73,S10_C1_14,D_4_HOS_C2_64,A_C2_88,A_C1_56,D_4_HOS_C11_57,S10_C1_11,B_1_C0_1,D_4_IPF_C13_54,A_C6_66,A7_1_C2_1,D1_HOS_C1_27,S2_1_C4_2,A_C1_9910,D3_HOS_C3_66,B_1_C21_64,A_C2_51,D_5_HOS_C2_63,S3_2_C2_11,B_1_C26_62,D3_HOS_C2_53,B_1_C0_97,D_5_HOS_C6_62,S5_C4_2,S5_C2_3,D3_IPF_C2_51,B_1_C0_9910,A8_C2_7,B_1_C26_111,D_4_HOS_C4_89,S3_2_C4_1401,A_C2_58,B_1_C26_70,B_1_C26_51,D_5_HOS_C7_63,D_4_HOS_C2_70,A_C2_99,D3_SNF_C3_63,D_5_HOS_C3_95,E_B_HOS_C1_39,D_5_HOS_C4_66,D_5_HOS_C4_69,E_B_HOS_C1_7,E_B_HOS_C1_4001,S2_1_C2_1519,A7_1_C3_3,D_4_HOS_C3_59,D_5_HOS_C5_97,C_1_C7_56,D3_SNF_C3_9201,S2_1_C2_11801,D_5_HOS_C6_51,S3_1_C3_18,C_1_C5_112,C_1_C6_9920,B_1_C26_107,A_C2_62,S5_C5_2,D_4_HOS_C11_62,S3_1_C10_2001,D1_HOS_C1_48,A_C6_1,S2_1_C1_60,B_1_C22_98,D_4_HOS_C13_76,S3_3_C2_3,C_1_C6_112,S3_2_C2_15,D3_HOS_C3_71,S3_1_C3_9,D_4_IRF_C11_75,D3_IRF_C2_98,S4_HHA3_C5_37,G_C1THRU4_40,D3_IPF_C3_91,S3_2_C4_27,C_1_C7_70,C_1_C5_111,S3_1_C9_22,S5_C1_2,D_4_HOS_C10_73,D_4_HOS_C12_70,B_1_C21_40,C_1_C7_68,D_5_HOS_C6_56,D3_SNF_C3_72,G_C1THRU4_36,A_C2_19,A_C2_190,D_4_HOS_C10_62,D_4_HOS_C3_65,D_5_HOS_C7_60,A_C1_96,S2_1_C2_1604,D3_HOS_C3_72,B_1_C21_74,G_C1THRU4_38,D_5_HOS_C3_54,A_C6_16,S10_C1_1,S3_1_C13_16,D_4_SNF_C11_93,B_2_C26_56,S2_1_C1_125,A7_1_C7_6,S3_2_C4_1,A_C1_69,C_1_C6_53,D_1_HOS_C7_35,S3_1_C4_10,A8_C2_16,D_5_HOS_C3_200,D3_SNF_C2_94,S2_1_C1_105,A_C6_23,A8_C2_31,D_4_HOS_C2_65,D_4_HOS_C11_51,A_C1_94,B_2_C26_72,C_1_C5_105,D3_IRF_C2_56,S3_2_C5_38,D_5_HOS_C2_9201,D3_SNF_C2_91,A_C2_74,A_C6_10,A_C6_18,A_C6_4201,S3_1_C7_32,D3_IPF_C3_57,B_1_C0_61,S5_C1_7,C_1_C6_73,D_5_HOS_C4_68,S3_1_C8_16,D3_IPF_C3_55,B_1_C26_52,G_C1THRU4_46,C_1_C5_42,B_1_C26_4201,A7_1_C3_7,B_1_C26_45,D_1_HOS_C6_32,S2_1_C3_11801,B_1_C0_10,S3_1_C3_20,C_1_C5_65,S3_1_C4_14,S4_HHA1_C2_34,A_C6_96,D_5_HOS_C2_91,D1_IPF_C1_27,D_4_IPF_C13_91,D3_HOS_C2_35,D3_HOS_C3_74,S3_1_C14_14,B_2_C26_99,D_5_HOS_C4_71,C_1_C5_35,S3_2_C2_32,A7_1_C3_8,B_1_C0_108,D_5_HOS_C2_71,A_C2_69,A_C1_20,D_4_IPF_C11_72,D_5_HOS_C5_72,D_4_HOS_C1_91,D3_IPF_C3_69,C_1_C6_30,D_4_HOS_C3_54,D_5_HOS_C5_96,A_C6_59,C_1_C5_6250,D1_IPF_C1_37,A_C2_65,B_1_C0_91,A_C6_17,D_4_HOS_C10_91,D_5_HOS_C2_54,D3_IPF_C3_74,B_1_C26_194,S4_HHA2_C1_33,B_1_C0_13,A_C2_1,B_1_C22_31,S3_1_C13_2,C_1_C7_63,B_1_C26_190,A_C1_100,A_C1_31,S3_1_C7_11,B_2_C26_93,S3_2_C4_1602,D3_IPF_C3_52,S3_2_C5_36,D3_HOS_C3_91,S3_1_C13_17,S4_HHA1_C3_33,B_2_C26_50,B_1_C22_115,D_4_HOS_C10_64,D_1_HOS_C4_34,S3_1_C7_5,A_C2_97,C_1_C6_74,S3_1_C4_8,S2_1_C2_1521,A_C1_34,A_C1_194,A_C6_51,A8_C2_33,B_1_C21_117,S3_1_C10_26,D_4_HOS_C3_200,D_4_IPF_C11_93,D_4_HOS_C4_91,B_1_C22_111,C_1_C5_45,B_2_C26_53,S10_C1_2,B_2_C26_192,S3_1_C7_2,E_B_HOS_C1_3,D3_IPF_C3_50,C_1_C2_65,D_4_HOS_C4_50,D1_HOS_C1_37,C_1_C6_111,A_C2_12,D_4_IPF_C11_75,A_C2_2,B_1_C21_55,A_C2_9,B_1_C22_40,D_5_HOS_C6_55,D_5_HOS_C7_70,D3_SNF_C2_35,D_4_HOS_C13_59,S3_1_C7_16,D_5_HOS_C5_9201,D_5_HOS_C7_50,D3_SNF_C3_76,A_C1_4201,S3_1_C5_7,D_5_HOS_C7_58,D3_SNF_C3_56,S3_2_C5_31,D_4_HOS_C2_52,B_1_C26_88,B_2_C26_9920,D_3_HOS_C5_200,S3_2_C4_41,D_3_HOS_C9_32,S2_1_C2_9,D_5_HOS_C5_70,S3_2_C6_3,D1_IRF_C1_41,E_B_HOS_C101_7,D_4_HOS_C1_73,D_4_HOS_C3_51,B_1_C22_53,D_5_HOS_C4_64,S3_3_C4_2,D_5_HOS_C3_97,D_5_HOS_C7_72,D_5_HOS_C6_94,D1_IPF_C1_49,S5_C1_21,A_C6_67,E_A_HOS_C1_7094,S10_C1_3,D_4_IRF_C13_75,D_5_HOS_C6_68,E_B_HOS_C1_20,D3_HOS_C2_71,S4_HHA1_C2_33,D_4_HOS_C10_75,S3_1_C9_21,D_4_HOS_C3_91,S3_2_C2_41,B_1_C0_5,C_1_C5_44,D_4_IRF_C11_72,D_4_IPF_C13_64,B_1_C26_115,A_C1_116,B_1_C21_90,G_C1THRU4_6,C_1_C7_88,D_5_HOS_C5_73,S5_C1_11,D_5_HOS_C4_62,S3_2_C5_6,D3_SNF_C2_63,S3_2_C4_2552,G_C1THRU4_7,A_C6_191,S3_2_C4_37,S4_HHA1_C3_38,S2_1_C2_1516,B_2_C26_201,S5_C3_2,C_1_C5_31,C_1_C7_9910,D4_KIDNEY_C1_69,D_5_HOS_C3_96,C_1_C7_76,B_2_C26_4501,S5_C1_9,D_4_HOS_C13_55,S3_3_C6_2,A_C2_117,D3_SNF_C3_54,B_2_C26_67,B_1_C0_40,B_2_C26_57,D_5_HOS_C4_98,D_4_IRF_C13_59,B_1_C21_58,D_4_IPF_C11_200,B_1_C0_6250,D_4_IPF_C11_53,D_4_HOS_C11_63,S4_HHA1_C1_38,D_4_IRF_C13_66,A_C6_200,A8_C2_18,S4_HHA2_C2_37,D_4_HOS_C3_60,A7_3_C11_1,S5_C2_2,B_1_C26_44,D_5_HOS_C5_54,E_B_HOS_C1_26,C_1_C5_107,D1_IRF_C1_51,C_1_C6_59,D3_HOS_C3_96,B_2_C26_94,D3_IRF_C2_93,D3_SNF_C2_58,S4_HHA3_C2_34,D3_IRF_C2_53,D3_SNF_C2_65,G_C1THRU4_52,A_C6_33,A7_1_C7_8,D_4_IRF_C11_76,D_5_HOS_C7_67,D_3_HOS_C9_30,D_5_HOS_C4_75,D_4_HOS_C13_74,B_1_C21_32,A_C1_51,S4_HHA2_C5_33,S4_HHA1_C1_34,C_1_C6_90,D3_HOS_C3_50,G3_C1_5,A8_C2_30,B_1_C21_52,S3_1_C7_1801,A_C2_114,D3_IRF_C2_62,S2_1_C2_1,S4_HHA2_C2_35,S3_2_C3_23,D_4_HOS_C3_58,S2_1_C5_24,D_5_HOS_C4_51,D3_IPF_C3_71,B_1_C22_109,A8_C2_27,S10_C1_15,B_1_C0_95,C_1_C7_6250,C_1_C5_9940,D3_SNF_C3_52,S4_HHA3_C2_38,S10_C2_21,D1_IRF_C1_50,A_C1_53,D_4_SNF_C11_65,G_C1THRU4_51,S10_C1_6,S4_HHA1_C5_36,A8_C2_4,S2_1_C2_1809,C_1_C5_4201,S3_1_C9_24,B_1_C0_35,B_1_C0_17,S3_2_C5_9,D_4_HOS_C11_69,A_C2_116,B_1_C0_99,E_B_HOS_C1_2,S3_2_C2_14,S3_1_C2_12,S3_1_C10_21,D3_IPF_C3_200,D3_HOS_C3_61,S3_3_C2_2,B_1_C22_191,E_B_HOS_C1_5,B_1_C22_112,S4_HHA2_C3_38,D_5_HOS_C2_200,S3_2_C4_32,D_4_HOS_C13_54,D_4_IRF_C13_74,C_1_C7_98,D_4_HOS_C11_56,S3_3_C4_6,S3_2_C4_19,S3_1_C2_16,S2_1_C2_1202,S2_1_C1_38,D_4_IPF_C11_52,S2_1_C2_4,D_5_HOS_C4_93,B_1_C21_71,S2_1_C1_108,S3_1_C12_17,A_C2_21,S3_2_C2_42,S4_HHA1_C5_34,A_C1_108,S2_1_C2_1512,D3_IRF_C2_9201,D3_IRF_C3_53,S3_2_C3_14,B_1_C0_100,A8_C2_15,S3_2_C4_17,D_4_HOS_C12_97,D3_HOS_C2_60,G_C1THRU4_39,C_1_C7_65,A_C2_200,B_1_C26_69,A_C6_15,C_1_C5_106,B_1_C0_45,B_1_C26_97,S3_2_C4_22,S2_1_C1_127,D_4_SNF_C11_57,B_1_C26_193,D_4_HOS_C1_50,A_C6_70,S3_2_C6_15,A_C1_72,D_4_IPF_C13_52,C_1_C6_94,B_1_C26_54,D_4_IPF_C11_51,S3_1_C2_32,D_4_HOS_C10_93,S5_C1_3,A_C1_90,E_B_HOS_C1_6,E_B_HOS_C1_15,C_1_C7_93,D_4_HOS_C4_60,D3_IRF_C2_70,A_C6_44,A7_1_C2_3,D_4_HOS_C3_73,A7_3_C6_2,A_C1_98,S3_2_C6_1,E_B_HOS_C1_31,B_1_C0_4501,A_C2_32,A_C6_116,B_1_C21_93,S2_1_C2_127,S3_2_C4_13,C_1_C5_94,D_4_HOS_C3_66,D_4_SNF_C11_66,D_5_HOS_C6_75,D3_IRF_C2_61,S4_HHA3_C2_37,C_1_C3_202,S5_C1_13,A7_1_C5_4,D_4_HOS_C4_54,C_1_C6_4501,B_1_C0_9930,B_1_C21_106,D_5_HOS_C6_58,S10_C1_10,S3_1_C5_12,B_1_C26_76,S3_1_C7_9,D3_HOS_C2_69,D3_IPF_C2_59,C_1_C7_115,A8_C2_21,S4_HHA1_C4_33,S3_1_C7_13,A_C6_9930,B_1_C0_66,S3_1_C2_1801,D3_IPF_C2_67,S3_3_C6_1,S3_2_C6_2,S3_2_C4_36,A_C2_56,D3_IPF_C2_40,S2_1_C2_1605,B_1_C21_98,B_2_C26_115,G_C1THRU4_53,E_B_HOS_C101_4,S3_3_C6_7,D3_SNF_C2_67,B_1_C22_106,S3_1_C6_32,D3_IRF_C3_65,D3_IRF_C2_66,A7_1_C2_5,S3_2_C5_43,S2_1_C2_128,C_1_C5_99,D_4_IPF_C11_62,D_4_HOS_C12_62,S3_1_C8_25,B_1_C22_75,A_C1_74,B_1_C26_91,C_1_C5_51,S3_1_C15_14,D_4_HOS_C3_97,A_C1_60,G_C1THRU4_17,D_5_HOS_C2_90,S3_2_C6_11,B_1_C0_21,C_1_C5_34,D_4_SNF_C11_73,C_1_C5_76,D3_IPF_C2_33,D3_IPF_C2_34,D_3_HOS_C9_31,A_C2_112,S3_1_C12_14,A_C2_55,D1_IPF_C1_53,D1_IPF_C1_50,C_1_C7_51,A_C2_68,D3_HOS_C3_75,S3_1_C3_1,C_1_C5_115,D_4_HOS_C4_74,S3_1_C8_2001,C_1_C5_59,A_C1_46,S2_1_C2_1802,D_5_HOS_C6_74,D_4_HOS_C3_72,S5_C6_4,S2_1_C1_116,S2_1_C2_132,D3_HOS_C3_68,D3_HOS_C2_93,D_1_HOS_C7_40,S4_HHA1_C1_35,D_5_HOS_C6_57,D3_HOS_C3_97,A7_1_C5_8,C_1_C5_55,D3_IRF_C3_200,B_2_C26_110,D_4_HOS_C12_68,D3_IPF_C2_64,B_1_C0_58,B_1_C26_31,S3_2_C6_5,C_1_C7_107,C_1_C7_101,D3_IRF_C2_94,C_1_C7_62,G2_C2_28,A_C1_17,B_1_C0_109,D1_HOS_C5_45,D1_IRF_C1_53,D_4_HOS_C10_57,D1_HOS_C1_55,G_C1THRU4_1,A7_1_C7_3,D_5_HOS_C4_200,A_C2_16,C_1_C7_90,D1_IPF_C1_48,B_1_C26_40,D_4_HOS_C4_88,D3_IPF_C2_68,S3_2_C5_11,D3_IRF_C3_51,A_C1_23,A_C2_75,D3_IRF_C3_73,D_4_HOS_C11_64,D_4_HOS_C12_60,A_C2_14,B_1_C26_34,B_1_C22_32,E_B_HOS_C1_18,S3_2_C5_12,A8_C2_11,S3_1_C3_11,D_4_IRF_C11_59,B_1_C0_89,S3_1_C8_17,A_C1_93,S3_3_C6_5,A_C2_40,FI_NUM,D3_SNF_C2_59,S3_2_C2_18,S3_1_C11_25,S4_HHA3_C2_35,D_5_HOS_C7_65,D_5_HOS_C2_67,PRVDR_NUM,D3_SNF_C2_72,D_4_HOS_C11_72,S2_1_C1_134,A_C2_11,A_C2_41,D_4_HOS_C11_93,B_2_C26_66,S3_2_C2_29,D_4_HOS_C10_96,S3_1_C15_17,D_4_HOS_C2_71,E_A_HOS_C1_59,D_4_SNF_C11_91,D3_IRF_C3_60,G3_C1_1,E_B_HOS_C1_4,B_1_C0_19,A_C1_71,A_C1_64,C_1_C7_57,S2_1_C1_3,A_C1_7,D_4_IRF_C13_69,D3_IPF_C3_72,D_4_IPF_C11_50,D_4_IRF_C11_56,D3_HOS_C2_98,D_5_HOS_C5_59,D3_SNF_C2_56,D_5_HOS_C3_53,A7_3_C11_2,A7_1_C1_1,B_1_C26_112,A7_3_C10_2,D1_HOS_C1_51,C_1_C5_95,D_5_HOS_C4_52,S4_HHA2_C1_35,D_4_IRF_C11_50,D_4_IRF_C11_93,D3_IRF_C2_73,S3_3_C6_6,A_C1_4,S3_2_C6_40,D3_IRF_C3_59,C_1_C5_70,D_4_IRF_C11_71,C_1_C5_54,B_1_C21_21,C_1_C7_202,S3_1_C10_27,S3_1_C7_24,B_1_C22_57,C_1_C5_9930,B_2_C26_95,S4_HHA3_C4_38,B_1_C26_117,B_1_C22_68,B_1_C0_14,D_1_HOS_C6_41,B_1_C26_30,S3_2_C6_32,B_2_C26_190,S3_1_C7_18,B_2_C26_64,B_1_C0_117,D3_IPF_C3_66,S3_2_C5_3,S3_2_C2_9,B_1_C0_90,D_5_HOS_C7_6250,A_C1_54,A_C1_55,B_1_C26_116,B_1_C22_108,G_C1THRU4_2,B_1_C22_34,B_1_C21_31,D_5_HOS_C6_76,S2_1_C2_1524,A8_C2_9,B_1_C0_65,D_5_HOS_C7_71,D3_IPF_C2_9201,A_C2_9910,A7_1_C3_5,S5_C2_1,C_1_C7_105,S2_1_C2_1509,C_1_C6_51,S2_1_C2_2,B_1_C0_76,D3_SNF_C2_51,B_1_C26_89,D_5_HOS_C5_68,S2_1_C2_3601,S3_2_C4_14,S2_1_C2_1805,C_1_C6_100,D_4_IRF_C13_52,D3_SNF_C2_73,S3_3_C4_4,B_2_C26_63,B_2_C26_91,A7_1_C3_4,A8_C2_28,A_C2_8,B_1_C22_56,D_4_HOS_C4_56,D_4_HOS_C2_56,S3_2_C5_7,S3_2_C2_20,D3_SNF_C2_34,A7_1_C1_7,D_5_HOS_C7_96,D3_IRF_C3_63,D_4_HOS_C11_91,D_4_HOS_C4_73,D_4_IPF_C13_66,D3_IRF_C3_54,S4_HHA2_C1_34,D_5_HOS_C6_67,A_C2_5,B_1_C0_111,S4_HHA1_C2_38,D3_HOS_C2_62,S3_1_C7_14,S3_2_C6_39,S3_2_C4_9,A7_1_C4_7,D3_IRF_C3_64,C_1_C7_67,D_5_HOS_C6_50,A_C6_3,A8_C2_1,C_1_C5_40,D_5_HOS_C7_9201,S3_1_C8_15,D_1_HOS_C4_43,B_1_C22_35,S2_1_C1_142,S4_HHA2_C5_38,A_C2_101,D_4_HOS_C3_98,G_C1THRU4_12,B_1_C22_42,B_2_C26_73,B_1_C0_63,D_4_SNF_C11_58,D3_HOS_C2_64,D_5_HOS_C4_56,D_4_HOS_C12_6250,S3_2_C4_1601,D_5_HOS_C2_74,D_4_IPF_C13_69,S5_C2_8,S2_1_C2_1603,A_C2_46,B_1_C21_72,S3_1_C11_19,B_1_C22_44,C_1_C7_100,A_C1_19,B_1_C22_50,D_4_HOS_C4_64,S3_1_C5_8,D_5_HOS_C6_6250,D_4_IPF_C13_55,D3_IRF_C2_33,D3_HOS_C2_55,D_4_HOS_C12_51,S3_1_C8_28,S3_2_C2_2553,B_1_C0_53,B_1_C22_52,C_1_C7_61,C_1_C7_55,S2_1_C2_18,D3_IRF_C3_74,D_4_IRF_C11_63,A8_C2_26,C_1_C7_54,S3_2_C4_15,D_4_HOS_C10_63,S3_2_C5_13,A_C6_6250,D_4_HOS_C12_75,D_4_IRF_C13_53,S2_1_C1_36,D3_IPF_C3_94,D_4_HOS_C13_66,A_C6_62,S4_HHA1_C5_35,A_C1_89,D3_HOS_C3_62,D_5_HOS_C4_55,S5_C1_14,S4_HHA3_C3_36,D_1_HOS_C6_40,D1_IRF_C1_48,S3_2_C2_4,B_1_C26_66,S3_1_C15_18,S3_2_C2_27,C_1_C6_116,D_4_IRF_C13_93,S3_2_C4_10,D_4_IPF_C13_63,A8_C2_19,S2_1_C1_106,S3_2_C2_28,B_1_C21_68,C_1_C5_202,D_4_IRF_C13_90,D_4_HOS_C10_90,D_4_HOS_C2_94,D3_IRF_C2_55,C_1_C7_71,S3_2_C5_8,D_4_HOS_C2_9201,S3_1_C10_22,S2_1_C1_4,S3_2_C6_1402,D3_IRF_C3_94,D_4_HOS_C11_52,S2_1_C1_48,D3_SNF_C2_54,A_C6_76,A_C1_63,S2_1_C2_5,S3_2_C2_25,C_1_C6_67,D_5_HOS_C5_52,D3_HOS_C2_74,D_4_HOS_C3_67,D3_IPF_C2_73,B_1_C22_73,S3_1_C10_24,D3_IRF_C2_71,S4_HHA2_C4_36,S4_HHA3_C4_35,D_4_HOS_C2_90,D_5_HOS_C4_9201,S3_2_C2_2,S4_HHA1_C3_34,E_B_HOS_C1_30,B_1_C21_60,D3_IRF_C3_72,A_C6_194,D3_SNF_C3_57,D_3_HOS_C9_40,D_5_HOS_C2_6250,S5_C4_4,D3_SNF_C3_53,D_4_HOS_C10_71,D_4_HOS_C2_58,C_1_C6_101,B_1_C0_41,D_4_HOS_C3_62,D1_HOS_C1_57,A_C1_9,D_4_HOS_C12_74,S3_1_C5_14,A_C2_18,A_C2_17,D_4_HOS_C4_57,D3_IRF_C2_54,D_4_IRF_C13_91,D_4_HOS_C12_73,S3_1_C6_17,S3_2_C6_31,S10_C3_22,S3_1_C3_24,S3_1_C8_1801,S5_C6_2,D3_IRF_C2_64,D3_HOS_C3_52,A7_1_C2_6,D_4_IRF_C13_54,B_1_C21_108,D_4_HOS_C4_66,S2_1_C2_13,D_5_HOS_C7_54,D_4_HOS_C13_62,B_1_C21_105,A_C1_44,A_C6_50,S3_2_C6_29,D3_IRF_C2_74,A_C6_30,S2_1_C1_129,S3_2_C2_3,B_2_C26_88,S3_2_C6_34,S2_1_C2_17,C_1_C5_101,D_5_HOS_C3_71,S2_1_C2_1511,B_1_C21_54,S3_2_C5_16,S5_C2_6,A_C1_45,G_C1THRU4_30,D3_IPF_C2_62,B_1_C0_191,S3_1_C11_26,D_4_HOS_C12_93,S3_1_C8_13,S3_1_C7_6,S3_1_C12_16,S3_1_C6_5,C_1_C5_9910,D_4_SNF_C13_200,FI_CREAT_DT,D_4_IPF_C11_66,D_5_HOS_C2_56,D_5_HOS_C2_58,D_4_HOS_C2_69,D_4_HOS_C13_64,D_4_IPF_C11_55,D3_SNF_C3_200,G_C1THRU4_27,E_B_HOS_C1_11,D_1_HOS_C4_31,D_4_HOS_C12_67,S3_3_C5_7,B_1_C22_94,D3_HOS_C3_200,D_5_HOS_C5_76,D_5_HOS_C6_60,S3_1_C4_7,D_4_IPF_C11_69,B_2_C26_51,C_1_C7_66,D_5_HOS_C5_90,S3_1_C7_7,D_5_HOS_C6_90,S2_1_C1_145,S3_2_C6_26,G2_C1_28,B_1_C0_116,S2_1_C3_143,B_2_C26_89,D_5_HOS_C2_76,S2_1_C2_1402,D3_HOS_C2_97,D3_IRF_C3_75,D_5_HOS_C7_75,S3_1_C5_20,S3_2_C4_31,D3_SNF_C2_30,A_C1_9940,S10_C2_20,A8_C2_3,B_1_C22_105,C_1_C5_98,D_5_HOS_C7_57,A8_C2_17,B_1_C21_66,A_C2_73,S4_HHA3_C1_35,G_C1THRU4_50,C_1_C5_66,D3_IRF_C2_50,A_C6_100,B_2_C26_70,D3_IRF_C3_58,D_4_IRF_C13_57,A7_1_C7_7,D_4_HOS_C3_9201,S3_1_C7_19,B_2_C26_43,D_5_HOS_C7_91,S4_HHA2_C5_37,S3_1_C10_18,D3_IRF_C2_59,D_5_HOS_C2_75,B_1_C21_62,C_1_C6_44,D_4_HOS_C2_54,S4_HHA1_C4_34,D4_LUNG_C1_69,B_2_C26_31,S3_2_C3_2551,D3_SNF_C3_75,S2_1_C2_36,D_4_HOS_C10_72,C_1_C5_4501,B_1_C0_71,D_4_HOS_C4_69,S3_2_C4_40,B_1_C0_74,D3_HOS_C2_59,C_1_C5_116,D_4_IRF_C11_74,D_1_HOS_C6_34,A_C1_66,D_1_HOS_C4_41,D_4_HOS_C12_71,S5_C2_21,D_5_HOS_C6_91,D3_IPF_C2_200,B_2_C26_74,A_C1_193,S2_1_C2_1504,D_4_IPF_C13_9201,D_4_HOS_C2_97,D_5_HOS_C3_94,S3_1_C7_2001,B_2_C26_41,B_1_C21_41,D3_IRF_C2_41,D_4_HOS_C2_59,S3_1_C6_16,S3_2_C5_26,E_B_HOS_C1_25,S3_3_C5_1,S4_HHA1_C2_35,A_C6_31,D_4_IPF_C13_57,D3_IPF_C3_60,B_1_C26_100,C_1_C6_202,D3_IPF_C2_57,S3_1_C4_11,C_1_C7_53,D3_IRF_C3_70,B_1_C22_76,D3_HOS_C2_40,D_4_IRF_C13_65,D3_IPF_C2_41,A_C1_12,D_5_HOS_C7_200,A_C2_52,D_5_HOS_C6_54,A_C2_9940,A_C6_61,C_1_C6_33,A7_3_C9_2,S4_HHA2_C3_33,A_C6_6,C_1_C7_60,B_1_C21_46,D_5_HOS_C4_73,C_1_C6_60,A_C1_9920,S4_HHA1_C3_35,D3_IRF_C3_52,D3_IRF_C3_67,A_C1_62,A_C6_52,S2_1_C4_3,D_4_HOS_C4_76,B_1_C26_98,D_4_HOS_C13_69,C_1_C6_63,B_1_C26_96,D_5_HOS_C3_93,S2_1_C2_1602,C_1_C6_71,C_1_C6_62,D3_HOS_C2_75,B_1_C26_64,D_1_HOS_C4_4201,S2_1_C2_1808,D_5_HOS_C6_9201,D_5_HOS_C5_6250,D3_IPF_C3_64,D3_IPF_C3_73,C_1_C5_57,S3_1_C10_14,B_1_C0_57,B_1_C21_107,S4_HHA3_C5_38,S3_3_C4_7,A7_1_C6_7,S3_1_C14_16,D3_IPF_C3_62,C_1_C6_32,B_2_C26_200,S3_2_C4_2201,A_C2_6,B_1_C26_53,D_5_HOS_C7_62,D_5_HOS_C6_97,C_1_C6_57,C_1_C6_43,C_1_C6_66,C_1_C5_60,D3_IPF_C2_52,D_4_HOS_C4_75,D_4_SNF_C11_74,D_4_IRF_C6_200,D_4_IPF_C11_59,D_4_HOS_C11_74,C_1_C5_56,S2_1_C1_140,D_4_HOS_C1_53,C_1_C7_96,A_C1_105,D_5_HOS_C3_74,B_1_C21_94,S2_1_C2_8,D_4_HOS_C6_200,D3_SNF_C3_69,S2_1_C2_1501,A_C6_108,D_4_IPF_C13_73,B_2_C26_55,G_C1THRU4_41,C_1_C5_67,D_4_HOS_C2_50,B_1_C22_117,D3_SNF_C2_57,A_C6_90,S3_1_C8_14,S2_1_C2_1515,C_1_C7_64,S3_1_C6_8,D3_IPF_C2_93,D3_IRF_C3_66,S3_2_C4_39,D_4_HOS_C3_57,D3_IPF_C3_65,C_1_C6_64,D_1_HOS_C6_35,D_5_HOS_C6_98,D3_IPF_C2_65,D_4_HOS_C13_57,D_5_HOS_C6_59,D4_ISLET_C1_69,B_1_C26_94,G3_C1_4,C_1_C5_9201,S3_1_C12_1,S2_1_C2_1401,D3_HOS_C3_67,D_5_HOS_C4_67,D_1_HOS_C7_30,D_5_HOS_C4_94,D3_HOS_C2_68,D_4_HOS_C10_52,C_1_C5_97,A_C6_21,S3_3_C2_1,S3_3_C4_5,D_3_HOS_C9_41,D_4_IRF_C11_60,S4_HHA3_C4_34,S3_2_C6_35,D_4_IRF_C11_70,S2_1_C2_1505,D_5_HOS_C6_71,C_1_C6_35,D3_HOS_C2_76,S3_1_C6_15,S3_1_C2_14,A_C6_7,A_C1_70,S3_1_C5_1,S3_1_C8_24,S10_C1_30,D3_IRF_C2_60,S3_2_C4_6,D3_HOS_C3_58,D3_IPF_C2_32,B_1_C22_93,A_C2_9930,A_C2_96,S4_HHA2_C3_36,C_1_C5_61,G_C1THRU4_48,C_1_C6_76,C_1_C7_111,D3_HOS_C3_57,D1_HOS_C1_49,D_3_HOS_C9_200,B_2_C26_65,D_4_SNF_C11_90,C_1_C5_200,D_1_HOS_C7_34,D_4_IPF_C13_90,D_5_HOS_C2_73,S3_1_C5_19,D_5_HOS_C7_55,D_4_HOS_C2_57,A8_C2_8,C_1_C7_89,S3_2_C4_7,D3_SNF_C2_41,E_B_HOS_C1_12,C_1_C5_72,B_1_C0_12,D_4_HOS_C1_200,S3_2_C6_4,A_C6_98,C_1_C6_65,A_C1_33,B_2_C26_111,D1_IRF_C1_49,B_1_C22_194,D3_IRF_C2_68,E_B_HOS_C1_22,D3_IRF_C3_55,E_B_HOS_C1_10,B_1_C21_51,A_C2_91,B_1_C22_88,D_4_HOS_C2_60,D_4_IRF_C11_58,E_B_HOS_C1_38,S3_2_C4_24,D3_HOS_C2_6250,B_1_C21_53,A_C1_68,D_4_HOS_C13_53,A7_1_C2_10,C_1_C7_50,A8_C2_10,D_5_HOS_C5_55,D3_SNF_C3_66,S5_C2_10,B_1_C0_106,B_1_C26_41,B_1_C21_88,A_C1_192,D1_HOS_C5_44,D3_SNF_C2_93,S10_C1_23,B_2_C26_76,C_1_C6_91,D_5_HOS_C4_50,G_C1THRU4_25,A_C1_41,S3_2_C3_25,D_5_HOS_C2_57,S3_2_C6_38,D3_HOS_C3_9201,D_4_IPF_C11_71,A7_1_C5_7,C_1_C7_52,S3_2_C4_43,D_4_IRF_C13_76,S3_1_C15_21,B_1_C0_2,S3_2_C4_29,D3_SNF_C3_74,A8_C2_12,D_4_HOS_C11_76,S10_C1_9,D_4_IPF_C11_76,S2_1_C2_14,B_1_C0_4201,S3_2_C5_33,D_4_HOS_C3_75,B_1_C26_9910,A_C2_20,D1_IRF_C1_37,D_4_SNF_C11_200,S3_2_C6_41,D_5_HOS_C5_91,D_5_HOS_C2_51,S4_HHA3_C4_36,B_1_C26_65,D_4_SNF_C11_63,D3_HOS_C3_93,S2_1_C3_2,D_4_IPF_C11_68,D_4_HOS_C11_73,D_4_HOS_C10_56,S3_2_C4_26,S2_1_C2_1608,B_2_C26_96,A_C6_107,S2_1_C2_10,S3_2_C2_26,D_5_HOS_C7_73,D4_HEART_C1_69,B_2_C26_105,A_C1_42,D3_IPF_C3_67,C_1_C5_53,C_1_C6_56,B_2_C26_107,D3_IPF_C2_76,A_C2_53,B_1_C26_105,B_1_C0_4,S2_1_C1_1,S3_3_C6_3,B_1_C26_59,A_C6_13,D_4_IRF_C11_64,S3_2_C5_2,D_5_HOS_C4_54,D_4_HOS_C4_59,FY_BGN_DT,S2_1_C2_24,C_1_C5_43,D3_HOS_C2_9201,A_C6_5,C_1_C7_117,S4_HHA2_C5_34,D_4_SNF_C11_9201,D3_SNF_C2_68,C_1_C7_9920,D_1_HOS_C4_200,G_C1THRU4_13,B_2_C26_68,D3_IPF_C2_42,S3_1_C11_14,S3_2_C2_43,D3_IRF_C2_31,B_1_C22_193,C_1_C6_40,B_1_C0_68,C_1_C6_50,A_C2_70,S2_1_C2_1507,S3_1_C9_14,S3_2_C2_5,S3_1_C7_12,A_C1_18,B_1_C26_71,D_4_HOS_C2_91,D_5_HOS_C3_68,D_4_SNF_C13_73,S3_1_C7_25,C_1_C6_41,D_4_HOS_C13_63,S3_1_C8_18,D_4_IRF_C11_62,A_C1_117,C_1_C6_69,C_1_C7_109,B_2_C26_40,D_4_IPF_C11_73,D3_SNF_C2_50,D_4_IPF_C11_60,D3_SNF_C2_31,B_1_C26_42,D1_HOS_C1_52,C_1_C2_68,S5_C1_8,D_4_IPF_C13_72,S10_C1_17,B_1_C0_115,D3_HOS_C2_66,S2_1_C2_115,A_C6_109,S3_2_C4_1402,D_5_HOS_C3_60,C_1_C6_96,B_2_C26_191,B_1_C0_98,D_5_HOS_C3_70,D3_SNF_C2_66,A_C1_21,C_1_C6_75,S3_2_C5_14,D1_IPF_C1_41,B_2_C26_100,A8_C2_13,D3_HOS_C3_64,S4_HHA3_C5_36,D3_SNF_C2_71,A_C1_190,D_4_IPF_C13_200,B_1_C21_30,C_1_C7_95,E_B_HOS_C1_42,S2_1_C2_1001,A_C2_106,D_5_HOS_C2_72,D3_SNF_C2_96,D3_HOS_C3_6250,A7_3_C5_2,C_1_C7_73,D_4_IPF_C13_67,A_C6_9910,S4_HHA3_C5_35,D_4_SNF_C11_71,D_5_HOS_C3_64,D_4_IRF_C11_73,D_4_HOS_C3_89,S3_1_C2_8,D_4_HOS_C4_58,B_1_C0_9920,B_2_C26_60,S2_1_C2_12,D_4_HOS_C13_56,D3_HOS_C2_54,A_C2_45,B_1_C0_112,C_1_C5_100,D_4_IRF_C11_51,S3_2_C4_2550,S3_2_C4_35,B_1_C0_30,S3_2_C3_2201,S4_HHA2_C4_37,C_1_C6_93,D_4_IRF_C11_53,D1_SNF_C1_37,D3_IPF_C3_70,S3_2_C6_7,D3_SNF_C3_67,E_B_HOS_C1_29,A_C2_100,S2_1_C1_2,D_4_IPF_C13_58,D3_HOS_C3_65,D_4_IRF_C13_73,S4_HHA2_C3_34,D_4_IPF_C2_200,D_5_HOS_C3_59,B_1_C26_9930,D_5_HOS_C2_68,S2_1_C2_143,B_2_C26_54,D_5_HOS_C2_53,B_1_C22_74,D_4_IPF_C13_56,B_2_C26_117,S3_2_C2_1401,D3_IPF_C3_98,S3_1_C5_9,B_1_C0_9201,S2_1_C1_141,B_2_C26_109,D_5_HOS_C4_90,D3_SNF_C2_69,C_1_C6_52,D_5_HOS_C2_52,A_C2_4501,D_4_SNF_C11_72,B_1_C26_110,S2_1_C1_126,D3_IRF_C3_68,D3_SNF_C3_98,A_C1_95,B_1_C21_101,D_5_HOS_C6_65,S2_1_C2_1523,S3_1_C9_27,A_C6_56,B_1_C21_190,D3_HOS_C2_34,B_1_C0_31,D3_SNF_C3_71,B_2_C26_108,D3_SNF_C2_60,D3_SNF_C3_50,D_4_HOS_C11_65,D_4_HOS_C4_67,A_C1_30,B_1_C26_101,S3_1_C3_32,D_4_IRF_C11_57,A_C1_99,S10_C1_12,D_4_HOS_C13_51,A7_3_C15_2,S3_2_C5_10,D3_IRF_C3_90,A_C6_93,S5_C4_3,B_1_C21_75,B_1_C21_34,S3_3_C5_4,S5_C4_6,B_1_C21_109,S2_1_C1_26,D3_SNF_C2_75,S3_3_C2_4,B_1_C26_6250,D1_SNF_C1_84,S2_1_C2_1508,S5_C1_10,A_C2_42,B_1_C26_192,D_5_HOS_C6_72,B_1_C0_88,D3_IPF_C2_94,S3_1_C10_1801,A_C6_40,S3_2_C2_8,B_2_C26_34,S3_2_C2_19,D_5_HOS_C7_51,S2_1_C2_142,E_B_HOS_C1_3998,D_5_HOS_C3_90,C_1_C6_89,S3_1_C8_10,B_1_C21_42,B_1_C0_46,D_4_HOS_C12_76,D_4_HOS_C4_93,S4_HHA2_C3_35,A_C6_54,C_1_C7_108,D3_SNF_C3_91,B_1_C0_34,S2_1_C4_24,A_C6_75,A7_3_C10_1,D_4_HOS_C12_91,B_1_C0_94,A_C1_43,S2_1_C2_1518,D_4_IRF_C11_98,D1_HOS_C1_62,B_1_C22_99,S10_C3_20,A_C2_34,B_1_C26_95,D_4_HOS_C3_50,D_4_IPF_C11_70,S3_2_C5_29,D3_HOS_C2_31,D_4_HOS_C4_68,D_5_HOS_C6_95,A7_1_C7_4,S3_2_C2_16,S5_C1_5,D1_HOS_C1_50,B_1_C21_89,D_4_HOS_C11_59,D_4_IPF_C11_65,D3_HOS_C2_30,D_5_HOS_C4_53,D_5_HOS_C7_59,S3_3_C5_3,S5_C3_3,S4_HHA2_C2_33,D1_IPF_C1_51,S10_C1_22,A_C2_50,D_5_HOS_C4_63,B_1_C26_63,A7_1_C1_2,D_4_HOS_C13_9201,A_C1_110,D_4_SNF_C11_70,D_4_SNF_C11_53,B_2_C26_112,A_C1_22,B_1_C26_55,D3_HOS_C2_96,D_5_HOS_C2_69,B_1_C0_43,D3_IPF_C2_53,D_4_HOS_C10_51,D_5_HOS_C4_6250,B_2_C26_75,D_5_HOS_C7_56,S4_HHA2_C2_34,D3_HOS_C3_69,D_4_SNF_C11_76,S3_2_C4_8,C_1_C6_88,D_5_HOS_C6_93,A_C2_105,S3_2_C2_40,B_1_C22_95,A8_C2_22,S5_C1_1,A_C1_58,C_1_C6_54,D_5_HOS_C3_6250,A_C6_12,S3_1_C11_20,B_1_C22_64,S3_2_C2_2201,C_1_C6_105,B_1_C26_75,C_1_C5_74,B_1_C26_9920,D3_IRF_C2_32,D_4_HOS_C12_53,B_1_C22_60,S2_1_C2_1506,G3_C1_2,D_4_HOS_C2_68,D_4_HOS_C3_52,S3_1_C9_20,S2_1_C1_56,B_1_C0_52,G_C1THRU4_9,S3_1_C8_5,S2_1_C2_7,D_5_HOS_C5_56,D_5_HOS_C2_94,C_1_C2_67,D3_SNF_C2_55,G_C1THRU4_34,D_4_HOS_C4_72,D3_SNF_C3_96,E_B_HOS_C101_6,S5_C1_12,A_C6_9201,D3_HOS_C2_52,D_5_HOS_C3_61,A_C2_22,D3_HOS_C3_53,A_C1_73,D3_HOS_C3_59,B_1_C22_58,E_B_HOS_C1_36,D3_SNF_C3_90,A_C1_91,D_5_HOS_C3_73,B_2_C26_32,D3_SNF_C2_70,E_B_HOS_C1_24,S3_1_C5_17,D1_HOS_C1_63,D3_HOS_C2_91,D_3_HOS_C6_200,D3_IRF_C3_62,A_C2_13,S2_1_C2_15,A_C6_46,D_4_IRF_C13_51,S5_C1_15,D_5_HOS_C5_75,D_1_HOS_C7_200,D_4_HOS_C12_57,D_4_HOS_C12_55,D1_HOS_C5_46,S3_1_C6_1,S3_2_C2_6,A8_C2_20,C_1_C5_75,A_C1_191,D_4_IRF_C13_200,D_4_SNF_C11_75,A_C6_9920,C_1_C5_110,S3_1_C3_21,A_C6_101,D3_IRF_C3_56,S3_2_C5_15,A_C1_9930,S3_1_C3_17,D_4_HOS_C13_60,A_C2_98,B_1_C21_67,D_4_HOS_C10_9201,S2_1_C1_144,D_4_HOS_C11_94,D3_SNF_C3_58,B_1_C21_43,D_4_IPF_C13_51,A7_3_C6_1,D_5_HOS_C3_56,D3_IPF_C3_53,D_4_IPF_C11_90,S3_1_C9_26,S3_1_C2_27,D_5_HOS_C5_51,A_C6_57,C_1_C7_9940,D_4_IRF_C11_68,B_1_C26_43,B_1_C26_72,D3_SNF_C2_64,D_4_HOS_C3_71,D3_IPF_C2_54,A_C2_3,B_1_C26_99,C_1_C6_9201,E_A_HOS_C1_7099,S3_2_C6_16,A_C2_61,A_C6_112,D3_IPF_C2_66,A_C1_6,D_4_HOS_C12_90,D3_SNF_C3_59,S3_1_C6_19,A_C6_41,D_4_HOS_C13_98,D_5_HOS_C4_70,A_C2_10,S3_1_C5_16,G_C1THRU4_31,S5_C2_9,S4_HHA1_C4_38,D_4_IRF_C13_55,D_4_SNF_C11_68,D3_HOS_C3_90,G_C1THRU4_19,B_1_C26_4501,S3_1_C8_1,B_2_C26_9910,C_1_C6_31,D_4_HOS_C12_69,A7_1_C2_7,S4_HHA1_C2_37,RPT_REC_NUM,S2_1_C2_1513,S2_1_C2_1606,D3_IPF_C2_70,A_C1_88,B_1_C26_90,D_5_HOS_C3_52,S4_HHA3_C4_33,B_1_C26_9940,A_C6_110,S10_C1_27,S3_2_C2_38,C_1_C7_116,D_5_HOS_C7_52,S3_2_C3_1402,D_5_HOS_C5_98,S3_3_C6_4,C_1_C7_94,D3_IPF_C2_55,D3_IPF_C3_59,B_1_C0_23,S3_2_C4_18,S3_1_C4_1,B_1_C26_191,D_4_HOS_C2_67,A_C2_43,S3_2_C4_12,B_1_C22_67,D3_IPF_C2_72,A7_3_C15_1,D3_HOS_C3_60,E_A_HOS_C1_72,D1_HOS_C1_56,D3_IRF_C3_71,TRNSMTL_NUM,B_1_C26_109,D_4_HOS_C12_58,A_C6_105,C_1_C6_115,B_1_C22_43,A_C2_9920,D_5_HOS_C7_53,A_C2_54,S10_C1_18,D3_HOS_C2_61,S3_1_C14_1,A7_1_C3_6,D3_HOS_C3_98,D_3_HOS_C3_200,D_4_HOS_C3_64,A_C2_30,D_4_HOS_C11_67,S10_C1_21,D_4_HOS_C2_63,D_5_HOS_C3_58,A_C1_109,C_1_C5_30,D_5_HOS_C2_66,D_5_HOS_C7_76,D_5_HOS_C7_90,D_4_HOS_C12_96,D_5_HOS_C4_57,S3_2_C4_2553,S2_1_C3_3,FY_END_DT,S3_2_C6_13,S3_1_C6_25,B_1_C21_45,D3_IPF_C2_75,S4_HHA2_C2_38,D_4_IRF_C13_50,D_4_IRF_C13_63,D_5_HOS_C3_63,D3_HOS_C2_94,D3_IPF_C2_56,D_4_IRF_C13_70,D3_SNF_C3_93,S2_1_C1_86,G_C1THRU4_45,B_2_C26_35,B_1_C22_90,D3_IRF_C3_93,C_1_C6_117,A_C6_60,D_4_HOS_C11_9201,S3_1_C3_8,A_C2_94,D_4_HOS_C3_94,B_2_C0_202,D3_HOS_C2_51,B_1_C26_56,B_1_C0_51,C_1_C5_64,D_5_HOS_C2_60,B_1_C21_70,D3_IPF_C3_58,A_C2_71,S3_1_C2_11,S2_1_C1_85,S3_2_C2_22,S3_1_C3_10,A_C2_193,B_1_C0_44,C_1_C7_91,D_4_HOS_C3_93,D_5_HOS_C2_64,D3_SNF_C2_90,B_1_C21_192,D_4_SNF_C11_50,D_3_HOS_C9_34,S5_C4_1,A7_3_C7_2,D_1_HOS_C7_41,A7_1_C1_5,D_4_HOS_C3_69,S3_1_C7_17,S2_1_C1_115,S3_1_C6_12,D_4_IRF_C13_56,D3_IRF_C2_67,A_C6_9,S2_1_C6_24,C_1_C5_90,S5_C2_7,S3_2_C6_37,D3_IPF_C3_93,D3_IRF_C2_90,D_4_HOS_C4_200,S3_1_C7_8,A_C6_190,D_4_IRF_C11_54,D_5_HOS_C5_67,D3_IPF_C2_91,E_B_HOS_C1_37,B_2_C26_33,D3_IRF_C3_76,B_1_C22_70,B_1_C0_73,S2_1_C1_27,A_C1_75,B_2_C26_194,C_1_C5_52,E_B_HOS_C1_40,S2_1_C2_1807,A_C1_114,E_B_HOS_C101_2,D3_HOS_C3_70,S4_HHA2_C5_36,S3_2_C2_37,D_4_HOS_C3_74,S3_2_C4_38,C_1_C6_61,D_5_HOS_C7_69,A7_1_C7_10,D_4_IPF_C13_75,S3_2_C5_39,D3_SNF_C2_76,D_4_HOS_C4_71,D_5_HOS_C2_50,S2_1_C1_3601,S3_2_C4_5,B_1_C0_42,S3_1_C2_10,A8_C2_25,D_4_IRF_C13_68,D_5_HOS_C5_64,G_C1THRU4_11,D3_IPF_C3_68,D_4_IRF_C11_66,C_1_C6_106,A_C2_35,D_4_IPF_C6_200,D1_HOS_C1_41,S2_1_C2_1803,C_1_C7_59,S10_C1_19,S3_2_C4_28,C_1_C7_9201,A_C1_65,D_4_HOS_C10_66,B_1_C22_192,A_C6_2,B_1_C21_50,C_1_C5_93,S3_2_C2_2551,A_C2_63,A_C2_60,S3_2_C2_2552,D_4_IPF_C13_62,A_C6_99,B_1_C0_69,S3_1_C7_26,D_5_HOS_C3_9201,D3_IPF_C2_35,D3_IPF_C3_75,S2_1_C1_132,D_4_SNF_C11_67,C_1_C7_97,A_C6_113,D_4_HOS_C2_73,S3_2_C4_2,S3_1_C11_24,C_1_C6_95,C_1_C6_98,D_4_HOS_C12_54,S3_2_C6_33,A_C6_74,D_4_IPF_C11_74,D3_IRF_C2_96,A_C1_32,D_5_HOS_C3_72,D_4_HOS_C2_88,A7_3_C7_3,D_4_HOS_C2_93,D3_SNF_C2_62,D3_IPF_C3_76,D_4_HOS_C13_68,B_1_C0_59,FFY,Hospital Type (From CMS Hospitals Data Archive),Name and Num
,Curated Name and Num,Hospital type (modified),Type of Control of Hospital (See Table I),Lon,Lat,OPPS payments,Recovery Room,Excluded Area Salaries,Nonpaid Workers,Ambulance Services,Int & Res (non approved teaching program,Cardiac Catheterization,Home Program Dialysis,"Gift, Flower, Coffee Shop, Canteen",Operating Room,Central Services and Supply,Burn Intensive Care Unit,Radiology-Therapeutic,Renal Dialysis,OPT,FQHC,Total,Delivery Room and Labor Room,Transitional corridor payment,Number of periods hospital was in MDH status,Radiology-Therapeutic,Observation Beds (Distinct Unit),Electroencephalography,CT Scan,SNF,FQHC 8 Provider Number,Cardiac Catheterization,Fixed Equipment,Home Program Dialysis,Organ acquisition charges,Hospital Adults & Pediatrics,Total,CT Scan,Operating Room,"Blood Storing, Processing, Trans",Nonphysician Anesthetists,HHA,Whole Blood & Packed Red Blood Cells,Subprovider-IPF,Cardiac Catheterization,Lung  Acquisition,Physician-Part A,HHA,Anesthesiology,Occupational Therapy,Electroencephalography,Prepaid expenses,Interns & Residents,Radioisotope,Recovery Room,Other Reimbursable,Renal Dialysis,"Blood Storing, Processing, Trans",Other Ancillary,Medical Supplies Charged to Patients,Land Improvements,Operating Room,NF,New Cap Related Csts Bldg & Fixtures,Physical Therapy,Durable Medical Equipment Rented,SNF,Electrocardiology,Home Office Salaries,Subprovider II,Respiratory Therapy,TOTAL,Ambulance Services,ASC (Non Distinct Part),MRI,Physicians' Private Office,Net revenue from state/local govt indigent care (not Medicaid or CHIP),Medical Supplies Charged to Patients,Cafeteria,Intensive Care Unit,Protested amounts,W/Out Outliers:  Number of Episodes,Electroencephalography,Delivery Room and Labor Room,Cafeteria,Laboratory,RHC,Intravenous Therapy,Pharmacy,Total reasonable charges,Laboratory,Medical Supplies Charged to Patients,OSP,Total Number of Outlier Episodes,Burn Intensive Care Unit,Home Program Dialysis,Speech Pathology,Laboratory,Coronary Intensive Care Unit,Medical Supplies Charged to Patients,Radioisotope,NF,SNF,Wage Related Costs RHC/FQHC,Coronary Intensive Care Unit,Non-Physician Anesthetist Part B,Total,"Blood Storing, Processing, Trans",Total,Durable Medical Equipment Rented,RHC 23 Provider Number,Operation of Plant,Burn Intensive Care Unit,Radiology-Diagnostic,FQHC 2 Provider Number,Total Adults & Pediatrics,Electroencephalography,Without Outliers:  Non Routine Med Sup Chgs,Other Ancillary,Pharmacy,Interim payments,Renal Dialysis,Whole Blood & Packed Red Blood Cells,Ambulance Trips,Surgical Intensive Care Unit,Impl. Dev. Charged to Patients,Social Service,Adults and Pediatrics,Operating Room,Medicare Certified Pancreas TC term date,New Cap Related Csts Bldg & Fixtures,OSP,Physical Therapy,ASC (Distinct Part),Teaching Physician Salaries,W/Out Outliers:  Number of Episodes,Total Program Excludable Costs,Respiratory Therapy,Liver Acquisition,Whole Blood & Packed Red Blood Cells,ICF,Whole Blood & Packed Red Blood Cells,Intravenous Therapy,Ancillary service other pass through costs,Occupational Therapy,Radiology-Diagnostic,Coronary Care Unit,"Number of patients in program at 
end of cost reporting period",Clinic,Surgical Intensive Care Unit,Intestinal Acquisition,Clinic,Renal Dialysis,Total Charges,Other Outpatient Services,Speech Pathology,"Blood Storing, Processing, Trans",RHC 18 Provider Number,Radiology-Therapeutic,Intestinal Acquisition,Total,Coronary Care Unit,Impl. Dev. Charged to Patients,TOTAL,Adults & Pediatrics,Total Other Charges,Total,HHA,Total,Delivery Room and Labor Room,Administrative and General under Contract,Cardiac Catheterization,HVBP payment adjustment amount,Intensive Care Unit,Liver Acquisition,"Is this a New Hospital under
42 CFR 412.300 PPS capital
(Y/N)",Laboratory,ASC (Distinct Part),Radiology-Therapeutic,Other Special Purpose,Housekeeping,Nonpaid Workers,Operation of Plant,Cost of physicians svcs in a teaching hospita,Medicare allowable bad debts for the entire hospital complex,Radiology-Diagnostic,MRI,Other Special Care,NF,Investment Income-New Movable Equip,Utilization Review SNF,OOT,Dietary,Cardiac Catheterization,FI/Contractor's Name,Delivery Room and Labor Room,Whole Blood & Packed Red Blood Cells,Burn Intensive Care Unit,"Blood Storing, Processing, Trans",Medicare Certified Kidney TC term date,Buildings and Fixtures,Durable Medical Equipment Rented,City,Operation of Plant,OLTC,Subprovider II,MRI,Intestinal Acquisition,Interns & Residents,Cardiac Catheterization,Dietary under contract,Anesthesiology,Laboratory,Intravenous Therapy,Lung  Acquisition,Electrocardiology,Laundry and Linen Service,Other Reimbursable,Electrocardiology,Impl. Dev. Charged to Patients,Recovery Room,Total discharges,Radiology-Therapeutic,Burn Intensive Care Unit,Drugs Charged to Patients,Pharmacy,Movable Equipment,ICF,Laboratory,IPF,Pancreas Acquisition,Other Special Care Unit,Impl. Dev. Charged to Patients,Non-Physician Anesthetist Part B,Blood Clotting Factors for Hemoph.,Durable Medical Equipment Sold,"Number of patients in program at 
end of cost reporting period",Burn Intensive Care Unit,Durable Medical Equipment Sold,"Number of days in year dialysis 
furnished",Other Reimbursable,Electrocardiology,PEP Episodes:  Other Charges,Observation Beds (Distinct Unit),Total Hospital,Number of stations,Housekeeping,PEP Episodes:  Total Charges:,Electroencephalography,Medical Supplies Charged to Patients,Radiology-Therapeutic,Surgical Intensive Care Unit,Ambulance Services,Total,Total Program Excludable Costs,ICF,Speech Pathology,Physical Therapy,ASC (Distinct Part),MRI,ASC (Non Distinct Part),Subtotal,Total Salaries,Total Hospital,ASC (Non Distinct Part),Total Nursing School,Other Outpatient Services,Other Ancillary,Electrocardiology,Burn Intensive Care Unit,Interns & Residents,HHA,Hospice,RHC,Maintenance and Repairs,Subprovider-IRF,Liver Acquisition,Delivery Room and Labor Room,Total Inpatient Program Days,Accounts Payable,HHA,Buildings,CORF,Administrative and General,"Blood Storing, Processing, Trans",Clinic,Subtotal,Respiratory Therapy,Notes Payable,Outpatient Rehab Provider,Operating Room,MRI,Laundry and Linen Service,Cost of patients approved for charity care and uninsured discounts,Other Special Purpose,Physician Part B,Other Reimbursable,Utilization Code (L/N/F),Adults & Pediatrics,Laboratory,MRI,Operating Room,Other Reimbursable,FQHC,Transitional corridor payment,Operating Room,Excluded Area Salaries,HHA,Radiology-Therapeutic,Respiratory Therapy,Occupational Therapy,PEP Episodes:  Total Number of Episodes,ASC (Non Distinct Part),HHA,Other Outpatient Services,Subprovider I,Renal 7 Provider Number,RHC/FQHC Combined,Anesthesiology,Respiratory Therapy,Nursing School,Emergency,NF,Blood Clotting Factors for Hemoph.,Renal 2 Provider Number,Occupational Therapy,Emergency,Speech Pathology,Medical Supplies Charged to Patients,OLTC,Total Other Expenses,Hospice,Less Observation Beds,Radiology-Therapeutic,Durable Medical Equipment Sold,PEP:  Total Non Routine Med Supply Chgs,Liver Acquisition,Electrocardiology,Medical Supplies Charged to Patients,Hospice,Anesthesiology,Respiratory Therapy,Clinic,Respiratory Therapy,Cost of charity care (patients covered by public program + patients w/ coverage accepted by provider),Respiratory Therapy,"If (SCH), enter the # of periods.",Intravenous Therapy,Occupational Therapy,Other Special Care,W/Out Outliers:  Number of Episodes,Laundry and Linen Service,Movable Equipment,Hospice,Observation Beds (Distinct Unit),Anesthesiology,Administrative and General,Durable Medical Equipment Rented,MDH status ending date (MM/DD/YY),Housekeeping under contract,Drugs Charged to Patients,Buildings and Fixtures,Hospital Adlts & Ped Swing Bed NF,Operating Room,Emergency,Total Program General Inp. Rtn Service,Subtotal Salaries,Drugs Charged to Patients,Speech Pathology,Without Outliers:  Non Routine Med Sup Chgs,Total Nursing School,Employee Benefits,Pharmacy,Dietary,Nursery,OLTC,Burn Intensive Care Unit,IRF Provider Number,Coronary Care Unit,Radiology-Diagnostic,Coronary Care Unit,Medicare Certified Lung TC term date,CT Scan,Respiratory Therapy,Laboratory,Durable Medical Equipment Sold,Total,Laundry and Linen Service,Other Reimbursable,Management and Administrative Services,Impl. Dev. Charged to Patients,Impl. Dev. Charged to Patients,Intravenous Therapy,Major Movable Equipment,Net Income,Other Reimbursable,Interns & Res Other Program Costs,Social Service,Laboratory,Whole Blood & Packed Red Blood Cells,Electroencephalography,Delivery Room and Labor Room,Electroencephalography,Intravenous Therapy,Title XVIII discharges,RHC 21 Provider Number,"Gift, Flower, Coffee Shop, Canteen",NF,Without Outliers:  Other Charges,Title XIX discharges,Physical Therapy,Anesthesiology,Home Program Dialysis,Total Non Routine Medical  Supply Charges,Burn Intensive Care Unit,Durable Medical Equipment Rented,MRI,Electroencephalography,Home Office Salaries & Wage Related Csts,Electrocardiology,Total Charges:  LUPA Episodes,Premiums,Total Income,Renal Dialysis,Radiology-Therapeutic,MRI,Nonpaid Workers,CT Scan,Interns & Residents,Medical and Other Services,Clinic,Other Ancillary,In State Medicaid paid days,Physical Therapy,Other Ancillary,Total Other Medical Education,Radioisotope,Total Visits,Burn Intensive Care Unit,Intensive Care Unit,Surgical Intensive Care Unit,Drugs Charged to Patients,Wage Related Costs Core,Whole Blood & Packed Red Blood Cells,Occupational Therapy,SNF,Home Office Personnel,Subprovider-IPF,Radiology-Diagnostic,PEP Episodes:  Total Charges:,Observation Beds (Distinct Unit),Delivery Room and Labor Room,Surgical Intensive Care Unit,HMO,Coronary Care Unit,Adults & Pediatrics,Electrocardiology,Medical Records & Med Records Library,Ratio of line 15 to line 16,Other Long-term Liabilities,Intestinal Acquisition,Title XIX discharges,Emergency,Emergency,Labor and Delivery Days -  Title XIX,Emergency,Durable Medical Equipment Rented,Building Improvements,MRI,FQHC,Total,IRF,Radioisotope,SNF,Renal Dialysis,Fixed Equipment,Total,Refunds and Rebates of Expenses,"Does the facility qualify and is it receiving payments for 
disproportionate share? (Y/N)",Burn Intensive Care Unit,Other Special Care Unit,Lung  Acquisition,FQHC 1 Provider Number,Other Reimbursable,Hospice,OLTC,OLTC,Balance due provider/program,Coronary Care Unit,Subprovider I,Title XVIII discharges,Operating Room,Subtotal Wage Related Csts,PBP Clinical Lab Services Program Only,Cardiac Catheterization,Total,Radiology-Diagnostic,Other Organ Acquisition,Durable Medical Equipment Rented,Land Improvements,Islet Acquisition,Payment to cost ratio,NF,Renal Dialysis,Operation of Plant,Lesser of cost or charges,Subprovider-IPF,Laboratory,Total discharges,CT Scan,OLTC,FQHC,Impl. Dev. Charged to Patients,Nursing School,Observation Beds (Distinct Unit),Total,Contract Labor,ICF,Intravenous Therapy,Subtotal,ASC (Non Distinct Part),Out of State Medicaid paid days,Program Discharges,Pancreas Acquisition,Renal Dialysis,Total,Does the facility operate an ICF/MR facility for purposes of Title XIX? (Y/N),SNF,Adj for Physical therapy costs in excess,Int & Res (non approved teaching program,Coronary Care Unit,Heart Acquisition,Physicians' Private Office,Anesthesiology,Other General Service,Subprovider-IRF,Radiology-Therapeutic,Recovery Room,Non-Physician Anesthetist Part B,"Blood Storing, Processing, Trans",Total,Observation Beds (Distinct Unit),Radiology-Therapeutic,Subtotal,Research,Radiology-Therapeutic,Interns & Res Other Program Costs,Heart Acquisition,Burn Intensive Care Unit,Physician-Part B,Subprovider-IRF,Respiratory Therapy,Other Special Care Unit,Net Patient Revenue,Intravenous Therapy,Other Outpatient Services,Physician Part B,Land,Clinic,Physician Part A,Operation of Plant,Other Ancillary,Observation Beds (Distinct Unit),Organ Procurement,Total Allied Health,Other Special Care,Emergency,Operating Room,Nursing Administration,interns and residents,Speech Pathology,Total Adults & Peds,Subprovider 1,Whole Blood & Packed Red Blood Cells,Total,Total Visits,Burn Intensive Care Unit,Cafeteria,Blood Clotting Factors for Hemoph.,Intravenous Therapy,SNF,Observation Beds (Distinct Unit),ASC (Non Distinct Part),Delivery Room and Labor Room,Respiratory Therapy,Radiology-Diagnostic,CT Scan,Amounts expected under 42 CFR,Land Improvements,Cost of charity care,Land Improvements,OLTC,Employee Benefits,Cafeteria employees and guests,Utilization Review - Physician Compen,Total Salaries,Other Reimbursable,Other Ancillary,Subprovider I,Occupational Therapy,Adjusted reimburseable bad debts,Impl. Dev. Charged to Patients,Adj for Respiratory therapy costs in excess,Coronary Care Unit,Operating Room,Respiratory Therapy,CMHC,MRI,Management and Administrative Services,Other Special Care Unit,Physicians' Private Office,Total,Respiratory Therapy,Clinic,Other Outpatient Services,Other Nonreimbursable,Emergency,Other Special Care Unit,Other General Service,Physician-Part A,Dietary under Contract,Durable Medical Equipment Sold,NF,Recovery Room,Hospital Title 18 Payment System (P/T/O),"Blood Storing, Processing, Trans",Social Service,"Medical certified liver 
transplant center cert date",Total Bad Debt expense,Electroencephalography,Recovery Room,Physical Therapy,Total Hospital,Administrative and General under Contract,SNF,RHC 4 Provider Number,Respiratory Therapy,Other Ancillary,Medical Supplies Charged to Patients,Nursery,Rental of Provider space by suppliers,MRI,Land,Intestinal Acquisition,Emergency,Intensive Care Unit,CT Scan,Total Subprovider I Interns & Residents,LUPA Episodes:  Total Visits,Electrocardiology,Other Ancillary,Cafeteria,Cardiac Catheterization,PBP Clinical Lab Services Program Only,Total Other Assets,Speech Pathology,Organ Procurement,Intensive Care Unit,Total Nonphysician Anesthetist Cost,Total,Physical Therapy,Medical Supplies Charged to Patients,RHC/FQHC Combined,Accounts Receivable,Durable Medical Equipment Rented,Islet Acquisition,Drugs Charged to Patients,Paramedical Education,MRI,Cross Foot Adjustments,Emergency,Total Charges,Contract Labor: Pysician Part A,OSP,Burn Intensive Care Unit,Blood Clotting Factors for Hemoph.,Other Organ Acquisition,Cardiac Catheterization,Radiology-Diagnostic,Delivery Room and Labor Room,Islet Acquisition,Component rate ESRD,Coronary Care Unit,Total,Electroencephalography,Maintenance of Personnel,Cardiac Catheterization,Speech Pathology,Clinic,Other Outpatient Services,Electrocardiology,Electrocardiology,Other Nonreimbursable,Notes Receivable,Radioisotope,Total,Total,Drugs Charged to Patients,With Outliers:  Total Visits,Blood Clotting Factors for Hemoph.,Radioisotope,"Blood Storing, Processing, Trans",RHC,Total Facility FTEs,Occupational Therapy,Home Office Salaries,Electrocardiology,Occupational Therapy,PEP Episodes:  Total Visits,PEP:  Total Number of Outlier Episodes,Anesthesiology,Interns & Residents,Total,RHC 3 Provider Number,Operating Room,LUPA:  Total Non Routine Med Sup Chgs,Other Organ Acquisition,Heart Acquisition,Medical Supplies Charged to Patients,Total Swing Bed Cost,New Cap Related Csts Bldg & Fixtures,Emergency,Dietary,Total Allied Health,Building Improvements,Impl. Dev. Charged to Patients,Clinic,State or local govt (not Medicaid or CHIP) -- Costs minus net revenue (0 min),Total,Other Current Liabilities,Allowable bad debts,Physical Therapy,CT Scan,RHC 15 Provider Number,Renal 5 Provider Number,Subprovider-IRF,Whole Blood & Packed Red Blood Cells,Payments received from patients for amounts previously written off as charity care,OOT,SNF,Drugs Charged to Patients,PEP:  Total Number of Outlier Episodes,Drugs Charged to Patients,Other Ancillary,Recovery Room,certification date,Medical Records and Medical Rec. Library,"Blood Storing, Processing, Trans",Kidney Acquisition,Negative Cost Centers,Physical Therapy,Wage Related Costs RHC/FQHC,Central Services and Supply,Other Ancillary,Liver Acquisition,Electroencephalography,RHC 11 Provider Number,Radiology-Therapeutic,Electroencephalography,Recovery Room,Charity care charges and uninsured discounts for the entire facility,Total Liabilities and Fund Balances,Clinic,MDH status beginning date  (MM/DD/YY),Blood Clotting Factors for Hemoph.,Physicians' Assistant,MRI,Heart Acquisition,Other Reimbursable,Renal Dialysis,Total Allied Health Cost,Excluded Area Salaries,Hospital Adults & Pediatrics,Durable Medical Equipment Rented,"Blood Storing, Processing, Trans",Radioisotope,Land,MRI,Operation of Plant,Radioisotope,"Blood Storing, Processing, Trans",Delivery Room and Labor Room,Cardiac Catheterization,Observation Beds (Distinct Unit),Other Ancillary,Excess of customary charges,Interest Expense,Radioisotope,CT Scan,NF,RPCH/CAH Visits,SNF,Housekeeping under contract,OSP,"Blood Storing, Processing, Trans",Whole Blood & Packed Red Blood Cells,Surgical Intensive Care Unit,Impl. Dev. Charged to Patients,ASC (Distinct Part),Subprovider II,Anesthesiology,Net Salaries,Impl. Dev. Charged to Patients,Central Services and Supply,Other Nonreimbursable,Speech Pathology,MRI,Intensive Care Unit Program Cost,Durable Medical Equipment Sold,Subprovider 2,Without Outliers:  Total Visits,Whole Blood & Packed Red Blood Cells,Recovery Room,Observation Beds (Distinct Unit),Medical Records and Medical Rec. Library,Observation Beds (Distinct Unit),Non-Physician Anesthetist Part A,Total Other Medical Education,HHA 2 Provider Number,Impl. Dev. Charged to Patients,Research,Physical Therapy,Organ Procurement,Total Salaries,Electrocardiology,Bonus Payment,"Number of patients in program at 
end of cost reporting period",ASC (Non Distinct Part),Electrocardiology,Speech Pathology,Heart Acquisition,Home Program Dialysis,Pancreas Acquisition,Report Status Code,Other Special Care Unit,OOT,Other Outpatient Services,Other Outpatient Services,PBP Clinical Lab Services Program Only,MDH status ending date (MM/DD/YY),HHA,Durable Medical Equipment Sold,Subprovider I,Coronary Care Unit,Lung  Acquisition,Interns & Residents,Non-Physician Part B,Intravenous Therapy,CMHC,Respiratory Therapy,Related  Salaries,"Blood Storing, Processing, Trans",MRI,Other Special Care Unit,LUPA Episodes:  Other Charges,Nonpaid Workers,Impl. Dev. Charged to Patients,Respiratory Therapy,Administrative and General,CMHC,Total unreimbursed and uncompensated care,"Anesthetist, and Medical Education Costs",Dietary,CT Scan,Operating Room,Radiology-Therapeutic,Subprovider I,LUPA Episodes:  Total Number of Episodes,Operating Room,OLTC,Laboratory,Number of stations,Anesthesiology,Total Other Income,Electrocardiology,Title XVIII discharges,Radiology-Therapeutic,Without Outliers:  Total Visits,Nursery,net of Swing Bed Cost,Cafeteria,Other Reimbursable,Interns & Residents,Occupational Therapy,Drugs Charged to Patients,Total charges to state or local government programs for indigent care (not Medicaid or CHIP),Intravenous Therapy,RHC,Radioisotope,CT Scan,Stand-alone CHIP cost,New Capital Buildings and Fixtures,Radiology-Diagnostic,Physical Therapy,Land,net of Swing Bed Cost,Hospital County,CORF,Physical Therapy,Intravenous Therapy,Recovery Room,"Blood Storing, Processing, Trans",Contract Labor,Whole Blood & Packed Red Blood Cells,Anesthesiology,Durable Medical Equipment Sold,Whole Blood & Packed Red Blood Cells,"Number of Times per week
 Patient receives Dialysis","Average patient dialysis time 
including setup",Recovery Room,CORF,Telephone Services,Islet Acquisition,FQHC,Home Office Salaries,MRI,Electroencephalography,Recovery Room,"Blood Storing, Processing, Trans",Electroencephalography,CMHC,"Blood Storing, Processing, Trans",Ambulance Services,Other adjustments,Physical Therapy,Electrocardiology,"Sum of lines 3,4 divided by line 6",Sequestration adjustment,RHC 20 Provider Number,Buildings and Fixtures,Cardiac Catheterization,Durable Medical Equipment Sold,Radioisotope,Observation Beds (Distinct Unit),Paid Losses,Recovery Room,Subprovider 1,Other Organ Acquisition,OPT,Liver Acquisition,Whole Blood & Packed Red Blood Cells,"Number of days in year dialysis 
furnished",Whole Blood & Packed Red Blood Cells,ICF,Program Inpatient Ancillary Service Cost,New Capital Buildings and Fixtures,or allied health costs?,Other Reimbursable,Other Ancillary,Subtotal Salaries,Other Organ Acquisition,Home Office:  Physician Part A,Medical Supplies Charged to Patients,Coronary Care Unit,ASC (Non Distinct Part),Other Reimbursable,Total Number of Outlier Episodes,Notes and Loans Payable (short term),Emergency,Administrative and General,Electroencephalography,Islet Acquisition,HHA,Number of Times per week Patient receives Dialysis,Drugs Charged to Patients,Electroencephalography,Subprovider-IPF,Speech Pathology,Radioisotope,Impl. Dev. Charged to Patients,Total Assets,Nonphysician Anesthetists,"Gift, Flower, Coffee Shop, Canteen",Whole Blood & Packed Red Blood Cells,Respiratory Therapy,Laboratory,Durable Medical Equipment Rented,FQHC 5 Provider Number,Impl. Dev. Charged to Patients,Renal Dialysis,"Salaries, Wages, and Fees Payable",Radiology-Diagnostic,Medical Records and Medical Rec. Library,Cost To Charge Ratio,Title XVIII discharges,Other Outpatient Services,Radioisotope,"Does this facility operate 
transplant center? (Y/N)",Movable Equipment,Total Salaries,Electrocardiology,Anesthesiology,Other Special Care Unit,Burn Intensive Care Unit,Sale of medical and surgical supplies to,Total,Home Program Dialysis,Does the hospital qualify as RPCH/CAH? (Y/N),Paramedical Education,Adj for Speech therapy in excess of lim,Respiratory Therapy,Recovery Room,Home Program Dialysis,Impl. Dev. Charged to Patients,Kidney Acquisition,Radioisotope,Nursing Administration,Observation Beds (Distinct Unit),Emergency,Renal Dialysis,Dietary,Other General Service,Subprovider II,Labor and Delivery Days -  Title XIX,CT Scan,PBP Clinical Lab Services Program Only,"Treatment capacity per day per
station",Drugs Charged to Patients,Speech Pathology,IPF,Radiology-Therapeutic,Delivery Room and Labor Room,Mortgage Payable,Subprovider I,Subprovider II,Donations,NF,Coronary Intensive Care Unit,Self Insurance,Dietary,NF,Respiratory Therapy,Total Hospital,With Outliers:  Other Charges,Durable Medical Equipment Rented,Emergency,net of Swing Bed Cost,Emergency,Other Special Care Unit,Renal Dialysis,Title XIX discharges,CMHC,Medical Supplies Charged to Patients,Other Special Care Unit,Housekeeping,Subtotal,Lung  Acquisition,Medical Supplies Charged to Patients,Electrocardiology,Nursing School,Impl. Dev. Charged to Patients,Impl. Dev. Charged to Patients,Emergency,Electrocardiology,Adults & Pediatrics,Radiology-Diagnostic,Durable Medical Equipment Rented,Cardiac Catheterization,Blood Clotting Factors for Hemoph.,net of Swing Bed and Private Room Diff,Respiratory Therapy,Emergency,Social Service,Emergency,Radiology-Diagnostic,Renal Dialysis,Other Nonreimbursable,Without Outliers:  Total Visits,Nursing Administration,New Capital Buildings and Fixtures,Intensive Care Unit,Title XVIII discharges,"Blood Storing, Processing, Trans","Gift, Flower, Coffee Shop, Canteen",Int & Res (non approved teaching program,Intensive Care Unit,Surgical Intensive Care Unit,Other Outpatient Services,Teaching Physician Salaries,Delivery Room and Labor Room,Cafeteria,Emergency,Title XVIII discharges,LUPA Episodes:  Total Visits,Operating Room,ASC (Distinct Part),Intravenous Therapy,Surgical Intensive Care Unit,Hospital Adlts & Ped Swing Bed SNF,Durable Medical Equipment Sold,Renal Dialysis,Intensive Care Unit,RHC 22 Provider Number,Surgical Intensive Care Unit,Other Nonreimbursable,Recovery Room,Other Adjustments (Summed),Other Special Purpose,RHC/FQHC Combined,Total Allied Health,Other Outpatient Services,Emergency,Islet Acquisition,NF,Anesthesiology,Net Revenue from Medicaid,Physicians' Private Office,HMO,OPPS payments,Operating Room,Respiratory Therapy,Operating Room,net of Swing Bed and Private Room Diff,Islet Acquisition,Maintenance of Personnel,ASC (Non Distinct Part),New Capital Equipment,Radiology-Therapeutic,Housekeeping,Subprovider-IPF,Radiology-Therapeutic,Electroencephalography,Other Special Care Unit,Cardiac Catheterization,IPF,Observation Beds (Distinct Unit),Operating Room,Other Ancillary,Subprovider II,Total Hospital,MRI,Radioisotope,Laundry and Linen Service,Delivery Room and Labor Room,RHC,OPT,Total Costs,Medical Records & Med Records Library,Coronary Care Unit,SNF Provider Number,Electroencephalography,Non-Physician Anesthetist Part B,Total Program General Inpatient Routine,"Sum of lines 3,4 divided by line 6",Drugs Charged to Patients,Recovery Room,Anesthesiology,Intravenous Therapy,Excluded Area Salaries,Durable Medical Equipment Sold,Impl. Dev. Charged to Patients,Home Program Dialysis,Total Program Inpatient Costs,MCP Physician Payment Method (Y/N),Occupational Therapy,HRR adjustment amount ,Received DSH or supplemental payments from Medicaid? (Y/N),ASC (Non Distinct Part),Speech Pathology,Excess of reasonable cost over reasonable charges,Medical Supplies Charged to Patients,With Outliers:  Total Visits,ASC (Non Distinct Part),OLTC,Emergency,Medical Records & Med Records Library,Administrative and General,SNF,Impl. Dev. Charged to Patients,Intravenous Therapy,ASC (Distinct Part),Hospice,Clinic,Less: Allowances for uncollectible notes and accounts receivable,RHC,Drugs Charged to Patients,"Number of patients on transplant 
list",Whole Blood & Packed Red Blood Cells,Non-Physician Part B,"Blood Storing, Processing, Trans",Interns & Residents,Inventory,Research,Maintenance of Personnel,LUPA:  Total Non Routine Med Sup Chgs,RHC 17 Provider Number,Negative Cost Centers,"Number of Times per week 
Patient receives Dialysis",Intensive Care Unit,CORF,Organ Procurement,Durable Medical Equipment Rented,Other Ancillary,ICF,Average times dialyzers re-used,Radiology-Therapeutic,Excluded Area Salaries,Other Special Purpose,Radiology-Diagnostic,Occupational Therapy,Subprovider-IPF,CT Scan,Other Reimbursable,Cardiac Catheterization,MRI,Total,Blood Clotting Factors for Hemoph.,Anesthesiology,"Blood Storing, Processing, Trans",Without Outliers:  Non Routine Med Sup Chgs,Physical Therapy,Total Salaries,Sale of medical records and abstracts,With Outliers:  Number of Episodes,Laboratory,New Cap Related Csts Bldg & Fixtures,"Number of Times per week
 Patient receives Dialysis",SNF,Radiology-Diagnostic,Deductibles and coinsurance related to line 24,Liver Acquisition,Pass Through Cost for  Program Ancillary,Cardiac Catheterization,Durable Medical Equipment Rented,Home Program Dialysis,Other Outpatient Services,MRI,With Outliers:  Other Charges,Anesthesiology,Respiratory Therapy,General Fund Balance,Burn Intensive Care Unit,Subtotal,Other Ancillary,Occupational Therapy,Adults & Pediatrics,ASC (Non Distinct Part),Renal Dialysis,Coronary Care Unit,Recovery Room,Total Visits,Without Outliers:  Other Charges,Clinic,Operating Room,Net Income from Service to Patients,Adj for Occupational therapy in excess of li,Delivery Room and Labor Room,Subprovider 2,Utilization Review SNF,Whole Blood & Packed Red Blood Cells,Hospital PO Box,With Outliers:  Total Charges,Physician Part B,MRI,Medicaid HMO Days,Recovery Room,Medical Supplies Charged to Patients,Pancreas Acquisition,Depreciation-New Movable Equipment,Total costs for patients covered by a state or local government program,Ambulance Services,Blood Clotting Factors for Hemoph.,OSP,Delivery Room and Labor Room,With Outliers:  Non Routine Med Sup Chgs,Cost of patients approved for charity care and uninsured discounts,Pass through Cost for Program Inpatient,Anesthesiology,Respiratory Therapy,Total Liabilities,Medicaid charges,Total Number of Episodes,"Trade, Quantity, and Time Discounts",Renal 10 Provider Number,Subprovider II,Hospice,Other Special Care Unit,Social Service,SNF,Electrocardiology,Hospice,CMHC,Medical and Other Services reimbursed by OPPS,Home Office Salaries & Wage Related Csts,Other Special Care,OLTC,TOTAL,PBP Clinical Lab Services Program Only,Excluded Area Salaries,Research,Payment to cost ratio,Other Organ Acquisition,LUPA:  Total Non Routine Med Sup Chgs,Total,Housekeeping,Radiology-Diagnostic,Renal Dialysis,Other Reimbursable,Radioisotope,Total,Excluded Areas,IPF,HHA 3 Provider Number,MDH status beginning date (MM/DD/YY),Delivery Room and Labor Room,IPF Provider Number,Other Outpatient Services,Medical Supplies Charged to Patients,Is this a rural hospital qualifying for an exception to the certified registered nurse anesthetist the CRNA fee schedule? (Y/N),Title V discharges,Interns & Res Salary and Fringe Benefits,Social Service,Total Other Charges,Lung  Acquisition,RHC 13 Provider Number,Observation Beds (Distinct Unit),Anesthesiology,Home Office Salaries & Wage Related Csts,Int & Res (non approved teaching program,Rental of quarters to employee and oths,Wage Related Costs Core,Durable Medical Equipment Sold,Laboratory,Payroll taxes payable,Respiratory Therapy,Total Salaries,Electrocardiology,Pharmacy,Heart Acquisition,NF,Durable Medical Equipment Sold,Physician Part A,"Medicare certified heart
transplant center cert date",CT Scan,Nonpaid Workers,Operating Room,Electroencephalography,Home Office:  Physician Part A,Impl. Dev. Charged to Patients,Delivery Room and Labor Room,Home Program Dialysis,Radiology-Diagnostic,Recovery Room,Labor and Delivery,Other Outpatient Services,"Average patient dialysis time 
including setup",Clinic,Line 2 times line 5,Aggregate amount collected from patients,Other Outpatient Services,Laboratory,Electroencephalography,SNF,Buildings and Fixtures,Drugs Charged to Patients,New Cap Related Csts Movable Equipment,Other Reimbursable,Total Salaries,Primary payer payments,ICF,Coronary Care Unit,Hospice,Other Outpatient Services,Medicare Certified Heart TC term date,Contract Labor:  Physician Part A,Home Program Dialysis,Physical Therapy,Physical Therapy,ASC (Non Distinct Part),PBP Clinical Lab Services Program Only,With Outliers:  Number of Episodes,Total Costs,"Net costs of Epoietin furnished to
all maintenance dialysis patients
by the provider",Building Improvements,Radiology-Diagnostic,ICF,OOT,Heart Acquisition,MRI,Stand-alone CHIP Charges (Gross Revenue),Other Special Care,Other Ancillary,Coronary Care Unit,Electrocardiology,Cardiac Catheterization,ASC (Distinct Part),"Income from imposition of interest, finance",PEP Episodes:  Total Visits,Nursery,OOT,Physical Therapy,Subprovider 2,Occupational Therapy,Net Salaries,Non-Physician Anesthetist Part A,Cafeteria,Radioisotope,Subprovider-IPF,FQHC 6 Provider Number,Other Reimbursable,ASC (Distinct Part),Total Fund Balances,Outlier payments,Total Overhead Costs,Occupational Therapy,Heart Acquisition,Labor and Delivery Days Title 18,Respiratory Therapy,Physical Therapy,Fixed Equipment,Other General Service,Medicare Certified Liver TC term date,CMHC,Whole Blood & Packed Red Blood Cells,Whole Blood & Packed Red Blood Cells,Outpatient Rehab Provider,ASC (Non Distinct Part),Renal Dialysis,Emergency,Recovery Room,Total discharges,Durable Medical Equipment Sold,Laboratory,Leasehold Improvements,Clinic,Contract Labor,Interns & Res Salary and Fringe Benefits,Surgical Intensive Care Unit,Drugs Charged to Patients,Other Ancillary,Burn Intensive Care Unit,Surgical Intensive Care Unit,Intensive Care Unit,Other Organ Acquisition,Title V discharges,Radiology-Therapeutic,"Anesthetist, and Medical Education Costs",Pass through Cost for Program Inpatient,Recovery Room,Speech Pathology,ASC (Non Distinct Part),Hospital Adults & Pediatrics,ASC (Distinct Part),Renal Dialysis,ICF,Cardiac Catheterization,OLTC,Renal 3 Provider Number,Renal Dialysis,Impl. Dev. Charged to Patients,CAPD exchanges per day,Is this hospital classified as a referral center? (Y/N),Medicare Certified Islet TC term date,Speech Pathology,Other Outpatient Services,Subprovider-IPF,Without Outliers:  Total Charges,CT Scan,Durable Medical Equipment Sold,Subtotal,Radiology-Therapeutic,TOTAL,Intestinal Acquisition,Speech Pathology,Intravenous Therapy,MRI,Intensive Care Unit,Physician-Part B,Liver Acquisition,HHA,Home Program Dialysis,Whole Blood & Packed Red Blood Cells,Outpatient Revenue,Social Service,Pancreas Acquisition,Burn Intensive Care Unit Program Cost,"Anesthetist, and Medical Education Costs",CT Scan,Target Amount per Discharge,Cash on Hand and in Banks,Buildings and Fixtures,Total,Medical Records and Medical Rec. Library,Clinic,Program Inpatient Ancillary Service Cost,Subprovider-IPF,RHC,Speech Pathology,Contract Labor,Recovery Room,Paramedical Education,ASC (Non Distinct Part),Drugs Charged to Patients,Intravenous Therapy,Laboratory,Central Services and Supply,Surgical Intensive Care Unit,Coronary Care Unit,Total customary charges,Management and Administrative Services,"Sale of scrap, waste, etc.",Surgical Intensive Care Unit,Cardiac Catheterization,FQHC,IRF,Other Outpatient Services,Subtotal Wage Related Csts,Subprovider-IPF,Fiscal Intermediary Number,Cardiac Catheterization,Wage Related Costs Other,Outpatient Rehab Provider,With Outliers:  Total Charges,Respiratory Therapy,Occupational Therapy,Hospital Provider Number,Impl. Dev. Charged to Patients,Impl. Dev. Charged to Patients,"If an Organ Procurement Organization, enter the OPO number",Cafeteria,Subprovider-IRF,Other Outpatient Services,Physical Therapy,Maintenance and Repairs,Durable Medical Equipment Rented,Total discharges,Medical Supplies Charged to Patients,IPPS Payment amount (unadjusted),Emergency,Laboratory,Gross Revenue,Outlier payments,Nonphysician Anesthetists,Medical Supplies Charged to Patients,Intravenous Therapy,CT Scan,Hospital Name,Operation of Plant,Electrocardiology,Impl. Dev. Charged to Patients,Operating Room,Radioisotope,Other Reimbursable,Cardiac Catheterization,Radioisotope,Anesthesiology,New Cap Related Csts Movable Equipment,Land,Other Organ Acquisition,New Cap Related Csts Movable Equipment,Pass Through Cost for  Program Ancillary,Ambulance Services,Delivery Room and Labor Room,Without Outliers:  Total Charges,Operating Room,Other Outpatient Services,Drugs Charged to Patients,Total,Employee Benefits,Pharmacy,Cardiac Catheterization,Electroencephalography,Medical Supplies Charged to Patients,Radiology-Diagnostic,Interns & Res Salary and Fringe Benefits,Total,Total Facility FTEs,Hospice,CT Scan,OOT,Ambulance Services,PEP:  Total Non Routine Med Supply Chgs,Other Special Purpose,Speech Pathology,Central Services and Supply,Subprovider-IRF,Adults and Pediatrics,Housekeeping,"Gift, Flower, Coffee Shop, Canteen",Subprovider 1,Intravenous Therapy,Other Special Purpose,Physical Therapy,Non-Physician Anesthetist Part B,SNF,Clinic,Blood Clotting Factors for Hemoph.,Radiology-Diagnostic,Radiology-Therapeutic,Hospice,Lung  Acquisition,Temporary Investments,Surgical Intensive Care Unit,Intensive Care Unit,Other Ancillary,RHC 25 Provider Number,Parking Lot,Respiratory Therapy,Medical Supplies Charged to Patients,Observation Beds (Distinct Unit),CORF,Fixed Equipment,"Number of patients in program at 
end of cost reporting period",Kidney Acquisition,RHC 10 Provider Number,Recovery Room,Hospital State,Other Ancillary,Recovery Room,FQHC,Speech Pathology,Ending Date of SCH status,Home Office Salaries & Wage Related Csts,Renal 6 Provider Number,Int & Res (non approved teaching program,Delivery Room and Labor Room,Drugs Charged to Patients,Subtotal Other Wages and Related Csts,"Blood Storing, Processing, Trans",Emergency,Building Improvements,Non-physician Anesthetist,Laundry and Linen Service,Radioisotope,Radioisotope,Radioisotope,Interns & Residents,Non-Physician Anesthetist Part A,Surgical Intensive Care Unit,Begin Balance,Durable Medical Equipment Rented,"Blood Storing, Processing, Trans",Emergency,Drugs Charged to Patients,Physical Therapy,Radiology-Diagnostic,Without Outliers:  Other Charges,Occupational Therapy,Administrative and General,Islet Acquisition,With Outliers:  Non Routine Med Sup Chgs,Whole Blood & Packed Red Blood Cells,Total Hospital,Central Services and Supply,SNF,Total,Intravenous Therapy,Occupational Therapy,Operating Room,Other Capital,Investment Income-New Bldgs & Fixtures,Subprovider-IPF,Observation Beds (Distinct Unit),CAH Visits,Nursery,Other Special Care Unit,Home Office Street,Total Non Routine Medical  Supply Charges,HHA,Other Reimbursable,Land,Subprovider I,Drugs Charged to Patients,"Blood Storing, Processing, Trans",MRI,Intravenous Therapy,Radioisotope,Blood Clotting Factors for Hemoph.,Teaching Physician Salaries,Renal Dialysis,Electrocardiology,Utilization,FQHC 4 Provider Number,OLTC,Impl. Dev. Charged to Patients,SNF,SNF,Int & Res (non approved teaching program,Nonphysician Anesthetists,Operating Room,Intravenous Therapy,Intensive Care Unit,Blood Clotting Factors for Hemoph.,Radiology-Therapeutic,Burn Intensive Care Unit,Radiology-Therapeutic,Recovery Room,Medicaid Observation Days,Interns & Residents,Anesthesiology,Delivery Room and Labor Room,PBP Clinical Lab Services Program Only,Radiology-Therapeutic,Renal 1 Provider Number,Renal Dialysis,"Blood Storing, Processing, Trans",Depreciation-New Bldgs & Fixtures,Radiology-Diagnostic,Home Office:  Physician Part A,"Blood Storing, Processing, Trans",Contract Labor:  Physician Part A,Blood Clotting Factors for Hemoph.,ASC (Non Distinct Part),Anesthesiology,Beginning Date of SCH status,Home Program Dialysis,Physical Therapy,Whole Blood & Packed Red Blood Cells,Total Charges,FQHC,Whole Blood & Packed Red Blood Cells,Radiology-Therapeutic,"Epoietin amount form worksheet A
for home dialysis program",LUPA Episodes:  Total Number of Episodes,Subprovider-IPF,Program Inpatient Ancillary Service Cost,Physician-Part A,Physical Therapy,Total discharges,Administrative and General,Hospice,Other Outpatient Services,Excluded Area Salaries,"Blood Storing, Processing, Trans",Nursing School,"If this facility qualifies as a RPCH/CAH, has it elected the all inclusive payment for outpatient service? (Y/N)",Administrative & General under contract,Speech Pathology,Total,Clinic,Clinic,Home Program Dialysis,Radiology-Therapeutic,Medical Supplies Charged to Patients,Home Office Personnel,Observation Beds (Distinct Unit),HHA,IPF Provider Number,Related Salaries,Home Program Dialysis,Delivery Room and Labor Room,Does the hospital elect a fully prospective payment method for capital costs? (Y/N),Radiology-Diagnostic,Other Ancillary,"Blood Storing, Processing, Trans",IRF Provider Number,Interns & Residents,Occupational Therapy,Delivery Room and Labor Room,Renal Dialysis,Occupational Therapy,Drugs Charged to Patients,Drugs Charged to Patients,Hospice,Medical Supplies Charged to Patients,PEP Episodes:  Total Number of Episodes,PEP Episodes:  Total Charges:,Clinic,Observation Beds (Distinct Unit),Non-Physician Anesthetist Part A,LUPA Episodes:  Other Charges,Subtotal,Laboratory,Impl. Dev. Charged to Patients,Other Nonreimbursable,CT Scan,Subprovider-IPF,Blood Clotting Factors for Hemoph.,CAPD exchanges per day,Anesthesiology,Medical Supplies Charged to Patients,MRI,HHA,Subprovider-IRF,Whole Blood & Packed Red Blood Cells,Operating Cost and Target Amount,Housekeeping,Renal Dialysis,Total Hospital,Other General Service,Social Service,CT Scan,Radiology-Diagnostic,Emergency,Drugs Charged to Patients,IRF,Laundry and Linen Service,Payments received from patients for amounts previously written off as charity care,Hospice,Subprovider 2,"Number of Times per week
 Patient receives Dialysis",Intravenous Therapy,Delivery Room and Labor Room,Movable Equipment,Radiology-Diagnostic,Lung  Acquisition,Physical Therapy,ASC 1 Provider Number,Radiology-Diagnostic,Whole Blood & Packed Red Blood Cells,Kidney Acquisition,SNF,Operating Room,Admin & Gen Under Contract,Renal Dialysis,Adults and Pediatrics,"Medical certified lung
transplant center cert date",Non-Physician Anesthetist Part B,RHC,Dietary,CMHC 1 Provider Number,HHA,Medical Supplies Charged to Patients,RHC 12 Provider Number,Radiology-Diagnostic,Teaching Physician Salaries,Number of stations,NF,Total Fixed Assets,Whole Blood & Packed Red Blood Cells,Research,RHC/FQHC Combined,Other Outpatient Services,Nursery,Hospital Adlts & Ped Swing Bed NF,Title V discharges,Hospital Adults & Ped Swing Bed SNF,CORF,Total,Fiscal Intermediary/MAC Create Date,Physical Therapy,Radioisotope,MRI,Electrocardiology,Intravenous Therapy,Radiology-Therapeutic,TOTAL,Health Information Technology Designated Assets,Total cost,Intensive Care Unit,Occupational Therapy,Total Overhead Costs,Home Program Dialysis,TOTAL,Other Ancillary,Laboratory,Total Hospital,Electrocardiology,Recovery Room,Physical Therapy,Clinic,Total Adults & Peds,Clinic,"If this Hospital is claiming cost for renal services on Worksheet A, are they inpatient services only? (Y/N)",Employee Benefits,Inpatient Revenue,Hospice,Zip Code,FQHC,Other Ancillary,Hospice 3 Provider Number,Durable Medical Equipment Sold,ASC (Non Distinct Part),ASC (Non Distinct Part),NF,Laundry and Linen Service,Adults and Pediatrics,OSP,Charity care charges and uninsured discounts for the entire facility,Investment Income-Other,Kidney Acquisition,Other Reimbursable,CT Scan,Sale of drugs to other than patients,Physical Therapy,Drugs Charged to Patients,Without Outliers:  Total Charges,Total Long-term Liabilities,Physical Therapy,Operating Room,Int & Res (non approved teaching program,Electroencephalography,MRI,CT Scan,Assets,Observation Beds (Distinct Unit),SNF,Nursery,Emergency,Total Number of Outlier Episodes,Total Subprovider I Interns & Residents,Cardiac Catheterization,ASC (Non Distinct Part),Whole Blood & Packed Red Blood Cells,SNF,Radiology-Diagnostic,PEP Episodes:  Other Charges,Organ Procurement,Intensive Care Unit,Interns & Residents,ASC (Non Distinct Part),Ending Date of SCH status,Impl. Dev. Charged to Patients,ICF,Medical Supplies Charged to Patients,Electrocardiology,Pharmacy,Renal Dialysis,Cardiac Catheterization,Hospice,Renal Dialysis,Surgical Intensive Care Unit,Physical Therapy,Subprovider-IRF,Medical Supplies Charged to Patients,Initial Physician Payment Method (Y/N),Emergency,TOTAL,Renal Dialysis,Nonpaid Workers,RHC 5 Provider Number,Observation Beds (Distinct Unit),Durable Medical Equipment Sold,Home Program Dialysis,ICF,Subprovider-IRF,Subprovider-IRF,Subprovider-IRF,Cardiac Catheterization,IPF,Employee Benefits,Deductibles and coinsurance,Net Salaries,With Outliers:  Total Charges,Intensive Care Unit,CT Scan,Laboratory,Int & Res (non approved teaching program,Total,CT Scan,Surgical Intensive Care Unit,Anesthesiology,Electroencephalography,Other Ancillary,Subprovider-IPF,Respiratory Therapy,Subprovider-IRF,Maintenance of Personnel,Total,Delivery Room and Labor Room,Radiology-Diagnostic,OSP,PBP Clinical Lab Services Program Only,Burn Intensive Care Unit,New Cap Related Csts Movable Equipment,LUPA Episodes:  Total Visits,Maintenance and Repairs,Laboratory,OLTC,Drugs Charged to Patients,Laboratory,OPT,Total Charges:  LUPA Episodes,Delivery Room and Labor Room,Occupational Therapy,Whole Blood & Packed Red Blood Cells,Delivery Room and Labor Room,Hospital Type,Other Ancillary,Other Reimbursable,Electrocardiology,"Blood Storing, Processing, Trans",Durable Medical Equipment Rented,Other Outpatient Services,FQHC 3 Provider Number,Medical Supplies Charged to Patients,Whole Blood & Packed Red Blood Cells,ASC (Non Distinct Part),Intravenous Therapy,Subprovider II,Renal 9 Provider Number,Observation Beds (Distinct Unit),Blood Clotting Factors for Hemoph.,Intravenous Therapy,Drugs Charged to Patients,CT Scan,Total Hospital Interns & Residents,CT Scan,Liver Acquisition,Total Non Routine Medical  Supply Charges,Total Overhead Costs,Ending Balance,Title XIX discharges,Whole Blood & Packed Red Blood Cells,Coronary Care Unit,Cross Foot Adjustments,Physician Part A Teaching,Maintenance and Repairs,Anesthesiology,Whole Blood & Packed Red Blood Cells,Durable Medical Equipment Sold,CT Scan,Nursery,Physical Therapy,Laboratory,Delivery Room and Labor Room,ASC (Non Distinct Part),Renal Dialysis,Total Outpatient Program Pass Thru Cost,Cardiac Catheterization,Renal Dialysis,Radioisotope,"Are there any related organization or how office costs as defined in HCFA Pub. 15-I, chapter 10? (Y/N)",Anesthesiology,Durable Medical Equipment Rented,Kidney Acquisition,Renal Dialysis,Home Program Dialysis,Swing Bed NF Provider Number,Total Outpatient Program Pass Thru Cost,Electrocardiology,RHC 2 Provider Number,Lung  Acquisition,Drugs Charged to Patients,Radiology-Therapeutic,Deferred Income,Occupational Therapy,Operating Room,Other Special Purpose,CT Scan,Clinic,Total Hospital,RHC 16 Provider Number,Intravenous Therapy,Intensive Care Unit,Other Outpatient Services,Physical Therapy,Central Services and Supply,CT Scan,Respiratory Therapy,Intravenous Therapy,Other Special Care Unit,Other Reimbursable,Respiratory Therapy,CT Scan,Cardiac Catheterization,Organ Procurement,Home Program Dialysis,Total Operating Expense,Observation Beds (Distinct Unit),Title V discharges,Hospice 2 Provider Number,Occupational Therapy,Occupational Therapy,Adults & Pediatrics,Home Program Dialysis,Speech Pathology,Delivery Room and Labor Room,Durable Medical Equipment Sold,Interns & Res Salary and Fringe Benefits,Net Salaries,Subtotal Wage Related Csts,Subprovider-IRF,Laboratory,PEP Episodes:  Other Charges,Dietary under Contract,Electroencephalography,RHC 6 Provider Number,Medical Supplies Charged to Patients,Other Special Care Unit,Other Ancillary,RPCH/CAH Visits,Total Hospital,Operation of Plant,Electroencephalography,Hospital Adults & Pediatrics,Hospice,Cost of Uncompensated Care,Laboratory,Non-Physician Part B,MRI,Coronary Care Unit,Other Outpatient Services,OOT,Durable Medical Equipment Rented,LUPA Episodes:  Total Number of Episodes,PBP Clinical Lab Services Program Only,Unsecured Loans,Other Ancillary,Islet Acquisition,CT Scan,Total Program Inpatient Costs,Total,Respiratory Therapy,Clinic,Subtotal,Surgical Intensive Care Unit,Clinic,Drugs Charged to Patients,SNF,Radiology-Therapeutic,CT Scan,Television and Radio Service,FQHC,Interns & Residents,Subprovider-IRF,Ancillary service charges,Impl. Dev. Charged to Patients,Maintenance of Personnel,Total,Physician-Part A,Other Reimbursable,Respiratory Therapy,Burn Intensive Care Unit,Islet Acquisition,Total Program Inpatient Costs,Other Nonreimbursable,Speech Pathology,Interns and residents,Radiology-Therapeutic,Organ acquisition,Recovery Room,Emergency,RHC,Laboratory,MRI,MSP-LCC reconciliation amount,Wage Related Costs RHC/FQHC,Blood Clotting Factors for Hemoph.,Anesthesiology,Speech Pathology,Anesthesiology,Total,Operating Room,Provider-based physician adjustment,Radiology-Therapeutic,Physical Therapy,"Percentage of patients re-using
dialyzers",Heart Acquisition,Subprovider-IRF,RHC,Physicians' Private Office,Coronary Care Unit Program Cost,Other Outpatient Services,Cost of charity care (uninsured patients + patients w/ coverage not accepted by provider),Other Ancillary,Emergency,Operating Room,Minor Equipment Depreciable,Subprovider-IRF,Interns & Residents,CT Scan,Nursing Administration,Observation Beds (Distinct Unit),Medical Supplies Charged to Patients,Disp. And Retirement,Delivery Room and Labor Room,Other General Service,Other Ancillary,Total discharges,New Capital Equipment,Admin & Gen Under Contract,Renal Dialysis,Related Organization Transactions,Other Ancillary,Net Revenue from stand-alone SCHIP,Other Ancillary,Hospice 1 Provider Number,Subprovider II,Housekeeping under Contract,ASC (Non Distinct Part),CORF,Nursing School,net of Swing Bed and Private Room Diff,Total,Medical Records & Med Records Library,Emergency,Recovery Room,PEP Episodes:  Total Number of Episodes,Respiratory Therapy,"Blood Storing, Processing, Trans",Other Outpatient Services,Hospital Zip Code,Speech Pathology,Drugs Charged to Patients,Radioisotope,Employee Benefits,FQHC 9 Provider Number,Durable Medical Equipment Rented,Liver Acquisition,NF Provider Number,Employee Benefits,Drugs Charged to Patients,Organ Procurement,Kidney Acquisition,Subprovider I,Occupational Therapy,Anesthesiology,Radioisotope,Liver Acquisition,Other Ancillary,Anesthesiology,Kidney Acquisition,Employee Benefits,Hospital Street Address,Subtotal Salaries,Cardiac Catheterization,Nursing Administration,Intravenous Therapy,Non-Physician Anesthetist Part A,Radiology-Diagnostic,Cardiac Catheterization,Fiscal Year Begin Date,In State Medicaid eligible days,Nursery,Observation Beds (Distinct Unit),Administrative and General,Other Special Purpose,Total Other Charges,Observation Beds (Distinct Unit),Speech Pathology,OPT,Total,Land Improvements,Speech Pathology,Subprovider I,Total Hospital Interns & Residents,Other General Service,Intensive Care Unit,Nonpaid Workers,Subprovider-IPF,Speech Pathology,Operating Room,Electroencephalography,RHC 8 Provider Number,Total Hospital Interns & Residents,Physician-Part B,Other Special Care,Other General Service,Medical Supplies Charged to Patients,Emergency,Speech Pathology,Drugs Charged to Patients,Outpatient Rehab Provider,Subprovider-IRF,"Blood Storing, Processing, Trans",Subprovider 1,Whole Blood & Packed Red Blood Cells,Other Special Purpose,Electrocardiology,Pancreas Acquisition,Subprovider-IPF,Drugs Charged to Patients,Operating Room,Laboratory,Intensive Care Unit,Subprovider I,Total Program Excludable Costs,Speech Pathology,Utilization,Impl. Dev. Charged to Patients,Private grants or donations or endowment income restricted to funding charity care,ASC (Distinct Part),Physical Therapy,"If Line 32, Col 1 is yes, enter the method used: (A, B, or E only)",Pancreas Acquisition,Related Salaries,Laboratory,Durable Medical Equipment Rented,Research,Other Reimbursable,Electroencephalography,Physical Therapy,Interns & Res Salary and Fringe Benefits,ASC (Non Distinct Part),Home Office Salaries & Wage Related Csts,Total Program General Inpatient Routine,Int & Res (non approved teaching program,Laundry and Linen Service,Intravenous Therapy,Total Number of Episodes,Medical Supplies Charged to Patients,"Gift, Flower, Coffee Shop, Canteen",Total,Adults and Pediatrics,Ambulance Services,Tentative settlement,ICF Provider Number,Heart Acquisition,Impl. Dev. Charged to Patients,Durable Medical Equipment Rented,Blood Clotting Factors for Hemoph.,New Cap Related Csts Movable Equipment,Drugs Charged to Patients,Occupational Therapy,CORF,Total Charges,Medical Supplies Charged to Patients,Intravenous Therapy,Drugs Charged to Patients,FQHC,Intensive Care Unit,MRI,OPT,Laboratory,HHA 1 Provider Number,Radioisotope,Radiology-Diagnostic,NF,Other Organ Acquisition,Int & Res (non approved teaching program,Recovery Room,Interns & Residents,Dietary under contract,Adults and Pediatrics,Physician Part A Teaching,PEP:  Total Number of Outlier Episodes,Other Outpatient Services,Anesthesiology,net of Swing Bed and Private Room Diff,Electroencephalography,Interns & Residents,Occupational Therapy,ESRD DME costs,Int & Res (non approved teaching program,Hospital City,MRI,Respiratory Therapy,Drugs Charged to Patients,LUPA Episodes:  Other Charges,Total Nursing School,Cardiac Catheterization,OOT,Speech Pathology,State,Radiology-Diagnostic,Anesthesiology,Renal Dialysis,Radioisotope,Other Special Purpose,Home Office Salaries,Other Reimbursable,Coronary Care Unit,Observation Beds (Distinct Unit),Home Office Name,Pancreas Acquisition,Clinic,Electrocardiology,Delivery Room and Labor Room,Delivery Room and Labor Room,ICF,Impl. Dev. Charged to Patients,Intestinal Acquisition,"Medicare certified kidney 
transplant center cert date",Speech Pathology,Other Reimbursable,Ambulance Services,HHA,Respiratory Therapy,RHC 24 Provider Number,Total Facility FTEs,Radioisotope,"Gift, Flower, Coffee Shop, Canteen",Surgical Intensive Care Unit,Intensive Care Unit,Medical Supplies Charged to Patients,Lung  Acquisition,Laboratory,Operating Room,Respiratory Therapy,Occupational Therapy,Adults and Pediatrics,HHA,Labor and Delivery,CT Scan,CMHC,Stand-alone CHIP -- Costs minus net revenue (0 min),Recovery Room,New Cap Related Csts Movable Equipment,Excluded Area Salaries,Clinic,Other Outpatient Services,"Average patient dialysis time 
including setup",ASC (Non Distinct Part),Surgical Intensive Care Unit,Subtotal Other Wages and Related Csts,Number of stations,Pancreas Acquisition,Urban/Rural Indicator at beginning,ASC (Non Distinct Part),Subtotal Other Wages and Related Csts,Blood Clotting Factors for Hemoph.,Program Ancillary Services,RHC 9 Provider Number,"Percentage of patients re-using
dialyzers",Subprovider I,Physicians' Private Office,Impl. Dev. Charged to Patients,RHC,Home Program Dialysis,Total Subprovider II Interns & Residents,Subprovider-IPF,Home Office Personnel,Surgical Intensive Care Unit,Excluded Areas,Recovery Room,Home Office PO Box,Partial or full credits from manufacturers,Clinic,FQHC,Burn Intensive Care Unit,Subprovider I,OLTC,Other Ancillary,Other Outpatient Services,Total Charges:  LUPA Episodes,Radiology-Diagnostic,Lung  Acquisition,Emergency,Surgical Intensive Care Unit,Out of State Medicaid eligible days,ASC (Non Distinct Part),New Cap Related Csts Bldg & Fixtures,Emergency,Home Program Dialysis,Nursery,RHC 19 Provider Number,Other Reimbursable,Relief Payment,CMHC,Charity care charges and uninsured discounts for the entire facility,Surgical Intensive Care Unit,Ambulance Services,Operating Room,Electroencephalography,Admin & Gen Under Contract,Intensive Care Unit,Speech Pathology,Ambulance Services,Building Improvements,Teaching Physician Salaries,"Number of days in year dialysis 
furnished",Pass through Cost for Program Inpatient Routine,FQHC,Cardiac Catheterization,Respiratory Therapy,Adults and Pediatrics,Anesthesiology,Cardiac Catheterization,Subtotal Salaries,"Average patient dialysis time 
including setup",With Outliers:  Total Visits,Pass Through Cost for  Program Ancillary,Payments received from patients for amounts previously written off as charity care,Operating Room,"Blood Storing, Processing, Trans","Blood Storing, Processing, Trans",Land Improvements,Observation Beds (Distinct Unit),Intestinal Acquisition,Electroencephalography,Anesthesiology,Other Organ Acquisition,Interns & Res Other Program Costs,Radiology-Therapeutic,Durable Medical Equipment Rented,Electrocardiology,Nursery,Anesthesiology,Recovery Room,Blood Clotting Factors for Hemoph.,ASC (Non Distinct Part),Radioisotope,With Outliers:  Other Charges,Electrocardiology,Other Ancillary,Home Office Personnel,RHC,Other Outpatient Services,Kidney Acquisition,Pharmacy,Ambulance Services,Interest expense on Medicare Overpaymts,"Number of patients in program at 
end of cost reporting period",MRI,Radiology-Diagnostic,Blood Clotting Factors for Hemoph.,Maintenance of Personnel,NF,Intravenous Therapy,Physician Part A,Kidney Acquisition,ASC (Non Distinct Part),Renal Dialysis,OPT,Coronary Care Unit,Anesthesiology,Laboratory,RHC 7 Provider Number,Less Contractual Allowance and Discounts on Patients' Accounts,Speech Pathology,Delivery Room and Labor Room,NF,"Is this a teaching hospital or
affiliated with a teaching hospital? (Y/N)",Delivery Room and Labor Room,Other Current Assets,Hospital Adlts & Ped Swing Bed SNF,Swing Bed SNF Provider Number,Radioisotope,Home Program Dialysis,Occupational Therapy,Radiology-Therapeutic,Other Assets,Impl. Dev. Charged to Patients,Durable Medical Equipment Rented,Line 2 times line 5,"Number of patients transplanted 
during fiscal year",Observation Beds (Distinct Unit),Delivery Room and Labor Room,PBP Clinical Lab Services Program Only,Interns & Res Other Program Costs,Anesthesiology,Drugs Charged to Patients,Cardiac Catheterization,MRI,Allowable bad debts for dual eligibles beneficiaries,Clinic,Emergency,Drugs Charged to Patients,Coronary Care Unit,Electroencephalography,Total prospective payment,IRF,Allowable Inpatient Cost Plus Incentive Pt,Emergency,Total Patient Days,Whole Blood & Packed Red Blood Cells,Nursing Administration,RHC 1 Provider Number,OLTC,Recovery Room,Number of EPO units furnished for Line 13,ASC (Non Distinct Part),Total,CT Scan,Radiology-Therapeutic,Surgical Intensive Care Unit Program Cost,Hospital Adults & Pediatrics,Non-Physician Part B,Vending Machines,ASC (Non Distinct Part),Research,Total,ASC (Non Distinct Part),OPT,Intestinal Acquisition,OLTC,HHA,Radioisotope,Home Office:  Physician Part A,OOT,IRF,Laboratory,Other Reimbursable,Occupational Therapy,Observation Beds (Distinct Unit),Are provider based physicians' costs included in Worksheet A? (Y/N),Home Program Dialysis,MRI,Nursery,Recovery Room,New Cap Related Csts Bldg & Fixtures,Radioisotope,Anesthesiology,Clinic,RHC/FQHC Combined,Total Facility,Recovery Room,CT Scan,OSP,Speech Pathology,Nursery,Impl. Dev. Charged to Patients,Intravenous Therapy,Medical Supplies Charged to Patients,Radiology-Diagnostic,Other Capital,CMHC,Observation Beds (Distinct Unit),HAC reduction adjustment amount,Teaching Physician Salaries,PBP Clinical Lab Services Program Only,Other Organ Acquisition,Physical Therapy,Maintenance and Repairs,Clinic,Cardiac Catheterization,SNF,Subprovider-IRF,Other Reimbursable,Electroencephalography,Dietary,IPF,Investments,Average times dialyzers re-used,PEP:  Total Non Routine Med Supply Chgs,Radiology-Therapeutic,Speech Pathology,Clinic,Fixed Equipment,ICF,Hospital Adults & Pediatrics,CORF,Intensive Care Unit,Electrocardiology,Purchase,With Outliers:  Number of Episodes,Report Record Number,RHC 14 Provider Number,FQHC 7 Provider Number,Electroencephalography,RHC,Clinic,Delivery Room and Labor Room,PEP Episodes:  Total Visits,OSP,Intestinal Acquisition,Medicare reimbursable bad debts for the entire hospital complex,Nursing Administration,Hospice,Delivery Room and Labor Room,Related Salaries,Other Reimbursable,Subtotal Other Wages and Related Csts,Home Program Dialysis,Radiology-Therapeutic,Cardiac Catheterization,Paramedical Education,Wage Related Costs Other,Hospital Adults & Pediatrics,Research,Occupational Therapy,Nursery,Management and Administrative Services,Occupational Therapy,Impl. Dev. Charged to Patients,New Cap Related Csts Bldg & Fixtures,Laboratory,IPPS Interim payment,Target Amount,Medical Supplies Charged to Patients,NOT IN THIS FILE,Pancreas Acquisition,MRI,Kidney Acquisition,ASC (Distinct Part),Nursery,OPT,Anesthesiology,Radiology-Diagnostic,Government grants or appropriations or transfers for support of hospital operations,PBP Clinical Lab Services Program Only,Title XIX discharges,Movable Equipment,Other Reimbursable,Total Other Medical Education Cost,Intravenous Therapy,Adults and Pediatrics,Occupational Therapy,Cost of patients approved for charity care and uninsured discounts,"Blood Storing, Processing, Trans",MRI,Pancreas Acquisition,Adults & Pediatrics,Physical Therapy,Other Ancillary,Clinic,Durable Medical Equipment Rented,CT Scan,Interns & Residents,Provider's actual MSA or CBSA,Fiscal Year End Date,Contract Labor:  Physician Part A,CMHC,NF,ASC (Non Distinct Part),With Outliers:  Non Routine Med Sup Chgs,Operating Room,"Blood Storing, Processing, Trans","Blood Storing, Processing, Trans",Home Program Dialysis,Radioisotope,Electroencephalography,Other Outpatient Services,Have you established a new subprovider excluded unit under 42 CFR 413.40(f)(1)(I)?(Y/N),Total Current Liabilities,Other Special Care Unit,Clinic,Other Outpatient Services,Other Special Purpose,Laboratory,Observation Beds (Distinct Unit),Intensive Care Unit,Home Program Dialysis,Home Program Dialysis,Total Directly Assigned New Cap Rel Csts,Recovery Room,Radioisotope,Recovery Room,Intravenous Therapy,Laboratory,Electroencephalography,MRI,Medical Supplies Charged to Patients,Surgical Intensive Care Unit,Is this a New Hospital under 42 CFR 413.40(f)(1)(I) (TEFRA)? (Y/N),Physician Part A,Burn Intensive Care Unit,Nonpaid Workers,SNF,Emergency,Other Outpatient Services,Intravenous Therapy,Clinic,Physicians' Private Office,Operating Room,Surgical Intensive Care Unit,"Number of patients in program at 
end of cost reporting period",New Cap Related Csts Movable Equipment,Subprovider-IRF,Fixed Equipment,Electrocardiology,IRF,Is this hospital an All-Inclusive rate provider? (Y/N),Other Special Care,Radioisotope,Occupational Therapy,Housekeeping,Other Medicaid Days,Clinic,"Treatment capacity per day per
station",Maintenance of Personnel,Other Outpatient Services,Clinic,Total Other Medical Education,Intensive Care Unit,"Gift, Flower, Coffee Shop, Canteen",Radiology-Diagnostic,Occupational Therapy,Emergency,Subtotal,Burn Intensive Care Unit,Other Ancillary,Electroencephalography,Drugs Charged to Patients,Urban (1) or Rural (2),ASC (Non Distinct Part),Other Nonreimbursable,Delivery Room and Labor Room,Subtotal,Renal 8 Provider Number,Utilization Review SNF,Medical and Other Services reimbursed by OPPS,Electroencephalography,Total Number of Episodes,Maintenance of Personnel,Renal Dialysis,Nursing Administration,PBP Clinical Lab Services Program Only,Electrocardiology,Total,ASC (Non Distinct Part),Central Services and Supply,Other Ancillary,Medical Supplies Charged to Patients,Operating Room,Beginning Date of SCH status,Physician-Part B,Subprovider I,Burn Intensive Care Unit,Utilization Review-physicians compens,Speech Pathology,Intravenous Therapy,Total Current Assets,Speech Pathology,Physical Therapy,Heart Acquisition,Other Special Care Unit,Total Outpatient Program Pass Thru Cost,Total Program General Inpatient Routine,Renal 4 Provider Number,Cardiac Catheterization,Total unreimbursed cost for Medicaid and CHIP and state and local indigent care programs,Administrative & General under contract,Observation Beds (Distinct Unit),Respiratory Therapy,Physical Therapy,Physicians' Private Office,New Capital Equipment,Operating Room,Other Outpatient Services,Interns & Residents,"Blood Storing, Processing, Trans",Laboratory,Interns & Residents,Whole Blood & Packed Red Blood Cells,CMHC,Electrocardiology,RHC/FQHC Combined,Observation Beds (Distinct Unit),Other Special Care Unit,ASC (Non Distinct Part),certification date,Occupational Therapy,Durable Medical Equipment Sold,Interest Expense,Drugs Charged to Patients,Non-Physician Anesthetist Part A,Hospice,Ambulance Services,Other Reimbursable,Radiology-Diagnostic,Housekeeping under Contract,Renal Dialysis,Renal Dialysis,Durable Medical Equipment Rented,Coronary Care Unit,Impl. Dev. Charged to Patients,RHC,Total,Other Outpatient Services,Whole Blood & Packed Red Blood Cells,Other Ancillary,Speech Pathology,Cardiac Catheterization,FFY,Hospital Type (From CMS Hospitals Data Archive),Name and Num
,Curated Name and Num,Hospital type (modified),,Lon,Lat,CALCULATION OF REIMBURSEMENT SETTLEMENT,INPATIENT ANCILLARY SERVICE COST APPORTIONMENT,HOSPITAL WAGE INDEX DATA,COST ALLOCATION,TRIAL BALANCE OF EXPENSE ACCOUNTS,COST ALLOCATION,TRIAL BALANCE OF EXPENSE ACCOUNTS,INPATIENT ANCILLARY SERVICE COST APPORTIONMENT,COST ALLOCATION,INPATIENT ANCILLARY SERVICE COST APPORTIONMENT,TRIAL BALANCE OF EXPENSE ACCOUNTS,Medicaid Inpatient Days/Outpatient Visits,INPATIENT ANCILLARY SERVICE COST APPORTIONMENT,APPORTIONMENT OF INPATIENT/OUTPATIENT ANCILLARY SERVICE OTHER PASS THROUGH COSTS,COMPUTATION OF RATIO OF COST TO CHARGES,COST ALLOCATION,NUMBER OF BEDS,APPORTIONMENT OF INPATIENT/OUTPATIENT ANCILLARY SERVICE OTHER PASS THROUGH COSTS,CALCULATION OF REIMBURSEMENT SETTLEMENT,,APPORTIONMENT OF INPATIENT/OUTPATIENT ANCILLARY SERVICE OTHER PASS THROUGH COSTS,INPATIENT ANCILLARY SERVICE COST APPORTIONMENT,APPORTIONMENT OF INPATIENT/OUTPATIENT ANCILLARY SERVICE OTHER PASS THROUGH COSTS,APPORTIONMENT OF MEDICAL AND OTHER HEALTH SERVICES,APPORTIONMENT OF INPATIENT ROUTINE SERVICE OTHER PASS THROUGH COSTS,,ALLOCATION OF NEW CAPITAL COSTS,ANALYSIS OF CHANGES IN NEW CAPITAL BALANCES,APPORTIONMENT OF INPATIENT/OUTPATIENT ANCILLARY SERVICE OTHER PASS THROUGH COSTS,CALCULATION OF REIMBURSEMENT SETTLEMENT,NUMBER OF BEDS,ANALYSIS OF CHANGES IN NEW CAPITAL BALANCES,APPORTIONMENT OF MEDICAL AND OTHER HEALTH SERVICES,INPATIENT ANCILLARY SERVICE COST APPORTIONMENT,INPATIENT ANCILLARY SERVICE COST APPORTIONMENT,TRIAL BALANCE OF EXPENSE ACCOUNTS,COST ALLOCATION,INPATIENT ANCILLARY SERVICE COST APPORTIONMENT,APPORTIONMENT OF INPATIENT ROUTINE SERVICE CAPITAL COSTS,APPORTIONMENT OF INPATIENT/OUTPATIENT ANCILLARY SERVICE OTHER PASS THROUGH COSTS,TRIAL BALANCE OF EXPENSE ACCOUNTS,HOSPITAL WAGE INDEX DATA,Medicaid Inpatient Days/Outpatient Visits,INPATIENT ANCILLARY SERVICE COST APPORTIONMENT,COST ALLOCATION,APPORTIONMENT OF MEDICAL AND OTHER HEALTH SERVICES,BALANCE SHEET,HOSPITAL WAGE INDEX DATA,APPORTIONMENT OF INPATIENT/OUTPATIENT ANCILLARY SERVICE OTHER PASS THROUGH COSTS,INPATIENT ANCILLARY SERVICE COST APPORTIONMENT,APPORTIONMENT OF INPATIENT/OUTPATIENT ANCILLARY SERVICE OTHER PASS THROUGH COSTS,APPORTIONMENT OF INPATIENT/OUTPATIENT ANCILLARY SERVICE OTHER PASS THROUGH COSTS,COMPUTATION OF RATIO OF COST TO CHARGES,APPORTIONMENT OF INPATIENT/OUTPATIENT ANCILLARY SERVICE OTHER PASS THROUGH COSTS,APPORTIONMENT OF INPATIENT/OUTPATIENT ANCILLARY SERVICE OTHER PASS THROUGH COSTS,ANALYSIS OF CHANGES IN NEW CAPITAL BALANCES,APPORTIONMENT OF MEDICAL AND OTHER HEALTH SERVICES,COST ALLOCATION,RECONCILIATION OF CAPITAL COST CENTERS,APPORTIONMENT OF INPATIENT/OUTPATIENT ANCILLARY SERVICE OTHER PASS THROUGH COSTS,APPORTIONMENT OF MEDICAL AND OTHER HEALTH SERVICES,ALLOCATION OF NEW CAPITAL COSTS,APPORTIONMENT OF MEDICAL AND OTHER HEALTH SERVICES,HOSPITAL WAGE INDEX DATA,COMPUTATION OF RATIO OF COST TO CHARGES,COST ALLOCATION,INPATIENT ANCILLARY SERVICE COST APPORTIONMENT,COST ALLOCATION,INPATIENT ANCILLARY SERVICE COST APPORTIONMENT,APPORTIONMENT OF MEDICAL AND OTHER HEALTH SERVICES,COST ALLOCATION,S-10 DATA,COST ALLOCATION,TRIAL BALANCE OF EXPENSE ACCOUNTS,APPORTIONMENT OF INPATIENT ROUTINE SERVICE CAPITAL COSTS,CALCULATION OF REIMBURSEMENT SETTLEMENT,HHA STATISTICAL DATA,APPORTIONMENT OF INPATIENT/OUTPATIENT ANCILLARY SERVICE OTHER PASS THROUGH COSTS,APPORTIONMENT OF INPATIENT/OUTPATIENT ANCILLARY SERVICE OTHER PASS THROUGH COSTS,TRIAL BALANCE OF EXPENSE ACCOUNTS,APPORTIONMENT OF MEDICAL AND OTHER HEALTH SERVICES,TRIAL BALANCE OF EXPENSE ACCOUNTS,APPORTIONMENT OF INPATIENT/OUTPATIENT ANCILLARY SERVICE OTHER PASS THROUGH COSTS,TRIAL BALANCE OF EXPENSE ACCOUNTS,CALCULATION OF REIMBURSEMENT SETTLEMENT,INPATIENT ANCILLARY SERVICE COST APPORTIONMENT,APPORTIONMENT OF INPATIENT/OUTPATIENT ANCILLARY SERVICE OTHER PASS THROUGH COSTS,ALLOCATION OF NEW CAPITAL COSTS,HHA STATISTICAL DATA,BED DAYS AVAILABLE,INPATIENT ANCILLARY SERVICE COST APPORTIONMENT,APPORTIONMENT OF INPATIENT/OUTPATIENT ANCILLARY SERVICE OTHER PASS THROUGH COSTS,APPORTIONMENT OF INPATIENT/OUTPATIENT ANCILLARY SERVICE OTHER PASS THROUGH COSTS,APPORTIONMENT OF INPATIENT ROUTINE SERVICE CAPITAL COSTS,APPORTIONMENT OF INPATIENT/OUTPATIENT ANCILLARY SERVICE OTHER PASS THROUGH COSTS,INPATIENT ANCILLARY SERVICE COST APPORTIONMENT,COMPUTATION OF RATIO OF COST TO CHARGES,NUMBER OF BEDS,HOSPITAL WAGE INDEX DATA,APPORTIONMENT OF INPATIENT ROUTINE SERVICE CAPITAL COSTS,HOSPITAL WAGE INDEX DATA,RECONCILIATION OF CAPITAL COST CENTERS,INPATIENT ANCILLARY SERVICE COST APPORTIONMENT,RECONCILIATION OF CAPITAL COST CENTERS,INPATIENT ANCILLARY SERVICE COST APPORTIONMENT,,HOSPITAL WAGE INDEX DATA,APPORTIONMENT OF INPATIENT ROUTINE SERVICE CAPITAL COSTS,COST ALLOCATION,,Total Inpatient Days/Outpatient Visits,APPORTIONMENT OF INPATIENT/OUTPATIENT ANCILLARY SERVICE OTHER PASS THROUGH COSTS,HHA STATISTICAL DATA,APPORTIONMENT OF MEDICAL AND OTHER HEALTH SERVICES,HOSPITAL WAGE INDEX DATA,CALCULATION OF REIMBURSEMENT SETTLEMENT,INPATIENT ANCILLARY SERVICE COST APPORTIONMENT,APPORTIONMENT OF MEDICAL AND OTHER HEALTH SERVICES,Medicare Inpatient Days/Outpatient Visits,Total Inpatient Days/Outpatient Visits,APPORTIONMENT OF INPATIENT/OUTPATIENT ANCILLARY SERVICE OTHER PASS THROUGH COSTS,HOSPITAL WAGE INDEX DATA,COST ALLOCATION,APPORTIONMENT OF INPATIENT/OUTPATIENT ANCILLARY SERVICE OTHER PASS THROUGH COSTS,,RECONCILIATION OF CAPITAL COST CENTERS,COST ALLOCATION,APPORTIONMENT OF MEDICAL AND OTHER HEALTH SERVICES,TRIAL BALANCE OF EXPENSE ACCOUNTS,HOSPITAL WAGE INDEX DATA,HHA STATISTICAL DATA,COMPUTATION OF INPATIENT OPERATING COSTS,APPORTIONMENT OF MEDICAL AND OTHER HEALTH SERVICES,COST ALLOCATION,APPORTIONMENT OF INPATIENT/OUTPATIENT ANCILLARY SERVICE OTHER PASS THROUGH COSTS,NUMBER OF BEDS,APPORTIONMENT OF INPATIENT/OUTPATIENT ANCILLARY SERVICE OTHER PASS THROUGH COSTS,INPATIENT ANCILLARY SERVICE COST APPORTIONMENT,CALCULATION OF REIMBURSEMENT SETTLEMENT,APPORTIONMENT OF INPATIENT/OUTPATIENT ANCILLARY SERVICE OTHER PASS THROUGH COSTS,APPORTIONMENT OF INPATIENT/OUTPATIENT ANCILLARY SERVICE OTHER PASS THROUGH COSTS,COST ALLOCATION,RENAL STATISTICAL DATA,APPORTIONMENT OF INPATIENT/OUTPATIENT ANCILLARY SERVICE OTHER PASS THROUGH COSTS,TRIAL BALANCE OF EXPENSE ACCOUNTS,TRIAL BALANCE OF EXPENSE ACCOUNTS,INPATIENT ANCILLARY SERVICE COST APPORTIONMENT,APPORTIONMENT OF MEDICAL AND OTHER HEALTH SERVICES,HHA STATISTICAL DATA,COST ALLOCATION,INPATIENT ANCILLARY SERVICE COST APPORTIONMENT,APPORTIONMENT OF MEDICAL AND OTHER HEALTH SERVICES,,APPORTIONMENT OF INPATIENT/OUTPATIENT ANCILLARY SERVICE OTHER PASS THROUGH COSTS,COST ALLOCATION,ANALYSIS OF CHANGES IN NEW CAPITAL BALANCES,BED DAYS AVAILABLE,INPATIENT ANCILLARY SERVICE COST APPORTIONMENT,INPATIENT ANCILLARY SERVICE COST APPORTIONMENT,APPORTIONMENT OF INPATIENT ROUTINE SERVICE CAPITAL COSTS,HHA STATISTICAL DATA,ALLOCATION OF NEW CAPITAL COSTS,COST ALLOCATION,ANALYSIS OF CHANGES IN NEW CAPITAL BALANCES,APPORTIONMENT OF INPATIENT/OUTPATIENT ANCILLARY SERVICE OTHER PASS THROUGH COSTS,HOSPITAL WAGE INDEX DATA,TRIAL BALANCE OF EXPENSE ACCOUNTS,CALCULATION OF REIMBURSEMENT SETTLEMENT (PPS),Total Inpatient Days/Outpatient Visits,COST ALLOCATION,,INPATIENT ANCILLARY SERVICE COST APPORTIONMENT,TRIAL BALANCE OF EXPENSE ACCOUNTS,APPORTIONMENT OF INPATIENT/OUTPATIENT ANCILLARY SERVICE OTHER PASS THROUGH COSTS,TRIAL BALANCE OF EXPENSE ACCOUNTS,COST ALLOCATION,COST ALLOCATION,TRIAL BALANCE OF EXPENSE ACCOUNTS,CALCULATION OF REIMBURSEMENT SETTLEMENT,S-10 DATA,APPORTIONMENT OF INPATIENT/OUTPATIENT ANCILLARY SERVICE OTHER PASS THROUGH COSTS,ALLOCATION OF NEW CAPITAL COSTS,BED DAYS AVAILABLE,ALLOCATION OF NEW CAPITAL COSTS,ADJUSTMENTS,TRIAL BALANCE OF EXPENSE ACCOUNTS,COMPUTATION OF RATIO OF COST TO CHARGES,TRIAL BALANCE OF EXPENSE ACCOUNTS,COST ALLOCATION,,ALLOCATION OF NEW CAPITAL COSTS,APPORTIONMENT OF MEDICAL AND OTHER HEALTH SERVICES,APPORTIONMENT OF INPATIENT ROUTINE SERVICE OTHER PASS THROUGH COSTS,INPATIENT ANCILLARY SERVICE COST APPORTIONMENT,,ANALYSIS OF CHANGES IN NEW CAPITAL BALANCES,INPATIENT ANCILLARY SERVICE COST APPORTIONMENT,,COST ALLOCATION,Total Inpatient Days/Outpatient Visits,TRIAL BALANCE OF EXPENSE ACCOUNTS,APPORTIONMENT OF INPATIENT/OUTPATIENT ANCILLARY SERVICE OTHER PASS THROUGH COSTS,COST ALLOCATION,HOSPITAL WAGE INDEX DATA,APPORTIONMENT OF MEDICAL AND OTHER HEALTH SERVICES,HOSPITAL WAGE INDEX DATA,APPORTIONMENT OF INPATIENT/OUTPATIENT ANCILLARY SERVICE OTHER PASS THROUGH COSTS,APPORTIONMENT OF INPATIENT/OUTPATIENT ANCILLARY SERVICE OTHER PASS THROUGH COSTS,APPORTIONMENT OF INPATIENT/OUTPATIENT ANCILLARY SERVICE OTHER PASS THROUGH COSTS,COMPUTATION OF RATIO OF COST TO CHARGES,COST ALLOCATION,COST ALLOCATION,APPORTIONMENT OF INPATIENT/OUTPATIENT ANCILLARY SERVICE OTHER PASS THROUGH COSTS,ALLOCATION OF NEW CAPITAL COSTS,APPORTIONMENT OF INPATIENT/OUTPATIENT ANCILLARY SERVICE OTHER PASS THROUGH COSTS,APPORTIONMENT OF MEDICAL AND OTHER HEALTH SERVICES,Total Inpatient Days/Outpatient Visits,INPATIENT ANCILLARY SERVICE COST APPORTIONMENT,COMPUTATION OF RATIO OF COST TO CHARGES,COST ALLOCATION,COST ALLOCATION,ANALYSIS OF CHANGES IN NEW CAPITAL BALANCES,TRIAL BALANCE OF EXPENSE ACCOUNTS,COST ALLOCATION,BED DAYS AVAILABLE,COMPUTATION OF RATIO OF COST TO CHARGES,COST ALLOCATION,APPORTIONMENT OF INPATIENT/OUTPATIENT ANCILLARY SERVICE OTHER PASS THROUGH COSTS,HOSPITAL WAGE INDEX DATA,APPORTIONMENT OF INPATIENT/OUTPATIENT ANCILLARY SERVICE OTHER PASS THROUGH COSTS,TRIAL BALANCE OF EXPENSE ACCOUNTS,RENAL STATISTICAL DATA,APPORTIONMENT OF INPATIENT ROUTINE SERVICE CAPITAL COSTS,APPORTIONMENT OF INPATIENT/OUTPATIENT ANCILLARY SERVICE OTHER PASS THROUGH COSTS,RENAL STATISTICAL DATA,INPATIENT ANCILLARY SERVICE COST APPORTIONMENT,INPATIENT ANCILLARY SERVICE COST APPORTIONMENT,HHA STATISTICAL DATA,APPORTIONMENT OF INPATIENT/OUTPATIENT ANCILLARY SERVICE OTHER PASS THROUGH COSTS,BED DAYS AVAILABLE,RENAL STATISTICAL DATA,HOSPITAL WAGE INDEX DATA,HHA STATISTICAL DATA,INPATIENT ANCILLARY SERVICE COST APPORTIONMENT,ALLOCATION OF NEW CAPITAL COSTS,TRIAL BALANCE OF EXPENSE ACCOUNTS,Medicare Inpatient Days/Outpatient Visits,TRIAL BALANCE OF EXPENSE ACCOUNTS,COST ALLOCATION,COMPUTATION OF INPATIENT OPERATING COSTS,BED DAYS AVAILABLE,APPORTIONMENT OF INPATIENT/OUTPATIENT ANCILLARY SERVICE OTHER PASS THROUGH COSTS,APPORTIONMENT OF INPATIENT/OUTPATIENT ANCILLARY SERVICE OTHER PASS THROUGH COSTS,TRIAL BALANCE OF EXPENSE ACCOUNTS,COMPUTATION OF RATIO OF COST TO CHARGES,APPORTIONMENT OF INPATIENT/OUTPATIENT ANCILLARY SERVICE OTHER PASS THROUGH COSTS,CALCULATION OF REIMBURSEMENT SETTLEMENT,HOSPITAL WAGE INDEX DATA,Medicare Inpatient Days/Outpatient Visits,APPORTIONMENT OF INPATIENT/OUTPATIENT ANCILLARY SERVICE OTHER PASS THROUGH COSTS,APPORTIONMENT OF INPATIENT/OUTPATIENT ANCILLARY SERVICE OTHER PASS THROUGH COSTS,APPORTIONMENT OF MEDICAL AND OTHER HEALTH SERVICES,APPORTIONMENT OF MEDICAL AND OTHER HEALTH SERVICES,APPORTIONMENT OF INPATIENT/OUTPATIENT ANCILLARY SERVICE OTHER PASS THROUGH COSTS,COST ALLOCATION,HOSPITAL WAGE INDEX DATA,ALLOCATION OF NEW CAPITAL COSTS,Medicare Inpatient Days/Outpatient Visits,APPORTIONMENT OF INPATIENT/OUTPATIENT ANCILLARY SERVICE OTHER PASS THROUGH COSTS,COST ALLOCATION,INPATIENT ANCILLARY SERVICE COST APPORTIONMENT,TRIAL BALANCE OF EXPENSE ACCOUNTS,INPATIENT ANCILLARY SERVICE COST APPORTIONMENT,APPORTIONMENT OF INPATIENT ROUTINE SERVICE OTHER PASS THROUGH COSTS,BALANCE SHEET,Medicare Inpatient Days/Outpatient Visits,BALANCE SHEET,COMPUTATION OF RATIO OF COST TO CHARGES,TRIAL BALANCE OF EXPENSE ACCOUNTS,APPORTIONMENT OF INPATIENT/OUTPATIENT ANCILLARY SERVICE OTHER PASS THROUGH COSTS,APPORTIONMENT OF INPATIENT/OUTPATIENT ANCILLARY SERVICE OTHER PASS THROUGH COSTS,ANALYSIS OF CHANGES IN NEW CAPITAL BALANCES,APPORTIONMENT OF MEDICAL AND OTHER HEALTH SERVICES,BALANCE SHEET,Total Inpatient Days/Outpatient Visits,TRIAL BALANCE OF EXPENSE ACCOUNTS,COST ALLOCATION,TRIAL BALANCE OF EXPENSE ACCOUNTS,S-10 DATA,COMPUTATION OF RATIO OF COST TO CHARGES,HOSPITAL WAGE INDEX DATA,APPORTIONMENT OF MEDICAL AND OTHER HEALTH SERVICES,HOSPITAL IDENTIFICATION INFORMATION,ALLOCATION OF NEW CAPITAL COSTS,APPORTIONMENT OF INPATIENT/OUTPATIENT ANCILLARY SERVICE OTHER PASS THROUGH COSTS,COMPUTATION OF RATIO OF COST TO CHARGES,APPORTIONMENT OF INPATIENT/OUTPATIENT ANCILLARY SERVICE OTHER PASS THROUGH COSTS,INPATIENT ANCILLARY SERVICE COST APPORTIONMENT,TRIAL BALANCE OF EXPENSE ACCOUNTS,CALCULATION OF REIMBURSEMENT SETTLEMENT,COMPUTATION OF RATIO OF COST TO CHARGES,HOSPITAL WAGE INDEX DATA,TRIAL BALANCE OF EXPENSE ACCOUNTS,COST ALLOCATION,COST ALLOCATION,TRIAL BALANCE OF EXPENSE ACCOUNTS,HHA STATISTICAL DATA,APPORTIONMENT OF MEDICAL AND OTHER HEALTH SERVICES,Total Inpatient Days/Outpatient Visits,COST ALLOCATION,ALLOCATION OF NEW CAPITAL COSTS,,Medicare Inpatient Days/Outpatient Visits,APPORTIONMENT OF INPATIENT/OUTPATIENT ANCILLARY SERVICE OTHER PASS THROUGH COSTS,APPORTIONMENT OF INPATIENT/OUTPATIENT ANCILLARY SERVICE OTHER PASS THROUGH COSTS,TRIAL BALANCE OF EXPENSE ACCOUNTS,COST ALLOCATION,NUMBER OF BEDS,TRIAL BALANCE OF EXPENSE ACCOUNTS,,TRIAL BALANCE OF EXPENSE ACCOUNTS,APPORTIONMENT OF INPATIENT/OUTPATIENT ANCILLARY SERVICE OTHER PASS THROUGH COSTS,APPORTIONMENT OF INPATIENT/OUTPATIENT ANCILLARY SERVICE OTHER PASS THROUGH COSTS,INPATIENT ANCILLARY SERVICE COST APPORTIONMENT,COST ALLOCATION,STATEMENT OF REVENUES AND EXPENSES,ALLOCATION OF NEW CAPITAL COSTS,COMPUTATION OF RATIO OF COST TO CHARGES,APPORTIONMENT OF INPATIENT/OUTPATIENT ANCILLARY SERVICE OTHER PASS THROUGH COSTS,APPORTIONMENT OF MEDICAL AND OTHER HEALTH SERVICES,HHA STATISTICAL DATA,COMPUTATION OF RATIO OF COST TO CHARGES,APPORTIONMENT OF INPATIENT/OUTPATIENT ANCILLARY SERVICE OTHER PASS THROUGH COSTS,TRIAL BALANCE OF EXPENSE ACCOUNTS,COST ALLOCATION,APPORTIONMENT OF INPATIENT/OUTPATIENT ANCILLARY SERVICE OTHER PASS THROUGH COSTS,APPORTIONMENT OF INPATIENT/OUTPATIENT ANCILLARY SERVICE OTHER PASS THROUGH COSTS,INPATIENT ANCILLARY SERVICE COST APPORTIONMENT,APPORTIONMENT OF INPATIENT/OUTPATIENT ANCILLARY SERVICE OTHER PASS THROUGH COSTS,S-10 DATA,APPORTIONMENT OF MEDICAL AND OTHER HEALTH SERVICES,,TRIAL BALANCE OF EXPENSE ACCOUNTS,APPORTIONMENT OF MEDICAL AND OTHER HEALTH SERVICES,BED DAYS AVAILABLE,HHA STATISTICAL DATA,TRIAL BALANCE OF EXPENSE ACCOUNTS,ANALYSIS OF CHANGES IN NEW CAPITAL BALANCES,NUMBER OF BEDS,ALLOCATION OF NEW CAPITAL COSTS,TRIAL BALANCE OF EXPENSE ACCOUNTS,HOSPITAL WAGE INDEX DATA,APPORTIONMENT OF INPATIENT/OUTPATIENT ANCILLARY SERVICE OTHER PASS THROUGH COSTS,,HOSPITAL WAGE INDEX DATA,COMPUTATION OF RATIO OF COST TO CHARGES,ANALYSIS OF CHANGES IN NEW CAPITAL BALANCES,Total Inpatient Days/Outpatient Visits,APPORTIONMENT OF INPATIENT/OUTPATIENT ANCILLARY SERVICE OTHER PASS THROUGH COSTS,APPORTIONMENT OF MEDICAL AND OTHER HEALTH SERVICES,COMPUTATION OF INPATIENT OPERATING COSTS,HOSPITAL WAGE INDEX DATA,APPORTIONMENT OF MEDICAL AND OTHER HEALTH SERVICES,COMPUTATION OF RATIO OF COST TO CHARGES,HHA STATISTICAL DATA,APPORTIONMENT OF INPATIENT/OUTPATIENT ANCILLARY SERVICE OTHER PASS THROUGH COSTS,TRIAL BALANCE OF EXPENSE ACCOUNTS,TRIAL BALANCE OF EXPENSE ACCOUNTS,HOSPITAL WAGE INDEX DATA,TRIAL BALANCE OF EXPENSE ACCOUNTS,COMPUTATION OF RATIO OF COST TO CHARGES,COST ALLOCATION,,INPATIENT ANCILLARY SERVICE COST APPORTIONMENT,INPATIENT ANCILLARY SERVICE COST APPORTIONMENT,COST ALLOCATION,,INPATIENT ANCILLARY SERVICE COST APPORTIONMENT,APPORTIONMENT OF INPATIENT/OUTPATIENT ANCILLARY SERVICE OTHER PASS THROUGH COSTS,COST ALLOCATION,APPORTIONMENT OF INPATIENT/OUTPATIENT ANCILLARY SERVICE OTHER PASS THROUGH COSTS,APPORTIONMENT OF MEDICAL AND OTHER HEALTH SERVICES,HOSPITAL WAGE INDEX DATA,APPORTIONMENT OF INPATIENT/OUTPATIENT ANCILLARY SERVICE OTHER PASS THROUGH COSTS,HOSPITAL WAGE INDEX DATA,APPORTIONMENT OF INPATIENT/OUTPATIENT ANCILLARY SERVICE OTHER PASS THROUGH COSTS,COST ALLOCATION,APPORTIONMENT OF MEDICAL AND OTHER HEALTH SERVICES,BALANCE SHEET,STATEMENT OF REVENUES AND EXPENSES,INPATIENT ANCILLARY SERVICE COST APPORTIONMENT,TRIAL BALANCE OF EXPENSE ACCOUNTS,HOSPITAL WAGE INDEX DATA,APPORTIONMENT OF INPATIENT/OUTPATIENT ANCILLARY SERVICE OTHER PASS THROUGH COSTS,APPORTIONMENT OF MEDICAL AND OTHER HEALTH SERVICES,INPATIENT ANCILLARY SERVICE COST APPORTIONMENT,INPATIENT ANCILLARY SERVICE COST APPORTIONMENT,COMPUTATION OF RATIO OF COST TO CHARGES,APPORTIONMENT OF MEDICAL AND OTHER HEALTH SERVICES,Total Inpatient Days/Outpatient Visits,,COST ALLOCATION,Total Inpatient Days/Outpatient Visits,HHA STATISTICAL DATA,Total Inpatient Days/Outpatient Visits,APPORTIONMENT OF INPATIENT/OUTPATIENT ANCILLARY SERVICE OTHER PASS THROUGH COSTS,APPORTIONMENT OF MEDICAL AND OTHER HEALTH SERVICES,APPORTIONMENT OF MEDICAL AND OTHER HEALTH SERVICES,HHA STATISTICAL DATA,Medicare Inpatient Days/Outpatient Visits,APPORTIONMENT OF MEDICAL AND OTHER HEALTH SERVICES,COMPUTATION OF RATIO OF COST TO CHARGES,COST ALLOCATION,HOSPITAL WAGE INDEX DATA,COST ALLOCATION,HHA STATISTICAL DATA,,STATEMENT OF REVENUES AND EXPENSES,INPATIENT ANCILLARY SERVICE COST APPORTIONMENT,APPORTIONMENT OF MEDICAL AND OTHER HEALTH SERVICES,INPATIENT ANCILLARY SERVICE COST APPORTIONMENT,TRIAL BALANCE OF EXPENSE ACCOUNTS,INPATIENT ANCILLARY SERVICE COST APPORTIONMENT,HOSPITAL WAGE INDEX DATA,CALCULATION OF REIMBURSEMENT SETTLEMENT,ALLOCATION OF NEW CAPITAL COSTS,TRIAL BALANCE OF EXPENSE ACCOUNTS,,APPORTIONMENT OF MEDICAL AND OTHER HEALTH SERVICES,INPATIENT ANCILLARY SERVICE COST APPORTIONMENT,APPORTIONMENT OF INPATIENT/OUTPATIENT ANCILLARY SERVICE OTHER PASS THROUGH COSTS,APPORTIONMENT OF INPATIENT/OUTPATIENT ANCILLARY SERVICE OTHER PASS THROUGH COSTS,HHA STATISTICAL DATA,APPORTIONMENT OF INPATIENT ROUTINE SERVICE CAPITAL COSTS,INPATIENT ANCILLARY SERVICE COST APPORTIONMENT,COMPUTATION OF RATIO OF COST TO CHARGES,APPORTIONMENT OF INPATIENT/OUTPATIENT ANCILLARY SERVICE OTHER PASS THROUGH COSTS,HOSPITAL WAGE INDEX DATA,ALLOCATION OF NEW CAPITAL COSTS,INPATIENT ANCILLARY SERVICE COST APPORTIONMENT,Total Inpatient Days/Outpatient Visits,HOSPITAL WAGE INDEX DATA,INPATIENT ANCILLARY SERVICE COST APPORTIONMENT,INPATIENT ANCILLARY SERVICE COST APPORTIONMENT,HHA STATISTICAL DATA,COST ALLOCATION,APPORTIONMENT OF MEDICAL AND OTHER HEALTH SERVICES,BED DAYS AVAILABLE,Medicare Inpatient Days/Outpatient Visits,COMPUTATION OF RATIO OF COST TO CHARGES,APPORTIONMENT OF INPATIENT ROUTINE SERVICE CAPITAL COSTS,APPORTIONMENT OF MEDICAL AND OTHER HEALTH SERVICES,HOSPITAL WAGE INDEX DATA,CALCULATION OF REIMBURSEMENT SETTLEMENT,BALANCE SHEET,COMPUTATION OF RATIO OF COST TO CHARGES,Total Inpatient Days/Outpatient Visits,APPORTIONMENT OF MEDICAL AND OTHER HEALTH SERVICES,APPORTIONMENT OF INPATIENT/OUTPATIENT ANCILLARY SERVICE OTHER PASS THROUGH COSTS,Total Inpatient Days/Outpatient Visits,INPATIENT ANCILLARY SERVICE COST APPORTIONMENT,COST ALLOCATION,ANALYSIS OF CHANGES IN NEW CAPITAL BALANCES,APPORTIONMENT OF INPATIENT/OUTPATIENT ANCILLARY SERVICE OTHER PASS THROUGH COSTS,COMPUTATION OF RATIO OF COST TO CHARGES,APPORTIONMENT OF MEDICAL AND OTHER HEALTH SERVICES,NUMBER OF BEDS,APPORTIONMENT OF INPATIENT/OUTPATIENT ANCILLARY SERVICE OTHER PASS THROUGH COSTS,BED DAYS AVAILABLE,APPORTIONMENT OF MEDICAL AND OTHER HEALTH SERVICES,ANALYSIS OF CHANGES IN NEW CAPITAL BALANCES,RECONCILIATION OF CAPITAL COST CENTERS,ADJUSTMENTS,,COST ALLOCATION,TRIAL BALANCE OF EXPENSE ACCOUNTS,COST ALLOCATION,,APPORTIONMENT OF INPATIENT/OUTPATIENT ANCILLARY SERVICE OTHER PASS THROUGH COSTS,COST ALLOCATION,ALLOCATION OF NEW CAPITAL COSTS,COST ALLOCATION,CALCULATION OF REIMBURSEMENT SETTLEMENT,NUMBER OF BEDS,INPATIENT ANCILLARY SERVICE COST APPORTIONMENT,Total Inpatient Days/Outpatient Visits,COST ALLOCATION,HOSPITAL WAGE INDEX DATA,APPORTIONMENT OF MEDICAL AND OTHER HEALTH SERVICES,APPORTIONMENT OF INPATIENT/OUTPATIENT ANCILLARY SERVICE OTHER PASS THROUGH COSTS,HOSPITAL WAGE INDEX DATA,APPORTIONMENT OF INPATIENT/OUTPATIENT ANCILLARY SERVICE OTHER PASS THROUGH COSTS,COST ALLOCATION,APPORTIONMENT OF MEDICAL AND OTHER HEALTH SERVICES,ANALYSIS OF CHANGES IN NEW CAPITAL BALANCES,TRIAL BALANCE OF EXPENSE ACCOUNTS,CALCULATION OF REIMBURSEMENT SETTLEMENT,Medicaid Inpatient Days/Outpatient Visits,COMPUTATION OF RATIO OF COST TO CHARGES,HOSPITAL WAGE INDEX DATA,CALCULATION OF REIMBURSEMENT SETTLEMENT,TRIAL BALANCE OF EXPENSE ACCOUNTS,APPORTIONMENT OF INPATIENT/OUTPATIENT ANCILLARY SERVICE OTHER PASS THROUGH COSTS,Total Inpatient Days/Outpatient Visits,COST ALLOCATION,NUMBER OF BEDS,TRIAL BALANCE OF EXPENSE ACCOUNTS,TRIAL BALANCE OF EXPENSE ACCOUNTS,COST ALLOCATION,APPORTIONMENT OF INPATIENT/OUTPATIENT ANCILLARY SERVICE OTHER PASS THROUGH COSTS,APPORTIONMENT OF INPATIENT/OUTPATIENT ANCILLARY SERVICE OTHER PASS THROUGH COSTS,HOSPITAL WAGE INDEX DATA,TRIAL BALANCE OF EXPENSE ACCOUNTS,APPORTIONMENT OF INPATIENT/OUTPATIENT ANCILLARY SERVICE OTHER PASS THROUGH COSTS,ANALYSIS OF CHANGES IN NEW CAPITAL BALANCES,COMPUTATION OF RATIO OF COST TO CHARGES,,COMPUTATION OF INPATIENT OPERATING COSTS,COMPUTATION OF RATIO OF COST TO CHARGES,APPORTIONMENT OF MEDICAL AND OTHER HEALTH SERVICES,COST ALLOCATION,,HOSPITAL WAGE INDEX DATA,ADJUSTMENTS,COST ALLOCATION,INPATIENT ANCILLARY SERVICE COST APPORTIONMENT,TRIAL BALANCE OF EXPENSE ACCOUNTS,TRIAL BALANCE OF EXPENSE ACCOUNTS,APPORTIONMENT OF INPATIENT/OUTPATIENT ANCILLARY SERVICE OTHER PASS THROUGH COSTS,COST ALLOCATION,INPATIENT ANCILLARY SERVICE COST APPORTIONMENT,COST ALLOCATION,APPORTIONMENT OF INPATIENT/OUTPATIENT ANCILLARY SERVICE OTHER PASS THROUGH COSTS,HOSPITAL WAGE INDEX DATA,APPORTIONMENT OF INPATIENT/OUTPATIENT ANCILLARY SERVICE OTHER PASS THROUGH COSTS,ADJUSTMENTS,INPATIENT ANCILLARY SERVICE COST APPORTIONMENT,COMPUTATION OF RATIO OF COST TO CHARGES,CALCULATION OF REIMBURSEMENT SETTLEMENT,COST ALLOCATION,APPORTIONMENT OF INPATIENT/OUTPATIENT ANCILLARY SERVICE OTHER PASS THROUGH COSTS,COST ALLOCATION,COMPUTATION OF RATIO OF COST TO CHARGES,INPATIENT ANCILLARY SERVICE COST APPORTIONMENT,HOSPITAL WAGE INDEX DATA,COMPUTATION OF RATIO OF COST TO CHARGES,APPORTIONMENT OF INPATIENT/OUTPATIENT ANCILLARY SERVICE OTHER PASS THROUGH COSTS,INPATIENT ANCILLARY SERVICE COST APPORTIONMENT,STATEMENT OF REVENUES AND EXPENSES,TRIAL BALANCE OF EXPENSE ACCOUNTS,APPORTIONMENT OF INPATIENT/OUTPATIENT ANCILLARY SERVICE OTHER PASS THROUGH COSTS,HOSPITAL WAGE INDEX DATA,ANALYSIS OF CHANGES IN NEW CAPITAL BALANCES,INPATIENT ANCILLARY SERVICE COST APPORTIONMENT,HOSPITAL WAGE INDEX DATA,HOSPITAL WAGE INDEX DATA,TRIAL BALANCE OF EXPENSE ACCOUNTS,COST ALLOCATION,,APPORTIONMENT OF INPATIENT/OUTPATIENT ANCILLARY SERVICE OTHER PASS THROUGH COSTS,Total Inpatient Days/Outpatient Visits,APPORTIONMENT OF INPATIENT/OUTPATIENT ANCILLARY SERVICE OTHER PASS THROUGH COSTS,COST ALLOCATION,TRIAL BALANCE OF EXPENSE ACCOUNTS,CALCULATION OF REIMBURSEMENT SETTLEMENT,APPORTIONMENT OF INPATIENT/OUTPATIENT ANCILLARY SERVICE OTHER PASS THROUGH COSTS,Medicare Inpatient Days/Outpatient Visits,NUMBER OF BEDS,COST ALLOCATION,APPORTIONMENT OF INPATIENT/OUTPATIENT ANCILLARY SERVICE OTHER PASS THROUGH COSTS,HHA STATISTICAL DATA,TRIAL BALANCE OF EXPENSE ACCOUNTS,HOSPITAL WAGE INDEX DATA,ALLOCATION OF NEW CAPITAL COSTS,COST ALLOCATION,COST ALLOCATION,TRIAL BALANCE OF EXPENSE ACCOUNTS,APPORTIONMENT OF INPATIENT/OUTPATIENT ANCILLARY SERVICE OTHER PASS THROUGH COSTS,APPORTIONMENT OF INPATIENT/OUTPATIENT ANCILLARY SERVICE OTHER PASS THROUGH COSTS,INPATIENT ANCILLARY SERVICE COST APPORTIONMENT,APPORTIONMENT OF INPATIENT/OUTPATIENT ANCILLARY SERVICE OTHER PASS THROUGH COSTS,TRIAL BALANCE OF EXPENSE ACCOUNTS,CALCULATION OF REIMBURSEMENT SETTLEMENT,ANALYSIS OF CHANGES IN NEW CAPITAL BALANCES,S-10 DATA,ANALYSIS OF CHANGES IN NEW CAPITAL BALANCES,COMPUTATION OF RATIO OF COST TO CHARGES,TRIAL BALANCE OF EXPENSE ACCOUNTS,ADJUSTMENTS,COMPUTATION OF INPATIENT OPERATING COSTS,TRIAL BALANCE OF EXPENSE ACCOUNTS,ALLOCATION OF NEW CAPITAL COSTS,APPORTIONMENT OF INPATIENT/OUTPATIENT ANCILLARY SERVICE OTHER PASS THROUGH COSTS,TRIAL BALANCE OF EXPENSE ACCOUNTS,APPORTIONMENT OF INPATIENT/OUTPATIENT ANCILLARY SERVICE OTHER PASS THROUGH COSTS,CALCULATION OF REIMBURSEMENT SETTLEMENT,COMPUTATION OF RATIO OF COST TO CHARGES,ADJUSTMENTS,Total Inpatient Days/Outpatient Visits,APPORTIONMENT OF INPATIENT/OUTPATIENT ANCILLARY SERVICE OTHER PASS THROUGH COSTS,INPATIENT ANCILLARY SERVICE COST APPORTIONMENT,COST ALLOCATION,APPORTIONMENT OF MEDICAL AND OTHER HEALTH SERVICES,HOSPITAL WAGE INDEX DATA,TRIAL BALANCE OF EXPENSE ACCOUNTS,TRIAL BALANCE OF EXPENSE ACCOUNTS,RECONCILIATION OF CAPITAL COST CENTERS,APPORTIONMENT OF MEDICAL AND OTHER HEALTH SERVICES,APPORTIONMENT OF INPATIENT/OUTPATIENT ANCILLARY SERVICE OTHER PASS THROUGH COSTS,TRIAL BALANCE OF EXPENSE ACCOUNTS,COST ALLOCATION,TRIAL BALANCE OF EXPENSE ACCOUNTS,APPORTIONMENT OF INPATIENT ROUTINE SERVICE CAPITAL COSTS,HOSPITAL WAGE INDEX DATA,HOSPITAL WAGE INDEX DATA,HOSPITAL WAGE INDEX DATA,TRIAL BALANCE OF EXPENSE ACCOUNTS,Total Inpatient Days/Outpatient Visits,INPATIENT ANCILLARY SERVICE COST APPORTIONMENT,,TRIAL BALANCE OF EXPENSE ACCOUNTS,HOSPITAL WAGE INDEX DATA,,S-10 DATA,APPORTIONMENT OF INPATIENT/OUTPATIENT ANCILLARY SERVICE OTHER PASS THROUGH COSTS,COST ALLOCATION,APPORTIONMENT OF MEDICAL AND OTHER HEALTH SERVICES,BED DAYS AVAILABLE,HOSPITAL WAGE INDEX DATA,Total Inpatient Days/Outpatient Visits,,TRIAL BALANCE OF EXPENSE ACCOUNTS,APPORTIONMENT OF INPATIENT/OUTPATIENT ANCILLARY SERVICE OTHER PASS THROUGH COSTS,APPORTIONMENT OF MEDICAL AND OTHER HEALTH SERVICES,BED DAYS AVAILABLE,ADJUSTMENTS,APPORTIONMENT OF INPATIENT/OUTPATIENT ANCILLARY SERVICE OTHER PASS THROUGH COSTS,ANALYSIS OF CHANGES IN NEW CAPITAL BALANCES,COMPUTATION OF RATIO OF COST TO CHARGES,INPATIENT ANCILLARY SERVICE COST APPORTIONMENT,TRIAL BALANCE OF EXPENSE ACCOUNTS,INPATIENT ANCILLARY SERVICE COST APPORTIONMENT,Total Inpatient Days/Outpatient Visits,HHA STATISTICAL DATA,INPATIENT ANCILLARY SERVICE COST APPORTIONMENT,APPORTIONMENT OF INPATIENT/OUTPATIENT ANCILLARY SERVICE OTHER PASS THROUGH COSTS,COST ALLOCATION,APPORTIONMENT OF INPATIENT/OUTPATIENT ANCILLARY SERVICE OTHER PASS THROUGH COSTS,INPATIENT ANCILLARY SERVICE COST APPORTIONMENT,BALANCE SHEET,TRIAL BALANCE OF EXPENSE ACCOUNTS,,APPORTIONMENT OF INPATIENT ROUTINE SERVICE CAPITAL COSTS,APPORTIONMENT OF INPATIENT/OUTPATIENT ANCILLARY SERVICE OTHER PASS THROUGH COSTS,HOSPITAL WAGE INDEX DATA,COST ALLOCATION,APPORTIONMENT OF INPATIENT/OUTPATIENT ANCILLARY SERVICE OTHER PASS THROUGH COSTS,Total Inpatient Days/Outpatient Visits,BALANCE SHEET,COMPUTATION OF RATIO OF COST TO CHARGES,TRIAL BALANCE OF EXPENSE ACCOUNTS,COST ALLOCATION,TRIAL BALANCE OF EXPENSE ACCOUNTS,INPATIENT ANCILLARY SERVICE COST APPORTIONMENT,COST ALLOCATION,COMPUTATION OF RATIO OF COST TO CHARGES,COMPUTATION OF RATIO OF COST TO CHARGES,HOSPITAL WAGE INDEX DATA,TRIAL BALANCE OF EXPENSE ACCOUNTS,COST ALLOCATION,TRIAL BALANCE OF EXPENSE ACCOUNTS,TRIAL BALANCE OF EXPENSE ACCOUNTS,APPORTIONMENT OF MEDICAL AND OTHER HEALTH SERVICES,COST ALLOCATION,APPORTIONMENT OF INPATIENT/OUTPATIENT ANCILLARY SERVICE OTHER PASS THROUGH COSTS,TRIAL BALANCE OF EXPENSE ACCOUNTS,CALCULATION OF REIMBURSEMENT SETTLEMENT,TRIAL BALANCE OF EXPENSE ACCOUNTS,RECONCILIATION OF CAPITAL COST CENTERS,APPORTIONMENT OF MEDICAL AND OTHER HEALTH SERVICES,HOSPITAL WAGE INDEX DATA,APPORTIONMENT OF INPATIENT/OUTPATIENT ANCILLARY SERVICE OTHER PASS THROUGH COSTS,COMPUTATION OF RATIO OF COST TO CHARGES,APPORTIONMENT OF INPATIENT/OUTPATIENT ANCILLARY SERVICE OTHER PASS THROUGH COSTS,APPORTIONMENT OF MEDICAL AND OTHER HEALTH SERVICES,APPORTIONMENT OF INPATIENT/OUTPATIENT ANCILLARY SERVICE OTHER PASS THROUGH COSTS,TRIAL BALANCE OF EXPENSE ACCOUNTS,TRIAL BALANCE OF EXPENSE ACCOUNTS,BALANCE SHEET,COST ALLOCATION,APPORTIONMENT OF INPATIENT/OUTPATIENT ANCILLARY SERVICE OTHER PASS THROUGH COSTS,APPORTIONMENT OF INPATIENT ROUTINE SERVICE CAPITAL COSTS,INPATIENT ANCILLARY SERVICE COST APPORTIONMENT,HHA STATISTICAL DATA,APPORTIONMENT OF INPATIENT/OUTPATIENT ANCILLARY SERVICE OTHER PASS THROUGH COSTS,APPORTIONMENT OF INPATIENT/OUTPATIENT ANCILLARY SERVICE OTHER PASS THROUGH COSTS,COST ALLOCATION,COMPUTATION OF RATIO OF COST TO CHARGES,Total Inpatient Days/Outpatient Visits,APPORTIONMENT OF INPATIENT/OUTPATIENT ANCILLARY SERVICE OTHER PASS THROUGH COSTS,HOSPITAL WAGE INDEX DATA,COMPUTATION OF RATIO OF COST TO CHARGES,COST ALLOCATION,HHA STATISTICAL DATA,HHA STATISTICAL DATA,APPORTIONMENT OF INPATIENT/OUTPATIENT ANCILLARY SERVICE OTHER PASS THROUGH COSTS,HOSPITAL WAGE INDEX DATA,RECONCILIATION OF CAPITAL COST CENTERS,,APPORTIONMENT OF MEDICAL AND OTHER HEALTH SERVICES,HHA STATISTICAL DATA,COMPUTATION OF RATIO OF COST TO CHARGES,ALLOCATION OF NEW CAPITAL COSTS,COMPUTATION OF RATIO OF COST TO CHARGES,COMPUTATION OF INPATIENT OPERATING COSTS,RECONCILIATION OF CAPITAL COST CENTERS,COST ALLOCATION,HOSPITAL WAGE INDEX DATA,APPORTIONMENT OF INPATIENT/OUTPATIENT ANCILLARY SERVICE OTHER PASS THROUGH COSTS,ANALYSIS OF CHANGES IN NEW CAPITAL BALANCES,COMPUTATION OF RATIO OF COST TO CHARGES,APPORTIONMENT OF INPATIENT/OUTPATIENT ANCILLARY SERVICE OTHER PASS THROUGH COSTS,S-10 DATA,APPORTIONMENT OF INPATIENT/OUTPATIENT ANCILLARY SERVICE OTHER PASS THROUGH COSTS,BALANCE SHEET,CALCULATION OF REIMBURSEMENT SETTLEMENT,TRIAL BALANCE OF EXPENSE ACCOUNTS,APPORTIONMENT OF INPATIENT/OUTPATIENT ANCILLARY SERVICE OTHER PASS THROUGH COSTS,,,COST ALLOCATION,APPORTIONMENT OF INPATIENT/OUTPATIENT ANCILLARY SERVICE OTHER PASS THROUGH COSTS,S-10 DATA,COMPUTATION OF RATIO OF COST TO CHARGES,Total Inpatient Days/Outpatient Visits,INPATIENT ANCILLARY SERVICE COST APPORTIONMENT,HHA STATISTICAL DATA,TRIAL BALANCE OF EXPENSE ACCOUNTS,APPORTIONMENT OF INPATIENT/OUTPATIENT ANCILLARY SERVICE OTHER PASS THROUGH COSTS,INPATIENT ANCILLARY SERVICE COST APPORTIONMENT,,COST ALLOCATION,INPATIENT ANCILLARY SERVICE COST APPORTIONMENT,COST ALLOCATION,COST ALLOCATION,APPORTIONMENT OF MEDICAL AND OTHER HEALTH SERVICES,HOSPITAL WAGE INDEX DATA,HOSPITAL WAGE INDEX DATA,COST ALLOCATION,TRIAL BALANCE OF EXPENSE ACCOUNTS,APPORTIONMENT OF INPATIENT/OUTPATIENT ANCILLARY SERVICE OTHER PASS THROUGH COSTS,,APPORTIONMENT OF INPATIENT/OUTPATIENT ANCILLARY SERVICE OTHER PASS THROUGH COSTS,APPORTIONMENT OF INPATIENT/OUTPATIENT ANCILLARY SERVICE OTHER PASS THROUGH COSTS,APPORTIONMENT OF INPATIENT/OUTPATIENT ANCILLARY SERVICE OTHER PASS THROUGH COSTS,S-10 DATA,BALANCE SHEET,TRIAL BALANCE OF EXPENSE ACCOUNTS,,COMPUTATION OF RATIO OF COST TO CHARGES,ADJUSTMENTS,APPORTIONMENT OF INPATIENT/OUTPATIENT ANCILLARY SERVICE OTHER PASS THROUGH COSTS,TRIAL BALANCE OF EXPENSE ACCOUNTS,APPORTIONMENT OF MEDICAL AND OTHER HEALTH SERVICES,COST ALLOCATION,APPORTIONMENT OF INPATIENT ROUTINE SERVICE OTHER PASS THROUGH COSTS,HOSPITAL WAGE INDEX DATA,Medicaid Inpatient Days/Outpatient Visits,INPATIENT ANCILLARY SERVICE COST APPORTIONMENT,APPORTIONMENT OF INPATIENT/OUTPATIENT ANCILLARY SERVICE OTHER PASS THROUGH COSTS,INPATIENT ANCILLARY SERVICE COST APPORTIONMENT,ANALYSIS OF CHANGES IN NEW CAPITAL BALANCES,APPORTIONMENT OF INPATIENT/OUTPATIENT ANCILLARY SERVICE OTHER PASS THROUGH COSTS,HOSPITAL WAGE INDEX DATA,COST ALLOCATION,APPORTIONMENT OF MEDICAL AND OTHER HEALTH SERVICES,TRIAL BALANCE OF EXPENSE ACCOUNTS,COST ALLOCATION,APPORTIONMENT OF INPATIENT/OUTPATIENT ANCILLARY SERVICE OTHER PASS THROUGH COSTS,INPATIENT ANCILLARY SERVICE COST APPORTIONMENT,CALCULATION OF REIMBURSEMENT SETTLEMENT,TRIAL BALANCE OF EXPENSE ACCOUNTS,INPATIENT ANCILLARY SERVICE COST APPORTIONMENT,TRIAL BALANCE OF EXPENSE ACCOUNTS,TRIAL BALANCE OF EXPENSE ACCOUNTS,Medicaid Inpatient Days/Outpatient Visits,TRIAL BALANCE OF EXPENSE ACCOUNTS,HOSPITAL WAGE INDEX DATA,COMPUTATION OF RATIO OF COST TO CHARGES,COST ALLOCATION,COST ALLOCATION,INPATIENT ANCILLARY SERVICE COST APPORTIONMENT,TRIAL BALANCE OF EXPENSE ACCOUNTS,COST ALLOCATION,ALLOCATION OF NEW CAPITAL COSTS,APPORTIONMENT OF INPATIENT/OUTPATIENT ANCILLARY SERVICE OTHER PASS THROUGH COSTS,HOSPITAL WAGE INDEX DATA,APPORTIONMENT OF MEDICAL AND OTHER HEALTH SERVICES,TRIAL BALANCE OF EXPENSE ACCOUNTS,COST ALLOCATION,APPORTIONMENT OF MEDICAL AND OTHER HEALTH SERVICES,TRIAL BALANCE OF EXPENSE ACCOUNTS,COMPUTATION OF INPATIENT OPERATING COSTS,COMPUTATION OF RATIO OF COST TO CHARGES,BED DAYS AVAILABLE,HHA STATISTICAL DATA,COMPUTATION OF RATIO OF COST TO CHARGES,APPORTIONMENT OF INPATIENT/OUTPATIENT ANCILLARY SERVICE OTHER PASS THROUGH COSTS,INPATIENT ANCILLARY SERVICE COST APPORTIONMENT,TRIAL BALANCE OF EXPENSE ACCOUNTS,COST ALLOCATION,HOSPITAL WAGE INDEX DATA,APPORTIONMENT OF INPATIENT/OUTPATIENT ANCILLARY SERVICE OTHER PASS THROUGH COSTS,,COST ALLOCATION,TRIAL BALANCE OF EXPENSE ACCOUNTS,COMPUTATION OF RATIO OF COST TO CHARGES,,HOSPITAL WAGE INDEX DATA,APPORTIONMENT OF MEDICAL AND OTHER HEALTH SERVICES,COMPUTATION OF INPATIENT OPERATING COSTS,RENAL STATISTICAL DATA,COST ALLOCATION,INPATIENT ANCILLARY SERVICE COST APPORTIONMENT,COST ALLOCATION,COST ALLOCATION,TRIAL BALANCE OF EXPENSE ACCOUNTS,TRIAL BALANCE OF EXPENSE ACCOUNTS,HOSPITAL IDENTIFICATION INFORMATION,APPORTIONMENT OF INPATIENT ROUTINE SERVICE OTHER PASS THROUGH COSTS,ALLOCATION OF NEW CAPITAL COSTS,APPORTIONMENT OF INPATIENT/OUTPATIENT ANCILLARY SERVICE OTHER PASS THROUGH COSTS,APPORTIONMENT OF MEDICAL AND OTHER HEALTH SERVICES,COST ALLOCATION,,Total Inpatient Days/Outpatient Visits,ALLOCATION OF NEW CAPITAL COSTS,APPORTIONMENT OF INPATIENT ROUTINE SERVICE CAPITAL COSTS,Medicare Inpatient Days/Outpatient Visits,COMPUTATION OF RATIO OF COST TO CHARGES,HOSPITAL WAGE INDEX DATA,HOSPITAL WAGE INDEX DATA,APPORTIONMENT OF INPATIENT/OUTPATIENT ANCILLARY SERVICE OTHER PASS THROUGH COSTS,COMPUTATION OF RATIO OF COST TO CHARGES,APPORTIONMENT OF INPATIENT/OUTPATIENT ANCILLARY SERVICE OTHER PASS THROUGH COSTS,HOSPITAL WAGE INDEX DATA,INPATIENT ANCILLARY SERVICE COST APPORTIONMENT,INPATIENT ANCILLARY SERVICE COST APPORTIONMENT,COST ALLOCATION,HHA STATISTICAL DATA,ALLOCATION OF NEW CAPITAL COSTS,INPATIENT ANCILLARY SERVICE COST APPORTIONMENT,INPATIENT ANCILLARY SERVICE COST APPORTIONMENT,HOSPITAL WAGE INDEX DATA,COMPUTATION OF RATIO OF COST TO CHARGES,S-10 DATA,COMPUTATION OF INPATIENT OPERATING COSTS,HOSPITAL WAGE INDEX DATA,COST ALLOCATION,APPORTIONMENT OF INPATIENT/OUTPATIENT ANCILLARY SERVICE OTHER PASS THROUGH COSTS,APPORTIONMENT OF INPATIENT/OUTPATIENT ANCILLARY SERVICE OTHER PASS THROUGH COSTS,COMPUTATION OF RATIO OF COST TO CHARGES,HHA STATISTICAL DATA,INPATIENT ANCILLARY SERVICE COST APPORTIONMENT,Total Inpatient Days/Outpatient Visits,APPORTIONMENT OF MEDICAL AND OTHER HEALTH SERVICES,RENAL STATISTICAL DATA,APPORTIONMENT OF MEDICAL AND OTHER HEALTH SERVICES,STATEMENT OF REVENUES AND EXPENSES,COMPUTATION OF RATIO OF COST TO CHARGES,Total Inpatient Days/Outpatient Visits,APPORTIONMENT OF MEDICAL AND OTHER HEALTH SERVICES,HHA STATISTICAL DATA,INPATIENT ANCILLARY SERVICE COST APPORTIONMENT,COMPUTATION OF INPATIENT OPERATING COSTS,HOSPITAL WAGE INDEX DATA,APPORTIONMENT OF MEDICAL AND OTHER HEALTH SERVICES,HOSPITAL WAGE INDEX DATA,APPORTIONMENT OF INPATIENT/OUTPATIENT ANCILLARY SERVICE OTHER PASS THROUGH COSTS,INPATIENT ANCILLARY SERVICE COST APPORTIONMENT,S-10 DATA,APPORTIONMENT OF INPATIENT/OUTPATIENT ANCILLARY SERVICE OTHER PASS THROUGH COSTS,TRIAL BALANCE OF EXPENSE ACCOUNTS,TRIAL BALANCE OF EXPENSE ACCOUNTS,APPORTIONMENT OF INPATIENT/OUTPATIENT ANCILLARY SERVICE OTHER PASS THROUGH COSTS,S-10 DATA,COST ALLOCATION,APPORTIONMENT OF INPATIENT/OUTPATIENT ANCILLARY SERVICE OTHER PASS THROUGH COSTS,TRIAL BALANCE OF EXPENSE ACCOUNTS,ANALYSIS OF CHANGES IN NEW CAPITAL BALANCES,COMPUTATION OF INPATIENT OPERATING COSTS,,TRIAL BALANCE OF EXPENSE ACCOUNTS,INPATIENT ANCILLARY SERVICE COST APPORTIONMENT,COST ALLOCATION,TRIAL BALANCE OF EXPENSE ACCOUNTS,APPORTIONMENT OF MEDICAL AND OTHER HEALTH SERVICES,HOSPITAL WAGE INDEX DATA,COST ALLOCATION,INPATIENT ANCILLARY SERVICE COST APPORTIONMENT,COST ALLOCATION,APPORTIONMENT OF MEDICAL AND OTHER HEALTH SERVICES,RENAL STATISTICAL DATA,RENAL STATISTICAL DATA,INPATIENT ANCILLARY SERVICE COST APPORTIONMENT,COST ALLOCATION,ADJUSTMENTS,COST ALLOCATION,APPORTIONMENT OF INPATIENT/OUTPATIENT ANCILLARY SERVICE OTHER PASS THROUGH COSTS,HOSPITAL WAGE INDEX DATA,TRIAL BALANCE OF EXPENSE ACCOUNTS,COST ALLOCATION,COST ALLOCATION,APPORTIONMENT OF MEDICAL AND OTHER HEALTH SERVICES,APPORTIONMENT OF INPATIENT/OUTPATIENT ANCILLARY SERVICE OTHER PASS THROUGH COSTS,TRIAL BALANCE OF EXPENSE ACCOUNTS,INPATIENT ANCILLARY SERVICE COST APPORTIONMENT,APPORTIONMENT OF MEDICAL AND OTHER HEALTH SERVICES,CALCULATION OF REIMBURSEMENT SETTLEMENT,APPORTIONMENT OF MEDICAL AND OTHER HEALTH SERVICES,APPORTIONMENT OF MEDICAL AND OTHER HEALTH SERVICES,CALCULATION OF REIMBURSEMENT SETTLEMENT,CALCULATION OF REIMBURSEMENT SETTLEMENT,,ANALYSIS OF CHANGES IN NEW CAPITAL BALANCES,APPORTIONMENT OF INPATIENT/OUTPATIENT ANCILLARY SERVICE OTHER PASS THROUGH COSTS,APPORTIONMENT OF MEDICAL AND OTHER HEALTH SERVICES,COMPUTATION OF RATIO OF COST TO CHARGES,INPATIENT ANCILLARY SERVICE COST APPORTIONMENT,,APPORTIONMENT OF MEDICAL AND OTHER HEALTH SERVICES,BED DAYS AVAILABLE,COMPUTATION OF RATIO OF COST TO CHARGES,COMPUTATION OF RATIO OF COST TO CHARGES,COST ALLOCATION,TRIAL BALANCE OF EXPENSE ACCOUNTS,RENAL STATISTICAL DATA,APPORTIONMENT OF INPATIENT/OUTPATIENT ANCILLARY SERVICE OTHER PASS THROUGH COSTS,Total Inpatient Days/Outpatient Visits,COMPUTATION OF INPATIENT OPERATING COSTS,TRIAL BALANCE OF EXPENSE ACCOUNTS,,COST ALLOCATION,APPORTIONMENT OF INPATIENT/OUTPATIENT ANCILLARY SERVICE OTHER PASS THROUGH COSTS,HOSPITAL WAGE INDEX DATA,COMPUTATION OF RATIO OF COST TO CHARGES,HOSPITAL WAGE INDEX DATA,INPATIENT ANCILLARY SERVICE COST APPORTIONMENT,BED DAYS AVAILABLE,APPORTIONMENT OF INPATIENT/OUTPATIENT ANCILLARY SERVICE OTHER PASS THROUGH COSTS,INPATIENT ANCILLARY SERVICE COST APPORTIONMENT,HHA STATISTICAL DATA,BALANCE SHEET,INPATIENT ANCILLARY SERVICE COST APPORTIONMENT,HOSPITAL WAGE INDEX DATA,COMPUTATION OF RATIO OF COST TO CHARGES,COMPUTATION OF RATIO OF COST TO CHARGES,Total Inpatient Days/Outpatient Visits,RENAL STATISTICAL DATA,APPORTIONMENT OF INPATIENT/OUTPATIENT ANCILLARY SERVICE OTHER PASS THROUGH COSTS,APPORTIONMENT OF INPATIENT/OUTPATIENT ANCILLARY SERVICE OTHER PASS THROUGH COSTS,COST ALLOCATION,COMPUTATION OF RATIO OF COST TO CHARGES,APPORTIONMENT OF MEDICAL AND OTHER HEALTH SERVICES,INPATIENT ANCILLARY SERVICE COST APPORTIONMENT,BALANCE SHEET,TRIAL BALANCE OF EXPENSE ACCOUNTS,TRIAL BALANCE OF EXPENSE ACCOUNTS,APPORTIONMENT OF INPATIENT/OUTPATIENT ANCILLARY SERVICE OTHER PASS THROUGH COSTS,APPORTIONMENT OF INPATIENT/OUTPATIENT ANCILLARY SERVICE OTHER PASS THROUGH COSTS,APPORTIONMENT OF MEDICAL AND OTHER HEALTH SERVICES,TRIAL BALANCE OF EXPENSE ACCOUNTS,,INPATIENT ANCILLARY SERVICE COST APPORTIONMENT,COST ALLOCATION,BALANCE SHEET,APPORTIONMENT OF MEDICAL AND OTHER HEALTH SERVICES,TRIAL BALANCE OF EXPENSE ACCOUNTS,S-10 DATA,Total Inpatient Days/Outpatient Visits,APPORTIONMENT OF INPATIENT/OUTPATIENT ANCILLARY SERVICE OTHER PASS THROUGH COSTS,ALLOCATION OF NEW CAPITAL COSTS,,ANALYSIS OF CHANGES IN NEW CAPITAL BALANCES,HOSPITAL WAGE INDEX DATA,TRIAL BALANCE OF EXPENSE ACCOUNTS,COMPUTATION OF RATIO OF COST TO CHARGES,APPORTIONMENT OF INPATIENT ROUTINE SERVICE CAPITAL COSTS,BED DAYS AVAILABLE,ADJUSTMENTS,APPORTIONMENT OF MEDICAL AND OTHER HEALTH SERVICES,INPATIENT ANCILLARY SERVICE COST APPORTIONMENT,,TRIAL BALANCE OF EXPENSE ACCOUNTS,ADJUSTMENTS,APPORTIONMENT OF INPATIENT/OUTPATIENT ANCILLARY SERVICE OTHER PASS THROUGH COSTS,APPORTIONMENT OF INPATIENT/OUTPATIENT ANCILLARY SERVICE OTHER PASS THROUGH COSTS,TRIAL BALANCE OF EXPENSE ACCOUNTS,ALLOCATION OF NEW CAPITAL COSTS,COMPUTATION OF RATIO OF COST TO CHARGES,INPATIENT ANCILLARY SERVICE COST APPORTIONMENT,HOSPITAL WAGE INDEX DATA,APPORTIONMENT OF MEDICAL AND OTHER HEALTH SERVICES,INPATIENT ANCILLARY SERVICE COST APPORTIONMENT,TRIAL BALANCE OF EXPENSE ACCOUNTS,TRIAL BALANCE OF EXPENSE ACCOUNTS,TRIAL BALANCE OF EXPENSE ACCOUNTS,TRIAL BALANCE OF EXPENSE ACCOUNTS,Medicaid Inpatient Days/Outpatient Visits,INPATIENT ANCILLARY SERVICE COST APPORTIONMENT,COST ALLOCATION,RENAL STATISTICAL DATA,COMPUTATION OF RATIO OF COST TO CHARGES,APPORTIONMENT OF MEDICAL AND OTHER HEALTH SERVICES,Total Inpatient Days/Outpatient Visits,INPATIENT ANCILLARY SERVICE COST APPORTIONMENT,COST ALLOCATION,BALANCE SHEET,COMPUTATION OF RATIO OF COST TO CHARGES,COST ALLOCATION,ANALYSIS OF CHANGES IN NEW CAPITAL BALANCES,COST ALLOCATION,APPORTIONMENT OF INPATIENT ROUTINE SERVICE CAPITAL COSTS,,COST ALLOCATION,BED DAYS AVAILABLE,COMPUTATION OF RATIO OF COST TO CHARGES,BED DAYS AVAILABLE,HHA STATISTICAL DATA,TRIAL BALANCE OF EXPENSE ACCOUNTS,APPORTIONMENT OF MEDICAL AND OTHER HEALTH SERVICES,COMPUTATION OF INPATIENT OPERATING COSTS,APPORTIONMENT OF INPATIENT/OUTPATIENT ANCILLARY SERVICE OTHER PASS THROUGH COSTS,INPATIENT ANCILLARY SERVICE COST APPORTIONMENT,INPATIENT ANCILLARY SERVICE COST APPORTIONMENT,Total Inpatient Days/Outpatient Visits,ALLOCATION OF NEW CAPITAL COSTS,APPORTIONMENT OF MEDICAL AND OTHER HEALTH SERVICES,COMPUTATION OF RATIO OF COST TO CHARGES,HOSPITAL WAGE INDEX DATA,ANALYSIS OF CHANGES IN NEW CAPITAL BALANCES,COST ALLOCATION,APPORTIONMENT OF MEDICAL AND OTHER HEALTH SERVICES,TRIAL BALANCE OF EXPENSE ACCOUNTS,TRIAL BALANCE OF EXPENSE ACCOUNTS,APPORTIONMENT OF INPATIENT/OUTPATIENT ANCILLARY SERVICE OTHER PASS THROUGH COSTS,APPORTIONMENT OF MEDICAL AND OTHER HEALTH SERVICES,APPORTIONMENT OF INPATIENT/OUTPATIENT ANCILLARY SERVICE OTHER PASS THROUGH COSTS,INPATIENT ANCILLARY SERVICE COST APPORTIONMENT,COMPUTATION OF RATIO OF COST TO CHARGES,APPORTIONMENT OF INPATIENT/OUTPATIENT ANCILLARY SERVICE OTHER PASS THROUGH COSTS,APPORTIONMENT OF MEDICAL AND OTHER HEALTH SERVICES,TRIAL BALANCE OF EXPENSE ACCOUNTS,COMPUTATION OF RATIO OF COST TO CHARGES,COMPUTATION OF INPATIENT OPERATING COSTS,TRIAL BALANCE OF EXPENSE ACCOUNTS,COST ALLOCATION,TRIAL BALANCE OF EXPENSE ACCOUNTS,APPORTIONMENT OF INPATIENT/OUTPATIENT ANCILLARY SERVICE OTHER PASS THROUGH COSTS,APPORTIONMENT OF MEDICAL AND OTHER HEALTH SERVICES,INPATIENT ANCILLARY SERVICE COST APPORTIONMENT,COST ALLOCATION,HHA STATISTICAL DATA,COST ALLOCATION,TRIAL BALANCE OF EXPENSE ACCOUNTS,COST ALLOCATION,Total Inpatient Days/Outpatient Visits,COMPUTATION OF RATIO OF COST TO CHARGES,COST ALLOCATION,TRIAL BALANCE OF EXPENSE ACCOUNTS,TRIAL BALANCE OF EXPENSE ACCOUNTS,Medicaid Inpatient Days/Outpatient Visits,ALLOCATION OF NEW CAPITAL COSTS,HOSPITAL WAGE INDEX DATA,INPATIENT ANCILLARY SERVICE COST APPORTIONMENT,HOSPITAL WAGE INDEX DATA,INPATIENT ANCILLARY SERVICE COST APPORTIONMENT,Total Inpatient Days/Outpatient Visits,HHA STATISTICAL DATA,ALLOCATION OF NEW CAPITAL COSTS,COST ALLOCATION,APPORTIONMENT OF INPATIENT/OUTPATIENT ANCILLARY SERVICE OTHER PASS THROUGH COSTS,APPORTIONMENT OF INPATIENT ROUTINE SERVICE CAPITAL COSTS,Medicaid Inpatient Days/Outpatient Visits,TRIAL BALANCE OF EXPENSE ACCOUNTS,COMPUTATION OF RATIO OF COST TO CHARGES,BED DAYS AVAILABLE,,TRIAL BALANCE OF EXPENSE ACCOUNTS,TRIAL BALANCE OF EXPENSE ACCOUNTS,TRIAL BALANCE OF EXPENSE ACCOUNTS,ADJUSTMENTS,COST ALLOCATION,Total Inpatient Days/Outpatient Visits,APPORTIONMENT OF INPATIENT/OUTPATIENT ANCILLARY SERVICE OTHER PASS THROUGH COSTS,APPORTIONMENT OF INPATIENT/OUTPATIENT ANCILLARY SERVICE OTHER PASS THROUGH COSTS,APPORTIONMENT OF INPATIENT/OUTPATIENT ANCILLARY SERVICE OTHER PASS THROUGH COSTS,COST ALLOCATION,COMPUTATION OF RATIO OF COST TO CHARGES,ALLOCATION OF NEW CAPITAL COSTS,S-10 DATA,ALLOCATION OF NEW CAPITAL COSTS,Medicaid Inpatient Days/Outpatient Visits,CALCULATION OF REIMBURSEMENT SETTLEMENT,INPATIENT ANCILLARY SERVICE COST APPORTIONMENT,COMPUTATION OF RATIO OF COST TO CHARGES,APPORTIONMENT OF INPATIENT/OUTPATIENT ANCILLARY SERVICE OTHER PASS THROUGH COSTS,COMPUTATION OF INPATIENT OPERATING COSTS,COMPUTATION OF RATIO OF COST TO CHARGES,TRIAL BALANCE OF EXPENSE ACCOUNTS,APPORTIONMENT OF INPATIENT/OUTPATIENT ANCILLARY SERVICE OTHER PASS THROUGH COSTS,TRIAL BALANCE OF EXPENSE ACCOUNTS,COST ALLOCATION,TRIAL BALANCE OF EXPENSE ACCOUNTS,COST ALLOCATION,APPORTIONMENT OF MEDICAL AND OTHER HEALTH SERVICES,APPORTIONMENT OF MEDICAL AND OTHER HEALTH SERVICES,INPATIENT ANCILLARY SERVICE COST APPORTIONMENT,APPORTIONMENT OF INPATIENT/OUTPATIENT ANCILLARY SERVICE OTHER PASS THROUGH COSTS,Medicaid Inpatient Days/Outpatient Visits,APPORTIONMENT OF MEDICAL AND OTHER HEALTH SERVICES,APPORTIONMENT OF MEDICAL AND OTHER HEALTH SERVICES,INPATIENT ANCILLARY SERVICE COST APPORTIONMENT,TRIAL BALANCE OF EXPENSE ACCOUNTS,BED DAYS AVAILABLE,APPORTIONMENT OF MEDICAL AND OTHER HEALTH SERVICES,INPATIENT ANCILLARY SERVICE COST APPORTIONMENT,HOSPITAL WAGE INDEX DATA,APPORTIONMENT OF INPATIENT/OUTPATIENT ANCILLARY SERVICE OTHER PASS THROUGH COSTS,COST ALLOCATION,ALLOCATION OF NEW CAPITAL COSTS,APPORTIONMENT OF INPATIENT ROUTINE SERVICE OTHER PASS THROUGH COSTS,HOSPITAL WAGE INDEX DATA,APPORTIONMENT OF INPATIENT ROUTINE SERVICE OTHER PASS THROUGH COSTS,,APPORTIONMENT OF MEDICAL AND OTHER HEALTH SERVICES,HOSPITAL WAGE INDEX DATA,COMPUTATION OF INPATIENT OPERATING COSTS,CALCULATION OF REIMBURSEMENT SETTLEMENT,APPORTIONMENT OF INPATIENT/OUTPATIENT ANCILLARY SERVICE OTHER PASS THROUGH COSTS,APPORTIONMENT OF INPATIENT/OUTPATIENT ANCILLARY SERVICE OTHER PASS THROUGH COSTS,COST ALLOCATION,APPORTIONMENT OF MEDICAL AND OTHER HEALTH SERVICES,HOSPITAL WAGE INDEX DATA,APPORTIONMENT OF MEDICAL AND OTHER HEALTH SERVICES,APPORTIONMENT OF MEDICAL AND OTHER HEALTH SERVICES,APPORTIONMENT OF MEDICAL AND OTHER HEALTH SERVICES,COMPUTATION OF INPATIENT OPERATING COSTS,RENAL STATISTICAL DATA,TRIAL BALANCE OF EXPENSE ACCOUNTS,CALCULATION OF REIMBURSEMENT SETTLEMENT (PPS),S-10 DATA,APPORTIONMENT OF INPATIENT/OUTPATIENT ANCILLARY SERVICE OTHER PASS THROUGH COSTS,APPORTIONMENT OF MEDICAL AND OTHER HEALTH SERVICES,CALCULATION OF REIMBURSEMENT SETTLEMENT,INPATIENT ANCILLARY SERVICE COST APPORTIONMENT,HHA STATISTICAL DATA,APPORTIONMENT OF INPATIENT/OUTPATIENT ANCILLARY SERVICE OTHER PASS THROUGH COSTS,Total Inpatient Days/Outpatient Visits,APPORTIONMENT OF INPATIENT/OUTPATIENT ANCILLARY SERVICE OTHER PASS THROUGH COSTS,HOSPITAL WAGE INDEX DATA,COST ALLOCATION,COMPUTATION OF RATIO OF COST TO CHARGES,APPORTIONMENT OF INPATIENT/OUTPATIENT ANCILLARY SERVICE OTHER PASS THROUGH COSTS,APPORTIONMENT OF INPATIENT/OUTPATIENT ANCILLARY SERVICE OTHER PASS THROUGH COSTS,COST ALLOCATION,TRIAL BALANCE OF EXPENSE ACCOUNTS,COST ALLOCATION,BALANCE SHEET,COMPUTATION OF RATIO OF COST TO CHARGES,APPORTIONMENT OF MEDICAL AND OTHER HEALTH SERVICES,RENAL STATISTICAL DATA,APPORTIONMENT OF MEDICAL AND OTHER HEALTH SERVICES,HOSPITAL WAGE INDEX DATA,INPATIENT ANCILLARY SERVICE COST APPORTIONMENT,HOSPITAL WAGE INDEX DATA,BALANCE SHEET,TRIAL BALANCE OF EXPENSE ACCOUNTS,HOSPITAL WAGE INDEX DATA,HHA STATISTICAL DATA,,ALLOCATION OF NEW CAPITAL COSTS,RENAL STATISTICAL DATA,COMPUTATION OF RATIO OF COST TO CHARGES,COMPUTATION OF RATIO OF COST TO CHARGES,,APPORTIONMENT OF MEDICAL AND OTHER HEALTH SERVICES,COMPUTATION OF RATIO OF COST TO CHARGES,ALLOCATION OF NEW CAPITAL COSTS,RENAL STATISTICAL DATA,APPORTIONMENT OF INPATIENT/OUTPATIENT ANCILLARY SERVICE OTHER PASS THROUGH COSTS,HOSPITAL WAGE INDEX DATA,TRIAL BALANCE OF EXPENSE ACCOUNTS,INPATIENT ANCILLARY SERVICE COST APPORTIONMENT,ALLOCATION OF NEW CAPITAL COSTS,COST ALLOCATION,ALLOCATION OF NEW CAPITAL COSTS,APPORTIONMENT OF MEDICAL AND OTHER HEALTH SERVICES,APPORTIONMENT OF INPATIENT/OUTPATIENT ANCILLARY SERVICE OTHER PASS THROUGH COSTS,COST ALLOCATION,APPORTIONMENT OF INPATIENT/OUTPATIENT ANCILLARY SERVICE OTHER PASS THROUGH COSTS,COST ALLOCATION,APPORTIONMENT OF INPATIENT/OUTPATIENT ANCILLARY SERVICE OTHER PASS THROUGH COSTS,APPORTIONMENT OF INPATIENT/OUTPATIENT ANCILLARY SERVICE OTHER PASS THROUGH COSTS,HHA STATISTICAL DATA,APPORTIONMENT OF INPATIENT/OUTPATIENT ANCILLARY SERVICE OTHER PASS THROUGH COSTS,TRIAL BALANCE OF EXPENSE ACCOUNTS,ADJUSTMENTS,HHA STATISTICAL DATA,APPORTIONMENT OF INPATIENT/OUTPATIENT ANCILLARY SERVICE OTHER PASS THROUGH COSTS,RECONCILIATION OF CAPITAL COST CENTERS,RENAL STATISTICAL DATA,COST ALLOCATION,APPORTIONMENT OF MEDICAL AND OTHER HEALTH SERVICES,CALCULATION OF REIMBURSEMENT SETTLEMENT,COMPUTATION OF RATIO OF COST TO CHARGES,COMPUTATION OF INPATIENT OPERATING COSTS,COMPUTATION OF RATIO OF COST TO CHARGES,INPATIENT ANCILLARY SERVICE COST APPORTIONMENT,ALLOCATION OF NEW CAPITAL COSTS,INPATIENT ANCILLARY SERVICE COST APPORTIONMENT,INPATIENT ANCILLARY SERVICE COST APPORTIONMENT,HHA STATISTICAL DATA,INPATIENT ANCILLARY SERVICE COST APPORTIONMENT,INPATIENT ANCILLARY SERVICE COST APPORTIONMENT,BALANCE SHEET,TRIAL BALANCE OF EXPENSE ACCOUNTS,ANALYSIS OF CHANGES IN NEW CAPITAL BALANCES,APPORTIONMENT OF INPATIENT/OUTPATIENT ANCILLARY SERVICE OTHER PASS THROUGH COSTS,APPORTIONMENT OF MEDICAL AND OTHER HEALTH SERVICES,APPORTIONMENT OF INPATIENT ROUTINE SERVICE OTHER PASS THROUGH COSTS,APPORTIONMENT OF MEDICAL AND OTHER HEALTH SERVICES,APPORTIONMENT OF INPATIENT/OUTPATIENT ANCILLARY SERVICE OTHER PASS THROUGH COSTS,COST ALLOCATION,TRIAL BALANCE OF EXPENSE ACCOUNTS,HHA STATISTICAL DATA,HHA STATISTICAL DATA,COMPUTATION OF RATIO OF COST TO CHARGES,INPATIENT ANCILLARY SERVICE COST APPORTIONMENT,STATEMENT OF REVENUES AND EXPENSES,ADJUSTMENTS,COST ALLOCATION,Medicaid Inpatient Days/Outpatient Visits,TRIAL BALANCE OF EXPENSE ACCOUNTS,INPATIENT ANCILLARY SERVICE COST APPORTIONMENT,,HHA STATISTICAL DATA,HOSPITAL WAGE INDEX DATA,APPORTIONMENT OF INPATIENT/OUTPATIENT ANCILLARY SERVICE OTHER PASS THROUGH COSTS,,APPORTIONMENT OF MEDICAL AND OTHER HEALTH SERVICES,INPATIENT ANCILLARY SERVICE COST APPORTIONMENT,COST ALLOCATION,ADJUSTMENTS,S-10 DATA,COST ALLOCATION,COMPUTATION OF RATIO OF COST TO CHARGES,COMPUTATION OF RATIO OF COST TO CHARGES,INPATIENT ANCILLARY SERVICE COST APPORTIONMENT,HHA STATISTICAL DATA,S-10 DATA,COMPUTATION OF INPATIENT OPERATING COSTS,TRIAL BALANCE OF EXPENSE ACCOUNTS,APPORTIONMENT OF INPATIENT/OUTPATIENT ANCILLARY SERVICE OTHER PASS THROUGH COSTS,BALANCE SHEET,S-10 DATA,HHA STATISTICAL DATA,ADJUSTMENTS,,COMPUTATION OF RATIO OF COST TO CHARGES,Total Inpatient Days/Outpatient Visits,COST ALLOCATION,COST ALLOCATION,HOSPITAL WAGE INDEX DATA,APPORTIONMENT OF INPATIENT/OUTPATIENT ANCILLARY SERVICE OTHER PASS THROUGH COSTS,TRIAL BALANCE OF EXPENSE ACCOUNTS,COST ALLOCATION,CALCULATION OF REIMBURSEMENT SETTLEMENT,HOSPITAL WAGE INDEX DATA,NUMBER OF BEDS,Total Inpatient Days/Outpatient Visits,INPATIENT ANCILLARY SERVICE COST APPORTIONMENT,INPATIENT ANCILLARY SERVICE COST APPORTIONMENT,HOSPITAL WAGE INDEX DATA,COST ALLOCATION,CALCULATION OF REIMBURSEMENT SETTLEMENT,COST ALLOCATION,HHA STATISTICAL DATA,APPORTIONMENT OF MEDICAL AND OTHER HEALTH SERVICES,HOSPITAL WAGE INDEX DATA,APPORTIONMENT OF INPATIENT/OUTPATIENT ANCILLARY SERVICE OTHER PASS THROUGH COSTS,APPORTIONMENT OF INPATIENT/OUTPATIENT ANCILLARY SERVICE OTHER PASS THROUGH COSTS,COMPUTATION OF RATIO OF COST TO CHARGES,APPORTIONMENT OF INPATIENT/OUTPATIENT ANCILLARY SERVICE OTHER PASS THROUGH COSTS,HOSPITAL WAGE INDEX DATA,HOSPITAL WAGE INDEX DATA,NUMBER OF BEDS,,,APPORTIONMENT OF INPATIENT/OUTPATIENT ANCILLARY SERVICE OTHER PASS THROUGH COSTS,,APPORTIONMENT OF MEDICAL AND OTHER HEALTH SERVICES,COST ALLOCATION,,Total Inpatient Days/Outpatient Visits,TRIAL BALANCE OF EXPENSE ACCOUNTS,HOSPITAL WAGE INDEX DATA,HHA STATISTICAL DATA,TRIAL BALANCE OF EXPENSE ACCOUNTS,,INPATIENT ANCILLARY SERVICE COST APPORTIONMENT,INPATIENT ANCILLARY SERVICE COST APPORTIONMENT,HOSPITAL WAGE INDEX DATA,COST ALLOCATION,ADJUSTMENTS,HOSPITAL WAGE INDEX DATA,APPORTIONMENT OF INPATIENT/OUTPATIENT ANCILLARY SERVICE OTHER PASS THROUGH COSTS,INPATIENT ANCILLARY SERVICE COST APPORTIONMENT,BALANCE SHEET,COMPUTATION OF RATIO OF COST TO CHARGES,TRIAL BALANCE OF EXPENSE ACCOUNTS,COST ALLOCATION,TRIAL BALANCE OF EXPENSE ACCOUNTS,COMPUTATION OF RATIO OF COST TO CHARGES,COST ALLOCATION,COST ALLOCATION,HOSPITAL WAGE INDEX DATA,,APPORTIONMENT OF INPATIENT/OUTPATIENT ANCILLARY SERVICE OTHER PASS THROUGH COSTS,COST ALLOCATION,APPORTIONMENT OF INPATIENT/OUTPATIENT ANCILLARY SERVICE OTHER PASS THROUGH COSTS,TRIAL BALANCE OF EXPENSE ACCOUNTS,HOSPITAL WAGE INDEX DATA,TRIAL BALANCE OF EXPENSE ACCOUNTS,APPORTIONMENT OF INPATIENT/OUTPATIENT ANCILLARY SERVICE OTHER PASS THROUGH COSTS,COMPUTATION OF RATIO OF COST TO CHARGES,COST ALLOCATION,APPORTIONMENT OF INPATIENT/OUTPATIENT ANCILLARY SERVICE OTHER PASS THROUGH COSTS,NUMBER OF BEDS,APPORTIONMENT OF INPATIENT/OUTPATIENT ANCILLARY SERVICE OTHER PASS THROUGH COSTS,RENAL STATISTICAL DATA,TRIAL BALANCE OF EXPENSE ACCOUNTS,CALCULATION OF REIMBURSEMENT SETTLEMENT,CALCULATION OF REIMBURSEMENT SETTLEMENT,COMPUTATION OF RATIO OF COST TO CHARGES,APPORTIONMENT OF INPATIENT/OUTPATIENT ANCILLARY SERVICE OTHER PASS THROUGH COSTS,INPATIENT ANCILLARY SERVICE COST APPORTIONMENT,TRIAL BALANCE OF EXPENSE ACCOUNTS,ANALYSIS OF CHANGES IN NEW CAPITAL BALANCES,APPORTIONMENT OF INPATIENT/OUTPATIENT ANCILLARY SERVICE OTHER PASS THROUGH COSTS,RECONCILIATION OF CAPITAL COST CENTERS,TRIAL BALANCE OF EXPENSE ACCOUNTS,HOSPITAL WAGE INDEX DATA,CALCULATION OF REIMBURSEMENT SETTLEMENT,COST ALLOCATION,TRIAL BALANCE OF EXPENSE ACCOUNTS,TRIAL BALANCE OF EXPENSE ACCOUNTS,COST ALLOCATION,,HOSPITAL WAGE INDEX DATA,COMPUTATION OF RATIO OF COST TO CHARGES,APPORTIONMENT OF INPATIENT/OUTPATIENT ANCILLARY SERVICE OTHER PASS THROUGH COSTS,APPORTIONMENT OF INPATIENT/OUTPATIENT ANCILLARY SERVICE OTHER PASS THROUGH COSTS,APPORTIONMENT OF MEDICAL AND OTHER HEALTH SERVICES,INPATIENT ANCILLARY SERVICE COST APPORTIONMENT,HHA STATISTICAL DATA,COMPUTATION OF RATIO OF COST TO CHARGES,RENAL STATISTICAL DATA,ANALYSIS OF CHANGES IN NEW CAPITAL BALANCES,APPORTIONMENT OF INPATIENT/OUTPATIENT ANCILLARY SERVICE OTHER PASS THROUGH COSTS,COMPUTATION OF RATIO OF COST TO CHARGES,COST ALLOCATION,COST ALLOCATION,APPORTIONMENT OF MEDICAL AND OTHER HEALTH SERVICES,S-10 DATA,BED DAYS AVAILABLE,COST ALLOCATION,Medicaid Inpatient Days/Outpatient Visits,INPATIENT ANCILLARY SERVICE COST APPORTIONMENT,INPATIENT ANCILLARY SERVICE COST APPORTIONMENT,COMPUTATION OF RATIO OF COST TO CHARGES,ADJUSTMENTS,HHA STATISTICAL DATA,Medicaid Inpatient Days/Outpatient Visits,TRIAL BALANCE OF EXPENSE ACCOUNTS,COST ALLOCATION,NUMBER OF BEDS,INPATIENT ANCILLARY SERVICE COST APPORTIONMENT,HOSPITAL WAGE INDEX DATA,HOSPITAL WAGE INDEX DATA,HOSPITAL WAGE INDEX DATA,TRIAL BALANCE OF EXPENSE ACCOUNTS,INPATIENT ANCILLARY SERVICE COST APPORTIONMENT,,COST ALLOCATION,ALLOCATION OF NEW CAPITAL COSTS,BALANCE SHEET,CALCULATION OF REIMBURSEMENT SETTLEMENT,HOSPITAL WAGE INDEX DATA,INPATIENT ANCILLARY SERVICE COST APPORTIONMENT,COST ALLOCATION,Medicare Inpatient Days/Outpatient Visits,INPATIENT ANCILLARY SERVICE COST APPORTIONMENT,INPATIENT ANCILLARY SERVICE COST APPORTIONMENT,ANALYSIS OF CHANGES IN NEW CAPITAL BALANCES,HOSPITAL WAGE INDEX DATA,,COMPUTATION OF RATIO OF COST TO CHARGES,APPORTIONMENT OF INPATIENT/OUTPATIENT ANCILLARY SERVICE OTHER PASS THROUGH COSTS,APPORTIONMENT OF INPATIENT/OUTPATIENT ANCILLARY SERVICE OTHER PASS THROUGH COSTS,Total Inpatient Days/Outpatient Visits,COST ALLOCATION,TRIAL BALANCE OF EXPENSE ACCOUNTS,COST ALLOCATION,COMPUTATION OF RATIO OF COST TO CHARGES,Total Inpatient Days/Outpatient Visits,APPORTIONMENT OF INPATIENT/OUTPATIENT ANCILLARY SERVICE OTHER PASS THROUGH COSTS,TRIAL BALANCE OF EXPENSE ACCOUNTS,BALANCE SHEET,APPORTIONMENT OF MEDICAL AND OTHER HEALTH SERVICES,HOSPITAL WAGE INDEX DATA,COST ALLOCATION,COMPUTATION OF RATIO OF COST TO CHARGES,APPORTIONMENT OF INPATIENT/OUTPATIENT ANCILLARY SERVICE OTHER PASS THROUGH COSTS,COMPUTATION OF RATIO OF COST TO CHARGES,INPATIENT ANCILLARY SERVICE COST APPORTIONMENT,INPATIENT ANCILLARY SERVICE COST APPORTIONMENT,APPORTIONMENT OF INPATIENT ROUTINE SERVICE OTHER PASS THROUGH COSTS,TRIAL BALANCE OF EXPENSE ACCOUNTS,Total Inpatient Days/Outpatient Visits,TRIAL BALANCE OF EXPENSE ACCOUNTS,COMPUTATION OF INPATIENT OPERATING COSTS,COMPUTATION OF INPATIENT OPERATING COSTS,COMPUTATION OF RATIO OF COST TO CHARGES,TRIAL BALANCE OF EXPENSE ACCOUNTS,INPATIENT ANCILLARY SERVICE COST APPORTIONMENT,BED DAYS AVAILABLE,COMPUTATION OF RATIO OF COST TO CHARGES,APPORTIONMENT OF INPATIENT/OUTPATIENT ANCILLARY SERVICE OTHER PASS THROUGH COSTS,Total Inpatient Days/Outpatient Visits,COMPUTATION OF RATIO OF COST TO CHARGES,TRIAL BALANCE OF EXPENSE ACCOUNTS,,APPORTIONMENT OF MEDICAL AND OTHER HEALTH SERVICES,APPORTIONMENT OF INPATIENT/OUTPATIENT ANCILLARY SERVICE OTHER PASS THROUGH COSTS,RENAL STATISTICAL DATA,,,INPATIENT ANCILLARY SERVICE COST APPORTIONMENT,INPATIENT ANCILLARY SERVICE COST APPORTIONMENT,APPORTIONMENT OF INPATIENT ROUTINE SERVICE CAPITAL COSTS,HHA STATISTICAL DATA,APPORTIONMENT OF MEDICAL AND OTHER HEALTH SERVICES,INPATIENT ANCILLARY SERVICE COST APPORTIONMENT,ANALYSIS OF CHANGES IN NEW CAPITAL BALANCES,COMPUTATION OF RATIO OF COST TO CHARGES,INPATIENT ANCILLARY SERVICE COST APPORTIONMENT,ALLOCATION OF NEW CAPITAL COSTS,APPORTIONMENT OF INPATIENT/OUTPATIENT ANCILLARY SERVICE OTHER PASS THROUGH COSTS,INPATIENT ANCILLARY SERVICE COST APPORTIONMENT,COST ALLOCATION,COST ALLOCATION,HOSPITAL WAGE INDEX DATA,COMPUTATION OF RATIO OF COST TO CHARGES,COMPUTATION OF RATIO OF COST TO CHARGES,INPATIENT ANCILLARY SERVICE COST APPORTIONMENT,COMPUTATION OF RATIO OF COST TO CHARGES,STATEMENT OF PATIENT REVENUES AND OPERATING EXPENSES,TRIAL BALANCE OF EXPENSE ACCOUNTS,COST ALLOCATION,COMPUTATION OF INPATIENT OPERATING COSTS,COMPUTATION OF INPATIENT OPERATING COSTS,APPORTIONMENT OF INPATIENT/OUTPATIENT ANCILLARY SERVICE OTHER PASS THROUGH COSTS,COMPUTATION OF INPATIENT OPERATING COSTS,BALANCE SHEET,ANALYSIS OF CHANGES IN NEW CAPITAL BALANCES,APPORTIONMENT OF MEDICAL AND OTHER HEALTH SERVICES,TRIAL BALANCE OF EXPENSE ACCOUNTS,COMPUTATION OF RATIO OF COST TO CHARGES,COMPUTATION OF INPATIENT OPERATING COSTS,COST ALLOCATION,APPORTIONMENT OF INPATIENT/OUTPATIENT ANCILLARY SERVICE OTHER PASS THROUGH COSTS,INPATIENT ANCILLARY SERVICE COST APPORTIONMENT,HOSPITAL WAGE INDEX DATA,INPATIENT ANCILLARY SERVICE COST APPORTIONMENT,TRIAL BALANCE OF EXPENSE ACCOUNTS,TRIAL BALANCE OF EXPENSE ACCOUNTS,INPATIENT ANCILLARY SERVICE COST APPORTIONMENT,APPORTIONMENT OF INPATIENT/OUTPATIENT ANCILLARY SERVICE OTHER PASS THROUGH COSTS,APPORTIONMENT OF INPATIENT/OUTPATIENT ANCILLARY SERVICE OTHER PASS THROUGH COSTS,TRIAL BALANCE OF EXPENSE ACCOUNTS,COST ALLOCATION,COST ALLOCATION,CALCULATION OF REIMBURSEMENT SETTLEMENT,HOSPITAL WAGE INDEX DATA,ADJUSTMENTS,BED DAYS AVAILABLE,APPORTIONMENT OF INPATIENT/OUTPATIENT ANCILLARY SERVICE OTHER PASS THROUGH COSTS,COST ALLOCATION,Total Inpatient Days/Outpatient Visits,TRIAL BALANCE OF EXPENSE ACCOUNTS,HOSPITAL WAGE INDEX DATA,TRIAL BALANCE OF EXPENSE ACCOUNTS,HOSPITAL IDENTIFICATION INFORMATION,INPATIENT ANCILLARY SERVICE COST APPORTIONMENT,HOSPITAL WAGE INDEX DATA,Total Inpatient Days/Outpatient Visits,HHA STATISTICAL DATA,APPORTIONMENT OF MEDICAL AND OTHER HEALTH SERVICES,APPORTIONMENT OF MEDICAL AND OTHER HEALTH SERVICES,HOSPITAL IDENTIFICATION INFORMATION,INPATIENT ANCILLARY SERVICE COST APPORTIONMENT,APPORTIONMENT OF INPATIENT/OUTPATIENT ANCILLARY SERVICE OTHER PASS THROUGH COSTS,,TRIAL BALANCE OF EXPENSE ACCOUNTS,TRIAL BALANCE OF EXPENSE ACCOUNTS,APPORTIONMENT OF INPATIENT/OUTPATIENT ANCILLARY SERVICE OTHER PASS THROUGH COSTS,ALLOCATION OF NEW CAPITAL COSTS,HOSPITAL WAGE INDEX DATA,APPORTIONMENT OF INPATIENT/OUTPATIENT ANCILLARY SERVICE OTHER PASS THROUGH COSTS,Total Inpatient Days/Outpatient Visits,APPORTIONMENT OF INPATIENT/OUTPATIENT ANCILLARY SERVICE OTHER PASS THROUGH COSTS,CALCULATION OF REIMBURSEMENT SETTLEMENT (PPS),APPORTIONMENT OF INPATIENT/OUTPATIENT ANCILLARY SERVICE OTHER PASS THROUGH COSTS,INPATIENT ANCILLARY SERVICE COST APPORTIONMENT,STATEMENT OF REVENUES AND EXPENSES,CALCULATION OF REIMBURSEMENT SETTLEMENT,COST ALLOCATION,TRIAL BALANCE OF EXPENSE ACCOUNTS,TRIAL BALANCE OF EXPENSE ACCOUNTS,COMPUTATION OF RATIO OF COST TO CHARGES,,TRIAL BALANCE OF EXPENSE ACCOUNTS,APPORTIONMENT OF INPATIENT/OUTPATIENT ANCILLARY SERVICE OTHER PASS THROUGH COSTS,INPATIENT ANCILLARY SERVICE COST APPORTIONMENT,APPORTIONMENT OF INPATIENT/OUTPATIENT ANCILLARY SERVICE OTHER PASS THROUGH COSTS,APPORTIONMENT OF INPATIENT/OUTPATIENT ANCILLARY SERVICE OTHER PASS THROUGH COSTS,INPATIENT ANCILLARY SERVICE COST APPORTIONMENT,APPORTIONMENT OF MEDICAL AND OTHER HEALTH SERVICES,INPATIENT ANCILLARY SERVICE COST APPORTIONMENT,APPORTIONMENT OF MEDICAL AND OTHER HEALTH SERVICES,RECONCILIATION OF CAPITAL COST CENTERS,ANALYSIS OF CHANGES IN NEW CAPITAL BALANCES,COST ALLOCATION,RECONCILIATION OF CAPITAL COST CENTERS,COMPUTATION OF INPATIENT OPERATING COSTS,COMPUTATION OF RATIO OF COST TO CHARGES,APPORTIONMENT OF MEDICAL AND OTHER HEALTH SERVICES,HHA STATISTICAL DATA,APPORTIONMENT OF INPATIENT/OUTPATIENT ANCILLARY SERVICE OTHER PASS THROUGH COSTS,APPORTIONMENT OF INPATIENT/OUTPATIENT ANCILLARY SERVICE OTHER PASS THROUGH COSTS,INPATIENT ANCILLARY SERVICE COST APPORTIONMENT,HOSPITAL WAGE INDEX DATA,TRIAL BALANCE OF EXPENSE ACCOUNTS,HOSPITAL WAGE INDEX DATA,INPATIENT ANCILLARY SERVICE COST APPORTIONMENT,COMPUTATION OF RATIO OF COST TO CHARGES,APPORTIONMENT OF INPATIENT/OUTPATIENT ANCILLARY SERVICE OTHER PASS THROUGH COSTS,COMPUTATION OF RATIO OF COST TO CHARGES,COST ALLOCATION,COMPUTATION OF RATIO OF COST TO CHARGES,Total Inpatient Days/Outpatient Visits,Medicaid Inpatient Days/Outpatient Visits,COST ALLOCATION,COMPUTATION OF RATIO OF COST TO CHARGES,ALLOCATION OF NEW CAPITAL COSTS,HHA STATISTICAL DATA,COST ALLOCATION,COST ALLOCATION,COST ALLOCATION,APPORTIONMENT OF INPATIENT ROUTINE SERVICE CAPITAL COSTS,COST ALLOCATION,HOSPITAL WAGE INDEX DATA,ALLOCATION OF NEW CAPITAL COSTS,Medicaid Inpatient Days/Outpatient Visits,ALLOCATION OF NEW CAPITAL COSTS,COST ALLOCATION,INPATIENT ANCILLARY SERVICE COST APPORTIONMENT,HOSPITAL WAGE INDEX DATA,HOSPITAL WAGE INDEX DATA,COST ALLOCATION,APPORTIONMENT OF MEDICAL AND OTHER HEALTH SERVICES,TRIAL BALANCE OF EXPENSE ACCOUNTS,TRIAL BALANCE OF EXPENSE ACCOUNTS,COST ALLOCATION,COST ALLOCATION,BALANCE SHEET,COST ALLOCATION,COST ALLOCATION,APPORTIONMENT OF MEDICAL AND OTHER HEALTH SERVICES,,ADJUSTMENTS,COST ALLOCATION,APPORTIONMENT OF MEDICAL AND OTHER HEALTH SERVICES,INPATIENT ANCILLARY SERVICE COST APPORTIONMENT,TRIAL BALANCE OF EXPENSE ACCOUNTS,ANALYSIS OF CHANGES IN NEW CAPITAL BALANCES,RENAL STATISTICAL DATA,COMPUTATION OF RATIO OF COST TO CHARGES,,COMPUTATION OF RATIO OF COST TO CHARGES,,COST ALLOCATION,INPATIENT ANCILLARY SERVICE COST APPORTIONMENT,COST ALLOCATION,APPORTIONMENT OF MEDICAL AND OTHER HEALTH SERVICES,,HOSPITAL WAGE INDEX DATA,,COMPUTATION OF RATIO OF COST TO CHARGES,APPORTIONMENT OF INPATIENT/OUTPATIENT ANCILLARY SERVICE OTHER PASS THROUGH COSTS,INPATIENT ANCILLARY SERVICE COST APPORTIONMENT,HOSPITAL WAGE INDEX DATA,ALLOCATION OF NEW CAPITAL COSTS,ALLOCATION OF NEW CAPITAL COSTS,ANALYSIS OF CHANGES IN NEW CAPITAL BALANCES,ADJUSTMENTS,TRIAL BALANCE OF EXPENSE ACCOUNTS,COST ALLOCATION,APPORTIONMENT OF INPATIENT/OUTPATIENT ANCILLARY SERVICE OTHER PASS THROUGH COSTS,APPORTIONMENT OF INPATIENT/OUTPATIENT ANCILLARY SERVICE OTHER PASS THROUGH COSTS,HOSPITAL WAGE INDEX DATA,HOSPITAL WAGE INDEX DATA,INPATIENT ANCILLARY SERVICE COST APPORTIONMENT,ANALYSIS OF CHANGES IN NEW CAPITAL BALANCES,APPORTIONMENT OF MEDICAL AND OTHER HEALTH SERVICES,INPATIENT ANCILLARY SERVICE COST APPORTIONMENT,APPORTIONMENT OF INPATIENT/OUTPATIENT ANCILLARY SERVICE OTHER PASS THROUGH COSTS,APPORTIONMENT OF INPATIENT/OUTPATIENT ANCILLARY SERVICE OTHER PASS THROUGH COSTS,APPORTIONMENT OF INPATIENT/OUTPATIENT ANCILLARY SERVICE OTHER PASS THROUGH COSTS,INPATIENT ANCILLARY SERVICE COST APPORTIONMENT,HHA STATISTICAL DATA,APPORTIONMENT OF MEDICAL AND OTHER HEALTH SERVICES,TRIAL BALANCE OF EXPENSE ACCOUNTS,COST ALLOCATION,HHA STATISTICAL DATA,INPATIENT ANCILLARY SERVICE COST APPORTIONMENT,Medicaid Inpatient Days/Outpatient Visits,HOSPITAL WAGE INDEX DATA,HOSPITAL WAGE INDEX DATA,ANALYSIS OF CHANGES IN NEW CAPITAL BALANCES,INPATIENT ANCILLARY SERVICE COST APPORTIONMENT,COMPUTATION OF RATIO OF COST TO CHARGES,APPORTIONMENT OF MEDICAL AND OTHER HEALTH SERVICES,TRIAL BALANCE OF EXPENSE ACCOUNTS,ADJUSTMENTS,COMPUTATION OF RATIO OF COST TO CHARGES,APPORTIONMENT OF MEDICAL AND OTHER HEALTH SERVICES,Total Inpatient Days/Outpatient Visits,APPORTIONMENT OF INPATIENT ROUTINE SERVICE CAPITAL COSTS,COST ALLOCATION,,HHA STATISTICAL DATA,TRIAL BALANCE OF EXPENSE ACCOUNTS,APPORTIONMENT OF INPATIENT/OUTPATIENT ANCILLARY SERVICE OTHER PASS THROUGH COSTS,BALANCE SHEET,COST ALLOCATION,ALLOCATION OF NEW CAPITAL COSTS,COST ALLOCATION,APPORTIONMENT OF INPATIENT/OUTPATIENT ANCILLARY SERVICE OTHER PASS THROUGH COSTS,INPATIENT ANCILLARY SERVICE COST APPORTIONMENT,APPORTIONMENT OF MEDICAL AND OTHER HEALTH SERVICES,APPORTIONMENT OF INPATIENT/OUTPATIENT ANCILLARY SERVICE OTHER PASS THROUGH COSTS,HOSPITAL WAGE INDEX DATA,APPORTIONMENT OF MEDICAL AND OTHER HEALTH SERVICES,APPORTIONMENT OF INPATIENT/OUTPATIENT ANCILLARY SERVICE OTHER PASS THROUGH COSTS,RENAL STATISTICAL DATA,,TRIAL BALANCE OF EXPENSE ACCOUNTS,COST ALLOCATION,Total Inpatient Days/Outpatient Visits,COST ALLOCATION,COMPUTATION OF RATIO OF COST TO CHARGES,TRIAL BALANCE OF EXPENSE ACCOUNTS,COST ALLOCATION,APPORTIONMENT OF INPATIENT/OUTPATIENT ANCILLARY SERVICE OTHER PASS THROUGH COSTS,BED DAYS AVAILABLE,APPORTIONMENT OF MEDICAL AND OTHER HEALTH SERVICES,APPORTIONMENT OF INPATIENT/OUTPATIENT ANCILLARY SERVICE OTHER PASS THROUGH COSTS,INPATIENT ANCILLARY SERVICE COST APPORTIONMENT,INPATIENT ANCILLARY SERVICE COST APPORTIONMENT,APPORTIONMENT OF INPATIENT/OUTPATIENT ANCILLARY SERVICE OTHER PASS THROUGH COSTS,Total Inpatient Days/Outpatient Visits,HOSPITAL WAGE INDEX DATA,COST ALLOCATION,COST ALLOCATION,COMPUTATION OF RATIO OF COST TO CHARGES,COMPUTATION OF RATIO OF COST TO CHARGES,,INPATIENT ANCILLARY SERVICE COST APPORTIONMENT,APPORTIONMENT OF INPATIENT/OUTPATIENT ANCILLARY SERVICE OTHER PASS THROUGH COSTS,ADJUSTMENTS,COMPUTATION OF RATIO OF COST TO CHARGES,HOSPITAL WAGE INDEX DATA,APPORTIONMENT OF INPATIENT/OUTPATIENT ANCILLARY SERVICE OTHER PASS THROUGH COSTS,HOSPITAL WAGE INDEX DATA,TRIAL BALANCE OF EXPENSE ACCOUNTS,APPORTIONMENT OF INPATIENT/OUTPATIENT ANCILLARY SERVICE OTHER PASS THROUGH COSTS,APPORTIONMENT OF INPATIENT/OUTPATIENT ANCILLARY SERVICE OTHER PASS THROUGH COSTS,,INPATIENT ANCILLARY SERVICE COST APPORTIONMENT,APPORTIONMENT OF INPATIENT/OUTPATIENT ANCILLARY SERVICE OTHER PASS THROUGH COSTS,TRIAL BALANCE OF EXPENSE ACCOUNTS,HHA STATISTICAL DATA,TRIAL BALANCE OF EXPENSE ACCOUNTS,INPATIENT ANCILLARY SERVICE COST APPORTIONMENT,APPORTIONMENT OF MEDICAL AND OTHER HEALTH SERVICES,RENAL STATISTICAL DATA,HHA STATISTICAL DATA,APPORTIONMENT OF INPATIENT ROUTINE SERVICE CAPITAL COSTS,COMPUTATION OF INPATIENT OPERATING COSTS,HOSPITAL WAGE INDEX DATA,COST ALLOCATION,Total Inpatient Days/Outpatient Visits,HOSPITAL WAGE INDEX DATA,COMPUTATION OF RATIO OF COST TO CHARGES,APPORTIONMENT OF INPATIENT/OUTPATIENT ANCILLARY SERVICE OTHER PASS THROUGH COSTS,HOSPITAL WAGE INDEX DATA,APPORTIONMENT OF INPATIENT/OUTPATIENT ANCILLARY SERVICE OTHER PASS THROUGH COSTS,ADJUSTMENTS,,HOSPITAL WAGE INDEX DATA,COST ALLOCATION,COMPUTATION OF RATIO OF COST TO CHARGES,APPORTIONMENT OF INPATIENT/OUTPATIENT ANCILLARY SERVICE OTHER PASS THROUGH COSTS,APPORTIONMENT OF INPATIENT/OUTPATIENT ANCILLARY SERVICE OTHER PASS THROUGH COSTS,APPORTIONMENT OF INPATIENT/OUTPATIENT ANCILLARY SERVICE OTHER PASS THROUGH COSTS,INPATIENT ANCILLARY SERVICE COST APPORTIONMENT,COMPUTATION OF RATIO OF COST TO CHARGES,HOSPITAL WAGE INDEX DATA,APPORTIONMENT OF INPATIENT/OUTPATIENT ANCILLARY SERVICE OTHER PASS THROUGH COSTS,Total Inpatient Days/Outpatient Visits,,HOSPITAL WAGE INDEX DATA,INPATIENT ANCILLARY SERVICE COST APPORTIONMENT,APPORTIONMENT OF INPATIENT/OUTPATIENT ANCILLARY SERVICE OTHER PASS THROUGH COSTS,,INPATIENT ANCILLARY SERVICE COST APPORTIONMENT,TRIAL BALANCE OF EXPENSE ACCOUNTS,TRIAL BALANCE OF EXPENSE ACCOUNTS,,HOSPITAL WAGE INDEX DATA,COMPUTATION OF RATIO OF COST TO CHARGES,APPORTIONMENT OF MEDICAL AND OTHER HEALTH SERVICES,INPATIENT ANCILLARY SERVICE COST APPORTIONMENT,APPORTIONMENT OF INPATIENT/OUTPATIENT ANCILLARY SERVICE OTHER PASS THROUGH COSTS,INPATIENT ANCILLARY SERVICE COST APPORTIONMENT,COST ALLOCATION,Total Inpatient Days/Outpatient Visits,INPATIENT ANCILLARY SERVICE COST APPORTIONMENT,HHA STATISTICAL DATA,HHA STATISTICAL DATA,APPORTIONMENT OF INPATIENT/OUTPATIENT ANCILLARY SERVICE OTHER PASS THROUGH COSTS,APPORTIONMENT OF MEDICAL AND OTHER HEALTH SERVICES,HOSPITAL WAGE INDEX DATA,HHA STATISTICAL DATA,CALCULATION OF REIMBURSEMENT SETTLEMENT,COST ALLOCATION,INPATIENT ANCILLARY SERVICE COST APPORTIONMENT,TRIAL BALANCE OF EXPENSE ACCOUNTS,INPATIENT ANCILLARY SERVICE COST APPORTIONMENT,APPORTIONMENT OF INPATIENT ROUTINE SERVICE OTHER PASS THROUGH COSTS,APPORTIONMENT OF MEDICAL AND OTHER HEALTH SERVICES,RENAL STATISTICAL DATA,INPATIENT ANCILLARY SERVICE COST APPORTIONMENT,APPORTIONMENT OF INPATIENT/OUTPATIENT ANCILLARY SERVICE OTHER PASS THROUGH COSTS,APPORTIONMENT OF INPATIENT/OUTPATIENT ANCILLARY SERVICE OTHER PASS THROUGH COSTS,COMPUTATION OF RATIO OF COST TO CHARGES,COST ALLOCATION,APPORTIONMENT OF INPATIENT/OUTPATIENT ANCILLARY SERVICE OTHER PASS THROUGH COSTS,COMPUTATION OF INPATIENT OPERATING COSTS,TRIAL BALANCE OF EXPENSE ACCOUNTS,APPORTIONMENT OF INPATIENT/OUTPATIENT ANCILLARY SERVICE OTHER PASS THROUGH COSTS,BED DAYS AVAILABLE,TRIAL BALANCE OF EXPENSE ACCOUNTS,TRIAL BALANCE OF EXPENSE ACCOUNTS,APPORTIONMENT OF INPATIENT/OUTPATIENT ANCILLARY SERVICE OTHER PASS THROUGH COSTS,INPATIENT ANCILLARY SERVICE COST APPORTIONMENT,APPORTIONMENT OF INPATIENT/OUTPATIENT ANCILLARY SERVICE OTHER PASS THROUGH COSTS,APPORTIONMENT OF INPATIENT/OUTPATIENT ANCILLARY SERVICE OTHER PASS THROUGH COSTS,Medicare Inpatient Days/Outpatient Visits,HOSPITAL WAGE INDEX DATA,S-10 DATA,BED DAYS AVAILABLE,Total Inpatient Days/Outpatient Visits,RENAL STATISTICAL DATA,INPATIENT ANCILLARY SERVICE COST APPORTIONMENT,INPATIENT ANCILLARY SERVICE COST APPORTIONMENT,ANALYSIS OF CHANGES IN NEW CAPITAL BALANCES,APPORTIONMENT OF INPATIENT/OUTPATIENT ANCILLARY SERVICE OTHER PASS THROUGH COSTS,COST ALLOCATION,APPORTIONMENT OF INPATIENT/OUTPATIENT ANCILLARY SERVICE OTHER PASS THROUGH COSTS,,APPORTIONMENT OF MEDICAL AND OTHER HEALTH SERVICES,APPORTIONMENT OF INPATIENT/OUTPATIENT ANCILLARY SERVICE OTHER PASS THROUGH COSTS,COST ALLOCATION,TRIAL BALANCE OF EXPENSE ACCOUNTS,TRIAL BALANCE OF EXPENSE ACCOUNTS,HOSPITAL WAGE INDEX DATA,INPATIENT ANCILLARY SERVICE COST APPORTIONMENT,TRIAL BALANCE OF EXPENSE ACCOUNTS,,HOSPITAL WAGE INDEX DATA,ALLOCATION OF NEW CAPITAL COSTS,HOSPITAL WAGE INDEX DATA,,COMPUTATION OF RATIO OF COST TO CHARGES,APPORTIONMENT OF MEDICAL AND OTHER HEALTH SERVICES,,COST ALLOCATION,HOSPITAL WAGE INDEX DATA,RENAL STATISTICAL DATA,TRIAL BALANCE OF EXPENSE ACCOUNTS,BALANCE SHEET,INPATIENT ANCILLARY SERVICE COST APPORTIONMENT,COST ALLOCATION,Total Inpatient Days/Outpatient Visits,APPORTIONMENT OF INPATIENT/OUTPATIENT ANCILLARY SERVICE OTHER PASS THROUGH COSTS,Total Inpatient Days/Outpatient Visits,Medicaid Inpatient Days/Outpatient Visits,Total Inpatient Days/Outpatient Visits,Medicare Inpatient Days/Outpatient Visits,COMPUTATION OF RATIO OF COST TO CHARGES,APPORTIONMENT OF INPATIENT/OUTPATIENT ANCILLARY SERVICE OTHER PASS THROUGH COSTS,HOSPITAL IDENTIFICATION INFORMATION,APPORTIONMENT OF INPATIENT/OUTPATIENT ANCILLARY SERVICE OTHER PASS THROUGH COSTS,APPORTIONMENT OF MEDICAL AND OTHER HEALTH SERVICES,APPORTIONMENT OF MEDICAL AND OTHER HEALTH SERVICES,APPORTIONMENT OF INPATIENT/OUTPATIENT ANCILLARY SERVICE OTHER PASS THROUGH COSTS,APPORTIONMENT OF INPATIENT/OUTPATIENT ANCILLARY SERVICE OTHER PASS THROUGH COSTS,APPORTIONMENT OF INPATIENT/OUTPATIENT ANCILLARY SERVICE OTHER PASS THROUGH COSTS,INPATIENT ANCILLARY SERVICE COST APPORTIONMENT,BALANCE SHEET,CALCULATION OF REIMBURSEMENT SETTLEMENT,APPORTIONMENT OF INPATIENT ROUTINE SERVICE CAPITAL COSTS,APPORTIONMENT OF INPATIENT/OUTPATIENT ANCILLARY SERVICE OTHER PASS THROUGH COSTS,HOSPITAL WAGE INDEX DATA,COST ALLOCATION,INPATIENT ANCILLARY SERVICE COST APPORTIONMENT,APPORTIONMENT OF MEDICAL AND OTHER HEALTH SERVICES,APPORTIONMENT OF MEDICAL AND OTHER HEALTH SERVICES,BED DAYS AVAILABLE,APPORTIONMENT OF INPATIENT/OUTPATIENT ANCILLARY SERVICE OTHER PASS THROUGH COSTS,ALLOCATION OF NEW CAPITAL COSTS,COMPUTATION OF RATIO OF COST TO CHARGES,APPORTIONMENT OF MEDICAL AND OTHER HEALTH SERVICES,Medicaid Inpatient Days/Outpatient Visits,APPORTIONMENT OF MEDICAL AND OTHER HEALTH SERVICES,,HOSPITAL WAGE INDEX DATA,STATEMENT OF PATIENT REVENUES AND OPERATING EXPENSES,COST ALLOCATION,,ALLOCATION OF NEW CAPITAL COSTS,APPORTIONMENT OF MEDICAL AND OTHER HEALTH SERVICES,,INPATIENT ANCILLARY SERVICE COST APPORTIONMENT,INPATIENT ANCILLARY SERVICE COST APPORTIONMENT,APPORTIONMENT OF MEDICAL AND OTHER HEALTH SERVICES,BED DAYS AVAILABLE,HOSPITAL WAGE INDEX DATA,INPATIENT ANCILLARY SERVICE COST APPORTIONMENT,TRIAL BALANCE OF EXPENSE ACCOUNTS,S-10 DATA,ADJUSTMENTS,COST ALLOCATION,COMPUTATION OF RATIO OF COST TO CHARGES,APPORTIONMENT OF MEDICAL AND OTHER HEALTH SERVICES,ADJUSTMENTS,COST ALLOCATION,TRIAL BALANCE OF EXPENSE ACCOUNTS,HHA STATISTICAL DATA,BALANCE SHEET,COMPUTATION OF RATIO OF COST TO CHARGES,INPATIENT ANCILLARY SERVICE COST APPORTIONMENT,TRIAL BALANCE OF EXPENSE ACCOUNTS,ALLOCATION OF NEW CAPITAL COSTS,INPATIENT ANCILLARY SERVICE COST APPORTIONMENT,APPORTIONMENT OF INPATIENT/OUTPATIENT ANCILLARY SERVICE OTHER PASS THROUGH COSTS,ANALYSIS OF CHANGES IN NEW CAPITAL BALANCES,APPORTIONMENT OF INPATIENT/OUTPATIENT ANCILLARY SERVICE OTHER PASS THROUGH COSTS,Medicaid Inpatient Days/Outpatient Visits,ALLOCATION OF NEW CAPITAL COSTS,APPORTIONMENT OF MEDICAL AND OTHER HEALTH SERVICES,HHA STATISTICAL DATA,Total Inpatient Days/Outpatient Visits,INPATIENT ANCILLARY SERVICE COST APPORTIONMENT,APPORTIONMENT OF MEDICAL AND OTHER HEALTH SERVICES,COST ALLOCATION,COMPUTATION OF RATIO OF COST TO CHARGES,APPORTIONMENT OF INPATIENT/OUTPATIENT ANCILLARY SERVICE OTHER PASS THROUGH COSTS,HHA STATISTICAL DATA,,ALLOCATION OF NEW CAPITAL COSTS,HOSPITAL WAGE INDEX DATA,INPATIENT ANCILLARY SERVICE COST APPORTIONMENT,,APPORTIONMENT OF INPATIENT/OUTPATIENT ANCILLARY SERVICE OTHER PASS THROUGH COSTS,COMPUTATION OF RATIO OF COST TO CHARGES,COST ALLOCATION,APPORTIONMENT OF INPATIENT/OUTPATIENT ANCILLARY SERVICE OTHER PASS THROUGH COSTS,HOSPITAL WAGE INDEX DATA,COST ALLOCATION,INPATIENT ANCILLARY SERVICE COST APPORTIONMENT,COMPUTATION OF RATIO OF COST TO CHARGES,APPORTIONMENT OF INPATIENT/OUTPATIENT ANCILLARY SERVICE OTHER PASS THROUGH COSTS,APPORTIONMENT OF INPATIENT ROUTINE SERVICE CAPITAL COSTS,TRIAL BALANCE OF EXPENSE ACCOUNTS,APPORTIONMENT OF INPATIENT ROUTINE SERVICE CAPITAL COSTS,APPORTIONMENT OF INPATIENT/OUTPATIENT ANCILLARY SERVICE OTHER PASS THROUGH COSTS,RENAL STATISTICAL DATA,APPORTIONMENT OF MEDICAL AND OTHER HEALTH SERVICES,INPATIENT ANCILLARY SERVICE COST APPORTIONMENT,ALLOCATION OF NEW CAPITAL COSTS,TRIAL BALANCE OF EXPENSE ACCOUNTS,,APPORTIONMENT OF INPATIENT/OUTPATIENT ANCILLARY SERVICE OTHER PASS THROUGH COSTS,APPORTIONMENT OF INPATIENT/OUTPATIENT ANCILLARY SERVICE OTHER PASS THROUGH COSTS,APPORTIONMENT OF MEDICAL AND OTHER HEALTH SERVICES,Medicaid Inpatient Days/Outpatient Visits,ALLOCATION OF NEW CAPITAL COSTS,COST ALLOCATION,INPATIENT ANCILLARY SERVICE COST APPORTIONMENT,APPORTIONMENT OF INPATIENT/OUTPATIENT ANCILLARY SERVICE OTHER PASS THROUGH COSTS,Medicare Inpatient Days/Outpatient Visits,HOSPITAL WAGE INDEX DATA,CALCULATION OF REIMBURSEMENT SETTLEMENT,HOSPITAL WAGE INDEX DATA,HHA STATISTICAL DATA,TRIAL BALANCE OF EXPENSE ACCOUNTS,APPORTIONMENT OF INPATIENT/OUTPATIENT ANCILLARY SERVICE OTHER PASS THROUGH COSTS,INPATIENT ANCILLARY SERVICE COST APPORTIONMENT,COST ALLOCATION,COMPUTATION OF RATIO OF COST TO CHARGES,INPATIENT ANCILLARY SERVICE COST APPORTIONMENT,BED DAYS AVAILABLE,COMPUTATION OF RATIO OF COST TO CHARGES,INPATIENT ANCILLARY SERVICE COST APPORTIONMENT,COST ALLOCATION,INPATIENT ANCILLARY SERVICE COST APPORTIONMENT,APPORTIONMENT OF INPATIENT/OUTPATIENT ANCILLARY SERVICE OTHER PASS THROUGH COSTS,INPATIENT ANCILLARY SERVICE COST APPORTIONMENT,TRIAL BALANCE OF EXPENSE ACCOUNTS,APPORTIONMENT OF MEDICAL AND OTHER HEALTH SERVICES,TRIAL BALANCE OF EXPENSE ACCOUNTS,APPORTIONMENT OF MEDICAL AND OTHER HEALTH SERVICES,TRIAL BALANCE OF EXPENSE ACCOUNTS,TRIAL BALANCE OF EXPENSE ACCOUNTS,COMPUTATION OF RATIO OF COST TO CHARGES,RECONCILIATION OF CAPITAL COST CENTERS,HHA STATISTICAL DATA,TRIAL BALANCE OF EXPENSE ACCOUNTS,COMPUTATION OF RATIO OF COST TO CHARGES,COST ALLOCATION,APPORTIONMENT OF MEDICAL AND OTHER HEALTH SERVICES,COMPUTATION OF RATIO OF COST TO CHARGES,TRIAL BALANCE OF EXPENSE ACCOUNTS,HHA STATISTICAL DATA,INPATIENT ANCILLARY SERVICE COST APPORTIONMENT,INPATIENT ANCILLARY SERVICE COST APPORTIONMENT,TRIAL BALANCE OF EXPENSE ACCOUNTS,TRIAL BALANCE OF EXPENSE ACCOUNTS,,APPORTIONMENT OF INPATIENT/OUTPATIENT ANCILLARY SERVICE OTHER PASS THROUGH COSTS,COST ALLOCATION,APPORTIONMENT OF INPATIENT/OUTPATIENT ANCILLARY SERVICE OTHER PASS THROUGH COSTS,COMPUTATION OF RATIO OF COST TO CHARGES,COST ALLOCATION,APPORTIONMENT OF MEDICAL AND OTHER HEALTH SERVICES,,COMPUTATION OF RATIO OF COST TO CHARGES,COMPUTATION OF RATIO OF COST TO CHARGES,INPATIENT ANCILLARY SERVICE COST APPORTIONMENT,COST ALLOCATION,APPORTIONMENT OF INPATIENT ROUTINE SERVICE CAPITAL COSTS,,APPORTIONMENT OF MEDICAL AND OTHER HEALTH SERVICES,APPORTIONMENT OF MEDICAL AND OTHER HEALTH SERVICES,INPATIENT ANCILLARY SERVICE COST APPORTIONMENT,INPATIENT ANCILLARY SERVICE COST APPORTIONMENT,COMPUTATION OF RATIO OF COST TO CHARGES,Total Inpatient Days/Outpatient Visits,COST ALLOCATION,COST ALLOCATION,HHA STATISTICAL DATA,HOSPITAL WAGE INDEX DATA,ANALYSIS OF CHANGES IN NEW CAPITAL BALANCES,Total Inpatient Days/Outpatient Visits,INPATIENT ANCILLARY SERVICE COST APPORTIONMENT,COMPUTATION OF RATIO OF COST TO CHARGES,ALLOCATION OF NEW CAPITAL COSTS,HOSPITAL WAGE INDEX DATA,TRIAL BALANCE OF EXPENSE ACCOUNTS,COST ALLOCATION,APPORTIONMENT OF MEDICAL AND OTHER HEALTH SERVICES,APPORTIONMENT OF MEDICAL AND OTHER HEALTH SERVICES,COMPUTATION OF RATIO OF COST TO CHARGES,COMPUTATION OF RATIO OF COST TO CHARGES,COMPUTATION OF RATIO OF COST TO CHARGES,COMPUTATION OF RATIO OF COST TO CHARGES,INPATIENT ANCILLARY SERVICE COST APPORTIONMENT,APPORTIONMENT OF INPATIENT/OUTPATIENT ANCILLARY SERVICE OTHER PASS THROUGH COSTS,APPORTIONMENT OF INPATIENT/OUTPATIENT ANCILLARY SERVICE OTHER PASS THROUGH COSTS,APPORTIONMENT OF INPATIENT/OUTPATIENT ANCILLARY SERVICE OTHER PASS THROUGH COSTS,APPORTIONMENT OF INPATIENT/OUTPATIENT ANCILLARY SERVICE OTHER PASS THROUGH COSTS,APPORTIONMENT OF INPATIENT/OUTPATIENT ANCILLARY SERVICE OTHER PASS THROUGH COSTS,COMPUTATION OF RATIO OF COST TO CHARGES,,APPORTIONMENT OF INPATIENT/OUTPATIENT ANCILLARY SERVICE OTHER PASS THROUGH COSTS,COMPUTATION OF RATIO OF COST TO CHARGES,TRIAL BALANCE OF EXPENSE ACCOUNTS,APPORTIONMENT OF MEDICAL AND OTHER HEALTH SERVICES,COST ALLOCATION,,APPORTIONMENT OF INPATIENT/OUTPATIENT ANCILLARY SERVICE OTHER PASS THROUGH COSTS,INPATIENT ANCILLARY SERVICE COST APPORTIONMENT,,TRIAL BALANCE OF EXPENSE ACCOUNTS,APPORTIONMENT OF INPATIENT/OUTPATIENT ANCILLARY SERVICE OTHER PASS THROUGH COSTS,ALLOCATION OF NEW CAPITAL COSTS,BALANCE SHEET,COMPUTATION OF RATIO OF COST TO CHARGES,APPORTIONMENT OF INPATIENT/OUTPATIENT ANCILLARY SERVICE OTHER PASS THROUGH COSTS,COST ALLOCATION,INPATIENT ANCILLARY SERVICE COST APPORTIONMENT,TRIAL BALANCE OF EXPENSE ACCOUNTS,Total Inpatient Days/Outpatient Visits,,COMPUTATION OF RATIO OF COST TO CHARGES,Medicare Inpatient Days/Outpatient Visits,INPATIENT ANCILLARY SERVICE COST APPORTIONMENT,INPATIENT ANCILLARY SERVICE COST APPORTIONMENT,HOSPITAL WAGE INDEX DATA,APPORTIONMENT OF INPATIENT/OUTPATIENT ANCILLARY SERVICE OTHER PASS THROUGH COSTS,INPATIENT ANCILLARY SERVICE COST APPORTIONMENT,COMPUTATION OF RATIO OF COST TO CHARGES,APPORTIONMENT OF INPATIENT ROUTINE SERVICE CAPITAL COSTS,APPORTIONMENT OF MEDICAL AND OTHER HEALTH SERVICES,INPATIENT ANCILLARY SERVICE COST APPORTIONMENT,APPORTIONMENT OF INPATIENT/OUTPATIENT ANCILLARY SERVICE OTHER PASS THROUGH COSTS,APPORTIONMENT OF MEDICAL AND OTHER HEALTH SERVICES,,COST ALLOCATION,STATEMENT OF REVENUES AND EXPENSES,COMPUTATION OF RATIO OF COST TO CHARGES,Total Inpatient Days/Outpatient Visits,,INPATIENT ANCILLARY SERVICE COST APPORTIONMENT,APPORTIONMENT OF MEDICAL AND OTHER HEALTH SERVICES,APPORTIONMENT OF INPATIENT ROUTINE SERVICE CAPITAL COSTS,APPORTIONMENT OF MEDICAL AND OTHER HEALTH SERVICES,INPATIENT ANCILLARY SERVICE COST APPORTIONMENT,APPORTIONMENT OF INPATIENT/OUTPATIENT ANCILLARY SERVICE OTHER PASS THROUGH COSTS,COMPUTATION OF RATIO OF COST TO CHARGES,TRIAL BALANCE OF EXPENSE ACCOUNTS,HOSPITAL WAGE INDEX DATA,HOSPITAL WAGE INDEX DATA,APPORTIONMENT OF INPATIENT ROUTINE SERVICE OTHER PASS THROUGH COSTS,APPORTIONMENT OF INPATIENT/OUTPATIENT ANCILLARY SERVICE OTHER PASS THROUGH COSTS,HHA STATISTICAL DATA,HOSPITAL WAGE INDEX DATA,APPORTIONMENT OF INPATIENT/OUTPATIENT ANCILLARY SERVICE OTHER PASS THROUGH COSTS,,APPORTIONMENT OF MEDICAL AND OTHER HEALTH SERVICES,COMPUTATION OF RATIO OF COST TO CHARGES,INPATIENT ANCILLARY SERVICE COST APPORTIONMENT,Medicare Inpatient Days/Outpatient Visits,NUMBER OF BEDS,TRIAL BALANCE OF EXPENSE ACCOUNTS,TRIAL BALANCE OF EXPENSE ACCOUNTS,BED DAYS AVAILABLE,Total Inpatient Days/Outpatient Visits,S-10 DATA,INPATIENT ANCILLARY SERVICE COST APPORTIONMENT,HOSPITAL WAGE INDEX DATA,INPATIENT ANCILLARY SERVICE COST APPORTIONMENT,INPATIENT ANCILLARY SERVICE COST APPORTIONMENT,COST ALLOCATION,TRIAL BALANCE OF EXPENSE ACCOUNTS,TRIAL BALANCE OF EXPENSE ACCOUNTS,HHA STATISTICAL DATA,COMPUTATION OF RATIO OF COST TO CHARGES,BALANCE SHEET,COMPUTATION OF RATIO OF COST TO CHARGES,COMPUTATION OF RATIO OF COST TO CHARGES,INPATIENT ANCILLARY SERVICE COST APPORTIONMENT,COMPUTATION OF INPATIENT OPERATING COSTS,APPORTIONMENT OF INPATIENT ROUTINE SERVICE OTHER PASS THROUGH COSTS,ALLOCATION OF NEW CAPITAL COSTS,APPORTIONMENT OF INPATIENT/OUTPATIENT ANCILLARY SERVICE OTHER PASS THROUGH COSTS,COMPUTATION OF RATIO OF COST TO CHARGES,APPORTIONMENT OF INPATIENT ROUTINE SERVICE CAPITAL COSTS,APPORTIONMENT OF INPATIENT/OUTPATIENT ANCILLARY SERVICE OTHER PASS THROUGH COSTS,APPORTIONMENT OF MEDICAL AND OTHER HEALTH SERVICES,BED DAYS AVAILABLE,APPORTIONMENT OF MEDICAL AND OTHER HEALTH SERVICES,APPORTIONMENT OF INPATIENT/OUTPATIENT ANCILLARY SERVICE OTHER PASS THROUGH COSTS,ADJUSTMENTS,COMPUTATION OF RATIO OF COST TO CHARGES,HOSPITAL WAGE INDEX DATA,INPATIENT ANCILLARY SERVICE COST APPORTIONMENT,CALCULATION OF REIMBURSEMENT SETTLEMENT,COMPUTATION OF RATIO OF COST TO CHARGES,COST ALLOCATION,APPORTIONMENT OF INPATIENT/OUTPATIENT ANCILLARY SERVICE OTHER PASS THROUGH COSTS,HOSPITAL WAGE INDEX DATA,TRIAL BALANCE OF EXPENSE ACCOUNTS,COMPUTATION OF RATIO OF COST TO CHARGES,TRIAL BALANCE OF EXPENSE ACCOUNTS,ALLOCATION OF NEW CAPITAL COSTS,COMPUTATION OF INPATIENT OPERATING COSTS,COST ALLOCATION,INPATIENT ANCILLARY SERVICE COST APPORTIONMENT,CALCULATION OF REIMBURSEMENT SETTLEMENT,INPATIENT ANCILLARY SERVICE COST APPORTIONMENT,CALCULATION OF REIMBURSEMENT SETTLEMENT,COST ALLOCATION,TRIAL BALANCE OF EXPENSE ACCOUNTS,COST ALLOCATION,APPORTIONMENT OF INPATIENT/OUTPATIENT ANCILLARY SERVICE OTHER PASS THROUGH COSTS,APPORTIONMENT OF INPATIENT/OUTPATIENT ANCILLARY SERVICE OTHER PASS THROUGH COSTS,CALCULATION OF REIMBURSEMENT SETTLEMENT,HOSPITAL WAGE INDEX DATA,INPATIENT ANCILLARY SERVICE COST APPORTIONMENT,COST ALLOCATION,TRIAL BALANCE OF EXPENSE ACCOUNTS,APPORTIONMENT OF INPATIENT/OUTPATIENT ANCILLARY SERVICE OTHER PASS THROUGH COSTS,ANALYSIS OF CHANGES IN NEW CAPITAL BALANCES,COMPUTATION OF RATIO OF COST TO CHARGES,ADJUSTMENTS,APPORTIONMENT OF MEDICAL AND OTHER HEALTH SERVICES,INPATIENT ANCILLARY SERVICE COST APPORTIONMENT,RENAL STATISTICAL DATA,COST ALLOCATION,COST ALLOCATION,COST ALLOCATION,TRIAL BALANCE OF EXPENSE ACCOUNTS,COMPUTATION OF INPATIENT OPERATING COSTS,INPATIENT ANCILLARY SERVICE COST APPORTIONMENT,S-10 DATA,ALLOCATION OF NEW CAPITAL COSTS,COMPUTATION OF RATIO OF COST TO CHARGES,APPORTIONMENT OF MEDICAL AND OTHER HEALTH SERVICES,BALANCE SHEET,TRIAL BALANCE OF EXPENSE ACCOUNTS,HOSPITAL WAGE INDEX DATA,APPORTIONMENT OF MEDICAL AND OTHER HEALTH SERVICES,HOSPITAL WAGE INDEX DATA,INPATIENT ANCILLARY SERVICE COST APPORTIONMENT,APPORTIONMENT OF INPATIENT/OUTPATIENT ANCILLARY SERVICE OTHER PASS THROUGH COSTS,ANALYSIS OF CHANGES IN NEW CAPITAL BALANCES,COMPUTATION OF RATIO OF COST TO CHARGES,HOSPITAL WAGE INDEX DATA,APPORTIONMENT OF INPATIENT/OUTPATIENT ANCILLARY SERVICE OTHER PASS THROUGH COSTS,Total Inpatient Days/Outpatient Visits,COST ALLOCATION,HOSPITAL WAGE INDEX DATA,INPATIENT ANCILLARY SERVICE COST APPORTIONMENT,ADJUSTMENTS,APPORTIONMENT OF INPATIENT/OUTPATIENT ANCILLARY SERVICE OTHER PASS THROUGH COSTS,S-10 DATA,APPORTIONMENT OF INPATIENT/OUTPATIENT ANCILLARY SERVICE OTHER PASS THROUGH COSTS,,COST ALLOCATION,HOSPITAL WAGE INDEX DATA,APPORTIONMENT OF INPATIENT/OUTPATIENT ANCILLARY SERVICE OTHER PASS THROUGH COSTS,COST ALLOCATION,TRIAL BALANCE OF EXPENSE ACCOUNTS,COMPUTATION OF INPATIENT OPERATING COSTS,APPORTIONMENT OF INPATIENT/OUTPATIENT ANCILLARY SERVICE OTHER PASS THROUGH COSTS,HOSPITAL WAGE INDEX DATA,APPORTIONMENT OF MEDICAL AND OTHER HEALTH SERVICES,APPORTIONMENT OF MEDICAL AND OTHER HEALTH SERVICES,HHA STATISTICAL DATA,COST ALLOCATION,APPORTIONMENT OF INPATIENT/OUTPATIENT ANCILLARY SERVICE OTHER PASS THROUGH COSTS,INPATIENT ANCILLARY SERVICE COST APPORTIONMENT,,APPORTIONMENT OF INPATIENT/OUTPATIENT ANCILLARY SERVICE OTHER PASS THROUGH COSTS,APPORTIONMENT OF INPATIENT/OUTPATIENT ANCILLARY SERVICE OTHER PASS THROUGH COSTS,APPORTIONMENT OF INPATIENT/OUTPATIENT ANCILLARY SERVICE OTHER PASS THROUGH COSTS,HOSPITAL WAGE INDEX DATA,,ALLOCATION OF NEW CAPITAL COSTS,TRIAL BALANCE OF EXPENSE ACCOUNTS,,HOSPITAL WAGE INDEX DATA,APPORTIONMENT OF MEDICAL AND OTHER HEALTH SERVICES,,ALLOCATION OF NEW CAPITAL COSTS,TRIAL BALANCE OF EXPENSE ACCOUNTS,INPATIENT ANCILLARY SERVICE COST APPORTIONMENT,COMPUTATION OF RATIO OF COST TO CHARGES,COMPUTATION OF RATIO OF COST TO CHARGES,ALLOCATION OF NEW CAPITAL COSTS,INPATIENT ANCILLARY SERVICE COST APPORTIONMENT,TRIAL BALANCE OF EXPENSE ACCOUNTS,COST ALLOCATION,COST ALLOCATION,,HOSPITAL WAGE INDEX DATA,COST ALLOCATION,TRIAL BALANCE OF EXPENSE ACCOUNTS,APPORTIONMENT OF INPATIENT/OUTPATIENT ANCILLARY SERVICE OTHER PASS THROUGH COSTS,HOSPITAL WAGE INDEX DATA,APPORTIONMENT OF MEDICAL AND OTHER HEALTH SERVICES,APPORTIONMENT OF INPATIENT/OUTPATIENT ANCILLARY SERVICE OTHER PASS THROUGH COSTS,HOSPITAL IDENTIFICATION INFORMATION,,COMPUTATION OF RATIO OF COST TO CHARGES,INPATIENT ANCILLARY SERVICE COST APPORTIONMENT,TRIAL BALANCE OF EXPENSE ACCOUNTS,COMPUTATION OF RATIO OF COST TO CHARGES,HHA STATISTICAL DATA,APPORTIONMENT OF INPATIENT/OUTPATIENT ANCILLARY SERVICE OTHER PASS THROUGH COSTS,INPATIENT ANCILLARY SERVICE COST APPORTIONMENT,COMPUTATION OF RATIO OF COST TO CHARGES,APPORTIONMENT OF INPATIENT ROUTINE SERVICE CAPITAL COSTS,BALANCE SHEET,ALLOCATION OF NEW CAPITAL COSTS,INPATIENT ANCILLARY SERVICE COST APPORTIONMENT,Total Inpatient Days/Outpatient Visits,HOSPITAL WAGE INDEX DATA,INPATIENT ANCILLARY SERVICE COST APPORTIONMENT,COST ALLOCATION,COMPUTATION OF RATIO OF COST TO CHARGES,COST ALLOCATION,COMPUTATION OF RATIO OF COST TO CHARGES,TRIAL BALANCE OF EXPENSE ACCOUNTS,,Total Inpatient Days/Outpatient Visits,HOSPITAL WAGE INDEX DATA,Medicaid Inpatient Days/Outpatient Visits,TRIAL BALANCE OF EXPENSE ACCOUNTS,COST ALLOCATION,APPORTIONMENT OF INPATIENT/OUTPATIENT ANCILLARY SERVICE OTHER PASS THROUGH COSTS,APPORTIONMENT OF MEDICAL AND OTHER HEALTH SERVICES,APPORTIONMENT OF INPATIENT/OUTPATIENT ANCILLARY SERVICE OTHER PASS THROUGH COSTS,Medicaid Inpatient Days/Outpatient Visits,COMPUTATION OF RATIO OF COST TO CHARGES,APPORTIONMENT OF INPATIENT/OUTPATIENT ANCILLARY SERVICE OTHER PASS THROUGH COSTS,Total Inpatient Days/Outpatient Visits,APPORTIONMENT OF INPATIENT/OUTPATIENT ANCILLARY SERVICE OTHER PASS THROUGH COSTS,TRIAL BALANCE OF EXPENSE ACCOUNTS,COMPUTATION OF RATIO OF COST TO CHARGES,COMPUTATION OF RATIO OF COST TO CHARGES,ALLOCATION OF NEW CAPITAL COSTS,APPORTIONMENT OF INPATIENT/OUTPATIENT ANCILLARY SERVICE OTHER PASS THROUGH COSTS,INPATIENT ANCILLARY SERVICE COST APPORTIONMENT,APPORTIONMENT OF INPATIENT/OUTPATIENT ANCILLARY SERVICE OTHER PASS THROUGH COSTS,INPATIENT ANCILLARY SERVICE COST APPORTIONMENT,COST ALLOCATION,COMPUTATION OF INPATIENT OPERATING COSTS,COMPUTATION OF RATIO OF COST TO CHARGES,RENAL STATISTICAL DATA,APPORTIONMENT OF INPATIENT/OUTPATIENT ANCILLARY SERVICE OTHER PASS THROUGH COSTS,S-10 DATA,COST ALLOCATION,INPATIENT ANCILLARY SERVICE COST APPORTIONMENT,,TRIAL BALANCE OF EXPENSE ACCOUNTS,HOSPITAL WAGE INDEX DATA,APPORTIONMENT OF MEDICAL AND OTHER HEALTH SERVICES,COMPUTATION OF RATIO OF COST TO CHARGES,ALLOCATION OF NEW CAPITAL COSTS,COST ALLOCATION,APPORTIONMENT OF MEDICAL AND OTHER HEALTH SERVICES,INPATIENT ANCILLARY SERVICE COST APPORTIONMENT,TRIAL BALANCE OF EXPENSE ACCOUNTS,COMPUTATION OF RATIO OF COST TO CHARGES,HOSPITAL WAGE INDEX DATA,COMPUTATION OF INPATIENT OPERATING COSTS,ALLOCATION OF NEW CAPITAL COSTS,ADJUSTMENTS,INPATIENT ANCILLARY SERVICE COST APPORTIONMENT,HHA STATISTICAL DATA,INPATIENT ANCILLARY SERVICE COST APPORTIONMENT,TRIAL BALANCE OF EXPENSE ACCOUNTS,APPORTIONMENT OF INPATIENT/OUTPATIENT ANCILLARY SERVICE OTHER PASS THROUGH COSTS,COST ALLOCATION,COMPUTATION OF RATIO OF COST TO CHARGES,CALCULATION OF REIMBURSEMENT SETTLEMENT,,TRIAL BALANCE OF EXPENSE ACCOUNTS,APPORTIONMENT OF MEDICAL AND OTHER HEALTH SERVICES,INPATIENT ANCILLARY SERVICE COST APPORTIONMENT,INPATIENT ANCILLARY SERVICE COST APPORTIONMENT,RECONCILIATION OF CAPITAL COST CENTERS,COMPUTATION OF RATIO OF COST TO CHARGES,APPORTIONMENT OF INPATIENT/OUTPATIENT ANCILLARY SERVICE OTHER PASS THROUGH COSTS,TRIAL BALANCE OF EXPENSE ACCOUNTS,HHA STATISTICAL DATA,APPORTIONMENT OF INPATIENT/OUTPATIENT ANCILLARY SERVICE OTHER PASS THROUGH COSTS,APPORTIONMENT OF MEDICAL AND OTHER HEALTH SERVICES,APPORTIONMENT OF INPATIENT/OUTPATIENT ANCILLARY SERVICE OTHER PASS THROUGH COSTS,APPORTIONMENT OF INPATIENT/OUTPATIENT ANCILLARY SERVICE OTHER PASS THROUGH COSTS,NUMBER OF BEDS,APPORTIONMENT OF INPATIENT/OUTPATIENT ANCILLARY SERVICE OTHER PASS THROUGH COSTS,COST ALLOCATION,ALLOCATION OF NEW CAPITAL COSTS,,APPORTIONMENT OF INPATIENT/OUTPATIENT ANCILLARY SERVICE OTHER PASS THROUGH COSTS,INPATIENT ANCILLARY SERVICE COST APPORTIONMENT,TRIAL BALANCE OF EXPENSE ACCOUNTS,COST ALLOCATION,COMPUTATION OF RATIO OF COST TO CHARGES,APPORTIONMENT OF INPATIENT/OUTPATIENT ANCILLARY SERVICE OTHER PASS THROUGH COSTS,HOSPITAL WAGE INDEX DATA,HOSPITAL WAGE INDEX DATA,COST ALLOCATION,HOSPITAL WAGE INDEX DATA,HHA STATISTICAL DATA,COMPUTATION OF RATIO OF COST TO CHARGES,APPORTIONMENT OF INPATIENT/OUTPATIENT ANCILLARY SERVICE OTHER PASS THROUGH COSTS,COMPUTATION OF INPATIENT OPERATING COSTS,INPATIENT ANCILLARY SERVICE COST APPORTIONMENT,HOSPITAL WAGE INDEX DATA,INPATIENT ANCILLARY SERVICE COST APPORTIONMENT,CALCULATION OF REIMBURSEMENT SETTLEMENT,TRIAL BALANCE OF EXPENSE ACCOUNTS,,APPORTIONMENT OF INPATIENT/OUTPATIENT ANCILLARY SERVICE OTHER PASS THROUGH COSTS,INPATIENT ANCILLARY SERVICE COST APPORTIONMENT,APPORTIONMENT OF INPATIENT/OUTPATIENT ANCILLARY SERVICE OTHER PASS THROUGH COSTS,HHA STATISTICAL DATA,APPORTIONMENT OF INPATIENT/OUTPATIENT ANCILLARY SERVICE OTHER PASS THROUGH COSTS,APPORTIONMENT OF MEDICAL AND OTHER HEALTH SERVICES,COST ALLOCATION,APPORTIONMENT OF MEDICAL AND OTHER HEALTH SERVICES,,ALLOCATION OF NEW CAPITAL COSTS,APPORTIONMENT OF MEDICAL AND OTHER HEALTH SERVICES,COST ALLOCATION,APPORTIONMENT OF INPATIENT/OUTPATIENT ANCILLARY SERVICE OTHER PASS THROUGH COSTS,ALLOCATION OF NEW CAPITAL COSTS,HOSPITAL WAGE INDEX DATA,INPATIENT ANCILLARY SERVICE COST APPORTIONMENT,BED DAYS AVAILABLE,COST ALLOCATION,,ALLOCATION OF NEW CAPITAL COSTS,APPORTIONMENT OF MEDICAL AND OTHER HEALTH SERVICES,INPATIENT ANCILLARY SERVICE COST APPORTIONMENT,COMPUTATION OF RATIO OF COST TO CHARGES,APPORTIONMENT OF MEDICAL AND OTHER HEALTH SERVICES,TRIAL BALANCE OF EXPENSE ACCOUNTS,APPORTIONMENT OF INPATIENT/OUTPATIENT ANCILLARY SERVICE OTHER PASS THROUGH COSTS,COST ALLOCATION,,INPATIENT ANCILLARY SERVICE COST APPORTIONMENT,INPATIENT ANCILLARY SERVICE COST APPORTIONMENT,TRIAL BALANCE OF EXPENSE ACCOUNTS,COST ALLOCATION,APPORTIONMENT OF MEDICAL AND OTHER HEALTH SERVICES,,Total Inpatient Days/Outpatient Visits,TRIAL BALANCE OF EXPENSE ACCOUNTS,COST ALLOCATION,INPATIENT ANCILLARY SERVICE COST APPORTIONMENT,COST ALLOCATION,INPATIENT ANCILLARY SERVICE COST APPORTIONMENT,ALLOCATION OF NEW CAPITAL COSTS,INPATIENT ANCILLARY SERVICE COST APPORTIONMENT,INPATIENT ANCILLARY SERVICE COST APPORTIONMENT,APPORTIONMENT OF INPATIENT/OUTPATIENT ANCILLARY SERVICE OTHER PASS THROUGH COSTS,APPORTIONMENT OF INPATIENT/OUTPATIENT ANCILLARY SERVICE OTHER PASS THROUGH COSTS,TRIAL BALANCE OF EXPENSE ACCOUNTS,COST ALLOCATION,BED DAYS AVAILABLE,APPORTIONMENT OF INPATIENT/OUTPATIENT ANCILLARY SERVICE OTHER PASS THROUGH COSTS,TRIAL BALANCE OF EXPENSE ACCOUNTS,S-10 DATA,APPORTIONMENT OF INPATIENT/OUTPATIENT ANCILLARY SERVICE OTHER PASS THROUGH COSTS,RECONCILIATION OF CAPITAL COST CENTERS,HOSPITAL WAGE INDEX DATA,INPATIENT ANCILLARY SERVICE COST APPORTIONMENT,TRIAL BALANCE OF EXPENSE ACCOUNTS,RENAL STATISTICAL DATA,COST ALLOCATION,COST ALLOCATION,HOSPITAL WAGE INDEX DATA,RENAL STATISTICAL DATA,COST ALLOCATION,,INPATIENT ANCILLARY SERVICE COST APPORTIONMENT,HOSPITAL WAGE INDEX DATA,COST ALLOCATION,COMPUTATION OF INPATIENT OPERATING COSTS,,RENAL STATISTICAL DATA,TRIAL BALANCE OF EXPENSE ACCOUNTS,COST ALLOCATION,APPORTIONMENT OF MEDICAL AND OTHER HEALTH SERVICES,COST ALLOCATION,INPATIENT ANCILLARY SERVICE COST APPORTIONMENT,Total Inpatient Days/Outpatient Visits,TRIAL BALANCE OF EXPENSE ACCOUNTS,HOSPITAL WAGE INDEX DATA,ALLOCATION OF NEW CAPITAL COSTS,HOSPITAL WAGE INDEX DATA,APPORTIONMENT OF MEDICAL AND OTHER HEALTH SERVICES,,CALCULATION OF REIMBURSEMENT SETTLEMENT,APPORTIONMENT OF MEDICAL AND OTHER HEALTH SERVICES,COMPUTATION OF RATIO OF COST TO CHARGES,Total Inpatient Days/Outpatient Visits,COST ALLOCATION,COST ALLOCATION,APPORTIONMENT OF INPATIENT/OUTPATIENT ANCILLARY SERVICE OTHER PASS THROUGH COSTS,APPORTIONMENT OF INPATIENT/OUTPATIENT ANCILLARY SERVICE OTHER PASS THROUGH COSTS,HHA STATISTICAL DATA,TRIAL BALANCE OF EXPENSE ACCOUNTS,COMPUTATION OF RATIO OF COST TO CHARGES,INPATIENT ANCILLARY SERVICE COST APPORTIONMENT,COST ALLOCATION,,TRIAL BALANCE OF EXPENSE ACCOUNTS,RECONCILIATION OF CAPITAL COST CENTERS,APPORTIONMENT OF INPATIENT/OUTPATIENT ANCILLARY SERVICE OTHER PASS THROUGH COSTS,COST ALLOCATION,TRIAL BALANCE OF EXPENSE ACCOUNTS,,APPORTIONMENT OF INPATIENT/OUTPATIENT ANCILLARY SERVICE OTHER PASS THROUGH COSTS,COMPUTATION OF INPATIENT OPERATING COSTS,COST ALLOCATION,S-10 DATA,TRIAL BALANCE OF EXPENSE ACCOUNTS,COST ALLOCATION,APPORTIONMENT OF INPATIENT/OUTPATIENT ANCILLARY SERVICE OTHER PASS THROUGH COSTS,APPORTIONMENT OF INPATIENT/OUTPATIENT ANCILLARY SERVICE OTHER PASS THROUGH COSTS,HOSPITAL WAGE INDEX DATA,INPATIENT ANCILLARY SERVICE COST APPORTIONMENT,APPORTIONMENT OF INPATIENT/OUTPATIENT ANCILLARY SERVICE OTHER PASS THROUGH COSTS,APPORTIONMENT OF MEDICAL AND OTHER HEALTH SERVICES,ANALYSIS OF CHANGES IN NEW CAPITAL BALANCES,HOSPITAL WAGE INDEX DATA,RENAL STATISTICAL DATA,COMPUTATION OF INPATIENT OPERATING COSTS,COST ALLOCATION,APPORTIONMENT OF INPATIENT/OUTPATIENT ANCILLARY SERVICE OTHER PASS THROUGH COSTS,APPORTIONMENT OF INPATIENT/OUTPATIENT ANCILLARY SERVICE OTHER PASS THROUGH COSTS,INPATIENT ANCILLARY SERVICE COST APPORTIONMENT,APPORTIONMENT OF MEDICAL AND OTHER HEALTH SERVICES,APPORTIONMENT OF MEDICAL AND OTHER HEALTH SERVICES,HOSPITAL WAGE INDEX DATA,RENAL STATISTICAL DATA,HHA STATISTICAL DATA,COMPUTATION OF INPATIENT OPERATING COSTS,S-10 DATA,TRIAL BALANCE OF EXPENSE ACCOUNTS,APPORTIONMENT OF MEDICAL AND OTHER HEALTH SERVICES,COST ALLOCATION,ANALYSIS OF CHANGES IN NEW CAPITAL BALANCES,APPORTIONMENT OF INPATIENT/OUTPATIENT ANCILLARY SERVICE OTHER PASS THROUGH COSTS,TRIAL BALANCE OF EXPENSE ACCOUNTS,APPORTIONMENT OF INPATIENT/OUTPATIENT ANCILLARY SERVICE OTHER PASS THROUGH COSTS,APPORTIONMENT OF INPATIENT/OUTPATIENT ANCILLARY SERVICE OTHER PASS THROUGH COSTS,ALLOCATION OF NEW CAPITAL COSTS,TRIAL BALANCE OF EXPENSE ACCOUNTS,COST ALLOCATION,INPATIENT ANCILLARY SERVICE COST APPORTIONMENT,APPORTIONMENT OF MEDICAL AND OTHER HEALTH SERVICES,COST ALLOCATION,INPATIENT ANCILLARY SERVICE COST APPORTIONMENT,APPORTIONMENT OF INPATIENT/OUTPATIENT ANCILLARY SERVICE OTHER PASS THROUGH COSTS,APPORTIONMENT OF MEDICAL AND OTHER HEALTH SERVICES,ALLOCATION OF NEW CAPITAL COSTS,APPORTIONMENT OF MEDICAL AND OTHER HEALTH SERVICES,HHA STATISTICAL DATA,INPATIENT ANCILLARY SERVICE COST APPORTIONMENT,APPORTIONMENT OF INPATIENT/OUTPATIENT ANCILLARY SERVICE OTHER PASS THROUGH COSTS,HOSPITAL WAGE INDEX DATA,COMPUTATION OF RATIO OF COST TO CHARGES,APPORTIONMENT OF MEDICAL AND OTHER HEALTH SERVICES,TRIAL BALANCE OF EXPENSE ACCOUNTS,HOSPITAL WAGE INDEX DATA,COST ALLOCATION,ADJUSTMENTS,RENAL STATISTICAL DATA,TRIAL BALANCE OF EXPENSE ACCOUNTS,COMPUTATION OF RATIO OF COST TO CHARGES,APPORTIONMENT OF MEDICAL AND OTHER HEALTH SERVICES,TRIAL BALANCE OF EXPENSE ACCOUNTS,Total Inpatient Days/Outpatient Visits,COST ALLOCATION,HOSPITAL WAGE INDEX DATA,COMPUTATION OF RATIO OF COST TO CHARGES,COST ALLOCATION,COMPUTATION OF RATIO OF COST TO CHARGES,COST ALLOCATION,INPATIENT ANCILLARY SERVICE COST APPORTIONMENT,APPORTIONMENT OF INPATIENT/OUTPATIENT ANCILLARY SERVICE OTHER PASS THROUGH COSTS,COST ALLOCATION,,STATEMENT OF REVENUES AND EXPENSES,APPORTIONMENT OF INPATIENT/OUTPATIENT ANCILLARY SERVICE OTHER PASS THROUGH COSTS,APPORTIONMENT OF INPATIENT/OUTPATIENT ANCILLARY SERVICE OTHER PASS THROUGH COSTS,Total Inpatient Days/Outpatient Visits,,COST ALLOCATION,BALANCE SHEET,Total Inpatient Days/Outpatient Visits,,APPORTIONMENT OF MEDICAL AND OTHER HEALTH SERVICES,APPORTIONMENT OF MEDICAL AND OTHER HEALTH SERVICES,COMPUTATION OF RATIO OF COST TO CHARGES,INPATIENT ANCILLARY SERVICE COST APPORTIONMENT,BALANCE SHEET,APPORTIONMENT OF INPATIENT/OUTPATIENT ANCILLARY SERVICE OTHER PASS THROUGH COSTS,INPATIENT ANCILLARY SERVICE COST APPORTIONMENT,CALCULATION OF REIMBURSEMENT SETTLEMENT,RENAL STATISTICAL DATA,TRIAL BALANCE OF EXPENSE ACCOUNTS,INPATIENT ANCILLARY SERVICE COST APPORTIONMENT,APPORTIONMENT OF MEDICAL AND OTHER HEALTH SERVICES,TRIAL BALANCE OF EXPENSE ACCOUNTS,INPATIENT ANCILLARY SERVICE COST APPORTIONMENT,TRIAL BALANCE OF EXPENSE ACCOUNTS,INPATIENT ANCILLARY SERVICE COST APPORTIONMENT,COST ALLOCATION,CALCULATION OF REIMBURSEMENT SETTLEMENT,INPATIENT ANCILLARY SERVICE COST APPORTIONMENT,TRIAL BALANCE OF EXPENSE ACCOUNTS,APPORTIONMENT OF MEDICAL AND OTHER HEALTH SERVICES,ALLOCATION OF NEW CAPITAL COSTS,INPATIENT ANCILLARY SERVICE COST APPORTIONMENT,CALCULATION OF REIMBURSEMENT SETTLEMENT,BED DAYS AVAILABLE,COMPUTATION OF INPATIENT OPERATING COSTS,INPATIENT ANCILLARY SERVICE COST APPORTIONMENT,APPORTIONMENT OF INPATIENT ROUTINE SERVICE OTHER PASS THROUGH COSTS,INPATIENT ANCILLARY SERVICE COST APPORTIONMENT,TRIAL BALANCE OF EXPENSE ACCOUNTS,,TRIAL BALANCE OF EXPENSE ACCOUNTS,APPORTIONMENT OF INPATIENT/OUTPATIENT ANCILLARY SERVICE OTHER PASS THROUGH COSTS,RENAL STATISTICAL DATA,APPORTIONMENT OF MEDICAL AND OTHER HEALTH SERVICES,APPORTIONMENT OF INPATIENT ROUTINE SERVICE CAPITAL COSTS,APPORTIONMENT OF INPATIENT/OUTPATIENT ANCILLARY SERVICE OTHER PASS THROUGH COSTS,APPORTIONMENT OF INPATIENT/OUTPATIENT ANCILLARY SERVICE OTHER PASS THROUGH COSTS,COMPUTATION OF INPATIENT OPERATING COSTS,Medicare Inpatient Days/Outpatient Visits,HOSPITAL WAGE INDEX DATA,ADJUSTMENTS,COMPUTATION OF RATIO OF COST TO CHARGES,TRIAL BALANCE OF EXPENSE ACCOUNTS,APPORTIONMENT OF INPATIENT/OUTPATIENT ANCILLARY SERVICE OTHER PASS THROUGH COSTS,APPORTIONMENT OF INPATIENT/OUTPATIENT ANCILLARY SERVICE OTHER PASS THROUGH COSTS,TRIAL BALANCE OF EXPENSE ACCOUNTS,COMPUTATION OF RATIO OF COST TO CHARGES,BED DAYS AVAILABLE,TRIAL BALANCE OF EXPENSE ACCOUNTS,INPATIENT ANCILLARY SERVICE COST APPORTIONMENT,HOSPITAL WAGE INDEX DATA,TRIAL BALANCE OF EXPENSE ACCOUNTS,BED DAYS AVAILABLE,APPORTIONMENT OF INPATIENT/OUTPATIENT ANCILLARY SERVICE OTHER PASS THROUGH COSTS,TRIAL BALANCE OF EXPENSE ACCOUNTS,COST ALLOCATION,APPORTIONMENT OF INPATIENT/OUTPATIENT ANCILLARY SERVICE OTHER PASS THROUGH COSTS,,APPORTIONMENT OF INPATIENT/OUTPATIENT ANCILLARY SERVICE OTHER PASS THROUGH COSTS,INPATIENT ANCILLARY SERVICE COST APPORTIONMENT,COST ALLOCATION,APPORTIONMENT OF INPATIENT/OUTPATIENT ANCILLARY SERVICE OTHER PASS THROUGH COSTS,RECONCILIATION OF CAPITAL COST CENTERS,APPORTIONMENT OF MEDICAL AND OTHER HEALTH SERVICES,INPATIENT ANCILLARY SERVICE COST APPORTIONMENT,APPORTIONMENT OF INPATIENT/OUTPATIENT ANCILLARY SERVICE OTHER PASS THROUGH COSTS,Total Inpatient Days/Outpatient Visits,NUMBER OF BEDS,APPORTIONMENT OF MEDICAL AND OTHER HEALTH SERVICES,TRIAL BALANCE OF EXPENSE ACCOUNTS,COMPUTATION OF RATIO OF COST TO CHARGES,APPORTIONMENT OF INPATIENT/OUTPATIENT ANCILLARY SERVICE OTHER PASS THROUGH COSTS,COST ALLOCATION,COST ALLOCATION,INPATIENT ANCILLARY SERVICE COST APPORTIONMENT,APPORTIONMENT OF INPATIENT/OUTPATIENT ANCILLARY SERVICE OTHER PASS THROUGH COSTS,INPATIENT ANCILLARY SERVICE COST APPORTIONMENT,TRIAL BALANCE OF EXPENSE ACCOUNTS,COST ALLOCATION,COMPUTATION OF RATIO OF COST TO CHARGES,CALCULATION OF REIMBURSEMENT SETTLEMENT (PPS),HOSPITAL WAGE INDEX DATA,TRIAL BALANCE OF EXPENSE ACCOUNTS,TRIAL BALANCE OF EXPENSE ACCOUNTS,INPATIENT ANCILLARY SERVICE COST APPORTIONMENT,TRIAL BALANCE OF EXPENSE ACCOUNTS,APPORTIONMENT OF INPATIENT/OUTPATIENT ANCILLARY SERVICE OTHER PASS THROUGH COSTS,INPATIENT ANCILLARY SERVICE COST APPORTIONMENT,Medicare Inpatient Days/Outpatient Visits,TRIAL BALANCE OF EXPENSE ACCOUNTS,APPORTIONMENT OF INPATIENT/OUTPATIENT ANCILLARY SERVICE OTHER PASS THROUGH COSTS,APPORTIONMENT OF MEDICAL AND OTHER HEALTH SERVICES,TRIAL BALANCE OF EXPENSE ACCOUNTS,BED DAYS AVAILABLE,BALANCE SHEET,RENAL STATISTICAL DATA,HHA STATISTICAL DATA,APPORTIONMENT OF INPATIENT/OUTPATIENT ANCILLARY SERVICE OTHER PASS THROUGH COSTS,APPORTIONMENT OF INPATIENT/OUTPATIENT ANCILLARY SERVICE OTHER PASS THROUGH COSTS,INPATIENT ANCILLARY SERVICE COST APPORTIONMENT,BALANCE SHEET,COST ALLOCATION,Total Inpatient Days/Outpatient Visits,ALLOCATION OF NEW CAPITAL COSTS,COMPUTATION OF RATIO OF COST TO CHARGES,APPORTIONMENT OF INPATIENT/OUTPATIENT ANCILLARY SERVICE OTHER PASS THROUGH COSTS,ANALYSIS OF CHANGES IN NEW CAPITAL BALANCES,HHA STATISTICAL DATA,HOSPITAL IDENTIFICATION INFORMATION,,,INPATIENT ANCILLARY SERVICE COST APPORTIONMENT,TRIAL BALANCE OF EXPENSE ACCOUNTS,COST ALLOCATION,APPORTIONMENT OF MEDICAL AND OTHER HEALTH SERVICES,HHA STATISTICAL DATA,COST ALLOCATION,TRIAL BALANCE OF EXPENSE ACCOUNTS,S-10 DATA,HOSPITAL WAGE INDEX DATA,COMPUTATION OF RATIO OF COST TO CHARGES,APPORTIONMENT OF MEDICAL AND OTHER HEALTH SERVICES,HOSPITAL WAGE INDEX DATA,APPORTIONMENT OF MEDICAL AND OTHER HEALTH SERVICES,HOSPITAL WAGE INDEX DATA,COMPUTATION OF RATIO OF COST TO CHARGES,INPATIENT ANCILLARY SERVICE COST APPORTIONMENT,INPATIENT ANCILLARY SERVICE COST APPORTIONMENT,COST ALLOCATION,HOSPITAL WAGE INDEX DATA,BED DAYS AVAILABLE,COST ALLOCATION,APPORTIONMENT OF INPATIENT/OUTPATIENT ANCILLARY SERVICE OTHER PASS THROUGH COSTS,TRIAL BALANCE OF EXPENSE ACCOUNTS,HOSPITAL WAGE INDEX DATA,COST ALLOCATION,INPATIENT ANCILLARY SERVICE COST APPORTIONMENT,RECONCILIATION OF CAPITAL COST CENTERS,INPATIENT ANCILLARY SERVICE COST APPORTIONMENT,CALCULATION OF REIMBURSEMENT SETTLEMENT (PPS),COMPUTATION OF INPATIENT OPERATING COSTS,INPATIENT ANCILLARY SERVICE COST APPORTIONMENT,HOSPITAL IDENTIFICATION INFORMATION,COST ALLOCATION,APPORTIONMENT OF INPATIENT/OUTPATIENT ANCILLARY SERVICE OTHER PASS THROUGH COSTS,TRIAL BALANCE OF EXPENSE ACCOUNTS,COMPUTATION OF RATIO OF COST TO CHARGES,COST ALLOCATION,TRIAL BALANCE OF EXPENSE ACCOUNTS,APPORTIONMENT OF MEDICAL AND OTHER HEALTH SERVICES,TRIAL BALANCE OF EXPENSE ACCOUNTS,S-10 DATA,INPATIENT ANCILLARY SERVICE COST APPORTIONMENT,Total Inpatient Days/Outpatient Visits,ANALYSIS OF CHANGES IN NEW CAPITAL BALANCES,INPATIENT ANCILLARY SERVICE COST APPORTIONMENT,APPORTIONMENT OF INPATIENT ROUTINE SERVICE OTHER PASS THROUGH COSTS,APPORTIONMENT OF INPATIENT/OUTPATIENT ANCILLARY SERVICE OTHER PASS THROUGH COSTS,TRIAL BALANCE OF EXPENSE ACCOUNTS,APPORTIONMENT OF INPATIENT/OUTPATIENT ANCILLARY SERVICE OTHER PASS THROUGH COSTS,S-10 DATA,APPORTIONMENT OF INPATIENT/OUTPATIENT ANCILLARY SERVICE OTHER PASS THROUGH COSTS,APPORTIONMENT OF MEDICAL AND OTHER HEALTH SERVICES,TRIAL BALANCE OF EXPENSE ACCOUNTS,COMPUTATION OF RATIO OF COST TO CHARGES,APPORTIONMENT OF MEDICAL AND OTHER HEALTH SERVICES,APPORTIONMENT OF MEDICAL AND OTHER HEALTH SERVICES,APPORTIONMENT OF MEDICAL AND OTHER HEALTH SERVICES,APPORTIONMENT OF INPATIENT/OUTPATIENT ANCILLARY SERVICE OTHER PASS THROUGH COSTS,APPORTIONMENT OF MEDICAL AND OTHER HEALTH SERVICES,HOSPITAL WAGE INDEX DATA,,HOSPITAL IDENTIFICATION INFORMATION,HOSPITAL WAGE INDEX DATA,Medicare Inpatient Days/Outpatient Visits,COST ALLOCATION,INPATIENT ANCILLARY SERVICE COST APPORTIONMENT,HHA STATISTICAL DATA,APPORTIONMENT OF INPATIENT/OUTPATIENT ANCILLARY SERVICE OTHER PASS THROUGH COSTS,APPORTIONMENT OF INPATIENT/OUTPATIENT ANCILLARY SERVICE OTHER PASS THROUGH COSTS,APPORTIONMENT OF MEDICAL AND OTHER HEALTH SERVICES,INPATIENT ANCILLARY SERVICE COST APPORTIONMENT,INPATIENT ANCILLARY SERVICE COST APPORTIONMENT,APPORTIONMENT OF INPATIENT/OUTPATIENT ANCILLARY SERVICE OTHER PASS THROUGH COSTS,INPATIENT ANCILLARY SERVICE COST APPORTIONMENT,,BALANCE SHEET,ALLOCATION OF NEW CAPITAL COSTS,COST ALLOCATION,INPATIENT ANCILLARY SERVICE COST APPORTIONMENT,COMPUTATION OF RATIO OF COST TO CHARGES,TRIAL BALANCE OF EXPENSE ACCOUNTS,APPORTIONMENT OF INPATIENT/OUTPATIENT ANCILLARY SERVICE OTHER PASS THROUGH COSTS,BED DAYS AVAILABLE,TRIAL BALANCE OF EXPENSE ACCOUNTS,APPORTIONMENT OF INPATIENT/OUTPATIENT ANCILLARY SERVICE OTHER PASS THROUGH COSTS,ALLOCATION OF NEW CAPITAL COSTS,INPATIENT ANCILLARY SERVICE COST APPORTIONMENT,COST ALLOCATION,COST ALLOCATION,COMPUTATION OF RATIO OF COST TO CHARGES,APPORTIONMENT OF MEDICAL AND OTHER HEALTH SERVICES,COST ALLOCATION,INPATIENT ANCILLARY SERVICE COST APPORTIONMENT,TRIAL BALANCE OF EXPENSE ACCOUNTS,NUMBER OF BEDS,,HOSPITAL WAGE INDEX DATA,BED DAYS AVAILABLE,TRIAL BALANCE OF EXPENSE ACCOUNTS,COST ALLOCATION,COMPUTATION OF RATIO OF COST TO CHARGES,APPORTIONMENT OF INPATIENT/OUTPATIENT ANCILLARY SERVICE OTHER PASS THROUGH COSTS,APPORTIONMENT OF MEDICAL AND OTHER HEALTH SERVICES,INPATIENT ANCILLARY SERVICE COST APPORTIONMENT,COST ALLOCATION,APPORTIONMENT OF INPATIENT/OUTPATIENT ANCILLARY SERVICE OTHER PASS THROUGH COSTS,APPORTIONMENT OF INPATIENT ROUTINE SERVICE OTHER PASS THROUGH COSTS,RENAL STATISTICAL DATA,RECONCILIATION OF CAPITAL COST CENTERS,APPORTIONMENT OF INPATIENT ROUTINE SERVICE CAPITAL COSTS,ANALYSIS OF CHANGES IN NEW CAPITAL BALANCES,APPORTIONMENT OF INPATIENT/OUTPATIENT ANCILLARY SERVICE OTHER PASS THROUGH COSTS,Medicaid Inpatient Days/Outpatient Visits,,Medicare Inpatient Days/Outpatient Visits,APPORTIONMENT OF INPATIENT/OUTPATIENT ANCILLARY SERVICE OTHER PASS THROUGH COSTS,INPATIENT ANCILLARY SERVICE COST APPORTIONMENT,TRIAL BALANCE OF EXPENSE ACCOUNTS,,COMPUTATION OF RATIO OF COST TO CHARGES,RENAL STATISTICAL DATA,HOSPITAL WAGE INDEX DATA,INPATIENT ANCILLARY SERVICE COST APPORTIONMENT,INPATIENT ANCILLARY SERVICE COST APPORTIONMENT,APPORTIONMENT OF INPATIENT/OUTPATIENT ANCILLARY SERVICE OTHER PASS THROUGH COSTS,Medicaid Inpatient Days/Outpatient Visits,TRIAL BALANCE OF EXPENSE ACCOUNTS,APPORTIONMENT OF INPATIENT/OUTPATIENT ANCILLARY SERVICE OTHER PASS THROUGH COSTS,APPORTIONMENT OF MEDICAL AND OTHER HEALTH SERVICES,INPATIENT ANCILLARY SERVICE COST APPORTIONMENT,CALCULATION OF REIMBURSEMENT SETTLEMENT,ALLOCATION OF NEW CAPITAL COSTS,INPATIENT ANCILLARY SERVICE COST APPORTIONMENT,COST ALLOCATION,COST ALLOCATION,,TRIAL BALANCE OF EXPENSE ACCOUNTS,ALLOCATION OF NEW CAPITAL COSTS,COMPUTATION OF RATIO OF COST TO CHARGES,CALCULATION OF REIMBURSEMENT SETTLEMENT,,TRIAL BALANCE OF EXPENSE ACCOUNTS,CALCULATION OF REIMBURSEMENT SETTLEMENT,INPATIENT ANCILLARY SERVICE COST APPORTIONMENT,HHA STATISTICAL DATA,HOSPITAL WAGE INDEX DATA,APPORTIONMENT OF INPATIENT/OUTPATIENT ANCILLARY SERVICE OTHER PASS THROUGH COSTS,HOSPITAL WAGE INDEX DATA,COMPUTATION OF RATIO OF COST TO CHARGES,APPORTIONMENT OF MEDICAL AND OTHER HEALTH SERVICES,ANALYSIS OF CHANGES IN NEW CAPITAL BALANCES,APPORTIONMENT OF INPATIENT/OUTPATIENT ANCILLARY SERVICE OTHER PASS THROUGH COSTS,HOSPITAL WAGE INDEX DATA,INPATIENT ANCILLARY SERVICE COST APPORTIONMENT,APPORTIONMENT OF INPATIENT/OUTPATIENT ANCILLARY SERVICE OTHER PASS THROUGH COSTS,APPORTIONMENT OF MEDICAL AND OTHER HEALTH SERVICES,,HOSPITAL WAGE INDEX DATA,COST ALLOCATION,NUMBER OF BEDS,ADJUSTMENTS,APPORTIONMENT OF INPATIENT/OUTPATIENT ANCILLARY SERVICE OTHER PASS THROUGH COSTS,APPORTIONMENT OF MEDICAL AND OTHER HEALTH SERVICES,BALANCE SHEET,INPATIENT ANCILLARY SERVICE COST APPORTIONMENT,APPORTIONMENT OF INPATIENT/OUTPATIENT ANCILLARY SERVICE OTHER PASS THROUGH COSTS,COMPUTATION OF RATIO OF COST TO CHARGES,TRIAL BALANCE OF EXPENSE ACCOUNTS,APPORTIONMENT OF INPATIENT/OUTPATIENT ANCILLARY SERVICE OTHER PASS THROUGH COSTS,COMPUTATION OF INPATIENT OPERATING COSTS,,COMPUTATION OF RATIO OF COST TO CHARGES,S-10 DATA,HOSPITAL WAGE INDEX DATA,COMPUTATION OF RATIO OF COST TO CHARGES,TRIAL BALANCE OF EXPENSE ACCOUNTS,APPORTIONMENT OF INPATIENT/OUTPATIENT ANCILLARY SERVICE OTHER PASS THROUGH COSTS,COST ALLOCATION,TRIAL BALANCE OF EXPENSE ACCOUNTS,COST ALLOCATION,COMPUTATION OF RATIO OF COST TO CHARGES,HOSPITAL WAGE INDEX DATA,TRIAL BALANCE OF EXPENSE ACCOUNTS,TRIAL BALANCE OF EXPENSE ACCOUNTS,HOSPITAL WAGE INDEX DATA,APPORTIONMENT OF INPATIENT/OUTPATIENT ANCILLARY SERVICE OTHER PASS THROUGH COSTS,TRIAL BALANCE OF EXPENSE ACCOUNTS,COST ALLOCATION,Medicaid Inpatient Days/Outpatient Visits,APPORTIONMENT OF MEDICAL AND OTHER HEALTH SERVICES,INPATIENT ANCILLARY SERVICE COST APPORTIONMENT,INPATIENT ANCILLARY SERVICE COST APPORTIONMENT,,APPORTIONMENT OF INPATIENT/OUTPATIENT ANCILLARY SERVICE OTHER PASS THROUGH COSTS,COMPUTATION OF RATIO OF COST TO CHARGES,TRIAL BALANCE OF EXPENSE ACCOUNTS,APPORTIONMENT OF INPATIENT/OUTPATIENT ANCILLARY SERVICE OTHER PASS THROUGH COSTS,HOSPITAL WAGE INDEX DATA,Total Inpatient Days/Outpatient Visits,COMPUTATION OF RATIO OF COST TO CHARGES,COMPUTATION OF RATIO OF COST TO CHARGES,APPORTIONMENT OF INPATIENT/OUTPATIENT ANCILLARY SERVICE OTHER PASS THROUGH COSTS,HOSPITAL WAGE INDEX DATA,TRIAL BALANCE OF EXPENSE ACCOUNTS,APPORTIONMENT OF INPATIENT/OUTPATIENT ANCILLARY SERVICE OTHER PASS THROUGH COSTS,INPATIENT ANCILLARY SERVICE COST APPORTIONMENT,TRIAL BALANCE OF EXPENSE ACCOUNTS,APPORTIONMENT OF MEDICAL AND OTHER HEALTH SERVICES,APPORTIONMENT OF INPATIENT/OUTPATIENT ANCILLARY SERVICE OTHER PASS THROUGH COSTS,RECONCILIATION OF CAPITAL COST CENTERS,APPORTIONMENT OF INPATIENT/OUTPATIENT ANCILLARY SERVICE OTHER PASS THROUGH COSTS,INPATIENT ANCILLARY SERVICE COST APPORTIONMENT,INPATIENT ANCILLARY SERVICE COST APPORTIONMENT,APPORTIONMENT OF INPATIENT/OUTPATIENT ANCILLARY SERVICE OTHER PASS THROUGH COSTS,COST ALLOCATION,FFY,Hospital Type (From CMS Hospitals Data Archive),Name and Num
,Curated Name and Num,Hospital type (modified),Type of Control of Hospital (See Table I) (S2_1_C1_21),Lon,Lat,OPPS payments (E_B_HOS_C101_3),Recovery Room (D3_SNF_C3_51),"AVERAGE HOURLY WAGE, Excluded Area Salaries (S3_2_C6_10)","Net Expense for Cost Allocation, Nonpaid Workers (B_1_C0_193)",Ambulance Services (A_C2_95),Int & Res (non approved teaching program (B_1_C22_100),Cardiac Catheterization (A_C2_59),Home Program Dialysis (D3_HOS_C3_94),"Gift, Flower, Coffee Shop, Canteen (B_1_C22_190)",Operating Room (D3_IPF_C2_50),Central Services and Supply (A_C6_14),Burn Intensive Care Unit (S3_1_C7_10),Radiology-Therapeutic (D3_SNF_C3_55),Renal Dialysis (D_4_IPF_C13_74),OPT (C_1_C5_9920),FQHC (B_1_C22_89),Total (S3_1_C2_7),Delivery Room and Labor Room (D_4_HOS_C13_52),Transitional corridor payment (E_B_HOS_C1_8),Number of periods hospital was in MDH status (S2_1_C1_37),Radiology-Therapeutic (D_4_HOS_C10_55),Observation Beds (Distinct Unit) (D3_IPF_C3_9201),Electroencephalography (D_4_HOS_C3_70),"COST REIMBURSED SERVICES SUBJECT TO DEDUCTIBLES  AND COINSURANCE - CHARGES, CT Scan (D_5_HOS_C3_57)",SNF (D_3_HOS_C9_44),FQHC 8 Provider Number (S2_1_C2_1607),"TOTAL CAPITAL COSTS AFTER COST ALLOCATION, Cardiac Catheterization (B_2_C26_59)","Disposals and Retirements, Fixed Equipment (A7_1_C7_5)",Home Program Dialysis (D_4_HOS_C12_94),Organ acquisition charges (E_B_HOS_C1_13),Hospital Adults & Pediatrics (S3_1_C2_1),"Disposals and Retirements, Total (A7_1_C5_10)","PPS SERVICES COST, CT Scan (D_5_HOS_C5_57)",Operating Room (D3_HOS_C2_50),"Blood Storing, Processing, Trans (D3_IRF_C2_63)",Nonphysician Anesthetists (A_C6_19),HHA (B_1_C22_101),Whole Blood & Packed Red Blood Cells (D3_SNF_C3_62),Subprovider-IPF (D_1_HOS_C4_40),Cardiac Catheterization (D_4_HOS_C12_59),Lung  Acquisition (A_C2_108),"PAID HOURS RELATED TO SALARIES, Physician-Part A (S3_2_C5_4)",HHA (S3_1_C7_22),Anesthesiology (D3_SNF_C2_53),Occupational Therapy (B_1_C26_67),"PPS REIMBURSED SERVICES -  CHARGES, Electroencephalography (D_5_HOS_C2_70)",Prepaid expenses (G_C1THRU4_8),"ADJUSTED SALARIES, Interns & Residents (S3_2_C4_25)",Radioisotope (D_4_HOS_C12_56),Recovery Room (D3_IPF_C3_51),Other Reimbursable (D_4_HOS_C2_98),Renal Dialysis (D_4_HOS_C2_74),"Blood Storing, Processing, Trans (C_1_C5_63)",Other Ancillary (D_4_HOS_C3_76),Medical Supplies Charged to Patients (D_4_HOS_C11_71),"Disposals and Retirements, Land Improvements (A7_1_C7_2)","PPS SERVICES COST, Operating Room (D_5_HOS_C5_50)","Allocation of Interns & Residents Program Costs, NF (B_1_C22_45)","Insurance, New Cap Related Csts Bldg & Fixtures (A7_3_C5_1)",Physical Therapy (D_4_HOS_C11_66),"COST REIMBURSED SERVICES NOT SUBJECT TO DEDUCTIBLES AND COINSURANCE - CHARGES, Durable Medical Equipment Rented (D_5_HOS_C4_96)","TOTAL CAPITAL COSTS AFTER COST ALLOCATION, SNF (B_2_C26_44)","PPS SERVICES COST, Electrocardiology (D_5_HOS_C5_69)","AVERAGE HOURLY WAGE, Home Office Salaries (S3_2_C6_1401)","Total Inpatient Charges, Subprovider II (C_1_C6_4201)","Allocation of Interns & Residents Salary and Fringes, Respiratory Therapy (B_1_C21_65)",TOTAL (D3_SNF_C2_202),Ambulance Services (B_1_C21_95),ASC (Non Distinct Part) (D3_IRF_C2_75),"COST REIMBURSED SERVICES NOT SUBJECT TO DEDUCTIBLES AND COINSURANCE - CHARGES, MRI (D_5_HOS_C4_58)","Net Expense for Cost Allocation, Physicians' Private Office (B_1_C0_192)",Net revenue from state/local govt indigent care (not Medicaid or CHIP) (S10_C1_13),"Allocation of Interns & Residents Program Costs, Medical Supplies Charged to Patients (B_1_C22_71)",Cafeteria (A_C6_11),Intensive Care Unit (D_1_HOS_C7_31),Protested amounts (E_B_HOS_C1_44),"HHA III, W/Out Outliers:  Number of Episodes (S4_HHA3_C1_36)",Electroencephalography (D_4_IPF_C13_70),Delivery Room and Labor Room (D_4_HOS_C4_52),Cafeteria (A_C1_11),"PPS SERVICES COST, Laboratory (D_5_HOS_C5_60)",RHC (A_C6_88),Intravenous Therapy (D_4_IRF_C13_64),Pharmacy (A_C1_15),Total reasonable charges (E_B_HOS_C1_14),Laboratory (D3_SNF_C3_60),Medical Supplies Charged to Patients (D_4_HOS_C13_71),OSP (B_2_C26_9940),"HHA I, Total Number of Outlier Episodes (S4_HHA1_C5_37)",Burn Intensive Care Unit (S3_1_C5_10),Home Program Dialysis (D3_SNF_C3_94),Speech Pathology (D_4_HOS_C3_68),Laboratory (D_4_SNF_C11_60),Coronary Intensive Care Unit (D_1_HOS_C7_32),Medical Supplies Charged to Patients (D_4_IPF_C13_71),Radioisotope (D3_HOS_C3_56),"Total Inpatient Charges, NF (C_1_C6_45)",SNF (S3_1_C2_19),"AMOUNT REPORTED, Wage Related Costs RHC/FQHC (S3_2_C2_24)",Coronary Intensive Care Unit (D_1_HOS_C4_32),"ADJUSTED SALARIES, Non-Physician Anesthetist Part B (S3_2_C4_21)","Taxes, Total (A7_3_C6_3)","Blood Storing, Processing, Trans (D3_IPF_C3_63)","Total, Total (A7_3_C15_3)",Durable Medical Equipment Rented (D3_IRF_C3_96),RHC 23 Provider Number (S2_1_C2_1522),"AMOUNT REPORTED, Operation of Plant (S3_2_C2_30)",Burn Intensive Care Unit (D_1_HOS_C4_33),"Net Expense for Cost Allocation, Radiology-Diagnostic (B_1_C0_54)",FQHC 2 Provider Number (S2_1_C2_1601),Total Adults & Pediatrics (S3_1_C8_7),Electroencephalography (D_4_HOS_C10_70),"HHA II, Without Outliers:  Non Routine Med Sup Chgs (S4_HHA2_C1_38)","COST REIMBURSED SERVICES NOT SUBJECT TO DEDUCTIBLES AND COINSURANCE - CHARGES, Other Ancillary (D_5_HOS_C4_76)","PAID HOURS RELATED TO SALARIES, Pharmacy (S3_2_C5_40)",Interim payments (E_B_HOS_C1_41),Renal Dialysis (D3_SNF_C2_74),"PPS SERVICES COST, Whole Blood & Packed Red Blood Cells (D_5_HOS_C5_62)",Ambulance Trips (S3_1_C6_29),Surgical Intensive Care Unit (S3_1_C8_11),Impl. Dev. Charged to Patients (D_4_HOS_C2_72),"ADJUSTED SALARIES, Social Service (S3_2_C4_42)","Allocation of Interns & Residents Program Costs, Adults and Pediatrics (B_1_C22_30)",Operating Room (D_4_HOS_C12_50),Medicare Certified Pancreas TC term date (S2_1_C2_130),"Other Capital Related Costs, New Cap Related Csts Bldg & Fixtures (A7_3_C7_1)","Net Expense for Cost Allocation, OSP (B_1_C0_9940)","COST SERVICES NOT SUBJECT TO DEDUCTIBLES AND COINSURANCE - COST, Physical Therapy (D_5_HOS_C7_66)",ASC (Distinct Part) (A_C2_115),"ADJUSTED SALARIES, Teaching Physician Salaries (S3_2_C4_16)","HHA II, W/Out Outliers:  Number of Episodes (S4_HHA2_C1_36)",Total Program Excludable Costs (D1_IRF_C1_52),"PPS REIMBURSED SERVICES -  CHARGES, Respiratory Therapy (D_5_HOS_C2_65)","Net Expense for Cost Allocation, Liver Acquisition (B_1_C0_107)",Whole Blood & Packed Red Blood Cells (D_4_HOS_C2_62),ICF (S3_1_C2_2001),Whole Blood & Packed Red Blood Cells (D_4_SNF_C11_62),Intravenous Therapy (D3_SNF_C3_64),Ancillary service other pass through costs (E_B_HOS_C1_9),Occupational Therapy (D_4_IPF_C11_67),Radiology-Diagnostic (D_4_SNF_C11_54),Coronary Care Unit (B_1_C26_32),"Number of patients in program at 
end of cost reporting period (S5_C5_1)",Clinic (D_4_HOS_C4_90),Surgical Intensive Care Unit (A_C6_34),Intestinal Acquisition (A_C2_110),Clinic (D3_HOS_C2_90),"PPS SERVICES COST, Renal Dialysis (D_5_HOS_C5_74)","HHA II, Total Charges (S4_HHA2_C5_35)",Other Outpatient Services (B_1_C26_93),Speech Pathology (D3_SNF_C3_68),"PPS SERVICES COST, Blood Storing, Processing, Trans (D_5_HOS_C5_63)",RHC 18 Provider Number (S2_1_C2_1517),Radiology-Therapeutic (D_4_IRF_C11_55),Intestinal Acquisition (B_1_C22_110),"Beginning Balances, Total (A7_1_C1_10)",Coronary Care Unit (S3_1_C4_9),Impl. Dev. Charged to Patients (D3_HOS_C2_72),TOTAL (D3_IRF_C2_200),Adults & Pediatrics (D_1_HOS_C4_30),"HHA III, Total Other Charges (S4_HHA3_C5_34)",Total (B_2_C26_202),"Net Expense for Cost Allocation, HHA (B_1_C0_101)","Donations, Total (A7_1_C3_10)",Delivery Room and Labor Room (D_4_SNF_C11_52),"PAID HOURS RELATED TO SALARIES, Administrative and General under Contract (S3_2_C5_28)",Cardiac Catheterization (A_C1_59),HVBP payment adjustment amount (E_A_HOS_C1_7093),Intensive Care Unit (S3_1_C8_8),Liver Acquisition (B_1_C22_107),"Is this a New Hospital under
42 CFR 412.300 PPS capital
(Y/N) (S2_1_C1_47)",Laboratory (D3_IPF_C2_60),ASC (Distinct Part) (A_C6_115),Radiology-Therapeutic (D_4_HOS_C4_55),Other Special Purpose (A_C6_117),"Net Expense for Cost Allocation, Housekeeping (B_1_C0_9)",Nonpaid Workers (B_1_C21_193),Operation of Plant (A_C2_7),Cost of physicians svcs in a teaching hospita (E_B_HOS_C1_23),Medicare allowable bad debts for the entire hospital complex (S10_C1_2701),Radiology-Diagnostic (D_4_HOS_C10_54),"TOTAL CAPITAL COSTS AFTER COST ALLOCATION, MRI (B_2_C26_58)",Other Special Care (S3_1_C3_12),"TOTAL CAPITAL COSTS AFTER COST ALLOCATION, NF (B_2_C26_45)",Investment Income-New Movable Equip (A8_C2_2),Utilization Review SNF (A_C6_114),OOT (C_1_C6_9930),Dietary (A_C1_10),"Allocation of Interns & Residents Program Costs, Cardiac Catheterization (B_1_C22_59)",FI/Contractor's Name (S2_1_C2_140),"TOTAL CAPITAL COSTS AFTER COST ALLOCATION, Delivery Room and Labor Room (B_2_C26_52)","PPS REIMBURSED SERVICES -  CHARGES, Whole Blood & Packed Red Blood Cells (D_5_HOS_C2_62)",Burn Intensive Care Unit (D_3_HOS_C9_33),"Blood Storing, Processing, Trans (D3_HOS_C3_63)",Medicare Certified Kidney TC term date (S2_1_C2_126),"Beginning Balances, Buildings and Fixtures (A7_1_C1_3)",Durable Medical Equipment Rented (D3_IPF_C3_96),City (S2_1_C1_143),"Net Expense for Cost Allocation, Operation of Plant (B_1_C0_7)",OLTC (S3_1_C8_21),Subprovider II (A_C2_4201),MRI (D_4_HOS_C10_58),"Net Expense for Cost Allocation, Intestinal Acquisition (B_1_C0_110)","AMOUNT REPORTED, Interns & Residents (S3_2_C3_2550)","COST REIMBURSED SERVICES NOT SUBJECT TO DEDUCTIBLES AND COINSURANCE - CHARGES, Cardiac Catheterization (D_5_HOS_C4_59)","AMOUNT REPORTED, Dietary under contract (S3_2_C2_35)",Anesthesiology (D_4_HOS_C2_53),Laboratory (D_4_HOS_C10_60),Intravenous Therapy (D_4_SNF_C11_64),Lung  Acquisition (C_1_C5_108),"Allocation of Interns & Residents Program Costs, Electrocardiology (B_1_C22_69)","Net Expense for Cost Allocation, Laundry and Linen Service (B_1_C0_8)",Other Reimbursable (D_4_HOS_C11_98),Electrocardiology (B_2_C26_69),Impl. Dev. Charged to Patients (D_4_IRF_C13_72),"COST REIMBURSED SERVICES SUBJECT TO DEDUCTIBLES  AND COINSURANCE - CHARGES, Recovery Room (D_5_HOS_C3_51)",Total discharges (S3_1_C15_1),Radiology-Therapeutic (D3_HOS_C3_55),Burn Intensive Care Unit (C_1_C5_33),Drugs Charged to Patients (B_1_C26_73),"Net Expense for Cost Allocation, Pharmacy (B_1_C0_15)","Beginning Balances, Movable Equipment (A7_1_C1_6)",ICF (A_C1_4501),Laboratory (B_1_C26_60),IPF (S3_1_C3_16),Pancreas Acquisition (C_1_C5_109),"Allocation of Interns & Residents Salary and Fringes, Other Special Care Unit (B_1_C21_35)",Impl. Dev. Charged to Patients (D_4_HOS_C12_72),"ADJUSTED SALARIES, Non-Physician Anesthetist Part B (S3_2_C4_3)",Blood Clotting Factors for Hemoph. (D_4_HOS_C10_6250),Durable Medical Equipment Sold (A_C6_97),"Number of patients in program at 
end of cost reporting period (S5_C3_1)",Burn Intensive Care Unit (D_1_HOS_C7_33),Durable Medical Equipment Sold (D_4_HOS_C10_97),"Number of days in year dialysis 
furnished (S5_C2_5)",Other Reimbursable (D3_IPF_C2_98),Electrocardiology (D3_IPF_C2_69),"HHA II, PEP Episodes:  Other Charges (S4_HHA2_C4_34)",Observation Beds (Distinct Unit) (D_4_HOS_C12_9201),Total Hospital (S3_1_C3_14),Number of stations (S5_C3_6),"PAID HOURS RELATED TO SALARIES, Housekeeping (S3_2_C5_32)","HHA I, PEP Episodes:  Total Charges: (S4_HHA1_C4_35)",Electroencephalography (D3_SNF_C3_70),Medical Supplies Charged to Patients (B_2_C26_71),Radiology-Therapeutic (A_C6_55),Surgical Intensive Care Unit (S3_1_C6_11),Ambulance Services (A_C6_95),"Net Expense for Cost Allocation, Total (B_1_C0_200)",Total Program Excludable Costs (D1_IPF_C1_52),ICF (S3_1_C3_2001),Speech Pathology (D_4_HOS_C11_68),Physical Therapy (D_4_HOS_C2_66),ASC (Distinct Part) (A_C1_115),MRI (C_1_C5_58),ASC (Non Distinct Part) (D_4_HOS_C2_75),Subtotal (E_B_HOS_C1_32),"PAID HOURS RELATED TO SALARIES, Total Salaries (S3_2_C5_1)",Total Hospital (S3_1_C6_14),ASC (Non Distinct Part) (D_4_HOS_C13_75),Total Nursing School (D_4_IRF_C2_200),"PPS SERVICES COST, Other Outpatient Services (D_5_HOS_C5_93)","COST REIMBURSED SERVICES SUBJECT TO DEDUCTIBLES  AND COINSURANCE - CHARGES, Other Ancillary (D_5_HOS_C3_76)",Electrocardiology (D_4_IRF_C11_69),"Allocation of Interns & Residents Salary and Fringes, Burn Intensive Care Unit (B_1_C21_33)","AMOUNT REPORTED, Interns & Residents (S3_2_C3_2553)",HHA (B_2_C26_101),Hospice (S3_1_C6_24),RHC (D_4_HOS_C3_88),"Net Expense for Cost Allocation, Maintenance and Repairs (B_1_C0_6)",Subprovider-IRF (D3_HOS_C2_41),Liver Acquisition (A_C1_107),Delivery Room and Labor Room (D3_IRF_C2_52),Total Inpatient Program Days (D_3_HOS_C8_200),Accounts Payable (G_C1THRU4_37),HHA (S3_1_C6_22),Buildings (G_C1THRU4_15),CORF (C_1_C6_9910),Administrative and General (A_C1_5),"Blood Storing, Processing, Trans (D_4_HOS_C12_63)",Clinic (D_4_HOS_C11_90),"Purchases, Subtotal (A7_1_C2_8)","PPS SERVICES COST, Respiratory Therapy (D_5_HOS_C5_65)",Notes Payable (G_C1THRU4_47),Outpatient Rehab Provider (S3_1_C10_25),Operating Room (A_C1_50),MRI (B_1_C26_58),Laundry and Linen Service (A_C6_8),Cost of patients approved for charity care and uninsured discounts (S10_C3_21),Other Special Purpose (C_1_C5_117),"ADJUSTED SALARIES, Physician Part B (S3_2_C4_23)","PPS REIMBURSED SERVICES -  CHARGES, Other Reimbursable (D_5_HOS_C2_98)",Utilization Code (L/N/F) (UTIL_CODE),"TOTAL CAPITAL COSTS AFTER COST ALLOCATION, Adults & Pediatrics (B_2_C26_30)",Laboratory (D_4_HOS_C11_60),"Total Outpatient Charges, MRI (C_1_C7_58)",Operating Room (D_4_HOS_C10_50),Other Reimbursable (D3_SNF_C2_98),FQHC (A_C6_89),Transitional corridor payment (E_B_HOS_C101_8),Operating Room (C_1_C5_50),"AMOUNT REPORTED, Excluded Area Salaries (S3_2_C2_10)",HHA (A_C1_101),"Net Expense for Cost Allocation, Radiology-Therapeutic (B_1_C0_55)","Allocation of Interns & Residents Program Costs, Respiratory Therapy (B_1_C22_65)",Occupational Therapy (A_C1_67),"HHA I, PEP Episodes:  Total Number of Episodes (S4_HHA1_C4_36)","COST REIMBURSED SERVICES SUBJECT TO DEDUCTIBLES  AND COINSURANCE - CHARGES, ASC (Non Distinct Part) (D_5_HOS_C3_75)",HHA (S3_1_C8_22),"Net Expense for Cost Allocation, Other Outpatient Services (B_1_C0_93)","TOTAL CAPITAL COSTS AFTER COST ALLOCATION, Subprovider I (B_2_C26_42)",Renal 7 Provider Number (S2_1_C2_1806),RHC/FQHC Combined (S3_1_C6_26),Anesthesiology (D_4_IPF_C13_53),Respiratory Therapy (D_4_HOS_C12_65),Nursing School (A_C6_20),Emergency (B_1_C22_91),NF (S3_1_C2_20),Blood Clotting Factors for Hemoph. (A_C2_6250),Renal 2 Provider Number (S2_1_C2_1801),Occupational Therapy (A_C2_67),Emergency (D_4_IRF_C11_91),Speech Pathology (D_4_IPF_C13_68),Medical Supplies Charged to Patients (D3_IPF_C2_71),OLTC (B_1_C26_46),Total Other Expenses (G3_C1_28),Hospice (B_2_C26_116),Less Observation Beds (C_1_C5_201),Radiology-Therapeutic (D_4_HOS_C3_55),"PPS REIMBURSED SERVICES -  CHARGES, Durable Medical Equipment Sold (D_5_HOS_C2_97)","HHA II, PEP:  Total Non Routine Med Supply Chgs (S4_HHA2_C4_38)",Liver Acquisition (C_1_C6_107),Electrocardiology (D_4_SNF_C11_69),Medical Supplies Charged to Patients (A_C6_71),Hospice (B_1_C21_116),Anesthesiology (D_4_HOS_C11_53),Respiratory Therapy (D_4_IRF_C11_65),Clinic (D3_IPF_C3_90),Respiratory Therapy (D_4_HOS_C4_65),Cost of charity care (patients covered by public program + patients w/ coverage accepted by provider) (S10_C2_23),"COST REIMBURSED SERVICES NOT SUBJECT TO DEDUCTIBLES AND COINSURANCE - CHARGES, Respiratory Therapy (D_5_HOS_C4_65)","If (SCH), enter the # of periods. (S2_1_C1_35)",Intravenous Therapy (A_C2_64),"COST REIMBURSED SERVICES SUBJECT TO DEDUCTIBLES  AND COINSURANCE - CHARGES, Occupational Therapy (D_5_HOS_C3_67)",Other Special Care (S3_1_C4_12),"HHA I, W/Out Outliers:  Number of Episodes (S4_HHA1_C1_36)",Laundry and Linen Service (A_C1_8),"Disposals and Retirements, Movable Equipment (A7_1_C5_6)",Hospice (S3_1_C2_24),Observation Beds (Distinct Unit) (B_2_C26_9201),Anesthesiology (A_C6_53),"AVERAGE HOURLY WAGE, Administrative and General (S3_2_C6_27)",Durable Medical Equipment Rented (D_4_HOS_C3_96),MDH status ending date (MM/DD/YY) (S2_1_C2_3801),"ADJUSTED SALARIES, Housekeeping under contract (S3_2_C4_33)",Drugs Charged to Patients (C_1_C5_73),"Disposals and Retirements, Buildings and Fixtures (A7_1_C5_3)",Hospital Adlts & Ped Swing Bed NF (S3_1_C8_6),Operating Room (D_4_HOS_C11_50),"COST REIMBURSED SERVICES NOT SUBJECT TO DEDUCTIBLES AND COINSURANCE - CHARGES, Emergency (D_5_HOS_C4_91)",Total Program General Inp. Rtn Service (D1_SNF_C1_74),"ADJUSTED SALARIES, Subtotal Salaries (S3_3_C4_3)","COST SERVICES SUBJECT TO DEDUCTIBLES AND COINSURANCE - COST, Drugs Charged to Patients (D_5_HOS_C6_73)",Speech Pathology (C_1_C6_68),"HHA III, Without Outliers:  Non Routine Med Sup Chgs (S4_HHA3_C1_38)",Total Nursing School (D_4_HOS_C2_200),Employee Benefits (A_C2_4),Pharmacy (A_C2_15),"ADJUSTED SALARIES, Dietary (S3_2_C4_34)",Nursery (A_C6_43),OLTC (C_1_C5_46),"Allocation of Interns & Residents Program Costs, Burn Intensive Care Unit (B_1_C22_33)",IRF Provider Number (S2_1_C1_5),Coronary Care Unit (D3_HOS_C2_32),Radiology-Diagnostic (D3_IPF_C3_54),"Net Expense for Cost Allocation, Coronary Care Unit (B_1_C0_32)",Medicare Certified Lung TC term date (S2_1_C2_129),CT Scan (D3_IRF_C2_57),Respiratory Therapy (D_4_IPF_C13_65),"Net Expense for Cost Allocation, Laboratory (B_1_C0_60)",Durable Medical Equipment Sold (D_4_HOS_C13_97),"PPS SERVICES COST, Total (D_5_HOS_C5_200)","AMOUNT REPORTED, Laundry and Linen Service (S3_2_C2_31)",Other Reimbursable (D_4_HOS_C12_98),"AVERAGE HOURLY WAGE, Management and Administrative Services (S3_2_C6_12)",Impl. Dev. Charged to Patients (D_4_HOS_C13_72),"Net Expense for Cost Allocation, Impl. Dev. Charged to Patients (B_1_C0_72)","COST SERVICES NOT SUBJECT TO DEDUCTIBLES AND COINSURANCE - COST, Intravenous Therapy (D_5_HOS_C7_64)",Major Movable Equipment (G_C1THRU4_23),Net Income (G3_C1_29),Other Reimbursable (D3_IRF_C3_98),Interns & Res Other Program Costs (A_C6_22),"PAID HOURS RELATED TO SALARIES, Social Service (S3_2_C5_42)",Laboratory (D_4_IPF_C13_60),"COST REIMBURSED SERVICES SUBJECT TO DEDUCTIBLES  AND COINSURANCE - CHARGES, Whole Blood & Packed Red Blood Cells (D_5_HOS_C3_62)",Electroencephalography (D3_HOS_C2_70),Delivery Room and Labor Room (D3_SNF_C2_52),Electroencephalography (C_1_C6_70),"COST SERVICES SUBJECT TO DEDUCTIBLES AND COINSURANCE - COST, Intravenous Therapy (D_5_HOS_C6_64)",Title XVIII discharges (S3_1_C13_18),RHC 21 Provider Number (S2_1_C2_1520),"Net Expense for Cost Allocation, Gift, Flower, Coffee Shop, Canteen (B_1_C0_190)",NF (S3_1_C8_20),"HHA III, Without Outliers:  Other Charges (S4_HHA3_C1_34)",Title XIX discharges (S3_1_C14_18),Physical Therapy (D_4_HOS_C12_66),"COST SERVICES SUBJECT TO DEDUCTIBLES AND COINSURANCE - COST, Anesthesiology (D_5_HOS_C6_53)","COST SERVICES NOT SUBJECT TO DEDUCTIBLES AND COINSURANCE - COST, Home Program Dialysis (D_5_HOS_C7_94)","HHA I, Total Non Routine Medical  Supply Charges (S4_HHA1_C5_38)",Burn Intensive Care Unit (S3_1_C6_10),"COST SERVICES SUBJECT TO DEDUCTIBLES AND COINSURANCE - COST, Durable Medical Equipment Rented (D_5_HOS_C6_96)","Total Inpatient Charges, MRI (C_1_C6_58)","Net Expense for Cost Allocation, Electroencephalography (B_1_C0_70)","AVERAGE HOURLY WAGE, Home Office Salaries & Wage Related Csts (S3_2_C6_14)","Allocation of Interns & Residents Salary and Fringes, Electrocardiology (B_1_C21_69)","HHA III, Total Charges:  LUPA Episodes (S4_HHA3_C3_35)",Premiums (S2_1_C1_11801),Total Income (G3_C1_26),Renal Dialysis (D3_IPF_C2_74),"COST REIMBURSED SERVICES SUBJECT TO DEDUCTIBLES  AND COINSURANCE - CHARGES, Radiology-Therapeutic (D_5_HOS_C3_55)",MRI (D3_IPF_C2_58),Nonpaid Workers (A_C6_193),CT Scan (D3_HOS_C2_57),"AMOUNT REPORTED, Interns & Residents (S3_2_C3_2552)",Medical and Other Services (E_B_HOS_C1_1),Clinic (B_2_C26_90),Other Ancillary (A_C2_76),In State Medicaid paid days (S2_1_C1_24),"COST REIMBURSED SERVICES SUBJECT TO DEDUCTIBLES  AND COINSURANCE - CHARGES, Physical Therapy (D_5_HOS_C3_66)",Other Ancillary (D3_IRF_C2_76),Total Other Medical Education (D_4_IPF_C4_200),Radioisotope (D_4_IPF_C11_56),"HHA III, Total Visits (S4_HHA3_C5_33)",Burn Intensive Care Unit (D_1_HOS_C6_33),Intensive Care Unit (D3_IPF_C2_31),"Total Inpatient Charges, Surgical Intensive Care Unit (C_1_C6_34)",Drugs Charged to Patients (D_4_HOS_C13_73),"AMOUNT REPORTED, Wage Related Costs Core (S3_2_C2_17)","TOTAL CAPITAL COSTS AFTER COST ALLOCATION, Whole Blood & Packed Red Blood Cells (B_2_C26_62)",Occupational Therapy (D3_HOS_C2_67),SNF (S3_1_C10_19),"AVERAGE HOURLY WAGE, Home Office Personnel (S3_2_C6_8)",Subprovider-IPF (D3_SNF_C2_40),Radiology-Diagnostic (D3_HOS_C3_54),"HHA II, PEP Episodes:  Total Charges: (S4_HHA2_C4_35)",Observation Beds (Distinct Unit) (B_1_C22_9201),"COST SERVICES SUBJECT TO DEDUCTIBLES AND COINSURANCE - COST, Delivery Room and Labor Room (D_5_HOS_C6_52)",Surgical Intensive Care Unit (S3_1_C5_11),HMO (S3_1_C6_2),Coronary Care Unit (C_1_C5_32),Adults & Pediatrics (D_1_HOS_C6_30),"COST REIMBURSED SERVICES SUBJECT TO DEDUCTIBLES  AND COINSURANCE - CHARGES, Electrocardiology (D_5_HOS_C3_69)","PAID HOURS RELATED TO SALARIES, Medical Records & Med Records Library (S3_2_C5_41)",Ratio of line 15 to line 16 (E_B_HOS_C1_17),Other Long-term Liabilities (G_C1THRU4_49),Intestinal Acquisition (C_1_C6_110),Title XIX discharges (S3_1_C14_17),"COST REIMBURSED SERVICES SUBJECT TO DEDUCTIBLES  AND COINSURANCE - CHARGES, Emergency (D_5_HOS_C3_91)",Emergency (D_4_IPF_C11_91),Labor and Delivery Days -  Title XIX (S3_1_C8_32),Emergency (D3_IRF_C2_91),"Net Expense for Cost Allocation, Durable Medical Equipment Rented (B_1_C0_96)","Purchases, Building Improvements (A7_1_C2_4)",MRI (D_4_IRF_C13_58),FQHC (C_1_C5_89),"COST SERVICES SUBJECT TO DEDUCTIBLES AND COINSURANCE - COST, Total (D_5_HOS_C6_200)",IRF (S3_1_C2_17),Radioisotope (D_4_SNF_C11_56),SNF (S3_1_C3_19),"COST SERVICES NOT SUBJECT TO DEDUCTIBLES AND COINSURANCE - COST, Renal Dialysis (D_5_HOS_C7_74)","Disposals and Retirements, Fixed Equipment (A7_1_C5_5)","Interest, Total (A7_3_C11_3)",Refunds and Rebates of Expenses (A8_C2_5),"Does the facility qualify and is it receiving payments for 
disproportionate share? (Y/N) (S2_1_C1_22)",Burn Intensive Care Unit (B_1_C26_33),Other Special Care Unit (A_C1_35),Lung  Acquisition (B_1_C26_108),FQHC 1 Provider Number (S2_1_C2_16),Other Reimbursable (D_4_HOS_C10_98),Hospice (B_1_C22_116),"TOTAL CAPITAL COSTS AFTER COST ALLOCATION, OLTC (B_2_C26_46)","Allocation of Interns & Residents Program Costs, OLTC (B_1_C22_46)",Balance due provider/program (E_B_HOS_C1_43),Coronary Care Unit (S3_1_C2_9),Subprovider I (D3_HOS_C2_42),Title XVIII discharges (S3_1_C13_1),"Net Expense for Cost Allocation, Operating Room (B_1_C0_50)","AMOUNT REPORTED, Subtotal Wage Related Csts (S3_3_C2_5)","COST SERVICES SUBJECT TO DEDUCTIBLES AND COINSURANCE - COST, PBP Clinical Lab Services Program Only (D_5_HOS_C6_61)",Cardiac Catheterization (D_4_HOS_C10_59),"PAID HOURS RELATED TO SALARIES, Total (S3_3_C5_6)",Radiology-Diagnostic (D_4_IPF_C11_54),Other Organ Acquisition (B_1_C21_112),"PPS REIMBURSED SERVICES -  CHARGES, Durable Medical Equipment Rented (D_5_HOS_C2_96)","Purchases, Land Improvements (A7_1_C2_2)",Islet Acquisition (A_C1_111),Payment to cost ratio (E_B_HOS_C101_5),NF (S3_1_C7_20),Renal Dialysis (C_1_C7_74),"ADJUSTED SALARIES, Operation of Plant (S3_2_C4_30)",Lesser of cost or charges (E_B_HOS_C1_21),Subprovider-IPF (A_C1_40),Laboratory (D_4_IRF_C13_60),Total discharges (S3_1_C15_16),CT Scan (B_1_C26_57),OLTC (S3_1_C2_21),FQHC (A_C2_89),Impl. Dev. Charged to Patients (A_C2_72),"Net Expense for Cost Allocation, Nursing School (B_1_C0_20)",Observation Beds (Distinct Unit) (D_4_IPF_C11_9201),Total (D_4_IRF_C11_200),"ADJUSTED SALARIES, Contract Labor (S3_2_C4_11)",ICF (A_C6_4501),Intravenous Therapy (D_4_IPF_C11_64),"Beginning Balances, Subtotal (A7_1_C1_8)",ASC (Non Distinct Part) (C_1_C7_75),Out of State Medicaid paid days (S2_1_C3_24),Program Discharges (D1_HOS_C1_54),Pancreas Acquisition (C_1_C6_109),"COST REIMBURSED SERVICES NOT SUBJECT TO DEDUCTIBLES AND COINSURANCE - CHARGES, Renal Dialysis (D_5_HOS_C4_74)",Total (B_1_C26_202),Does the facility operate an ICF/MR facility for purposes of Title XIX? (Y/N) (S2_1_C1_93),"AVERAGE HOURLY WAGE, SNF (S3_2_C6_9)",Adj for Physical therapy costs in excess (A8_C2_24),Int & Res (non approved teaching program (B_1_C21_100),Coronary Care Unit (D3_SNF_C2_32),Heart Acquisition (A_C1_106),Physicians' Private Office (A_C2_192),Anesthesiology (D_4_HOS_C10_53),"Net Expense for Cost Allocation, Other General Service (B_1_C0_18)",Subprovider-IRF (D3_IRF_C2_40),"Allocation of Interns & Residents Program Costs, Radiology-Therapeutic (B_1_C22_55)",Recovery Room (D_4_HOS_C4_51),"AMOUNT REPORTED, Non-Physician Anesthetist Part B (S3_2_C2_21)","Blood Storing, Processing, Trans (D_4_IPF_C11_63)",Total (A8_C2_50),Observation Beds (Distinct Unit) (D3_SNF_C2_9201),"Total Inpatient Charges, Radiology-Therapeutic (C_1_C6_55)",Subtotal (E_B_HOS_C1_27),Research (B_1_C21_191),Radiology-Therapeutic (D_4_HOS_C11_55),"Net Expense for Cost Allocation, Interns & Res Other Program Costs (B_1_C0_22)",Heart Acquisition (C_1_C7_106),Burn Intensive Care Unit (D3_HOS_C2_33),"PAID HOURS RELATED TO SALARIES, Physician-Part B (S3_2_C5_5)",Subprovider-IRF (C_1_C5_41),Respiratory Therapy (D_4_HOS_C13_65),Other Special Care Unit (D3_IRF_C2_35),Net Patient Revenue (G3_C1_3),Intravenous Therapy (A_C6_64),Other Outpatient Services (D_4_HOS_C13_93),"AMOUNT REPORTED, Physician Part B (S3_2_C2_23)","Disposals and Retirements, Land (A7_1_C5_1)",Clinic (D3_IPF_C2_90),"AMOUNT REPORTED, Physician Part A (S3_2_C3_22)","AVERAGE HOURLY WAGE, Operation of Plant (S3_2_C6_30)",Other Ancillary (A_C1_76),Observation Beds (Distinct Unit) (B_1_C26_9201),Organ Procurement (D4_PANCREAS_C1_69),Total Allied Health (D_4_IRF_C3_200),Other Special Care (S3_1_C8_12),Emergency (D_4_HOS_C13_91),Operating Room (B_1_C26_50),Nursing Administration (A_C1_13),interns and residents (E_B_HOS_C1_28),Speech Pathology (D_4_HOS_C10_68),Total Adults & Peds (S3_1_C6_7),Subprovider 1 (S3_1_C2_18),"Allocation of Interns & Residents Program Costs, Whole Blood & Packed Red Blood Cells (B_1_C22_62)",Total (D_4_HOS_C11_200),"HHA I, Total Visits (S4_HHA1_C5_33)",Burn Intensive Care Unit (A_C2_33),"AVERAGE HOURLY WAGE, Cafeteria (S3_2_C6_36)","TOTAL CAPITAL COSTS AFTER COST ALLOCATION, Blood Clotting Factors for Hemoph. (B_2_C26_6250)","Net Expense for Cost Allocation, Intravenous Therapy (B_1_C0_64)","Allocation of Interns & Residents Salary and Fringes, SNF (B_1_C21_44)",Observation Beds (Distinct Unit) (A_C1_9201),ASC (Non Distinct Part) (D_4_HOS_C11_75),Delivery Room and Labor Room (D_4_IRF_C11_52),Respiratory Therapy (D3_IRF_C2_65),Radiology-Diagnostic (D_4_HOS_C11_54),CT Scan (A_C2_57),Amounts expected under 42 CFR (E_B_HOS_C1_16),"Donations, Land Improvements (A7_1_C3_2)",Cost of charity care (S10_C3_23),"Disposals and Retirements, Land Improvements (A7_1_C5_2)","Total Inpatient Charges, OLTC (C_1_C6_46)",Employee Benefits (A_C6_4),Cafeteria employees and guests (A8_C2_14),Utilization Review - Physician Compen (D1_SNF_C1_85),Total Salaries (A_C1_200),Other Reimbursable (B_2_C26_98),Other Ancillary (D_4_HOS_C10_76),Subprovider I (A_C6_42),Occupational Therapy (D_4_IRF_C11_67),Adjusted reimburseable bad debts (E_B_HOS_C1_35),Impl. Dev. Charged to Patients (C_1_C7_72),Adj for Respiratory therapy costs in excess (A8_C2_23),Coronary Care Unit (S3_1_C8_9),Operating Room (D_4_IPF_C13_50),Respiratory Therapy (D3_SNF_C3_65),CMHC (B_1_C21_99),"PPS SERVICES COST, MRI (D_5_HOS_C5_58)","AMOUNT REPORTED, Management and Administrative Services (S3_2_C2_12)",Other Special Care Unit (A_C6_35),Physicians' Private Office (A_C6_192),"Lease, Total (A7_3_C10_3)","COST REIMBURSED SERVICES SUBJECT TO DEDUCTIBLES  AND COINSURANCE - CHARGES, Respiratory Therapy (D_5_HOS_C3_65)",Clinic (D_4_HOS_C3_90),Other Outpatient Services (A_C2_93),Other Nonreimbursable (B_1_C21_194),Emergency (A_C6_91),Other Special Care Unit (D_1_HOS_C4_35),"AVERAGE HOURLY WAGE, Other General Service (S3_2_C6_43)","ADJUSTED SALARIES, Physician-Part A (S3_2_C4_4)","PAID HOURS RELATED TO SALARIES, Dietary under Contract (S3_2_C5_35)",Durable Medical Equipment Sold (A_C1_97),NF (S3_1_C10_20),Recovery Room (D3_IRF_C2_51),Hospital Title 18 Payment System (P/T/O) (S2_1_C7_3),"Blood Storing, Processing, Trans (A_C6_63)","AVERAGE HOURLY WAGE, Social Service (S3_2_C6_42)","Medical certified liver 
transplant center cert date (S2_1_C1_128)",Total Bad Debt expense (S10_C1_26),Electroencephalography (D_4_HOS_C4_70),"Allocation of Interns & Residents Program Costs, Recovery Room (B_1_C22_51)","PPS SERVICES COST, Physical Therapy (D_5_HOS_C5_66)",Total Hospital (S3_1_C3_7),"AVERAGE HOURLY WAGE, Administrative and General under Contract (S3_2_C6_28)",SNF (S3_1_C9_19),RHC 4 Provider Number (S2_1_C2_1503),Respiratory Therapy (A_C6_65),Other Ancillary (D_4_HOS_C1_76),"PPS SERVICES COST, Medical Supplies Charged to Patients (D_5_HOS_C5_71)",Nursery (S3_1_C5_13),Rental of Provider space by suppliers (A8_C2_6),MRI (D_4_IPF_C11_58),"Donations, Land (A7_1_C3_1)",Intestinal Acquisition (C_1_C7_110),Emergency (D3_IRF_C3_91),Intensive Care Unit (A_C2_31),CT Scan (D3_IRF_C3_57),Total Subprovider I Interns & Residents (S3_1_C9_18),"HHA III, LUPA Episodes:  Total Visits (S4_HHA3_C3_33)",Electrocardiology (D3_IRF_C2_69),Other Ancillary (D_4_IPF_C13_76),"Net Expense for Cost Allocation, Cafeteria (B_1_C0_11)",Cardiac Catheterization (D_4_SNF_C11_59),PBP Clinical Lab Services Program Only (D3_IRF_C3_61),Total Other Assets (G_C1THRU4_35),Speech Pathology (A_C6_68),Organ Procurement (D4_LIVER_C1_69),Intensive Care Unit (D_1_HOS_C6_31),Total Nonphysician Anesthetist Cost (D_4_IPF_C1_200),"AMOUNT REPORTED, Total (S3_3_C2_6)","Allocation of Interns & Residents Program Costs, Physical Therapy (B_1_C22_66)",Medical Supplies Charged to Patients (D_4_IRF_C13_71),RHC/FQHC Combined (S3_1_C8_26),Accounts Receivable (G_C1THRU4_4),Durable Medical Equipment Rented (C_1_C5_96),Islet Acquisition (A_C6_111),Drugs Charged to Patients (B_1_C21_73),Paramedical Education (A_C2_23),MRI (D3_HOS_C2_58),Cross Foot Adjustments (B_1_C26_200),Emergency (C_1_C5_91),Total Charges (C_1_C8_202),"AMOUNT REPORTED, Contract Labor: Pysician Part A (S3_2_C2_13)",OSP (A_C6_9940),"Net Expense for Cost Allocation, Burn Intensive Care Unit (B_1_C0_33)",Blood Clotting Factors for Hemoph. (A_C1_6250),Other Organ Acquisition (A_C1_112),"PPS REIMBURSED SERVICES -  CHARGES, Cardiac Catheterization (D_5_HOS_C2_59)","Allocation of Interns & Residents Program Costs, Radiology-Diagnostic (B_1_C22_54)",Delivery Room and Labor Room (D_4_HOS_C12_52),Islet Acquisition (A_C2_111),Component rate ESRD (E_B_HOS_C1_33),Coronary Care Unit (A_C6_32),"Depreciation, Total (A7_3_C9_3)","COST SERVICES SUBJECT TO DEDUCTIBLES AND COINSURANCE - COST, Electroencephalography (D_5_HOS_C6_70)","PAID HOURS RELATED TO SALARIES, Maintenance of Personnel (S3_2_C5_37)",Cardiac Catheterization (D_4_IPF_C13_59),Speech Pathology (C_1_C5_68),Clinic (D_4_HOS_C13_90),"COST SERVICES NOT SUBJECT TO DEDUCTIBLES AND COINSURANCE - COST, Other Outpatient Services (D_5_HOS_C7_93)",Electrocardiology (D_4_HOS_C10_69),Electrocardiology (A_C6_69),Other Nonreimbursable (A_C2_194),Notes Receivable (G_C1THRU4_3),"Net Expense for Cost Allocation, Radioisotope (B_1_C0_56)",Total (D_4_HOS_C13_200),Total (D_1_HOS_C6_200),Drugs Charged to Patients (D3_SNF_C3_73),"HHA III, With Outliers:  Total Visits (S4_HHA3_C2_33)",Blood Clotting Factors for Hemoph. (D_4_HOS_C3_6250),Radioisotope (D_4_HOS_C3_56),"Allocation of Interns & Residents Salary and Fringes, Blood Storing, Processing, Trans (B_1_C21_63)",RHC (C_1_C5_88),Total Facility FTEs (S3_1_C11_27),Occupational Therapy (D_4_HOS_C13_67),"AMOUNT REPORTED, Home Office Salaries (S3_2_C3_1401)",Electrocardiology (C_1_C7_69),"Net Expense for Cost Allocation, Occupational Therapy (B_1_C0_67)","HHA II, PEP Episodes:  Total Visits (S4_HHA2_C4_33)","HHA III, PEP:  Total Number of Outlier Episodes (S4_HHA3_C4_37)",Anesthesiology (D_4_HOS_C3_53),"AMOUNT REPORTED, Interns & Residents (S3_2_C2_7)","Insurance, Total (A7_3_C5_3)",RHC 3 Provider Number (S2_1_C2_1502),"COST REIMBURSED SERVICES SUBJECT TO DEDUCTIBLES  AND COINSURANCE - CHARGES, Operating Room (D_5_HOS_C3_50)","HHA III, LUPA:  Total Non Routine Med Sup Chgs (S4_HHA3_C3_38)",Other Organ Acquisition (C_1_C7_112),Heart Acquisition (B_2_C26_106),Medical Supplies Charged to Patients (C_1_C5_71),Total Swing Bed Cost (D1_HOS_C1_26),"Depreciation, New Cap Related Csts Bldg & Fixtures (A7_3_C9_1)",Emergency (B_1_C21_91),"PAID HOURS RELATED TO SALARIES, Dietary (S3_2_C5_34)",Total Allied Health (D_4_IPF_C3_200),"Beginning Balances, Building Improvements (A7_1_C1_4)",Impl. Dev. Charged to Patients (C_1_C6_72),Clinic (D_4_IRF_C11_90),State or local govt (not Medicaid or CHIP) -- Costs minus net revenue (0 min) (S10_C1_16),Total (D_4_HOS_C12_200),Other Current Liabilities (G_C1THRU4_44),Allowable bad debts (E_B_HOS_C1_34),Physical Therapy (A_C2_66),CT Scan (D_4_IPF_C11_57),RHC 15 Provider Number (S2_1_C2_1514),Renal 5 Provider Number (S2_1_C2_1804),"Allocation of Interns & Residents Program Costs, Subprovider-IRF (B_1_C22_41)",Whole Blood & Packed Red Blood Cells (D_4_IRF_C13_62),Payments received from patients for amounts previously written off as charity care (S10_C2_22),OOT (C_1_C7_9930),SNF (S3_1_C8_19),Drugs Charged to Patients (D3_HOS_C3_73),"HHA I, PEP:  Total Number of Outlier Episodes (S4_HHA1_C4_37)",Drugs Charged to Patients (A_C6_73),Other Ancillary (D_4_HOS_C2_76),Recovery Room (D3_HOS_C3_51),certification date (S2_1_C1_131),"Net Expense for Cost Allocation, Medical Records and Medical Rec. Library (B_1_C0_16)","Blood Storing, Processing, Trans (D3_HOS_C2_63)","Net Expense for Cost Allocation, Kidney Acquisition (B_1_C0_105)",Negative Cost Centers (B_1_C26_201),"COST SERVICES SUBJECT TO DEDUCTIBLES AND COINSURANCE - COST, Physical Therapy (D_5_HOS_C6_66)","AMOUNT REPORTED, Wage Related Costs RHC/FQHC (S3_2_C3_24)","AMOUNT REPORTED, Central Services and Supply (S3_2_C2_39)",Other Ancillary (B_1_C21_76),Liver Acquisition (A_C2_107),Electroencephalography (D_4_HOS_C11_70),RHC 11 Provider Number (S2_1_C2_1510),Radiology-Therapeutic (D_4_HOS_C2_55),Electroencephalography (D_4_HOS_C13_70),Recovery Room (D_4_HOS_C2_51),Charity care charges and uninsured discounts for the entire facility (S10_C1_20),Total Liabilities and Fund Balances (G_C1THRU4_54),Clinic (A_C2_90),MDH status beginning date  (MM/DD/YY) (S2_1_C1_3801),"Total Inpatient Charges, Blood Clotting Factors for Hemoph. (C_1_C6_6250)",Physicians' Assistant (A8_C2_29),MRI (D_4_HOS_C11_58),Heart Acquisition (A_C6_106),"COST SERVICES NOT SUBJECT TO DEDUCTIBLES AND COINSURANCE - COST, Other Reimbursable (D_5_HOS_C7_98)",Renal Dialysis (B_1_C26_74),Total Allied Health Cost (D_3_HOS_C2_200),"PAID HOURS RELATED TO SALARIES, Excluded Area Salaries (S3_3_C5_2)",Hospital Adults & Pediatrics (S3_1_C7_1),Durable Medical Equipment Rented (D3_IPF_C2_96),"Blood Storing, Processing, Trans (D_4_HOS_C3_63)",Radioisotope (D3_HOS_C2_56),"Disposals and Retirements, Land (A7_1_C7_1)",MRI (D_4_HOS_C13_58),"PAID HOURS RELATED TO SALARIES, Operation of Plant (S3_2_C5_30)","Allocation of Interns & Residents Salary and Fringes, Radioisotope (B_1_C21_56)","COST SERVICES SUBJECT TO DEDUCTIBLES AND COINSURANCE - COST, Blood Storing, Processing, Trans (D_5_HOS_C6_63)",Delivery Room and Labor Room (A_C1_52),"Allocation of Interns & Residents Salary and Fringes, Cardiac Catheterization (B_1_C21_59)",Observation Beds (Distinct Unit) (D_4_IRF_C11_9201),Other Ancillary (D3_HOS_C3_76),Excess of customary charges (E_B_HOS_C1_19),Interest Expense (A_C2_113),Radioisotope (D3_IPF_C3_56),CT Scan (A_C1_57),NF (A_C6_45),RPCH/CAH Visits (S3_1_C7_15),SNF (A_C2_44),"AMOUNT REPORTED, Housekeeping under contract (S3_2_C2_33)",OSP (C_1_C6_9940),"Allocation of Interns & Residents Program Costs, Blood Storing, Processing, Trans (B_1_C22_63)","Net Expense for Cost Allocation, Whole Blood & Packed Red Blood Cells (B_1_C0_62)",Surgical Intensive Care Unit (D3_IRF_C2_34),Impl. Dev. Charged to Patients (A_C6_72),ASC (Distinct Part) (B_1_C21_115),"TOTAL CAPITAL COSTS AFTER COST ALLOCATION, Subprovider II (B_2_C26_4201)",Anesthesiology (D_4_HOS_C4_53),"ADJUSTED SALARIES, Net Salaries (S3_3_C4_1)","COST REIMBURSED SERVICES NOT SUBJECT TO DEDUCTIBLES AND COINSURANCE - CHARGES, Impl. Dev. Charged to Patients (D_5_HOS_C4_72)",Central Services and Supply (A_C1_14),"Net Expense for Cost Allocation, Other Nonreimbursable (B_1_C0_194)","COST SERVICES NOT SUBJECT TO DEDUCTIBLES AND COINSURANCE - COST, Speech Pathology (D_5_HOS_C7_68)",MRI (A_C6_58),Intensive Care Unit Program Cost (D1_HOS_C5_43),Durable Medical Equipment Sold (C_1_C6_97),Subprovider 2 (S3_1_C3_1801),"HHA I, Without Outliers:  Total Visits (S4_HHA1_C1_33)",Whole Blood & Packed Red Blood Cells (C_1_C5_62),Recovery Room (D_4_SNF_C11_51),Observation Beds (Distinct Unit) (D3_IRF_C3_9201),Medical Records and Medical Rec. Library (A_C1_16),Observation Beds (Distinct Unit) (B_1_C21_9201),"ADJUSTED SALARIES, Non-Physician Anesthetist Part A (S3_2_C4_20)",Total Other Medical Education (D_4_IRF_C4_200),HHA 2 Provider Number (S2_1_C2_1201),"Allocation of Interns & Residents Program Costs, Impl. Dev. Charged to Patients (B_1_C22_72)",Research (A_C2_191),Physical Therapy (C_1_C2_66),Organ Procurement (D4_INTESTINE_C1_69),"AMOUNT REPORTED, Total Salaries (S3_2_C2_1)","COST SERVICES SUBJECT TO DEDUCTIBLES AND COINSURANCE - COST, Electrocardiology (D_5_HOS_C6_69)",Bonus Payment (D1_HOS_C1_58),"Number of patients in program at 
end of cost reporting period (S5_C6_1)","Net Expense for Cost Allocation, ASC (Non Distinct Part) (B_1_C0_75)",Electrocardiology (D3_IRF_C3_69),Speech Pathology (B_1_C26_68),Heart Acquisition (B_1_C26_106),Home Program Dialysis (A_C6_94),Pancreas Acquisition (A_C2_109),Report Status Code (RPT_STUS_CD),Other Special Care Unit (D_3_HOS_C9_35),OOT (B_2_C26_9930),Other Outpatient Services (D_4_IPF_C13_93),"PPS REIMBURSED SERVICES -  CHARGES, Other Outpatient Services (D_5_HOS_C2_93)",PBP Clinical Lab Services Program Only (B_1_C26_61),MDH status ending date (MM/DD/YY) (S2_1_C2_38),HHA (S3_1_C11_22),Durable Medical Equipment Sold (B_2_C26_97),Subprovider I (D_1_HOS_C4_42),Coronary Care Unit (S3_1_C6_9),Lung  Acquisition (C_1_C6_108),"AMOUNT REPORTED, Interns & Residents (S3_2_C2_2550)","AVERAGE HOURLY WAGE, Non-Physician Part B (S3_2_C6_6)",Intravenous Therapy (D_4_HOS_C12_64),CMHC (C_1_C7_99),Respiratory Therapy (D_4_HOS_C10_65),"AMOUNT REPORTED, Related  Salaries (S3_2_C2_1402)","Blood Storing, Processing, Trans (D3_IPF_C2_63)",MRI (D3_IRF_C2_58),Other Special Care Unit (B_1_C26_35),"HHA III, LUPA Episodes:  Other Charges (S4_HHA3_C3_34)",Nonpaid Workers (B_2_C26_193),Impl. Dev. Charged to Patients (D3_IRF_C2_72),Respiratory Therapy (D3_HOS_C2_65),"PAID HOURS RELATED TO SALARIES, Administrative and General (S3_2_C5_27)",CMHC (C_1_C6_99),Total unreimbursed and uncompensated care (S10_C1_31),"Total Program Inpatient Operating Cost excluding Capital Related, Nonphysician, Anesthetist, and Medical Education Costs (D1_HOS_C1_53)","AMOUNT REPORTED, Dietary (S3_2_C2_34)","Allocation of Interns & Residents Salary and Fringes, CT Scan (B_1_C21_57)",Operating Room (D_4_HOS_C13_50),Radiology-Therapeutic (D_4_SNF_C11_55),"Total Inpatient Charges, Subprovider I (C_1_C6_42)","HHA I, LUPA Episodes:  Total Number of Episodes (S4_HHA1_C3_36)",Operating Room (D3_IRF_C3_50),OLTC (S3_1_C11_21),"COST REIMBURSED SERVICES NOT SUBJECT TO DEDUCTIBLES AND COINSURANCE - CHARGES, Laboratory (D_5_HOS_C4_60)",Number of stations (S5_C1_6),"PPS SERVICES COST, Anesthesiology (D_5_HOS_C5_53)",Total Other Income (G3_C1_25),Electrocardiology (C_1_C5_69),Title XVIII discharges (S3_1_C13_14),"PPS REIMBURSED SERVICES -  CHARGES, Radiology-Therapeutic (D_5_HOS_C2_55)","HHA III, Without Outliers:  Total Visits (S4_HHA3_C1_33)",Nursery (D3_HOS_C2_43),"General Inpatient Routine Service Cost, net of Swing Bed Cost (D1_IRF_C1_27)","AMOUNT REPORTED, Cafeteria (S3_2_C2_36)","COST REIMBURSED SERVICES SUBJECT TO DEDUCTIBLES  AND COINSURANCE - CHARGES, Other Reimbursable (D_5_HOS_C3_98)","ADJUSTED SALARIES, Interns & Residents (S3_2_C4_2551)",Occupational Therapy (D_4_HOS_C10_67),Drugs Charged to Patients (D3_HOS_C2_73),Total charges to state or local government programs for indigent care (not Medicaid or CHIP) (S10_C1_14),Intravenous Therapy (D_4_HOS_C2_64),RHC (A_C2_88),Radioisotope (A_C1_56),CT Scan (D_4_HOS_C11_57),Stand-alone CHIP cost (S10_C1_11),"Net Expense for Cost Allocation, New Capital Buildings and Fixtures (B_1_C0_1)",Radiology-Diagnostic (D_4_IPF_C13_54),Physical Therapy (A_C6_66),"Purchases, Land (A7_1_C2_1)","General Inpatient Routine Service Cost, net of Swing Bed Cost (D1_HOS_C1_27)",Hospital County (S2_1_C4_2),CORF (A_C1_9910),Physical Therapy (D3_HOS_C3_66),"Allocation of Interns & Residents Salary and Fringes, Intravenous Therapy (B_1_C21_64)",Recovery Room (A_C2_51),"PPS REIMBURSED SERVICES -  CHARGES, Blood Storing, Processing, Trans (D_5_HOS_C2_63)","AMOUNT REPORTED, Contract Labor (S3_2_C2_11)",Whole Blood & Packed Red Blood Cells (B_1_C26_62),Anesthesiology (D3_HOS_C2_53),"Net Expense for Cost Allocation, Durable Medical Equipment Sold (B_1_C0_97)","COST SERVICES SUBJECT TO DEDUCTIBLES AND COINSURANCE - COST, Whole Blood & Packed Red Blood Cells (D_5_HOS_C6_62)","Number of Times per week
 Patient receives Dialysis (S5_C4_2)","Average patient dialysis time 
including setup (S5_C2_3)",Recovery Room (D3_IPF_C2_51),"Net Expense for Cost Allocation, CORF (B_1_C0_9910)",Telephone Services (A8_C2_7),Islet Acquisition (B_1_C26_111),FQHC (D_4_HOS_C4_89),"ADJUSTED SALARIES, Home Office Salaries (S3_2_C4_1401)",MRI (A_C2_58),Electroencephalography (B_1_C26_70),Recovery Room (B_1_C26_51),"COST SERVICES NOT SUBJECT TO DEDUCTIBLES AND COINSURANCE - COST, Blood Storing, Processing, Trans (D_5_HOS_C7_63)",Electroencephalography (D_4_HOS_C2_70),CMHC (A_C2_99),"Blood Storing, Processing, Trans (D3_SNF_C3_63)","COST REIMBURSED SERVICES SUBJECT TO DEDUCTIBLES  AND COINSURANCE - CHARGES, Ambulance Services (D_5_HOS_C3_95)",Other adjustments (E_B_HOS_C1_39),"COST REIMBURSED SERVICES NOT SUBJECT TO DEDUCTIBLES AND COINSURANCE - CHARGES, Physical Therapy (D_5_HOS_C4_66)","COST REIMBURSED SERVICES NOT SUBJECT TO DEDUCTIBLES AND COINSURANCE - CHARGES, Electrocardiology (D_5_HOS_C4_69)","Sum of lines 3,4 divided by line 6 (E_B_HOS_C1_7)",Sequestration adjustment (E_B_HOS_C1_4001),RHC 20 Provider Number (S2_1_C2_1519),"Donations, Buildings and Fixtures (A7_1_C3_3)",Cardiac Catheterization (D_4_HOS_C3_59),"PPS SERVICES COST, Durable Medical Equipment Sold (D_5_HOS_C5_97)","Total Outpatient Charges, Radioisotope (C_1_C7_56)",Observation Beds (Distinct Unit) (D3_SNF_C3_9201),Paid Losses (S2_1_C2_11801),"COST SERVICES SUBJECT TO DEDUCTIBLES AND COINSURANCE - COST, Recovery Room (D_5_HOS_C6_51)",Subprovider 1 (S3_1_C3_18),Other Organ Acquisition (C_1_C5_112),OPT (C_1_C6_9920),Liver Acquisition (B_1_C26_107),Whole Blood & Packed Red Blood Cells (A_C2_62),"Number of days in year dialysis 
furnished (S5_C5_2)",Whole Blood & Packed Red Blood Cells (D_4_HOS_C11_62),ICF (S3_1_C10_2001),Program Inpatient Ancillary Service Cost (D1_HOS_C1_48),New Capital Buildings and Fixtures (A_C6_1),or allied health costs? (S2_1_C1_60),Other Reimbursable (B_1_C22_98),Other Ancillary (D_4_HOS_C13_76),"AMOUNT REPORTED, Subtotal Salaries (S3_3_C2_3)",Other Organ Acquisition (C_1_C6_112),"AMOUNT REPORTED, Home Office:  Physician Part A (S3_2_C2_15)",Medical Supplies Charged to Patients (D3_HOS_C3_71),Coronary Care Unit (S3_1_C3_9),ASC (Non Distinct Part) (D_4_IRF_C11_75),Other Reimbursable (D3_IRF_C2_98),"HHA III, Total Number of Outlier Episodes (S4_HHA3_C5_37)",Notes and Loans Payable (short term) (G_C1THRU4_40),Emergency (D3_IPF_C3_91),"ADJUSTED SALARIES, Administrative and General (S3_2_C4_27)",Electroencephalography (C_1_C7_70),Islet Acquisition (C_1_C5_111),HHA (S3_1_C9_22),Number of Times per week Patient receives Dialysis (S5_C1_2),Drugs Charged to Patients (D_4_HOS_C10_73),Electroencephalography (D_4_HOS_C12_70),"Allocation of Interns & Residents Salary and Fringes, Subprovider-IPF (B_1_C21_40)",Speech Pathology (C_1_C7_68),"COST SERVICES SUBJECT TO DEDUCTIBLES AND COINSURANCE - COST, Radioisotope (D_5_HOS_C6_56)",Impl. Dev. Charged to Patients (D3_SNF_C3_72),Total Assets (G_C1THRU4_36),Nonphysician Anesthetists (A_C2_19),"Gift, Flower, Coffee Shop, Canteen (A_C2_190)",Whole Blood & Packed Red Blood Cells (D_4_HOS_C10_62),Respiratory Therapy (D_4_HOS_C3_65),"COST SERVICES NOT SUBJECT TO DEDUCTIBLES AND COINSURANCE - COST, Laboratory (D_5_HOS_C7_60)",Durable Medical Equipment Rented (A_C1_96),FQHC 5 Provider Number (S2_1_C2_1604),Impl. Dev. Charged to Patients (D3_HOS_C3_72),Renal Dialysis (B_1_C21_74),"Salaries, Wages, and Fees Payable (G_C1THRU4_38)","COST REIMBURSED SERVICES SUBJECT TO DEDUCTIBLES  AND COINSURANCE - CHARGES, Radiology-Diagnostic (D_5_HOS_C3_54)",Medical Records and Medical Rec. Library (A_C6_16),Cost To Charge Ratio (S10_C1_1),Title XVIII discharges (S3_1_C13_16),Other Outpatient Services (D_4_SNF_C11_93),"TOTAL CAPITAL COSTS AFTER COST ALLOCATION, Radioisotope (B_2_C26_56)","Does this facility operate 
transplant center? (Y/N) (S2_1_C1_125)","Disposals and Retirements, Movable Equipment (A7_1_C7_6)","ADJUSTED SALARIES, Total Salaries (S3_2_C4_1)",Electrocardiology (A_C1_69),"Total Inpatient Charges, Anesthesiology (C_1_C6_53)",Other Special Care Unit (D_1_HOS_C7_35),Burn Intensive Care Unit (S3_1_C4_10),Sale of medical and surgical supplies to (A8_C2_16),"COST REIMBURSED SERVICES SUBJECT TO DEDUCTIBLES  AND COINSURANCE - CHARGES, Total (D_5_HOS_C3_200)",Home Program Dialysis (D3_SNF_C2_94),Does the hospital qualify as RPCH/CAH? (Y/N) (S2_1_C1_105),Paramedical Education (A_C6_23),Adj for Speech therapy in excess of lim (A8_C2_31),Respiratory Therapy (D_4_HOS_C2_65),Recovery Room (D_4_HOS_C11_51),Home Program Dialysis (A_C1_94),Impl. Dev. Charged to Patients (B_2_C26_72),Kidney Acquisition (C_1_C5_105),Radioisotope (D3_IRF_C2_56),"PAID HOURS RELATED TO SALARIES, Nursing Administration (S3_2_C5_38)","PPS REIMBURSED SERVICES -  CHARGES, Observation Beds (Distinct Unit) (D_5_HOS_C2_9201)",Emergency (D3_SNF_C2_91),Renal Dialysis (A_C2_74),Dietary (A_C6_10),Other General Service (A_C6_18),Subprovider II (A_C6_4201),Labor and Delivery Days -  Title XIX (S3_1_C7_32),CT Scan (D3_IPF_C3_57),"Net Expense for Cost Allocation, PBP Clinical Lab Services Program Only (B_1_C0_61)","Treatment capacity per day per
station (S5_C1_7)",Drugs Charged to Patients (C_1_C6_73),"COST REIMBURSED SERVICES NOT SUBJECT TO DEDUCTIBLES AND COINSURANCE - CHARGES, Speech Pathology (D_5_HOS_C4_68)",IPF (S3_1_C8_16),Radiology-Therapeutic (D3_IPF_C3_55),Delivery Room and Labor Room (B_1_C26_52),Mortgage Payable (G_C1THRU4_46),Subprovider I (C_1_C5_42),Subprovider II (B_1_C26_4201),"Fully Depreciated Assets, Donations (A7_1_C3_7)",NF (B_1_C26_45),Coronary Intensive Care Unit (D_1_HOS_C6_32),Self Insurance (S2_1_C3_11801),"Net Expense for Cost Allocation, Dietary (B_1_C0_10)",NF (S3_1_C3_20),Respiratory Therapy (C_1_C5_65),Total Hospital (S3_1_C4_14),"HHA I, With Outliers:  Other Charges (S4_HHA1_C2_34)",Durable Medical Equipment Rented (A_C6_96),"PPS REIMBURSED SERVICES -  CHARGES, Emergency (D_5_HOS_C2_91)","General Inpatient Routine Service Cost, net of Swing Bed Cost (D1_IPF_C1_27)",Emergency (D_4_IPF_C13_91),Other Special Care Unit (D3_HOS_C2_35),Renal Dialysis (D3_HOS_C3_74),Title XIX discharges (S3_1_C14_14),CMHC (B_2_C26_99),"COST REIMBURSED SERVICES NOT SUBJECT TO DEDUCTIBLES AND COINSURANCE - CHARGES, Medical Supplies Charged to Patients (D_5_HOS_C4_71)",Other Special Care Unit (C_1_C5_35),"AMOUNT REPORTED, Housekeeping (S3_2_C2_32)","Donations, Subtotal (A7_1_C3_8)","Net Expense for Cost Allocation, Lung  Acquisition (B_1_C0_108)","PPS REIMBURSED SERVICES -  CHARGES, Medical Supplies Charged to Patients (D_5_HOS_C2_71)",Electrocardiology (A_C2_69),Nursing School (A_C1_20),Impl. Dev. Charged to Patients (D_4_IPF_C11_72),"PPS SERVICES COST, Impl. Dev. Charged to Patients (D_5_HOS_C5_72)",Emergency (D_4_HOS_C1_91),Electrocardiology (D3_IPF_C3_69),"Total Inpatient Charges, Adults & Pediatrics (C_1_C6_30)",Radiology-Diagnostic (D_4_HOS_C3_54),"PPS SERVICES COST, Durable Medical Equipment Rented (D_5_HOS_C5_96)",Cardiac Catheterization (A_C6_59),Blood Clotting Factors for Hemoph. (C_1_C5_6250),"General Inpatient Routine Service Cost, net of Swing Bed and Private Room Diff (D1_IPF_C1_37)",Respiratory Therapy (A_C2_65),"Net Expense for Cost Allocation, Emergency (B_1_C0_91)",Social Service (A_C6_17),Emergency (D_4_HOS_C10_91),"PPS REIMBURSED SERVICES -  CHARGES, Radiology-Diagnostic (D_5_HOS_C2_54)",Renal Dialysis (D3_IPF_C3_74),Other Nonreimbursable (B_1_C26_194),"HHA II, Without Outliers:  Total Visits (S4_HHA2_C1_33)","Net Expense for Cost Allocation, Nursing Administration (B_1_C0_13)",New Capital Buildings and Fixtures (A_C2_1),"Allocation of Interns & Residents Program Costs, Intensive Care Unit (B_1_C22_31)",Title XVIII discharges (S3_1_C13_2),"Blood Storing, Processing, Trans (C_1_C7_63)","Gift, Flower, Coffee Shop, Canteen (B_1_C26_190)",Int & Res (non approved teaching program (A_C1_100),Intensive Care Unit (A_C1_31),Surgical Intensive Care Unit (S3_1_C7_11),Other Outpatient Services (B_2_C26_93),"ADJUSTED SALARIES, Teaching Physician Salaries (S3_2_C4_1602)",Delivery Room and Labor Room (D3_IPF_C3_52),"PAID HOURS RELATED TO SALARIES, Cafeteria (S3_2_C5_36)",Emergency (D3_HOS_C3_91),Title XVIII discharges (S3_1_C13_17),"HHA I, LUPA Episodes:  Total Visits (S4_HHA1_C3_33)","TOTAL CAPITAL COSTS AFTER COST ALLOCATION, Operating Room (B_2_C26_50)",ASC (Distinct Part) (B_1_C22_115),Intravenous Therapy (D_4_HOS_C10_64),Surgical Intensive Care Unit (D_1_HOS_C4_34),Hospital Adlts & Ped Swing Bed SNF (S3_1_C7_5),Durable Medical Equipment Sold (A_C2_97),Renal Dialysis (C_1_C6_74),Intensive Care Unit (S3_1_C4_8),RHC 22 Provider Number (S2_1_C2_1521),Surgical Intensive Care Unit (A_C1_34),Other Nonreimbursable (A_C1_194),Recovery Room (A_C6_51),Other Adjustments (Summed) (A8_C2_33),Other Special Purpose (B_1_C21_117),RHC/FQHC Combined (S3_1_C10_26),Total Allied Health (D_4_HOS_C3_200),Other Outpatient Services (D_4_IPF_C11_93),Emergency (D_4_HOS_C4_91),Islet Acquisition (B_1_C22_111),NF (C_1_C5_45),"TOTAL CAPITAL COSTS AFTER COST ALLOCATION, Anesthesiology (B_2_C26_53)",Net Revenue from Medicaid (S10_C1_2),Physicians' Private Office (B_2_C26_192),HMO (S3_1_C7_2),OPPS payments (E_B_HOS_C1_3),Operating Room (D3_IPF_C3_50),Respiratory Therapy (C_1_C2_65),Operating Room (D_4_HOS_C4_50),"General Inpatient Routine Service Cost, net of Swing Bed and Private Room Diff (D1_HOS_C1_37)",Islet Acquisition (C_1_C6_111),Maintenance of Personnel (A_C2_12),ASC (Non Distinct Part) (D_4_IPF_C11_75),New Capital Equipment (A_C2_2),"Allocation of Interns & Residents Salary and Fringes, Radiology-Therapeutic (B_1_C21_55)",Housekeeping (A_C2_9),"Allocation of Interns & Residents Program Costs, Subprovider-IPF (B_1_C22_40)","COST SERVICES SUBJECT TO DEDUCTIBLES AND COINSURANCE - COST, Radiology-Therapeutic (D_5_HOS_C6_55)","COST SERVICES NOT SUBJECT TO DEDUCTIBLES AND COINSURANCE - COST, Electroencephalography (D_5_HOS_C7_70)",Other Special Care Unit (D3_SNF_C2_35),Cardiac Catheterization (D_4_HOS_C13_59),IPF (S3_1_C7_16),"PPS SERVICES COST, Observation Beds (Distinct Unit) (D_5_HOS_C5_9201)","COST SERVICES NOT SUBJECT TO DEDUCTIBLES AND COINSURANCE - COST, Operating Room (D_5_HOS_C7_50)",Other Ancillary (D3_SNF_C3_76),Subprovider II (A_C1_4201),Total Hospital (S3_1_C5_7),"COST SERVICES NOT SUBJECT TO DEDUCTIBLES AND COINSURANCE - COST, MRI (D_5_HOS_C7_58)",Radioisotope (D3_SNF_C3_56),"PAID HOURS RELATED TO SALARIES, Laundry and Linen Service (S3_2_C5_31)",Delivery Room and Labor Room (D_4_HOS_C2_52),RHC (B_1_C26_88),OPT (B_2_C26_9920),Total Costs (D_3_HOS_C5_200),"ADJUSTED SALARIES, Medical Records & Med Records Library (S3_2_C4_41)",Coronary Care Unit (D_3_HOS_C9_32),SNF Provider Number (S2_1_C2_9),"PPS SERVICES COST, Electroencephalography (D_5_HOS_C5_70)","AVERAGE HOURLY WAGE, Non-Physician Anesthetist Part B (S3_2_C6_3)",Total Program General Inpatient Routine (D1_IRF_C1_41),"Sum of lines 3,4 divided by line 6 (E_B_HOS_C101_7)",Drugs Charged to Patients (D_4_HOS_C1_73),Recovery Room (D_4_HOS_C3_51),"Allocation of Interns & Residents Program Costs, Anesthesiology (B_1_C22_53)","COST REIMBURSED SERVICES NOT SUBJECT TO DEDUCTIBLES AND COINSURANCE - CHARGES, Intravenous Therapy (D_5_HOS_C4_64)","ADJUSTED SALARIES, Excluded Area Salaries (S3_3_C4_2)","COST REIMBURSED SERVICES SUBJECT TO DEDUCTIBLES  AND COINSURANCE - CHARGES, Durable Medical Equipment Sold (D_5_HOS_C3_97)","COST SERVICES NOT SUBJECT TO DEDUCTIBLES AND COINSURANCE - COST, Impl. Dev. Charged to Patients (D_5_HOS_C7_72)","COST SERVICES SUBJECT TO DEDUCTIBLES AND COINSURANCE - COST, Home Program Dialysis (D_5_HOS_C6_94)",Total Program Inpatient Costs (D1_IPF_C1_49),MCP Physician Payment Method (Y/N) (S5_C1_21),Occupational Therapy (A_C6_67),HRR adjustment amount  (E_A_HOS_C1_7094),Received DSH or supplemental payments from Medicaid? (Y/N) (S10_C1_3),ASC (Non Distinct Part) (D_4_IRF_C13_75),"COST SERVICES SUBJECT TO DEDUCTIBLES AND COINSURANCE - COST, Speech Pathology (D_5_HOS_C6_68)",Excess of reasonable cost over reasonable charges (E_B_HOS_C1_20),Medical Supplies Charged to Patients (D3_HOS_C2_71),"HHA I, With Outliers:  Total Visits (S4_HHA1_C2_33)",ASC (Non Distinct Part) (D_4_HOS_C10_75),OLTC (S3_1_C9_21),Emergency (D_4_HOS_C3_91),"AMOUNT REPORTED, Medical Records & Med Records Library (S3_2_C2_41)","Net Expense for Cost Allocation, Administrative and General (B_1_C0_5)",SNF (C_1_C5_44),Impl. Dev. Charged to Patients (D_4_IRF_C11_72),Intravenous Therapy (D_4_IPF_C13_64),ASC (Distinct Part) (B_1_C26_115),Hospice (A_C1_116),Clinic (B_1_C21_90),Less: Allowances for uncollectible notes and accounts receivable (G_C1THRU4_6),RHC (C_1_C7_88),"PPS SERVICES COST, Drugs Charged to Patients (D_5_HOS_C5_73)","Number of patients on transplant 
list (S5_C1_11)","COST REIMBURSED SERVICES NOT SUBJECT TO DEDUCTIBLES AND COINSURANCE - CHARGES, Whole Blood & Packed Red Blood Cells (D_5_HOS_C4_62)","PAID HOURS RELATED TO SALARIES, Non-Physician Part B (S3_2_C5_6)","Blood Storing, Processing, Trans (D3_SNF_C2_63)","ADJUSTED SALARIES, Interns & Residents (S3_2_C4_2552)",Inventory (G_C1THRU4_7),Research (A_C6_191),"ADJUSTED SALARIES, Maintenance of Personnel (S3_2_C4_37)","HHA I, LUPA:  Total Non Routine Med Sup Chgs (S4_HHA1_C3_38)",RHC 17 Provider Number (S2_1_C2_1516),Negative Cost Centers (B_2_C26_201),"Number of Times per week 
Patient receives Dialysis (S5_C3_2)",Intensive Care Unit (C_1_C5_31),CORF (C_1_C7_9910),Organ Procurement (D4_KIDNEY_C1_69),"COST REIMBURSED SERVICES SUBJECT TO DEDUCTIBLES  AND COINSURANCE - CHARGES, Durable Medical Equipment Rented (D_5_HOS_C3_96)",Other Ancillary (C_1_C7_76),"TOTAL CAPITAL COSTS AFTER COST ALLOCATION, ICF (B_2_C26_4501)",Average times dialyzers re-used (S5_C1_9),Radiology-Therapeutic (D_4_HOS_C13_55),"AVERAGE HOURLY WAGE, Excluded Area Salaries (S3_3_C6_2)",Other Special Purpose (A_C2_117),Radiology-Diagnostic (D3_SNF_C3_54),Occupational Therapy (B_2_C26_67),"Net Expense for Cost Allocation, Subprovider-IPF (B_1_C0_40)","TOTAL CAPITAL COSTS AFTER COST ALLOCATION, CT Scan (B_2_C26_57)","COST REIMBURSED SERVICES NOT SUBJECT TO DEDUCTIBLES AND COINSURANCE - CHARGES, Other Reimbursable (D_5_HOS_C4_98)",Cardiac Catheterization (D_4_IRF_C13_59),"Allocation of Interns & Residents Salary and Fringes, MRI (B_1_C21_58)",Total (D_4_IPF_C11_200),"Net Expense for Cost Allocation, Blood Clotting Factors for Hemoph. (B_1_C0_6250)",Anesthesiology (D_4_IPF_C11_53),"Blood Storing, Processing, Trans (D_4_HOS_C11_63)","HHA I, Without Outliers:  Non Routine Med Sup Chgs (S4_HHA1_C1_38)",Physical Therapy (D_4_IRF_C13_66),Total Salaries (A_C6_200),Sale of medical records and abstracts (A8_C2_18),"HHA II, With Outliers:  Number of Episodes (S4_HHA2_C2_37)",Laboratory (D_4_HOS_C3_60),"Interest, New Cap Related Csts Bldg & Fixtures (A7_3_C11_1)","Number of Times per week
 Patient receives Dialysis (S5_C2_2)",SNF (B_1_C26_44),"PPS SERVICES COST, Radiology-Diagnostic (D_5_HOS_C5_54)",Deductibles and coinsurance related to line 24 (E_B_HOS_C1_26),Liver Acquisition (C_1_C5_107),Pass Through Cost for  Program Ancillary (D1_IRF_C1_51),"Total Inpatient Charges, Cardiac Catheterization (C_1_C6_59)",Durable Medical Equipment Rented (D3_HOS_C3_96),Home Program Dialysis (B_2_C26_94),Other Outpatient Services (D3_IRF_C2_93),MRI (D3_SNF_C2_58),"HHA III, With Outliers:  Other Charges (S4_HHA3_C2_34)",Anesthesiology (D3_IRF_C2_53),Respiratory Therapy (D3_SNF_C2_65),General Fund Balance (G_C1THRU4_52),Burn Intensive Care Unit (A_C6_33),"Fully Depreciated Assets, Subtotal (A7_1_C7_8)",Other Ancillary (D_4_IRF_C11_76),"COST SERVICES NOT SUBJECT TO DEDUCTIBLES AND COINSURANCE - COST, Occupational Therapy (D_5_HOS_C7_67)",Adults & Pediatrics (D_3_HOS_C9_30),"COST REIMBURSED SERVICES NOT SUBJECT TO DEDUCTIBLES AND COINSURANCE - CHARGES, ASC (Non Distinct Part) (D_5_HOS_C4_75)",Renal Dialysis (D_4_HOS_C13_74),"Allocation of Interns & Residents Salary and Fringes, Coronary Care Unit (B_1_C21_32)",Recovery Room (A_C1_51),"HHA II, Total Visits (S4_HHA2_C5_33)","HHA I, Without Outliers:  Other Charges (S4_HHA1_C1_34)",Clinic (C_1_C6_90),Operating Room (D3_HOS_C3_50),Net Income from Service to Patients (G3_C1_5),Adj for Occupational therapy in excess of li (A8_C2_30),"Allocation of Interns & Residents Salary and Fringes, Delivery Room and Labor Room (B_1_C21_52)",Subprovider 2 (S3_1_C7_1801),Utilization Review SNF (A_C2_114),Whole Blood & Packed Red Blood Cells (D3_IRF_C2_62),Hospital PO Box (S2_1_C2_1),"HHA II, With Outliers:  Total Charges (S4_HHA2_C2_35)","AMOUNT REPORTED, Physician Part B (S3_2_C3_23)",MRI (D_4_HOS_C3_58),Medicaid HMO Days (S2_1_C5_24),"COST REIMBURSED SERVICES NOT SUBJECT TO DEDUCTIBLES AND COINSURANCE - CHARGES, Recovery Room (D_5_HOS_C4_51)",Medical Supplies Charged to Patients (D3_IPF_C3_71),Pancreas Acquisition (B_1_C22_109),Depreciation-New Movable Equipment (A8_C2_27),Total costs for patients covered by a state or local government program (S10_C1_15),"Net Expense for Cost Allocation, Ambulance Services (B_1_C0_95)","Total Outpatient Charges, Blood Clotting Factors for Hemoph. (C_1_C7_6250)",OSP (C_1_C5_9940),Delivery Room and Labor Room (D3_SNF_C3_52),"HHA III, With Outliers:  Non Routine Med Sup Chgs (S4_HHA3_C2_38)",Cost of patients approved for charity care and uninsured discounts (S10_C2_21),Pass through Cost for Program Inpatient (D1_IRF_C1_50),Anesthesiology (A_C1_53),Respiratory Therapy (D_4_SNF_C11_65),Total Liabilities (G_C1THRU4_51),Medicaid charges (S10_C1_6),"HHA I, Total Number of Episodes (S4_HHA1_C5_36)","Trade, Quantity, and Time Discounts (A8_C2_4)",Renal 10 Provider Number (S2_1_C2_1809),Subprovider II (C_1_C5_4201),Hospice (S3_1_C9_24),"Net Expense for Cost Allocation, Other Special Care Unit (B_1_C0_35)","Net Expense for Cost Allocation, Social Service (B_1_C0_17)","PAID HOURS RELATED TO SALARIES, SNF (S3_2_C5_9)",Electrocardiology (D_4_HOS_C11_69),Hospice (A_C2_116),"Net Expense for Cost Allocation, CMHC (B_1_C0_99)",Medical and Other Services reimbursed by OPPS (E_B_HOS_C1_2),"AMOUNT REPORTED, Home Office Salaries & Wage Related Csts (S3_2_C2_14)",Other Special Care (S3_1_C2_12),OLTC (S3_1_C10_21),TOTAL (D3_IPF_C3_200),PBP Clinical Lab Services Program Only (D3_HOS_C3_61),"AMOUNT REPORTED, Excluded Area Salaries (S3_3_C2_2)",Research (B_1_C22_191),Payment to cost ratio (E_B_HOS_C1_5),Other Organ Acquisition (B_1_C22_112),"HHA II, LUPA:  Total Non Routine Med Sup Chgs (S4_HHA2_C3_38)","PPS REIMBURSED SERVICES -  CHARGES, Total (D_5_HOS_C2_200)","ADJUSTED SALARIES, Housekeeping (S3_2_C4_32)",Radiology-Diagnostic (D_4_HOS_C13_54),Renal Dialysis (D_4_IRF_C13_74),Other Reimbursable (C_1_C7_98),Radioisotope (D_4_HOS_C11_56),"ADJUSTED SALARIES, Total (S3_3_C4_6)","ADJUSTED SALARIES, Excluded Areas (S3_2_C4_19)",IPF (S3_1_C2_16),HHA 3 Provider Number (S2_1_C2_1202),MDH status beginning date (MM/DD/YY) (S2_1_C1_38),Delivery Room and Labor Room (D_4_IPF_C11_52),IPF Provider Number (S2_1_C2_4),"COST REIMBURSED SERVICES NOT SUBJECT TO DEDUCTIBLES AND COINSURANCE - CHARGES, Other Outpatient Services (D_5_HOS_C4_93)","Allocation of Interns & Residents Salary and Fringes, Medical Supplies Charged to Patients (B_1_C21_71)",Is this a rural hospital qualifying for an exception to the certified registered nurse anesthetist the CRNA fee schedule? (Y/N) (S2_1_C1_108),Title V discharges (S3_1_C12_17),Interns & Res Salary and Fringe Benefits (A_C2_21),"AMOUNT REPORTED, Social Service (S3_2_C2_42)","HHA I, Total Other Charges (S4_HHA1_C5_34)",Lung  Acquisition (A_C1_108),RHC 13 Provider Number (S2_1_C2_1512),Observation Beds (Distinct Unit) (D3_IRF_C2_9201),Anesthesiology (D3_IRF_C3_53),"AMOUNT REPORTED, Home Office Salaries & Wage Related Csts (S3_2_C3_14)","Net Expense for Cost Allocation, Int & Res (non approved teaching program (B_1_C0_100)",Rental of quarters to employee and oths (A8_C2_15),"ADJUSTED SALARIES, Wage Related Costs Core (S3_2_C4_17)",Durable Medical Equipment Sold (D_4_HOS_C12_97),Laboratory (D3_HOS_C2_60),Payroll taxes payable (G_C1THRU4_39),Respiratory Therapy (C_1_C7_65),Total Salaries (A_C2_200),Electrocardiology (B_1_C26_69),Pharmacy (A_C6_15),Heart Acquisition (C_1_C5_106),"Net Expense for Cost Allocation, NF (B_1_C0_45)",Durable Medical Equipment Sold (B_1_C26_97),"ADJUSTED SALARIES, Physician Part A (S3_2_C4_22)","Medicare certified heart
transplant center cert date (S2_1_C1_127)",CT Scan (D_4_SNF_C11_57),Nonpaid Workers (B_1_C26_193),Operating Room (D_4_HOS_C1_50),Electroencephalography (A_C6_70),"AVERAGE HOURLY WAGE, Home Office:  Physician Part A (S3_2_C6_15)",Impl. Dev. Charged to Patients (A_C1_72),Delivery Room and Labor Room (D_4_IPF_C13_52),Home Program Dialysis (C_1_C6_94),Radiology-Diagnostic (B_1_C26_54),Recovery Room (D_4_IPF_C11_51),Labor and Delivery (S3_1_C2_32),Other Outpatient Services (D_4_HOS_C10_93),"Average patient dialysis time 
including setup (S5_C1_3)",Clinic (A_C1_90),Line 2 times line 5 (E_B_HOS_C1_6),Aggregate amount collected from patients (E_B_HOS_C1_15),Other Outpatient Services (C_1_C7_93),Laboratory (D_4_HOS_C4_60),Electroencephalography (D3_IRF_C2_70),SNF (A_C6_44),"Purchases, Buildings and Fixtures (A7_1_C2_3)",Drugs Charged to Patients (D_4_HOS_C3_73),"Taxes, New Cap Related Csts Movable Equipment (A7_3_C6_2)",Other Reimbursable (A_C1_98),"AVERAGE HOURLY WAGE, Total Salaries (S3_2_C6_1)",Primary payer payments (E_B_HOS_C1_31),"Net Expense for Cost Allocation, ICF (B_1_C0_4501)",Coronary Care Unit (A_C2_32),Hospice (A_C6_116),Other Outpatient Services (B_1_C21_93),Medicare Certified Heart TC term date (S2_1_C2_127),"ADJUSTED SALARIES, Contract Labor:  Physician Part A (S3_2_C4_13)",Home Program Dialysis (C_1_C5_94),Physical Therapy (D_4_HOS_C3_66),Physical Therapy (D_4_SNF_C11_66),"COST SERVICES SUBJECT TO DEDUCTIBLES AND COINSURANCE - COST, ASC (Non Distinct Part) (D_5_HOS_C6_75)",PBP Clinical Lab Services Program Only (D3_IRF_C2_61),"HHA III, With Outliers:  Number of Episodes (S4_HHA3_C2_37)",Total Costs (C_1_C3_202),"Net costs of Epoietin furnished to
all maintenance dialysis patients
by the provider (S5_C1_13)","Disposals and Retirements, Building Improvements (A7_1_C5_4)",Radiology-Diagnostic (D_4_HOS_C4_54),"Total Inpatient Charges, ICF (C_1_C6_4501)","Net Expense for Cost Allocation, OOT (B_1_C0_9930)",Heart Acquisition (B_1_C21_106),"COST SERVICES SUBJECT TO DEDUCTIBLES AND COINSURANCE - COST, MRI (D_5_HOS_C6_58)",Stand-alone CHIP Charges (Gross Revenue) (S10_C1_10),Other Special Care (S3_1_C5_12),Other Ancillary (B_1_C26_76),Coronary Care Unit (S3_1_C7_9),Electrocardiology (D3_HOS_C2_69),Cardiac Catheterization (D3_IPF_C2_59),ASC (Distinct Part) (C_1_C7_115),"Income from imposition of interest, finance (A8_C2_21)","HHA I, PEP Episodes:  Total Visits (S4_HHA1_C4_33)",Nursery (S3_1_C7_13),OOT (A_C6_9930),"Net Expense for Cost Allocation, Physical Therapy (B_1_C0_66)",Subprovider 2 (S3_1_C2_1801),Occupational Therapy (D3_IPF_C2_67),"AVERAGE HOURLY WAGE, Net Salaries (S3_3_C6_1)","AVERAGE HOURLY WAGE, Non-Physician Anesthetist Part A (S3_2_C6_2)","ADJUSTED SALARIES, Cafeteria (S3_2_C4_36)",Radioisotope (A_C2_56),Subprovider-IPF (D3_IPF_C2_40),FQHC 6 Provider Number (S2_1_C2_1605),Other Reimbursable (B_1_C21_98),ASC (Distinct Part) (B_2_C26_115),Total Fund Balances (G_C1THRU4_53),Outlier payments (E_B_HOS_C101_4),"AVERAGE HOURLY WAGE, Total Overhead Costs (S3_3_C6_7)",Occupational Therapy (D3_SNF_C2_67),Heart Acquisition (B_1_C22_106),Labor and Delivery Days Title 18 (S3_1_C6_32),Respiratory Therapy (D3_IRF_C3_65),Physical Therapy (D3_IRF_C2_66),"Purchases, Fixed Equipment (A7_1_C2_5)","PAID HOURS RELATED TO SALARIES, Other General Service (S3_2_C5_43)",Medicare Certified Liver TC term date (S2_1_C2_128),CMHC (C_1_C5_99),Whole Blood & Packed Red Blood Cells (D_4_IPF_C11_62),Whole Blood & Packed Red Blood Cells (D_4_HOS_C12_62),Outpatient Rehab Provider (S3_1_C8_25),ASC (Non Distinct Part) (B_1_C22_75),Renal Dialysis (A_C1_74),Emergency (B_1_C26_91),Recovery Room (C_1_C5_51),Total discharges (S3_1_C15_14),Durable Medical Equipment Sold (D_4_HOS_C3_97),Laboratory (A_C1_60),Leasehold Improvements (G_C1THRU4_17),"PPS REIMBURSED SERVICES -  CHARGES, Clinic (D_5_HOS_C2_90)","AVERAGE HOURLY WAGE, Contract Labor (S3_2_C6_11)","Net Expense for Cost Allocation, Interns & Res Salary and Fringe Benefits (B_1_C0_21)",Surgical Intensive Care Unit (C_1_C5_34),Drugs Charged to Patients (D_4_SNF_C11_73),Other Ancillary (C_1_C5_76),Burn Intensive Care Unit (D3_IPF_C2_33),Surgical Intensive Care Unit (D3_IPF_C2_34),Intensive Care Unit (D_3_HOS_C9_31),Other Organ Acquisition (A_C2_112),Title V discharges (S3_1_C12_14),Radiology-Therapeutic (A_C2_55),"Total Program Inpatient Operating Cost excluding Capital Related, Nonphysician, Anesthetist, and Medical Education Costs (D1_IPF_C1_53)",Pass through Cost for Program Inpatient (D1_IPF_C1_50),"Total Outpatient Charges, Recovery Room (C_1_C7_51)",Speech Pathology (A_C2_68),ASC (Non Distinct Part) (D3_HOS_C3_75),Hospital Adults & Pediatrics (S3_1_C3_1),ASC (Distinct Part) (C_1_C5_115),Renal Dialysis (D_4_HOS_C4_74),ICF (S3_1_C8_2001),Cardiac Catheterization (C_1_C5_59),OLTC (A_C1_46),Renal 3 Provider Number (S2_1_C2_1802),"COST SERVICES SUBJECT TO DEDUCTIBLES AND COINSURANCE - COST, Renal Dialysis (D_5_HOS_C6_74)",Impl. Dev. Charged to Patients (D_4_HOS_C3_72),CAPD exchanges per day (S5_C6_4),Is this hospital classified as a referral center? (Y/N) (S2_1_C1_116),Medicare Certified Islet TC term date (S2_1_C2_132),Speech Pathology (D3_HOS_C3_68),Other Outpatient Services (D3_HOS_C2_93),Subprovider-IPF (D_1_HOS_C7_40),"HHA I, Without Outliers:  Total Charges (S4_HHA1_C1_35)","COST SERVICES SUBJECT TO DEDUCTIBLES AND COINSURANCE - COST, CT Scan (D_5_HOS_C6_57)",Durable Medical Equipment Sold (D3_HOS_C3_97),"Disposals and Retirements, Subtotal (A7_1_C5_8)",Radiology-Therapeutic (C_1_C5_55),TOTAL (D3_IRF_C3_200),Intestinal Acquisition (B_2_C26_110),Speech Pathology (D_4_HOS_C12_68),Intravenous Therapy (D3_IPF_C2_64),"Net Expense for Cost Allocation, MRI (B_1_C0_58)",Intensive Care Unit (B_1_C26_31),"AVERAGE HOURLY WAGE, Physician-Part B (S3_2_C6_5)",Liver Acquisition (C_1_C7_107),HHA (C_1_C7_101),Home Program Dialysis (D3_IRF_C2_94),"Total Outpatient Charges, Whole Blood & Packed Red Blood Cells (C_1_C7_62)",Outpatient Revenue (G2_C2_28),Social Service (A_C1_17),"Net Expense for Cost Allocation, Pancreas Acquisition (B_1_C0_109)",Burn Intensive Care Unit Program Cost (D1_HOS_C5_45),"Total Program Inpatient Operating Cost excluding Capital Related, Nonphysician, Anesthetist, and Medical Education Costs (D1_IRF_C1_53)",CT Scan (D_4_HOS_C10_57),Target Amount per Discharge (D1_HOS_C1_55),Cash on Hand and in Banks (G_C1THRU4_1),"Disposals and Retirements, Buildings and Fixtures (A7_1_C7_3)","COST REIMBURSED SERVICES NOT SUBJECT TO DEDUCTIBLES AND COINSURANCE - CHARGES, Total (D_5_HOS_C4_200)",Medical Records and Medical Rec. Library (A_C2_16),Clinic (C_1_C7_90),Program Inpatient Ancillary Service Cost (D1_IPF_C1_48),Subprovider-IPF (B_1_C26_40),RHC (D_4_HOS_C4_88),Speech Pathology (D3_IPF_C2_68),"PAID HOURS RELATED TO SALARIES, Contract Labor (S3_2_C5_11)",Recovery Room (D3_IRF_C3_51),Paramedical Education (A_C1_23),ASC (Non Distinct Part) (A_C2_75),Drugs Charged to Patients (D3_IRF_C3_73),Intravenous Therapy (D_4_HOS_C11_64),Laboratory (D_4_HOS_C12_60),Central Services and Supply (A_C2_14),Surgical Intensive Care Unit (B_1_C26_34),"Allocation of Interns & Residents Program Costs, Coronary Care Unit (B_1_C22_32)",Total customary charges (E_B_HOS_C1_18),"PAID HOURS RELATED TO SALARIES, Management and Administrative Services (S3_2_C5_12)","Sale of scrap, waste, etc. (A8_C2_11)",Surgical Intensive Care Unit (S3_1_C3_11),Cardiac Catheterization (D_4_IRF_C11_59),"Net Expense for Cost Allocation, FQHC (B_1_C0_89)",IRF (S3_1_C8_17),Other Outpatient Services (A_C1_93),"AVERAGE HOURLY WAGE, Subtotal Wage Related Csts (S3_3_C6_5)",Subprovider-IPF (A_C2_40),Fiscal Intermediary Number (FI_NUM),Cardiac Catheterization (D3_SNF_C2_59),"AMOUNT REPORTED, Wage Related Costs Other (S3_2_C2_18)",Outpatient Rehab Provider (S3_1_C11_25),"HHA III, With Outliers:  Total Charges (S4_HHA3_C2_35)","COST SERVICES NOT SUBJECT TO DEDUCTIBLES AND COINSURANCE - COST, Respiratory Therapy (D_5_HOS_C7_65)","PPS REIMBURSED SERVICES -  CHARGES, Occupational Therapy (D_5_HOS_C2_67)",Hospital Provider Number (PRVDR_NUM),Impl. Dev. Charged to Patients (D3_SNF_C2_72),Impl. Dev. Charged to Patients (D_4_HOS_C11_72),"If an Organ Procurement Organization, enter the OPO number (S2_1_C1_134)",Cafeteria (A_C2_11),Subprovider-IRF (A_C2_41),Other Outpatient Services (D_4_HOS_C11_93),Physical Therapy (B_2_C26_66),"AMOUNT REPORTED, Maintenance and Repairs (S3_2_C2_29)",Durable Medical Equipment Rented (D_4_HOS_C10_96),Total discharges (S3_1_C15_17),Medical Supplies Charged to Patients (D_4_HOS_C2_71),IPPS Payment amount (unadjusted) (E_A_HOS_C1_59),Emergency (D_4_SNF_C11_91),Laboratory (D3_IRF_C3_60),Gross Revenue (G3_C1_1),Outlier payments (E_B_HOS_C1_4),"Net Expense for Cost Allocation, Nonphysician Anesthetists (B_1_C0_19)",Medical Supplies Charged to Patients (A_C1_71),Intravenous Therapy (A_C1_64),"Total Outpatient Charges, CT Scan (C_1_C7_57)",Hospital Name (S2_1_C1_3),Operation of Plant (A_C1_7),Electrocardiology (D_4_IRF_C13_69),Impl. Dev. Charged to Patients (D3_IPF_C3_72),Operating Room (D_4_IPF_C11_50),Radioisotope (D_4_IRF_C11_56),Other Reimbursable (D3_HOS_C2_98),"PPS SERVICES COST, Cardiac Catheterization (D_5_HOS_C5_59)",Radioisotope (D3_SNF_C2_56),"COST REIMBURSED SERVICES SUBJECT TO DEDUCTIBLES  AND COINSURANCE - CHARGES, Anesthesiology (D_5_HOS_C3_53)","Interest, New Cap Related Csts Movable Equipment (A7_3_C11_2)","Beginning Balances, Land (A7_1_C1_1)",Other Organ Acquisition (B_1_C26_112),"Lease, New Cap Related Csts Movable Equipment (A7_3_C10_2)",Pass Through Cost for  Program Ancillary (D1_HOS_C1_51),Ambulance Services (C_1_C5_95),"COST REIMBURSED SERVICES NOT SUBJECT TO DEDUCTIBLES AND COINSURANCE - CHARGES, Delivery Room and Labor Room (D_5_HOS_C4_52)","HHA II, Without Outliers:  Total Charges (S4_HHA2_C1_35)",Operating Room (D_4_IRF_C11_50),Other Outpatient Services (D_4_IRF_C11_93),Drugs Charged to Patients (D3_IRF_C2_73),"AVERAGE HOURLY WAGE, Total (S3_3_C6_6)",Employee Benefits (A_C1_4),"AVERAGE HOURLY WAGE, Pharmacy (S3_2_C6_40)",Cardiac Catheterization (D3_IRF_C3_59),Electroencephalography (C_1_C5_70),Medical Supplies Charged to Patients (D_4_IRF_C11_71),Radiology-Diagnostic (C_1_C5_54),"Allocation of Interns & Residents Salary and Fringes, Interns & Res Salary and Fringe Benefits (B_1_C21_21)",Total (C_1_C7_202),Total Facility FTEs (S3_1_C10_27),Hospice (S3_1_C7_24),"Allocation of Interns & Residents Program Costs, CT Scan (B_1_C22_57)",OOT (C_1_C5_9930),Ambulance Services (B_2_C26_95),"HHA III, PEP:  Total Non Routine Med Supply Chgs (S4_HHA3_C4_38)",Other Special Purpose (B_1_C26_117),"Allocation of Interns & Residents Program Costs, Speech Pathology (B_1_C22_68)","Net Expense for Cost Allocation, Central Services and Supply (B_1_C0_14)",Subprovider-IRF (D_1_HOS_C6_41),Adults and Pediatrics (B_1_C26_30),"AVERAGE HOURLY WAGE, Housekeeping (S3_2_C6_32)","Gift, Flower, Coffee Shop, Canteen (B_2_C26_190)",Subprovider 1 (S3_1_C7_18),Intravenous Therapy (B_2_C26_64),"Net Expense for Cost Allocation, Other Special Purpose (B_1_C0_117)",Physical Therapy (D3_IPF_C3_66),"PAID HOURS RELATED TO SALARIES, Non-Physician Anesthetist Part B (S3_2_C5_3)","AMOUNT REPORTED, SNF (S3_2_C2_9)","Net Expense for Cost Allocation, Clinic (B_1_C0_90)","COST SERVICES NOT SUBJECT TO DEDUCTIBLES AND COINSURANCE - COST, Blood Clotting Factors for Hemoph. (D_5_HOS_C7_6250)",Radiology-Diagnostic (A_C1_54),Radiology-Therapeutic (A_C1_55),Hospice (B_1_C26_116),Lung  Acquisition (B_1_C22_108),Temporary Investments (G_C1THRU4_2),"Allocation of Interns & Residents Program Costs, Surgical Intensive Care Unit (B_1_C22_34)","Allocation of Interns & Residents Salary and Fringes, Intensive Care Unit (B_1_C21_31)","COST SERVICES SUBJECT TO DEDUCTIBLES AND COINSURANCE - COST, Other Ancillary (D_5_HOS_C6_76)",RHC 25 Provider Number (S2_1_C2_1524),Parking Lot (A8_C2_9),"Net Expense for Cost Allocation, Respiratory Therapy (B_1_C0_65)","COST SERVICES NOT SUBJECT TO DEDUCTIBLES AND COINSURANCE - COST, Medical Supplies Charged to Patients (D_5_HOS_C7_71)",Observation Beds (Distinct Unit) (D3_IPF_C2_9201),CORF (A_C2_9910),"Donations, Fixed Equipment (A7_1_C3_5)","Number of patients in program at 
end of cost reporting period (S5_C2_1)",Kidney Acquisition (C_1_C7_105),RHC 10 Provider Number (S2_1_C2_1509),"Total Inpatient Charges, Recovery Room (C_1_C6_51)",Hospital State (S2_1_C2_2),"Net Expense for Cost Allocation, Other Ancillary (B_1_C0_76)",Recovery Room (D3_SNF_C2_51),FQHC (B_1_C26_89),"PPS SERVICES COST, Speech Pathology (D_5_HOS_C5_68)",Ending Date of SCH status (S2_1_C2_3601),"ADJUSTED SALARIES, Home Office Salaries & Wage Related Csts (S3_2_C4_14)",Renal 6 Provider Number (S2_1_C2_1805),Int & Res (non approved teaching program (C_1_C6_100),Delivery Room and Labor Room (D_4_IRF_C13_52),Drugs Charged to Patients (D3_SNF_C2_73),"ADJUSTED SALARIES, Subtotal Other Wages and Related Csts (S3_3_C4_4)","Blood Storing, Processing, Trans (B_2_C26_63)",Emergency (B_2_C26_91),"Donations, Building Improvements (A7_1_C3_4)",Non-physician Anesthetist (A8_C2_28),Laundry and Linen Service (A_C2_8),"Allocation of Interns & Residents Program Costs, Radioisotope (B_1_C22_56)",Radioisotope (D_4_HOS_C4_56),Radioisotope (D_4_HOS_C2_56),"PAID HOURS RELATED TO SALARIES, Interns & Residents (S3_2_C5_7)","AMOUNT REPORTED, Non-Physician Anesthetist Part A (S3_2_C2_20)",Surgical Intensive Care Unit (D3_SNF_C2_34),"Fully Depreciated Assets, Begin Balance (A7_1_C1_7)","COST SERVICES NOT SUBJECT TO DEDUCTIBLES AND COINSURANCE - COST, Durable Medical Equipment Rented (D_5_HOS_C7_96)","Blood Storing, Processing, Trans (D3_IRF_C3_63)",Emergency (D_4_HOS_C11_91),Drugs Charged to Patients (D_4_HOS_C4_73),Physical Therapy (D_4_IPF_C13_66),Radiology-Diagnostic (D3_IRF_C3_54),"HHA II, Without Outliers:  Other Charges (S4_HHA2_C1_34)","COST SERVICES SUBJECT TO DEDUCTIBLES AND COINSURANCE - COST, Occupational Therapy (D_5_HOS_C6_67)",Administrative and General (A_C2_5),"Net Expense for Cost Allocation, Islet Acquisition (B_1_C0_111)","HHA I, With Outliers:  Non Routine Med Sup Chgs (S4_HHA1_C2_38)",Whole Blood & Packed Red Blood Cells (D3_HOS_C2_62),Total Hospital (S3_1_C7_14),"AVERAGE HOURLY WAGE, Central Services and Supply (S3_2_C6_39)","ADJUSTED SALARIES, SNF (S3_2_C4_9)","Fully Depreciated Assets, Total (A7_1_C4_7)",Intravenous Therapy (D3_IRF_C3_64),Occupational Therapy (C_1_C7_67),"COST SERVICES SUBJECT TO DEDUCTIBLES AND COINSURANCE - COST, Operating Room (D_5_HOS_C6_50)",Other Capital (A_C6_3),Investment Income-New Bldgs & Fixtures (A8_C2_1),Subprovider-IPF (C_1_C5_40),"COST SERVICES NOT SUBJECT TO DEDUCTIBLES AND COINSURANCE - COST, Observation Beds (Distinct Unit) (D_5_HOS_C7_9201)",CAH Visits (S3_1_C8_15),Nursery (D_1_HOS_C4_43),"Allocation of Interns & Residents Program Costs, Other Special Care Unit (B_1_C22_35)",Home Office Street (S2_1_C1_142),"HHA II, Total Non Routine Medical  Supply Charges (S4_HHA2_C5_38)",HHA (A_C2_101),Other Reimbursable (D_4_HOS_C3_98),Land (G_C1THRU4_12),"Allocation of Interns & Residents Program Costs, Subprovider I (B_1_C22_42)",Drugs Charged to Patients (B_2_C26_73),"Net Expense for Cost Allocation, Blood Storing, Processing, Trans (B_1_C0_63)",MRI (D_4_SNF_C11_58),Intravenous Therapy (D3_HOS_C2_64),"COST REIMBURSED SERVICES NOT SUBJECT TO DEDUCTIBLES AND COINSURANCE - CHARGES, Radioisotope (D_5_HOS_C4_56)",Blood Clotting Factors for Hemoph. (D_4_HOS_C12_6250),"ADJUSTED SALARIES, Teaching Physician Salaries (S3_2_C4_1601)","PPS REIMBURSED SERVICES -  CHARGES, Renal Dialysis (D_5_HOS_C2_74)",Electrocardiology (D_4_IPF_C13_69),Utilization (S5_C2_8),FQHC 4 Provider Number (S2_1_C2_1603),OLTC (A_C2_46),"Allocation of Interns & Residents Salary and Fringes, Impl. Dev. Charged to Patients (B_1_C21_72)",SNF (S3_1_C11_19),"Allocation of Interns & Residents Program Costs, SNF (B_1_C22_44)",Int & Res (non approved teaching program (C_1_C7_100),Nonphysician Anesthetists (A_C1_19),"Allocation of Interns & Residents Program Costs, Operating Room (B_1_C22_50)",Intravenous Therapy (D_4_HOS_C4_64),Intensive Care Unit (S3_1_C5_8),"COST SERVICES SUBJECT TO DEDUCTIBLES AND COINSURANCE - COST, Blood Clotting Factors for Hemoph. (D_5_HOS_C6_6250)",Radiology-Therapeutic (D_4_IPF_C13_55),Burn Intensive Care Unit (D3_IRF_C2_33),Radiology-Therapeutic (D3_HOS_C2_55),Recovery Room (D_4_HOS_C12_51),Medicaid Observation Days (S3_1_C8_28),"AMOUNT REPORTED, Interns & Residents (S3_2_C2_2553)","Net Expense for Cost Allocation, Anesthesiology (B_1_C0_53)","Allocation of Interns & Residents Program Costs, Delivery Room and Labor Room (B_1_C22_52)","Total Outpatient Charges, PBP Clinical Lab Services Program Only (C_1_C7_61)","Total Outpatient Charges, Radiology-Therapeutic (C_1_C7_55)",Renal 1 Provider Number (S2_1_C2_18),Renal Dialysis (D3_IRF_C3_74),"Blood Storing, Processing, Trans (D_4_IRF_C11_63)",Depreciation-New Bldgs & Fixtures (A8_C2_26),"Total Outpatient Charges, Radiology-Diagnostic (C_1_C7_54)","ADJUSTED SALARIES, Home Office:  Physician Part A (S3_2_C4_15)","Blood Storing, Processing, Trans (D_4_HOS_C10_63)","PAID HOURS RELATED TO SALARIES, Contract Labor:  Physician Part A (S3_2_C5_13)",Blood Clotting Factors for Hemoph. (A_C6_6250),ASC (Non Distinct Part) (D_4_HOS_C12_75),Anesthesiology (D_4_IRF_C13_53),Beginning Date of SCH status (S2_1_C1_36),Home Program Dialysis (D3_IPF_C3_94),Physical Therapy (D_4_HOS_C13_66),Whole Blood & Packed Red Blood Cells (A_C6_62),"HHA I, Total Charges (S4_HHA1_C5_35)",FQHC (A_C1_89),Whole Blood & Packed Red Blood Cells (D3_HOS_C3_62),"COST REIMBURSED SERVICES NOT SUBJECT TO DEDUCTIBLES AND COINSURANCE - CHARGES, Radiology-Therapeutic (D_5_HOS_C4_55)","Epoietin amount form worksheet A
for home dialysis program (S5_C1_14)","HHA III, LUPA Episodes:  Total Number of Episodes (S4_HHA3_C3_36)",Subprovider-IPF (D_1_HOS_C6_40),Program Inpatient Ancillary Service Cost (D1_IRF_C1_48),"AMOUNT REPORTED, Physician-Part A (S3_2_C2_4)",Physical Therapy (B_1_C26_66),Total discharges (S3_1_C15_18),"AMOUNT REPORTED, Administrative and General (S3_2_C2_27)",Hospice (C_1_C6_116),Other Outpatient Services (D_4_IRF_C13_93),"ADJUSTED SALARIES, Excluded Area Salaries (S3_2_C4_10)","Blood Storing, Processing, Trans (D_4_IPF_C13_63)",Nursing School (A8_C2_19),"If this facility qualifies as a RPCH/CAH, has it elected the all inclusive payment for outpatient service? (Y/N) (S2_1_C1_106)","AMOUNT REPORTED, Administrative & General under contract (S3_2_C2_28)","Allocation of Interns & Residents Salary and Fringes, Speech Pathology (B_1_C21_68)",Total (C_1_C5_202),Clinic (D_4_IRF_C13_90),Clinic (D_4_HOS_C10_90),Home Program Dialysis (D_4_HOS_C2_94),Radiology-Therapeutic (D3_IRF_C2_55),Medical Supplies Charged to Patients (C_1_C7_71),"PAID HOURS RELATED TO SALARIES, Home Office Personnel (S3_2_C5_8)",Observation Beds (Distinct Unit) (D_4_HOS_C2_9201),HHA (S3_1_C10_22),IPF Provider Number (S2_1_C1_4),"AVERAGE HOURLY WAGE, Related Salaries (S3_2_C6_1402)",Home Program Dialysis (D3_IRF_C3_94),Delivery Room and Labor Room (D_4_HOS_C11_52),Does the hospital elect a fully prospective payment method for capital costs? (Y/N) (S2_1_C1_48),Radiology-Diagnostic (D3_SNF_C2_54),Other Ancillary (A_C6_76),"Blood Storing, Processing, Trans (A_C1_63)",IRF Provider Number (S2_1_C2_5),"AMOUNT REPORTED, Interns & Residents (S3_2_C2_25)",Occupational Therapy (C_1_C6_67),"PPS SERVICES COST, Delivery Room and Labor Room (D_5_HOS_C5_52)",Renal Dialysis (D3_HOS_C2_74),Occupational Therapy (D_4_HOS_C3_67),Drugs Charged to Patients (D3_IPF_C2_73),Drugs Charged to Patients (B_1_C22_73),Hospice (S3_1_C10_24),Medical Supplies Charged to Patients (D3_IRF_C2_71),"HHA II, PEP Episodes:  Total Number of Episodes (S4_HHA2_C4_36)","HHA III, PEP Episodes:  Total Charges: (S4_HHA3_C4_35)",Clinic (D_4_HOS_C2_90),"COST REIMBURSED SERVICES NOT SUBJECT TO DEDUCTIBLES AND COINSURANCE - CHARGES, Observation Beds (Distinct Unit) (D_5_HOS_C4_9201)","AMOUNT REPORTED, Non-Physician Anesthetist Part A (S3_2_C2_2)","HHA I, LUPA Episodes:  Other Charges (S4_HHA1_C3_34)",Subtotal (E_B_HOS_C1_30),"Allocation of Interns & Residents Salary and Fringes, Laboratory (B_1_C21_60)",Impl. Dev. Charged to Patients (D3_IRF_C3_72),Other Nonreimbursable (A_C6_194),CT Scan (D3_SNF_C3_57),Subprovider-IPF (D_3_HOS_C9_40),"PPS REIMBURSED SERVICES -  CHARGES, Blood Clotting Factors for Hemoph. (D_5_HOS_C2_6250)",CAPD exchanges per day (S5_C4_4),Anesthesiology (D3_SNF_C3_53),Medical Supplies Charged to Patients (D_4_HOS_C10_71),MRI (D_4_HOS_C2_58),HHA (C_1_C6_101),"Net Expense for Cost Allocation, Subprovider-IRF (B_1_C0_41)",Whole Blood & Packed Red Blood Cells (D_4_HOS_C3_62),"Difference between Adjusted Inpatient, Operating Cost and Target Amount (D1_HOS_C1_57)",Housekeeping (A_C1_9),Renal Dialysis (D_4_HOS_C12_74),Total Hospital (S3_1_C5_14),Other General Service (A_C2_18),Social Service (A_C2_17),CT Scan (D_4_HOS_C4_57),Radiology-Diagnostic (D3_IRF_C2_54),Emergency (D_4_IRF_C13_91),Drugs Charged to Patients (D_4_HOS_C12_73),IRF (S3_1_C6_17),"AVERAGE HOURLY WAGE, Laundry and Linen Service (S3_2_C6_31)",Payments received from patients for amounts previously written off as charity care (S10_C3_22),Hospice (S3_1_C3_24),Subprovider 2 (S3_1_C8_1801),"Number of Times per week
 Patient receives Dialysis (S5_C6_2)",Intravenous Therapy (D3_IRF_C2_64),Delivery Room and Labor Room (D3_HOS_C3_52),"Purchases, Movable Equipment (A7_1_C2_6)",Radiology-Diagnostic (D_4_IRF_C13_54),Lung  Acquisition (B_1_C21_108),Physical Therapy (D_4_HOS_C4_66),ASC 1 Provider Number (S2_1_C2_13),"COST SERVICES NOT SUBJECT TO DEDUCTIBLES AND COINSURANCE - COST, Radiology-Diagnostic (D_5_HOS_C7_54)",Whole Blood & Packed Red Blood Cells (D_4_HOS_C13_62),Kidney Acquisition (B_1_C21_105),SNF (A_C1_44),Operating Room (A_C6_50),"AVERAGE HOURLY WAGE, Admin & Gen Under Contract (S3_2_C6_29)",Renal Dialysis (D3_IRF_C2_74),Adults and Pediatrics (A_C6_30),"Medical certified lung
transplant center cert date (S2_1_C1_129)","AMOUNT REPORTED, Non-Physician Anesthetist Part B (S3_2_C2_3)",RHC (B_2_C26_88),"AVERAGE HOURLY WAGE, Dietary (S3_2_C6_34)",CMHC 1 Provider Number (S2_1_C2_17),HHA (C_1_C5_101),"COST REIMBURSED SERVICES SUBJECT TO DEDUCTIBLES  AND COINSURANCE - CHARGES, Medical Supplies Charged to Patients (D_5_HOS_C3_71)",RHC 12 Provider Number (S2_1_C2_1511),"Allocation of Interns & Residents Salary and Fringes, Radiology-Diagnostic (B_1_C21_54)","PAID HOURS RELATED TO SALARIES, Teaching Physician Salaries (S3_2_C5_16)",Number of stations (S5_C2_6),NF (A_C1_45),Total Fixed Assets (G_C1THRU4_30),Whole Blood & Packed Red Blood Cells (D3_IPF_C2_62),"Net Expense for Cost Allocation, Research (B_1_C0_191)",RHC/FQHC Combined (S3_1_C11_26),Other Outpatient Services (D_4_HOS_C12_93),Nursery (S3_1_C8_13),Hospital Adlts & Ped Swing Bed NF (S3_1_C7_6),Title V discharges (S3_1_C12_16),Hospital Adults & Ped Swing Bed SNF (S3_1_C6_5),CORF (C_1_C5_9910),Total (D_4_SNF_C13_200),Fiscal Intermediary/MAC Create Date (FI_CREAT_DT),Physical Therapy (D_4_IPF_C11_66),"PPS REIMBURSED SERVICES -  CHARGES, Radioisotope (D_5_HOS_C2_56)","PPS REIMBURSED SERVICES -  CHARGES, MRI (D_5_HOS_C2_58)",Electrocardiology (D_4_HOS_C2_69),Intravenous Therapy (D_4_HOS_C13_64),Radiology-Therapeutic (D_4_IPF_C11_55),TOTAL (D3_SNF_C3_200),Health Information Technology Designated Assets (G_C1THRU4_27),Total cost (E_B_HOS_C1_11),Intensive Care Unit (D_1_HOS_C4_31),Occupational Therapy (D_4_HOS_C12_67),"PAID HOURS RELATED TO SALARIES, Total Overhead Costs (S3_3_C5_7)",Home Program Dialysis (B_1_C22_94),TOTAL (D3_HOS_C3_200),"PPS SERVICES COST, Other Ancillary (D_5_HOS_C5_76)","COST SERVICES SUBJECT TO DEDUCTIBLES AND COINSURANCE - COST, Laboratory (D_5_HOS_C6_60)",Total Hospital (S3_1_C4_7),Electrocardiology (D_4_IPF_C11_69),"TOTAL CAPITAL COSTS AFTER COST ALLOCATION, Recovery Room (B_2_C26_51)",Physical Therapy (C_1_C7_66),"PPS SERVICES COST, Clinic (D_5_HOS_C5_90)",Total Adults & Peds (S3_1_C7_7),"COST SERVICES SUBJECT TO DEDUCTIBLES AND COINSURANCE - COST, Clinic (D_5_HOS_C6_90)","If this Hospital is claiming cost for renal services on Worksheet A, are they inpatient services only? (Y/N) (S2_1_C1_145)","AVERAGE HOURLY WAGE, Employee Benefits (S3_2_C6_26)",Inpatient Revenue (G2_C1_28),"Net Expense for Cost Allocation, Hospice (B_1_C0_116)",Zip Code (S2_1_C3_143),FQHC (B_2_C26_89),"PPS REIMBURSED SERVICES -  CHARGES, Other Ancillary (D_5_HOS_C2_76)",Hospice 3 Provider Number (S2_1_C2_1402),Durable Medical Equipment Sold (D3_HOS_C2_97),ASC (Non Distinct Part) (D3_IRF_C3_75),"COST SERVICES NOT SUBJECT TO DEDUCTIBLES AND COINSURANCE - COST, ASC (Non Distinct Part) (D_5_HOS_C7_75)",NF (S3_1_C5_20),"ADJUSTED SALARIES, Laundry and Linen Service (S3_2_C4_31)",Adults and Pediatrics (D3_SNF_C2_30),OSP (A_C1_9940),Charity care charges and uninsured discounts for the entire facility (S10_C2_20),Investment Income-Other (A8_C2_3),Kidney Acquisition (B_1_C22_105),Other Reimbursable (C_1_C5_98),"COST SERVICES NOT SUBJECT TO DEDUCTIBLES AND COINSURANCE - COST, CT Scan (D_5_HOS_C7_57)",Sale of drugs to other than patients (A8_C2_17),"Allocation of Interns & Residents Salary and Fringes, Physical Therapy (B_1_C21_66)",Drugs Charged to Patients (A_C2_73),"HHA III, Without Outliers:  Total Charges (S4_HHA3_C1_35)",Total Long-term Liabilities (G_C1THRU4_50),Physical Therapy (C_1_C5_66),Operating Room (D3_IRF_C2_50),Int & Res (non approved teaching program (A_C6_100),Electroencephalography (B_2_C26_70),MRI (D3_IRF_C3_58),CT Scan (D_4_IRF_C13_57),"Fully Depreciated Assets, Assets (A7_1_C7_7)",Observation Beds (Distinct Unit) (D_4_HOS_C3_9201),SNF (S3_1_C7_19),"TOTAL CAPITAL COSTS AFTER COST ALLOCATION, Nursery (B_2_C26_43)","COST SERVICES NOT SUBJECT TO DEDUCTIBLES AND COINSURANCE - COST, Emergency (D_5_HOS_C7_91)","HHA II, Total Number of Outlier Episodes (S4_HHA2_C5_37)",Total Subprovider I Interns & Residents (S3_1_C10_18),Cardiac Catheterization (D3_IRF_C2_59),"PPS REIMBURSED SERVICES -  CHARGES, ASC (Non Distinct Part) (D_5_HOS_C2_75)","Allocation of Interns & Residents Salary and Fringes, Whole Blood & Packed Red Blood Cells (B_1_C21_62)","Total Inpatient Charges, SNF (C_1_C6_44)",Radiology-Diagnostic (D_4_HOS_C2_54),"HHA I, PEP Episodes:  Other Charges (S4_HHA1_C4_34)",Organ Procurement (D4_LUNG_C1_69),"TOTAL CAPITAL COSTS AFTER COST ALLOCATION, Intensive Care Unit (B_2_C26_31)","AMOUNT REPORTED, Interns & Residents (S3_2_C3_2551)",ASC (Non Distinct Part) (D3_SNF_C3_75),Ending Date of SCH status (S2_1_C2_36),Impl. Dev. Charged to Patients (D_4_HOS_C10_72),ICF (C_1_C5_4501),"Net Expense for Cost Allocation, Medical Supplies Charged to Patients (B_1_C0_71)",Electrocardiology (D_4_HOS_C4_69),"ADJUSTED SALARIES, Pharmacy (S3_2_C4_40)","Net Expense for Cost Allocation, Renal Dialysis (B_1_C0_74)",Cardiac Catheterization (D3_HOS_C2_59),Hospice (C_1_C5_116),Renal Dialysis (D_4_IRF_C11_74),Surgical Intensive Care Unit (D_1_HOS_C6_34),Physical Therapy (A_C1_66),Subprovider-IRF (D_1_HOS_C4_41),Medical Supplies Charged to Patients (D_4_HOS_C12_71),Initial Physician Payment Method (Y/N) (S5_C2_21),"COST SERVICES SUBJECT TO DEDUCTIBLES AND COINSURANCE - COST, Emergency (D_5_HOS_C6_91)",TOTAL (D3_IPF_C2_200),Renal Dialysis (B_2_C26_74),Nonpaid Workers (A_C1_193),RHC 5 Provider Number (S2_1_C2_1504),Observation Beds (Distinct Unit) (D_4_IPF_C13_9201),Durable Medical Equipment Sold (D_4_HOS_C2_97),"COST REIMBURSED SERVICES SUBJECT TO DEDUCTIBLES  AND COINSURANCE - CHARGES, Home Program Dialysis (D_5_HOS_C3_94)",ICF (S3_1_C7_2001),"TOTAL CAPITAL COSTS AFTER COST ALLOCATION, Subprovider-IRF (B_2_C26_41)","Allocation of Interns & Residents Salary and Fringes, Subprovider-IRF (B_1_C21_41)",Subprovider-IRF (D3_IRF_C2_41),Cardiac Catheterization (D_4_HOS_C2_59),IPF (S3_1_C6_16),"PAID HOURS RELATED TO SALARIES, Employee Benefits (S3_2_C5_26)",Deductibles and coinsurance (E_B_HOS_C1_25),"PAID HOURS RELATED TO SALARIES, Net Salaries (S3_3_C5_1)","HHA I, With Outliers:  Total Charges (S4_HHA1_C2_35)",Intensive Care Unit (A_C6_31),CT Scan (D_4_IPF_C13_57),Laboratory (D3_IPF_C3_60),Int & Res (non approved teaching program (B_1_C26_100),Total (C_1_C6_202),CT Scan (D3_IPF_C2_57),Surgical Intensive Care Unit (S3_1_C4_11),"Total Outpatient Charges, Anesthesiology (C_1_C7_53)",Electroencephalography (D3_IRF_C3_70),Other Ancillary (B_1_C22_76),Subprovider-IPF (D3_HOS_C2_40),Respiratory Therapy (D_4_IRF_C13_65),Subprovider-IRF (D3_IPF_C2_41),Maintenance of Personnel (A_C1_12),"COST SERVICES NOT SUBJECT TO DEDUCTIBLES AND COINSURANCE - COST, Total (D_5_HOS_C7_200)",Delivery Room and Labor Room (A_C2_52),"COST SERVICES SUBJECT TO DEDUCTIBLES AND COINSURANCE - COST, Radiology-Diagnostic (D_5_HOS_C6_54)",OSP (A_C2_9940),PBP Clinical Lab Services Program Only (A_C6_61),"Total Inpatient Charges, Burn Intensive Care Unit (C_1_C6_33)","Depreciation, New Cap Related Csts Movable Equipment (A7_3_C9_2)","HHA II, LUPA Episodes:  Total Visits (S4_HHA2_C3_33)",Maintenance and Repairs (A_C6_6),"Total Outpatient Charges, Laboratory (C_1_C7_60)","Allocation of Interns & Residents Salary and Fringes, OLTC (B_1_C21_46)","COST REIMBURSED SERVICES NOT SUBJECT TO DEDUCTIBLES AND COINSURANCE - CHARGES, Drugs Charged to Patients (D_5_HOS_C4_73)","Total Inpatient Charges, Laboratory (C_1_C6_60)",OPT (A_C1_9920),"HHA I, Total Charges:  LUPA Episodes (S4_HHA1_C3_35)",Delivery Room and Labor Room (D3_IRF_C3_52),Occupational Therapy (D3_IRF_C3_67),Whole Blood & Packed Red Blood Cells (A_C1_62),Delivery Room and Labor Room (A_C6_52),Hospital Type (S2_1_C4_3),Other Ancillary (D_4_HOS_C4_76),Other Reimbursable (B_1_C26_98),Electrocardiology (D_4_HOS_C13_69),"Blood Storing, Processing, Trans (C_1_C6_63)",Durable Medical Equipment Rented (B_1_C26_96),"COST REIMBURSED SERVICES SUBJECT TO DEDUCTIBLES  AND COINSURANCE - CHARGES, Other Outpatient Services (D_5_HOS_C3_93)",FQHC 3 Provider Number (S2_1_C2_1602),Medical Supplies Charged to Patients (C_1_C6_71),"Total Inpatient Charges, Whole Blood & Packed Red Blood Cells (C_1_C6_62)",ASC (Non Distinct Part) (D3_HOS_C2_75),Intravenous Therapy (B_1_C26_64),Subprovider II (D_1_HOS_C4_4201),Renal 9 Provider Number (S2_1_C2_1808),"COST SERVICES SUBJECT TO DEDUCTIBLES AND COINSURANCE - COST, Observation Beds (Distinct Unit) (D_5_HOS_C6_9201)","PPS SERVICES COST, Blood Clotting Factors for Hemoph. (D_5_HOS_C5_6250)",Intravenous Therapy (D3_IPF_C3_64),Drugs Charged to Patients (D3_IPF_C3_73),CT Scan (C_1_C5_57),Total Hospital Interns & Residents (S3_1_C10_14),"Net Expense for Cost Allocation, CT Scan (B_1_C0_57)",Liver Acquisition (B_1_C21_107),"HHA III, Total Non Routine Medical  Supply Charges (S4_HHA3_C5_38)","ADJUSTED SALARIES, Total Overhead Costs (S3_3_C4_7)","Fully Depreciated Assets, Ending Balance (A7_1_C6_7)",Title XIX discharges (S3_1_C14_16),Whole Blood & Packed Red Blood Cells (D3_IPF_C3_62),"Total Inpatient Charges, Coronary Care Unit (C_1_C6_32)",Cross Foot Adjustments (B_2_C26_200),"ADJUSTED SALARIES, Physician Part A Teaching (S3_2_C4_2201)",Maintenance and Repairs (A_C2_6),Anesthesiology (B_1_C26_53),"COST SERVICES NOT SUBJECT TO DEDUCTIBLES AND COINSURANCE - COST, Whole Blood & Packed Red Blood Cells (D_5_HOS_C7_62)","COST SERVICES SUBJECT TO DEDUCTIBLES AND COINSURANCE - COST, Durable Medical Equipment Sold (D_5_HOS_C6_97)","Total Inpatient Charges, CT Scan (C_1_C6_57)","Total Inpatient Charges, Nursery (C_1_C6_43)",Physical Therapy (C_1_C6_66),Laboratory (C_1_C5_60),Delivery Room and Labor Room (D3_IPF_C2_52),ASC (Non Distinct Part) (D_4_HOS_C4_75),Renal Dialysis (D_4_SNF_C11_74),Total Outpatient Program Pass Thru Cost (D_4_IRF_C6_200),Cardiac Catheterization (D_4_IPF_C11_59),Renal Dialysis (D_4_HOS_C11_74),Radioisotope (C_1_C5_56),"Are there any related organization or how office costs as defined in HCFA Pub. 15-I, chapter 10? (Y/N) (S2_1_C1_140)",Anesthesiology (D_4_HOS_C1_53),Durable Medical Equipment Rented (C_1_C7_96),Kidney Acquisition (A_C1_105),"COST REIMBURSED SERVICES SUBJECT TO DEDUCTIBLES  AND COINSURANCE - CHARGES, Renal Dialysis (D_5_HOS_C3_74)",Home Program Dialysis (B_1_C21_94),Swing Bed NF Provider Number (S2_1_C2_8),Total Outpatient Program Pass Thru Cost (D_4_HOS_C6_200),Electrocardiology (D3_SNF_C3_69),RHC 2 Provider Number (S2_1_C2_1501),Lung  Acquisition (A_C6_108),Drugs Charged to Patients (D_4_IPF_C13_73),"TOTAL CAPITAL COSTS AFTER COST ALLOCATION, Radiology-Therapeutic (B_2_C26_55)",Deferred Income (G_C1THRU4_41),Occupational Therapy (C_1_C5_67),Operating Room (D_4_HOS_C2_50),Other Special Purpose (B_1_C22_117),CT Scan (D3_SNF_C2_57),Clinic (A_C6_90),Total Hospital (S3_1_C8_14),RHC 16 Provider Number (S2_1_C2_1515),Intravenous Therapy (C_1_C7_64),Intensive Care Unit (S3_1_C6_8),Other Outpatient Services (D3_IPF_C2_93),Physical Therapy (D3_IRF_C3_66),"ADJUSTED SALARIES, Central Services and Supply (S3_2_C4_39)",CT Scan (D_4_HOS_C3_57),Respiratory Therapy (D3_IPF_C3_65),Intravenous Therapy (C_1_C6_64),Other Special Care Unit (D_1_HOS_C6_35),"COST SERVICES SUBJECT TO DEDUCTIBLES AND COINSURANCE - COST, Other Reimbursable (D_5_HOS_C6_98)",Respiratory Therapy (D3_IPF_C2_65),CT Scan (D_4_HOS_C13_57),"COST SERVICES SUBJECT TO DEDUCTIBLES AND COINSURANCE - COST, Cardiac Catheterization (D_5_HOS_C6_59)",Organ Procurement (D4_ISLET_C1_69),Home Program Dialysis (B_1_C26_94),Total Operating Expense (G3_C1_4),Observation Beds (Distinct Unit) (C_1_C5_9201),Title V discharges (S3_1_C12_1),Hospice 2 Provider Number (S2_1_C2_1401),Occupational Therapy (D3_HOS_C3_67),"COST REIMBURSED SERVICES NOT SUBJECT TO DEDUCTIBLES AND COINSURANCE - CHARGES, Occupational Therapy (D_5_HOS_C4_67)",Adults & Pediatrics (D_1_HOS_C7_30),"COST REIMBURSED SERVICES NOT SUBJECT TO DEDUCTIBLES AND COINSURANCE - CHARGES, Home Program Dialysis (D_5_HOS_C4_94)",Speech Pathology (D3_HOS_C2_68),Delivery Room and Labor Room (D_4_HOS_C10_52),Durable Medical Equipment Sold (C_1_C5_97),Interns & Res Salary and Fringe Benefits (A_C6_21),"AMOUNT REPORTED, Net Salaries (S3_3_C2_1)","ADJUSTED SALARIES, Subtotal Wage Related Csts (S3_3_C4_5)",Subprovider-IRF (D_3_HOS_C9_41),Laboratory (D_4_IRF_C11_60),"HHA III, PEP Episodes:  Other Charges (S4_HHA3_C4_34)","AVERAGE HOURLY WAGE, Dietary under Contract (S3_2_C6_35)",Electroencephalography (D_4_IRF_C11_70),RHC 6 Provider Number (S2_1_C2_1505),"COST SERVICES SUBJECT TO DEDUCTIBLES AND COINSURANCE - COST, Medical Supplies Charged to Patients (D_5_HOS_C6_71)","Total Inpatient Charges, Other Special Care Unit (C_1_C6_35)",Other Ancillary (D3_HOS_C2_76),RPCH/CAH Visits (S3_1_C6_15),Total Hospital (S3_1_C2_14),Operation of Plant (A_C6_7),Electroencephalography (A_C1_70),Hospital Adults & Pediatrics (S3_1_C5_1),Hospice (S3_1_C8_24),Cost of Uncompensated Care (S10_C1_30),Laboratory (D3_IRF_C2_60),"ADJUSTED SALARIES, Non-Physician Part B (S3_2_C4_6)",MRI (D3_HOS_C3_58),Coronary Care Unit (D3_IPF_C2_32),Other Outpatient Services (B_1_C22_93),OOT (A_C2_9930),Durable Medical Equipment Rented (A_C2_96),"HHA II, LUPA Episodes:  Total Number of Episodes (S4_HHA2_C3_36)",PBP Clinical Lab Services Program Only (C_1_C5_61),Unsecured Loans (G_C1THRU4_48),Other Ancillary (C_1_C6_76),Islet Acquisition (C_1_C7_111),CT Scan (D3_HOS_C3_57),Total Program Inpatient Costs (D1_HOS_C1_49),Total (D_3_HOS_C9_200),Respiratory Therapy (B_2_C26_65),Clinic (D_4_SNF_C11_90),Subtotal (C_1_C5_200),Surgical Intensive Care Unit (D_1_HOS_C7_34),Clinic (D_4_IPF_C13_90),"PPS REIMBURSED SERVICES -  CHARGES, Drugs Charged to Patients (D_5_HOS_C2_73)",SNF (S3_1_C5_19),"COST SERVICES NOT SUBJECT TO DEDUCTIBLES AND COINSURANCE - COST, Radiology-Therapeutic (D_5_HOS_C7_55)",CT Scan (D_4_HOS_C2_57),Television and Radio Service (A8_C2_8),FQHC (C_1_C7_89),"ADJUSTED SALARIES, Interns & Residents (S3_2_C4_7)",Subprovider-IRF (D3_SNF_C2_41),Ancillary service charges (E_B_HOS_C1_12),Impl. Dev. Charged to Patients (C_1_C5_72),"Net Expense for Cost Allocation, Maintenance of Personnel (B_1_C0_12)",Total (D_4_HOS_C1_200),"AVERAGE HOURLY WAGE, Physician-Part A (S3_2_C6_4)",Other Reimbursable (A_C6_98),Respiratory Therapy (C_1_C6_65),Burn Intensive Care Unit (A_C1_33),Islet Acquisition (B_2_C26_111),Total Program Inpatient Costs (D1_IRF_C1_49),Other Nonreimbursable (B_1_C22_194),Speech Pathology (D3_IRF_C2_68),Interns and residents (E_B_HOS_C1_22),Radiology-Therapeutic (D3_IRF_C3_55),Organ acquisition (E_B_HOS_C1_10),"Allocation of Interns & Residents Salary and Fringes, Recovery Room (B_1_C21_51)",Emergency (A_C2_91),RHC (B_1_C22_88),Laboratory (D_4_HOS_C2_60),MRI (D_4_IRF_C11_58),MSP-LCC reconciliation amount (E_B_HOS_C1_38),"ADJUSTED SALARIES, Wage Related Costs RHC/FQHC (S3_2_C4_24)",Blood Clotting Factors for Hemoph. (D3_HOS_C2_6250),"Allocation of Interns & Residents Salary and Fringes, Anesthesiology (B_1_C21_53)",Speech Pathology (A_C1_68),Anesthesiology (D_4_HOS_C13_53),"Purchases, Total (A7_1_C2_10)","Total Outpatient Charges, Operating Room (C_1_C7_50)",Provider-based physician adjustment (A8_C2_10),"PPS SERVICES COST, Radiology-Therapeutic (D_5_HOS_C5_55)",Physical Therapy (D3_SNF_C3_66),"Percentage of patients re-using
dialyzers (S5_C2_10)","Net Expense for Cost Allocation, Heart Acquisition (B_1_C0_106)",Subprovider-IRF (B_1_C26_41),RHC (B_1_C21_88),Physicians' Private Office (A_C1_192),Coronary Care Unit Program Cost (D1_HOS_C5_44),Other Outpatient Services (D3_SNF_C2_93),Cost of charity care (uninsured patients + patients w/ coverage not accepted by provider) (S10_C1_23),Other Ancillary (B_2_C26_76),Emergency (C_1_C6_91),"COST REIMBURSED SERVICES NOT SUBJECT TO DEDUCTIBLES AND COINSURANCE - CHARGES, Operating Room (D_5_HOS_C4_50)",Minor Equipment Depreciable (G_C1THRU4_25),Subprovider-IRF (A_C1_41),"AMOUNT REPORTED, Interns & Residents (S3_2_C3_25)","PPS REIMBURSED SERVICES -  CHARGES, CT Scan (D_5_HOS_C2_57)","AVERAGE HOURLY WAGE, Nursing Administration (S3_2_C6_38)",Observation Beds (Distinct Unit) (D3_HOS_C3_9201),Medical Supplies Charged to Patients (D_4_IPF_C11_71),"Fully Depreciated Assets, Disp. And Retirement (A7_1_C5_7)","Total Outpatient Charges, Delivery Room and Labor Room (C_1_C7_52)","ADJUSTED SALARIES, Other General Service (S3_2_C4_43)",Other Ancillary (D_4_IRF_C13_76),Total discharges (S3_1_C15_21),"Net Expense for Cost Allocation, New Capital Equipment (B_1_C0_2)","ADJUSTED SALARIES, Admin & Gen Under Contract (S3_2_C4_29)",Renal Dialysis (D3_SNF_C3_74),Related Organization Transactions (A8_C2_12),Other Ancillary (D_4_HOS_C11_76),Net Revenue from stand-alone SCHIP (S10_C1_9),Other Ancillary (D_4_IPF_C11_76),Hospice 1 Provider Number (S2_1_C2_14),"Net Expense for Cost Allocation, Subprovider II (B_1_C0_4201)","PAID HOURS RELATED TO SALARIES, Housekeeping under Contract (S3_2_C5_33)",ASC (Non Distinct Part) (D_4_HOS_C3_75),CORF (B_1_C26_9910),Nursing School (A_C2_20),"General Inpatient Routine Service Cost, net of Swing Bed and Private Room Diff (D1_IRF_C1_37)",Total (D_4_SNF_C11_200),"AVERAGE HOURLY WAGE, Medical Records & Med Records Library (S3_2_C6_41)","PPS SERVICES COST, Emergency (D_5_HOS_C5_91)","PPS REIMBURSED SERVICES -  CHARGES, Recovery Room (D_5_HOS_C2_51)","HHA III, PEP Episodes:  Total Number of Episodes (S4_HHA3_C4_36)",Respiratory Therapy (B_1_C26_65),"Blood Storing, Processing, Trans (D_4_SNF_C11_63)",Other Outpatient Services (D3_HOS_C3_93),Hospital Zip Code (S2_1_C3_2),Speech Pathology (D_4_IPF_C11_68),Drugs Charged to Patients (D_4_HOS_C11_73),Radioisotope (D_4_HOS_C10_56),"ADJUSTED SALARIES, Employee Benefits (S3_2_C4_26)",FQHC 9 Provider Number (S2_1_C2_1608),Durable Medical Equipment Rented (B_2_C26_96),Liver Acquisition (A_C6_107),NF Provider Number (S2_1_C2_10),"AMOUNT REPORTED, Employee Benefits (S3_2_C2_26)","COST SERVICES NOT SUBJECT TO DEDUCTIBLES AND COINSURANCE - COST, Drugs Charged to Patients (D_5_HOS_C7_73)",Organ Procurement (D4_HEART_C1_69),Kidney Acquisition (B_2_C26_105),Subprovider I (A_C1_42),Occupational Therapy (D3_IPF_C3_67),Anesthesiology (C_1_C5_53),"Total Inpatient Charges, Radioisotope (C_1_C6_56)",Liver Acquisition (B_2_C26_107),Other Ancillary (D3_IPF_C2_76),Anesthesiology (A_C2_53),Kidney Acquisition (B_1_C26_105),"Net Expense for Cost Allocation, Employee Benefits (B_1_C0_4)",Hospital Street Address (S2_1_C1_1),"AVERAGE HOURLY WAGE, Subtotal Salaries (S3_3_C6_3)",Cardiac Catheterization (B_1_C26_59),Nursing Administration (A_C6_13),Intravenous Therapy (D_4_IRF_C11_64),"PAID HOURS RELATED TO SALARIES, Non-Physician Anesthetist Part A (S3_2_C5_2)","COST REIMBURSED SERVICES NOT SUBJECT TO DEDUCTIBLES AND COINSURANCE - CHARGES, Radiology-Diagnostic (D_5_HOS_C4_54)",Cardiac Catheterization (D_4_HOS_C4_59),Fiscal Year Begin Date (FY_BGN_DT),In State Medicaid eligible days (S2_1_C2_24),Nursery (C_1_C5_43),Observation Beds (Distinct Unit) (D3_HOS_C2_9201),Administrative and General (A_C6_5),Other Special Purpose (C_1_C7_117),"HHA II, Total Other Charges (S4_HHA2_C5_34)",Observation Beds (Distinct Unit) (D_4_SNF_C11_9201),Speech Pathology (D3_SNF_C2_68),OPT (C_1_C7_9920),Total (D_1_HOS_C4_200),Land Improvements (G_C1THRU4_13),Speech Pathology (B_2_C26_68),Subprovider I (D3_IPF_C2_42),Total Hospital Interns & Residents (S3_1_C11_14),"AMOUNT REPORTED, Other General Service (S3_2_C2_43)",Intensive Care Unit (D3_IRF_C2_31),Nonpaid Workers (B_1_C22_193),"Total Inpatient Charges, Subprovider-IPF (C_1_C6_40)","Net Expense for Cost Allocation, Speech Pathology (B_1_C0_68)","Total Inpatient Charges, Operating Room (C_1_C6_50)",Electroencephalography (A_C2_70),RHC 8 Provider Number (S2_1_C2_1507),Total Hospital Interns & Residents (S3_1_C9_14),"AMOUNT REPORTED, Physician-Part B (S3_2_C2_5)",Other Special Care (S3_1_C7_12),Other General Service (A_C1_18),Medical Supplies Charged to Patients (B_1_C26_71),Emergency (D_4_HOS_C2_91),"COST REIMBURSED SERVICES SUBJECT TO DEDUCTIBLES  AND COINSURANCE - CHARGES, Speech Pathology (D_5_HOS_C3_68)",Drugs Charged to Patients (D_4_SNF_C13_73),Outpatient Rehab Provider (S3_1_C7_25),"Total Inpatient Charges, Subprovider-IRF (C_1_C6_41)","Blood Storing, Processing, Trans (D_4_HOS_C13_63)",Subprovider 1 (S3_1_C8_18),Whole Blood & Packed Red Blood Cells (D_4_IRF_C11_62),Other Special Purpose (A_C1_117),Electrocardiology (C_1_C6_69),Pancreas Acquisition (C_1_C7_109),"TOTAL CAPITAL COSTS AFTER COST ALLOCATION, Subprovider-IPF (B_2_C26_40)",Drugs Charged to Patients (D_4_IPF_C11_73),Operating Room (D3_SNF_C2_50),Laboratory (D_4_IPF_C11_60),Intensive Care Unit (D3_SNF_C2_31),Subprovider I (B_1_C26_42),Total Program Excludable Costs (D1_HOS_C1_52),Speech Pathology (C_1_C2_68),Utilization (S5_C1_8),Impl. Dev. Charged to Patients (D_4_IPF_C13_72),Private grants or donations or endowment income restricted to funding charity care (S10_C1_17),"Net Expense for Cost Allocation, ASC (Distinct Part) (B_1_C0_115)",Physical Therapy (D3_HOS_C2_66),"If Line 32, Col 1 is yes, enter the method used: (A, B, or E only) (S2_1_C2_115)",Pancreas Acquisition (A_C6_109),"ADJUSTED SALARIES, Related Salaries (S3_2_C4_1402)","COST REIMBURSED SERVICES SUBJECT TO DEDUCTIBLES  AND COINSURANCE - CHARGES, Laboratory (D_5_HOS_C3_60)",Durable Medical Equipment Rented (C_1_C6_96),Research (B_2_C26_191),"Net Expense for Cost Allocation, Other Reimbursable (B_1_C0_98)","COST REIMBURSED SERVICES SUBJECT TO DEDUCTIBLES  AND COINSURANCE - CHARGES, Electroencephalography (D_5_HOS_C3_70)",Physical Therapy (D3_SNF_C2_66),Interns & Res Salary and Fringe Benefits (A_C1_21),ASC (Non Distinct Part) (C_1_C6_75),"PAID HOURS RELATED TO SALARIES, Home Office Salaries & Wage Related Csts (S3_2_C5_14)",Total Program General Inpatient Routine (D1_IPF_C1_41),Int & Res (non approved teaching program (B_2_C26_100),Laundry and Linen Service (A8_C2_13),Intravenous Therapy (D3_HOS_C3_64),"HHA III, Total Number of Episodes (S4_HHA3_C5_36)",Medical Supplies Charged to Patients (D3_SNF_C2_71),"Gift, Flower, Coffee Shop, Canteen (A_C1_190)",Total (D_4_IPF_C13_200),"Allocation of Interns & Residents Salary and Fringes, Adults and Pediatrics (B_1_C21_30)",Ambulance Services (C_1_C7_95),Tentative settlement (E_B_HOS_C1_42),ICF Provider Number (S2_1_C2_1001),Heart Acquisition (A_C2_106),"PPS REIMBURSED SERVICES -  CHARGES, Impl. Dev. Charged to Patients (D_5_HOS_C2_72)",Durable Medical Equipment Rented (D3_SNF_C2_96),Blood Clotting Factors for Hemoph. (D3_HOS_C3_6250),"Insurance, New Cap Related Csts Movable Equipment (A7_3_C5_2)",Drugs Charged to Patients (C_1_C7_73),Occupational Therapy (D_4_IPF_C13_67),CORF (A_C6_9910),"HHA III, Total Charges (S4_HHA3_C5_35)",Medical Supplies Charged to Patients (D_4_SNF_C11_71),"COST REIMBURSED SERVICES SUBJECT TO DEDUCTIBLES  AND COINSURANCE - CHARGES, Intravenous Therapy (D_5_HOS_C3_64)",Drugs Charged to Patients (D_4_IRF_C11_73),FQHC (D_4_HOS_C3_89),Intensive Care Unit (S3_1_C2_8),MRI (D_4_HOS_C4_58),"Net Expense for Cost Allocation, OPT (B_1_C0_9920)","TOTAL CAPITAL COSTS AFTER COST ALLOCATION, Laboratory (B_2_C26_60)",HHA 1 Provider Number (S2_1_C2_12),Radioisotope (D_4_HOS_C13_56),Radiology-Diagnostic (D3_HOS_C2_54),NF (A_C2_45),"Net Expense for Cost Allocation, Other Organ Acquisition (B_1_C0_112)",Int & Res (non approved teaching program (C_1_C5_100),Recovery Room (D_4_IRF_C11_51),"ADJUSTED SALARIES, Interns & Residents (S3_2_C4_2550)","ADJUSTED SALARIES, Dietary under contract (S3_2_C4_35)","Net Expense for Cost Allocation, Adults and Pediatrics (B_1_C0_30)","AMOUNT REPORTED, Physician Part A Teaching (S3_2_C3_2201)","HHA II, PEP:  Total Number of Outlier Episodes (S4_HHA2_C4_37)",Other Outpatient Services (C_1_C6_93),Anesthesiology (D_4_IRF_C11_53),"General Inpatient Routine Service Cost, net of Swing Bed and Private Room Diff (D1_SNF_C1_37)",Electroencephalography (D3_IPF_C3_70),"AVERAGE HOURLY WAGE, Interns & Residents (S3_2_C6_7)",Occupational Therapy (D3_SNF_C3_67),ESRD DME costs (E_B_HOS_C1_29),Int & Res (non approved teaching program (A_C2_100),Hospital City (S2_1_C1_2),MRI (D_4_IPF_C13_58),Respiratory Therapy (D3_HOS_C3_65),Drugs Charged to Patients (D_4_IRF_C13_73),"HHA II, LUPA Episodes:  Other Charges (S4_HHA2_C3_34)",Total Nursing School (D_4_IPF_C2_200),"COST REIMBURSED SERVICES SUBJECT TO DEDUCTIBLES  AND COINSURANCE - CHARGES, Cardiac Catheterization (D_5_HOS_C3_59)",OOT (B_1_C26_9930),"PPS REIMBURSED SERVICES -  CHARGES, Speech Pathology (D_5_HOS_C2_68)",State (S2_1_C2_143),"TOTAL CAPITAL COSTS AFTER COST ALLOCATION, Radiology-Diagnostic (B_2_C26_54)","PPS REIMBURSED SERVICES -  CHARGES, Anesthesiology (D_5_HOS_C2_53)",Renal Dialysis (B_1_C22_74),Radioisotope (D_4_IPF_C13_56),Other Special Purpose (B_2_C26_117),"AMOUNT REPORTED, Home Office Salaries (S3_2_C2_1401)",Other Reimbursable (D3_IPF_C3_98),Coronary Care Unit (S3_1_C5_9),"Net Expense for Cost Allocation, Observation Beds (Distinct Unit) (B_1_C0_9201)",Home Office Name (S2_1_C1_141),Pancreas Acquisition (B_2_C26_109),"COST REIMBURSED SERVICES NOT SUBJECT TO DEDUCTIBLES AND COINSURANCE - CHARGES, Clinic (D_5_HOS_C4_90)",Electrocardiology (D3_SNF_C2_69),"Total Inpatient Charges, Delivery Room and Labor Room (C_1_C6_52)","PPS REIMBURSED SERVICES -  CHARGES, Delivery Room and Labor Room (D_5_HOS_C2_52)",ICF (A_C2_4501),Impl. Dev. Charged to Patients (D_4_SNF_C11_72),Intestinal Acquisition (B_1_C26_110),"Medicare certified kidney 
transplant center cert date (S2_1_C1_126)",Speech Pathology (D3_IRF_C3_68),Other Reimbursable (D3_SNF_C3_98),Ambulance Services (A_C1_95),HHA (B_1_C21_101),"COST SERVICES SUBJECT TO DEDUCTIBLES AND COINSURANCE - COST, Respiratory Therapy (D_5_HOS_C6_65)",RHC 24 Provider Number (S2_1_C2_1523),Total Facility FTEs (S3_1_C9_27),Radioisotope (A_C6_56),"Gift, Flower, Coffee Shop, Canteen (B_1_C21_190)",Surgical Intensive Care Unit (D3_HOS_C2_34),"Net Expense for Cost Allocation, Intensive Care Unit (B_1_C0_31)",Medical Supplies Charged to Patients (D3_SNF_C3_71),Lung  Acquisition (B_2_C26_108),Laboratory (D3_SNF_C2_60),Operating Room (D3_SNF_C3_50),Respiratory Therapy (D_4_HOS_C11_65),Occupational Therapy (D_4_HOS_C4_67),Adults and Pediatrics (A_C1_30),HHA (B_1_C26_101),Labor and Delivery (S3_1_C3_32),CT Scan (D_4_IRF_C11_57),CMHC (A_C1_99),Stand-alone CHIP -- Costs minus net revenue (0 min) (S10_C1_12),Recovery Room (D_4_HOS_C13_51),"Total, New Cap Related Csts Movable Equipment (A7_3_C15_2)","PAID HOURS RELATED TO SALARIES, Excluded Area Salaries (S3_2_C5_10)",Clinic (D3_IRF_C3_90),Other Outpatient Services (A_C6_93),"Average patient dialysis time 
including setup (S5_C4_3)",ASC (Non Distinct Part) (B_1_C21_75),"Allocation of Interns & Residents Salary and Fringes, Surgical Intensive Care Unit (B_1_C21_34)","PAID HOURS RELATED TO SALARIES, Subtotal Other Wages and Related Csts (S3_3_C5_4)",Number of stations (S5_C4_6),Pancreas Acquisition (B_1_C21_109),Urban/Rural Indicator at beginning (S2_1_C1_26),ASC (Non Distinct Part) (D3_SNF_C2_75),"AMOUNT REPORTED, Subtotal Other Wages and Related Csts (S3_3_C2_4)",Blood Clotting Factors for Hemoph. (B_1_C26_6250),Program Ancillary Services (D1_SNF_C1_84),RHC 9 Provider Number (S2_1_C2_1508),"Percentage of patients re-using
dialyzers (S5_C1_10)",Subprovider I (A_C2_42),Physicians' Private Office (B_1_C26_192),"COST SERVICES SUBJECT TO DEDUCTIBLES AND COINSURANCE - COST, Impl. Dev. Charged to Patients (D_5_HOS_C6_72)","Net Expense for Cost Allocation, RHC (B_1_C0_88)",Home Program Dialysis (D3_IPF_C2_94),Total Subprovider II Interns & Residents (S3_1_C10_1801),Subprovider-IPF (A_C6_40),"AMOUNT REPORTED, Home Office Personnel (S3_2_C2_8)","TOTAL CAPITAL COSTS AFTER COST ALLOCATION, Surgical Intensive Care Unit (B_2_C26_34)","AMOUNT REPORTED, Excluded Areas (S3_2_C2_19)","COST SERVICES NOT SUBJECT TO DEDUCTIBLES AND COINSURANCE - COST, Recovery Room (D_5_HOS_C7_51)",Home Office PO Box (S2_1_C2_142),Partial or full credits from manufacturers (E_B_HOS_C1_3998),"COST REIMBURSED SERVICES SUBJECT TO DEDUCTIBLES  AND COINSURANCE - CHARGES, Clinic (D_5_HOS_C3_90)",FQHC (C_1_C6_89),Burn Intensive Care Unit (S3_1_C8_10),"Allocation of Interns & Residents Salary and Fringes, Subprovider I (B_1_C21_42)","Net Expense for Cost Allocation, OLTC (B_1_C0_46)",Other Ancillary (D_4_HOS_C12_76),Other Outpatient Services (D_4_HOS_C4_93),"HHA II, Total Charges:  LUPA Episodes (S4_HHA2_C3_35)",Radiology-Diagnostic (A_C6_54),Lung  Acquisition (C_1_C7_108),Emergency (D3_SNF_C3_91),"Net Expense for Cost Allocation, Surgical Intensive Care Unit (B_1_C0_34)",Out of State Medicaid eligible days (S2_1_C4_24),ASC (Non Distinct Part) (A_C6_75),"Lease, New Cap Related Csts Bldg & Fixtures (A7_3_C10_1)",Emergency (D_4_HOS_C12_91),"Net Expense for Cost Allocation, Home Program Dialysis (B_1_C0_94)",Nursery (A_C1_43),RHC 19 Provider Number (S2_1_C2_1518),Other Reimbursable (D_4_IRF_C11_98),Relief Payment (D1_HOS_C1_62),CMHC (B_1_C22_99),Charity care charges and uninsured discounts for the entire facility (S10_C3_20),Surgical Intensive Care Unit (A_C2_34),Ambulance Services (B_1_C26_95),Operating Room (D_4_HOS_C3_50),Electroencephalography (D_4_IPF_C11_70),"PAID HOURS RELATED TO SALARIES, Admin & Gen Under Contract (S3_2_C5_29)",Intensive Care Unit (D3_HOS_C2_31),Speech Pathology (D_4_HOS_C4_68),"COST SERVICES SUBJECT TO DEDUCTIBLES AND COINSURANCE - COST, Ambulance Services (D_5_HOS_C6_95)","Disposals and Retirements, Building Improvements (A7_1_C7_4)","AMOUNT REPORTED, Teaching Physician Salaries (S3_2_C2_16)","Number of days in year dialysis 
furnished (S5_C1_5)",Pass through Cost for Program Inpatient Routine (D1_HOS_C1_50),FQHC (B_1_C21_89),Cardiac Catheterization (D_4_HOS_C11_59),Respiratory Therapy (D_4_IPF_C11_65),Adults and Pediatrics (D3_HOS_C2_30),"COST REIMBURSED SERVICES NOT SUBJECT TO DEDUCTIBLES AND COINSURANCE - CHARGES, Anesthesiology (D_5_HOS_C4_53)","COST SERVICES NOT SUBJECT TO DEDUCTIBLES AND COINSURANCE - COST, Cardiac Catheterization (D_5_HOS_C7_59)","PAID HOURS RELATED TO SALARIES, Subtotal Salaries (S3_3_C5_3)","Average patient dialysis time 
including setup (S5_C3_3)","HHA II, With Outliers:  Total Visits (S4_HHA2_C2_33)",Pass Through Cost for  Program Ancillary (D1_IPF_C1_51),Payments received from patients for amounts previously written off as charity care (S10_C1_22),Operating Room (A_C2_50),"COST REIMBURSED SERVICES NOT SUBJECT TO DEDUCTIBLES AND COINSURANCE - CHARGES, Blood Storing, Processing, Trans (D_5_HOS_C4_63)","Blood Storing, Processing, Trans (B_1_C26_63)","Beginning Balances, Land Improvements (A7_1_C1_2)",Observation Beds (Distinct Unit) (D_4_HOS_C13_9201),Intestinal Acquisition (A_C1_110),Electroencephalography (D_4_SNF_C11_70),Anesthesiology (D_4_SNF_C11_53),Other Organ Acquisition (B_2_C26_112),Interns & Res Other Program Costs (A_C1_22),Radiology-Therapeutic (B_1_C26_55),Durable Medical Equipment Rented (D3_HOS_C2_96),"PPS REIMBURSED SERVICES -  CHARGES, Electrocardiology (D_5_HOS_C2_69)","Net Expense for Cost Allocation, Nursery (B_1_C0_43)",Anesthesiology (D3_IPF_C2_53),Recovery Room (D_4_HOS_C10_51),"COST REIMBURSED SERVICES NOT SUBJECT TO DEDUCTIBLES AND COINSURANCE - CHARGES, Blood Clotting Factors for Hemoph. (D_5_HOS_C4_6250)",ASC (Non Distinct Part) (B_2_C26_75),"COST SERVICES NOT SUBJECT TO DEDUCTIBLES AND COINSURANCE - COST, Radioisotope (D_5_HOS_C7_56)","HHA II, With Outliers:  Other Charges (S4_HHA2_C2_34)",Electrocardiology (D3_HOS_C3_69),Other Ancillary (D_4_SNF_C11_76),"ADJUSTED SALARIES, Home Office Personnel (S3_2_C4_8)",RHC (C_1_C6_88),"COST SERVICES SUBJECT TO DEDUCTIBLES AND COINSURANCE - COST, Other Outpatient Services (D_5_HOS_C6_93)",Kidney Acquisition (A_C2_105),"AMOUNT REPORTED, Pharmacy (S3_2_C2_40)",Ambulance Services (B_1_C22_95),Interest expense on Medicare Overpaymts (A8_C2_22),"Number of patients in program at 
end of cost reporting period (S5_C1_1)",MRI (A_C1_58),"Total Inpatient Charges, Radiology-Diagnostic (C_1_C6_54)","COST REIMBURSED SERVICES SUBJECT TO DEDUCTIBLES  AND COINSURANCE - CHARGES, Blood Clotting Factors for Hemoph. (D_5_HOS_C3_6250)",Maintenance of Personnel (A_C6_12),NF (S3_1_C11_20),"Allocation of Interns & Residents Program Costs, Intravenous Therapy (B_1_C22_64)","AMOUNT REPORTED, Physician Part A (S3_2_C2_2201)",Kidney Acquisition (C_1_C6_105),ASC (Non Distinct Part) (B_1_C26_75),Renal Dialysis (C_1_C5_74),OPT (B_1_C26_9920),Coronary Care Unit (D3_IRF_C2_32),Anesthesiology (D_4_HOS_C12_53),"Allocation of Interns & Residents Program Costs, Laboratory (B_1_C22_60)",RHC 7 Provider Number (S2_1_C2_1506),Less Contractual Allowance and Discounts on Patients' Accounts (G3_C1_2),Speech Pathology (D_4_HOS_C2_68),Delivery Room and Labor Room (D_4_HOS_C3_52),NF (S3_1_C9_20),"Is this a teaching hospital or
affiliated with a teaching hospital? (Y/N) (S2_1_C1_56)","Net Expense for Cost Allocation, Delivery Room and Labor Room (B_1_C0_52)",Other Current Assets (G_C1THRU4_9),Hospital Adlts & Ped Swing Bed SNF (S3_1_C8_5),Swing Bed SNF Provider Number (S2_1_C2_7),"PPS SERVICES COST, Radioisotope (D_5_HOS_C5_56)","PPS REIMBURSED SERVICES -  CHARGES, Home Program Dialysis (D_5_HOS_C2_94)",Occupational Therapy (C_1_C2_67),Radiology-Therapeutic (D3_SNF_C2_55),Other Assets (G_C1THRU4_34),Impl. Dev. Charged to Patients (D_4_HOS_C4_72),Durable Medical Equipment Rented (D3_SNF_C3_96),Line 2 times line 5 (E_B_HOS_C101_6),"Number of patients transplanted 
during fiscal year (S5_C1_12)",Observation Beds (Distinct Unit) (A_C6_9201),Delivery Room and Labor Room (D3_HOS_C2_52),"COST REIMBURSED SERVICES SUBJECT TO DEDUCTIBLES  AND COINSURANCE - CHARGES, PBP Clinical Lab Services Program Only (D_5_HOS_C3_61)",Interns & Res Other Program Costs (A_C2_22),Anesthesiology (D3_HOS_C3_53),Drugs Charged to Patients (A_C1_73),Cardiac Catheterization (D3_HOS_C3_59),"Allocation of Interns & Residents Program Costs, MRI (B_1_C22_58)",Allowable bad debts for dual eligibles beneficiaries (E_B_HOS_C1_36),Clinic (D3_SNF_C3_90),Emergency (A_C1_91),"COST REIMBURSED SERVICES SUBJECT TO DEDUCTIBLES  AND COINSURANCE - CHARGES, Drugs Charged to Patients (D_5_HOS_C3_73)","TOTAL CAPITAL COSTS AFTER COST ALLOCATION, Coronary Care Unit (B_2_C26_32)",Electroencephalography (D3_SNF_C2_70),Total prospective payment (E_B_HOS_C1_24),IRF (S3_1_C5_17),Allowable Inpatient Cost Plus Incentive Pt (D1_HOS_C1_63),Emergency (D3_HOS_C2_91),Total Patient Days (D_3_HOS_C6_200),Whole Blood & Packed Red Blood Cells (D3_IRF_C3_62),Nursing Administration (A_C2_13),RHC 1 Provider Number (S2_1_C2_15),OLTC (A_C6_46),Recovery Room (D_4_IRF_C13_51),Number of EPO units furnished for Line 13 (S5_C1_15),"PPS SERVICES COST, ASC (Non Distinct Part) (D_5_HOS_C5_75)",Total (D_1_HOS_C7_200),CT Scan (D_4_HOS_C12_57),Radiology-Therapeutic (D_4_HOS_C12_55),Surgical Intensive Care Unit Program Cost (D1_HOS_C5_46),Hospital Adults & Pediatrics (S3_1_C6_1),"AMOUNT REPORTED, Non-Physician Part B (S3_2_C2_6)",Vending Machines (A8_C2_20),ASC (Non Distinct Part) (C_1_C5_75),Research (A_C1_191),Total (D_4_IRF_C13_200),ASC (Non Distinct Part) (D_4_SNF_C11_75),OPT (A_C6_9920),Intestinal Acquisition (C_1_C5_110),OLTC (S3_1_C3_21),HHA (A_C6_101),Radioisotope (D3_IRF_C3_56),"PAID HOURS RELATED TO SALARIES, Home Office:  Physician Part A (S3_2_C5_15)",OOT (A_C1_9930),IRF (S3_1_C3_17),Laboratory (D_4_HOS_C13_60),Other Reimbursable (A_C2_98),"Allocation of Interns & Residents Salary and Fringes, Occupational Therapy (B_1_C21_67)",Observation Beds (Distinct Unit) (D_4_HOS_C10_9201),Are provider based physicians' costs included in Worksheet A? (Y/N) (S2_1_C1_144),Home Program Dialysis (D_4_HOS_C11_94),MRI (D3_SNF_C3_58),"Allocation of Interns & Residents Salary and Fringes, Nursery (B_1_C21_43)",Recovery Room (D_4_IPF_C13_51),"Taxes, New Cap Related Csts Bldg & Fixtures (A7_3_C6_1)","COST REIMBURSED SERVICES SUBJECT TO DEDUCTIBLES  AND COINSURANCE - CHARGES, Radioisotope (D_5_HOS_C3_56)",Anesthesiology (D3_IPF_C3_53),Clinic (D_4_IPF_C11_90),RHC/FQHC Combined (S3_1_C9_26),Total Facility (S3_1_C2_27),"PPS SERVICES COST, Recovery Room (D_5_HOS_C5_51)",CT Scan (A_C6_57),OSP (C_1_C7_9940),Speech Pathology (D_4_IRF_C11_68),Nursery (B_1_C26_43),Impl. Dev. Charged to Patients (B_1_C26_72),Intravenous Therapy (D3_SNF_C2_64),Medical Supplies Charged to Patients (D_4_HOS_C3_71),Radiology-Diagnostic (D3_IPF_C2_54),Other Capital (A_C2_3),CMHC (B_1_C26_99),Observation Beds (Distinct Unit) (C_1_C6_9201),HAC reduction adjustment amount (E_A_HOS_C1_7099),"AVERAGE HOURLY WAGE, Teaching Physician Salaries (S3_2_C6_16)",PBP Clinical Lab Services Program Only (A_C2_61),Other Organ Acquisition (A_C6_112),Physical Therapy (D3_IPF_C2_66),Maintenance and Repairs (A_C1_6),Clinic (D_4_HOS_C12_90),Cardiac Catheterization (D3_SNF_C3_59),SNF (S3_1_C6_19),Subprovider-IRF (A_C6_41),Other Reimbursable (D_4_HOS_C13_98),"COST REIMBURSED SERVICES NOT SUBJECT TO DEDUCTIBLES AND COINSURANCE - CHARGES, Electroencephalography (D_5_HOS_C4_70)",Dietary (A_C2_10),IPF (S3_1_C5_16),Investments (G_C1THRU4_31),Average times dialyzers re-used (S5_C2_9),"HHA I, PEP:  Total Non Routine Med Supply Chgs (S4_HHA1_C4_38)",Radiology-Therapeutic (D_4_IRF_C13_55),Speech Pathology (D_4_SNF_C11_68),Clinic (D3_HOS_C3_90),Fixed Equipment (G_C1THRU4_19),ICF (B_1_C26_4501),Hospital Adults & Pediatrics (S3_1_C8_1),CORF (B_2_C26_9910),"Total Inpatient Charges, Intensive Care Unit (C_1_C6_31)",Electrocardiology (D_4_HOS_C12_69),"Fully Depreciated Assets, Purchase (A7_1_C2_7)","HHA I, With Outliers:  Number of Episodes (S4_HHA1_C2_37)",Report Record Number (RPT_REC_NUM),RHC 14 Provider Number (S2_1_C2_1513),FQHC 7 Provider Number (S2_1_C2_1606),Electroencephalography (D3_IPF_C2_70),RHC (A_C1_88),Clinic (B_1_C26_90),"COST REIMBURSED SERVICES SUBJECT TO DEDUCTIBLES  AND COINSURANCE - CHARGES, Delivery Room and Labor Room (D_5_HOS_C3_52)","HHA III, PEP Episodes:  Total Visits (S4_HHA3_C4_33)",OSP (B_1_C26_9940),Intestinal Acquisition (A_C6_110),Medicare reimbursable bad debts for the entire hospital complex (S10_C1_27),"AMOUNT REPORTED, Nursing Administration (S3_2_C2_38)",Hospice (C_1_C7_116),"COST SERVICES NOT SUBJECT TO DEDUCTIBLES AND COINSURANCE - COST, Delivery Room and Labor Room (D_5_HOS_C7_52)","AMOUNT REPORTED, Related Salaries (S3_2_C3_1402)","PPS SERVICES COST, Other Reimbursable (D_5_HOS_C5_98)","AVERAGE HOURLY WAGE, Subtotal Other Wages and Related Csts (S3_3_C6_4)",Home Program Dialysis (C_1_C7_94),Radiology-Therapeutic (D3_IPF_C2_55),Cardiac Catheterization (D3_IPF_C3_59),"Net Expense for Cost Allocation, Paramedical Education (B_1_C0_23)","ADJUSTED SALARIES, Wage Related Costs Other (S3_2_C4_18)",Hospital Adults & Pediatrics (S3_1_C4_1),Research (B_1_C26_191),Occupational Therapy (D_4_HOS_C2_67),Nursery (A_C2_43),"ADJUSTED SALARIES, Management and Administrative Services (S3_2_C4_12)","Allocation of Interns & Residents Program Costs, Occupational Therapy (B_1_C22_67)",Impl. Dev. Charged to Patients (D3_IPF_C2_72),"Total, New Cap Related Csts Bldg & Fixtures (A7_3_C15_1)",Laboratory (D3_HOS_C3_60),IPPS Interim payment (E_A_HOS_C1_72),Target Amount (D1_HOS_C1_56),Medical Supplies Charged to Patients (D3_IRF_C3_71),NOT IN THIS FILE (TRNSMTL_NUM),Pancreas Acquisition (B_1_C26_109),MRI (D_4_HOS_C12_58),Kidney Acquisition (A_C6_105),ASC (Distinct Part) (C_1_C6_115),"Allocation of Interns & Residents Program Costs, Nursery (B_1_C22_43)",OPT (A_C2_9920),"COST SERVICES NOT SUBJECT TO DEDUCTIBLES AND COINSURANCE - COST, Anesthesiology (D_5_HOS_C7_53)",Radiology-Diagnostic (A_C2_54),Government grants or appropriations or transfers for support of hospital operations (S10_C1_18),PBP Clinical Lab Services Program Only (D3_HOS_C2_61),Title XIX discharges (S3_1_C14_1),"Donations, Movable Equipment (A7_1_C3_6)",Other Reimbursable (D3_HOS_C3_98),Total Other Medical Education Cost (D_3_HOS_C3_200),Intravenous Therapy (D_4_HOS_C3_64),Adults and Pediatrics (A_C2_30),Occupational Therapy (D_4_HOS_C11_67),Cost of patients approved for charity care and uninsured discounts (S10_C1_21),"Blood Storing, Processing, Trans (D_4_HOS_C2_63)","COST REIMBURSED SERVICES SUBJECT TO DEDUCTIBLES  AND COINSURANCE - CHARGES, MRI (D_5_HOS_C3_58)",Pancreas Acquisition (A_C1_109),Adults & Pediatrics (C_1_C5_30),"PPS REIMBURSED SERVICES -  CHARGES, Physical Therapy (D_5_HOS_C2_66)","COST SERVICES NOT SUBJECT TO DEDUCTIBLES AND COINSURANCE - COST, Other Ancillary (D_5_HOS_C7_76)","COST SERVICES NOT SUBJECT TO DEDUCTIBLES AND COINSURANCE - COST, Clinic (D_5_HOS_C7_90)",Durable Medical Equipment Rented (D_4_HOS_C12_96),"COST REIMBURSED SERVICES NOT SUBJECT TO DEDUCTIBLES AND COINSURANCE - CHARGES, CT Scan (D_5_HOS_C4_57)","ADJUSTED SALARIES, Interns & Residents (S3_2_C4_2553)",Provider's actual MSA or CBSA (S2_1_C3_3),Fiscal Year End Date (FY_END_DT),"AVERAGE HOURLY WAGE, Contract Labor:  Physician Part A (S3_2_C6_13)",CMHC (S3_1_C6_25),"Allocation of Interns & Residents Salary and Fringes, NF (B_1_C21_45)",ASC (Non Distinct Part) (D3_IPF_C2_75),"HHA II, With Outliers:  Non Routine Med Sup Chgs (S4_HHA2_C2_38)",Operating Room (D_4_IRF_C13_50),"Blood Storing, Processing, Trans (D_4_IRF_C13_63)","COST REIMBURSED SERVICES SUBJECT TO DEDUCTIBLES  AND COINSURANCE - CHARGES, Blood Storing, Processing, Trans (D_5_HOS_C3_63)",Home Program Dialysis (D3_HOS_C2_94),Radioisotope (D3_IPF_C2_56),Electroencephalography (D_4_IRF_C13_70),Other Outpatient Services (D3_SNF_C3_93),Have you established a new subprovider excluded unit under 42 CFR 413.40(f)(1)(I)?(Y/N) (S2_1_C1_86),Total Current Liabilities (G_C1THRU4_45),"TOTAL CAPITAL COSTS AFTER COST ALLOCATION, Other Special Care Unit (B_2_C26_35)",Clinic (B_1_C22_90),Other Outpatient Services (D3_IRF_C3_93),Other Special Purpose (C_1_C6_117),Laboratory (A_C6_60),Observation Beds (Distinct Unit) (D_4_HOS_C11_9201),Intensive Care Unit (S3_1_C3_8),Home Program Dialysis (A_C2_94),Home Program Dialysis (D_4_HOS_C3_94),"TOTAL CAPITAL COSTS AFTER COST ALLOCATION, Total Directly Assigned New Cap Rel Csts (B_2_C0_202)",Recovery Room (D3_HOS_C2_51),Radioisotope (B_1_C26_56),"Net Expense for Cost Allocation, Recovery Room (B_1_C0_51)",Intravenous Therapy (C_1_C5_64),"PPS REIMBURSED SERVICES -  CHARGES, Laboratory (D_5_HOS_C2_60)","Allocation of Interns & Residents Salary and Fringes, Electroencephalography (B_1_C21_70)",MRI (D3_IPF_C3_58),Medical Supplies Charged to Patients (A_C2_71),Surgical Intensive Care Unit (S3_1_C2_11),Is this a New Hospital under 42 CFR 413.40(f)(1)(I) (TEFRA)? (Y/N) (S2_1_C1_85),"AMOUNT REPORTED, Physician Part A (S3_2_C2_22)",Burn Intensive Care Unit (S3_1_C3_10),Nonpaid Workers (A_C2_193),"Net Expense for Cost Allocation, SNF (B_1_C0_44)",Emergency (C_1_C7_91),Other Outpatient Services (D_4_HOS_C3_93),"PPS REIMBURSED SERVICES -  CHARGES, Intravenous Therapy (D_5_HOS_C2_64)",Clinic (D3_SNF_C2_90),Physicians' Private Office (B_1_C21_192),Operating Room (D_4_SNF_C11_50),Surgical Intensive Care Unit (D_3_HOS_C9_34),"Number of patients in program at 
end of cost reporting period (S5_C4_1)","Other Capital Related Costs, New Cap Related Csts Movable Equipment (A7_3_C7_2)",Subprovider-IRF (D_1_HOS_C7_41),"Beginning Balances, Fixed Equipment (A7_1_C1_5)",Electrocardiology (D_4_HOS_C3_69),IRF (S3_1_C7_17),Is this hospital an All-Inclusive rate provider? (Y/N) (S2_1_C1_115),Other Special Care (S3_1_C6_12),Radioisotope (D_4_IRF_C13_56),Occupational Therapy (D3_IRF_C2_67),Housekeeping (A_C6_9),Other Medicaid Days (S2_1_C6_24),Clinic (C_1_C5_90),"Treatment capacity per day per
station (S5_C2_7)","AVERAGE HOURLY WAGE, Maintenance of Personnel (S3_2_C6_37)",Other Outpatient Services (D3_IPF_C3_93),Clinic (D3_IRF_C2_90),Total Other Medical Education (D_4_HOS_C4_200),Intensive Care Unit (S3_1_C7_8),"Gift, Flower, Coffee Shop, Canteen (A_C6_190)",Radiology-Diagnostic (D_4_IRF_C11_54),"PPS SERVICES COST, Occupational Therapy (D_5_HOS_C5_67)",Emergency (D3_IPF_C2_91),Subtotal (E_B_HOS_C1_37),"TOTAL CAPITAL COSTS AFTER COST ALLOCATION, Burn Intensive Care Unit (B_2_C26_33)",Other Ancillary (D3_IRF_C3_76),"Allocation of Interns & Residents Program Costs, Electroencephalography (B_1_C22_70)","Net Expense for Cost Allocation, Drugs Charged to Patients (B_1_C0_73)",Urban (1) or Rural (2) (S2_1_C1_27),ASC (Non Distinct Part) (A_C1_75),Other Nonreimbursable (B_2_C26_194),Delivery Room and Labor Room (C_1_C5_52),Subtotal (E_B_HOS_C1_40),Renal 8 Provider Number (S2_1_C2_1807),Utilization Review SNF (A_C1_114),Medical and Other Services reimbursed by OPPS (E_B_HOS_C101_2),Electroencephalography (D3_HOS_C3_70),"HHA II, Total Number of Episodes (S4_HHA2_C5_36)","AMOUNT REPORTED, Maintenance of Personnel (S3_2_C2_37)",Renal Dialysis (D_4_HOS_C3_74),"ADJUSTED SALARIES, Nursing Administration (S3_2_C4_38)","Total Inpatient Charges, PBP Clinical Lab Services Program Only (C_1_C6_61)","COST SERVICES NOT SUBJECT TO DEDUCTIBLES AND COINSURANCE - COST, Electrocardiology (D_5_HOS_C7_69)","Fully Depreciated Assets, Total (A7_1_C7_10)",ASC (Non Distinct Part) (D_4_IPF_C13_75),"PAID HOURS RELATED TO SALARIES, Central Services and Supply (S3_2_C5_39)",Other Ancillary (D3_SNF_C2_76),Medical Supplies Charged to Patients (D_4_HOS_C4_71),"PPS REIMBURSED SERVICES -  CHARGES, Operating Room (D_5_HOS_C2_50)",Beginning Date of SCH status (S2_1_C1_3601),"ADJUSTED SALARIES, Physician-Part B (S3_2_C4_5)","Net Expense for Cost Allocation, Subprovider I (B_1_C0_42)",Burn Intensive Care Unit (S3_1_C2_10),Utilization Review-physicians compens (A8_C2_25),Speech Pathology (D_4_IRF_C13_68),"PPS SERVICES COST, Intravenous Therapy (D_5_HOS_C5_64)",Total Current Assets (G_C1THRU4_11),Speech Pathology (D3_IPF_C3_68),Physical Therapy (D_4_IRF_C11_66),Heart Acquisition (C_1_C6_106),Other Special Care Unit (A_C2_35),Total Outpatient Program Pass Thru Cost (D_4_IPF_C6_200),Total Program General Inpatient Routine (D1_HOS_C1_41),Renal 4 Provider Number (S2_1_C2_1803),"Total Outpatient Charges, Cardiac Catheterization (C_1_C7_59)",Total unreimbursed cost for Medicaid and CHIP and state and local indigent care programs (S10_C1_19),"ADJUSTED SALARIES, Administrative & General under contract (S3_2_C4_28)",Observation Beds (Distinct Unit) (C_1_C7_9201),Respiratory Therapy (A_C1_65),Physical Therapy (D_4_HOS_C10_66),Physicians' Private Office (B_1_C22_192),New Capital Equipment (A_C6_2),"Allocation of Interns & Residents Salary and Fringes, Operating Room (B_1_C21_50)",Other Outpatient Services (C_1_C5_93),"AMOUNT REPORTED, Interns & Residents (S3_2_C2_2551)","Blood Storing, Processing, Trans (A_C2_63)",Laboratory (A_C2_60),"AMOUNT REPORTED, Interns & Residents (S3_2_C2_2552)",Whole Blood & Packed Red Blood Cells (D_4_IPF_C13_62),CMHC (A_C6_99),"Net Expense for Cost Allocation, Electrocardiology (B_1_C0_69)",RHC/FQHC Combined (S3_1_C7_26),"COST REIMBURSED SERVICES SUBJECT TO DEDUCTIBLES  AND COINSURANCE - CHARGES, Observation Beds (Distinct Unit) (D_5_HOS_C3_9201)",Other Special Care Unit (D3_IPF_C2_35),ASC (Non Distinct Part) (D3_IPF_C3_75),certification date (S2_1_C1_132),Occupational Therapy (D_4_SNF_C11_67),Durable Medical Equipment Sold (C_1_C7_97),Interest Expense (A_C6_113),Drugs Charged to Patients (D_4_HOS_C2_73),"ADJUSTED SALARIES, Non-Physician Anesthetist Part A (S3_2_C4_2)",Hospice (S3_1_C11_24),Ambulance Services (C_1_C6_95),Other Reimbursable (C_1_C6_98),Radiology-Diagnostic (D_4_HOS_C12_54),"AVERAGE HOURLY WAGE, Housekeeping under Contract (S3_2_C6_33)",Renal Dialysis (A_C6_74),Renal Dialysis (D_4_IPF_C11_74),Durable Medical Equipment Rented (D3_IRF_C2_96),Coronary Care Unit (A_C1_32),"COST REIMBURSED SERVICES SUBJECT TO DEDUCTIBLES  AND COINSURANCE - CHARGES, Impl. Dev. Charged to Patients (D_5_HOS_C3_72)",RHC (D_4_HOS_C2_88),"Other Capital Related Costs, Total (A7_3_C7_3)",Other Outpatient Services (D_4_HOS_C2_93),Whole Blood & Packed Red Blood Cells (D3_SNF_C2_62),Other Ancillary (D3_IPF_C3_76),Speech Pathology (D_4_HOS_C13_68),"Net Expense for Cost Allocation, Cardiac Catheterization (B_1_C0_59)",FFY,Hospital Type (From CMS Hospitals Data Archive),Name and Num
5849,SOUTHWEST GENERAL HEALTH CENTER (360155),General Short Term (Acute Care Hospitals),Voluntary Nonprofit-Other,-81.83291,41.37208,,,23.25,,,,,,,7401.0,-33820.0,,,,,,212.0,,,,,,,,,,,1994645.0,,,212.0,1938912.0,346849.0,21927290.0,535.0,,,,8266.0,,,,162.0,,1628277.0,,3786174.0,,1271438.0,145.0,,,2116858.0,,,4266868.0,3072857.0,,50037.0,,,152603.0,420672.0,,,,2635890.0,,,,4647405.0,,,-825687.0,184274.0,,,,,1921733.0,178828.0,,,3165690.0,114459.0,26184.0,,,8.0,,,,220.0,189012.0,,83374.0,,13.0,246714.0,4531.0,,,373.0,15485576.0,,,1127782.0,,6422091.0,,47954.0,,,,87728.02,14067066.0,,,,,,1896206.0,,16398628.0,,,,,,,,152584.0,244327.0,,,,,,1500.0,,,5895682.0,,,,,15952.0,,,,2405.0,120609.0,,,,303822821.0,,11545323.0,4362153.0,50517.0,,15485576.0,3231476.0,,,5254.8,,,6344.0,,N,689408.0,,,,2711105.0,,3993854.0,,,8573005.0,257858.0,,,-16853.0,,,,,,150877.0,,,335556.0,,173396357.0,,,4566884.0,,,2468040.0,,,,6347.0,,26565694.0,,,,-36047.0,,321026.0,,,13674.0,,,21074498.0,3293280.0,101714312.0,,12905593.0,13140.0,,,4217193.0,,,,,,,,,90514.0,,,90520.0,,111563.12,112770.0,,106476.0,,,,244717766.0,205657.0,,,,,1618095.0,,14000071.0,3868647.71,28132.0,,,,,,,,88113.0,1384.0,,5541558.0,,,,36371.0,10440037.0,18589.0,174816198.0,,13266273.0,356846.0,,6969739.0,58198.0,,,7763417.0,1618095.0,-3540.0,2109031.0,508482.0,,,F,2072426.0,19473.0,12861298.0,21927290.0,,,,26652407.0,12164536.0,2031156.0,,,894844.0,52.0,,30414.0,,,,,,244327.0,,,,,,297595.0,,,9443.0,,13240941.0,264279.0,1662823.0,,,,,,,,,,24680.0,,4227.0,,,,,,1037.0,75732.0,1763366.0,10.0,,-616846.0,28.4,,,584781.0,21074498.0,429.0,,,,1348787.0,88057458.0,,916173.0,,,2977209.0,19014568.0,1059303.0,-127645.0,,,1 S ACUTE REHAB,5501868.0,8172.0,2978756.0,,44199.0,,8621055.0,,16710356.0,75732.0,,67.5,,15434582.0,,105448969.0,18725272.0,,,65285.47,,,,,,,,,346684.0,,,,592106.0,,,74181.0,,,5892320.0,,,,,,31966213.0,,,,,8399706.0,,25069.0,156178.0,,1498.0,5442.0,,,,,,,,,25995415.0,,829624.0,16.77,,,1767771.0,,,,,10849.0,5895682.0,22829.0,,104563.43,,163584232.0,,,,,596.0,978.0,,,,,1842.0,19.0,,4745.0,,175117.0,413947.0,-259233.0,N,,,,,,,,,-117652.0,16.0,,5673.0,13277569.0,25995415.0,,,3368572.56,,,,5312.0,,,,,1120531.0,25069.0,2461550.0,,1139.0,2079832.0,,,,,,250.0,765348.0,,,306661912.0,,24.0,,,,244717766.0,N,27.6,,,,,5111458.0,4643043.0,,,,,,,-11928815.0,,,14009163.0,,,,,,,2891890.0,,,282005935.0,,,,,101157.0,,21.65,,,,108240.0,,,26652407.0,1323087.0,,357726.0,22829.0,,,19473.0,18589.0,,14.85,,,,,,,51740.0,,772761.0,,,1469348.0,,,-98495.0,-750292.0,,100592836.0,,,,,1576.0,12980163.0,,4531.0,,32605.0,,270332.0,4050.0,,,,,,,,,,,,200.2,,,3007.0,P,,29.04,,95932150.0,,,196786.0,77380.0,160.39,,,-9320.0,,408341.0,,,,,,198.0,1587799.0,1421.0,,,22178.0,,206943.0,,,211922029.0,-245.0,,3059.0,,117160817.0,,,,53289923.0,,,,27125.0,2468040.0,,12530229.0,975094341.0,2304875.0,,,,,,,20747.0,,,-17171.0,12717009.0,,,,401575.0,,,6412270.0,-45922.0,5529550.0,,256018.0,1500.0,36371.0,144988.0,,,,,,,,,13859670.0,954677.0,,,,,74932.0,,,,,,6522443.0,,5998424.0,,71334.0,108240.0,421788.0,29029583.0,,,91883618.0,7760197.0,2251.0,1749782.0,,,,,,639683.0,,3708.0,4525773.0,,,,747076.0,,2928383.0,992809.0,,,1809.0,,725233.0,,,,,,,,6555115.0,,544045.0,,,,,,,,,569533.74,979.0,,,731391.0,,,51746.36,,,1391105.0,,,,89390.0,2034518.0,,652121.0,,,548756.0,584781.0,,,,,,,,,101448309.0,,725233.0,9112017.0,,-87690.0,4237266.0,,,17160.0,,,,2002700.0,,,,,,16247.0,,,100592836.0,,,,,2797.0,401575.0,,,,2,,,,,,,,,,2244.0,,,48.07,,,3592178.0,,1105.0,15626.0,,,,7825.0,3592178.0,466754.69,,25738287.0,44907322.0,,,,,,154.0,4520.0,,,,1427722.0,6606859.0,3322400.0,5673.0,,,,2891890.0,1921733.0,,,829624.0,21168156.0,,,,219048.0,,,8536613.0,,-279070.0,,32774623.0,CUYAHOGA,,674557.0,,929766.0,356846.0,765348.0,,4643043.0,,,,,609.0,,,,,,802118.0,,4546823.0,,,,3325.0,,,,,,,,,,,3324213.0,,,,,,,,,,,,25560785.0,-652422.0,Y,,,88091129.0,,,1790895.0,5840.0,,,,5747491.0,63307.0,13253966.0,,,,,21168156.0,,,695942.0,,,356880136.0,,,,,,,,5037375.0,,2085293.0,,-71859.0,0.223508,376.0,,41265.0,N,59396543.0,100836471.0,965237.0,13133534.0,,,,5822.0,,N,-7960.0,,,,,230842.0,,7918.0,41711.25,,,,,-3809902.0,,2.0,3529.0,,,47450495.0,,8266.0,,2923306.0,7467204.0,,,,,2244.0,,1757404.0,,2187481.0,,,,6408579.0,6434988.0,,,,211.0,,,,1363450.0,,,1782450.0,1498987.0,,,1840016.0,,11415.0,71593377.0,,,,,6434988.0,607972.0,6787794.0,-53790.0,6852171.0,6932818.0,,17889195.0,,1559159.0,4592447.0,,2189.0,1673328.0,782569.0,,4282505.0,,,,,44000.75,1387798.0,206.0,416.0,2630242.0,,,,,,,,,,4668271.0,,-5071201.0,,,108240.0,,,,,632456.0,9446943.0,1077067.0,1711.0,17946855.0,1387.0,,,32774623.0,,,,,,1903839.0,,,,,,238.0,,,,,,,,6205.95,,,,,2002700.0,,365919,,,1736564.0,,,,,,13390851.0,,,,3379821.0,,,,Y,,,,7817429.0,362.0,,,,2002700.0,29493443.0,2498139.0,,,,1606170.0,,-24686168.0,,4006205.0,,,17103.94,9837.0,,2549564.0,,,2472.0,,10597.0,,8787553.0,,,,,,,,23.51,202109.0,13747.0,69255.0,3187346.0,350313.0,,,,505.0,,,,67277.0,,-11928815.0,-13008.0,,108240.0,202043.0,,2498139.0,1423737.0,3986199.0,,51690.0,,,,,,,6788.0,136882.0,149783738.0,,116550642.0,,,,,,,1857119.0,,,187105.0,4108845.0,25359354.0,,,,,,,,,,3442.0,,2163.0,,,,,,,,,643910.0,100894.0,1577201.0,,207096398.0,55100498.0,1243.0,-41489.0,,,,,2661678.0,34245.39,,1242328.0,,16708856.0,,,,410660.0,,13113545.0,,,,,91883618.0,1363450.0,,,,,117127146.0,4018548.0,36.0,,,,36S155,,,N,,,1896206.0,,,,,1015.0,,,,25995415.0,,26565694.0,10011944.0,860587.0,156053745.0,3287663.0,-93500.0,,,,,,,,,,,,,,11932935.0,,,,,1421547.0,,,,,,-50599.0,1420271.0,,,,26.07,9092.0,,1211482.0,-212069.0,,,2304875.0,,,,,,,217941035.0,,,,,,,,,,,84.0,6412270.0,,,-29531.0,651.0,87.0,,4476792.0,,19239.0,26.05,,653461.0,341416.0,5838628.0,,,,,,24.96,464152.0,,,12344.0,1396744.0,46134.0,,,,,,,,,12530229.0,4546823.0,13674.0,,3505635.0,421789.0,524025.0,53.42,,,,,,,,,,,3174164.0,188907.0,11987435.0,58380.0,,77380.0,,,,,,,,,,N,,89109.0,,188907.0,2986434.0,,,1938912.0,,1096562.0,,1627.0,,787662.0,8787553.0,,,4775062.0,,,521257137.0,1896206.0,,,2680542.0,8399706.0,,13913575.0,50523878.0,108637.0,1793476.0,9533128.0,410660.0,6404204.0,,7650.0,14327.77,716.0,68296.0,,147240.0,,2046833.0,1242039.0,,,114459.0,60.0,,,,,4035.0,,29.52,1523691.0,15201,,,,,,,360155,,,,2031444.0,789874.0,,501185.0,1903597.0,,315.0,,42636135.0,,29801.0,983045408.0,23026.0,,,,46441266.0,SOUTHWEST GENERAL HEALTH CENTER,1127782.0,,,,,,,,,211904.0,7255650.0,,,1311866.0,,,,,,688679.0,34.77,1245552.0,35.24,,,,11981720.0,,514379982.0,1863.16,,,,,,508482.0,,1071188.0,2423.0,32774623.0,12.22,96544.0,,,330615.0,27477.0,,949009.0,1584110.0,,4390495.0,,3880496.0,,,,,,,-20836.0,1346309.0,,,,,,,,7097288.0,OH,,,,405.0,,,,,,678146.0,3074273.0,45246.0,868819.0,,,-94122.0,,,,,,,,,181.0,,,,21141.0,,,21991127.0,,2297.0,,1267.0,17.55,945252.0,,,1839042.0,,,-25074.0,6434988.0,,,2521.0,,,,1820808.0,,7255650.0,,279976.0,1644919.0,,,,,,,,,,,,,,,,,,,,,,,4015468.0,2563.0,,3218413.0,,,,,,,,42063760.0,,992809.0,29830.0,,,,,,,,3235321.0,,,,,,3814.0,1096562.0,,8207094.0,,13266273.0,9304.0,,12445599.0,,,N,842825.0,,218486010.0,,15952.0,,,8901185.0,,,33.75,SWGHC MENTAL HEALTH SERVICES,,,,N,66940.0,,280990.0,36T155,,4742880.0,11237.0,,,900646.0,,33.99,156092.0,,,,,,,14009163.0,,3414.0,-6494.0,,,,,,7817429.0,,,1491007.0,,,1363450.0,,,3892940.0,1225709.0,,102526.0,,18738010.0,2423.0,12.2,639683.0,3650.0,,,,2573.0,5498022.0,,,,,,,,949009.0,-2875.0,26.6,,-641648.0,,,,14.85,,4685541.0,,,,,,,94527850.0,,77745.0,,,2521.0,,,,,,2014-10-23 00:00:00,,1271438.0,3133121.0,,,,640116.0,,25069.0,6344.0,,1258995.84,,25560785.0,,33.0,,,251154.0,16690863.0,201257.0,979.0,,N,28.79,461788271.0,1970612.0,,,,,,,,,75732.0,,,2880925.0,-39026.0,,,,-15760.0,,,,171051436.0,8207449.0,24120.0,,,1348.0,,,,,67566.0,,,,,,,4149252.0,,,,382177.0,,,,11545323.0,,5375577.0,,3091172.0,,,3880496.0,,,4350181.0,4035.0,1782450.0,,,2407153.0,,,,,,,,168001.0,,4046410.0,,3814.0,52857.44,1088.0,3893888.53,63350.0,,,60352.0,,460714359.0,109744.0,,38413222.0,,,,,,,23227.0,778857.0,,,,,6718585.0,,-80899.0,93885987.0,,108637.0,53830166.0,,72767.0,,333979.0,,,General Short Term,,,,4589831.0,,,,19569942.0,,,,,,,,,192559.0,2079832.0,1714.23,927022.0,,,31424087.0,,41.0,,11148663.0,2748.0,,4640448.0,6027096.0,,,18228630.0,2989291.0,8003317.0,12931429.0,,,,108240.0,,,538227.0,N,,,,,,,108240.0,1566.0,,,,,,1628277.0,,,,-5488.0,61350.0,,,3059.0,,464227.0,725233.0,,8436.0,,,,35360.0,,,,,256646581.0,,,,205237.0,,936446.0,,357726.0,4751.0,,,101204674.0,25995415.0,,250.0,,31.7,,,,,,,248.0,-21233.0,,,1538.0,22869828.0,340417.0,822115.0,212947.0,,,,,,,,,,270143.0,47528920.0,,98614.0,,220148833.0,,,18738010.0,,,,,,,,,18329393.0,,,,,8308031.0,,,2833126.0,,142749.0,,,,,3370162.0,,,,1092.0,246714.0,,,251610.0,,6969739.0,79360931.0,-5605223.0,,261815.0,,,2891890.0,,194668.0,2919870.0,,1465121.0,,15978778.0,,,878609.0,,10784758.0,31.72,,,,1259627.0,,,,6948963.0,1903597.0,,,,,,361530,,36889.76,,,,2891890.0,220.0,19.15,1297955.0,4015468.0,,2183927.0,,,44130-3497,,,731391.0,1521696.0,,,,,1245552.0,23227.0,,,,4759.0,6422882.0,1397336.0,,,3699827.0,,29225262.0,18697 BAGLEY ROAD,26.49,,,,,,,2011-01-01 00:00:00,9.0,1401651.0,,-2271113.0,1031962.0,,,9654.0,,79922.0,8568392.0,8037.0,,,4382.0,,,12851039.0,252946.0,62872148.0,,,,,,4382.0,6522443.0,,,,,6736780.0,,,,184204.0,12484536.0,,409453.0,,8688.0,505.0,,,2621598.0,,,,,,2029572.0,,,,380.0,,2660.0,,,787772.0,,,,2969161.0,,-3540.0,,,160801.0,,,,,51141.0,,,4217193.0,,,24895.0,51120175.0,,,,,,,,20.0,,,502334.0,367253,,8573005.0,,,,,,6347.0,15083827.0,,,,,2498139.0,,,114825.0,,,MIDDLEBURG HEIGHTS,,857036.0,,,,,,1627.0,,1403409.0,9543065.0,,,23152.0,,,,,,,,12546.0,4137481.0,20747.0,,,,,35558.0,,,,,,,,,,4710655.0,36838.0,,299693.0,1628.0,,,13570737.0,4685541.0,,,,,,6948963.0,535288.35,,,,,,44217.77,,,1.0,,3074273.0,,640116.0,,,,7982625.0,,,,,-15272.0,,,4018548.0,,,,,,,,,,,,-164011.0,,,,1.0,,,6408579.0,,545656.0,,,,,9436040.0,,,,,71575.1,7506786.0,,,368708.0,,,1309732.0,,,,34328337.0,,,3324354.79,,,16750.0,,28322450.0,,2116858.0,8563080.0,,,,,,,,,3370880.0,683992.0,,3135760.0,,,,,808683.0,,,,,,3165690.0,,,,426689.0,16042968.0,,,,,,,,,,,9543065.0,,,701039473.0,,,,N,1656796.0,,,,144936.0,,,,9323994.0,,,,,,4751.0,,,320034.0,,,,,190.0,5183372.0,,381625.0,,17971381.0,,,6852171.0,79922.0,,1543517.0,,,,,,1681935.0,10784758.0,,,22829.0,822115.0,-37749.0,,71612.0,,,,,,-50735.0,903.0,,,6935.0,1500.0,,,,Y,,,,,,,,,,326.0,956661.0,,,,1400569.0,18329393.0,,,39631.0,74932.0,,,,,,,82671.0,1903597.0,524025.0,,2002.0,-47157.0,,,,,202598035.0,,2135.0,,,3906.0,15181741.0,,47954.0,,17263287.0,3370880.0,,8.0,541985,,,,,2707585.0,,,,,183989.0,1323087.0,7376441.0,,,,69.53,,,,67751.0,,,122342.0,,455981.0,4050.0,,,8536613.0,2325614.0,38324890.0,,35759.0,A,,3133121.0,,,,,,5281800.0,809414.0,,211.0,,,,,6048652.0,,1465121.0,,,,32774623.0,592106.0,,,,,,17460,2011-12-31,77.27,,,,,,,,,,,,,36044962.0,,,,,-192379.0,,7300.0,,,,3135760.0,538227.0,2649745.0,,2046833.0,,,,,N,,,,1194707.0,45888564.0,,,779.0,,,,,,100894.0,15310725.0,,,N,,,1350032.0,-4933.0,,2711641.0,,,,,,117.0,,,,312575.0,14001647.0,,,,17536804.0,1.0,,1381003.0,2923306.0,14000555.0,,,,,,,,1323087.0,,,113711551.0,,41325.5,,,16398628.0,,,,,,,,50430257.0,1906.0,,,,108240.0,14810999.0,,,2868459.0,842825.0,,1112157.0,2029572.0,,-23274.0,,,,1461384.0,6562638.0,,,,1926474.0,,,,,,,,-1303752.0,,,,,,6932818.0,15.85,,,,2816208.0,,,,,,,,,2011,Acute Care Hospitals,SOUTHWEST GENERAL HEALTH CENTER (360155)
11318,SOUTHWEST GENERAL HEALTH CENTER (360155),General Short Term (Acute Care Hospitals),Voluntary Nonprofit-Other,-81.83291,41.37208,,,23.6,,,,,,,22216.0,-33820.0,,,,,,207.0,,,,,,,,,,,2545563.0,,,207.0,3747182.0,333530.0,25733027.0,6199.0,,,,9481.0,,,,232.0,,1760537.0,,3636751.0,,1247749.0,1046.0,,,2291876.0,,,4268111.0,3285932.0,,41442.0,,,136324.0,276131.0,,,,2392484.0,,,,4258251.0,,,-838844.0,167013.0,,,,,1787468.0,190603.0,,,3494451.0,121490.0,19807.0,,,10.0,,,,160.0,172920.0,,72757.0,,13.0,,4636.0,,,41.0,14072907.0,,,1166251.0,,6436060.0,,47837.0,,,,96040.37,14667803.0,,,,,,1876588.0,,20063817.0,,,,,,,,139182.0,274177.0,,,,,,1539.0,,,6222659.0,,,,,29746.0,,,,668.0,109045.0,,,,308853648.0,,12125282.0,4577333.0,51466.0,,14072907.0,3203787.0,,,6711.22,,376.0,6220.0,,N,766428.0,,,,3082252.0,,3790662.0,,,8244985.0,289150.0,,,-26178.0,,,,,,147560.0,,,392739.0,,174816199.0,,,4400632.0,,,1981925.0,,,,214940.0,,28650731.0,,,,66133.0,,223442.0,,,14088.0,,,21240006.0,3689059.0,105448969.0,,13802439.0,13176.0,,,5373945.0,,,,,,,,,79681.0,,,88938.0,,9459.35,88739.0,,109778.0,,,,252657301.0,172519.0,,,,,1675550.0,,14555001.0,3770221.45,26912.0,,,,,,,,102347.0,,,5811983.0,,,,34809.0,13856848.0,16096.0,178560057.0,,13656550.0,326645.0,,16919134.0,65414.0,,,8063973.0,1675550.0,-2810.0,2167098.0,498375.0,218605.0,,F,1921326.0,19225.0,10540969.0,25733027.0,,,,26616000.0,12682331.0,2134878.0,,,967908.0,42.0,,30698.0,,,,,,274177.0,,,,,,311653.0,,,20847.0,,11527290.0,230370.0,2429035.0,,,,,,,,,,16244.0,,78568.0,,,,,,911.0,88530.0,3442678.0,10.0,,-318992.0,29.64,,,2214631.0,21240006.0,50239.0,,,,1215366.0,91164336.0,,994969.0,,,2457365.0,19240243.0,917205.0,-159367.0,,,1 S ACUTE REHAB,5568126.0,11183.0,3122121.0,,44980.0,,9235872.0,,17545725.0,88530.0,,37.5,,17696850.0,,113539301.0,26256612.0,,,62877.25,,,,,,,,,332543.0,,,,523130.0,,,52099.0,,,4710663.0,,,,,,37783902.0,,,,,8561555.0,,24154.0,137703.0,,1329.0,,,,,,,8580.0,,,24988097.0,,992985.0,15.52,,,1570562.0,,,,,12609.0,6222659.0,21749.0,,72155.03,,226714794.0,,,,,521.0,1811.0,,,,,9.0,19.0,,4758.0,,254265.0,1793823.0,-617047.0,N,,,,,,,,,115668.0,16.0,,5724.0,12633130.0,24988097.0,,,3400185.44,,,,,,,,,1158656.0,24154.0,2875572.0,,1133.0,2006813.0,,,,,,238.0,1279935.0,,,311692739.0,,6.0,,,,252657301.0,N,28.4,,,,,4713930.0,5400342.0,,,,,,,-14252943.0,,,14560833.0,,,,,,14186.0,3016455.0,,,295862963.0,,,218605.0,,79853.0,,22.74,,,,111498.0,,,26487672.0,1304895.0,,363017.0,21749.0,,,19225.0,16096.0,,16.7,,,,,,,36001.0,,716510.0,,,1543894.0,,,2516636.0,-774873.0,,102123416.0,,,,,117506.0,16340824.0,,4636.0,,18083.0,,254980.0,7238.0,,,,,,,,-255725.0,,,,4455.36,,,1536.0,P,,29.85,,83457425.0,,,159134.0,75762.0,145.53,,,-9049.0,,440549.0,,,,,,319.0,1662047.0,1357.0,,,16520.0,,419919.0,,,278128656.0,-1171.0,,2894.0,,119934210.0,,,,54284081.0,,,,20758.0,1981925.0,,13434596.0,1064006838.0,2483281.0,,,,,,,37001.0,,,,11423812.0,,,,388384.0,,,6276405.0,-1136611.0,5835901.0,,258181.0,1539.0,34809.0,88615.0,,,,,,,,,15343394.0,1022267.0,,,,,63426.0,,,,,,7134712.0,,4836984.0,,69165.0,111498.0,421788.0,31783856.0,,,101527998.0,11008718.0,167865.0,1713105.0,,,,,,623204.0,,3374.0,4201877.0,,,,769697.0,,2866311.0,1176456.0,,,,,740318.0,,,,,,,,6894191.0,,543094.0,,,,,,,,,580219.47,809.0,,,703165.0,,,50959.64,,,1378911.0,,,,97336.0,2087194.0,,645205.0,,,544116.0,2214631.0,,,,,,,,,105010164.0,,740318.0,9232741.0,,,4248624.0,,,14673.0,,,,1469019.0,,,,,,14276.0,,,102123416.0,,,,,1262.0,388384.0,,,,2,,,,,,,,,,2269.0,,,,,,3448355.0,,122.0,21746.0,,,,1571.0,3448355.0,460276.58,,23118274.0,45265788.0,,,,,,167.0,6225.0,,,,1389715.0,8831183.0,2209398.0,5724.0,,,,3016455.0,1787468.0,,,992985.0,21124195.0,,,,222986.0,,,7208692.0,,-277745.0,,34448354.0,CUYAHOGA,,695601.0,,1036213.0,326645.0,1279935.0,,5400342.0,,,,,4359.0,,,,,,802240.0,,4906531.0,,,,1383.0,,,,,,,,,,,3403230.0,,8990110.0,,,,,,,,,,25758767.0,-1669024.0,Y,,,91175659.0,,,1985757.0,5856.0,,,,12004884.0,69504.0,13642964.0,,,,,21124195.0,,,700725.0,,,438016377.0,,,,,,,,5316403.0,,10087586.0,,-54023.0,0.212545,381.0,,34380.0,N,64434522.0,102371498.0,887764.0,14374290.0,,,,107.0,,N,-9160.0,,,,,264243.0,,4353.0,39500.44,,,,,,,,2968.0,,,48425376.0,,9481.0,,2924617.0,,,,,,2269.0,3643345.0,1652930.0,,2214854.0,,,,8017455.0,7313141.0,,,,209.0,,,,116212.0,,,1816502.0,1674214.0,,,2356238.0,,6087.0,70720652.0,,,,,7313141.0,621024.0,7172946.0,-57614.0,9134161.0,7787755.0,,18216045.0,,1627773.0,3900117.0,,2609.0,2110997.0,752421.0,,4410878.0,,,,,41063.03,1610599.0,176.0,445.0,2402150.0,,,,,,,,,,4555447.0,,-5647247.0,,,111498.0,,,,,627691.0,9077573.0,899625.0,1837.0,18566441.0,3656.0,,,34448354.0,,,,,,3057019.0,,,,,,296.0,,,,,,,,7314.13,,,,,1469019.0,,365919,,,1814697.0,,,,,,13845828.0,,,,3290823.0,,,-56872.0,Y,,,,8187809.0,494.0,,,,1469019.0,31364647.0,2419261.0,,,,1653498.0,,-24199425.0,,3938304.0,,,,4143.0,,2892168.0,,,1200.0,,,,9131437.0,,,,,,,,23.86,203883.0,9926.0,63471.0,3614583.0,251095.0,,,,514.0,,,,46643.0,,-14252943.0,-5875.0,,111498.0,1533317.0,,2419261.0,1479284.0,4056510.0,,45485.0,,,,,,,47148.0,75794.0,161137386.0,,125617128.0,,,,,,,1978331.0,,,143688.0,4234833.0,28952719.0,,,,,,,,,,3459.0,,5056.0,,,,,,,,,701772.0,93697.0,1620651.0,,276878991.0,61742401.0,1120.0,-37393.0,,,,,2743546.0,31670.19,,1179113.0,,17544186.0,,,,368178.0,,13586423.0,,,,,101527998.0,116212.0,,,,,119922887.0,3947665.0,36.0,,,,36S155,,,N,,,1876588.0,,,,,7786.0,,,,24988097.0,,28650731.0,3206161.0,1169158.0,164786828.0,2176142.0,-118240.0,,,,,,,,,,,,,,11735180.0,,,,,1325395.0,,,,,,-53846.0,3794097.0,,,,27.15,5832.0,,1272091.0,-250201.0,,,2483281.0,,,,,,,226149721.0,,,,,,,,,,,51.0,6276405.0,,,-16291.0,484.0,82.0,,4579621.0,,9488.0,26.82,,685736.0,327460.0,5794110.0,,,,,,26.45,519531.0,,,8602.0,1528555.0,9349.0,,,,,,,,,13400871.0,4906531.0,14088.0,,3568819.0,421789.0,562934.0,45.02,,,,,,,,,,,3118304.0,158418.0,13096183.0,60545.0,,75762.0,,,,,,,,,,N,,83146.0,,158418.0,2698709.0,,,3747182.0,,1080866.0,,,,806042.0,9131437.0,54.11,,4530284.0,,,579748378.0,1876588.0,,,2756381.0,8561555.0,,17799553.0,54000224.0,121383.0,2090154.0,10986622.0,368178.0,7306152.0,,6660.0,28427.88,368.0,70078.0,,125492.0,,2292965.0,1380155.0,,,121490.0,193.0,,,,,4011.0,,27.41,1627031.0,15201,,,,,,,360155,,,,2167758.0,842835.0,,456734.0,1987266.0,,286.0,,43099550.0,,29431.0,1072670688.0,25209.0,,,,46982704.0,SOUTHWEST GENERAL HEALTH CENTER,1166251.0,,,,,,,,,260506.0,7255650.0,,,1192821.0,,,,,,630890.0,35.27,1385039.0,35.98,,,,11768320.0,,572814230.0,1815.96,,,,,,498375.0,,1217428.0,2413.0,34448354.0,12.29,82777.0,,,324335.0,18343.0,,904092.0,1513676.0,,4375675.0,,3749934.0,,,,,,,-21609.0,1351478.0,,,,,,,,7355800.0,OH,,,,,,,,,,445496.0,3770454.0,45354.0,826296.0,,,-4756.0,,,,,,,,,2069.0,,,,18061.0,,,25017868.0,,1213.0,,1034.0,18.21,899452.0,1582678.0,,1989501.0,,,-236570.0,7313141.0,,,2263.0,,,,1701506.0,,7255649.0,,279926.0,1773683.0,,,,,,,,,,,,,,,,,,,,,,,4112284.0,3629.0,,3254181.0,,,,,,,,44466000.0,,1176456.0,36384.0,,,,,,,,2960558.0,,,,,,3789.0,1080866.0,,8497046.0,,13656550.0,,,12946376.0,,,N,976696.0,,226462681.0,,29746.0,,,9048049.0,,,35.82,SWGHC MENTAL HEALTH SERVICES,,,,N,52254.0,,300117.0,36T155,,5496944.0,20461.0,,,819456.0,,33.69,145353.0,,,,,,,14560833.0,,689.0,-67387.0,46.0,,,,,8187809.0,,,1544182.0,,,116212.0,,,,1341289.0,,94815.0,,19799128.0,2413.0,12.1,623204.0,3660.0,,,,8427.0,11533010.0,,,,,,,,904092.0,-1787985.0,27.69,,-4635847.0,,,,13.26,,4911916.0,,,,,,,94785291.0,,76666.0,,,2263.0,,,,,,2015-06-23 00:00:00,,1247749.0,2320954.0,,,,567419.0,1582678.0,24154.0,6220.0,,1227972.58,,25758767.0,,9.0,,,284824.0,18872355.0,182581.0,809.0,,N,34.49,492922310.0,1919512.0,,,,,,,,,88530.0,,,3301759.0,-3885.0,,,,-7103.0,,,,226714794.0,8497401.0,37824.0,,,2389.0,,,,,63051.0,,,,,,,3775506.0,,,,358941.0,,,,12125282.0,,5878619.0,,3455360.0,,,3749934.0,,,4480964.0,4011.0,1816502.0,,,2438490.0,,,,,,,,155765.0,,4064030.0,,3789.0,47380.39,,3915400.03,90555.0,,,63709.0,,491192608.0,98384.0,,41817979.0,,,13770.0,,,,24145.0,773963.0,,,,,6586828.0,,-72732.0,105696995.0,,121383.0,60347559.0,,82555.0,,335784.0,,,General Short Term,,,,4754361.0,,,,20370249.0,,,,,,,,,163000.0,2006813.0,1657.67,965819.0,,,32483352.0,1582678.0,47.0,,11379160.0,2570.0,,4858653.0,6287237.0,,,19541951.0,2721374.0,9060576.0,13802439.0,,,,111498.0,,,511608.0,Y,,,,,,,111498.0,773.0,,,,,,1760537.0,,,1541.0,-7436.0,60956.0,,,2894.0,,464997.0,740318.0,,3444.0,,,,14415.0,,,,,266910244.0,,,,233513.0,,811890.0,,363017.0,15239.0,,,104762082.0,24988097.0,,238.0,,48.24,,,,,,,243.0,-21785.0,,,,19194291.0,354055.0,,217734.0,2454.0,,,,,,,,,258268.0,47610432.0,,96347.0,,228891716.0,,,19799128.0,,,,,,,,,21100537.0,,,,,8100030.0,,,2895563.0,,176097.0,,,,,3621439.0,,,,548.0,,,,227139.0,,15901416.0,92484123.0,-6833368.0,,266572.0,,,3016455.0,,202395.0,3045565.0,,1465326.0,,22043755.0,,,945086.0,,11056499.0,33.03,,,,1348451.0,,,,6864215.0,1987266.0,,,,,,361530,,148198.0,,,,3016455.0,160.0,20.36,1410142.0,4112284.0,,2211471.0,,,44130-3497,,,703165.0,1634336.0,,,,,1385039.0,24145.0,,,,2231.0,6323897.0,1541243.0,,,3430287.0,,31621505.0,18697 BAGLEY ROAD,27.33,,,,,,,2012-01-01 00:00:00,1.0,1315830.0,,-4314939.0,1108038.0,,,2918.0,,81451.0,8568392.0,7318.0,,,,,,14740150.0,243239.0,69248741.0,,,,767601.0,,,7134712.0,,,,,6696700.0,,,,171893.0,13578816.0,,396385.0,,11060.0,514.0,,,2344644.0,,,,13932.0,,2286603.0,,,,107.0,,2737.0,,,876318.0,,,,2922645.0,,-2810.0,,,154876.0,,,,,-111512.0,,,5373945.0,,,21984.0,58354886.0,,,,,,,,20.0,,,506050.0,367253,,8244985.0,,,,,,214940.0,15774709.0,,,,,2419261.0,,,122174.0,,,MIDDLEBURG HEIGHTS,,823978.0,,,,,,,,1061909.0,9751440.0,,,18536.0,,,,,,,,10270.0,3940230.0,37001.0,,,,,40333.0,,,,,,,,,,4861478.0,37561.0,,238283.0,1811.0,,,14289977.0,4911916.0,,,,,,6864215.0,548549.28,,,,,,65004.88,,,1.0,,3770454.0,,567419.0,,,,7414602.0,,,,,3561.0,,,3947665.0,,,,,,,,,,,,-327440.0,,,,17.0,,,8017455.0,,494136.0,,,,,10195950.0,,,,,71764.89,8098694.0,,,368708.0,,,1151823.0,,,,32537704.0,,,3335180.56,,,14101.0,,31692906.0,,2291876.0,8568392.0,,,,,,,,,3669960.0,587685.0,3399.0,3208339.0,,,,,479461.0,,,,,,3494451.0,,,,424205.0,17314310.0,,,,,,,,,,,9751440.0,,,776807725.0,,,,N,1654482.0,5835171.0,,,129106.0,,,,32451505.0,,,,,,15239.0,,,280493.0,,,,99134.0,,5732658.0,,353318.0,,18593189.0,,,9134161.0,81451.0,,1791471.0,,,,,,1472416.0,11056499.0,,,21749.0,,-22694.0,,73484.0,,,,,,-50068.0,450.0,,,6954.0,1539.0,,,,Y,,,,,,,141.0,,,321.0,986557.0,,,,1284300.0,21100537.0,,,58705.0,63426.0,,,,,,,60299.0,1987266.0,562934.0,,1695.0,-43640.0,,,,,245677151.0,,3043.0,,,6049.0,14936825.0,,47837.0,,17086128.0,3669960.0,1582678.0,10.0,556832,,,,,2621649.0,,,,,414321.0,1304895.0,7962288.0,,,,58.0,,,,68101.0,,,124512.0,,430384.0,7238.0,,,7208692.0,2381592.0,38568760.0,,35252.0,E,,2320954.0,,,,,,5363659.0,753088.0,,209.0,,,,,10113557.0,,1465326.0,,,,34448354.0,523130.0,,,,,,17460,2012-12-31,68.25,,,,,,,,,,,,,50164197.0,,,,,-156656.0,,7320.0,,,,3208339.0,511608.0,2816601.0,,2292965.0,,,,,N,,,,1147293.0,54147710.0,,,,,,,,,93697.0,15181741.0,,,N,,,1427879.0,-7308.0,,2627243.0,,,,,,92.0,,,,394178.0,14672507.0,,,,17603047.0,1.0,,1233414.0,2924617.0,14671959.0,,,,,,,,1304895.0,,,122778037.0,,40651.9,,,20063817.0,,767601.0,,,,,,65102430.0,1525.0,,,,111498.0,14557476.0,,,3923983.0,976696.0,,1109194.0,2286603.0,,-31281.0,,,,1574040.0,7124430.0,,,,1056495.0,,,,,,,,-2394.0,,,,,,7787755.0,14.94,,,,2959520.0,,,,,,,,,2012,Acute Care Hospitals,SOUTHWEST GENERAL HEALTH CENTER (360155)
17419,SOUTHWEST GENERAL HEALTH CENTER (360155),General Short Term (Acute Care Hospitals),Voluntary Nonprofit-Other,-81.83291,41.37208,,,24.02,,,,5276151.0,,,26323.0,-33819.0,,1072.0,,,,202.0,,,,468923.0,,,,,,477255.0,3762726.0,,,202.0,16188044.0,299137.0,20152905.0,19376.0,,,,8959.0,5675166.0,,,134.0,,1735377.0,,4935965.0,,1281283.0,1149.0,,,1847678.0,,,4424673.0,3098620.0,,66443.0,,,125069.0,396857.0,,,,2349237.0,,,,3936055.0,,,-913232.0,158053.0,,,,,1784404.0,192261.0,,,3934413.0,148576.0,15359.0,,,18.0,,,,114.0,241176.0,,55873.0,,12.0,,4761.0,,,334.0,3580498.0,,,1294184.0,,8084770.0,,47308.0,,,,106840.18,16249250.0,,,,,,2301383.0,,16980228.0,,,,,,,,121721.0,238115.0,,,,,,1430.0,,,6492762.0,,,,,26218.0,,,,1374.0,71035.0,,,,321007882.0,,10696048.0,4245967.0,51829.0,,19353157.0,3019157.0,,,10769.66,1533546.0,17410.0,6305.0,,N,899163.0,,,,3089796.0,,4358634.0,,,7629395.0,416866.0,,,-191016.0,,,,,,206961.0,,,530561.0,,178560057.0,,,5322329.0,,,2029185.0,,,,216598.0,,28151321.0,,,,89545.0,,405241.0,,,14136.0,102720.0,,22998767.0,4721140.0,113539301.0,,13996166.0,13140.0,,,4685113.0,,,,,,,,,126142.0,,,86870.0,,4734.75,85928.0,,143599.0,-75545.0,,,257533923.0,205782.0,,,,,1791280.0,,16401332.0,3880782.5,25992.0,,,,,,,,116919.0,1669.0,,6149356.0,,,,33187.0,30270617.0,14717.0,180605253.0,,13664513.0,251597.0,,13214371.0,47280.0,,,7306183.0,1791280.0,-6281.0,7075232.0,623824.0,279446.0,,F,2046244.0,16975.0,14992568.0,20152905.0,,,,23924673.0,12852580.0,2398278.0,3195957.0,,986672.0,42.0,,28283.0,,,,,,238115.0,,,,,,311972.0,,,5543.0,,,385315.0,3115557.0,,,,,,,,,,19567.0,,2824685.0,,,215774.0,,,894.0,87910.0,14963368.0,10.0,,-706343.0,28.55,,,2339647.0,22998767.0,4266.0,,,,1146049.0,95636773.0,,1163825.0,,,2931554.0,20869145.0,957154.0,-165679.0,,,1 S ACUTE REHAB,5425794.0,10737.0,3514307.0,,40688.0,,9880642.0,,20143606.0,87910.0,,,,15916157.0,,108304066.0,22052760.0,,,75109.97,,,,,,,,,515314.0,,,,920476.0,,,72739.0,,,4980260.0,,,,,,22052760.0,,,3163.0,,9528324.0,,24910.0,112353.0,,1538.0,,,,,,,4908.0,,,23633263.0,,1082375.0,15.41,,,1521813.0,,,,,13076.0,6492762.0,20835.0,,71006.99,,191910886.0,,,,,506.0,,,,,,2223.0,15.0,,4380.0,,1111855.0,1102978.0,-702189.0,N,,,,,,,,,3153.0,16.0,,5571.0,13091335.0,23633263.0,,7065360.0,3471949.5,,,,,,,,,1286256.0,24910.0,2924557.0,,1125.0,1755171.0,,,,,,175.0,971661.0,,,324864691.0,,9.0,,,,257533923.0,N,28.67,,,,,4378812.0,5071042.0,,,,,,,-19898478.0,,945014.0,16415378.0,,,,,,19680.95,2991379.0,,,282970843.0,,,279446.0,108555.0,117445.0,,22.9,,,,104170.0,,,23791384.0,1734107.0,,425765.0,20835.0,,,16975.0,14717.0,,14.51,,436402.0,,,,,42763.0,,476334.0,,,7004574.0,,,-2301773.0,-828653.0,,106267631.0,,,,,193726.0,15286492.0,,4761.0,,15977.0,,304035.0,,,,,,,,,-246868.0,,,,4420.17,,,6900.0,P,,30.64,,25456893.0,,,258199.0,73730.0,139.69,,,-5024.0,,601833.0,,,,,,,1452376.0,952.0,,,9447.0,,106245.0,,,301768714.0,-312.0,,2946.0,,121029832.0,,,,58527245.0,,,,24107.0,2029185.0,,13953160.0,1136001959.0,940213.0,,,,,5675166.0,,77114.0,,,,-1410713.0,,,,350253.0,,,6307732.0,-903051.0,6186929.0,,253066.0,1430.0,33187.0,76459.0,,,,,,,,,15740309.0,1075891.0,,,,,100323.0,,,,,,8244057.0,,-1410713.0,,66011.0,104170.0,421788.0,28885921.0,,,120009359.0,10027069.0,298040.0,1737124.0,,,,,,40867.0,,3202.0,3776843.0,1.0,,,743776.0,,3137812.0,1879183.0,,,,,792719.0,,,,,,,,20559296.0,,529228.0,,,,,,,,,580875.5,1112.0,,,596441.0,,,56180.15,,,1566204.0,,,,123666.0,2533754.0,238.0,656305.0,,,538798.0,2339647.0,,,,,,,,,109733946.0,,792719.0,9527051.0,,,3911463.0,,,13163.0,,,,1457255.0,,,,,,16932.0,,,106267631.0,,,,,942.0,350253.0,,,,2,,,,,,,,,,2211.0,,,,72145.0,,4080467.0,,1184.0,11639.0,,,,6921.0,4080467.0,479243.41,,17107619.0,44424899.0,,,,,,153.0,4739.0,,,,277328.0,16514318.0,2958910.0,5571.0,7156842.0,,,2991379.0,1784404.0,,,1082375.0,20168654.0,,,,214704.0,,,3322184.0,,-291896.0,,35716863.0,CUYAHOGA,,684876.0,,1077899.0,251597.0,971661.0,,5071042.0,,,,,4610.0,,,,,,838490.0,,5028288.0,,,,2577.0,,,,,,250582.0,,,,,3844712.0,,102885.0,,,,,,,,,,25909216.0,-1688742.0,Y,,,95484695.0,,,2251996.0,5840.0,,,,12954153.0,74932.0,13684307.0,,,,,20168654.0,,,722151.0,,,469648855.0,,,,,,,,4576304.0,,10612534.0,,-30804.0,0.204758,356.0,,28003.0,N,56288473.0,106757560.0,1008961.0,13697219.0,,,,27426.0,,N,-12554.0,,,,,300780.0,,,49832.14,,,,,-3855261.0,,3.0,3104.0,,,48993140.0,,8959.0,,3249702.0,,,,,,2211.0,2590299.0,1844613.0,,2173759.0,,,,9032738.0,7272629.0,,,,230.0,,,,65062.0,,,2190293.0,1942792.0,,,2004526.0,,12573.0,70593334.0,,,-55563.0,,7272629.0,623107.0,8156987.0,-56925.0,10281036.0,8238671.0,,17440238.0,,3090413.0,5953060.0,,2760.0,1647655.0,945946.0,,4083290.0,,,,,38551.0,1675901.0,159.0,413.0,2672426.0,,1026010.0,,,,,,,,4315649.0,,-9872972.0,,,104170.0,,,,,204940.0,9264939.0,2280458.0,2170.0,20767616.0,4830.0,,,35716863.0,,,,,,3052454.0,,,,,,271.0,,,,,,,386.0,7232.25,,,,,1457255.0,,365919,,,1675828.0,,,,,,14097173.0,,,,3253977.0,,,-182348.0,Y,,,,8195843.0,673.0,,,,1457255.0,34639644.0,2355356.0,,,,1657562.0,,-23957495.0,,5247470.0,,,,9129.0,,3297292.0,,,1440.0,,,,8371281.0,,,,,,,,24.27,292211.0,12434.0,52424.0,3768834.0,88232.0,,,,542.0,,,,53157.0,,-19898478.0,2526.0,,104170.0,874265.0,,2354343.0,1640031.0,4415028.0,,38554.0,21279369.0,,,,,,5680.0,80463.0,211497773.0,,124539816.0,,,,,,,2103527.0,,,195236.0,3698179.0,5538442.0,,,,,,,,,,3835.0,,1523.0,,,,,,,,,2865552.0,83167.0,159127.0,,258151082.0,69669834.0,1089.0,-45392.0,,,,,3213956.0,31430.43,,1082184.0,,20142176.0,,,,433888.0,,13759322.0,,,,,120009359.0,65062.0,,,,,121181910.0,3633368.0,36.0,,,,36S155,,,N,,,2301383.0,,,,,207.0,,,,23633263.0,,28151321.0,2375823.0,1252250.0,171164770.0,2938107.0,-17685.0,,,,,,,,,,,,,,12804431.0,,9.0,,,1353794.0,,,,,,-51674.0,2049462.0,,,,27.51,14046.0,,1302561.0,-445387.0,,,940213.0,,,,,,,232605576.0,,,,,,,,,,,29.0,6307732.0,,,-11883.0,468.0,63.0,,4990747.0,,20926.0,27.26,,559233.0,369560.0,5299920.0,,,,,,27.29,513808.0,,,8505.0,1407199.0,,,,,,,,,,13921792.0,5028288.0,14136.0,,3652678.0,421789.0,734656.0,47.21,,,,,,,,,,2074826.0,3048195.0,185407.0,13264478.0,44441.0,,73730.0,,,,3834771.0,,,,,,N,,79071.0,,185407.0,2423264.0,,,16188044.0,5907089.0,952106.0,,,18772.0,1140975.0,8371281.0,55.09,,4372049.0,,,635828084.0,2301383.0,,,2506213.0,9528324.0,,17435279.0,59695236.0,121150.0,2123579.0,12496221.0,433888.0,7270516.0,,8686.0,20579.75,1719.0,72063.0,,110576.0,,2371833.0,1592363.0,,,148576.0,,,,,,3861.0,,24.71,1524159.0,15201,,,,,,,360155,,,,2219753.0,815703.0,,396245.0,1957958.0,,273.0,,43394768.0,,23543.0,1144289855.0,41367.0,,,327823.0,52617416.0,SOUTHWEST GENERAL HEALTH CENTER,1294184.0,,,,,,546649.0,4120.0,,228713.0,7255650.0,,,1547238.0,,,,,,590487.0,34.9,1371125.0,36.46,,,,12830270.0,,629097249.0,1865.62,23.0,,,,,623824.0,,1376314.0,2163.0,35716863.0,13.74,56480.0,,81915.0,442443.0,26024.0,,906742.0,1556548.0,,4603972.0,1569062.0,3484516.0,,,,,,,-24802.0,1435661.0,,,,,,,,6914203.0,OH,,,,,,,,,,408299.0,1911874.0,41410.0,1116842.0,,,29904.0,,,,,,,1582678.0,,5471.0,,,,16794.0,,,24895096.0,,9129.0,,1264.0,19.19,901180.0,3036715.0,33656.0,2479257.0,,,-1165837.0,7272629.0,,,2236.0,,,,1290652.0,,7147094.0,,383080.0,1445807.0,,1026010.0,,,,,,,,,,,,,,,,,,,,468923.0,4251486.0,4521.0,,1302874.0,,,26021200.0,,,,-14278.0,46987586.0,,1879183.0,7238.0,,,,,,,,2708703.0,,,,,,3474.0,952106.0,,8501701.0,,13664513.0,2788026.0,,13195993.0,,,N,1504367.0,,232927384.0,,26218.0,,,10044874.0,,,38.91,SWGHC MENTAL HEALTH SERVICES,,,,N,62462.0,,249530.0,36T155,,5861794.0,46823.0,,,863701.0,,33.66,122691.0,,,,,,,16415378.0,,2961.0,-54804.0,51.0,,,,,8195843.0,,,1563854.0,,,65062.0,,,3939224.0,1496538.0,,84193.0,,28021926.0,2163.0,12.16,70658.0,3650.0,,,62016.0,11637.0,8128194.0,,,,,,,,906742.0,-2154207.0,28.04,,-630350.0,,,,14.5,,4459471.0,,,,,,,89971065.0,,80836.0,,,2236.0,,,,,,2016-04-19 00:00:00,,1281283.0,3389994.0,,,,529779.0,3019456.0,24910.0,6305.0,,1270331.19,,25909216.0,,2223.0,,,304776.0,20614556.0,211493.0,1112.0,,N,45.09,508461771.0,1901868.0,,,,,,,,,87910.0,,,13994825.0,-26599.0,,,,-627.0,,,,191910886.0,8502056.0,25823.0,,,1044.0,,,,,99943.0,,,,,,,3592133.0,,,,338240.0,,,,10696048.0,,6854865.0,,3895531.0,,7065360.0,3484516.0,,,4639733.0,3861.0,2190293.0,,,2977260.0,,,,,,,,148473.0,,3612210.0,,3474.0,40537.2,4917.0,4025007.25,122798.0,,,72886.0,,506904710.0,132702.0,,21504323.0,,,,,,,22687.0,810254.0,,,,,,,-91754.0,111032056.0,,121150.0,61631988.0,,76713.0,,281696.0,,-4472.0,General Short Term,,,,4896608.0,,,,19958231.0,,,817034.0,,,,,10188.0,161739.0,1755171.0,1701.88,967075.0,,,34667176.0,4619393.0,30.0,,11936111.0,2368.0,,4791572.0,1749032.0,,,22425399.0,2730643.0,9693939.0,13996166.0,,,,104170.0,,,474782.0,Y,,,,,,,104170.0,644.0,,,,1109058.0,,1735377.0,,,2161.0,-2788.0,60610.0,,73568.0,2946.0,,394743.0,792719.0,,6383.0,1431924.0,,,32096.0,,,,,277432401.0,,,,225191.0,,822566.0,,425765.0,19165.0,,,109244017.0,23633263.0,,175.0,,49.0,,,,,,,238.0,-26845.0,,,1825.0,12107102.0,290434.0,,181989.0,,,,,,,,,,222858.0,47193932.0,,96689.0,,236042941.0,,,28021926.0,,,,,,,,,18899159.0,,,,,9677546.0,,,2627934.0,,160726.0,,,,,4098827.0,,,,232.0,,,,222093.0,,13118003.0,79149709.0,-6994813.0,1550193.0,258099.0,,,2989553.0,,196519.0,3015229.0,,4179889.0,,26120530.0,,,1003030.0,,12789659.0,34.8,,,,1339498.0,,,,258314.0,1957958.0,,,,,,361530,,148715.87,,,,2991379.0,114.0,20.52,1469103.0,4251486.0,,2170205.0,,,44130-3497,,,596441.0,1827689.0,,,,,1371125.0,22687.0,,,,4354.0,1749032.0,1223517.0,,,1903985.0,,26903976.0,18697 BAGLEY ROAD,27.77,3834771.0,,,,,,2013-01-01 00:00:00,,1589660.0,,-4415841.0,1476626.0,,,7401.0,,81153.0,8568392.0,7320.0,,,,,,14057682.0,228313.0,51225588.0,,,,1084226.0,,,8244057.0,,,,,6456843.0,,,,205177.0,13946430.0,,478155.0,,1248.0,542.0,,,2769033.0,,,,7068.0,,2441478.0,,,,27426.0,,3878.0,,,920119.0,,,,2820089.0,,-6281.0,556818.0,,139097.0,,,,,91841.0,,,4685113.0,,,33880.0,73822328.0,,,,,,,,20.0,,,630233.0,367253,,7629395.0,,,,,,216598.0,17191627.0,,,,,2355356.0,,,106899.0,,,MIDDLEBURG HEIGHTS,,811540.0,,,,,,,,1793844.0,4303947.0,,,19241.0,,,,,,,,6504.0,4012520.0,77114.0,,,,,29849.0,,,,,,,,,,4503023.0,38220.0,,189479.0,228.0,,,14990652.0,4459471.0,3285.0,,,,,258314.0,549445.07,,,,,,27817.75,,,1.0,,1911874.0,,529779.0,,,,6414977.0,,,,,2843.0,,,3633368.0,,,,,,,,,,,,-80385.0,,,,9.0,,,9032738.0,,626973.0,,,,,34554121.0,,,,,69828.87,7229484.0,,,368708.0,,,1221795.0,,,,31088935.0,,,3444131.75,,,20375.0,29791.0,26086543.0,,1847678.0,8568392.0,,,,,,,5840976.0,,4009875.0,776828.0,,2984797.0,,,,,628698.0,,,,,,3934413.0,,,,415818.0,17335249.0,,,,,,,,,,,4303947.0,,,861319012.0,,,,N,1983996.0,12893738.0,,,120028.0,,,4947.0,90278619.0,,,,,,19165.0,,,185743.0,,680557.0,,177463.0,,5630542.0,,519346.0,,20810413.0,,,10281036.0,81153.0,,1752628.0,,,,,,1551224.0,12789659.0,7156842.0,,20835.0,,-15662.0,,79745.0,,,,,,-46696.0,,,,5475.0,1430.0,,,,Y,,,,,,,,,,311.0,1059419.0,,,,1556237.0,18899159.0,,,53830.0,100323.0,,,,,,,92773.0,1957958.0,734656.0,,1558.0,-67710.0,,,,,211490095.0,,9013.0,,,4373.0,13824970.0,,47308.0,,16025530.0,4009875.0,3036715.0,17.0,573904,,,,,2546097.0,,,,,537094.0,1734107.0,6837172.0,,,,68.73,,,,66564.0,,,127186.0,,461203.0,,,,3322184.0,2281946.0,38103795.0,,33712.0,D,,3389994.0,,,,,,5307602.0,783331.0,,230.0,,,,,6750727.0,,4209680.0,,,,35716863.0,920476.0,,,,,,17460,2013-12-31,129.9,,,,,,,,,2543.0,,,,66240196.0,,,,,-229481.0,,7300.0,,,15778820.0,2984797.0,474782.0,3070545.0,817034.0,2371833.0,,284.0,,,N,,,,1169907.0,59477029.0,,72145.0,,,,,,,83167.0,14936825.0,,,N,,,1353963.0,-8898.0,,2548209.0,,,,,,60.0,,,,459683.0,16595058.0,,,,19135038.0,1.0,,1662536.0,3249702.0,16594826.0,,,,,,,,1734107.0,,,121700725.0,,41317.58,,,16980228.0,,1084226.0,,,,,39153.0,77909076.0,1613.0,,,,104170.0,14358024.0,,18532133.0,5000517.0,1504367.0,,1132489.0,2441478.0,,-195295.0,,,,1268674.0,7414252.0,,,,1868504.0,,,,,,,,-27377.0,,,,,,8238671.0,15.73,,,,3029598.0,,,,,,,,2218463.0,2013,Acute Care Hospitals,SOUTHWEST GENERAL HEALTH CENTER (360155)
24422,SOUTHWEST GENERAL HEALTH CENTER (360155),General Short Term (Acute Care Hospitals),Voluntary Nonprofit-Other,-81.83291,41.37208,,,24.12,,,,5470079.0,,,40018.0,-33820.0,,,,,,201.0,2.0,,,586527.0,,,,196.0,,552339.0,6596151.0,,,201.0,11570378.0,455092.0,20458388.0,3875.0,,,,8608.0,6465474.0,,,272.0,,1869992.0,,6427257.0,,1496840.0,2159.0,,,1992196.0,,,4639675.0,3513255.0,,82798.0,7.0,,194070.0,448117.0,,,,2201299.0,,,,3821489.0,,,-945275.0,410901.0,,,,,1778542.0,1161302.0,,,4001783.0,158791.0,16023.0,,,10.0,,,,64.0,72583.0,,138352.0,,12.0,,1685.0,,,43.0,9383726.0,,,1401857.0,,7226003.0,,48006.0,,,,104744.08,18646200.0,,,,,,2445682.0,,17043908.0,,,,,,,,118035.0,254411.0,,,,,,10829.0,,1.0,2266780.0,,,,,3569.0,,,1709328.0,2218.0,114793.0,,,,317937841.0,,11385920.0,2764179.0,53872.0,,25288354.0,3052292.0,,,7483.62,1542000.0,48617.0,8810.0,,N,1126015.0,,,-200.0,3431328.0,,4814359.0,,755418.0,7399337.0,424020.0,,,-7196.0,,,,,,418545.0,,,581625.0,,180605253.0,,,5861271.0,,,2175869.0,,,,213294.0,,28236937.0,,,,86135.0,,408356.0,,,14236.0,134156.0,,26565375.0,4819562.0,106704127.0,,13852427.0,13140.0,,,5027611.0,,,,,,,,,125701.0,,,86870.0,,4648.0,111093.0,,152043.0,-10747.0,,,278332308.0,295105.0,,,,,1605871.0,,18860327.0,3842447.91,25018.0,,,28191.0,,,,,147388.0,1561.0,,6937241.0,,,,31291.0,18892546.0,16093.0,274332001.0,,14471258.0,390435.0,,126526770.0,47848.0,,,6882557.0,1605871.0,-1920.0,13310365.0,560810.0,299706.0,,F,3155419.0,8895.0,16102617.0,20458388.0,,,,27552053.0,13259243.0,2558641.0,3204425.0,,997789.0,60.0,,32131.0,905099.0,,,,,254411.0,,,,,,275555.0,,,18380.0,,869767.0,487588.0,4185332.0,1354.0,,,,,,,,,,,12042385.0,,,,,,934.0,89215.0,3367654.0,10.0,,-776963.0,31.14,,,2323861.0,26565375.0,7899791.0,,5069.0,,1062476.0,94013983.0,,1125592.0,,,3990409.0,23727623.0,976954.0,-184617.0,,,ACUTE REHAB,1770640.0,19444.0,961250.0,,40293.0,,9465089.0,,22605987.0,89215.0,,,,18280313.0,,125682111.0,21168221.0,,,80519.88,10.0,,,,,,,,498857.0,,,,762603.0,,,112523.0,,,5279148.0,,,,,,22037988.0,10128.0,,72158.0,,10655382.0,,31942.0,27653.0,459840.0,1945.0,,,,2.0,,,,,,25758159.0,,1208940.0,14.85,,,1388967.0,,,,,12911.0,2266780.0,20412.0,,61697.12,,221946146.0,,,,54.0,500.0,,,,,,344.0,15.0,,4380.0,,235352.0,4222530.0,-568589.0,N,,,,,,,,,-2425.0,5.0,,5435.0,13835447.0,25758159.0,,6454383.0,3437315.68,2.0,,,,,,,,1392700.0,31942.0,2808596.0,,1177.0,1946997.0,,,,,,78.0,1074533.0,,,321891018.0,,51.0,,,,278332308.0,N,27.4,,,,,4272830.0,4527548.0,,,,,,,-12886429.0,,1181288.0,18875254.0,,30.0,,,,19813.45,2730816.0,,,297200176.0,,,299706.0,,,,23.33,,,,105642.0,,905.0,27420439.0,1879942.0,,335443.0,20412.0,,,16403.0,16093.0,,14.42,,1126364.0,,,,,59804.0,155.0,489114.0,,,13244312.0,14500.0,,4805943.0,-850038.0,,105862726.0,,20366.0,,,190726.0,15075851.0,,1685.0,,17444.0,,260461.0,,,,,,31.0,339224.0,,-201476.0,,,,4159.92,,,1581.0,P,,30.37,,12759450.0,,,208492.0,73365.0,122.05,,,-10435.0,,541310.0,,,,,,,2075590.0,924.0,,,6165.0,,108125.0,,,205431133.0,-155.0,,3926.0,,122299479.0,,,,59820883.0,,,,27932.0,2175869.0,,16039923.0,1192854855.0,1301590.0,,,,,6465474.0,,5277.0,,,,1267812.0,,,,407413.0,8.0,,6265975.0,-962046.0,5747807.0,,720483.0,10829.0,31291.0,66312.0,,,1025.0,,,,,,16908633.0,1071974.0,,,,,117908.0,,,,,,7310577.0,,1267812.0,,67750.0,105642.0,421788.0,33368870.0,,,140671563.0,9723217.0,293424.0,1388076.0,,,,,,14083.0,,3204.0,4026136.0,,,,828238.0,,2707693.0,1978223.0,,,,,722854.0,,,,,,,,5945571.0,,130892.0,,,,,,,748527.0,23193.0,595614.18,1624.0,,,679807.0,,,59704.96,,,1471298.0,,,3318.0,126849.0,4804635.0,2743.0,707465.0,,,474712.0,2323861.0,,,,,,,,,108478164.0,,722854.0,9435429.0,,,2547539.0,,,14677.0,,,,1299029.0,,,,,,22262.0,,,105862726.0,,,,,589.0,407413.0,,,,2,,,,145986.0,,,,,,680.0,,,,1629610.0,,4030965.0,,145.0,20899.0,,,,,4030965.0,465363.71,,24930462.0,44534577.0,,,4207.0,,,126.0,2616.0,,,,147573.0,16056549.0,2963560.0,5435.0,2647376.0,,,2730816.0,1778542.0,,,1208940.0,19680487.0,,,,234173.0,,,8993471.0,,-202493.0,,38436950.0,CUYAHOGA,,677451.0,,1110655.0,390435.0,1074533.0,,4527548.0,,,,,7916.0,,,,,,610961.0,,5848643.0,,,,12461.0,,,,,,380955.0,,,1324.0,,4386676.0,,1692633.0,,,,,,,,,,26930570.0,-912632.0,Y,,,94165197.0,,,1840849.0,1825.0,,,,16271143.0,99163.0,14492230.0,,,,,19680487.0,,,772537.0,,,471036683.0,,,,,,,,5138409.0,,11258911.0,,-1275.0,0.210896,385.0,,56768.0,N,65726779.0,106081396.0,923818.0,13119455.0,,,,4334.0,,N,-5000.0,,,,,378805.0,,,52530.57,,,208239.0,,,,,4922.0,,,48458957.0,,8608.0,22.0,3646652.0,,,,,,680.0,3125892.0,1774289.0,,2295515.0,,,,9622629.0,7549102.0,,,440228.0,442.0,,,,63953.0,,,2197795.0,1929734.0,,,2268936.0,,12014.0,73253567.0,1417.0,,-138807.0,,7549102.0,595744.0,8502540.0,-58241.0,10581226.0,8488318.0,6019.0,18575368.0,,4230878.0,8960884.0,,2759.0,1917207.0,1007035.0,,5844632.0,,172383.0,,,35712.83,1839557.0,111.0,357.0,3600525.0,,89610.0,,,,1259468.0,,,,4656830.0,,-3648650.0,,,107065.0,,,,,338777.0,9942671.0,2548441.0,3089.0,23680414.0,7844.0,,,38244642.0,,,,,,3388392.0,,,,,207.0,313.0,,,,,,,,7612.06,,,,23193.0,1299029.0,510.0,365919,,,1065157.0,,,,,,14464181.0,,,,3476699.0,,,-50552.0,Y,,,,7474104.0,451.0,,,8664.0,1299029.0,38359669.0,2429830.0,,,,1680215.0,,-27869540.0,,5690215.0,,,,42381.0,,3296460.0,,,5000.0,,,,12850913.0,,,,3393805.0,,,138.0,24.28,244814.0,11719.0,91133.0,3629631.0,121012.0,,,,433.0,,,,98010.0,,-12886429.0,-1275.0,,55089.0,3862620.0,,2421746.0,1590278.0,4873420.0,,34504.0,20553029.0,,,,,,4256.0,92749.0,190339309.0,,146335517.0,,,4899.0,,,,2021083.0,,,10027.0,4059263.0,5981439.0,,,,,,,,,,3641.0,,4527.0,,,,,,,,,12056468.0,83531.0,161692.0,,280697374.0,89299098.0,1120.0,-64654.0,,,,,3175345.0,30551.5,,1095064.0,,22595158.0,,,,462484.0,,14094297.0,,,,,140671563.0,63953.0,178.0,,,120.0,122148265.0,4113918.0,36.0,,,,36S155,,,N,,,2445682.0,,,,,198.0,,,,25758159.0,,28236937.0,2605411.0,1524367.0,185356011.0,2937893.0,-24216.0,,,,,,,,,,,,,,12565843.0,,9.0,28054.0,,576377.0,,,8656177.0,,,-52261.0,101626539.0,,,,27.61,14927.0,,342359.0,-235243.0,,,1301590.0,,99.0,3.0,,,,251567952.0,,53081.0,,,,,,,,557395.0,43.0,6265975.0,,,-6339.0,608.0,74.0,,4478093.0,,29004.0,27.07,,515065.0,610898.0,5367494.0,,,,,,27.24,457341.0,,,11283.0,886831.0,,,,,,,,,326071.0,16009447.0,5848643.0,14236.0,,3589565.0,368708.0,759053.0,67.63,,,,557395.0,,,2364.0,,,2051144.0,3181594.0,262106.0,13901910.0,44116.0,,73365.0,,,,4046734.0,,,,,,N,,71999.0,28054.0,261178.0,2684928.0,,,11570378.0,5944438.0,605984.0,,,4086.0,898753.0,12850913.0,53.18,,4466325.0,,,674159110.0,2445682.0,,,1553106.0,10655382.0,,16218237.0,69004205.0,154457.0,1747440.0,2931029.0,462484.0,7543596.0,,7776.0,15887.51,431.0,114418.0,,71509.0,,14642383.0,1623969.0,,,158791.0,,,,,,3679.0,739194.0,27.4,1465797.0,15201,,,,,,,360155,,,,2100428.0,393992.0,,608905.0,2078098.0,,246.0,,44109407.0,,16302.0,1202969511.0,26179.0,,,,60566457.0,SOUTHWEST GENERAL HEALTH CENTER,1401857.0,,9446.0,10.0,,,625948.0,,,359910.0,7147095.0,,,1895389.0,,,,3.0,,349549.0,35.54,1211100.0,37.86,,,,12590407.0,,665596507.0,1856.5,,,,,,560810.0,,1373389.0,1435.0,38436950.0,13.76,98628.0,,33734.0,367793.0,33374.0,,835054.0,568186.0,,4414084.0,1593226.0,4196763.0,,,,,,,-21683.0,1461086.0,,,,,,,,7543794.0,OH,459840.0,,,,,,,,,324146.0,2376123.0,55437.0,2139723.0,,,21415.0,,,,,,,4619393.0,,1139.0,995.0,,,13050.0,,,27442021.0,,5990.0,,1941.0,18.19,836976.0,2561478.0,87.0,2522295.0,,,-79666.0,7549102.0,,,2315.0,,,,1191547.0,,7147094.0,,477557.0,1528276.0,,89610.0,,,,,,,,,,,,,,,,,,,,586527.0,4499137.0,5866.0,,968845.0,,,24807620.0,,3903.0,,-13196.0,49668025.0,,1978223.0,9096.0,,,,,,2.0,,2943270.0,,,,,,3437.0,605984.0,,8410368.0,,14471258.0,,,13627205.0,,,N,913355.0,,251958724.0,,3569.0,,,9660026.0,,,42.32,SWGHC MENTAL HEALTH SERVICES,,,4.0,N,62550.0,,256196.0,36T155,,6095129.0,3136.0,740726.0,,728514.0,,33.52,84383.0,,,,,,,18875254.0,,,-69659.0,38.0,928.0,,,,7474104.0,,,1149067.0,,,63953.0,,,,1258621.0,,69522.0,,27814813.0,1435.0,11.72,66053.0,3650.0,,,349.0,8598.0,22338753.0,,,,,,,,835054.0,-2812562.0,28.48,6567.0,-4402718.0,,,,14.42,,4849368.0,,,,,,,191683532.0,,77214.0,,145986.0,2315.0,,,,,,2018-01-31 00:00:00,,1496840.0,3467955.0,,,,493018.0,7180871.0,31942.0,8810.0,,1276394.72,,26930570.0,170744.0,344.0,,,432621.0,20852942.0,228886.0,1624.0,,Y,36.69,528810401.0,2177282.0,,,1047983.0,,,,,,89215.0,,,12056468.0,-1905.0,,,,-1005.0,,,,221946146.0,8410723.0,13346.0,,,1570.0,,,,,97520.0,,,,,,,4109163.0,,,,934504.0,,,,11385920.0,,6006570.0,,3965441.0,422833.0,6454383.0,4196763.0,6.0,,4194011.0,3679.0,2197795.0,,,3261645.0,86334.0,,,,,,,213946.0,,2444246.0,,3437.0,38076.48,690.0,4007946.35,82591.0,,,89305.0,,527258348.0,214598.0,,15792809.0,,,,,,,31598.0,1052376.0,,,,,,,-98625.0,111189781.0,,154457.0,63470485.0,,64658.0,,191956.0,,-6630.0,General Short Term,,,,4858645.0,,,,20021951.0,,,1414670.0,,,,,1018.0,149036.0,1946997.0,1692.09,1031131.0,,,34768751.0,7180871.0,43.0,,4570526.0,6214.0,,5429052.0,1344958.0,,,24327840.0,2852636.0,9909725.0,13852427.0,,,,105642.0,,711.0,1188617.0,Y,,,,,,,107065.0,2038.0,,,,1268186.0,,1869992.0,,,1637.0,-6548.0,60816.0,,5434251.0,3926.0,7119.0,242466.0,722854.0,3.0,6377.0,242595.0,,,33801.0,,,,,291218737.0,,,,262341.0,,1195531.0,,335443.0,14469.0,,,108259494.0,25758159.0,86.0,65.0,,51.27,,,,,20366.0,,238.0,-23645.0,,,1700.0,16040310.0,205551.0,,163419.0,,,,,,,,27344.0,,244371.0,48116754.0,8983.0,105195.0,,256144056.0,,,27814813.0,,,,-13721.0,,,,,21862884.0,,,,,10643051.0,,,1671141.0,,126620.0,,,,,4501184.0,,,,3281.0,,,,240671.0,,126517510.0,80137263.0,-7588820.0,605534.0,229025.0,,,2690198.0,,168424.0,914784.0,,1201927.0,10189.0,28125137.0,,,991393.0,,19843542.0,35.79,,,,1433854.0,,,,390255.0,2078098.0,,,,,,361530,,173668.35,,,,2730816.0,69.0,21.05,1669728.0,4499137.0,,2288361.0,,5435.0,44130-3497,,,679807.0,1397078.0,,,,,1211100.0,31598.0,,,,6294.0,1344958.0,1453720.0,,,1666616.0,,32647030.0,18697 BAGLEY ROAD,27.55,4046734.0,,,,,,2014-01-01 00:00:00,81.0,1454677.0,,-4517541.0,1372749.0,,,10333.0,,82173.0,8553892.0,15996.0,,,,,,13822723.0,241892.0,56294410.0,,,,1053742.0,,,7310577.0,,,,,6273771.0,,,,204910.0,14097850.0,,654114.0,,3573.0,355.0,,,3582177.0,,,,12294.0,,2477810.0,,,,4334.0,,4457.0,,,837706.0,,,,3014215.0,,-1920.0,22331.0,,145352.0,,10.0,,,23042.0,,,5027611.0,,,35110.0,81397523.0,,,,,,,,32.0,,,764000.0,367253,263.0,7399337.0,,,,,,213294.0,16414344.0,,,195559.0,,2429830.0,,,99243.0,,,MIDDLEBURG HEIGHTS,,760486.0,,,,,,,,1795898.0,3172316.0,,,24526.0,,,,,,,,21508.0,4702574.0,5277.0,,,,,27178.0,,,,,,,-72123.0,,,6342655.0,35800.0,,202023.0,697.0,,,14969823.0,4849368.0,3285.0,,,,,390255.0,565062.68,,-5506.0,,,,24983.51,,,1.0,,2376123.0,,493018.0,,,,7051378.0,,,,,-65814.0,,,4113918.0,,,,,,,,,1047983.0,,,-99780.0,,,,9.0,,,9622629.0,,507201.0,,,,,18002039.0,,,33657.0,,72974.25,10208898.0,,,368707.0,,,1686788.0,,207.0,,32461322.0,,,3412332.17,,,32999.0,51970.0,29636818.0,,1992196.0,8568392.0,,,,,,,5944438.0,,4729422.0,642804.0,5739.0,3036966.0,,,,,598896.0,,,,,,4001783.0,,,,401722.0,17403914.0,,,,,,,,748527.0,,,3172316.0,,,905769335.0,,1768.0,,N,2147785.0,9832187.0,,,286148.0,,,,17125657.0,,,,,,14469.0,,,210617.0,,624875.0,,194253.0,,5718671.0,,179861.0,,23717422.0,,,10581226.0,82173.0,,2766225.0,,,,,,2108497.0,19843542.0,2647376.0,,20412.0,,-17772.0,,75816.0,,,,,,-48436.0,,,,5475.0,4612.0,,,,Y,,,,,,,267.0,,,311.0,1227000.0,,,,1415572.0,21862884.0,,,103580.0,117908.0,,,,,,,122067.0,2078098.0,759053.0,,1401.0,-58617.0,,,,,188305476.0,,3523.0,,,1076.0,13582734.0,,48006.0,,23768598.0,4729422.0,2561478.0,10.0,617558,,,,,911334.0,,,,,491022.0,1879942.0,9333657.0,,,,95.11,,98.0,,119549.0,,,130575.0,,424202.0,,,20931.0,8993471.0,2239500.0,38754946.0,,20783.0,F,,3467955.0,,,,,,4403386.0,779145.0,,442.0,,,,,10091102.0,,1253897.0,,,,38436950.0,762603.0,,,,,,17460,2014-12-31,143.09,,,,,,,,,13480.0,,,,58751228.0,,,,,-229555.0,,11680.0,,,15904628.0,3036966.0,1116494.0,3256344.0,1414670.0,14642383.0,,5419.0,,,N,,,,1056577.0,64137350.0,,1629610.0,,,1.0,,,,83445.0,13824970.0,2.0,,N,,,884588.0,-3833.0,,911334.0,,,1379.0,,,200.0,,1.0,,570391.0,19051053.0,,,,22010323.0,1.0,,2005544.0,3646652.0,19047772.0,,,,,,,1209.0,1879942.0,,,143496426.0,,39748.89,,,17043908.0,,1053742.0,,,,,406099.0,73922018.0,1669.0,3.0,,,105642.0,14563758.0,,21246151.0,8890152.0,913355.0,,1141361.0,2477810.0,,-11961.0,,1714834.0,,1342121.0,6975848.0,,,,1751940.0,,,,,,,,-400997.0,,,,,,8488318.0,13.38,,10.0,,870436.0,,,,,,,,2120760.0,2014,Acute Care Hospitals,SOUTHWEST GENERAL HEALTH CENTER (360155)
32690,SOUTHWEST GENERAL HEALTH CENTER (360155),General Short Term (Acute Care Hospitals),Voluntary Nonprofit-Other,-81.83291,41.37208,,,24.87,,,,5517949.0,,,25147.0,-41820.0,,,,,,189.0,2.0,,,1102043.0,,,,8.0,,567635.0,7320182.0,,,189.0,9725295.0,349180.0,17913591.0,7383.0,,,,10208.0,7846136.0,,,267.0,,1816505.0,,7586929.0,,1614758.0,8427.0,,,1884374.0,,,4900104.0,4039298.0,,73441.0,43.0,,29585.0,362669.0,,,,181475.0,,,,3826967.0,,,-950322.0,623152.0,,,,,1867923.0,1218458.0,,,4304395.0,203921.0,1459.0,,,15.0,,,,,,,135342.0,,12.0,,,,,,12175229.0,,,1470865.0,,6496104.0,,41953.0,,,,108176.9,20316809.0,,,,,,2898381.0,,17677295.0,,,,,,,,100238.0,999204.0,,,,,,16620.0,,,,,,,,2198.0,,,1637609.0,180.0,85889.0,,1.0,,432884973.0,,9104758.0,2582774.0,47259.0,,28274244.0,3737592.0,,,27947.63,1547550.0,19215.0,10329.0,,N,1134664.0,,,-200.0,3603267.0,,4974255.0,,795968.0,6565107.0,391873.0,,,-26741.0,,,,,,723871.0,,,560527.0,,274332001.0,,,6045885.0,,,1969523.0,,,,221662.0,,24947388.0,,,,75184.0,,402906.0,,,13571.0,260019.0,,26685680.0,5133698.0,125675226.0,,13812594.0,13140.0,,,5968715.0,,,,,,,,,150594.0,,6308.0,83260.0,,3131.25,137350.0,,148747.0,-43546.0,,,277067996.0,289847.0,,,,,1555852.0,,20578887.0,3785577.35,21258.0,,,85991.0,,,,,179923.0,1437.0,,7254272.0,,,,26364.0,14833738.0,17739.0,281824775.0,,12592986.0,284659.0,,19942727.0,212607.0,,,7045844.0,1555852.0,-523.0,1642831.0,546371.0,314197.0,,F,4881452.0,,17468139.0,17913591.0,,,,30245781.0,13049234.0,2966950.0,3896426.0,,992758.0,46.0,,36568.0,935361.0,,,,,999204.0,,,,,,283177.0,,,13342.0,,3465554.0,553445.0,4435551.0,8194.0,,,,,,,,6.0,88.0,,1064524.0,,,,,,1005.0,79597.0,7351540.0,10.0,203794.0,-873798.0,29.68,,,2495007.0,26685680.0,1650323.0,,8813.0,,118257.0,96941139.0,,1217756.0,,,5282515.0,24038248.0,1014470.0,-185602.0,,,ACUTE REHAB,,24681.0,,,40590.0,,9602130.0,,27088377.0,79597.0,,,,14841449.0,,127610351.0,13072551.0,,,85104.72,,,,,,,,,519978.0,,,,41752.0,,,105579.0,,,4974720.0,,,,,,16538105.0,2990.0,,30068.0,,9678008.0,,42695.0,23050.0,396830.0,1492.0,,,,5.0,,,,,,25166777.0,,1206082.0,2.86,,,1215910.0,,,,,13565.0,,17075.0,,65834.84,,234882029.0,,2.0,,55.0,433.0,4270.0,,,,,106.0,15.0,,372.0,,723432.0,5337269.0,-454729.0,N,,,,,,,,,,,,4891.0,14390246.0,25166777.0,,5483718.0,3457232.61,4.0,,,26473.0,,,,,1459643.0,42695.0,3049703.0,,1395.0,1981988.0,,,,,,46.0,1097857.0,,,436847410.0,,18.0,,,,277067996.0,N,2.08,,,,,4247573.0,4009263.0,,,,,,,-20350465.0,,4868885.0,20582115.0,,293.0,,,,21634.25,2721524.0,145.0,,303943908.0,,,314197.0,,289.0,,24.41,,3031704.0,,106296.0,,1094.0,30148556.0,1595377.0,,362224.0,17075.0,,,11886.0,17739.0,,14.98,,1102180.0,,1190988.0,,,41678.0,204.0,489072.0,,,1620100.0,,,-325660.0,-870194.0,,105736528.0,,10258.0,,,212246.0,16247269.0,,,,1151.0,,279875.0,,,,,,39.0,310562.0,,-197995.0,,,,4159.92,,,866.0,P,,34.06,,22761183.0,,,11619.0,68985.0,84.71,,,-12788.0,,831251.0,,,,,,736.0,2846545.0,919.0,,,9241.0,,170155.0,,,202477083.0,-100.0,,4183.0,,123857854.0,,,,61521315.0,,,,31193.0,1969523.0,,16455458.0,1185590210.0,980272.0,,,,,7846136.0,,4341.0,,,,2764757.0,,,,414046.0,11.0,,5869842.0,-1463008.0,4265593.0,,991861.0,16620.0,26364.0,2570.0,,,1448.0,,,,,,18387289.0,1057499.0,,,,,104708.0,,,,,,7581817.0,,2764757.0,,67631.0,106296.0,368707.0,25928985.0,,,154761077.0,8127502.0,326533.0,1392333.0,,,,,,17417.0,,219.0,3126102.0,4.0,,,724399.0,,2468043.0,1857729.0,,,,,806880.0,,,,,,,,2599793.0,,161135.0,,,,,,,782604.0,22600.0,546247.62,1392.0,,,547948.0,,,59786.88,,,1491797.0,,,1632.0,161226.0,6284506.0,5311.0,758232.0,,,89068.0,2495007.0,,,,,,,,,110390482.0,,806880.0,7199295.0,,,261830.0,,,16241.0,,,,1453149.0,,,,,,23122.0,,,105736528.0,,,,,705.0,414046.0,,,,4,,,,505909.0,,,,,,,,,,1712497.0,,3814282.0,,,16277.0,,,,,3814282.0,425003.5,,17206041.0,39854605.0,,,11930.0,,,126.0,1185.0,,,,161443.0,10012658.0,2461606.0,4891.0,8295896.0,,,2721524.0,1867923.0,,,1206082.0,14926005.0,,,,240585.0,,,11631834.0,,-201645.0,,39506056.0,CUYAHOGA,,661535.0,,1135358.0,284659.0,1097857.0,,4009263.0,,,,,29430.0,,,,,,560025.0,,5963284.0,,,,,,23250.0,,,,415822.0,,,813.0,,4529936.0,,1685000.0,,,,,,,,,,23222533.0,-1214038.0,Y,,,96612948.0,,,1488993.0,,,,,16100041.0,92183.0,12612095.0,,,,,14926005.0,,,786611.0,,,473162344.0,,,,1611.0,,,,3833404.0,,10977947.0,572.0,-51540.0,0.215744,404.0,,111863.0,N,65544988.0,106453078.0,989523.0,12289488.0,,,,572.0,,N,,,,3.0,,288021.0,,2453.0,48506.26,6308.0,,188020.0,,,,1.0,4718.0,,,39318765.0,,10208.0,1864.0,3905638.0,,,,,,,3698880.0,1793022.0,,2372897.0,,,,10726690.0,8520143.0,,,342377.0,349.0,,,,43490.0,,,2618683.0,1999865.0,,,2513026.0,,11488.0,68795125.0,1920.0,,-103465.0,,8520143.0,594995.0,8461646.0,-7727.0,9800916.0,8443132.0,2280.0,13001318.0,,4055810.0,11008563.0,,2947.0,1883352.0,999781.0,,6911177.0,,140290.0,,,36151.42,1688325.0,104.0,351.0,3932864.0,,80609.0,,,,1026380.0,,,,3787168.0,,-10068106.0,,,107551.0,,,,,520845.0,14573072.0,2627543.0,3394.0,25634806.0,5836.0,,,38362665.0,,,,,,3578267.0,,,,,157.0,320.0,2552.0,,,,,,,7105.25,,,,22600.0,1453149.0,,365919,,,1105320.0,,,24.0,,,13449343.0,,,,3305190.0,,-748.0,-43798.0,Y,,,,4690760.0,392.0,,,9701.0,1453149.0,38985260.0,200761.0,,,,1622406.0,,-27305400.0,,6987895.0,,,,,,4618274.0,,,4947.0,,,,16177151.0,,,,2985537.0,,,2207.0,24.62,229585.0,1173.0,96073.0,3896486.0,121194.0,,,,99.0,,,,86738.0,,-20350465.0,-51540.0,,,4816502.0,,199852.0,1563736.0,5127257.0,,37056.0,18366463.0,,,,,,965.0,5409.0,185483153.0,,159774942.0,,,4098.0,,,,2220491.0,,,7441.0,3757095.0,6525447.0,,,,,,,,,,3830.0,,4235.0,,,,,,,,,1081941.0,63182.0,175492.0,1.0,287679191.0,116534230.0,1177.0,-38282.0,,,,,3363682.0,5938.2,,1148371.0,,27071757.0,,,,377238.0,,13060984.0,,,,,154761077.0,43490.0,262.0,,,135.0,124186045.0,3684824.0,36.0,,,,36S155,,,N,,,2898381.0,,,,,52.0,,,,25166777.0,,24947388.0,2757934.0,1580657.0,191681933.0,2445907.0,-72474.0,,,,,,,,,,,,,,11376920.0,,9.0,551.0,,568327.0,,,9078068.0,,,-2016.0,9143098.0,,,,28.12,3228.0,,35.0,-117991.0,,,980272.0,,540.0,1.0,,,,255783527.0,,,,,,,,,,480614.0,,5869842.0,13086.0,,-11541.0,755.0,624.0,,4488916.0,,44004.0,27.77,,541696.0,805577.0,5476281.0,,,,,,28.35,42864.0,,,8907.0,889684.0,,,,,,,,,312018.0,16423463.0,5963284.0,13571.0,,3656730.0,368708.0,762629.0,52.22,,,,480614.0,,,3190.0,,,2640778.0,3015343.0,256540.0,13962909.0,38815.0,,68985.0,,,,3996065.0,,,,,,N,,74825.0,551.0,255593.0,2971888.0,,,9725295.0,7254839.0,603811.0,,,3077.0,870245.0,16177151.0,53.01,,5194417.0,,,704858866.0,2898381.0,,,1608893.0,9678008.0,,19174777.0,81640961.0,203349.0,1442047.0,2988089.0,377238.0,8520143.0,,10382.0,21025.66,248.0,82440.0,157103.0,30805.0,,15900332.0,1524323.0,,,203921.0,,,,,,3617.0,799044.0,25.96,1671650.0,15201,,,,,,394.0,360155,,,,2108924.0,537462.0,,615298.0,2205761.0,,240.0,,40474359.0,,14581.0,1190903295.0,15251.0,,,,63044511.0,SOUTHWEST GENERAL HEALTH CENTER,1470865.0,,296.0,18.0,1.0,,756626.0,,,520767.0,7147095.0,,,1813967.0,,,,6.0,,147081.0,35.92,1317307.0,39.65,20.0,,,11376920.0,,701034206.0,1818.45,,,,,,546371.0,,1432338.0,1469.0,39506056.0,13.89,105510.0,,21991.0,362543.0,44195.0,,11750.0,602754.0,,4115302.0,2130981.0,4282113.0,,,,,,,-28910.0,1481661.0,,,,,,,,6863734.0,OH,396830.0,,,,,,,,,12271.0,2078129.0,53408.0,2374398.0,,,17457.0,,,,,,,7180871.0,,2228.0,1000.0,,,10438.0,,,29433378.0,,12653.0,,2016.0,18.41,12358.0,1493377.0,227.0,2597650.0,,,-253918.0,8520143.0,,,2228.0,,,,1612253.0,,7147094.0,,442358.0,1443810.0,,80609.0,,,,,,,,,,,,,,,,,,,,1102043.0,4389726.0,5306.0,,1127068.0,,,25879433.0,,9135.0,,-3388.0,47985732.0,,1857729.0,7212.0,,,,,,1.0,,3243237.0,,,,,,3508.0,603811.0,,8253550.0,,12592986.0,,,13436985.0,,,N,2367532.0,,256100360.0,,2198.0,,4751.0,10484921.0,,,46.23,SWGHC MENTAL HEALTH SERVICES,,,3.0,N,6335.0,,271817.0,36T155,,5150739.0,2573.0,449025.0,,251400.0,,32.13,96349.0,,,,,,,20582115.0,,,-94766.0,,947.0,,,,4690760.0,,,1264791.0,,,43490.0,,,,1042291.0,,56356.0,,33364662.0,1469.0,11.2,22731.0,3650.0,,,1053.0,4994.0,9279779.0,,,,,,,,11750.0,-3288342.0,29.73,11981.0,-5013372.0,,,,15.0,,5778709.0,,,,,,,188081246.0,,82964.0,,505909.0,2228.0,,,,,,2022-02-23 00:00:00,3.0,1614758.0,4037146.0,,,2.0,42790.0,8674248.0,42695.0,10329.0,394.0,1272943.57,,23222533.0,138090.0,,,,476930.0,21532027.0,233540.0,1392.0,,Y,53.98,486044429.0,2282995.0,,,867756.0,,,,,,79597.0,,,1081941.0,-5853.0,,,,-1786.0,,,,234882029.0,8253885.0,3872.0,,,1128.0,,,1008.0,,96063.0,,,,204.0,,,281547.0,,,,1530816.0,,,,9104758.0,,6256550.0,,4288989.0,422038.0,5483718.0,4282113.0,14.0,,4252980.0,3617.0,2618683.0,,,2869604.0,97712.0,,,,,,,154965.0,,2503176.0,,3508.0,37190.5,,3975242.57,72317.0,,,87088.0,,484556004.0,208398.0,,15765922.0,,,,,,,42589.0,1245930.0,106.0,,,,,,-96807.0,119220672.0,,203349.0,61027770.0,,61682.0,,202736.0,,-3941.0,General Short Term,,,,4361950.0,,,,13400027.0,,,1328025.0,,,,,664.0,52653.0,1981988.0,1659.58,1071760.0,,,36091323.0,8674248.0,39.0,,,5008.0,,5678956.0,1520444.0,,,24493673.0,2821910.0,8127385.0,13834363.0,,,,106296.0,,512.0,1447975.0,Y,,,,,,,107551.0,229.0,,,,1261335.0,,1816505.0,,,,-580.0,54510.0,,5949924.0,4183.0,5005.0,247589.0,806880.0,9.0,12958.0,204525.0,,,60630.0,,,,,297418461.0,3031704.0,,,282749.0,,1763677.0,,362224.0,8425.0,,,109673932.0,25166777.0,250.0,,,53.29,,,,,10258.0,,236.0,-29960.0,,,1576.0,6637552.0,189976.0,,136537.0,,,,,,,,34635.0,,219120.0,44062689.0,8493.0,115121.0,,260535911.0,,,33364662.0,,,,-33252.0,,,,203921.0,17757602.0,,,,,9522431.0,,,1709131.0,,192963.0,,1121.0,,,4217011.0,,,,47.0,,,,245072.0,,19942727.0,87753997.0,-8489758.0,1945645.0,22172.0,,,2666542.0,,175951.0,,,555576.0,8078.0,25915331.0,,,1068222.0,,15422448.0,32.89,,,,1366717.0,,,,543395.0,2205761.0,,,,,,361530,,179191.92,,,,2721524.0,2.0,22.07,1844218.0,4389726.0,,2362474.0,,94.0,44130-3497,,,547948.0,2007594.0,,,,,1317307.0,42589.0,,,,10316.0,1520444.0,1332361.0,,,1915988.0,,29695476.0,18697 BAGLEY ROAD,28.27,3996065.0,-15.0,,,,,2015-01-01 00:00:00,51.0,1416817.0,,-4506979.0,1151170.0,,,869.0,,73860.0,8580364.0,17807.0,,,,,,16071427.0,245917.0,54406960.0,,,,1146797.0,,,7581817.0,,,,,6169313.0,,,,215216.0,13880563.0,,743800.0,,,,,,4208084.0,,,,8734.0,,2377150.0,,,,,,5731.0,,,79674.0,,,,2927952.0,,-523.0,17394.0,,11994.0,,,,,58455.0,,,5968715.0,,,31267.0,88095643.0,,,,,,,,47.0,,,739298.0,367253,399.0,6565107.0,,,,,,221662.0,15628563.0,,,556390.0,,200761.0,,,10049.0,,,MIDDLEBURG HEIGHTS,,815169.0,,,,,,,,1756091.0,2978975.0,,,24736.0,,,,1724871.0,,,,3015.0,5221942.0,4341.0,,,,,39861.0,,,,,,,,,,7887534.0,3807.0,,19044.0,,553.0,,13897462.0,5778709.0,3285.0,,,,4.0,543395.0,540309.42,,-547.0,,,,28237.66,,,1.0,,2078129.0,,42790.0,,,,7142920.0,,,,,-187577.0,,,3684824.0,,,23250.0,,,,,,867756.0,,,-126675.0,,,,19.0,-157103.0,,10726690.0,,507345.0,,,,,3681734.0,,,77360.0,,74187.97,11271146.0,,,368707.0,,,2394117.0,,110.0,9.0,28905598.0,,,3428994.95,,,33307.0,5314.0,27542918.0,,1884374.0,8553892.0,1.0,,,,,,7211433.0,,4784546.0,630612.0,29795.0,2529944.0,,,,,447793.0,,,,,,4304395.0,,,,427716.0,13442166.0,,,,,,,,782604.0,,,2978975.0,,,886959387.0,,2459.0,,N,2374741.0,10975779.0,,,398842.0,,,,21622665.0,,,,,,8425.0,,,217278.0,,528811.0,,168993.0,,6106171.0,,,,25666677.0,,,9800916.0,73860.0,,2863235.0,,,,,,2722781.0,15422448.0,8295896.0,,17075.0,,-11944.0,,81178.0,,,,,,-43203.0,606.0,,,5475.0,,,,,Y,,,,,,,1615.0,,,309.0,1256910.0,,,,1376727.0,17757602.0,,,133260.0,104708.0,,1008213.0,,,,,158809.0,2205761.0,762629.0,,129.0,-115520.0,,,,,180854418.0,,1241.0,,,673.0,12859302.0,,41953.0,,28836385.0,4784546.0,1493377.0,11.0,712382,,,,,923140.0,,,,,517379.0,1595377.0,3577806.0,,,,73.59,,7899.0,1262.0,99097.0,,,140450.0,,431750.0,,,702.0,11631834.0,1914762.0,35550806.0,,30584.0,F,,4037146.0,,,,,,3751821.0,779862.0,,349.0,,,,,10698523.0,,560890.0,,,,39506056.0,41752.0,,,,,,17460,2015-12-31,135.92,,,,,,,,,21502.0,,,,52797162.0,,,,,-228319.0,,14275.0,,,16099015.0,2529944.0,1447975.0,3354165.0,1328025.0,15900332.0,,2084.0,,,N,,,,78969.0,69610157.0,,1712497.0,,,,,,,62932.0,13589618.0,,31.0,N,,,864781.0,-4670.0,1.0,923140.0,,,851.0,,,,,2.0,92.0,535131.0,20791133.0,,,,22137891.0,1.0,,1682816.0,3905638.0,20791086.0,,,,,,,1170.0,1595377.0,,,156935851.0,,43833.61,,,17677295.0,,1146797.0,,,,,369528.0,82604015.0,2145.0,16.0,,,106296.0,14273846.0,,23072166.0,10568489.0,2367532.0,6485307.0,1184031.0,2377150.0,,-35380.0,,1637609.0,,1251245.0,7095720.0,,,,1367555.0,,,,,,,,-549703.0,,,,,,8443132.0,13.92,,3.0,,,,,,,,,,2176615.0,2015,Acute Care Hospitals,SOUTHWEST GENERAL HEALTH CENTER (360155)
38176,SOUTHWEST GENERAL HEALTH CENTER (360155),General Short Term (Acute Care Hospitals),Voluntary Nonprofit-Other,-81.83291,41.37208,,,25.66,,,,6093733.0,,,90576.0,-41820.0,,,,,,154.0,5.0,,,1484400.0,,,,,,587838.0,7392476.0,,,154.0,5658752.0,530042.0,18905211.0,,,,,11542.0,8399060.0,,,178.0,,1924758.0,,8868378.0,,1488550.0,23793.0,,,1964114.0,,,5190341.0,6545160.0,,73133.0,13.0,,,478935.0,,,,,,,,3385885.0,,,-937287.0,634674.0,,,,,1934379.0,1358988.0,,,4396267.0,64238.0,,,,30.0,,,,,,,129796.0,,,,,,,160.0,12925998.0,,,1576502.0,,5886644.0,,40164.0,,,,110506.01,23942392.0,,,,,,3163638.0,,31049929.0,,,,,,,,166363.0,394852.0,,,,,,19270.0,,,,,,,,3435.0,,,2004423.0,,191086.0,,2.0,,443102405.0,,10128705.0,3445582.0,42296.0,,30521946.0,3788434.0,,,154877.45,1499431.0,172457.0,9485.0,,N,1055707.0,,,-200.0,3628801.0,,5109578.0,,680851.0,6663325.0,457051.0,,,,,,,,,800230.0,,,566693.0,,281824776.0,,,6276174.0,,,1952206.0,,,,220282.0,,26130068.0,,,,116180.0,,439219.0,,,14168.0,352009.0,,29685760.0,5042385.0,127603465.0,,13932578.0,13176.0,,,6656606.0,,,,,,,,,142372.0,,3021106.0,71004.0,,3141.75,176933.0,,142999.0,-44354.0,,,292472520.0,310815.0,,,,,1616238.0,,24232529.0,3646335.21,21684.0,,,210025.0,,,,,259325.0,1706.0,,7025431.0,,,,27547.0,16165094.0,19570.0,294791506.0,,9769249.0,638410.0,,29178125.0,92438.0,,,7205106.0,1616238.0,-2449.0,1009548.0,643159.0,338805.0,,F,5026584.0,,18117139.0,18905211.0,,,,31927076.0,13278989.0,3222768.0,3939375.0,,1015776.0,63.0,,38206.0,1089456.0,,,,,394852.0,,,,,,269711.0,1.0,,22056.0,,2211241.0,637647.0,1989710.0,12551.0,,,,,,,,14.0,,,480609.0,,,,,,1035.0,83347.0,3860921.0,10.0,394807.0,-698730.0,33.86,,,2707586.0,29685760.0,818044.0,,9208.0,,,103768313.0,,1141691.0,,,4874658.0,26739033.0,928115.0,-188294.0,,,ACUTE REHAB,,17536.0,,,79754.0,,9505089.0,,31369874.0,83347.0,,,,15543109.0,,133460613.0,12894112.0,,,87888.96,,,,,,,,,884798.0,,,,1036815.0,,,118120.0,,,4941710.0,,,,,,15105353.0,,,55917.0,,9511909.0,,13388.0,27042.0,420700.0,1087.0,,,,,,,,,,27817381.0,,1408848.0,,,,1167055.0,,,,,11998.0,,18181.0,,65434.86,,225689967.0,,,,66.0,400.0,9560.0,,1.0,,,,15.0,,,,72149.0,5702578.0,-737757.0,N,,,,,,,,,1547.0,,,4991.0,15166376.0,27817381.0,,6237204.0,3454842.33,2.0,,,525053.0,,,,,1568349.0,13388.0,3367213.0,,1346.0,2170543.0,,,,,,48.0,889561.0,,,447064842.0,36911663.0,14.0,,,,292472520.0,N,,,,,,3692659.0,4735812.0,,,,,,,-11726217.0,,4799559.0,24238963.0,,573.0,,,,20882.0,3314016.0,97.0,,315636130.0,,,338805.0,891748.0,,,25.47,,3779923.0,,118487.0,,1558.0,31855614.0,1574008.0,,351281.0,18181.0,,,12812.0,19570.0,,15.64,,1091500.0,,1591131.0,,,55085.0,127.0,597486.0,,,959829.0,15890.0,,8894425.0,-847542.0,,105563447.0,,10589.0,,,190509.0,17315519.0,,,,,,359503.0,,,,,,230.0,423250.0,,-186164.0,,,,4191.0,,,1070.0,P,,36.0,,3166927.0,,,294661.0,56364.0,64.49,,,-13403.0,,761533.0,,,,,,1745.0,2758478.0,2066.0,,,9654.0,,57275.0,,,201216346.0,-180.0,,3503.0,,133796433.0,,,,71669497.0,,,,32702.0,1952206.0,,17860519.0,1246046101.0,996186.0,,,,,8399060.0,,8966.0,,,,2942912.0,,,,434811.0,71.0,,5885161.0,-1415352.0,2913591.0,,643907.0,19270.0,27547.0,,,,840.0,,,,,,18631175.0,1078914.0,,,,,106278.0,,,,,,6159166.0,,2942912.0,,59342.0,118487.0,368707.0,27127733.0,,,183663689.0,7076084.0,293090.0,1339736.0,,,,,,43076.0,,,3343950.0,8.0,,,818330.0,,2349646.0,1893300.0,,,,,853831.0,,,,,,,,2212157.0,,151826.0,,,,,,,849081.0,17109.0,541064.16,909.0,,,629041.0,,,61582.41,,,1783417.0,,,1690.0,50850.0,6402081.0,,802857.0,,,,2707586.0,,,,,,,,,117652833.0,,853831.0,5482243.0,,,5971914.0,,,17441.0,,,,1433040.0,,,,,,20788.0,,,105563447.0,,,,5539676.0,765.0,434811.0,,,,2,,,,1155245.0,,,,,,,,,,1653647.0,,3809726.0,,534.0,19452.0,,,,,3809726.0,289095.73,,13463231.0,42525208.0,,,13600.0,,,118.0,2633.0,,,,217169.0,3667960.0,2557335.0,4991.0,7439217.0,,,3314016.0,1934379.0,,,1408848.0,16044900.0,,,,221806.0,,,12339355.0,,-186034.0,,39473070.0,CUYAHOGA,,718025.0,,1055732.0,638410.0,889561.0,,4735812.0,,,,,78035.0,,,,,,610043.0,,6093421.0,,,,,,25187.0,,,,488470.0,,,984.0,,3522294.0,,124500.0,,,,,,,,,,24462196.0,-559867.0,Y,,,104093305.0,,,1285557.0,,,,,12840902.0,98042.0,9789555.0,,,,,16044900.0,,,826472.0,,,478507452.0,,,,2614.0,,,,4200759.0,,11695140.0,,-1927.0,0.219633,356.0,,119838.0,N,65923681.0,105843986.0,1083626.0,13110076.0,,,,,,N,,,,48.0,,347090.0,,,45874.24,3021106.0,,182760.0,,,,,4583.0,,,40384674.0,,11542.0,2326.0,4551732.0,,,,,,,3655254.0,1612879.0,,2498857.0,,,,12663141.0,9415694.0,,,499539.0,229.0,,,,43664.0,,,2838807.0,1862073.0,,,2760747.0,,11275.0,67631723.0,1198.0,,-323927.0,,9415694.0,602902.0,8917800.0,-2877.0,9763564.0,11722110.0,,10512714.0,,4050509.0,11376961.0,,2715.0,2292635.0,1546279.0,,6530249.0,,199645.0,,,30611.36,1781753.0,132.0,320.0,4557568.0,,103637.0,,,,1229839.0,,,,3172905.0,,-1702284.0,,,118815.0,,,,,579400.0,15307525.0,2472602.0,3454.0,30048672.0,20530.0,,,39473070.0,,,,,,3635328.0,,,,,185.0,376.0,1020342.0,,,,,,,7036.86,,,,17109.0,1433040.0,,,,,1619457.0,,,366.0,,,13884520.0,,,,3626465.0,,,-49769.0,Y,,,,4792241.0,841.0,,,12068.0,1433040.0,39308010.0,,,,,1753379.0,,-39599553.0,,6226445.0,,,,,,7224433.0,,,2830.0,,,,16170007.0,,,,3086936.0,,,2872.0,25.66,325181.0,,106067.0,4206869.0,173626.0,,,,141.0,,,,104681.0,,-11726217.0,-1927.0,,3.0,5139520.0,,,2053081.0,5877203.0,,53803.0,20597224.0,,,,,,2804.0,,197425876.0,,161584597.0,,,2727.0,,,,2159438.0,,,11821.0,4091587.0,11437393.0,,,,,,,,,9.0,3991.0,,5917.0,,,,,,,,,523685.0,112560.0,189293.0,,281081576.0,123053486.0,1216.0,-36074.0,,,,,3475475.0,,,1288831.0,,31350604.0,,,,373950.0,,13278989.0,,,,,183663689.0,43664.0,223.0,,,109.0,133471441.0,4251168.0,36.0,,,,36S155,,,N,,,3163638.0,,,,,148.0,,,,27817381.0,,26130068.0,7614389.0,1353144.0,198635290.0,2533209.0,-270145.0,,,,,,,,,,,,,,10949193.0,1.0,9.0,42066.0,,531442.0,,,10199420.0,,,,13784774.0,,,,29.03,6434.0,,,-157254.0,,,996186.0,,142.0,,,,,273672429.0,,,,,,,,,,504544.0,,5885161.0,281.0,,-30579.0,968.0,646.0,,4633646.0,,37253.0,29.62,,478759.0,460596.0,6220585.0,,,,,,32.11,,,,12951.0,1200874.0,529055.0,,,,,,,,340113.0,17835965.0,6093421.0,14168.0,,3758046.0,368708.0,879946.0,55.29,,,,504544.0,,,2172.0,,,2509087.0,3315650.0,274106.0,13559169.0,34613.0,,56364.0,,,,3803978.0,,,,,,N,,77606.0,42066.0,272950.0,3210555.0,,,5658752.0,7719939.0,816827.0,,23393.0,1895.0,943074.0,16170007.0,52.99,,5361176.0,,,762331102.0,3163638.0,,,2269921.0,9511909.0,,27454120.0,82709391.0,64238.0,1262427.0,3036248.0,373950.0,9415694.0,,10372.0,16087.83,326.0,81501.0,5213637.0,39160.0,,17955607.0,1710202.0,,,64238.0,,,,,,3839.0,856918.0,26.81,2243313.0,15201,,,,,,55870.0,360155,,,,2132101.0,570861.0,,709332.0,2056118.0,,256.0,,44087033.0,,19355.0,1248753948.0,34836.0,,,,60348604.0,SOUTHWEST GENERAL HEALTH CENTER,1576502.0,,,54.0,,,716121.0,,,563058.0,7147095.0,,,2076299.0,,,,12.0,,187896.0,38.63,1389928.0,39.65,12.0,,,10949193.0,,760785430.0,1754.41,,,,,,643159.0,,1646537.0,1876.0,39473070.0,13.9,123322.0,,24783.0,438268.0,38716.0,,,554202.0,,4177717.0,2239867.0,4856939.0,,,,,,,-31964.0,1485498.0,,,,,,,,6425534.0,OH,420700.0,,,5168.0,,,,,,,1885747.0,60750.0,2471425.0,,,58949.0,,,,,,,8674248.0,,,1201.0,,,11999.0,,,32311923.0,,6797.0,,1664.0,19.05,,4621173.0,568.0,2469486.0,,,,9415694.0,,,2261.0,,,,1496050.0,,6255347.0,,568486.0,1502340.0,,103637.0,,,,,,,,,,,,,,,,,,,,1484400.0,6477354.0,2132.0,,1210209.0,,,27754865.0,,16503.0,,,49577098.0,,1893300.0,7222.0,,,,,,5.0,,3599479.0,,,,,,3987.0,816827.0,,8844013.0,,9769249.0,,,13884520.0,,,N,9987534.0,,274062523.0,,3435.0,,4246.0,10345437.0,,,48.9,SWGHC MENTAL HEALTH SERVICES,,,,N,,,277512.0,36T155,,5473994.0,5939.0,723550.0,,181262.0,,32.84,117394.0,,,,,,,24238963.0,,,-41140.0,,1156.0,,,,4792241.0,,,1435986.0,,,43664.0,,,,928939.0,,68506.0,,29875657.0,1876.0,11.84,49719.0,3660.0,,,2324.0,323.0,9718069.0,,,,,,,,,-3024213.0,26.45,23903.0,-4545401.0,,,,15.64,,6649949.0,,,,,,,191307601.0,,83831.0,,1155245.0,2261.0,,,,,,2021-07-08 00:00:00,1.0,1488550.0,5129018.0,,,4.0,,13295421.0,13388.0,9485.0,55870.0,1274010.02,,24462196.0,188850.0,,,,528772.0,23046598.0,258485.0,909.0,,Y,37.48,486422846.0,2523097.0,,,1183184.0,,,,,,83347.0,,,911794.0,,,,,-2660.0,,,,225689967.0,8844348.0,9187.0,,,1363.0,,,831.0,,94576.0,,,,142.0,,,,,,,1718471.0,,,,10128705.0,,5107636.0,,4381473.0,448042.0,6237204.0,4856939.0,12.0,,4341190.0,3839.0,2838807.0,,,2782213.0,98187.0,,,,,,,229791.0,,3239589.0,,3987.0,43790.28,,3972596.66,152611.0,,,80103.0,,485260671.0,176875.0,,17784180.0,,,24976.0,,,,13388.0,1273943.0,,,,,,,-180643.0,122035374.0,,64238.0,62049221.0,,59380.0,,276979.0,,-946.0,General Short Term,,,,4269388.0,,,,12614447.0,,,1300724.0,,,,,463.0,37777.0,2170543.0,1588.19,1185017.0,,,40910724.0,13295421.0,43.0,,,5590.0,,5630487.0,1630771.0,,,23424373.0,2837730.0,8072614.0,13967512.0,,,,118487.0,,370.0,1002123.0,Y,,,,,,,118815.0,,,,,1323433.0,,1924758.0,,,,-2239.0,51910.0,,5052639.0,3503.0,1070.0,341299.0,853831.0,,12431.0,265738.0,,,52871.0,,,,,304198737.0,3804235.0,,,341374.0,,2160630.0,,351281.0,487.0,,,117372294.0,27817381.0,263.0,,,52.56,,,,,10589.0,,194.0,-31996.0,,,1875.0,1744150.0,255093.0,,136834.0,,,,,,,,74127.0,,246454.0,47401710.0,6318.0,131577.0,,276052233.0,,,29875657.0,,,,-19617.0,,,,64238.0,18432303.0,,,,,9275198.0,,,2436284.0,,255548.0,,1007.0,,,4184833.0,,,,-445.0,,,,244307.0,,29178125.0,90182468.0,-8302026.0,1754011.0,,,,3201399.0,,197559.0,,,479220.0,9759.0,26533251.0,,,1200185.0,,20457039.0,34.31,,,,1168883.0,,,,586643.0,2056118.0,,,,,,361530,,188075.0,,,,3314016.0,,21.9,2307718.0,6477354.0,,2488179.0,,7648.0,44130-3497,,,629041.0,1641425.0,,,,,1389928.0,13388.0,,,,9027.0,1630771.0,1334384.0,,,1810221.0,,37396389.0,18697 BAGLEY ROAD,30.24,3803978.0,-306.0,,,,,2016-01-01 00:00:00,16.0,1203189.0,,-5373917.0,1344139.0,,,,,69423.0,9089528.0,19816.0,,,,,,17995208.0,247598.0,53531752.0,,,,1106555.0,,,6159166.0,,,,,6600669.0,,,,200510.0,13660393.0,,790126.0,,,,,,4876502.0,,,,10063.0,,2526397.0,,,,,,6210.0,,,,,24810.0,,3252515.0,,-2449.0,25347.0,,,,,,,-8926.0,,,6656606.0,,,33145.0,102053482.0,,,,,,,,40.0,,,755194.0,367253,258.0,6663325.0,,,,,,220282.0,15221574.0,,,825966.0,,,,,,,,MIDDLEBURG HEIGHTS,,895716.0,,,,,,23393.0,,1720335.0,4114147.0,,,27169.0,,,,1852129.0,,,,,5703012.0,8966.0,,,,,56456.0,,,,,,,,,,7564042.0,,,,,937.0,,13362355.0,6649949.0,3294.0,,,,117.0,586643.0,541064.16,,-39492.0,,,,23309.83,,,1.0,,1885747.0,,,,,,6594354.0,,,,,-733657.0,,,4251168.0,,,25187.0,,,,,,1183184.0,,,-157046.0,,,,10.0,-376869.0,,12663141.0,,347130.0,,,,,3123951.0,,,82405.0,,77730.21,9603700.0,,,368708.0,,,2800203.0,,137.0,13.0,30913446.0,,,3431532.5,,,36709.0,6643.0,26782660.0,,1964114.0,8580365.0,224.0,,,,,,7675645.0,,6105130.0,452550.0,91733.0,2683893.0,,144639.0,,,466075.0,,,,,,4396267.0,,,,431234.0,12937644.0,,,,,,,7182345.0,849081.0,,,4114147.0,,,933117818.0,,3617.0,,N,2626239.0,6252362.0,,,307146.0,,,,10010702.0,,,,,-26412.0,487.0,,,249985.0,,531796.0,,271392.0,,6565580.0,,,,30102778.0,,,9763564.0,69423.0,,2836956.0,,,,,,3180551.0,20457039.0,7439217.0,,18181.0,,-11338.0,7182345.0,82969.0,,,,,,-172442.0,,,,5490.0,,,,,Y,,,,,,,4842.0,,,255.0,1974971.0,,,,1160407.0,18432303.0,,,100125.0,106278.0,,1473384.0,,,,,136225.0,2056118.0,879946.0,,,-112617.0,,,,,191205644.0,,3812.0,,,1009.0,13323092.0,,40164.0,,25384160.0,6105130.0,4621173.0,22.0,693630,,,,,896651.0,,,,,442554.0,1574008.0,4425200.0,,,,80.9,,9807.0,24.0,96311.0,,,146744.0,,377127.0,,,,12339355.0,1982645.0,38923056.0,,31492.0,I,,5129018.0,,,,,,3165849.0,789016.0,,229.0,,,,,9978495.0,,485863.0,,,,39473070.0,1036815.0,,,,,,17460,2016-12-31,137.94,,,,,,,,,,,,,55391609.0,,,,,-175064.0,,14640.0,,,17595948.0,2683893.0,1002123.0,3272695.0,1300724.0,17955607.0,,3919.0,,,N,,,,,71338085.0,,1653647.0,,,,,,,112297.0,12866186.0,,,N,,,1143090.0,-5216.0,,896651.0,,,195.0,,,109.0,,1.0,13538.0,537247.0,24423038.0,,,,24859147.0,1.0,1279564.0,1631625.0,4551732.0,24423483.0,,,,,,,629.0,1574008.0,,,160529868.0,,44831.9,,,31049929.0,,1106555.0,,,,,404436.0,85983505.0,2291.0,6.0,,,118487.0,16967600.0,,24018100.0,11719081.0,9987534.0,9718498.0,1175382.0,2526397.0,,-9560.0,,2004423.0,,1302273.0,6815979.0,,,,1351517.0,,,,,,,,-581202.0,,,,,,11722110.0,14.4,,,,,,,,,,,,1895408.0,2016,Acute Care Hospitals,SOUTHWEST GENERAL HEALTH CENTER (360155)
43511,SOUTHWEST GENERAL HEALTH CENTER (360155),General Short Term (Acute Care Hospitals),Voluntary Nonprofit-Other,-81.83291,41.37208,,,26.36,,,,4804791.0,,,98433.0,,,,,,,154.0,11.0,,,310671.0,,,,,,588815.0,9529739.0,,,154.0,15491159.0,454189.0,19626834.0,16933.0,,,,11626.0,6145127.0,,,90.0,,2170702.0,,9181297.0,,1334927.0,22110.0,,,1964588.0,,,5403234.0,7897605.0,,68917.0,4.0,,,454719.0,,,,,,,,3598767.0,,,-942194.0,547122.0,,,,,2080305.0,1284533.0,,,4496893.0,41355.0,,,,55.0,,,,,,,142438.0,,,,,,,213.0,12866286.0,,,1556923.0,,6642028.0,,40542.0,,,,109693.09,23634009.0,,,,,,3168936.0,,33087375.0,,,,,,,,186149.0,759523.0,,,,,,29000.0,,,,,,,,6043.0,,,3042790.0,,156874.0,,9.0,,466621778.0,,7821276.0,3192422.0,43248.0,,30544172.0,4187593.0,,,155576.58,1535107.0,367286.0,9523.0,,N,932731.0,,,-200.0,3847421.0,,5438412.0,,949531.0,7337422.0,294172.0,,,,,,,,,679431.0,,,571605.0,,294791505.0,,,6620902.0,,,1901234.0,,,,212319.0,,24862748.0,,,,85574.0,,515529.0,,,14358.0,98680.0,,30694662.0,5252434.0,133467499.0,,14962865.0,13140.0,,,5442171.0,,,,,,,,,113869.0,,3266663.0,70810.0,,3132.0,112202.0,,167018.0,-36718.0,,,313002794.0,250555.0,,,,,1358970.0,,23942548.0,3726722.61,20539.0,,,161614.0,,,,,202407.0,1693.0,,7431543.0,,,,25397.0,12952677.0,19817.0,296099985.0,,10508211.0,657727.0,,11355542.0,122002.0,,,7682596.0,1358970.0,-1649.0,4180406.0,568504.0,337084.0,,F,4995582.0,,20424771.0,19626834.0,,,,34891276.0,13706490.0,3550921.0,3924095.0,,1143004.0,51.0,,40642.0,1861743.0,,,,,759523.0,,,,,,263516.0,2.0,,4066.0,,2605407.0,643727.0,2577681.0,6442.0,,,,,,,,5.0,,,3180737.0,,,,,,1031.0,77632.0,14364113.0,10.0,439606.0,-757208.0,36.45,,,3131740.0,30694662.0,,,9845.0,,,109240715.0,,1448203.0,,,8047030.0,27191267.0,992305.0,-188294.0,,,ACUTE REHAB,,17151.0,,,48570.0,,10156703.0,,32207976.0,77632.0,,,,15176187.0,,124472904.0,19881385.0,,,86706.11,,,,,,,,,978417.0,,,,863318.0,,,129293.0,,,5079533.0,,,,,,22486792.0,23688.0,,51527.0,,10363319.0,,8480.0,58349.0,752999.0,1183.0,,,,1.0,,,,,,30825713.0,,1259690.0,,,,1291269.0,,,,,16951.0,,17472.0,,65212.0,,211821869.0,,,,69.0,408.0,12394.0,,,,,,15.0,,,,1127046.0,5728702.0,-905404.0,N,,,,,,,,,-1242.0,,,4745.0,16473772.0,30825713.0,,5885000.0,3526463.73,2.0,,,34277.0,,,,,1548476.0,8480.0,3553567.0,,1284.0,2219108.0,,,,,,65.0,935858.0,,,470584215.0,56810443.0,28.0,,,,313002794.0,N,,,,,,3897758.0,4688825.0,,,,,,,-11584045.0,,1002744.0,23953713.0,,87.0,,,,18706.43,3455453.0,47.0,,335019076.0,,,337084.0,,,,25.13,,4348663.0,,126372.0,,1554.0,34810666.0,1573063.0,,415933.0,17472.0,,,12362.0,19817.0,,15.86,,1117132.0,,1787656.0,,,87003.0,183.0,553543.0,,,4181591.0,,,8910335.0,-833928.0,,110878111.0,,7241.0,,,276140.0,15273898.0,,,,,,262479.0,,,,,,,1234823.0,,-216697.0,,,,3813.48,,,8288.0,P,,36.55,,15890821.0,,,260674.0,56210.0,66.6,,,-11127.0,,782365.0,,,,,,2080.0,2490321.0,1146.0,,,5900.0,,92364.0,,,241355060.0,-45.0,,3067.0,,142673285.0,,,,76919761.0,,,,26061.0,1901234.0,,18111134.0,1314585310.0,1079649.0,,,,,6145127.0,,10814.0,,,,2606663.0,,,,487726.0,,,5457252.0,-1396732.0,2572464.0,,1107601.0,29000.0,25397.0,,,,462.0,,,,,,19824403.0,1212054.0,,,,,98165.0,,,,,,7756645.0,,2606663.0,,62567.0,126372.0,368708.0,23963051.0,,,179625346.0,7826228.0,424831.0,1295072.0,,,,,,-8098.0,,,3051387.0,4.0,,,814006.0,,2201560.0,2396565.0,,,,,961132.0,,,,,,,,4508783.0,,177307.0,,,,2.0,,,867802.0,16160.0,547588.67,928.0,,,564827.0,,5.0,61613.93,,,1936279.0,,,1132.0,32875.0,6438383.0,2648.0,816812.0,,,,3131740.0,,,,,,,,,123676604.0,,961132.0,5119611.0,,,5312044.0,,,16857.0,,,,1431356.0,,,,,,18487.0,,,110878111.0,,,,9461165.0,487.0,487726.0,,,,2,,,,617248.0,,,,,,,,,,1353853.0,,5471572.0,,893.0,20889.0,,,,28650.0,5471572.0,288771.42,,22432657.0,41377314.0,,,25838.0,,,143.0,11113.0,,,,187968.0,12054555.0,2714199.0,4745.0,2321855.0,,,3455453.0,2080305.0,,,1259690.0,14881111.0,,,,221404.0,,,12250398.0,,-205194.0,,41197176.0,CUYAHOGA,,647410.0,,926218.0,657727.0,935858.0,,4688825.0,,,,,71214.0,,,,,,377751.0,,6040223.0,,,,,,3165.0,,,,484372.0,,,1134.0,,4895664.0,,725000.0,,,,,,,,,,23861591.0,-621969.0,Y,,,109832065.0,,,1500339.0,,,,,12701125.0,94330.0,10525624.0,,,,,14881111.0,,,955680.0,,,498170646.0,,,,986.0,,,,3641265.0,,12574771.0,,2738.0,0.223512,303.0,,126491.0,N,69385769.0,111016160.0,1107532.0,12886080.0,,,,,,N,,,,13.0,,331483.0,,2050.0,45742.48,3266663.0,,141931.0,,,,,5089.0,,,41076551.0,,11626.0,16.0,4959122.0,,,,,,,3753048.0,1697341.0,,2570040.0,,,,12633121.0,9483257.0,,,434871.0,255.0,,,,47259.0,,,2269127.0,1911244.0,,,2533652.0,,9399.0,68118604.0,1794.0,,-238810.0,,9483257.0,634670.0,8798348.0,,11250926.0,11756313.0,10475.0,10340155.0,,3871110.0,11627956.0,,3151.0,2482583.0,1714531.0,,6513749.0,,225975.0,,,31133.05,1888209.0,109.0,391.0,4628505.0,,61545.0,,,,1962505.0,,,,3089830.0,,-1066989.0,,,126759.0,,,,,360876.0,15071974.0,2431854.0,3970.0,29433061.0,22391.0,,,41197176.0,,,,,,3816723.0,,,,,178.0,701.0,1056181.0,,,,,,,6397.11,,,,16160.0,1431356.0,,,,,1412204.0,,,102.0,,,14435889.0,,,,3100804.0,,,-20168.0,Y,,,,4351496.0,1960.0,,,13307.0,1431356.0,46391700.0,,,,,1839129.0,,-44402531.0,,7550129.0,,,,,,8309778.0,,,3059.0,,,,16493804.0,,,,4170095.0,,,648.0,26.36,228777.0,,109133.0,4141064.0,168383.0,,,,142.0,,,,97154.0,,-11584045.0,2738.0,,,5134186.0,,,2068923.0,5563414.0,,51003.0,19419119.0,,,,,,11278.0,,231728513.0,,179341766.0,,,2446.0,,,,2101441.0,,,14434.0,4246525.0,10432237.0,,,,,,,,,38.0,3954.0,,1402.0,,,,,,,,,3172639.0,135146.0,175854.0,,266442133.0,132660196.0,1225.0,-19100.0,,,,,3531856.0,,,1289330.0,,32178976.0,,,,342956.0,,13706490.0,,,,,179625346.0,47259.0,294.0,,,42.0,142081935.0,4657915.0,36.0,,,,36S155,,,N,,,3168936.0,,,,,487.0,,,,30825713.0,,24862748.0,8565463.0,2143103.0,213708728.0,2692180.0,-235294.0,,,,,,,,,,,,,,12381909.0,,9.0,36750.0,,619857.0,,,10843942.0,,,,1308480.0,,,,29.79,11165.0,,,-154772.0,,,1079649.0,,64.0,,,,,293824943.0,,,,,,,,,,935651.0,,5457252.0,468.0,,-18722.0,609.0,648.0,,4844380.0,,27207.0,30.55,,493866.0,922488.0,5279486.0,,,,,,33.52,,,,14031.0,1025261.0,3434793.0,,,,,,,,366249.0,18086580.0,6040223.0,14358.0,,3943768.0,368708.0,1767616.0,53.16,,,,935651.0,,,1994.0,,,2515881.0,2850249.0,218481.0,13119493.0,34672.0,,56210.0,,,,4000264.0,,,,,,N,,84389.0,36750.0,217872.0,3096447.0,,,15491159.0,7342003.0,798984.0,,41334.0,3391.0,705330.0,16493804.0,55.85,,5786791.0,,,814764346.0,3168936.0,,,2025039.0,10363319.0,,21391668.0,94654316.0,41355.0,1076318.0,4650646.0,342956.0,9483257.0,,12827.0,17605.26,2573.0,82901.0,9744492.0,33237.0,,15633958.0,1683815.0,,,41355.0,,,,,,3614.0,991759.0,28.22,1905204.0,15201,,,,,,64490.0,360155,,,,2151686.0,512861.0,,754928.0,2215205.0,,245.0,,42049739.0,,18970.0,1317625966.0,46586.0,,,,67012930.0,SOUTHWEST GENERAL HEALTH CENTER,1556923.0,,,63.0,,,622557.0,,,594516.0,6255346.0,,,1870046.0,,,,41.0,,162091.0,40.29,1256411.0,40.86,37.0,,,12381909.0,,813214689.0,1793.83,2.0,,,,,568504.0,,1721229.0,1477.0,41197176.0,15.09,124914.0,,24767.0,361319.0,27165.0,,,584455.0,,4787419.0,1948247.0,5327923.0,,,,,,,-32448.0,1562581.0,,,,,,,,6335460.0,OH,752969.0,,,8386.0,,,,,,,2015507.0,58595.0,2397040.0,,,32951.0,,,,,,,13295421.0,,4039.0,1384.0,,,11681.0,,,37967544.0,,22501.0,,1756.0,18.59,,1208474.0,989.0,2704401.0,,,,9483257.0,,,2378.0,,,,1525740.0,,6255346.0,,564985.0,1467952.0,,61545.0,,,,,,,,,,,,,,,,,,,,310671.0,5985541.0,2706.0,,1001594.0,,,22111841.0,,9489.0,,,53768467.0,,2396565.0,7866.75,,,,,,2.0,,3640510.0,,,,,,3381.0,798984.0,,9417468.0,,10508211.0,,,14435889.0,,,N,10361080.0,,294233714.0,,6043.0,,33188.0,10077630.0,,,52.71,SWGHC MENTAL HEALTH SERVICES,,,5.0,N,,,293022.0,36T155,,5543066.0,7618.0,983446.0,,147197.0,,32.71,101611.0,,,,,,,23953713.0,,13338.0,-67568.0,,609.0,,,,4351496.0,,,1303089.0,,,47259.0,,,,905299.0,,66378.0,,36820739.0,1477.0,12.14,-1185.0,3650.0,,,3973.0,3310.0,5369518.0,,,,,,,,,-3143636.0,28.13,21460.0,-4708430.0,,,,15.86,,6803138.0,,,,,,,177580757.0,,83441.0,,617248.0,2378.0,,,,,,2021-07-29 00:00:00,,1334927.0,4926033.0,,,,,14503895.0,8480.0,9523.0,64490.0,1270508.8,,23861591.0,196196.0,,,,463516.0,23720702.0,353987.0,928.0,,Y,35.59,502861620.0,2635587.0,,,1284529.0,,,,,,77632.0,,,3172639.0,,,,,-39.0,,,,211821869.0,9418283.0,44447.0,,,1113.0,,,967.0,,96689.0,,,,362.0,,,,,,,1698854.0,,,,7821276.0,,6364543.0,,4482357.0,454322.0,5885000.0,5327923.0,4.0,,4564811.0,3614.0,2269127.0,,,2593994.0,80456.0,,,,,,,330367.0,,2535042.0,,3381.0,38529.29,,4048580.39,359310.0,,,76842.0,,501370621.0,215681.0,,19465984.0,,,62440.0,,,,8480.0,1146953.0,,,,,,,-42477.0,119758623.0,,41355.0,62353905.0,,72551.0,,272997.0,,,General Short Term,,,,5754344.0,,,,12419293.0,,,1351368.0,,,,,844.0,30183.0,2219108.0,1624.23,1191942.0,,,42593446.0,14503895.0,64.0,,,5437.0,,5686805.0,1397301.0,,,27037528.0,4240575.0,7468727.0,15003246.0,,,,126372.0,,202.0,1557317.0,Y,,,,,,,126759.0,,,,,1495486.0,,2170702.0,,,,-16608.0,52443.0,,5194064.0,3067.0,543.0,309598.0,961132.0,,5976.0,234859.0,,,37056.0,,,,,324586839.0,4378209.0,,,331545.0,,2018191.0,,415933.0,4698.0,,,123538555.0,30825713.0,133.0,,,55.68,,,,,7241.0,,194.0,-32448.0,,,1748.0,7853485.0,230268.0,,101305.0,,,,,,,,60216.0,,244523.0,45817113.0,5182.0,120488.0,,296811395.0,,,36820739.0,,,,-1080.0,,,,41355.0,18267123.0,,,,,13792740.0,,,2211188.0,,224188.0,,10542.0,,,4032279.0,,,,78.0,,,,274943.0,,11355542.0,99026930.0,-8690465.0,733815.0,,,,3341287.0,,193677.0,,,1000854.0,24687.0,31791481.0,,,1096930.0,,19249367.0,34.39,327.0,,,1056594.0,,,,615888.0,2215205.0,,,,,,361530,,181174.15,,,,3455453.0,,21.95,2117311.0,5985541.0,,2559773.0,,9644.0,44130-3497,,,564827.0,1371096.0,,,,,1256411.0,8480.0,,,,7161.0,1397301.0,1279762.0,,,1674843.0,,39305145.0,18697 BAGLEY ROAD,31.2,4000264.0,-14.0,,,,,2017-01-01 00:00:00,9.0,1239564.0,1005.0,-5036504.0,1354046.0,,,,,70389.0,9123805.0,20521.0,,,,,,18190065.0,275245.0,56197930.0,,,,1044695.0,,,7756645.0,,,,,6216801.0,,,,217432.0,13057034.0,,749158.0,,,,,,4439799.0,,,,8188.0,,2143955.0,,,,,,4507.0,,,,,44261.0,,2757848.0,,-1649.0,15320.0,,,,,,,101471.0,,,5442171.0,,,29248.0,108615977.0,,,,,,,,40.0,,,759385.0,367253,100.0,7337422.0,,,,,,212319.0,15850530.0,,,777322.0,,,,,,,,MIDDLEBURG HEIGHTS,,882422.0,,,,,,41334.0,,1702352.0,4352126.0,,,24076.0,,,,2075228.0,,,,,5982665.0,10814.0,,,,,45486.0,,,,,,,,,,7484587.0,,,,,339.0,,14035879.0,6803138.0,3285.0,,,,30.0,615888.0,547588.67,,-210617.0,,,,25472.01,,,1.0,,2015507.0,,,,,,6979784.0,,,,,-652016.0,,,4657915.0,,,3165.0,,,,,,1284529.0,,,-154550.0,,,,3.0,-416976.0,,12633121.0,,315506.0,,,,,7681422.0,,,93785.0,,78755.82,8417280.0,,,368708.0,,,2569753.0,,171.0,2.0,29740191.0,,,3500991.72,,,32074.0,6913.0,28356281.0,,1964588.0,9089528.0,235.0,,,,,,7305305.0,,5553815.0,448506.0,93168.0,2621835.0,,500143.0,,,450469.0,,,,,,4496893.0,,,,426106.0,16589654.0,,,,,,,12732715.0,867802.0,,,4352126.0,,,982606890.0,,6889.0,,N,2675284.0,6309761.0,,,336642.0,,,,9178796.0,,,,,-29546.0,4698.0,,,202510.0,,596203.0,,257517.0,,6569651.0,,,,29508647.0,,,11250926.0,70389.0,,2619080.0,,,,,,2918198.0,19249367.0,2321855.0,,17472.0,,-16959.0,12732715.0,82103.0,,,,,,-131672.0,517.0,,,5475.0,,,,1005.0,Y,,,,,,,4024.0,,,255.0,1858343.0,,,,1196782.0,18267123.0,,,97460.0,98165.0,,1358006.0,,,,,89958.0,2215205.0,1767616.0,,,-114612.0,,,,,232176264.0,,6579.0,,,1210.0,15623955.0,,40542.0,,25391246.0,5553815.0,1208474.0,51.0,694858,,,,,1043586.0,,,,,617195.0,1573063.0,4419484.0,,,,79.13,,51.0,47.0,91555.0,,,143381.0,,390265.0,,,,12250398.0,2048293.0,37356169.0,,35034.0,L,,4926033.0,,,,,,3504675.0,847235.0,,255.0,,,,,9969121.0,,1007767.0,,,,41197176.0,863318.0,,,,,,17460,2017-12-31,137.24,,,,,,,,,10502.0,,,,54620264.0,,,,,-129893.0,,14600.0,,,17677886.0,2621835.0,1557317.0,3169635.0,1351368.0,15633958.0,,2746.0,,,N,,,,,76123761.0,,1353853.0,,,,,,,135013.0,13316208.0,,,N,,,1037240.0,-2956.0,,1043586.0,,,142.0,,,180.0,,2.0,16974.0,562064.0,24218688.0,,,,25315988.0,1.0,2445137.0,1575485.0,4959122.0,24218610.0,,,,,,,402.0,1573063.0,,,177163692.0,,51691.29,,,33087375.0,,1044695.0,,,,,337001.0,79234829.0,2602.0,2.0,,,126372.0,16643478.0,,20066819.0,14579172.0,10361080.0,12091987.0,1194507.0,2143955.0,,-7876.0,,3049723.0,,1249969.0,7161439.0,,,,1449227.0,,,,,,,,-591816.0,,,,,,11756313.0,17.29,,5.0,,,,,,,,,,1980760.0,2017,Acute Care Hospitals,SOUTHWEST GENERAL HEALTH CENTER (360155)
48222,SOUTHWEST GENERAL HEALTH CENTER (360155),General Short Term (Acute Care Hospitals),Voluntary Nonprofit-Other,-81.83291,41.37208,,,27.06,,,,6123665.0,,,53905.0,,,,,,,157.0,6.0,,,396373.0,,,,,,473280.0,,,,157.0,6842476.0,467706.0,19690412.0,16726.0,,,,11639.0,6304828.0,,,119.0,,2277846.0,,7959952.0,,1048687.0,10613.0,,,1913728.0,5.0,,,8469834.0,,76690.0,6.0,,,460525.0,,,,,,,,3342475.0,,,-992190.0,448086.0,,,,,2159170.0,1280635.0,,,4813263.0,35573.0,,,,48.0,,,,,,,124032.0,,,,,,,,12739647.0,,,1535753.0,,6485228.0,,39351.0,,,,111810.3,25204088.0,,,,,,3425730.0,,32158718.0,,,,,,,,171363.0,624461.0,,,,,,34936.0,,,,,,,,7145.0,38746.0,,2990326.0,,110134.0,,3.0,,462486161.0,,8050977.0,3078973.0,42584.0,,28363958.0,4167093.0,,,155384.0,1616651.0,409973.0,9302.0,,N,773241.0,,,-200.0,3724483.0,,5720837.0,,1016487.0,5667064.0,217821.0,,,,,,,,,358369.0,,,488954.0,,296099985.0,,,6852761.0,,,2158863.0,,,,107351.0,,20993738.0,,,,95021.0,,571100.0,,,14506.0,107356.0,,34221463.0,5517433.0,124472904.0,,15427080.0,13140.0,,,5345982.0,,,,,,,,,94862.0,,3290766.0,71905.0,,2483.23,141678.0,,146484.0,-94516.0,,,318234659.0,272689.0,,,,,1131585.0,,25452767.0,3796265.61,18664.0,,,233448.0,,,,,180822.0,981.0,,7722141.0,,,,23732.0,22344910.0,19803.0,299858993.0,,10530651.0,478324.0,,13298613.0,99553.0,,,8671118.0,1131585.0,-1099.0,2461786.0,572990.0,372001.0,,F,4790808.0,,20659597.0,19690412.0,,,,37427156.0,14219328.0,3505311.0,3926642.0,,1263265.0,58.0,,37767.0,2138452.0,,,,,624461.0,,,,,,272045.0,1.0,,14888.0,,6217900.0,477584.0,3051176.0,3122.0,,,,,,,,,117.0,,907770.0,,,,,,993.0,83714.0,6699312.0,10.0,420337.0,-797199.0,36.64,,,3037494.0,34221463.0,131615.0,,10544.0,,,111800692.0,,1472332.0,,,6455811.0,29926565.0,1089517.0,-203877.0,,,ACUTE REHAB,,13787.0,,,47103.0,,10745441.0,,32963832.0,83714.0,,,,16090818.0,,141509428.0,19124138.0,,,92846.95,,,,,,,,,858731.0,,,,1045224.0,,,90738.0,,,5425170.0,,,,,,25342038.0,28861.0,,37903.0,,10798170.0,,7414.0,53259.0,1438724.0,856.0,,,,,,,2879.0,,,31379541.0,,1192347.0,,,,941668.0,,,,,15355.0,,16076.0,,65954.14,,198984381.0,,,,56.0,455.0,11526.0,,32735.0,,,95.0,15.0,,,,11549.0,5771491.0,-944385.0,N,,,,,,,,,-83.0,,,4525.0,17585411.0,31379541.0,,5550705.0,3577751.44,4.0,,,1600.0,,,,86583.0,1519376.0,7414.0,3629873.0,,1160.0,2190259.0,,,,,,30.0,696150.0,,,466448598.0,52763099.0,3.0,,,,318234659.0,N,,,,,,3612521.0,4603416.0,,,,,,,-16172112.0,,972979.0,25456125.0,,47.0,,,,21461.97,3409341.0,,,347091248.0,,21.0,372001.0,,316.0,,26.02,,4575674.0,,139519.0,,1550.0,37374262.0,1830201.0,,395565.0,16076.0,,,12986.0,19803.0,,15.81,,1144799.0,,2008013.0,,,77206.0,266.0,526893.0,,,2448658.0,,,4409348.0,-862689.0,,115018634.0,,726.0,,,303505.0,18594053.0,,,,,,233756.0,,,,,,,1459813.0,,-188574.0,,,,1924.28,,,6291.0,P,,36.9,,19727280.0,,,310529.0,57305.0,61.24,,,-10292.0,,697342.0,,,,,,1800.0,2543399.0,1070.0,,,21579.0,,95831.0,,,229898194.0,,,2588.0,,145354424.0,,,,82006425.0,,,,29647.0,2158863.0,,17206142.0,1357504074.0,994765.0,,,,,6304828.0,,5400.0,,,,2229433.0,,,,531043.0,,,4852166.0,-1268050.0,3014777.0,,806555.0,34936.0,23732.0,,,,586.0,,,,,,21279487.0,1328925.0,,,,,109438.0,,,,,,7596007.0,,2229433.0,,68870.0,139519.0,368708.0,22377513.0,,,182726673.0,12090179.0,466931.0,1821077.0,,,,,,86.0,,,3290872.0,4.0,,,744232.0,,2168952.0,2123586.0,,,,,985560.0,,,,,,,,7047621.0,,137125.0,,,,,,,870815.0,18319.0,548765.4,706.0,,,531473.0,,,58388.28,,,2066342.0,,,309.0,28159.0,6424695.0,2.0,847977.0,,,,3037494.0,,,,,,,,,126647879.0,,985560.0,5703672.0,,,4445356.0,,,16903.0,,,,1481274.0,,,,,,20321.0,,,115018634.0,,,,9649574.0,1947.0,531043.0,,,,3,,,,926718.0,,,,,,,,,,1465451.0,,4977697.0,,,12280.0,,,,1195.0,4977697.0,288064.85,,21864145.0,38748830.0,,,31801.0,,,138.0,4133.0,,,,161239.0,12657561.0,3085745.0,4525.0,2517713.0,,,3409341.0,2159170.0,,,1192347.0,15736912.0,,,,223419.0,,,12063608.0,,-184595.0,,40188962.0,CUYAHOGA,,572319.0,,914346.0,478324.0,696150.0,,4603416.0,,,,,37270.0,,,,,,313840.0,,5849139.0,,,,,,396.0,,,,515123.0,,,1070.0,,3822849.0,,4150000.0,,,,,,,,,,22972848.0,-532223.0,Y,,2.0,112283968.0,,,1413741.0,,,,,13726781.0,73985.0,10554866.0,,,,,15736912.0,,,1135823.0,,,494997718.0,,,,,,,,3807677.0,,13125800.0,574.0,-360.0,0.22049,290.0,,116739.0,N,,115163217.0,1237181.0,12416054.0,,,,574.0,,N,,,,,,307869.0,,2526.0,50422.06,3290766.0,,138434.0,,,,,3737.0,,,43796239.0,,11639.0,87.0,4747635.0,,,,,,,463089.0,1833650.0,,2624996.0,,,,13138910.0,10166148.0,,,384587.0,177.0,,,,38808.0,,,2137781.0,1997322.0,,,2528361.0,,8561.0,66608267.0,3407.0,,-720814.0,,10166148.0,688696.0,8610531.0,-8852.0,10758631.0,12083052.0,12915.0,10600375.0,,4117471.0,11575624.0,,3468.0,2379832.0,1508649.0,,6382038.0,,96674.0,,68.0,34255.79,1680229.0,105.0,370.0,4305694.0,,60837.0,,,,1859379.0,,,,3386958.0,,-5132365.0,,,140117.0,3.0,,,,147670.0,13585708.0,2362485.0,4089.0,31213419.0,13388.0,,,40188962.0,,,,,,3701207.0,,,,,158.0,348.0,973122.0,,,,,,,6267.39,,,,18319.0,1481274.0,,,,,1393591.0,,,1.0,,,14847187.0,,,,3466573.0,,,,,,,,4333984.0,1754.0,,,13026.0,1481274.0,48034134.0,,,,,1983941.0,,-48479416.0,,8113296.0,,,,,,8956097.0,,,1958.0,,,,15977880.0,,,,6379299.0,,,297.0,27.06,208943.0,,106787.0,4543669.0,159121.0,,,,124.0,,,,66477.0,,-16172112.0,-360.0,,,5118686.0,,,2007780.0,5835770.0,,45315.0,20131627.0,,,522.0,,,6798.0,,226251560.0,,,,,2894.0,,52.0,,2069022.0,,,17660.0,4426833.0,12684477.0,,,,,,,,,4.0,4716.0,,4856.0,,,,,,,,,907856.0,126048.0,177536.0,,268746158.0,129347735.0,1189.0,-39215.0,,,,,3985745.0,,15.0,1156756.0,,32928896.0,,,,303774.0,,14219328.0,,,,,182726673.0,38808.0,568.0,,,61.0,144871148.0,4699359.0,36.0,,,,36S155,,,N,,,3425730.0,,,,,233.0,,,,31379541.0,,20993738.0,8474107.0,2470875.0,219388137.0,3065652.0,-82051.0,,,,,,,,,,,,,,12109176.0,,,43152.0,,549912.0,,,11194755.0,,,,3890624.0,,,,30.34,3358.0,,,-329324.0,,,994765.0,,95.0,,,,,299315630.0,,,,,,,,,,1779397.0,,4852166.0,2796.0,,-42341.0,776.0,743.0,,5960085.0,,27580.0,30.85,,541521.0,622203.0,5644576.0,,,,,,33.43,,,,12357.0,1029191.0,141714.0,,,,,,,,359935.0,17181588.0,5849139.0,14506.0,,4094887.0,401443.0,1501334.0,48.63,,,,1779397.0,,,1941.0,,,2393100.0,3193884.0,249052.0,14399461.0,40117.0,,57305.0,,,,3365592.0,,,,,,N,,80541.0,43152.0,248147.0,3111725.0,,,6842476.0,7142097.0,763400.0,,45162.0,4005.0,578286.0,15977880.0,54.76,,5420364.0,,,864746798.0,3425730.0,,,1985628.0,10798170.0,,24551502.0,,34999.0,1019730.0,4393854.0,303774.0,10166148.0,,11794.0,14316.34,1791.0,88225.0,9562037.0,34811.0,,14808626.0,1828622.0,,,35573.0,,,,,,3540.0,1018649.0,28.07,1915860.0,15201,,,,,,85750.0,360155,,,,2173261.0,512892.0,1.0,818988.0,2343838.0,,228.0,,40627316.0,,14535.0,1361793539.0,36126.0,,,,68463914.0,SOUTHWEST GENERAL HEALTH CENTER,1535753.0,,,44.0,,,493138.0,,,652805.0,6255346.0,,,1579789.0,,,,9.0,,166468.0,40.49,1308364.0,42.93,,,,12109176.0,,862395774.0,1825.44,,,,,,572990.0,,1899551.0,1447.0,40188962.0,15.63,116621.0,,22277.0,357529.0,15652.0,,,539551.0,,4937760.0,2149697.0,4920085.0,,,,,,,-36433.0,1689670.0,,,,,,,,6141975.0,OH,1438680.0,,,9195.0,,,,,,,1690915.0,52745.0,2262683.0,,,40960.0,,,,,,,14503895.0,,3851.0,1270.0,,,9986.0,,,38645876.0,,17417.0,,1536.0,19.09,,,480.0,3066661.0,,,,10166148.0,,,2714.0,,,,1453875.0,,6255346.0,,550506.0,1442617.0,,60837.0,,,,86583.0,,,,,,,,,,,,,,,,396373.0,5668304.0,3233.0,,843488.0,,,25396466.0,,8157.0,,,56045895.0,,2123586.0,7403.58,,5917.0,,,,3.0,,3641257.0,,,,,,3621.0,763400.0,,10712546.0,,10530651.0,,,14847187.0,,,N,9515118.0,,299699510.0,,7145.0,,25804.0,10843178.0,,,51.53,SWGHC MENTAL HEALTH SERVICES,,,5.0,N,,,291022.0,36T155,,5687618.0,3094.0,859417.0,,138048.0,,33.75,91418.0,,,,,,,25456125.0,,565.0,-63209.0,,905.0,,,,4333984.0,,,1312086.0,,,38808.0,86583.0,,,1153127.0,,60099.0,,38797694.0,1447.0,13.36,13128.0,3650.0,,,2163.0,2941.0,9231940.0,,,,,,,,,-3416876.0,29.34,18228.0,-5260089.0,,,,15.82,,6524393.0,,,,,,,180286793.0,,86669.0,,926718.0,2714.0,,,,,,2021-06-02 00:00:00,,1048687.0,5388439.0,,,,,12091603.0,7414.0,9302.0,85750.0,1279436.27,,22972848.0,483754.0,,,,399811.0,28828337.0,303283.0,706.0,,Y,36.72,497046741.0,2448372.0,,,1135868.0,,,,,,83714.0,,,907856.0,,,,,-2911.0,,,,198984381.0,10713361.0,18877.0,,,533.0,,,1099.0,,90988.0,,,,,5917.0,,,,,,1610543.0,,,,8050977.0,,6226407.0,,4799469.0,446644.0,5550705.0,4920085.0,11.0,,5262197.0,3540.0,2137781.0,,,2211574.0,73120.0,,,,,,,308277.0,,2465688.0,,3621.0,38569.96,,4104796.92,319139.0,,,66976.0,,495108300.0,164563.0,,22509460.0,,,1561.0,,,,7319.0,968685.0,95.0,,,,,,-60458.0,121448496.0,,34999.0,56943025.0,,68715.0,,276452.0,,,General Short Term,,,15.0,5931743.0,,,,12443232.0,,,1386863.0,,,,,889.0,28868.0,2190259.0,1656.68,1211705.0,,,42770310.0,14503895.0,27.0,,,5198.0,,5894697.0,1198004.0,,,27999030.0,4662374.0,7229514.0,15451692.0,118.0,,,139519.0,,517.0,1185930.0,Y,,,,,,,140117.0,,,,,1450161.0,,2277846.0,,,,-20329.0,51367.0,,6031143.0,2588.0,119044.0,305789.0,985560.0,,5798.0,216981.0,,,36229.0,,,,,334406771.0,4611581.0,,,310246.0,,1808550.0,,395565.0,5132.0,,,126503296.0,31379541.0,43.0,,,55.79,,,,,726.0,,197.0,-32140.0,,,1061.0,6929971.0,167813.0,,93654.0,,,,,,,,53502.0,,245183.0,42590090.0,5783.0,100387.0,,302750686.0,,,38797694.0,,,,-1080.0,,,,35573.0,19377358.0,,,,,13930297.0,,,2156991.0,,232694.0,,6989.0,,,3940575.0,,,,138.0,,,,313724.0,,13298613.0,105393899.0,-9089070.0,677640.0,,,,3296810.0,,203559.0,,,1540888.0,41129.0,30486571.0,,,1119742.0,,20598363.0,36.3,,,,1047638.0,,,,676039.0,2343838.0,,,,,,361530,,172685.0,131.0,,,3409341.0,,22.46,2049039.0,5668304.0,,2614704.0,,10908.0,44130-3497,,,531473.0,1416473.0,,,,,1308364.0,7319.0,,,,7176.0,1198004.0,1258826.0,,20.0,1564746.0,,34339389.0,18697 BAGLEY ROAD,31.44,3365592.0,,,,,,2018-01-01 00:00:00,38.0,1195137.0,,-4187689.0,1244191.0,,,,,69779.0,9125405.0,19976.0,,,,,,18162235.0,314794.0,52652269.0,,,,1175301.0,,,7596007.0,,,,,6010986.0,,,,215928.0,12912297.0,,797599.0,,,,,,3841260.0,,,,20374.0,,1926248.0,,,,,,3969.0,,,,,61632.0,,3162799.0,,-1099.0,13504.0,,,,,,,37006.0,,,5345982.0,,,32748.0,119850425.0,,,,,,,,40.0,,,676282.0,367253,121.0,5667064.0,,,,,,107351.0,15503777.0,,,675933.0,,,,,,,,MIDDLEBURG HEIGHTS,,796675.0,,,,,,45162.0,,1471980.0,4700569.0,,,27257.0,,,,2314709.0,,,,,7238140.0,5400.0,,,,,47379.0,,,,,,,,,,7405550.0,,,,,,,13841150.0,6524393.0,,,,,,676039.0,548765.4,,-176631.0,,,,21719.92,,,1.0,,1690915.0,,,,,,6666536.0,,,,,-308169.0,,,4699359.0,,,396.0,,,,,,1135868.0,,,-223642.0,,,,14.0,-577351.0,,13138910.0,,284407.0,,,,,7955477.0,,,106729.0,,79891.06,7430536.0,,,,,,2261471.0,,139.0,,27590031.0,,,3556031.52,,,23637.0,13042.0,28812008.0,,1913728.0,9123805.0,234.0,,,,,,7097301.0,,5136349.0,422772.0,56415.0,2613653.0,,644061.0,,,437898.0,,,,,,4813263.0,,,,362019.0,16828431.0,,,,,,,12803791.0,870815.0,,,4700569.0,,,1014702291.0,,8692.0,,N,2520390.0,5730641.0,,,244736.0,,,,4802004.0,,,,,-35907.0,5132.0,,,157906.0,,434154.0,,259760.0,,6462624.0,,,,31284481.0,,,10758631.0,69779.0,,2637785.0,,,,,1869.0,2630788.0,20598363.0,2517713.0,,16076.0,,-20164.0,12803791.0,85791.0,,,,,,-49190.0,590.0,,,5475.0,,,,,Y,,,,,,,1935.0,,,258.0,1614038.0,,,,1147981.0,19377358.0,,,82973.0,109438.0,,1452162.0,,,,,52679.0,2343838.0,1501334.0,,,-112805.0,,,,,225096190.0,,4886.0,,,1443.0,15754120.0,,39351.0,,25689891.0,5136349.0,,44.0,692138,,,,,945617.0,,,,,660717.0,1830201.0,3833018.0,,,,77.85,,321.0,219.0,102541.0,,,143469.0,,396448.0,,,,12063608.0,1818415.0,36215214.0,,29820.0,M,,5388439.0,,,,,,3300865.0,786167.0,,177.0,,,,,10610929.0,,1553930.0,,,,40188962.0,1045224.0,,,,,,17460,2018-12-31,134.36,,,,,,,,,9.0,,,,69761777.0,,,132.0,,-94357.0,,14600.0,,,15624311.0,2613653.0,1185930.0,3255719.0,1386863.0,14808626.0,,1644.0,,,N,,,,,79685652.0,271.0,1465451.0,,,,,,,126005.0,15623955.0,112.0,,N,,,1062466.0,-2631.0,,945617.0,,,30091.0,,,87.0,,3.0,22312.0,473734.0,25756272.0,,,,28228782.0,1.0,2486588.0,1526497.0,4747635.0,25756134.0,,,,,,,1169.0,1830201.0,,,,,51618.98,,,32158718.0,,1175301.0,,,,,325279.0,84812731.0,2401.0,3.0,,,139519.0,15171886.0,,22897773.0,14934174.0,9515118.0,14021217.0,1285847.0,1926248.0,,-9514.0,,3000556.0,,1221192.0,7605431.0,,,,1780846.0,,,,,,,,-536257.0,,,,,,12083052.0,17.59,,17.0,,,,,,,,9.0,,1548765.0,2018,Acute Care Hospitals,SOUTHWEST GENERAL HEALTH CENTER (360155)
56020,SOUTHWEST GENERAL HEALTH CENTER (360155),General Short Term (Acute Care Hospitals),Voluntary Nonprofit-Other,-81.83291,41.37208,,,27.94,,,,5765327.0,,,65550.0,,,,,,,142.0,11.0,,,422013.0,,,,,,510608.0,10378782.0,,,142.0,1316912.0,383621.0,20212740.0,,,,,11449.0,7463602.0,,,,,2504638.0,,8842676.0,,1214106.0,12875.0,,,1865875.0,,,5676855.0,7837150.0,,68665.0,11.0,,,505116.0,,,,,,,,3524829.0,,,-1008168.0,414512.0,,,,,2216445.0,1251486.0,,,5079850.0,37353.0,,,,50.0,,,,,,,114225.0,,,,,,,,11993832.0,,,1689217.0,,7002147.0,,38849.0,,,,111810.3,25699634.0,,,,,,3128535.0,,34102599.0,,,,,,,,161036.0,764004.0,,,,,,31945.0,,,,,,,,7986.0,,,2447977.0,,128394.0,,,,468942297.0,,5914902.0,2715066.0,41549.0,,26904675.0,3936830.0,,,132383.36,1686668.0,226236.0,10410.0,,N,880611.0,,,-200.0,3635765.0,,5785440.0,,1144847.0,6127216.0,192049.0,,,,,,,,,339606.0,,,449707.0,,299858993.0,,,6957816.0,,,2238383.0,,,,126574.0,,20235802.0,,,,93724.0,,538020.0,,,14977.0,118209.0,,35964008.0,5496099.0,127005532.0,,16260504.0,13140.0,,,3216003.0,,,,,,,,,141958.0,,2952550.0,66430.0,,2483.23,120136.0,,139573.0,-97393.0,,,342518721.0,262022.0,,,,,1210032.0,,25924039.0,3798323.75,18254.0,1.0,,150342.0,,,,,165856.0,800.0,,7577606.0,,,,23120.0,17324043.0,16329.0,302422825.0,,11708457.0,478466.0,,16489538.0,126951.0,,,9153309.0,1210032.0,-1224.0,1934546.0,665339.0,394685.0,,F,4494283.0,,21680795.0,20212740.0,,,,40618902.0,14029452.0,3156842.0,3842761.0,,1318772.0,43.0,,33621.0,1669728.0,,,,,764004.0,,,,,,295525.0,1.0,,14556.0,,7859869.0,436805.0,2686608.0,2413.0,,,,,,,,,,,249013.0,,,,,,914.0,92121.0,3024601.0,10.0,488096.0,-1016171.0,40.75,,,3171431.0,35964008.0,11121.0,,11228.0,,,116423139.0,,1758556.0,,,15900120.0,30734871.0,1127948.0,-103898.0,,,ACUTE REHAB,,17519.0,,,65849.0,,10857448.0,,34171428.0,92121.0,,,,16918486.0,,152070321.0,34464868.0,,,92846.95,,,,,,,,,870396.0,,,,1205259.0,,,60344.0,,,6191186.0,,,,,,42324737.0,7595.0,,36495.0,,11181547.0,,7665.0,52060.0,1712216.0,865.0,,4.0,,1.0,,,,,,33810901.0,,1255416.0,,,,1121875.0,,,,,17385.0,,15478.0,,65954.14,,221652817.0,,1.0,,103.0,489.0,5041.0,,237696.0,,,,15.0,,,,65553.0,5775829.0,-597637.0,N,,,,,,,,,-2333.0,,,4495.0,18661537.0,33810901.0,,5513377.0,3577217.42,4.0,,,91395.0,,,,,1671980.0,7665.0,3709386.0,,1252.0,2381793.0,,,,,,27.0,311986.0,,,472904734.0,53541959.0,9.0,,,,342518721.0,N,,,,,,3770057.0,4475758.0,,,,,,,-21126231.0,,960994.0,25937929.0,,39.0,,,,22361.65,3916781.0,,,367287624.0,,,394685.0,,,,28.64,,7394386.0,,171383.0,,2343.0,40563910.0,1821630.0,,431310.0,15478.0,,,14305.0,16329.0,,16.29,,1281170.0,,3249037.0,,,43005.0,251.0,567667.0,,,1925831.0,,,2040403.0,-899674.0,,119519324.0,,29457.0,,,312129.0,13864691.0,,,,,,213622.0,,,,,,,1399470.0,,-118454.0,,,,2293.53,,,4311.0,P,,33.7,,23658035.0,,,354097.0,51830.0,67.27,,,-10742.0,,923851.0,,,,,,803.0,2611958.0,1577.0,,,15253.0,,149483.0,,,280186055.0,,,2776.0,,151565069.0,,,,97479183.0,,,,36443.0,2238383.0,,17671339.0,1435264091.0,966004.0,,,,,7463602.0,,10182.0,,,,-969993.0,,,,644528.0,,,4974412.0,-1089137.0,3678920.0,,855056.0,31945.0,23120.0,,,,1074.0,,,,,,20971740.0,1374415.0,,,,,99908.0,,,,,,9081538.0,,-969993.0,,68870.0,171383.0,401443.0,18423327.0,,,184916421.0,25129427.0,480199.0,2154444.0,,,,,,714.0,,,3140563.0,7.0,,,814024.0,,2318693.0,1675852.0,,,,,984208.0,,,,,,,,7502021.0,,147862.0,,,,,,,879863.0,21229.0,530096.01,558.0,,,495218.0,,,58388.28,,,1972756.0,,,10328.0,29688.0,6399641.0,793.0,871532.0,,,,3171431.0,,,,,,,,,131232528.0,,984208.0,6089120.0,,,4778634.0,,,13856.0,,,,1513650.0,,,,,,23851.0,,,119519324.0,,,,9641651.0,1349.0,644528.0,,,,2,,,,584844.0,,,,,,,,,,2523897.0,,4183515.0,,,19938.0,,,,,4183515.0,288064.85,,23238991.0,39555376.0,,,27715.0,,,121.0,5048.0,,,,185017.0,38682065.0,3057664.0,4495.0,6225958.0,,,3916781.0,2216445.0,,,1255416.0,15304589.0,,,,230413.0,11.0,,11297489.0,,-196295.0,,41343002.0,CUYAHOGA,,549210.0,,1012940.0,478466.0,311986.0,,4475758.0,,,,,36593.0,,,,,,299334.0,,6745839.0,,,,,,18287.0,,,,524724.0,,,515.0,,4414417.0,,4470957.0,,,,,,,,,,22863149.0,-722992.0,Y,,,116476178.0,,,1527343.0,,,,,,87049.0,11739532.0,,,,,15304589.0,,,1245151.0,,,532276123.0,,,,,,,,3778238.0,,14583804.0,,-2311.0,0.224582,304.0,,113126.0,N,74574011.0,120246222.0,1197247.0,13539893.0,,,,,,N,,,,39.0,,257530.0,,,50422.06,2952550.0,,153428.0,,,,,5057.0,,,44683983.0,,11449.0,14.0,4791093.0,,,,,,,186500.0,1911805.0,,2653533.0,,,,12462931.0,10608882.0,,,361410.0,181.0,,,,31266.0,,,2584784.0,1736826.0,,,2054273.0,,12554.0,69541942.0,3048.0,,-485650.0,,10608882.0,671460.0,8165700.0,-3039.0,10820652.0,12204047.0,3414.0,11496415.0,,4587439.0,13961398.0,,3877.0,2093747.0,1597940.0,,6881323.0,,80949.0,,,34255.79,1724682.0,85.0,326.0,3862479.0,,77665.0,,,,1957247.0,,,,3242064.0,,-10316571.0,,,171931.0,,,,,130913.0,13518121.0,2272002.0,4045.0,31802775.0,14455.0,,,41343002.0,,,,,,3620362.0,,,,,82.0,305.0,1029410.0,,,,,,,6267.39,,,,21229.0,1513650.0,,,,,1372879.0,,,321.0,,,14809389.0,,,,3633591.0,,,-5670.0,,,,,4273255.0,1521.0,,,20839.0,1513650.0,54664690.0,,,,,2035483.0,,-57970030.0,,8087821.0,,,,,,4983816.0,,,1159.0,,,,17919863.0,,,,7409546.0,,,579.0,27.94,294876.0,,109116.0,4472983.0,123180.0,,,,160.0,,,,49265.0,,-21126231.0,-2311.0,,,5099732.0,,,2234524.0,5927602.0,,38091.0,21827898.0,,,475.0,,,6950.0,,244381528.0,,217331144.0,,,3096.0,,,,2181060.0,,,20091.0,4111388.0,3642672.0,,,,,,,,,,4749.0,,5203.0,,,,,,,,,249727.0,122945.0,182682.0,,287894595.0,130796446.0,1078.0,-20356.0,,,,,3835960.0,,,1159429.0,,34139483.0,,,,296832.0,,14029452.0,,,,,184916421.0,31266.0,500.0,,,94.0,151512030.0,4804429.0,36.0,,,,36S155,,,N,,,3128535.0,,,,,256.0,,-414.0,,33810901.0,,20235802.0,9204504.0,2593394.0,244125628.0,3057664.0,-35814.0,,,,,,,,,,,,,,13500813.0,1.0,,26266.0,,635190.0,,,8891288.0,,,,2574953.0,,,,31.66,13890.0,,,-271324.0,,,966004.0,,264.0,,,,,322334249.0,,,,,,,,,,2138111.0,,4974412.0,2779.0,,-44121.0,626.0,784.0,,6620056.0,,20908.0,32.06,,557880.0,674543.0,5836884.0,,,,,,35.03,,,,7175.0,912169.0,,,,,,,,,329099.0,17646785.0,6745839.0,14977.0,,4307935.0,639139.0,1283046.0,38.91,,,,2138111.0,,,2471.0,,,2399143.0,3371569.0,239574.0,13548184.0,51574.0,,51830.0,,,,4038228.0,,,,,,N,,92550.0,26266.0,238638.0,2672837.0,,,3101275.0,7267147.0,672649.0,,49783.0,5265.0,589226.0,17919863.0,54.41,,5184242.0,,,909107451.0,3128535.0,,,1884492.0,11181547.0,,18233204.0,114194189.0,37353.0,1199362.0,3987489.0,296832.0,10608882.0,,18734.0,8017.44,1517.0,99976.0,10126674.0,36920.0,,13977928.0,1907514.0,,,37353.0,,,,,,3609.0,960042.0,29.04,1831100.0,15201,,,,,,59227.0,360155,,,,2386978.0,620106.0,,1001837.0,2464660.0,,215.0,,40038586.0,,13325.0,1439754402.0,23146.0,,,,69129119.0,SOUTHWEST GENERAL HEALTH CENTER,1689217.0,,,47.0,,,629809.0,,,676097.0,6255346.0,,,1393302.0,,,,19.0,,179917.0,42.35,1411186.0,45.31,13.0,,,13500813.0,,906744509.0,1833.71,,,,,,665339.0,,1994292.0,1265.0,41343002.0,12.59,111292.0,,21729.0,410221.0,13635.0,,,614180.0,,5122573.0,2138909.0,5331493.0,,,,,,,-48654.0,1608658.0,,,,,,,,5624547.0,OH,1712216.0,,,10682.0,,,,,,,1277990.0,44954.0,1971387.0,,,38440.0,,,,,,,14503895.0,,,2034.0,,,11066.0,,,43975592.0,,8480.0,,1598.0,19.07,,7151624.0,,3160141.0,,,,10608882.0,,,2654.0,,,,1577148.0,,6255346.0,,471453.0,1363180.0,,77665.0,,,,,,,,,,,,,,,,,,,,422013.0,6237921.0,2700.0,,951279.0,,,24983157.0,,,,,56782797.0,,1675852.0,6546.0,,16799.0,,,,7.0,,3147827.0,,,,,,3601.0,672649.0,,12434238.0,,11708457.0,216.0,,14809389.0,,,N,8904896.0,,322725717.0,,7986.0,,27.0,12006746.0,,,44.92,SWGHC MENTAL HEALTH SERVICES,,,7.0,N,,,290451.0,36T155,,6200036.0,5590.0,803954.0,,145517.0,,32.67,73548.0,,,,,,,25937929.0,,,-85537.0,,936.0,,,,4273255.0,,,1504663.0,,,31266.0,,,,1280312.0,,60439.0,,39413566.0,1265.0,14.7,8715.0,3650.0,,,,3504.0,6433870.0,,,,,,,,,-3582368.0,30.85,,-5427173.0,,,,16.38,,6470597.0,,,,,,,170424210.0,,88078.0,,584844.0,2654.0,,,,,,2023-01-31 00:00:00,,1214106.0,4920582.0,,,,,7167818.0,7665.0,10410.0,59227.0,1266230.88,,22863149.0,796821.0,,,,410040.0,34863750.0,346208.0,558.0,,Y,50.64,530646951.0,2496173.0,,,2749038.0,,,,,,92121.0,,,249727.0,,,,,6205.0,,,,221652817.0,12435053.0,21505.0,-414.0,,866.0,,12138599.0,2067.0,,80997.0,,,,154.0,16799.0,,,,,,1554405.0,,,,5914902.0,,7359984.0,,5066621.0,439108.0,5513377.0,5331493.0,,,5867227.0,3609.0,2584784.0,,,2336295.0,81520.0,,,,,,,350303.0,,2241600.0,,3601.0,38569.96,,4092749.99,291430.0,,,79016.0,-414.0,528519582.0,211212.0,,24218734.0,,,6336.0,,,,7665.0,973758.0,,,,,,,-49234.0,123292487.0,,37353.0,58322105.0,,63424.0,,251504.0,,,General Short Term,,,,4859525.0,,,,13401898.0,,,1588116.0,,,,,665.0,29861.0,2381793.0,1672.26,1255461.0,,,44356130.0,21655519.0,36.0,,,4962.0,,5676579.0,1373795.0,,,30343284.0,4628984.0,7459415.0,16296115.0,,,,171383.0,,399.0,1303589.0,Y,,,,,,,171931.0,,,,,1391186.0,,2504638.0,,,,-11401.0,51913.0,,12256746.0,2776.0,,268006.0,984208.0,114.0,1537.0,309203.0,,,9211.0,16.0,,,,363644952.0,7428774.0,,,335929.0,,1674255.0,,431310.0,6383.0,,,130505630.0,33810901.0,164.0,,,55.19,,,,,29457.0,,182.0,-46684.0,,,800.0,7382585.0,148505.0,,97177.0,,,,,,,,51650.0,,267731.0,43043012.0,6667.0,100187.0,,325412325.0,,,39413566.0,,,,-1920.0,,,,37353.0,20624499.0,,,,,13311160.0,,,2045528.0,,217869.0,,8.0,,,3612857.0,,,,-25.0,,,,359083.0,,16489538.0,123456890.0,-9178030.0,1732871.0,,,,3782310.0,,215394.0,,,1676818.0,39515.0,33139190.0,,,1245074.0,,16021594.0,36.13,423.0,,,1343929.0,,,,696343.0,2464660.0,,,,,,361530,,182111.0,1415.0,,,3916781.0,,22.95,1983687.0,6237921.0,,2642791.0,,6781.0,44130-3497,,,495218.0,1953198.0,,,,,1411186.0,7665.0,,,,5595.0,1389192.0,1237230.0,,,1909866.0,,44463657.0,18697 BAGLEY ROAD,32.68,4038228.0,,,,,,2019-01-01 00:00:00,17.0,1085575.0,1208.0,-6653376.0,1715651.0,,,,,69671.0,9216800.0,19464.0,,,,,,18134640.0,360740.0,63152539.0,,,,1216595.0,,,9081538.0,,,,,6448456.0,,,,238034.0,13604011.0,,758690.0,,,,,,3487636.0,,,,7761.0,,1869255.0,,,,,,4503.0,,,,,79710.0,,3336759.0,,-1224.0,9815.0,,,,,,,14168.0,,,3216003.0,,,31243.0,130576000.0,,,,,,,,40.0,,,634098.0,367253,231.0,6127216.0,,,,,,126574.0,15058668.0,,,631559.0,,,,,,,,MIDDLEBURG HEIGHTS,,697982.0,,,,,,49783.0,,1579632.0,5085120.0,,,25269.0,,,,3795267.0,,,,,7383428.0,10182.0,,,,,46750.0,,,,,,,,,,7880030.0,,,,,,,13756350.0,6470597.0,,,,,106.0,696343.0,530096.01,54.0,-236774.0,,,,14563.44,,,1.0,,1277990.0,,,,,,6933910.0,,,,,-298160.0,,,4804429.0,,,18287.0,,,,,,2749038.0,,,-221895.0,,,,3.0,-619368.0,,12462931.0,,225201.0,,,,,7751748.0,,,129176.0,,79891.06,9253958.0,,,368708.0,,,2094334.0,,61.0,,28010632.0,,,3562653.98,,,22448.0,8001.0,31866170.0,,1865875.0,9125405.0,286.0,,,,,,7221044.0,,5711789.0,356847.0,47583.0,2313586.0,,380295.0,,,439907.0,,,,,,5079850.0,,,,389279.0,16952893.0,,,,,,,13313483.0,879863.0,,,5085120.0,,,1072466778.0,,9167.0,,N,2385930.0,7906777.0,,,280041.0,,,,19131061.0,,,,,-34388.0,6383.0,,,164668.0,,465241.0,,236330.0,,6265667.0,,,,31857866.0,,,10820652.0,69671.0,,3129195.0,,,,,4814.0,2450186.0,16021594.0,6225958.0,,15478.0,,-21938.0,13313483.0,87199.0,,,,,,-6370.0,,,,5475.0,,,,1208.0,Y,,,,,,,1751.0,,,243.0,2194781.0,,,,1061559.0,20624499.0,,,95683.0,99908.0,,5285860.0,,,,,46407.0,2464660.0,1283046.0,,,-134471.0,,,,,261054994.0,,1440.0,,,2155.0,15688568.0,,38849.0,,33659031.0,5711789.0,7151624.0,43.0,736732,,,,,1127491.0,,,,,744150.0,1821630.0,4048321.0,,,,87.75,,51.0,235.0,118446.0,,,156621.0,,279298.0,,,,11297489.0,1815738.0,35411270.0,,26287.0,N,,4920582.0,,,,,,3803757.0,870418.0,,181.0,,,,,10838738.0,,1684819.0,,,,41343002.0,1205259.0,,,,,,17460,2019-12-31,147.57,,,,,,,,,3440.0,,,,66241778.0,,,123.0,,-74839.0,,14600.0,,,14910843.0,2313586.0,1303589.0,3604511.0,1588116.0,13977928.0,,1584.0,,,N,,,,,77730532.0,,2523897.0,,,,,,,122781.0,15754120.0,,14.0,N,,,939907.0,-2714.0,,1127491.0,,,,200.0,,256.0,,2.0,15848.0,546147.0,26236168.0,,2.0,,29246926.0,1.0,2539212.0,1554893.0,4791093.0,26236193.0,,,,,,,970.0,1821630.0,,,215153070.0,,51618.98,,,34102599.0,,1216595.0,,,,,318975.0,81665858.0,4020.0,5.0,,,171383.0,15401229.0,,26027643.0,15856406.0,8904896.0,15922707.0,1237630.0,1869255.0,,-10997.0,,2458356.0,,1134474.0,7685250.0,,,,1666343.0,,,,,,,,-507659.0,,,,,,12204047.0,17.41,,4.0,,,,,,,,,,1908726.0,2019,Acute Care Hospitals,SOUTHWEST GENERAL HEALTH CENTER (360155)
61487,SOUTHWEST GENERAL HEALTH CENTER (360155),General Short Term (Acute Care Hospitals),Voluntary Nonprofit-Other,-81.83291,41.37208,,,28.49,,,,6876467.0,,,54671.0,,,,,,,155.0,3.0,,,243785.0,,,,,,561416.0,7188510.0,,,155.0,17340267.0,316665.0,16055335.0,11952.0,,,,11433.0,7139053.0,,,30.0,,2298631.0,,8096578.0,,787031.0,19218.0,,,1941707.0,,,5691726.0,8400399.0,,57858.0,8.0,,,313884.0,,,,,,,,3351097.0,,,-786301.0,449538.0,,,,,,1084868.0,,,5072295.0,41615.0,,,,87.0,,,,,,,82942.0,,,,,,,,12200819.0,,,1747144.0,,6509454.0,,39196.0,,,,115270.06,22577641.0,,,,,,3025740.0,,31683653.0,,,,,,,,182485.0,552969.0,,,,,,38429.0,,,,,,,,5190.0,,,2389234.0,,82268.0,,,,484114923.0,,6181012.0,2646626.0,42303.0,,27404116.0,3802559.0,,,135476.37,1675506.0,102139.0,8244.0,,N,746407.0,,,-80.0,3337264.0,,5486555.0,,972711.0,5849064.0,172355.0,,,,,,2189273.0,,,337996.0,,,425303.0,,302422825.0,,,6723883.0,,,1927394.0,,,,131089.0,,15306063.0,,,,126799.0,,264307.0,,,14111.0,86132.0,,37378376.0,5863019.0,130414801.0,,17172258.0,13908.0,,,4005334.0,,,,,,,,,114147.0,,1678509.0,68808.0,,2138.25,41537.0,,114655.0,-116667.0,,,336509287.0,375966.0,,,,,1061752.0,,22411438.0,3645139.97,16649.0,1.0,,123774.0,,,,,146108.0,698.0,,8156239.0,,,,20949.0,19756070.0,11914.0,314303122.0,,12038632.0,303999.0,,22855656.0,124642.0,,,8824351.0,1061752.0,-1455.0,1738918.0,618058.0,372061.0,,F,4600822.0,,17270402.0,16055335.0,,,,37218629.0,13391967.0,3080671.0,3964638.0,,1264344.0,23.0,,29231.0,1680985.0,,,,,552969.0,,,,,,299309.0,3.0,,4954.0,,10336912.0,486321.0,3485743.0,27673.0,,,,,,,,2.0,,,238894.0,,,,,,982.0,97986.0,13348819.0,10.0,514316.0,-1144188.0,42.27,,,2691125.0,37378376.0,11179.0,,6714.0,,,112557850.0,,1539895.0,,,6647461.0,32052599.0,1212857.0,,,,ACUTE REHAB,,19519.0,,,50290.0,,11929370.0,,31994574.0,97986.0,,,,16396826.0,,149511890.0,18966261.0,,,81551.5,,,,,,,,,867339.0,,,,854223.0,,,58102.0,,,5676378.0,,,,,,29303173.0,16709.0,,43549.0,,10921672.0,,8527.0,67220.0,1074547.0,1005.0,,19.0,,,,,,,,32101250.0,,1216810.0,,,,1140895.0,,,,,18871.0,,13497.0,,62723.25,,258172674.0,,1.0,,94.0,460.0,13810.0,,27372.0,,,,15.0,,,,3980269.0,5373818.0,-360418.0,N,,,,,,,,,-83541.0,,,4031.0,17277263.0,32101250.0,,7619040.0,3431156.73,6.0,,,155371.0,,,,,1729850.0,8527.0,3709428.0,,1437.0,2246016.0,,,,,,69.0,685307.0,,,486292997.0,47101253.0,,,,,336509287.0,N,,,,,,3584112.0,3829811.0,,,,,,,-19396046.0,,747315.0,22423325.0,,283.0,,,,21876.28,3667801.0,34.0,,351997851.0,,,372061.0,,,,28.79,,6761523.0,,156326.0,,1733.0,37204558.0,1982936.0,,343588.0,13497.0,,,9727.0,11914.0,,17.33,,1289546.0,,3030987.0,,,33619.0,363.0,508174.0,,,1723107.0,,,2196182.0,-704536.0,,117307847.0,,31683.0,,,232287.0,13912433.0,,,,,,173388.0,,,,,,,1422255.0,,-56924.0,,,,2304.73,,,10629.0,P,,37.1,,19904535.0,,,266091.0,56730.0,53.89,,,-10767.0,,970150.0,,,,,,2318.0,1859349.0,1220.0,,,3947.0,,-51032.0,,,313544789.0,,,3152.0,,146533073.0,,,,95095914.0,,,,35567.0,1927394.0,,16254494.0,1291719872.0,895065.0,,,,,7139053.0,,9360.0,,,,-1425434.0,,,,543926.0,,,4403897.0,-1015601.0,3450450.0,,589082.0,38429.0,20949.0,,,,157.0,,,,,,15658334.0,1316574.0,,,,,83128.0,,,,,,8082115.0,,-1425434.0,,69998.54,156326.0,639139.0,15502656.0,,,153075678.0,39319858.0,357365.0,2247280.0,,,,,,2196.0,,,3125593.0,3.0,,,739460.0,,2257259.0,1571589.0,,,,,946223.0,,,,,,,,6097359.0,,197921.0,,,,,,,853075.0,4757.0,496041.33,880.0,,,359201.0,,,60090.83,,,1893830.0,,,8789.0,33088.0,7901750.0,1256.0,888757.0,,,,2691125.0,,,,,,,,,126690717.0,,946223.0,5655454.0,,,5645264.0,,,9337.0,,,,1449480.0,,,,,,24155.0,,,117307847.0,,,,9585276.0,299.0,543926.0,,,,1,,,,429991.0,,,,,,,,,,1943263.0,,3334477.0,,,12877.0,,,,376.0,3334477.0,285263.51,,22376275.0,40035335.0,2189273.0,,30674.0,,,187.0,8408.0,,,,171243.0,33210655.0,2123751.0,4031.0,4447458.0,,,3667801.0,,,,1216810.0,15254907.0,,,,198766.0,,,11674092.0,,-76605.0,,47459602.0,CUYAHOGA,,501672.0,,933281.0,303999.0,685307.0,,3829811.0,,,,,50624.0,,,,,,254266.0,,6390722.0,,,,,,,,,,149447.0,,,538.0,,2886157.0,,4678000.0,,,,,,,,,,22557259.0,-240865.0,Y,,,112851451.0,,,1196245.0,,,,,,82916.0,12059186.0,,,,,15254907.0,,,941986.0,,,593328591.0,,,,811.0,,,,4237931.0,,11538334.0,,40.0,0.245652,288.0,,59613.0,N,68286476.0,117755146.0,882519.0,11389362.0,,,,,,N,,,,21.0,,220722.0,,4891.0,48408.56,1678509.0,,220435.0,,,,,4841.0,,,49448228.0,,11433.0,53.0,4231255.0,,,,,,,4369928.0,2263562.0,,2972364.0,,1970.0,,9071233.0,11371956.0,,,347211.0,183.0,,,,33847.0,,,2440697.0,1356208.0,,,2746205.0,,8643.0,79655909.0,3986.0,,-330776.0,,11371956.0,959887.0,7703662.0,-6195.0,10339293.0,9731092.0,6781.0,10765213.0,,4828570.0,14745033.0,,4131.0,2259983.0,1553744.0,,5124086.0,,79224.0,,,26251.0,1735802.0,93.0,375.0,4206699.0,,77379.0,,,,2101924.0,,,,2767533.0,,-9162907.0,,,156469.0,,,,,106534.0,14073757.0,2193126.0,3996.0,27242932.0,15809.0,,,47459602.0,,,,,,3665604.0,,,,,71.0,265.0,679138.0,,,,,,,6502.17,,,,4757.0,1449480.0,,,,,1438874.0,,,187.0,,,14132867.0,,,,3378174.0,,,-19354.0,,,,,3009505.0,1988.0,,,18510.0,1449480.0,57036955.0,,,,,2042628.0,,-52504684.0,,6907766.0,,,,,,6933941.0,,,1526.0,,11744.0,,14765077.0,,,,5567520.0,,,5155.0,28.49,240937.0,,101953.0,4874542.0,119537.0,,,,175.0,,,,44700.0,,-19396046.0,40.0,,7.0,4861704.0,,,1898108.0,4904152.0,,44204.0,24172649.0,,,,,,6685.0,,250466758.0,,216075523.0,,,675.0,,,,2013666.0,,4509.0,15545.0,3549073.0,-3907482.0,,,,,,,,,,4576.0,,1969.0,,,,,,,,,241090.0,138281.0,165474.0,,342861833.0,121048621.0,1192.0,-9840.0,,,,,3904304.0,,,1162485.0,,31956145.0,,,,327552.0,,13391967.0,,,,,153075678.0,33847.0,603.0,,,14.0,146239472.0,4421979.0,38.0,,,,36S155,,,N,,,3025740.0,6566.0,,,,249.0,,,,32101250.0,,15306063.0,14074897.0,2141422.0,238597486.0,2123751.0,-118670.0,,,,,,,,,,,,,,12478737.0,1.0,9.0,22682.0,,891449.0,,,7745185.0,,,,11891476.0,,,,32.3,11887.0,,,-270129.0,,,895065.0,,173.0,,,,,317314190.0,,,,,,,,,,1371454.0,,4403897.0,51256.0,,-50945.0,214.0,634.0,,6302472.0,,25262.0,32.43,,454931.0,436512.0,5348709.0,,,,,,35.13,,,,7605.0,903036.0,,,,,,,,,302110.0,16229940.0,6390722.0,14111.0,,4266109.0,666511.0,1077063.0,47.73,,,,1371454.0,,,567.0,,,2682852.0,3002208.0,352000.0,12344496.0,36552.0,,56730.0,,,,4275894.0,,,,,,N,,75300.0,22682.0,351724.0,1802569.0,,,17340267.0,8435220.0,697684.0,,27613.0,28901.0,512756.0,14765077.0,54.27,,4535595.0,,,787459684.0,3025740.0,,,1954073.0,10921672.0,,39757910.0,121614989.0,41615.0,1175441.0,3226113.0,327552.0,11369210.0,,13921.0,14359.24,4035.0,93610.0,9752189.0,34026.0,,8599755.0,1769773.0,,,41615.0,,,,,,3143.0,912109.0,28.52,2142401.0,15201,,,,,,83698.0,360155,,,,,628561.0,,1007167.0,2498550.0,,211.0,,38464352.0,,17983.0,1295992423.0,37589.0,,,,59908397.0,SOUTHWEST GENERAL HEALTH CENTER,1747144.0,,3332.0,70.0,,,581619.0,,,512114.0,6255346.0,,,1390758.0,,,,52.0,,166070.0,42.62,1385062.0,43.89,452.0,,,12478737.0,,785316972.0,1750.06,,,,,,618058.0,,1924213.0,1233.0,47459602.0,15.83,108974.0,,19618.0,389512.0,10164.0,,,926158.0,,4840727.0,1982999.0,5900176.0,,,,,,,-21608.0,1913303.0,,,,,,,,4489554.0,OH,1074547.0,,,6052.0,,,,,,,1580372.0,42128.0,1949811.0,,,67502.0,,,,,,,21655519.0,,3234.0,1975.0,,,14643.0,,,42761013.0,,10964.0,,1694.0,19.87,,623376.0,47.0,2646655.0,,,,11371956.0,,,2222.0,,,,1470043.0,,6255346.0,,437420.0,1431857.0,,77379.0,,,,,,,,,,,,,,,,,,,,243785.0,5842199.0,3107.0,,820973.0,,,23127548.0,,16029.0,,,48103034.0,,1571589.0,6126.25,,3615.0,,,,4.0,,2298160.0,,,,,,3067.0,697684.0,,11382013.0,,12038632.0,216.0,,14132867.0,,,N,7300603.0,,317656984.0,,5190.0,,161.0,11406083.0,,,42.75,SWGHC MENTAL HEALTH SERVICES,,,,N,,,297356.0,36T155,,5731758.0,4897.0,855507.0,,144964.0,,33.08,10891.0,,,,,,87.0,22423325.0,,258.0,-30521.0,,276.0,,,,3009505.0,,,1451965.0,,,33847.0,,,,1486773.0,,75069.0,,33714348.0,1233.0,15.07,15811.0,3660.0,,,328.0,261.0,10158061.0,,,,,,,,,-3381497.0,31.37,39494.0,-5614227.0,,,,17.33,,6013798.0,,,,,,,169961026.0,,80467.0,,429991.0,2222.0,,,,,,2022-12-27 00:00:00,,787031.0,3747304.0,,,,,5579095.0,8527.0,8244.0,83698.0,1205430.73,,22557259.0,516763.0,,,,404035.0,29965478.0,515869.0,880.0,,Y,45.91,508532739.0,2508534.0,,,1913256.0,,,,,,97986.0,,,241090.0,,,,,-9055.0,,,,258172674.0,11382828.0,22409.0,,,596.0,,12905725.0,437.0,,83068.0,,,,5544.0,3615.0,,,,,,1175793.0,,,,6181012.0,,6487128.0,,5059363.0,483096.0,7619040.0,5900176.0,2.0,,5304907.0,3143.0,2440697.0,,,2218802.0,78357.0,,,,,,,352365.0,,2360358.0,,3067.0,36519.34,,3906712.57,381608.0,,,94367.0,,506402900.0,199511.0,,21271328.0,,,,,,,8527.0,948421.0,,,,,,,-39235.0,88788727.0,,41615.0,47335893.0,,72446.0,,254730.0,,,General Short Term,,,,4915051.0,,,,8926828.0,,,1610637.0,,,,,4113.0,29702.0,2246016.0,1591.95,1203717.0,,,42350198.0,22278895.0,26.0,,,4235.0,,6207509.0,1191749.0,,,32663395.0,4562472.0,6573746.0,17209938.0,,,,156326.0,1.0,34.0,908114.0,Y,,,,,,,156469.0,,,,,1438473.0,,2298631.0,,,,4270.0,49662.0,,10887326.0,3152.0,,281317.0,946223.0,16.0,6539.0,428989.0,,,28906.0,,,,,355905333.0,6802440.0,,,333834.0,,1467934.0,,343588.0,498.0,,,126243418.0,32101250.0,49.0,,,56.88,,,,,31683.0,,188.0,-20805.0,,,698.0,6714196.0,142243.0,,89181.0,,,,,,,,67102.0,,264982.0,43344807.0,1567.0,98003.0,,321142727.0,,,33714348.0,,,,-2160.0,,,,41615.0,20168068.0,,,,,10997594.0,,,2136558.0,,203631.0,,57.0,,,3508354.0,,,,178.0,,,,315871.0,,22855656.0,106601553.0,-9057187.0,1561712.0,,,,3541512.0,,206619.0,,,1484213.0,27977.0,34664795.0,,,1182579.0,,13051874.0,40.96,,,,1034799.0,,,,526727.0,2498550.0,,,,,,361530,,145667.78,4721.0,,,3667801.0,,23.11,1520611.0,5842199.0,,2961597.0,,6557.0,44130-3497,,,359201.0,1676432.0,,,,,1385062.0,8527.0,,,,6931.0,1214897.0,1046651.0,,,1916284.0,,34728217.0,18697 BAGLEY ROAD,33.0,4275894.0,-12.0,,,,,2020-01-01 00:00:00,107.0,918525.0,,-4019797.0,1451280.0,,,,,67345.0,9372171.0,16839.0,,,,,,19619259.0,316808.0,50614967.0,,,,1187246.0,,,8082115.0,,,,,6030880.0,,,,230213.0,12388637.0,,1311092.0,,,,,,3309472.0,,,,5584.0,,1610380.0,,,,,,4041.0,,,,,59445.0,,3050622.0,,-1455.0,11013.0,,,,,,,,,,4005334.0,,,25270.0,132982617.0,,,,,,,,33.0,,,590500.0,367253,31.0,5849064.0,,,,,,131089.0,20290999.0,,,555021.0,,,,,,,,MIDDLEBURG HEIGHTS,,754339.0,,,,,,27613.0,,1697933.0,4692998.0,,,23387.0,,,,3520231.0,,,,,7052443.0,9360.0,,,,,44628.0,,,,,,,,,,6842266.0,,,,,207.0,,16523496.0,6013798.0,3294.0,,,,64.0,526727.0,496041.33,85.0,-261961.0,,,,20485.49,,,1.0,,1580372.0,,,,,,6739485.0,,,,,-187766.0,,,4421979.0,,,,,,,,,1913256.0,,,-210560.0,,,,2.0,-623381.0,,9071233.0,,193738.0,,,,,6338449.0,,,96468.0,,79635.84,11245812.0,,,388097.0,,,1918714.0,,76.0,2.0,25844506.0,,,3410671.24,,,23966.0,13615.0,28811312.0,,1941707.0,9216800.0,44.0,,,,,,8383594.0,,4145267.0,300905.0,57984.0,1947840.0,,443394.0,,,333467.0,,,,,,5072295.0,,,,353296.0,15872015.0,,,,,,,13190974.0,853075.0,,,4692998.0,,,943994572.0,,2558.0,,N,2299913.0,10387979.0,,,181731.0,,,,18555525.0,,,,,-40917.0,498.0,,,142461.0,,620723.0,,151669.0,,5684277.0,,,,27318950.0,,,10339293.0,67345.0,,3230569.0,,,,,1287.0,2407428.0,13051874.0,4447458.0,,13497.0,,-15975.0,13190974.0,78686.0,,,,,,-4076.0,1129.0,,,5490.0,,,,,Y,,,,,,,2157.0,,,251.0,2217880.0,,,,918525.0,20168068.0,,,100070.0,83128.0,,7222000.0,,,,,32626.0,2498550.0,1077063.0,,,-145147.0,,,2284020.0,,294989264.0,,912.0,,,2486.0,11708298.0,,39196.0,,28695275.0,4145267.0,623376.0,84.0,734468,,,,,1572158.0,,,,,632262.0,1982936.0,4363903.0,,,,77.15,,151.0,4176.0,105207.0,,,136655.0,,142162.0,,,4860.0,11674092.0,1935115.0,34658874.0,,4329.0,N,,3747304.0,,,,,,3490752.0,842312.0,,183.0,,,,,15260193.0,,1497828.0,,,,47459602.0,854223.0,,,,,,17460,2020-12-31,146.1,,,,,,,,,5439.0,,,,84689159.0,,,,,-64010.0,,12078.0,,,15203297.0,1947840.0,908114.0,3528650.0,1610637.0,8599755.0,,2015.0,,,N,,,,,62155110.0,,1943263.0,,,,,,,138232.0,15688567.0,,19.0,N,,,928478.0,-349376.0,,1572158.0,,,,177.0,,180.0,,5.0,22963.0,493890.0,22643725.0,,7.0,,30104995.0,1.0,2353314.0,1720726.0,4231255.0,22643547.0,,,,,,,84.0,1982936.0,,,213897449.0,,47629.0,,,31683653.0,,1187246.0,,,,,276583.0,109822776.0,3051.0,5.0,,,156326.0,15142284.0,,28311686.0,15662079.0,7300603.0,9489276.0,1264668.0,1610380.0,,-10657.0,,2399415.0,,1188754.0,8820280.0,,,,1096791.0,,,,,,,,-2417370.0,,,,,,9731092.0,18.47,,1.0,,,,,,,,,,2196608.0,2020,Acute Care Hospitals,SOUTHWEST GENERAL HEALTH CENTER (360155)
68349,SOUTHWEST GENERAL HEALTH CENTER (360155),General Short Term (Acute Care Hospitals),Voluntary Nonprofit-Other,-81.83291,41.37208,,,30.16,,,,9789891.0,,,44137.0,,,,,,,155.0,,,,216987.0,,,,,,622529.0,5422102.0,,,155.0,37562750.0,328358.0,16055648.0,3666.0,,,,11240.0,8076795.0,,,,,2532042.0,,7515698.0,9349.0,1001679.0,18229.0,,,1896610.0,,,5534892.0,7159849.0,,76092.0,4.0,,,293017.0,,,,,,,,3266835.0,,,-892745.0,334188.0,,,,,,1125645.0,,,5487730.0,84533.0,,,,97.0,,,,,,,77215.0,,,,,,,,10442749.0,,,1820300.0,,7245140.0,,44120.0,,,,116765.5,24835235.0,,,,,,3197978.0,15961.0,30671204.0,,,,,,,,141708.0,766281.0,,,,,,24055.0,,,,,,,,6202.0,,,2316996.0,,59298.0,,,,489630312.0,,6182153.0,2404471.0,46312.0,,26934853.0,3967106.0,,,135781.7,1827734.0,63430.0,7151.0,,N,602759.0,,,,4267685.0,,5785922.0,,821241.0,5674593.0,421337.0,,,,,,2273671.0,,,691645.0,,,426918.0,,314303122.0,,,7020735.0,,,1814074.0,,,,146277.0,,15563431.0,,,,112725.0,,253255.0,,,14596.0,65355.0,,41287647.0,6483134.0,127224043.0,,18309013.0,13870.0,,,4034710.0,,,,,,,,,116767.0,,1634499.0,68620.0,,2097.0,29132.0,,88599.0,-330798.0,,,358141420.0,322473.0,,,,,1542754.0,,24602962.0,3747764.73,17010.0,1.0,,152799.0,,,,,126028.0,441.0,,8254767.0,,,,21021.0,35053286.0,10366.0,314968838.0,,13128996.0,221643.0,,31248121.0,125451.0,,,9461250.0,1542754.0,-1934.0,1547993.0,570250.0,391575.0,,F,4042089.0,,19814782.0,16055648.0,,,,37076038.0,13895314.0,2863543.0,4205963.0,,1438865.0,16.0,,24976.0,1661667.0,,,,,766281.0,,,,,,319285.0,,,1111.0,,12859504.0,524730.0,2322687.0,29383.0,,,,,,,,,,,140222.0,,,,,,918.0,104584.0,15899919.0,10.0,533614.0,-1287627.0,46.02,,,3634337.0,41287647.0,18041234.0,,2699.0,,,125303263.0,,1617037.0,,,16747630.0,36294240.0,1285989.0,-8197.0,,,ACUTE REHAB,,17085.0,,,47613.0,,13018935.0,,32439371.0,104584.0,,,,20349532.0,,144300675.0,25785895.0,,,82624.36,,,,,,,,,825076.0,,,,1010813.0,,,86998.0,,,6494261.0,,,,,,38645399.0,8435.0,,40282.0,,11322459.0,,15226.0,70512.0,1174868.0,706.0,,,,,,,,,,33204857.0,,1227156.0,,,,1059435.0,,,,,22124.0,,14332.0,,59629.32,,220712783.0,,,,46.0,627.0,,,99963.0,,,1739.0,15.0,,,,1845671.0,4221948.0,-403937.0,N,,,,,,,,,-41355.0,,,3918.0,18326460.0,33204857.0,,8107133.0,3573268.95,8.0,,,40980.0,,,,,1800491.0,15226.0,4069775.0,,1484.0,2469842.0,,,,,,100.0,521261.0,,,491808386.0,49155374.0,,,,,358068506.0,N,,,,,,3385397.0,3831056.0,,,,,,,-35937189.0,,647199.0,24602229.0,,213.0,18300.0,,,21559.92,3779156.0,,,394385112.0,,,391575.0,,,,29.35,,8191766.0,,129124.0,,1059.0,37068469.0,2224538.0,4804.0,380760.0,14332.0,,,4723.0,10366.0,,18.88,,1387680.0,,3800459.0,,,18026.0,471.0,602776.0,,,1542940.0,170461.0,,-6169206.0,-768823.0,,129029432.0,,35519.0,,,190960.0,16098005.0,,,,,,268361.0,,,,,,,1466143.0,,-74577.0,,,,2549.07,,,3127.0,P,,38.71,,17582867.0,,,292625.0,56575.0,59.37,,,-19111.0,,1045324.0,,,,,,,2068219.0,1129.0,,,9561.0,,-10279.0,,,329556031.0,-75.0,,2678.0,,160277147.0,,,,97403248.0,,,,35329.0,1814074.0,,16828509.0,1432556888.0,912800.0,,,,,8076795.0,1962.0,12385.0,,,,-5484329.0,,,,686607.0,,,4450280.0,-805462.0,3343607.0,,662185.0,24055.0,21021.0,,,,1644.0,,,,,,16749256.0,1487643.0,,,,,108225.0,,,,,,7744898.0,,-5484329.0,,68095.49,129124.0,666511.0,17324890.0,,,166001841.0,43874738.0,293785.0,2885620.0,,,,,,,,,3379096.0,3.0,,,741149.0,,2261630.0,1595729.0,,,,,1013475.0,,,,,,,,5952344.0,,316256.0,,,,,,,826189.0,1353.0,484058.86,634.0,,,352204.0,,,61345.22,,,2228743.0,,,6690.0,69307.0,6398642.0,212.0,1002738.0,,,,3634337.0,,,,,,,,,139903920.0,,1013475.0,5557132.0,,,5001540.0,,,7861.0,,,,1470967.0,,,,,,24125.0,,,129029432.0,,,,10578921.0,645.0,686607.0,,,,1,,,,544927.0,,,,,,,,,,1959500.0,,4482742.0,,,17981.0,,,,,4482742.0,285565.32,,19559168.0,39279932.0,2273671.0,,15610.0,,,177.0,11668.0,,,,160832.0,38338896.0,2052875.0,3918.0,6286375.0,,,3779156.0,,,,1227156.0,17605600.0,,,,238067.0,,,10024705.0,,-63641.0,270057.0,49072980.0,CUYAHOGA,,432264.0,,957903.0,221643.0,521261.0,,3831056.0,,,,,49607.0,,,,,,534099.0,,6637359.0,,,,,,,,,,,,,225.0,,3810218.0,,950000.0,,,,,,,,,,21920100.0,-883631.0,Y,,,125638229.0,,,887995.0,,,,,,64017.0,13142397.0,,,,,17605600.0,,,1329216.0,,,614338132.0,,,,,,,,4535512.0,,14366496.0,,8224.0,0.236507,243.0,,47820.0,N,60562683.0,129431753.0,866412.0,12078194.0,,,,14262.0,,N,,,,,,205753.0,,2881.0,50315.7,1634499.0,,182055.0,,,,,4735.0,,,61780533.0,,11240.0,13.0,5162005.0,,,,,,,4308715.0,2380463.0,,2984551.0,,,,9208526.0,11624867.0,,,292129.0,189.0,,,,31408.0,,,3234256.0,1159736.0,,,2960049.0,,7875.0,88174922.0,6013.0,,-270103.0,,11624867.0,955142.0,8340265.0,-6615.0,10228389.0,10186494.0,3127.0,10859004.0,,5291228.0,18325564.0,,4655.0,2147943.0,1456008.0,,5679177.0,,94402.0,12500.0,,27036.0,1635785.0,91.0,327.0,4514918.0,,99941.0,,,,2228616.0,,,,2811745.0,,-25358375.0,,,129166.0,,,,,60889.0,17603848.0,1890692.0,4406.0,29502002.0,12412.0,,,49072980.0,,,,,,4254927.0,,,,,32.0,295.0,672848.0,,,,,,,6360.0,,,,1353.0,1470967.0,,,,,1339928.0,,,,2093.0,,14600657.0,,,,3139981.0,,,-40495.0,,,,,2747476.0,2025.0,,,12123.0,1470967.0,54927747.0,,,,,2235055.0,,-54277859.0,,7773227.0,,,,,,7963798.0,,,1958.0,,1984.0,,13355489.0,,,,6199802.0,,,6167.0,30.16,206621.0,,89336.0,5265137.0,103374.0,,,,103.0,,,,74887.0,,-35937189.0,8224.0,,,3821580.0,,,1901798.0,4964404.0,,31416.0,24860725.0,,,,,,4433.0,,287678330.0,,193435005.0,,,287.0,,,,2198585.0,,,12323.0,3309216.0,306503.0,,,,,,,,,,4919.0,,359.0,,,,,,,,,140222.0,110292.0,186570.0,,326659802.0,132632013.0,1111.0,-3871.0,,,,,3794468.0,,,1368672.0,,32415316.0,,,,247212.0,,13895314.0,,,,,166001841.0,31408.0,845.0,,,118.0,159942181.0,4272941.0,38.0,,,,36S155,,,N,,,3197978.0,,,,,148.0,,,,33204857.0,,15563431.0,12652499.0,2547011.0,265049177.0,2052875.0,-248300.0,,,,,,,,,,,,,,13493008.0,,9.0,30996.0,,1396213.0,,,7617846.0,,,,18706949.0,,,,34.54,4071.0,,,-244991.0,,,912800.0,,145.0,,,,,338809467.0,,18100.0,,,,,,,,1464433.0,,4450280.0,108.0,,-49009.0,153.0,541.0,,7806184.0,,15915.0,34.62,,510439.0,475698.0,4888280.0,,,,,,37.38,,,,2970.0,888311.0,,,,,,,,,345671.0,16803955.0,6637359.0,14596.0,,4629289.0,748373.0,1036654.0,48.47,32444.0,,,1464433.0,,,134.0,,,2888857.0,2817508.0,305237.0,13334953.0,60646.0,,56575.0,,,,4743831.0,,,,,,N,,88734.0,30996.0,305209.0,1520211.0,,,37562750.0,9025156.0,621067.0,,33738.0,7398.0,897916.0,13355489.0,62.06,,3977774.0,,,884520832.0,3197978.0,,,1819287.0,11322459.0,,34332552.0,106145228.0,70271.0,1169196.0,3084503.0,247212.0,11619270.0,,9712.0,10754.55,1149.0,83155.0,10545823.0,26498.0,,9234320.0,1895938.0,,,84533.0,,,,,,3424.0,905388.0,26.5,2363197.0,15201,,,,,,98278.0,360155,,,,,640758.0,,940361.0,2519723.0,,220.0,,40205386.0,,11456.0,1437999451.0,25350.0,,,,67522897.0,SOUTHWEST GENERAL HEALTH CENTER,1820300.0,,,49.0,1.0,,646386.0,,,400368.0,6255346.0,,,1242676.0,,,,93.0,,138058.0,44.76,1339488.0,46.87,103.0,,,13493008.0,50936.0,880687267.0,1800.99,80.0,,,,,570250.0,,1962846.0,1214.0,49072980.0,14.98,91646.0,,15943.0,359062.0,7099.0,,,1485626.0,,5362400.0,2283173.0,6636176.0,,,,,,,-40932.0,1948174.0,,,,,,,,4727042.0,OH,1174857.0,,,7862.0,,,,,,,1434061.0,34701.0,1765909.0,,,51007.0,,,,1016.0,,,22278895.0,,981.0,1176.0,,,7324.0,,,43549250.0,,6272.0,,1392.0,21.34,,,,3080804.0,,,,11624867.0,,,2056.0,,,,1836037.0,,6525404.0,,376423.0,1422334.0,,99941.0,,,,,,,,,,,,,,,,,,,,216987.0,5776584.0,2192.0,,824473.0,,,29317441.0,,3752.0,,,54776615.0,,1595729.0,5978.0,,420.0,,,,3.0,,1999527.0,,,,,,2797.0,621067.0,,13477616.0,,13128996.0,3888.0,,14600657.0,,,N,8061512.0,,339197157.0,,6202.0,,87.0,14685813.0,,,39.52,SWGHC MENTAL HEALTH SERVICES,,,,N,,,310072.0,36T155,9349.0,6179739.0,7987.0,788008.0,,103064.0,,33.09,6504.0,,,,,,,24607033.0,4548.0,,-48476.0,,28.0,,,,2747476.0,,,1536896.0,,,31408.0,,,,1228753.0,,39227.0,,40499692.0,1214.0,16.44,5053.0,3650.0,,,,2860.0,12130172.0,,,,,,,,,-3696864.0,32.73,10122.0,-5707027.0,,,,18.89,,6081564.0,,,4548.0,,,,177664257.0,,79965.0,,544927.0,2056.0,,,,,,2022-05-26 00:00:00,,1001679.0,4576410.0,,,,,5015749.0,15226.0,7151.0,98278.0,1236008.4,,21920100.0,435863.0,1739.0,,,340772.0,39730033.0,799857.0,634.0,,Y,43.82,553478619.0,2675455.0,,,1917318.0,,,,,,104584.0,,,140222.0,,,,,47599.0,,,,220712783.0,13478431.0,21500.0,,,1054.0,,15165994.0,,,81010.0,,,,1292.0,420.0,,,,,,892401.0,,,,6182153.0,,6336699.0,,5472521.0,473215.0,8107133.0,6636176.0,,,6417423.0,3424.0,3234256.0,,,1814897.0,66436.0,,,,,,,311063.0,,2328452.0,,2797.0,36295.82,,4040595.26,386530.0,,,73688.0,,551869621.0,199588.0,,24724204.0,,,22321.0,,,,13487.0,1339941.0,,,,,,,-66026.0,98937976.0,,70271.0,51261370.0,,63654.0,,245694.0,,,General Short Term,,,,4941177.0,,,,9277057.0,,,1694157.0,,,,,1101.0,19781.0,2469842.0,1647.6,1385858.0,,,46207089.0,20691530.0,30.0,,,3955.0,,6359965.0,1183308.0,,,36592287.0,4170556.0,6825574.0,18362146.0,,,,129124.0,,,1077712.0,Y,,,,,,,129166.0,,,,,1467187.0,,2532042.0,,,,-53400.0,53327.0,,10881184.0,2678.0,3250.0,257178.0,1013475.0,,5519.0,503730.0,,,33494.0,,,,,394078609.0,8245157.0,,,335533.0,,1250897.0,,380760.0,4435.0,,,139533543.0,33204857.0,,,,57.38,,,,,35519.0,,188.0,-40932.0,,,521.0,5794617.0,93712.0,,106377.0,,,,,,,,51290.0,,268591.0,42108114.0,449.0,110719.0,,341519844.0,,,40499692.0,,,,-2160.0,,31944.0,,84533.0,24520562.0,,,,,15566490.0,,,1960995.0,,199783.0,,26.0,,,3583019.0,,,,42.0,,,4851.0,411687.0,,31248121.0,113344366.0,-9319562.0,1884215.0,,,,3652212.0,,225350.0,,,1402718.0,23637.0,37248670.0,,,1291890.0,,13841917.0,44.21,,,1587365.0,1173827.0,,,,418044.0,2519723.0,,,,,,361530,,177075.68,17724.0,,,3779156.0,,24.67,1470537.0,5776584.0,,2965440.0,,8701.0,44130-3497,,,352204.0,1590453.0,,,,,1339488.0,13487.0,,,,4352.0,1225327.0,1105581.0,,,2050663.0,,39214306.0,18697 BAGLEY ROAD,35.23,4743831.0,,,,,,2021-01-01 00:00:00,152.0,749438.0,,-11142081.0,1196787.0,,,,,70183.0,9242690.0,15330.0,,,,,,19267893.0,412263.0,53351153.0,,,0.5,1338015.0,,,7744898.0,,,,,6577600.0,,,,235568.0,13690996.0,,1226457.0,,,,,,2828182.0,,,,11443.0,,1493073.0,,,,14262.0,,3902.0,,,,,46322.0,,2892769.0,,-1934.0,14872.0,,,,,36989.0,,,,,4034710.0,,,32133.0,153333946.0,,,,,,,,33.0,,,634731.0,367253,335.0,5674593.0,,,,,,146277.0,20983389.0,,,645263.0,,,,31.44,,,,MIDDLEBURG HEIGHTS,,738617.0,,,,,,33738.0,,1760271.0,5002074.0,,,18889.0,,,,4352901.0,,,,,6830234.0,12385.0,,,,,46558.0,,,,,,0.5,,,,6394286.0,,,,,,,18482236.0,6081564.0,3285.0,,,,,418044.0,484058.86,,-244606.0,,,,16732.55,,,1.0,,1434061.0,,,,,,6806548.0,,,,,-267192.0,,,4272941.0,,,,,,,,,1917318.0,,,-192661.0,,,,21.0,-761315.0,,9208526.0,,109230.0,,,,,6092566.0,,,61801.0,,76990.58,9563138.0,,,604106.0,,,1585506.0,,32.0,,27464381.0,,,3556536.4,,,17236.0,5053.0,30885062.0,,1896610.0,9372171.0,,,,,,32444.0,8981308.0,,4344918.0,249168.0,61937.0,2016857.0,,611420.0,,,300122.0,,,,,,5487730.0,,,,453171.0,17495233.0,,,,,,,15141670.0,826189.0,,,5002074.0,1962.0,,1043614339.0,,66.0,,Y,2990243.0,9544379.0,,,219602.0,,,,19808144.0,,,,,-53391.0,4435.0,,30106.0,127555.0,,648814.0,,142864.0,,6338727.0,,,,29551407.0,,,10228389.0,70183.0,,3511052.0,,,,,175.0,2000586.0,13841917.0,6286375.0,,14332.0,,-44409.0,15141670.0,79233.0,,,,,,-12422.0,632.0,,,5475.0,,,,,Y,,,,,,,2062.0,,,251.0,2122762.0,,,,741241.0,24520562.0,,,91509.0,108225.0,,10673509.0,,,,,24521.0,2519723.0,1036654.0,,,-142944.0,,,2457702.0,,309747887.0,,3881.0,,,4785.0,9862627.0,,44120.0,,25201215.0,4344918.0,,94.0,741726,,,,,2422033.0,,,,,533806.0,2224538.0,4566854.0,,,,85.7,,44.0,9.0,97150.0,,,137479.0,,197393.0,,,,10024705.0,1902661.0,36407193.0,,2102.0,O,,4576410.0,,,,,,3864930.0,877612.0,,189.0,,,,,13233738.0,,1407771.0,,,,49072980.0,1010813.0,,,,,,17460,2021-12-31,152.69,,,,,,,,,966.0,,,,105947019.0,,,,,-76606.0,,12045.0,,,16492104.0,2016857.0,1077712.0,3739623.0,1694157.0,9234320.0,,2362.0,,,N,,,,,67978269.0,,1959500.0,,,,,,,110292.0,11708298.0,,,N,,,898587.0,-2642.0,,2422033.0,,,912.0,,,217.0,,3.0,26871.0,400293.0,24793922.0,,,,33943974.0,1.0,2744341.0,1754382.0,5162005.0,24793880.0,,,,,,,,2224538.0,,,191256931.0,,47481.64,,,30671204.0,,1338015.0,,,,,291587.0,107117844.0,2263.0,3.0,,,129124.0,15186474.0,,34415091.0,13764551.0,8061512.0,9226107.0,1371195.0,1493073.0,,-14457.0,,2319508.0,,1168892.0,9709848.0,,,,1073472.0,,,,,,,,-2115358.0,,,,,,10186494.0,20.52,,,,,,,,,,,,2624110.0,2021,Acute Care Hospitals,SOUTHWEST GENERAL HEALTH CENTER (360155)
71496,SOUTHWEST GENERAL HEALTH CENTER (360155),General Short Term (Acute Care Hospitals),Voluntary Nonprofit-Other,-81.83291,41.37208,,,32.56,,,,9095208.0,,,35806.0,,,,,,,167.0,,,,272943.0,,,,,,700705.0,5504867.0,,,167.0,9860746.0,407386.0,15080336.0,,,,,9577.0,8508886.0,,,1253.0,,2758691.0,,6700860.0,9022.0,911681.0,19491.0,,,1967139.0,,,5546347.0,8549555.0,,99790.0,3.0,,,306662.0,,,,,,,,3321231.0,,,-937578.0,270718.0,,,,,,1178917.0,,,5644678.0,27789.0,,,,83.0,,,,,,,67391.0,,,,,,,,10305759.0,,,1836745.0,,7679557.0,,46301.0,,,,116765.5,26251653.0,,,,,,3076331.0,45999.0,33413333.0,,,,,,,,150443.0,766216.0,,,,,,29202.0,,,,,,,,4486.0,,,2446972.0,,101822.0,,37.0,,483315683.0,,5956523.0,2509004.0,48170.0,,26818026.0,3959395.0,,,112714.35,1776215.0,,6023.0,,N,434972.0,,,28620.0,4820736.0,,5827412.0,,650706.0,5405931.0,580497.0,,,,,,2299995.0,,,1681823.0,,,356596.0,,314968837.0,,,7116036.0,,,2105584.0,,,,141802.0,,13863040.0,,,,100372.0,,214257.0,,,13802.0,107784.0,,38782415.0,6660623.0,123454296.0,,18405895.0,12410.0,,,5297496.0,,,,,,,,,61312.0,,1252546.0,69715.0,,2097.0,45751.0,,83033.0,-578652.0,,,374841955.0,260984.0,,,,,1769771.0,,26422838.0,3635891.89,15367.0,3.0,,144678.0,,,,,123402.0,1710.0,,8731917.0,,,,18771.0,28385162.0,10829.0,322886073.0,,12097796.0,368365.0,,20951287.0,149952.0,,,9790595.0,1769771.0,-1657.0,1242543.0,632723.0,400888.0,,F,3527819.0,,20646915.0,15080336.0,,,,44216523.0,13868844.0,2892516.0,4215363.0,,1547385.0,29.0,,28757.0,1730360.0,,,,,766216.0,,,,,,353028.0,,,268.0,,27389039.0,440296.0,1990149.0,32679.0,,,,,,,,6.0,,,162235.0,,,,,,1053.0,88785.0,8544889.0,10.0,485794.0,-1592576.0,42.4,,,4209554.0,38782415.0,,,5029.0,,,129494484.0,,1553328.0,,,6678062.0,33911364.0,1341817.0,,,,ACUTE REHAB,,10038.0,,,45980.0,,12881711.0,,36943304.0,88785.0,,,,21373643.0,,147149719.0,-49282068.0,,,82624.36,,,,,,,,,664588.0,,,,1097062.0,,,,,,6914809.0,,,,,,-21893029.0,,,31647.0,,11072484.0,,5473.0,57928.0,1191321.0,728.0,,,,,,,,,,32979686.0,,1094853.0,,,,1082376.0,,,,,20785.0,,13324.0,,59629.32,,187261744.0,,1.0,,5.0,658.0,5027.0,,175755.0,,,,15.0,,,,151908.0,4241582.0,-657928.0,N,,,,,,,,,-6057.0,,,3637.0,21878502.0,32979686.0,,6561803.0,3540048.59,4.0,,,147474.0,,,,,1817442.0,5473.0,4641494.0,,1389.0,2877147.0,,,,,,158.0,4672975.0,,,485493757.0,50929190.0,,,,,374627311.0,N,,,,,,3446197.0,3609345.0,,,,,,,-21831591.0,,767856.0,26404698.0,,376.0,51125.0,,,23834.7,3850190.0,79.0,,406864893.0,,,400888.0,,,,29.63,,8653416.0,,152353.0,,148.0,44212034.0,2162890.0,20616.0,361531.0,13324.0,,,6462.0,10829.0,,21.61,,1532568.0,,3357166.0,,,60082.0,470.0,743845.0,,,1241655.0,,,7061240.0,-869573.0,,131460560.0,,25640.0,,,157427.0,19772223.0,,,,,,304124.0,,,,,,,1484639.0,,-75330.0,,,,2831.31,,,,P,,37.23,,14824581.0,,,332692.0,60955.0,74.84,,,-10217.0,,1326542.0,,,,,,865.0,2120053.0,1247.0,,,20630.0,,100586.0,,,259656465.0,-235.0,,2043.0,,167535304.0,,,,106497234.0,,,,23114.0,2105584.0,,18176633.0,1418506013.0,923118.0,,,,,8508886.0,1844.0,6053.0,,,,-6370934.0,,,,818520.0,,,4250182.0,-644660.0,2362059.0,,637173.0,29202.0,18771.0,,,,,,,,,,16612389.0,1603238.0,,,,,160315.0,,,,,,9096704.0,,-6370934.0,,68095.49,152353.0,748374.0,16361821.0,,,175107662.0,42593932.0,242195.0,3332316.0,,,,,,888.0,,,2786429.0,3.0,,,740752.0,,2118002.0,1290074.0,,,,,1056055.0,,,,,,,,4275674.0,,274584.0,,,,,,,945632.0,214.0,426410.22,973.0,,,277661.0,,,61345.22,,,2334415.0,,,6452.0,22316.0,4808491.0,674.0,1153912.0,,,,4209554.0,,,,,,,,,143377455.0,,1056055.0,4019962.0,,,4313897.0,,,8605.0,,,,1332458.0,,,,,,20471.0,,,131460560.0,,,,11270531.0,1474.0,818520.0,,,,1,,,,551859.0,,,,,,,,,,1680488.0,,4174667.0,,,15825.0,,,,,4174667.0,285565.32,,22366928.0,37389494.0,2299995.0,,20879.0,,,244.0,9080.0,,,,209448.0,-32084376.0,2148216.0,3637.0,5161341.0,,,3850190.0,,,,1094853.0,14149121.0,,,,224978.0,,,9718245.0,,-115094.0,,51292468.0,CUYAHOGA,,399118.0,,1368599.0,368365.0,4672975.0,,3609345.0,,,,,44537.0,,,,,,744521.0,,8111731.0,,,,,,15880.0,,,,334914.0,,,75.0,,3101867.0,,5850000.0,,,,,,,,,,21326326.0,-541318.0,Y,,,128959525.0,,,979771.0,,,,,,54219.0,12107843.0,,,,,14149121.0,,,1376895.0,,,543076192.0,,,,1795.0,,,,4256287.0,,11635424.0,,7047.0,0.252456,190.0,,35532.0,N,55432882.0,132105030.0,938220.0,11761478.0,,,,,,N,,,,,,169606.0,,,50315.7,1252546.0,,228368.0,,,,,4307.0,,,47182618.0,,9577.0,20.0,7289490.0,,,,,,,719731.0,2539168.0,,3428149.0,,,,9852868.0,11101092.0,,,279954.0,300.0,,,,33097.0,,,3806238.0,963629.0,,,3785373.0,,4380.0,82040173.0,6228.0,,-388153.0,,11101092.0,1020820.0,9388772.0,-2779.0,9775663.0,11150357.0,,8575363.0,,4992283.0,18619933.0,,4563.0,2488739.0,1242331.0,,5253408.0,,86602.0,37500.0,,27036.0,1682998.0,95.0,409.0,5021983.0,,103805.0,,,,2248168.0,,,,2113209.0,,-9395155.0,,,152353.0,,,,,138534.0,15091523.0,1907967.0,5201.0,31783112.0,20583.0,,,51292468.0,,,,,,4808981.0,,,,,9.0,,558498.0,,,,,,,6360.0,,,,214.0,1332458.0,,,,,1564255.0,,,,1729.0,,13882971.0,,,,2685636.0,,,-120541.0,,,,,2811248.0,1580.0,,,1552.0,1332458.0,58458435.0,,,,,2175631.0,8600.0,-58866844.0,,8327463.0,,,,,,6372270.0,,,,,,,12717870.0,,,,5758836.0,,,7112.0,32.56,325069.0,,85290.0,5079505.0,236521.0,,,,192.0,,,,,,-21831591.0,7047.0,,,3699422.0,,,2232524.0,5462724.0,,29414.0,23109230.0,,,714.0,,,,,273199930.0,,193183960.0,,,,,,,2404841.0,,,12969.0,3545884.0,10191347.0,,,,,,,,,,5201.0,,93.0,,,,,,,,,163123.0,121029.0,188249.0,,269876262.0,128381854.0,1326.0,-3530.0,,,,,3794777.0,,,1082282.0,,36914102.0,,,,224782.0,,13868844.0,,,,,175107662.0,33097.0,970.0,,,,168070263.0,3920984.0,34.0,,,,36S155,,,N,,,3076331.0,,,,,,,,,32979686.0,,13863040.0,,2752013.0,265212986.0,2148216.0,-294845.0,,,,,,,,,,,,,,14383927.0,,,20074.0,,1163966.0,,,8753694.0,,,,7917235.0,,,,36.33,2476.0,,,-692273.0,,,923118.0,,117.0,,,,,358110431.0,,,,,,,,,,1492539.0,,4250182.0,199.0,,-66872.0,235.0,121.0,,9067116.0,,14271.0,36.65,,584199.0,464315.0,3867323.0,,,,,,37.84,,,,11793.0,911457.0,,,,,,,,,374828.0,18152079.0,8111731.0,13802.0,,4924028.0,924128.0,955957.0,96.41,95384.0,,,1492539.0,,,20.0,,,3152353.0,2424652.0,246989.0,14187400.0,74545.0,,60955.0,,,,4681568.0,,,,,,N,,100989.0,20074.0,246947.0,1668725.0,,,9860746.0,9365902.0,704988.0,,21167.0,1163.0,1119946.0,12717870.0,59.55,,6220605.0,,,909861884.0,3076331.0,,,2118800.0,11072484.0,,7836846.0,108540546.0,27789.0,1119529.0,2557442.0,224782.0,11097241.0,,9486.0,48468.05,,95344.0,11003257.0,25709.0,,9458731.0,1978309.0,,,27789.0,,,,,,3153.0,970781.0,25.47,2623222.0,15201,,,,,,124110.0,360155,,,,,680392.0,,808552.0,2485693.0,,211.0,,38143852.0,,12143.0,1425834522.0,49635.0,,,,71121165.0,SOUTHWEST GENERAL HEALTH CENTER,1836745.0,,,182.0,,,707199.0,,,542160.0,6525403.0,,,1191803.0,,,,108.0,,130547.0,47.48,1519345.0,48.16,34.0,,,14383927.0,153084.0,905417468.0,1743.34,9.0,,,,,632723.0,,2066053.0,1281.0,51264800.0,15.78,86086.0,,13714.0,389800.0,4569.0,,,1122816.0,,5631482.0,2276172.0,5461894.0,,,,,,,-45503.0,2160111.0,,,,,,,,4347827.0,OH,1191321.0,,,5913.0,,,,,,,5596093.0,31442.0,1658143.0,,,54481.0,,,,3120.0,,,20691530.0,,,147.0,,,10656.0,,,46417565.0,,,,1151.0,22.24,,1119325.0,214.0,3238764.0,,,,11101092.0,,,2331.0,,,,1807792.0,,6525404.0,,281852.0,1463920.0,,103805.0,,,,,,,,,,,,,,6686.0,,,,,,272943.0,6443662.0,1869.0,,984352.0,,,22949682.0,,,,,54695547.0,,1290074.0,5690.5,,3320.0,,,,2.0,,2098823.0,,,,,,2123.0,704988.0,,15859127.0,,12097796.0,3240.0,,13882971.0,,,N,8435872.0,,358439130.0,,4486.0,,27206.0,15937687.0,,,36.86,SWGHC MENTAL HEALTH SERVICES,,,,N,,,328695.0,36T155,9022.0,5708126.0,4760.0,665569.0,,80229.0,,30.58,6289.0,,,,,,,26425314.0,4587.0,,-54323.0,,42.0,,,,2811248.0,,,1636474.0,,,33097.0,,,,1334940.0,,53221.0,,42285768.0,1281.0,13.96,888.0,3650.0,,,1158.0,3787.0,11591498.0,,,,,,,,,-4145551.0,32.29,,-6665560.0,,,,19.7,,6236606.0,,,4587.0,,,,173544139.0,,64999.0,,551859.0,2331.0,,,,,,2023-06-02 00:00:00,,911681.0,4736322.0,,,,,2822078.0,5473.0,6023.0,124110.0,1230034.41,,21326326.0,367394.0,,,,328141.0,46097790.0,652881.0,973.0,,Y,48.3,515972638.0,2010673.0,,,1453152.0,,,,,,88785.0,,,163123.0,,,,,-284.0,,,,187261744.0,15860422.0,6705.0,,,1016.0,,17501820.0,,,133287.0,,,,405.0,3320.0,,,,,,798092.0,,,,5956523.0,,7439578.0,,5623647.0,549766.0,6561803.0,5461894.0,,,7618495.0,3153.0,3806238.0,,,1407186.0,75363.0,,,,,,,297911.0,,2457363.0,,2123.0,42365.21,,3912300.26,305177.0,,,54271.0,,513088545.0,158792.0,,26945745.0,,,9120.0,,,,5473.0,2369287.0,,,,,,,-52987.0,101413476.0,,27789.0,46261381.0,,79170.0,,282270.0,,,General Short Term,,,,4627873.0,,,,10163451.0,,,1868858.0,,,,,215.0,15800.0,2877147.0,1605.13,1671396.0,,,46543641.0,20646906.0,,,,4614.0,,6869057.0,1385752.0,,,34964958.0,4997477.0,6198178.0,18425202.0,,,,152353.0,,,958871.0,Y,,,,,,,152353.0,,,,,1335338.0,,2758691.0,,,,-42871.0,54655.0,,9737441.0,2043.0,87765.0,276429.0,1056055.0,,1937.0,389961.0,,,9868.0,,,,,396673546.0,8717823.0,,,337588.0,,975850.0,,361531.0,4815.0,,,142828369.0,32979686.0,,,,50.08,,,,,25640.0,,191.0,-43503.0,,,2011.0,5047682.0,97325.0,,135202.0,,,,,,,,51360.0,,300297.0,39827885.0,62.0,141894.0,,360429279.0,,,42285768.0,,,,-2040.0,,95384.0,,27789.0,25819905.0,,,,,14712662.0,,,2269243.0,,210985.0,,10743.0,,,3822068.0,,,,-322.0,,,4300.0,484646.0,,20951287.0,125924466.0,-10753739.0,2027777.0,,,,3830283.0,,221257.0,,,1079420.0,25492.0,36705379.0,,,1388052.0,,15021064.0,42.99,,,1163949.0,1240501.0,,,,587514.0,2485693.0,,,,,,361530,,187817.41,14908.0,,,3850190.0,,22.35,1694004.0,6443662.0,,3417932.0,,5263.0,44130-3497,,,277661.0,2046156.0,,,,,1519345.0,5473.0,,,,4400.0,1490954.0,848857.0,,,2510360.0,,42453791.0,18697 BAGLEY ROAD,37.15,4681568.0,-10156.0,,,,,2022-01-01 00:00:00,423.0,976539.0,,-10477841.0,1983068.0,,,,,69254.0,9390164.0,14874.0,,,,,,17459572.0,487311.0,51275302.0,,,1.5,1419419.0,,,9096704.0,,,,,6051342.0,,,,276884.0,13457249.0,,1113951.0,,,,,,2438391.0,,,,5817.0,,1315996.0,,,,,,2892.0,,,,,38338.0,,2460854.0,,-1657.0,19156.0,,,,,114383.0,,,,,5297496.0,,,60525.0,149749815.0,,,,,,,,24.0,,,612036.0,367253,,5405931.0,,,,,,141802.0,21961154.0,,,580033.0,,,,30.57,,,,MIDDLEBURG HEIGHTS,,819445.0,,,,,,21167.0,,1714968.0,5850326.0,,,23823.0,,,,4730658.0,,,,,8028826.0,6053.0,,,,,58936.0,,,,,,1.5,,,,6202772.0,,,,,430.0,,18938051.0,6236606.0,,,,,,587514.0,426410.22,,-264739.0,,,,54158.55,,,1.0,,5596093.0,,,,,,6583850.0,,,,,-243760.0,,,3920984.0,,,15957.0,,,,,,1453152.0,,,-201337.0,,,,,,,9852868.0,,142603.0,,,,,4438797.0,,,94910.0,,76990.58,7639551.0,,,657498.0,,,1246588.0,,7.0,1.0,25432492.0,,,3485890.04,,,13995.0,,37217547.0,,1967139.0,9242690.0,,,,,,95384.0,9318100.0,,4292522.0,326959.0,53910.0,1692610.0,,637160.0,,,303637.0,,,,,,5644678.0,,,,498038.0,17145067.0,,,,,,,15958683.0,945632.0,,,5850326.0,1844.0,,1018969629.0,,89.0,,Y,4060203.0,34544938.0,,,221272.0,,,,22885136.0,,,,,-64407.0,4815.0,,91203.0,139028.0,,545371.0,,150768.0,,7265250.0,,,,31861949.0,,,9775663.0,69254.0,,3244071.0,,,,,1156.0,1614544.0,15021064.0,5161341.0,,13324.0,,-42357.0,15958683.0,64457.0,,,,,,-29034.0,,,,5475.0,,,,,Y,,,,,,,2077.0,,,250.0,2819998.0,,,,976539.0,25819905.0,,,50136.0,160315.0,,11439991.0,,,,,15066.0,2485693.0,955957.0,,,-178272.0,,,2526838.0,,236771329.0,,,,,3059.0,9710719.0,,46301.0,,22218909.0,4292522.0,1119325.0,80.0,743408,,,,,1914273.0,,,,,422959.0,2162890.0,3925079.0,,,,103.33,,50.0,17.0,99464.0,,,115336.0,,219183.0,,,,9718245.0,1729678.0,33856894.0,,2192.0,Q,,4736322.0,,,,,,4160705.0,860864.0,,300.0,,,,,14008974.0,,1079420.0,,,,51292468.0,1097062.0,,,,,,17460,2022-12-31,162.22,,,,,,,,,2777.0,,,,82614518.0,,3458.0,187.0,,-40432.0,,8760.0,,,16512267.0,1692610.0,958871.0,4707363.0,1868858.0,9458731.0,,2032.0,,,N,,,,,68873082.0,,1680488.0,,,,,,,121029.0,9862627.0,,23.0,N,,,915448.0,-2214.0,,1914273.0,,,23009.0,,,57.0,,5.0,38268.0,314932.0,26580265.0,,,,31829205.0,1.0,2767383.0,1097610.0,7289490.0,26580510.0,,,,,,,,2162890.0,,,191005886.0,,47481.64,,,33413333.0,,1419419.0,,,,,310109.0,109875588.0,2650.0,2.0,,,152353.0,14187662.0,,33218183.0,17319246.0,8435872.0,7967076.0,1508662.0,1315996.0,,-15171.0,16627.0,2446972.0,,1199638.0,9236158.0,,,,1099390.0,,,,,,,,-520973.0,,,,,,11150357.0,22.41,,,,,,,,,,,,2549729.0,2022,Acute Care Hospitals,SOUTHWEST GENERAL HEALTH CENTER (360155)
