,Curated Name and Num,Hospital type (modified),S2_1_C1_21,Lon,Lat,D3_HOS_C2_70,D3_IPF_C2_93,A_C2_19,D_5_HOS_C4_96,A_C2_16,B_1_C0_200,S3_2_C5_34,D_5_HOS_C2_57,S3_2_C4_9,S3_2_C4_42,C_1_C2_68,B_1_C26_191,S3_1_C2_9,S10_C1_12,A_C2_41,C_1_C7_52,E_A_HOS_C1_72,D_1_HOS_C7_30,S3_1_C8_24,B_1_C22_100,D_4_IRF_C13_57,B_1_C0_73,D_4_HOS_C3_52,S10_C1_30,B_1_C22_54,D_4_HOS_C4_58,D_5_HOS_C5_65,E_B_HOS_C1_36,B_1_C26_105,B_1_C26_67,A_C2_58,A7_1_C1_8,A_C6_71,C_1_C6_65,C_1_C5_61,D_4_IPF_C11_68,B_1_C22_66,S2_1_C2_1501,S3_1_C2_21,B_1_C21_108,D_5_HOS_C3_93,A8_C2_4,B_1_C26_57,D_4_IRF_C13_69,D3_SNF_C3_68,B_1_C21_58,A_C2_62,S4_HHA1_C5_37,S2_1_C1_11801,D_4_IRF_C11_63,D3_IRF_C3_54,D3_SNF_C2_94,B_2_C26_52,S2_1_C2_127,S3_2_C4_7,B_1_C21_65,B_2_C26_111,A7_3_C9_3,B_1_C26_90,A8_C2_14,B_1_C22_35,B_2_C26_66,B_1_C26_71,S3_1_C2_18,D_4_HOS_C12_71,B_1_C26_58,C_1_C6_60,D_4_HOS_C12_68,S3_2_C6_6,D_4_HOS_C11_66,C_1_C5_41,A_C1_90,B_2_C26_9201,D1_IRF_C1_52,B_1_C21_54,D_4_HOS_C3_58,B_1_C26_99,D_4_HOS_C2_55,A_C1_97,S3_2_C4_34,A7_1_C7_2,S2_1_C1_131,S2_1_C2_1516,S10_C1_1,D_4_IPF_C11_51,B_2_C26_59,A_C1_70,D_1_HOS_C4_32,S2_1_C2_13,D3_IPF_C2_71,C_1_C6_52,D1_HOS_C5_43,C_1_C6_35,D_5_HOS_C2_71,C_1_C6_69,A_C1_5,S2_1_C1_26,C_1_C7_65,D1_SNF_C1_85,S10_C1_16,S10_C1_15,D3_IPF_C2_9201,S3_3_C2_3,A7_1_C7_4,D3_HOS_C3_72,A_C2_73,A_C6_41,D_4_HOS_C3_66,D3_HOS_C2_34,D_4_IRF_C13_64,S3_2_C4_4,S3_1_C8_18,A_C2_10,B_1_C26_117,D_5_HOS_C3_96,D3_IPF_C2_72,D_4_HOS_C11_51,S3_1_C8_17,B_1_C26_74,C_1_C6_30,A_C6_105,D_5_HOS_C7_63,B_2_C26_95,D_4_HOS_C10_91,D_4_IPF_C11_93,D3_SNF_C3_58,D3_SNF_C3_63,A7_1_C3_1,S3_2_C6_15,S4_HHA2_C2_38,S3_1_C3_21,D_4_HOS_C11_72,S3_2_C2_2550,A_C6_4201,S3_2_C4_29,D_4_HOS_C13_65,D1_IPF_C1_27,S2_1_C2_1809,B_2_C26_45,S4_HHA3_C4_36,B_1_C0_110,B_1_C26_100,D1_IPF_C1_52,A7_1_C7_7,B_1_C26_76,C_1_C3_202,A_C6_34,D_4_IPF_C11_200,C_1_C6_108,C_1_C7_69,B_1_C21_30,D_5_HOS_C5_73,S3_1_C5_16,A_C6_3,A8_C2_8,B_1_C21_60,D3_HOS_C3_53,A_C6_11,S3_2_C4_1,D_4_IPF_C11_70,D3_IPF_C2_33,D3_SNF_C3_93,S3_2_C2_3,A_C1_62,D_3_HOS_C9_40,S3_1_C3_7,B_1_C22_72,D_4_HOS_C3_67,S3_2_C6_33,B_1_C0_4501,D3_SNF_C2_55,S3_2_C6_1,D3_IPF_C3_57,S3_2_C2_4,C_1_C5_75,S4_HHA3_C5_34,B_1_C0_191,S3_1_C5_10,D_4_HOS_C4_52,B_1_C0_42,S3_3_C6_7,C_1_C5_62,D4_PANCREAS_C1_69,S3_1_C8_5,S3_1_C11_14,B_1_C22_64,D_4_IRF_C11_66,A7_1_C5_4,S3_1_C5_11,S2_1_C2_1202,D3_IPF_C3_96,S3_1_C7_26,A_C2_33,D3_IPF_C3_66,D_5_HOS_C3_52,S2_1_C4_24,E_B_HOS_C1_15,B_2_C26_9940,A_C6_31,S5_C2_2,B_1_C26_60,D_4_IPF_C6_200,D_5_HOS_C3_56,D_4_IRF_C11_71,S4_HHA1_C1_34,A_C1_74,A8_C2_7,S3_2_C4_1401,D3_HOS_C2_53,E_B_HOS_C101_5,A_C2_52,S2_1_C2_8,D_4_HOS_C12_52,D3_SNF_C2_65,S4_HHA1_C2_35,S3_1_C8_1,D3_SNF_C2_9201,D_5_HOS_C6_55,D_4_SNF_C11_63,A_C1_21,A_C2_67,D_4_HOS_C11_50,D_4_HOS_C4_50,D1_IRF_C1_50,A_C6_9920,S4_HHA2_C5_33,S3_2_C4_21,C_1_C7_53,D_5_HOS_C6_50,B_1_C21_116,C_1_C2_65,D_4_SNF_C11_62,D_5_HOS_C5_70,D3_HOS_C3_61,A_C6_46,S4_HHA3_C1_38,A_C6_1,A_C6_30,A_C6_114,A7_3_C15_1,B_1_C26_192,D3_SNF_C2_64,D_4_HOS_C3_89,D_5_HOS_C2_50,B_1_C22_106,S4_HHA2_C4_35,D_4_HOS_C10_69,S2_1_C2_24,C_1_C6_110,D_5_HOS_C6_67,A_C2_109,D_5_HOS_C4_56,D3_SNF_C3_57,C_1_C5_59,S3_2_C4_14,S2_1_C2_1521,S3_2_C6_12,S3_2_C5_38,A_C2_59,D3_HOS_C2_65,D_5_HOS_C2_51,D3_IRF_C2_63,S2_1_C1_105,A_C1_98,E_B_HOS_C1_20,B_2_C26_9930,A_C2_54,S3_1_C6_24,D3_SNF_C3_66,S3_1_C2_27,D3_IPF_C3_60,S3_1_C2_32,S2_1_C2_1607,A_C6_68,D_4_HOS_C2_66,B_1_C0_70,B_1_C26_109,B_1_C26_30,C_1_C6_100,B_1_C22_110,D_4_HOS_C2_93,S3_1_C10_25,S3_2_C3_22,D_5_HOS_C3_74,D_4_IPF_C13_60,S3_2_C5_14,A_C1_106,A_C1_69,D_4_IPF_C4_200,A_C1_40,A_C2_194,D_5_HOS_C2_76,A7_1_C2_3,S3_1_C8_19,C_1_C6_46,A_C2_60,B_1_C26_45,S3_1_C3_18,S2_1_C1_3801,D3_IPF_C2_31,A_C2_91,A_C6_89,E_B_HOS_C101_2,C_1_C6_31,S3_1_C9_19,B_1_C26_34,C_1_C7_110,S3_2_C4_17,G3_C1_2,A_C1_193,S4_HHA1_C3_34,D_4_IRF_C4_200,D_5_HOS_C4_68,D_4_HOS_C13_73,A_C6_58,B_1_C22_67,D_4_IRF_C11_98,D_5_HOS_C6_57,C_1_C6_74,S2_1_C1_115,S3_1_C3_11,S4_HHA1_C4_37,E_B_HOS_C1_12,A7_3_C9_1,S3_1_C10_27,S2_1_C4_2,A_C6_9201,D_4_SNF_C11_71,S4_HHA3_C1_33,D3_SNF_C2_71,G_C1THRU4_39,D_4_HOS_C13_70,A_C6_59,S3_3_C4_6,S2_1_C2_9,D_1_HOS_C6_35,S4_HHA3_C4_35,B_1_C22_193,D_1_HOS_C4_200,A7_1_C3_4,C_1_C7_63,D_4_IRF_C11_65,D_4_IPF_C11_71,S3_1_C3_12,E_B_HOS_C1_9,B_1_C0_107,D_4_HOS_C3_51,D3_IRF_C2_56,A_C6_76,S3_1_C12_1,G3_C1_28,D_5_HOS_C4_94,S2_1_C2_142,D_4_SNF_C11_56,D_4_HOS_C4_73,D_4_IRF_C11_69,B_1_C22_55,B_1_C21_73,MSA,D_4_HOS_C11_54,S2_1_C2_15,A_C1_6250,D3_IPF_C3_54,A_C2_114,A_C1_73,B_1_C26_43,D3_SNF_C3_98,D_5_HOS_C5_66,A_C1_190,A_C6_9910,D_5_HOS_C4_74,A7_1_C1_5,D_4_IPF_C11_52,G_C1THRU4_36,D3_HOS_C3_74,S3_2_C5_42,D_4_IPF_C2_200,S3_3_C2_6,B_2_C26_60,D3_SNF_C3_69,D3_IRF_C2_57,S3_2_C2_33,D3_IPF_C3_53,A_C1_115,A7_1_C3_6,E_B_HOS_C1_6,D_4_IPF_C11_67,S4_HHA2_C5_37,D_4_HOS_C3_53,D_4_HOS_C11_65,A7_3_C5_2,A_C6_200,S3_1_C2_10,C_1_C5_91,B_1_C21_64,S3_1_C6_16,A_C2_35,D3_IPF_C2_200,C_1_C5_57,S3_2_C2_41,D_4_HOS_C3_68,D3_IRF_C3_91,S4_HHA1_C3_35,A_C1_65,C_1_C7_202,C_1_C5_30,D_5_HOS_C6_6250,D3_SNF_C2_52,D3_IPF_C2_75,C_1_C5_88,D_4_HOS_C10_53,C_1_C5_46,D_4_HOS_C12_76,A_C6_110,B_2_C26_97,C_1_C7_108,C_1_C5_107,A_C6_97,C_1_C5_44,A8_C2_13,D_4_HOS_C2_76,S2_1_C2_3801,D_5_HOS_C4_76,S3_2_C2_2201,B_1_C0_22,D1_HOS_C1_52,D_5_HOS_C6_54,S3_1_C6_22,S2_1_C2_1522,B_1_C0_63,S3_1_C3_8,S3_1_C13_1,S2_1_C2_5,D3_HOS_C2_61,S3_2_C6_4,D3_IRF_C2_32,C_1_C6_70,D_4_IRF_C13_65,E_A_HOS_C1_59,A_C2_111,C_1_C6_58,D_5_HOS_C5_91,B_1_C22_116,D_3_HOS_C6_200,D_5_HOS_C6_97,A7_1_C7_5,D4_ISLET_C1_69,D3_HOS_C2_64,D_5_HOS_C5_50,S3_1_C9_24,S2_1_C2_143,D_4_IRF_C13_70,D_5_HOS_C2_62,B_1_C0_117,D_4_IRF_C13_53,E_B_HOS_C1_8,A_C1_110,C_1_C7_60,D_4_IPF_C11_55,D_4_HOS_C11_9201,D3_IRF_C2_70,S4_HHA1_C3_38,S2_1_C1_93,S5_C1_15,A8_C2_21,D3_IPF_C3_59,D_4_HOS_C11_55,A_C1_9910,A_C2_53,D3_HOS_C2_56,S4_HHA2_C3_33,D_5_HOS_C4_67,S4_HHA2_C5_35,S5_C3_2,S2_1_C1_143,D3_HOS_C3_69,A_C1_13,S3_1_C7_2,C_1_C7_6250,D_5_HOS_C2_54,A_C6_95,D_4_IRF_C13_52,C_1_C5_68,RPT_STUS_CD,S3_2_C6_42,B_1_C21_117,S3_2_C4_30,S3_1_C2_11,A_C1_192,D_4_HOS_C10_60,D_5_HOS_C6_60,S3_2_C5_1,B_1_C21_115,D_5_HOS_C5_56,S3_2_C6_39,D3_SNF_C3_56,S2_1_C1_35,S3_1_C8_12,E_B_HOS_C1_21,B_1_C26_190,S2_1_C1_125,A_C2_105,A7_1_C1_10,D_4_SNF_C11_59,C_1_C5_94,D_5_HOS_C4_9201,D_5_HOS_C6_98,D3_SNF_C2_31,S3_2_C6_2,B_1_C22_63,B_2_C0_202,D_4_IRF_C11_73,G_C1THRU4_15,D_4_HOS_C13_60,PRVDR_NUM,D_4_HOS_C13_59,D_4_HOS_C11_75,D_4_IPF_C13_67,S2_1_C2_1517,B_1_C0_9920,D_5_HOS_C2_98,D_5_HOS_C6_61,C_1_C6_63,B_1_C26_4501,A_C6_96,B_1_C21_45,D_4_HOS_C2_58,B_1_C21_70,S3_2_C4_37,D3_HOS_C2_94,D_4_HOS_C11_71,S3_2_C6_28,D_4_IRF_C13_93,A_C1_114,D_4_HOS_C13_76,C_1_C5_54,B_2_C26_98,S3_2_C4_39,D3_SNF_C3_200,D_4_IPF_C13_54,D3_SNF_C2_59,B_1_C22_101,S3_2_C2_40,S3_1_C9_18,D_1_HOS_C7_41,B_2_C26_62,A8_C2_6,E_A_HOS_C1_7094,S2_1_C2_1402,D3_SNF_C2_34,A_C6_14,D_4_IPF_C11_50,D3_IRF_C3_69,B_1_C21_94,D_1_HOS_C6_32,D_4_HOS_C4_91,E_B_HOS_C1_23,D3_IPF_C2_62,S3_1_C6_2,D3_IPF_C3_67,A7_3_C6_3,C_1_C5_95,A_C1_57,S3_1_C14_17,A_C2_4201,B_1_C21_46,S10_C1_2,G_C1THRU4_4,S3_2_C5_11,S3_2_C5_6,S3_2_C2_21,S5_C4_1,C_1_C6_4501,D1_IPF_C1_51,D3_HOS_C3_51,S3_2_C6_8,S3_1_C8_21,B_2_C26_4501,D_4_IRF_C13_66,D3_SNF_C3_90,D_4_IRF_C11_51,C_1_C6_90,B_2_C26_76,S3_2_C2_22,A_C1_9201,S2_1_C2_1808,C_1_C7_62,D_3_HOS_C5_200,D_4_HOS_C2_65,D3_SNF_C2_69,S2_1_C2_3601,S4_HHA2_C1_38,S4_HHA3_C5_36,A7_1_C3_2,C_1_C5_108,S3_2_C3_25,A_C6_21,D_5_HOS_C7_75,B_2_C26_40,D_4_HOS_C10_65,D3_IPF_C2_6250,S2_1_C1_129,D_4_IRF_C13_68,C_1_C6_88,A_C1_32,S3_1_C9_21,A_C1_34,B_1_C26_106,S3_2_C6_7,C_1_C5_201,A8_C2_16,C_1_C7_9201,D3_SNF_C3_62,D3_HOS_C3_9201,B_2_C26_99,B_1_C26_9201,D_4_HOS_C3_76,A_C2_22,B_1_C26_62,B_1_C0_61,A_C6_54,C_1_C5_101,S3_1_C4_10,A_C2_95,A_C2_8,C_1_C6_73,D_4_HOS_C10_51,E_B_HOS_C1_4001,A_C2_66,D_4_HOS_C2_56,D_4_HOS_C11_67,D3_HOS_C2_68,D1_HOS_C1_49,S4_HHA2_C3_34,D_5_HOS_C2_58,A_C2_110,A7_3_C5_1,S2_1_C2_1601,A7_1_C1_6,S3_2_C4_1602,D_4_HOS_C13_54,A8_C2_12,D_4_IRF_C11_57,D_5_HOS_C2_69,A7_1_C7_10,C_1_C7_109,S3_3_C5_3,UTIL_CODE,B_1_C0_2,C_1_C5_65,D_5_HOS_C7_60,D_5_HOS_C4_65,S5_C1_10,C_1_C6_96,D_4_HOS_C12_75,D3_HOS_C2_32,D_4_HOS_C11_74,B_1_C22_117,A8_C2_1,A8_C2_5,D3_HOS_C2_60,B_1_C0_192,D3_HOS_C2_55,S4_HHA1_C1_36,D3_HOS_C2_71,A_C2_1,D3_SNF_C2_68,D3_IPF_C2_63,G_C1THRU4_34,S3_1_C11_22,A8_C2_29,D_4_IRF_C13_76,D3_IRF_C2_90,S3_1_C7_15,S3_2_C5_5,A7_3_C15_2,D_5_HOS_C6_69,B_1_C0_106,A7_1_C5_8,S3_1_C4_1,D_4_HOS_C11_57,E_B_HOS_C101_6,G_C1THRU4_12,S3_2_C4_5,S5_C6_1,C_1_C7_111,D_5_HOS_C2_74,S4_HHA2_C3_36,C_1_C5_74,S2_1_C1_116,D_5_HOS_C3_9201,S3_2_C3_24,B_1_C0_15,B_1_C0_56,B_1_C21_53,A_C1_105,A_C2_42,D3_SNF_C2_98,A_C6_101,S3_1_C7_20,B_1_C21_98,D3_IPF_C2_35,S3_1_C6_10,A7_1_C7_8,B_1_C22_30,D3_IRF_C3_72,A8_C2_18,S3_1_C3_19,D3_SNF_C2_67,D3_IRF_C3_6250,G_C1THRU4_25,D3_IRF_C2_72,S3_2_C6_30,A_C1_42,S4_HHA3_C3_33,D3_IRF_C3_50,C_1_C5_73,B_2_C26_201,D_4_HOS_C3_70,D_5_HOS_C3_53,G_C1THRU4_7,A_C2_50,A_C6_32,A_C6_190,D_5_HOS_C7_200,D_5_HOS_C2_9201,S2_1_C2_129,A_C1_109,B_2_C26_106,A_C6_51,D3_IPF_C3_69,C_1_C5_53,E_B_HOS_C101_3,D3_IPF_C2_98,B_1_C0_9910,B_1_C0_111,D_5_HOS_C3_6250,D_5_HOS_C2_63,A_C2_75,D_5_HOS_C5_57,D_5_HOS_C7_55,A_C1_59,D_5_HOS_C6_76,C_1_C6_112,D3_SNF_C3_51,A_C6_65,B_1_C0_35,S3_1_C4_8,C_1_C6_42,D_4_IPF_C11_53,A_C2_4,B_1_C21_91,S3_2_C6_31,S2_1_C2_1507,A_C1_52,S3_2_C4_38,C_1_C7_68,D3_IRF_C3_63,B_2_C26_100,D_4_HOS_C1_200,D_5_HOS_C7_68,D3_SNF_C3_54,B_1_C26_108,S2_1_C2_1803,D_4_HOS_C12_91,D3_HOS_C2_73,A_C2_40,S3_1_C6_12,D_4_HOS_C11_58,A_C1_9940,D3_IRF_C3_76,S3_1_C5_14,D_5_HOS_C5_96,C_1_C6_68,D3_IPF_C2_53,D_1_HOS_C4_42,D_1_HOS_C7_35,D_4_IPF_C11_69,D_1_HOS_C4_43,A_C2_61,A_C6_100,S3_2_C5_32,E_B_HOS_C1_1,S5_C1_14,D_4_HOS_C2_75,D_4_SNF_C11_58,D_4_SNF_C11_9201,B_1_C21_57,D3_IPF_C3_200,S3_3_C6_5,D_5_HOS_C3_90,G_C1THRU4_31,D_4_IPF_C13_51,D_5_HOS_C4_59,D_4_IRF_C13_62,C_1_C5_32,D_4_HOS_C4_54,S3_2_C2_8,S3_2_C2_17,S4_HHA3_C5_35,B_1_C0_99,B_1_C21_90,B_2_C26_51,B_1_C21_76,D_5_HOS_C2_66,G_C1THRU4_52,C_1_C5_112,B_1_C0_6,D_4_HOS_C10_52,C_1_C5_63,ST_CTY_CD,A_C2_18,C_1_C7_67,S3_1_C11_20,C_1_C5_116,S3_2_C2_15,B_1_C26_112,A_C6_62,S3_1_C14_1,D_4_HOS_C13_93,S3_2_C4_10,D3_SNF_C2_202,B_1_C21_95,A8_C2_27,A_C6_9930,C_1_C8_202,S3_2_C3_2551,S3_2_C6_40,A_C2_190,D_5_HOS_C7_90,B_1_C22_58,S2_1_C2_115,A_C6_12,C_1_C7_56,B_1_C0_64,C_1_C5_72,E_B_HOS_C1_5,S3_1_C7_18,S4_HHA2_C2_33,E_B_HOS_C101_4,A_C1_35,A7_3_C9_2,B_1_C26_6250,A_C6_9940,B_1_C21_56,D3_SNF_C3_60,S3_1_C7_10,D3_SNF_C3_76,B_1_C21_72,A7_1_C1_4,S3_2_C3_1402,A8_C2_31,C_1_C7_94,D3_IRF_C3_70,D3_SNF_C3_74,D_5_HOS_C7_94,D3_HOS_C2_58,D_5_HOS_C7_70,D_3_HOS_C8_200,D3_IRF_C3_59,S3_2_C4_43,D_4_IRF_C11_53,D_5_HOS_C4_75,A_C6_56,B_2_C26_64,B_1_C22_95,B_2_C26_112,S3_1_C14_16,A_C6_6,S5_C1_11,B_1_C0_13,D3_IPF_C2_55,D_4_HOS_C1_76,B_1_C0_109,D_1_HOS_C7_33,A_C2_17,D_4_IRF_C11_64,S10_C2_22,S10_C1_19,B_2_C26_101,C_1_C6_54,D3_HOS_C3_75,D_4_HOS_C2_88,C_1_C5_89,D_5_HOS_C4_90,A_C2_31,C_1_C7_9930,A_C1_95,D_4_HOS_C12_97,D3_HOS_C3_200,B_1_C0_9,C_1_C5_110,S3_2_C5_40,D_5_HOS_C4_200,D_4_HOS_C12_65,D_4_HOS_C2_9201,D_5_HOS_C3_54,D_1_HOS_C4_35,A_C2_64,S2_1_C1_38,B_1_C22_75,A_C1_20,D_5_HOS_C5_200,B_1_C26_110,S3_1_C2_14,D_1_HOS_C4_4201,D_5_HOS_C3_61,B_1_C21_62,S4_HHA1_C3_33,A_C1_17,A_C1_33,D3_IRF_C2_61,B_1_C26_44,S2_1_C2_1611,B_1_C0_68,A_C2_11,A_C2_14,C_1_C5_43,S3_1_C5_19,D1_IRF_C1_49,D3_IRF_C2_65,S3_3_C6_1,A7_3_C7_1,D1_HOS_C5_46,G_C1THRU4_30,C_1_C7_88,S3_1_C10_1801,A7_1_C2_8,D_4_IRF_C13_63,B_1_C26_91,D_4_HOS_C2_98,D_4_HOS_C4_93,D_5_HOS_C5_69,C_1_C6_106,B_2_C26_4201,S3_1_C10_19,A_C6_55,A8_C2_10,B_1_C22_33,S3_2_C4_8,D_1_HOS_C6_30,D_5_HOS_C7_66,A_C1_107,S2_1_C5_24,S3_1_C8_14,A_C1_12,G_C1THRU4_8,D_5_HOS_C7_52,S4_HHA2_C3_38,S10_C1_3,D1_SNF_C1_84,D_4_IPF_C13_90,A_C2_69,B_1_C26_54,C_1_C6_89,S3_2_C2_35,S3_2_C4_11,D_4_IPF_C11_74,B_1_C0_112,A_C1_22,S4_HHA2_C4_34,B_1_C0_67,B_1_C0_90,B_2_C26_74,C_1_C5_64,D_4_IPF_C11_59,A_C6_22,B_1_C21_75,S3_2_C4_6,S2_1_C1_56,D_4_HOS_C12_60,D_5_HOS_C5_71,D1_HOS_C5_45,E_B_HOS_C1_41,S3_1_C7_2001,D_5_HOS_C6_96,B_1_C26_68,C_1_C7_9940,D_4_IRF_C11_56,S3_1_C3_16,D1_SNF_C1_37,S4_HHA1_C5_33,C_1_C5_109,D_5_HOS_C2_59,D3_SNF_C2_74,B_1_C22_98,D_5_HOS_C6_58,S2_1_C2_38,D_5_HOS_C3_67,B_1_C26_97,D_4_HOS_C3_90,C_1_C5_40,A_C6_23,D3_SNF_C3_71,D_4_HOS_C2_50,B_1_C22_94,S2_1_C1_144,C_1_C5_9930,C_1_C6_75,D_4_HOS_C10_90,S3_1_C7_1801,D_4_SNF_C11_66,D_4_HOS_C11_98,D_4_HOS_C13_50,S4_HHA2_C4_38,D3_IPF_C3_91,S3_2_C5_26,A_C1_112,B_1_C0_66,A_C2_20,A_C6_90,C_1_C7_90,D_4_HOS_C13_75,D_4_HOS_C10_98,D_4_HOS_C6_200,S4_HHA2_C4_36,D1_HOS_C1_56,D1_IPF_C1_50,S3_2_C2_2,D_5_HOS_C6_52,D_4_HOS_C11_76,B_1_C26_31,D_4_IRF_C11_54,D3_IRF_C2_200,D_4_HOS_C4_76,S2_1_C3_24,D_4_IPF_C11_9201,B_1_C26_75,A_C6_74,S2_1_C2_1401,D3_HOS_C3_70,D_4_HOS_C3_71,D_3_HOS_C9_200,D3_IRF_C3_67,D3_IPF_C2_54,D_4_HOS_C3_54,S3_2_C2_1,S3_2_C5_12,G_C1THRU4_46,S3_2_C5_43,D_5_HOS_C5_59,D_4_IPF_C13_57,S3_2_C2_11,B_1_C0_46,A_C1_200,D_5_HOS_C3_66,D_4_HOS_C4_71,B_1_C26_65,B_1_C0_9930,A_C1_101,G_C1THRU4_53,S2_1_C1_37,S3_2_C4_13,B_2_C26_6250,S3_1_C7_11,B_2_C26_193,D_4_HOS_C10_67,E_B_HOS_C1_3,S3_2_C4_16,D3_IRF_C3_74,D_5_HOS_C5_67,G_C1THRU4_17,C_1_C7_57,B_1_C0_194,C_1_C6_111,B_1_C21_89,S3_1_C8_11,D_5_HOS_C3_71,D3_IRF_C3_58,D3_SNF_C2_90,S10_C1_10,D_4_IRF_C13_90,D3_HOS_C3_68,S5_C4_4,A7_3_C7_3,A8_C2_20,A_C1_19,B_2_C26_91,D_4_IRF_C11_60,B_2_C26_110,B_2_C26_55,B_1_C26_93,A_C6_108,D_5_HOS_C2_73,D_4_HOS_C13_63,D_4_HOS_C13_72,D_5_HOS_C6_65,B_2_C26_9920,S3_2_C5_30,C_1_C7_54,D_5_HOS_C7_91,S3_2_C4_40,A7_1_C1_2,D_4_IPF_C11_56,D_1_HOS_C4_30,A8_C2_15,D_5_HOS_C5_52,D_4_HOS_C13_9201,D_4_HOS_C13_91,S3_2_C3_2201,S3_2_C6_34,S3_2_C6_10,B_1_C26_69,B_1_C26_202,B_1_C0_18,B_2_C26_35,D_4_IRF_C11_75,D_5_HOS_C2_75,D_5_HOS_C4_73,D3_HOS_C3_57,S10_C1_18,S2_1_C1_24,S3_2_C5_13,D_4_SNF_C11_76,D_5_HOS_C7_6250,S3_1_C7_12,D_5_HOS_C6_71,S3_1_C8_28,B_2_C26_192,A7_3_C11_3,D3_SNF_C2_35,B_1_C0_190,D_4_IPF_C13_76,B_1_C22_112,D_5_HOS_C6_53,D_5_HOS_C5_60,B_1_C0_44,D_5_HOS_C5_58,A_C6_70,E_B_HOS_C1_33,A8_C2_3,D_4_IRF_C11_93,B_1_C22_59,D_5_HOS_C5_90,A_C6_93,D3_SNF_C2_70,B_2_C26_31,S3_2_C2_24,B_1_C22_44,D_4_HOS_C11_60,G3_C1_5,C_1_C6_41,S2_1_C2_1505,G2_C2_28,G_C1THRU4_54,S3_2_C5_35,A_C6_66,S2_1_C2_1802,E_B_HOS_C1_13,D_4_HOS_C10_97,S3_1_C8_9,D_5_HOS_C3_200,B_1_C22_40,D_4_SNF_C11_64,S10_C1_11,S3_2_C6_13,C_1_C6_57,S3_2_C5_39,A_C1_7,D_5_HOS_C7_96,D3_IRF_C3_68,B_1_C22_73,S3_2_C6_26,D_4_HOS_C11_91,S3_2_C6_35,A_C1_108,B_1_C0_52,A_C2_70,A_C1_8,D_4_IPF_C13_91,A_C2_101,A_C6_43,S3_1_C3_10,D3_IRF_C3_71,S2_1_C2_140,B_1_C26_193,C_1_C5_58,B_2_C26_44,S3_1_C7_9,A_C1_4,B_1_C21_63,B_1_C21_99,C_1_C6_94,S4_HHA3_C4_38,A_C2_191,D3_IRF_C2_51,D_4_IPF_C13_62,D_4_IRF_C11_70,D3_IPF_C3_50,D_4_HOS_C4_51,D3_IRF_C2_74,S5_C6_4,S3_1_C3_17,D_4_HOS_C2_68,A_C1_96,D_4_HOS_C2_73,D_5_HOS_C4_71,D3_IRF_C2_68,D_4_HOS_C10_57,C_1_C7_76,C_1_C6_64,D_4_HOS_C3_60,D_5_HOS_C6_91,D_4_HOS_C12_50,D_4_HOS_C12_6250,C_1_C5_71,D_1_HOS_C4_34,D3_HOS_C2_30,D_3_HOS_C3_200,D_4_HOS_C12_200,S3_2_C6_1401,A8_C2_25,S3_3_C5_6,S3_3_C2_4,D_3_HOS_C9_30,D3_IPF_C2_56,S10_C1_23,STATE,S2_1_C2_1608,A_C1_64,D3_SNF_C2_93,A_C6_115,B_1_C0_45,D3_HOS_C2_96,A_C6_57,C_1_C7_97,C_1_C6_98,B_1_C22_56,S3_2_C2_2551,S3_2_C5_9,S3_1_C3_1,S3_1_C10_26,D_5_HOS_C2_91,B_1_C22_93,C_1_C7_91,A_C6_44,B_1_C0_74,S3_1_C6_26,C_1_C7_96,D3_HOS_C2_69,S3_2_C2_1402,S3_1_C3_14,S3_1_C8_6,E_B_HOS_C1_42,B_1_C0_32,S2_1_C2_1518,B_1_C0_115,S2_1_C2_18,C_1_C6_59,S3_3_C6_6,A7_1_C5_6,S4_HHA3_C1_36,E_B_HOS_C1_16,D_4_IPF_C3_200,D3_SNF_C2_56,A_C6_13,S3_3_C2_5,D_4_HOS_C13_51,D3_IRF_C2_75,D_5_HOS_C3_95,D_4_IPF_C13_55,A7_3_C10_2,D3_IRF_C2_60,D3_HOS_C3_55,D3_IRF_C2_76,S3_1_C15_14,B_1_C21_33,D3_SNF_C2_75,C_1_C7_107,D1_HOS_C1_41,S3_1_C5_17,D_4_IRF_C1_102,B_1_C22_50,A_C1_44,A_C6_88,S3_1_C7_5,A_C2_90,A_C2_56,A7_1_C5_1,D_5_HOS_C5_75,A_C6_91,C_1_C5_70,S10_C1_26,B_1_C0_41,D_4_HOS_C13_55,D_5_HOS_C7_67,S3_1_C12_14,FY_END_DT,D_5_HOS_C6_9201,S2_1_C3_2,D_4_HOS_C11_90,A_C6_4501,C_1_C6_51,D_1_HOS_C7_31,S3_2_C2_26,C_1_C5_99,S2_1_C2_128,D_4_SNF_C11_90,G_C1THRU4_27,S10_C1_20,B_1_C0_7,C_1_C5_100,A_C6_63,S3_2_C5_4,B_1_C0_89,D_5_HOS_C3_69,D_5_HOS_C7_73,S3_2_C3_1401,B_1_C22_34,S5_C1_3,A7_1_C5_5,S3_2_C6_11,C_1_C7_9920,C_1_C7_112,C_1_C7_115,S3_3_C5_4,C_1_C6_72,D_4_IRF_C11_76,S3_2_C4_36,B_2_C26_73,B_2_C26_58,C_1_C7_73,E_B_HOS_C1_10,D3_IRF_C3_52,D_4_HOS_C2_57,D3_HOS_C2_91,G_C1THRU4_38,D_4_IPF_C13_53,S3_1_C15_17,S3_2_C2_1401,D_3_HOS_C9_33,D1_HOS_C1_62,D3_IRF_C2_31,G_C1THRU4_41,B_1_C21_40,D_4_HOS_C3_50,S2_1_C1_106,D_1_HOS_C6_34,D_5_HOS_C3_75,D_4_IPF_C11_65,S4_HHA1_C2_37,S3_2_C2_13,A_C2_63,D_5_HOS_C6_90,RPT_REC_NUM,A_C6_8,D3_IRF_C3_98,A_C2_30,S2_1_C1_145,B_1_C26_9930,S2_1_C2_2,S3_2_C2_18,S3_3_C4_7,D_4_IRF_C13_200,A8_C2_33,D3_IPF_C3_74,C_1_C7_55,A_C6_73,B_1_C21_88,D_4_IPF_C13_66,S3_1_C5_1,D3_HOS_C3_71,D_4_HOS_C13_74,S3_1_C2_16,D_4_HOS_C4_67,A_C2_6,S3_1_C6_14,D3_IPF_C3_73,A7_1_C4_7,D3_IPF_C2_94,C_1_C7_93,B_2_C26_88,E_B_HOS_C1_32,D3_IPF_C2_96,B_2_C26_32,D3_HOS_C3_66,D_4_HOS_C3_75,S5_C1_6,D_4_IPF_C1_200,C_1_C5_45,S2_1_C7_3,D3_IPF_C3_52,D3_HOS_C2_52,D_5_HOS_C3_65,D3_IPF_C3_68,C_1_C7_89,B_1_C22_99,S3_2_C3_2550,D_4_HOS_C4_53,S3_1_C6_15,C_1_C5_42,D3_IPF_C3_71,C_1_C6_9910,D3_SNF_C3_9201,D_4_IPF_C11_64,D3_IRF_C2_69,S3_2_C4_23,G_C1THRU4_48,C_1_C6_61,E_B_HOS_C1_26,D_5_HOS_C4_70,D1_IRF_C1_41,S4_HHA1_C4_33,C_1_C5_97,D_4_HOS_C4_60,S3_2_C2_43,D_4_IPF_C11_57,A_C1_60,D_4_HOS_C11_64,D_5_HOS_C6_63,D_5_HOS_C2_96,S2_1_C1_36,D3_IRF_C3_75,A_C6_2,G_C1THRU4_47,D_4_HOS_C11_56,C_1_C7_71,S2_1_C1_27,D_5_HOS_C6_75,D3_SNF_C2_66,S2_1_C1_1,B_1_C21_67,S3_2_C6_38,S2_1_C1_5,C_1_C5_6250,S3_2_C5_2,C_1_C6_107,D_4_HOS_C2_54,A_C2_96,D_4_HOS_C3_97,D_4_HOS_C12_62,D3_IPF_C2_64,D3_HOS_C2_75,S4_HHA3_C2_35,D_5_HOS_C5_74,D_5_HOS_C2_53,E_B_HOS_C1_3998,S3_1_C11_25,D_4_HOS_C12_73,D_4_HOS_C2_69,E_B_HOS_C1_38,D_4_IRF_C11_58,D_4_HOS_C2_200,S3_2_C2_31,D3_IRF_C2_34,A_C6_60,S4_HHA3_C2_33,D_5_HOS_C5_62,A_C1_111,C_1_C6_97,A8_C2_26,S3_1_C9_14,B_2_C26_65,B_1_C26_96,B_1_C21_101,A_C6_109,S3_1_C6_5,D3_IPF_C3_98,D_5_HOS_C5_54,D_4_IRF_C11_50,S4_HHA1_C1_38,S3_1_C15_18,S3_1_C13_2,B_1_C26_46,D3_HOS_C2_59,D_3_HOS_C9_34,S3_1_C6_19,C_1_C7_50,D3_IPF_C3_63,S3_2_C4_25,D3_IRF_C2_71,E_B_HOS_C1_34,S4_HHA3_C1_34,S2_1_C2_1609,D3_IPF_C2_60,B_2_C26_53,S2_1_C2_12,S4_HHA1_C2_33,S3_1_C6_1,A_C1_9,S2_1_C1_47,S3_2_C5_29,B_2_C26_72,D3_IPF_C2_91,B_1_C0_97,B_1_C26_95,S2_1_C2_1513,D1_HOS_C1_55,D3_SNF_C2_62,S2_1_C1_134,A_C6_116,D_5_HOS_C3_76,D3_IRF_C2_94,S3_1_C5_12,D3_IPF_C3_64,S4_HHA1_C3_36,D_4_HOS_C13_200,S3_1_C2_8,S3_2_C6_29,D_4_IRF_C6_200,FI_NUM,A7_1_C7_3,S2_1_C1_108,D3_HOS_C2_93,D3_HOS_C2_76,S3_1_C4_11,S3_1_C6_25,S4_HHA1_C5_35,C_1_C5_106,B_1_C0_33,C_1_C6_32,D3_IRF_C2_54,S3_2_C4_41,D_4_HOS_C11_73,D_5_HOS_C6_70,G_C1THRU4_13,D_5_HOS_C6_66,D_4_IPF_C11_54,D_4_HOS_C10_55,B_1_C26_52,B_1_C0_50,D_5_HOS_C3_59,D3_IPF_C3_76,A_C1_72,C_1_C5_202,D3_HOS_C3_52,D3_HOS_C3_50,B_2_C26_93,D_5_HOS_C6_62,B_1_C22_71,B_2_C26_57,REGION,B_1_C26_115,D_1_HOS_C4_41,S3_1_C8_8,D4_INTESTINE_C1_69,A_C6_107,A7_1_C7_6,B_1_C0_16,D_4_HOS_C4_68,A_C2_46,D3_IPF_C2_68,B_1_C21_55,D_4_IPF_C13_74,S3_2_C6_1402,D3_IPF_C3_90,D_5_HOS_C4_64,C_1_C7_51,D_4_IRF_C3_200,D3_IPF_C3_70,C_1_C7_64,D_5_HOS_C3_63,A8_C2_28,B_1_C21_42,G_C1THRU4_50,D_5_HOS_C6_95,D1_HOS_C1_54,A_C6_7,A_C6_50,B_1_C0_91,B_1_C0_95,D3_IPF_C3_55,B_1_C21_106,D_5_HOS_C5_68,A_C6_192,D_3_HOS_C9_41,D_4_IPF_C11_63,D_5_HOS_C6_59,S2_1_C2_1504,S3_1_C5_7,D_3_HOS_C9_44,S5_C2_6,D4_KIDNEY_C1_69,S10_C1_27,D_5_HOS_C4_52,B_1_C22_62,D_4_HOS_C13_62,C_1_C5_67,B_1_C22_60,S2_1_C2_1514,D3_IRF_C3_57,B_2_C26_30,C_1_C5_69,D_4_HOS_C12_56,S2_1_C2_1503,B_1_C22_109,D_4_IRF_C13_51,S3_3_C4_2,S3_1_C7_14,C_1_C7_58,S3_2_C5_7,S2_1_C1_132,S4_HHA1_C5_34,S5_C3_3,D3_IRF_C3_55,B_1_C0_10,D_5_HOS_C7_71,D3_HOS_C3_91,G3_C1_4,D1_IRF_C1_37,S4_HHA2_C5_34,A_C2_3,D3_HOS_C3_60,A8_C2_24,D_4_HOS_C13_68,D_5_HOS_C7_56,B_1_C26_41,D_4_HOS_C12_74,A_C2_193,D3_IRF_C3_200,A8_C2_22,S3_2_C5_10,C_1_C6_50,A_C1_58,B_1_C0_58,B_1_C26_116,S10_C1_21,D_5_HOS_C4_60,S5_C2_5,C_1_C5_4501,D_4_HOS_C13_90,D_5_HOS_C3_51,D3_SNF_C3_59,D3_SNF_C3_75,D_4_HOS_C3_73,D_4_HOS_C3_62,S10_C3_23,D3_IRF_C2_62,D_5_HOS_C7_54,E_A_HOS_C1_7093,S3_1_C10_22,A7_1_C5_2,B_1_C22_31,B_2_C26_43,A_C6_112,B_2_C26_94,E_B_HOS_C1_40,S3_1_C15_21,D_4_HOS_C4_59,S3_3_C6_2,B_1_C0_17,D_4_HOS_C13_71,D3_IPF_C2_70,D3_SNF_C3_52,S2_1_C2_10,B_1_C26_56,D3_HOS_C3_98,S10_C1_13,B_1_C0_53,C_1_C2_66,S4_HHA2_C2_37,D_4_IRF_C11_90,D_4_SNF_C13_200,A_C6_16,D1_IPF_C1_37,B_1_C0_71,B_2_C26_41,B_1_C0_23,B_1_C21_107,S2_1_C2_1604,D_4_IRF_C11_9201,G3_C1_29,C_1_C6_6250,S3_2_C4_1402,B_1_C22_76,S3_3_C6_3,A_C1_76,B_1_C26_55,S3_2_C2_29,D_4_HOS_C2_53,D_5_HOS_C3_58,E_B_HOS_C1_11,D_4_IRF_C13_91,S4_HHA3_C2_37,D_4_HOS_C2_90,S3_2_C4_18,D3_HOS_C2_40,D_4_HOS_C2_60,D_5_HOS_C2_52,B_1_C26_42,D_5_HOS_C7_74,D_5_HOS_C5_6250,C_1_C5_90,D3_HOS_C2_66,D_5_HOS_C4_98,B_1_C22_9201,S3_2_C2_38,B_1_C21_69,S4_HHA1_C1_35,A8_C2_50,C_1_C6_9930,C_1_C7_9910,S3_1_C9_26,B_2_C26_96,C_1_C5_9201,D_4_HOS_C4_66,C_1_C2_67,A_C2_115,D4_LUNG_C1_69,D_4_IRF_C11_62,A7_3_C11_1,S3_2_C2_37,B_1_C21_32,D1_IRF_C1_48,C_1_C5_56,FY_BGN_DT,S3_2_C2_12,S2_1_C2_16,S3_2_C4_31,S10_C1_22,D_4_HOS_C13_69,D3_HOS_C2_51,S3_2_C4_26,S3_2_C5_8,C_1_C7_74,S3_1_C9_20,G_C1THRU4_44,D_4_HOS_C12_90,A_C2_44,E_B_HOS_C1_44,S3_2_C5_3,S2_1_C1_86,D_5_HOS_C5_55,D_4_IRF_C11_68,D_4_IPF_C13_70,A_C2_5,D3_IRF_C3_94,S4_HHA2_C2_35,D3_IRF_C2_9201,A7_3_C10_3,D_5_HOS_C3_68,S3_2_C4_28,B_1_C22_41,D3_IPF_C3_56,B_2_C26_105,D3_HOS_C3_97,A_C1_99,C_1_C6_76,D_4_HOS_C4_72,D_4_IPF_C13_73,D_5_HOS_C5_93,D3_IPF_C3_72,A_C6_18,B_1_C0_88,B_2_C26_108,D_5_HOS_C5_98,D_5_HOS_C4_93,B_1_C0_8,S2_1_C1_3601,D_4_HOS_C2_59,A_C6_72,C_1_C7_105,D_4_SNF_C11_60,S4_HHA1_C2_38,S2_1_C2_17,A_C2_68,S3_2_C6_16,D_4_HOS_C12_51,D_5_HOS_C2_64,D3_SNF_C3_91,S4_HHA3_C4_33,D_4_IPF_C11_91,S5_C1_5,A_C6_75,B_1_C0_14,A_C6_4,B_1_C0_4,S3_2_C2_5,S3_2_C4_12,S3_1_C8_10,A_C1_117,D_5_HOS_C7_76,D_4_HOS_C13_56,A_C2_51,B_1_C22_51,D_4_IPF_C13_58,B_1_C26_94,A7_3_C10_1,B_2_C26_42,E_B_HOS_C1_7,A_C6_67,D_4_SNF_C11_53,B_1_C22_68,A_C6_53,S3_1_C2_20,S3_1_C8_13,B_1_C21_43,D1_IPF_C1_53,S3_2_C6_5,D3_SNF_C3_73,C_1_C6_43,A_C1_18,B_1_C26_40,D_4_IRF_C13_75,B_1_C22_190,S2_1_C1_141,A_C1_14,D_5_HOS_C2_55,A_C6_113,C_1_C6_99,A_C6_5,A_C6_99,A7_1_C2_7,D_4_SNF_C11_70,S5_C5_1,A7_3_C15_3,C_1_C7_72,D3_HOS_C3_59,D_1_HOS_C6_41,B_1_C21_71,D_4_HOS_C10_66,S3_1_C9_22,S4_HHA3_C3_38,S2_1_C2_1508,D_5_HOS_C5_9201,B_2_C26_200,A7_1_C2_6,C_1_C7_59,D_4_IRF_C13_60,D3_IRF_C2_98,C_1_C6_67,D_4_HOS_C13_66,S3_2_C4_33,D_4_IRF_C13_58,S4_HHA3_C5_33,D3_IRF_C3_96,B_1_C0_19,S2_1_C2_1001,D3_IRF_C3_62,C_1_C7_101,A_C2_12,S3_2_C4_20,B_1_C22_108,D3_IPF_C3_58,D_5_HOS_C3_97,D3_IRF_C2_6250,D1_IRF_C1_53,B_1_C21_105,S2_1_C3_3,C_1_C5_4201,S4_HHA2_C1_33,A_C2_7,D_4_HOS_C2_94,D3_HOS_C3_63,B_1_C21_21,D3_SNF_C3_53,D3_HOS_C2_33,D_5_HOS_C6_51,C_1_C5_51,D_4_IPF_C13_69,B_1_C0_96,A_C6_61,A8_C2_23,S2_1_C4_3,C_1_C5_200,B_1_C26_51,S3_2_C2_14,G_C1THRU4_11,D3_IRF_C2_40,S5_C2_8,A_C1_71,D_4_HOS_C12_67,D1_IPF_C1_41,B_1_C26_107,D3_HOS_C2_62,C_1_C7_70,D_5_HOS_C3_62,D3_HOS_C2_42,S3_1_C13_14,B_1_C22_42,B_1_C26_70,S4_HHA3_C3_35,A_C2_112,S3_1_C8_7,D_4_IRF_C11_74,D3_HOS_C2_50,D_4_IRF_C11_72,D_5_HOS_C7_59,A7_3_C5_3,B_2_C26_9910,A8_C2_2,D3_HOS_C2_57,D_4_HOS_C13_53,D_4_SNF_C11_57,D1_HOS_C1_57,D3_SNF_C2_41,A_C2_6250,S3_1_C5_8,D_1_HOS_C4_40,D_4_HOS_C10_6250,A_C2_43,D3_IRF_C3_65,A7_3_C7_2,G3_C1_25,D_5_HOS_C5_72,C_1_C5_55,D3_IRF_C2_96,S3_2_C2_27,B_1_C0_65,B_1_C0_40,D_4_IPF_C11_60,B_1_C22_74,A7_1_C7_1,D3_IRF_C3_51,D_4_HOS_C12_57,A_C1_67,A7_1_C1_3,S3_3_C5_7,A_C2_55,B_1_C21_31,D_4_HOS_C11_200,D_5_HOS_C3_70,S3_1_C9_27,B_1_C21_44,E_B_HOS_C1_4,S10_C1_9,E_B_HOS_C1_43,D_4_HOS_C4_55,D_4_IPF_C11_66,S3_1_C11_19,S4_HHA1_C1_33,D_4_HOS_C1_50,A_C1_50,A_C1_9920,C_1_C5_98,D_5_HOS_C7_62,D_4_IPF_C13_71,D3_HOS_C2_54,E_B_HOS_C1_30,B_1_C0_31,B_2_C26_71,D_4_HOS_C2_74,A7_1_C5_7,D_4_IPF_C11_62,S2_1_C2_1605,D_4_HOS_C11_93,D3_SNF_C3_55,S10_C2_20,B_1_C22_191,E_B_HOS_C101_7,B_1_C26_88,S3_1_C8_2001,D_4_IRF_C11_52,B_1_C21_112,B_1_C26_73,D_5_HOS_C7_9201,D3_HOS_C2_67,G_C1THRU4_35,S2_1_C2_1515,B_1_C0_12,D_4_HOS_C10_64,S3_2_C5_41,D_4_IPF_C13_52,B_1_C0_105,A_C6_98,S3_2_C4_19,A_C6_106,A_C2_15,A_C2_93,S2_1_C2_1509,D3_IRF_C3_64,A7_1_C1_1,A_C2_100,S3_1_C8_26,D_5_HOS_C6_64,C_1_C7_100,G_C1THRU4_19,D_4_HOS_C2_70,A_C2_89,E_A_HOS_C1_7099,E_B_HOS_C1_39,D_5_HOS_C3_72,D_4_HOS_C4_200,A_C1_15,A_C2_9920,D_4_SNF_C11_52,S3_3_C4_3,D3_IRF_C2_55,S10_C2_23,S5_C1_7,S3_1_C5_20,S3_1_C6_29,D_5_HOS_C4_55,A_C6_45,D_4_HOS_C3_64,A7_1_C5_10,S5_C1_1,S3_1_C13_17,D3_HOS_C3_58,S3_2_C5_37,B_1_C0_72,B_2_C26_194,A_C6_194,D_4_SNF_C11_51,B_2_C26_46,D3_HOS_C3_76,A7_1_C3_8,D_4_IRF_C11_91,A_C2_45,D_5_HOS_C2_65,B_1_C21_50,D_1_HOS_C6_40,B_1_C22_111,D_5_HOS_C2_56,S3_2_C6_41,C_1_C5_96,D1_HOS_C1_63,C_1_C5_35,S3_2_C4_2550,A_C1_41,S3_1_C8_16,S3_2_C6_43,S2_1_C3_11801,B_2_C26_54,B_1_C21_194,D_4_SNF_C11_73,S3_2_C3_14,C_1_C6_45,D3_HOS_C3_73,S10_C1_14,S3_1_C11_27,S2_1_C2_1,D_5_HOS_C3_50,D_4_HOS_C4_64,S3_2_C2_23,S10_C2_21,D_1_HOS_C7_34,S5_C1_2,G_C1THRU4_51,D_5_HOS_C4_54,B_2_C26_69,E_B_HOS_C1_29,B_1_C26_61,A_C1_53,S4_HHA3_C5_38,S2_1_C1_2,D_1_HOS_C6_200,D_4_IRF_C11_67,S3_1_C4_9,A_C2_34,A_C2_65,B_1_C22_57,D_1_HOS_C7_40,A8_C2_9,B_1_C21_52,A_C1_116,A_C2_117,S3_1_C2_7,D_4_IPF_C11_73,C_1_C5_33,D_5_HOS_C2_70,D_4_HOS_C13_58,A_C6_15,C_1_C7_75,S2_1_C2_1602,D_5_HOS_C7_51,S2_1_C2_1805,D_5_HOS_C5_63,D3_IRF_C3_90,A_C6_6250,B_1_C21_191,D_4_HOS_C3_98,S2_1_C2_132,C_1_C7_117,D_4_HOS_C4_57,D3_IPF_C2_52,E_B_HOS_C1_28,B_1_C26_9920,B_1_C0_76,S3_1_C4_7,D_4_HOS_C12_55,C_1_C6_95,S2_1_C2_7,G_C1THRU4_6,B_1_C26_35,S3_1_C3_24,D_1_HOS_C6_33,D_4_HOS_C11_63,S2_1_C2_1603,A8_C2_17,B_1_C22_43,D3_HOS_C3_56,D4_HEART_C1_69,A_C2_71,D3_IRF_C2_93,D3_IRF_C2_58,D_4_IPF_C13_93,A_C1_191,S2_1_C1_4,D_4_HOS_C13_57,D3_IPF_C2_50,G_C1THRU4_3,S3_2_C2_32,D3_HOS_C2_90,B_1_C22_88,S3_1_C10_18,S3_1_C10_2001,D_5_HOS_C2_67,S5_C2_9,E_B_HOS_C1_27,S3_2_C3_2552,B_2_C26_50,G_C1THRU4_2,D_5_HOS_C2_72,D_1_HOS_C7_200,B_1_C26_59,D_4_HOS_C3_56,D3_HOS_C2_31,D3_IPF_C2_58,C_1_C7_98,S3_2_C2_9,D_4_HOS_C12_98,S3_1_C3_20,A_C6_64,B_1_C0_21,D_4_IPF_C11_90,S2_1_C2_1519,D_5_HOS_C7_98,B_1_C26_50,D_1_HOS_C7_32,D3_IPF_C2_57,D3_IPF_C2_90,B_1_C22_46,S2_1_C2_1610,S3_1_C2_17,D_4_IRF_C13_55,B_2_C26_33,B_1_C0_59,C_1_C6_115,D_4_HOS_C10_59,B_1_C22_45,D_4_IRF_C13_73,C_1_C6_55,S3_1_C3_2001,D_3_HOS_C9_31,B_1_C0_116,B_1_C21_100,D_5_HOS_C5_76,S5_C4_6,S2_1_C2_126,D3_IPF_C3_93,S2_1_C2_36,S3_2_C6_9,D_4_IRF_C13_59,S2_1_C2_1606,D_4_HOS_C12_96,A_C2_2,A_C2_9930,C_1_C7_106,C_1_C6_44,D3_IPF_C2_41,D3_IRF_C2_50,D1_HOS_C1_26,A7_1_C2_4,D3_HOS_C2_63,B_1_C26_98,A7_1_C3_10,S4_HHA1_C5_38,D_5_HOS_C6_72,S10_C3_21,A7_1_C2_2,A_C1_68,D_5_HOS_C7_50,D_4_HOS_C13_52,S3_2_C5_15,D_4_HOS_C12_58,D_4_HOS_C3_200,S2_1_C2_1506,D_5_HOS_C4_63,B_1_C22_91,S2_1_C2_1510,S3_2_C4_32,D3_HOS_C3_96,D1_IRF_C1_27,A_C6_117,A7_1_C6_7,D_4_HOS_C3_69,D_4_IRF_C13_50,D1_HOS_C1_58,S5_C1_13,D3_IPF_C2_34,D_4_HOS_C11_68,D_5_HOS_C2_6250,D_4_HOS_C4_74,S3_2_C5_28,A_C6_35,S3_1_C8_20,D3_SNF_C3_64,D3_HOS_C2_35,D3_IRF_C3_66,S4_HHA2_C1_35,C_1_C5_105,D_4_HOS_C3_88,B_1_C0_43,D_4_SNF_C11_74,B_2_C26_75,G_C1THRU4_9,S10_C1_6,S2_1_C2_1804,C_1_C6_56,B_1_C26_64,S5_C3_6,S4_HHA3_C1_35,C_1_C6_93,B_1_C21_190,A_C1_94,D3_SNF_C2_53,D1_HOS_C1_37,S3_1_C7_25,B_1_C26_194,B_1_C0_69,D3_IPF_C3_75,A_C1_66,B_1_C0_1,D_5_HOS_C7_57,S3_3_C5_2,B_1_C22_70,C_1_C7_66,D_4_IRF_C11_200,S3_1_C7_8,D3_IPF_C2_66,D_5_HOS_C6_94,D_4_HOS_C10_76,D3_HOS_C3_93,D3_IPF_C2_51,D_4_SNF_C13_73,D3_SNF_C3_50,D_4_IPF_C11_72,D_5_HOS_C2_68,S3_2_C3_2553,C_1_C6_66,D_4_IRF_C13_72,D3_SNF_C3_67,S3_1_C6_7,A_C2_9940,D_5_HOS_C7_65,B_1_C0_100,S2_1_C2_1520,C_1_C6_62,B_1_C21_59,S3_1_C13_16,S2_1_C2_1512,D_4_HOS_C3_63,D_5_HOS_C3_57,S2_1_C2_1807,A_C6_191,B_1_C21_35,B_1_C26_33,D_4_IRF_C2_200,S3_1_C12_17,S3_1_C14_18,C_1_C5_9920,A_C2_32,B_2_C26_89,D_4_HOS_C4_90,A_C2_76,D3_SNF_C2_30,E_B_HOS_C1_14,A7_3_C11_2,S3_1_C13_18,D_4_HOS_C11_59,S5_C1_21,C_1_C5_9940,S3_1_C11_24,S2_1_C2_1511,B_1_C26_111,D_4_IPF_C13_72,S2_1_C1_128,S3_1_C14_14,S4_HHA2_C1_34,B_1_C21_193,D_5_HOS_C4_51,B_2_C26_202,G_C1THRU4_49,D3_IPF_C3_94,A_C1_89,S3_1_C4_14,D_4_SNF_C11_55,D_1_HOS_C4_33,D3_IPF_C2_73,D3_SNF_C2_63,D3_SNF_C2_32,B_1_C0_55,A_C2_97,B_2_C26_107,C_1_C5_34,D_4_SNF_C11_68,D3_IRF_C3_73,D_4_HOS_C3_6250,A7_1_C3_5,A_C6_33,G_C1THRU4_40,D3_HOS_C3_62,TRNSMTL_NUM,S3_2_C2_30,D_4_HOS_C12_59,D_4_IPF_C13_56,G_C1THRU4_45,A_C1_63,S3_1_C5_9,D_4_IPF_C11_75,C_1_C5_93,S2_1_C2_130,S3_2_C2_19,S10_C3_22,S3_2_C4_2552,D_4_HOS_C2_63,D1_IPF_C1_49,S2_1_C1_3,S3_2_C2_36,D_4_SNF_C11_50,D3_HOS_C3_64,S4_HHA1_C4_35,A_C6_19,S3_2_C6_3,D_4_IPF_C11_58,D_4_SNF_C11_54,S4_HHA1_C4_34,S3_1_C3_9,D_4_HOS_C10_54,D_4_HOS_C10_71,B_1_C0_30,D3_SNF_C2_91,D_4_HOS_C3_9201,S2_1_C6_24,S2_1_C2_1806,A_C6_69,S4_HHA2_C5_36,D_5_HOS_C4_6250,B_1_C0_94,D_1_HOS_C4_31,D_4_HOS_C2_67,S3_1_C5_13,A_C1_16,D_5_HOS_C2_200,C_1_C6_71,S3_1_C2_12,C_1_C6_33,S3_2_C4_27,S2_1_C1_60,S3_1_C8_15,S3_1_C6_32,D_4_HOS_C3_74,S3_1_C7_6,B_2_C26_115,G2_C1_28,A_C2_192,D_5_HOS_C2_60,S3_1_C6_8,C_1_C5_76,S3_2_C5_36,D_4_HOS_C10_58,D_4_IRF_C13_54,B_1_C22_52,C_1_C6_53,B_1_C21_9201,D_3_HOS_C9_32,B_1_C0_4201,G3_C1_3,S3_2_C4_2553,A7_1_C3_3,S3_1_C6_11,S3_1_C7_22,D3_IRF_C2_64,B_1_C26_9940,S5_C2_21,D_4_HOS_C2_51,D1_HOS_C1_50,D3_SNF_C2_51,B_1_C22_90,A_C2_116,D3_IRF_C3_60,D3_IPF_C2_65,B_1_C22_65,A_C6_94,S4_HHA2_C5_38,A_C6_193,B_2_C26_117,B_1_C0_62,A_C6_17,D_5_HOS_C4_58,D_4_HOS_C2_62,D1_HOS_C1_53,D_4_HOS_C10_63,D_4_IPF_C13_68,S3_3_C4_5,G_C1THRU4_37,D3_IPF_C2_42,A_C2_107,D_4_IRF_C11_59,A_C1_46,S3_1_C10_24,S5_C1_12,A7_1_C1_7,D_5_HOS_C4_50,S3_2_C4_3,D3_SNF_C3_72,B_1_C21_109,C_1_C6_101,D_4_SNF_C11_200,S3_2_C4_2551,D3_IPF_C3_62,D_5_HOS_C2_97,S5_C4_3,D_5_HOS_C6_93,D3_SNF_C2_50,B_1_C26_200,B_1_C22_107,S4_HHA2_C4_33,D_4_HOS_C13_67,A7_3_C6_1,S3_2_C2_7,D_4_IPF_C11_76,E_B_HOS_C1_24,S3_2_C3_23,D1_HOS_C5_44,D3_SNF_C2_96,E_B_HOS_C1_18,D_4_HOS_C10_9201,S2_1_C2_1801,S3_2_C2_28,B_2_C26_190,S2_1_C1_127,G_C1THRU4_23,D_5_HOS_C4_57,D3_HOS_C2_6250,D3_SNF_C2_58,D3_IRF_C3_9201,S2_1_C2_11801,S3_3_C4_4,A7_1_C2_5,D_5_HOS_C6_200,A8_C2_19,B_1_C21_68,C_1_C5_60,B_1_C0_93,B_2_C26_68,S3_1_C3_32,A_C1_6,D_4_HOS_C10_73,D_4_HOS_C12_69,S4_HHA1_C4_36,S3_1_C15_1,D_4_HOS_C1_73,E_B_HOS_C1_25,D_5_HOS_C6_68,D_4_IPF_C13_65,A_C2_57,A_C2_200,C_1_C6_40,D3_IPF_C2_32,S4_HHA3_C4_37,S3_2_C4_35,D3_IPF_C3_51,E_B_HOS_C1_31,D_4_HOS_C3_55,D_5_HOS_C3_73,E_B_HOS_C1_22,B_1_C26_66,S3_2_C4_22,A7_1_C2_10,D3_HOS_C2_97,C_1_C6_9940,S3_2_C6_32,D_4_HOS_C4_56,A_C1_4201,A_C6_20,D_4_SNF_C11_91,D3_SNF_C2_72,FI_CREAT_DT,A8_C2_30,D_4_HOS_C4_75,D_5_HOS_C7_69,D_4_HOS_C11_70,A_C2_74,S2_1_C2_1201,S5_C1_8,D_5_HOS_C4_72,A_C2_106,S3_2_C2_25,C_1_C6_91,S3_1_C7_19,A_C1_10,B_1_C26_4201,D_4_HOS_C10_70,A_C1_88,S3_2_C2_39,D_4_HOS_C3_96,S2_1_C3_143,S3_2_C2_2552,D_4_HOS_C1_91,D3_HOS_C3_6250,D3_HOS_C2_72,D3_IRF_C2_73,A_C2_98,S3_3_C5_1,D3_IPF_C2_40,A7_1_C3_7,B_1_C26_32,S3_2_C5_33,D_4_HOS_C13_97,A_C2_72,D3_IPF_C2_69,A_C2_113,S2_1_C2_1524,B_1_C21_51,D_4_SNF_C11_65,D_5_HOS_C4_62,S5_C1_9,A_C2_4501,D3_SNF_C3_94,D_4_HOS_C12_54,B_1_C21_66,B_1_C21_74,D_3_HOS_C2_200,A_C6_111,D_4_IRF_C13_74,A_C1_100,D_5_HOS_C7_93,C_1_C5_115,D3_SNF_C3_96,D_5_HOS_C3_91,S3_2_C2_6,A_C1_23,S3_1_C8_25,S2_1_C1_126,D3_IRF_C2_35,B_1_C21_41,S3_1_C15_16,C_1_C7_95,D_4_IPF_C13_9201,A_C1_75,C_1_C6_117,D3_HOS_C2_98,B_1_C26_101,B_2_C26_70,S3_1_C6_9,B_1_C0_54,A_C1_11,S3_2_C2_16,D_4_HOS_C4_69,S5_C6_2,S3_2_C4_24,A7_3_C6_2,S3_3_C4_1,C_1_C6_9920,D_4_HOS_C12_66,B_1_C0_193,A_C1_30,A_C2_21,D3_SNF_C2_57,D_5_HOS_C5_53,S5_C5_2,CENSUS,D_4_HOS_C4_65,D3_IRF_C2_59,D_5_HOS_C5_97,A_C2_13,D_4_HOS_C2_71,D3_SNF_C2_76,S2_1_C2_4,C_1_C5_9910,D_5_HOS_C7_72,D3_HOS_C2_74,A_C1_4501,B_1_C21_34,D_4_HOS_C2_91,D1_IRF_C1_51,S4_HHA3_C3_36,A_C1_54,B_1_C0_9940,B_1_C26_201,E_B_HOS_C1_2,D3_HOS_C3_94,D_4_IPF_C13_64,D_4_HOS_C4_88,S3_1_C11_26,E_B_HOS_C101_8,D_4_HOS_C13_64,D_5_HOS_C3_60,A8_C2_11,B_2_C26_63,D_4_SNF_C11_72,S3_2_C5_27,B_1_C0_5,C_1_C5_111,S3_1_C3_1801,S3_1_C12_16,S2_1_C1_142,B_1_C22_192,D3_IRF_C3_56,S3_2_C4_1601,D_5_HOS_C3_98,B_1_C0_9201,A_C1_51,D_4_HOS_C2_52,A_C1_91,D_4_HOS_C2_97,D1_HOS_C1_48,S4_HHA3_C5_37,D_5_HOS_C3_55,D_5_HOS_C6_74,D3_HOS_C3_54,D_4_HOS_C2_64,C_1_C5_117,B_1_C21_192,S3_1_C8_1801,S5_C4_2,S3_1_C10_14,S3_1_C7_13,D_5_HOS_C7_64,B_2_C26_191,S2_1_C1_48,D_5_HOS_C2_93,C_1_C6_4201,B_1_C0_75,D4_LIVER_C1_69,D_5_HOS_C5_51,C_1_C6_116,D_4_HOS_C1_53,D3_IPF_C2_67,C_1_C6_34,S3_1_C2_1801,S3_2_C2_42,S3_2_C4_2,S3_3_C2_1,B_1_C0_20,D_4_HOS_C11_69,S4_HHA1_C5_36,A_C2_23,A_C2_88,S3_1_C10_20,S3_2_C6_37,A_C1_31,B_2_C26_56,B_1_C22_53,S2_1_C1_140,S3_1_C8_22,D_4_HOS_C11_94,D_5_HOS_C7_58,D_4_HOS_C4_70,S3_1_C7_16,E_B_HOS_C1_37,A_C1_93,D3_SNF_C3_65,E_B_HOS_C1_35,B_1_C22_89,D_5_HOS_C4_53,C_1_C5_66,D1_HOS_C1_51,A_C6_52,D3_IPF_C3_9201,D_4_HOS_C3_72,S3_1_C7_1,G3_C1_1,C_1_C7_116,S3_1_C11_21,D3_SNF_C3_70,B_1_C22_69,D_4_IPF_C13_200,D_4_HOS_C10_72,S5_C2_3,S3_2_C6_36,A_C6_42,S5_C2_7,B_1_C26_72,S3_2_C4_15,S3_3_C6_4,D3_IPF_C2_76,S4_HHA1_C4_38,D3_HOS_C3_67,S3_2_C5_16,D_4_HOS_C10_62,C_1_C5_50,D_4_IPF_C13_63,S5_C3_1,S3_2_C6_27,B_1_C22_194,C_1_C6_105,S3_2_C2_2553,A_C6_40,C_1_C6_109,D_5_HOS_C4_66,D3_IRF_C2_41,D_4_HOS_C10_68,D_5_HOS_C7_53,D_4_HOS_C10_56,D_4_HOS_C3_65,B_2_C26_34,D_4_SNF_C11_69,D_4_HOS_C10_93,D_4_HOS_C12_70,C_1_C7_61,D_4_IRF_C11_55,A_C1_194,B_1_C0_57,D3_IPF_C3_65,D_4_HOS_C10_75,D_4_IPF_C13_75,D_4_HOS_C12_53,D_4_HOS_C3_57,S3_2_C6_14,S2_1_C2_14,B_1_C0_51,S3_1_C6_17,D_5_HOS_C4_69,B_1_C22_105,D3_SNF_C2_54,S3_1_C2_2001,B_2_C26_67,D_4_HOS_C13_98,B_1_C0_98,D3_IRF_C3_53,A7_1_C5_3,A_C6_9,A7_1_C2_1,A_C2_108,D_4_IPF_C13_59,S3_1_C2_1,S3_1_C7_32,D_4_IRF_C13_71,D3_IRF_C3_61,S10_C3_20,S3_1_C2_24,B_1_C0_11,B_1_C0_60,S3_1_C8_32,D_4_HOS_C10_50,D3_IRF_C2_67,A_C1_43,D_3_HOS_C9_35,C_1_C7_99,S5_C2_1,B_1_C0_108,D1_SNF_C1_74,S3_1_C2_19,B_1_C0_6250,D_4_HOS_C11_62,S3_2_C2_10,D_5_HOS_C3_64,S2_1_C1_22,S4_HHA2_C1_36,S3_1_C7_24,B_2_C26_116,D3_IPF_C2_74,A_C2_99,D3_IPF_C2_59,D_4_HOS_C3_91,D3_SNF_C2_60,D3_IRF_C3_93,S2_1_C1_85,D_5_HOS_C5_64,D_5_HOS_C4_91,D_4_HOS_C11_53,D_4_HOS_C12_64,C_1_C5_52,C_1_C5_31,D1_IPF_C1_48,E_B_HOS_C1_17,D_4_HOS_C12_72,B_1_C22_32,A_C2_9,B_1_C26_63,S3_2_C4_2201,D3_HOS_C2_9201,D_4_HOS_C3_94,D3_IRF_C2_66,D_4_HOS_C3_93,B_1_C26_9910,S3_2_C2_20,B_1_C21_93,D_4_HOS_C12_93,S3_3_C2_2,S4_HHA1_C2_34,D3_IRF_C2_53,D_4_HOS_C12_9201,B_1_C26_89,B_2_C26_109,D3_SNF_C2_40,A_C1_45,S3_1_C7_7,A_C2_94,S4_HHA2_C4_37,D3_HOS_C2_41,S2_1_C2_1502,S3_1_C4_12,A_C1_9930,A_C6_10,S3_2_C2_34,C_1_C6_9201,A_C2_9910,D3_IRF_C2_52,S2_1_C2_1523,S3_1_C10_21,D1_HOS_C1_27,D_4_HOS_C10_96,D3_HOS_C3_90,S10_C1_31,S10_C1_2701,S4_HHA3_C2_38,A_C1_55,D_5_HOS_C6_73,S3_2_C5_31,D_4_HOS_C2_72,C_1_C6_202,D_4_SNF_C11_75,D_4_SNF_C11_93,S5_C2_10,B_1_C26_53,E_B_HOS_C1_19,D3_HOS_C3_65,D_4_SNF_C11_67,D_4_IRF_C13_56,D_5_HOS_C2_90,B_2_C26_90,D_1_HOS_C6_31,D_4_IPF_C13_50,D_5_HOS_C3_94,S4_HHA2_C3_35,D3_IRF_C2_91,D_4_HOS_C4_89,B_1_C0_101,D_4_HOS_C3_59,S3_1_C7_17,S10_C1_17,D_4_HOS_C12_63,G_C1THRU4_1,G3_C1_26,D_4_HOS_C11_52,B_1_C22_115,D_5_HOS_C6_56,A_C1_56,B_1_C0_34,D3_SNF_C2_73,Beginning FFY,Hospital Type (From CMS Hospitals Data Archive),Name and Num
,Curated Name and Num,Hospital type (modified),Type of Control of Hospital (See Table I),Lon,Lat,Electroencephalography,Other Outpatient Services,Nonphysician Anesthetists,Durable Medical Equipment Rented,Medical Records and Medical Rec. Library,Total,Dietary,CT Scan,SNF,Social Service,Speech Pathology,Research,Coronary Care Unit,Stand-alone CHIP -- Costs minus net revenue (0 min),Subprovider-IRF,Delivery Room and Labor Room,IPPS Interim payment,Adults & Pediatrics,Hospice,Int & Res (non approved teaching program,CT Scan,Drugs Charged to Patients,Delivery Room and Labor Room,Cost of Uncompensated Care,Radiology-Diagnostic,MRI,Respiratory Therapy,Allowable bad debts for dual eligibles beneficiaries,Kidney Acquisition,Occupational Therapy,MRI,Subtotal,Medical Supplies Charged to Patients,Respiratory Therapy,PBP Clinical Lab Services Program Only,Speech Pathology,Physical Therapy,RHC 2 Provider Number,OLTC,Lung  Acquisition,Other Outpatient Services,"Trade, Quantity, and Time Discounts",CT Scan,Electrocardiology,Speech Pathology,MRI,Whole Blood & Packed Red Blood Cells,Total Number of Outlier Episodes,Premiums,"Blood Storing, Processing, Trans",Radiology-Diagnostic,Home Program Dialysis,Delivery Room and Labor Room,Medicare Certified Heart TC term date,Interns & Residents,Respiratory Therapy,Islet Acquisition,Total,Clinic,Cafeteria employees and guests,Other Special Care Unit,Physical Therapy,Medical Supplies Charged to Patients,Subprovider 1,Medical Supplies Charged to Patients,MRI,Laboratory,Speech Pathology,Non-Physician Part B,Physical Therapy,Subprovider-IRF,Clinic,Observation Beds (Distinct Unit),Total Program Excludable Costs,Radiology-Diagnostic,MRI,CMHC,Radiology-Therapeutic,Durable Medical Equipment Sold,Dietary,Land Improvements,certification date,RHC 17 Provider Number,Cost To Charge Ratio,Recovery Room,Cardiac Catheterization,Electroencephalography,Coronary Intensive Care Unit,ASC 1 Provider Number,Medical Supplies Charged to Patients,Delivery Room and Labor Room,Intensive Care Unit Program Cost,Other Special Care Unit,Medical Supplies Charged to Patients,Electrocardiology,Administrative and General,Urban/Rural Indicator at beginning,Respiratory Therapy,Utilization Review - Physician Compen,State or local govt (not Medicaid or CHIP) -- Costs minus net revenue (0 min),Total costs for patients covered by a state or local government program,Observation Beds (Distinct Unit),Subtotal Salaries,Building Improvements,Impl. Dev. Charged to Patients,Drugs Charged to Patients,Subprovider-IRF,Physical Therapy,Surgical Intensive Care Unit,Intravenous Therapy,Physician-Part A,Subprovider 1,Dietary,Other Special Purpose,Durable Medical Equipment Rented,Impl. Dev. Charged to Patients,Recovery Room,IRF,Renal Dialysis,Adults & Pediatrics,Kidney Acquisition,"Blood Storing, Processing, Trans",Ambulance Services,Emergency,Other Outpatient Services,MRI,"Blood Storing, Processing, Trans",Land,Home Office:  Physician Part A,With Outliers:  Non Routine Med Sup Chgs,OLTC,Impl. Dev. Charged to Patients,Interns & Residents,Subprovider II,Admin & Gen Under Contract,Respiratory Therapy,net of Swing Bed Cost,Renal 10 Provider Number,NF,PEP Episodes:  Total Number of Episodes,Intestinal Acquisition,Int & Res (non approved teaching program,Total Program Excludable Costs,Assets,Other Ancillary,Total Costs,Surgical Intensive Care Unit,Total,Lung  Acquisition,Electrocardiology,Adults and Pediatrics,Drugs Charged to Patients,IPF,Other Capital,Television and Radio Service,Laboratory,Anesthesiology,Cafeteria,Total Salaries,Electroencephalography,Burn Intensive Care Unit,Other Outpatient Services,Non-Physician Anesthetist Part B,Whole Blood & Packed Red Blood Cells,Subprovider-IPF,Total Hospital,Impl. Dev. Charged to Patients,Occupational Therapy,Housekeeping under Contract,ICF,Radiology-Therapeutic,Total Salaries,CT Scan,Physician-Part A,ASC (Non Distinct Part),Total Other Charges,Research,Burn Intensive Care Unit,Delivery Room and Labor Room,Subprovider I,Total Overhead Costs,Whole Blood & Packed Red Blood Cells,Organ Procurement,Hospital Adlts & Ped Swing Bed SNF,Total Hospital Interns & Residents,Intravenous Therapy,Physical Therapy,Building Improvements,Surgical Intensive Care Unit,HHA 3 Provider Number,Durable Medical Equipment Rented,RHC/FQHC Combined,Burn Intensive Care Unit,Physical Therapy,Delivery Room and Labor Room,Out of State Medicaid eligible days,Aggregate amount collected from patients,OSP,Intensive Care Unit,"Number of Times per week
 Patient receives Dialysis",Laboratory,Total Outpatient Program Pass Thru Cost,Radioisotope,Medical Supplies Charged to Patients,Without Outliers:  Other Charges,Renal Dialysis,Telephone Services,Home Office Salaries,Anesthesiology,Payment to cost ratio,Delivery Room and Labor Room,Swing Bed NF Provider Number,Delivery Room and Labor Room,Respiratory Therapy,With Outliers:  Total Charges,Hospital Adults & Pediatrics,Observation Beds (Distinct Unit),Radiology-Therapeutic,"Blood Storing, Processing, Trans",Interns & Res Salary and Fringe Benefits,Occupational Therapy,Operating Room,Operating Room,Pass through Cost for Program Inpatient,OPT,Total Visits,Non-Physician Anesthetist Part B,Anesthesiology,Operating Room,Hospice,Respiratory Therapy,Whole Blood & Packed Red Blood Cells,Electroencephalography,PBP Clinical Lab Services Program Only,OLTC,Without Outliers:  Non Routine Med Sup Chgs,New Capital Buildings and Fixtures,Adults and Pediatrics,Utilization Review SNF,New Cap Related Csts Bldg & Fixtures,Physicians' Private Office,Intravenous Therapy,FQHC,Operating Room,Heart Acquisition,PEP Episodes:  Total Charges:,Electrocardiology,In State Medicaid eligible days,Intestinal Acquisition,Occupational Therapy,Pancreas Acquisition,Radioisotope,CT Scan,Cardiac Catheterization,Home Office Salaries & Wage Related Csts,RHC 22 Provider Number,Management and Administrative Services,Nursing Administration,Cardiac Catheterization,Respiratory Therapy,Recovery Room,"Blood Storing, Processing, Trans",Does the hospital qualify as RPCH/CAH? (Y/N),Other Reimbursable,Excess of reasonable cost over reasonable charges,OOT,Radiology-Diagnostic,Hospice,Physical Therapy,Total Facility,Laboratory,Labor and Delivery,FQHC 8 Provider Number,Speech Pathology,Physical Therapy,Electroencephalography,Pancreas Acquisition,Adults and Pediatrics,Int & Res (non approved teaching program,Intestinal Acquisition,Other Outpatient Services,Outpatient Rehab Provider,Physician Part A,Renal Dialysis,Laboratory,Home Office Salaries & Wage Related Csts,Heart Acquisition,Electrocardiology,Total Other Medical Education,Subprovider-IPF,Other Nonreimbursable,Other Ancillary,Buildings and Fixtures,SNF,OLTC,Laboratory,NF,Subprovider 1,MDH status beginning date  (MM/DD/YY),Intensive Care Unit,Emergency,FQHC,Medical and Other Services reimbursed by OPPS,Intensive Care Unit,SNF,Surgical Intensive Care Unit,Intestinal Acquisition,Wage Related Costs Core,Less Contractual Allowance and Discounts on Patients' Accounts,Nonpaid Workers,LUPA Episodes:  Other Charges,Total Other Medical Education,Speech Pathology,Drugs Charged to Patients,MRI,Occupational Therapy,Other Reimbursable,CT Scan,Renal Dialysis,Is this hospital an All-Inclusive rate provider? (Y/N),Surgical Intensive Care Unit,PEP:  Total Number of Outlier Episodes,Ancillary service charges,New Cap Related Csts Bldg & Fixtures,Total Facility FTEs,Hospital County,Observation Beds (Distinct Unit),Medical Supplies Charged to Patients,Without Outliers:  Total Visits,Medical Supplies Charged to Patients,Payroll taxes payable,Electroencephalography,Cardiac Catheterization,Total,SNF Provider Number,Other Special Care Unit,PEP Episodes:  Total Charges:,Nonpaid Workers,Total,Building Improvements,"Blood Storing, Processing, Trans",Respiratory Therapy,Medical Supplies Charged to Patients,Other Special Care,Ancillary service other pass through costs,Liver Acquisition,Recovery Room,Radioisotope,Other Ancillary,Title V discharges,Total Other Expenses,Home Program Dialysis,Home Office PO Box,Radioisotope,Drugs Charged to Patients,Electrocardiology,Radiology-Therapeutic,Drugs Charged to Patients,Geographic MSA,Radiology-Diagnostic,RHC 1 Provider Number,Blood Clotting Factors for Hemoph.,Radiology-Diagnostic,Utilization Review SNF,Drugs Charged to Patients,Nursery,Other Reimbursable,Physical Therapy,"Gift, Flower, Coffee Shop, Canteen",CORF,Renal Dialysis,Fixed Equipment,Delivery Room and Labor Room,Total Assets,Renal Dialysis,Social Service,Total Nursing School,Total,Laboratory,Electrocardiology,CT Scan,Housekeeping under contract,Anesthesiology,ASC (Distinct Part),Movable Equipment,Line 2 times line 5,Occupational Therapy,Total Number of Outlier Episodes,Anesthesiology,Respiratory Therapy,New Cap Related Csts Movable Equipment,Total Salaries,Burn Intensive Care Unit,Emergency,Intravenous Therapy,IPF,Other Special Care Unit,TOTAL,CT Scan,Medical Records & Med Records Library,Speech Pathology,Emergency,Total Charges:  LUPA Episodes,Respiratory Therapy,Total,Adults & Pediatrics,Blood Clotting Factors for Hemoph.,Delivery Room and Labor Room,ASC (Non Distinct Part),RHC,Anesthesiology,OLTC,Other Ancillary,Intestinal Acquisition,Durable Medical Equipment Sold,Lung  Acquisition,Liver Acquisition,Durable Medical Equipment Sold,SNF,Laundry and Linen Service,Other Ancillary,MDH status ending date (MM/DD/YY),Other Ancillary,Physician Part A,Interns & Res Other Program Costs,Total Program Excludable Costs,Radiology-Diagnostic,HHA,RHC 23 Provider Number,"Blood Storing, Processing, Trans",Intensive Care Unit,Title XVIII discharges,IRF Provider Number,PBP Clinical Lab Services Program Only,Physician-Part A,Coronary Care Unit,Electroencephalography,Respiratory Therapy,IPPS Payment amount (unadjusted),Islet Acquisition,MRI,Emergency,Hospice,Total Patient Days,Durable Medical Equipment Sold,Fixed Equipment,Organ Procurement,Intravenous Therapy,Operating Room,Hospice,State,Electroencephalography,Whole Blood & Packed Red Blood Cells,Other Special Purpose,Anesthesiology,Transitional corridor payment,Intestinal Acquisition,Laboratory,Radiology-Therapeutic,Observation Beds (Distinct Unit),Electroencephalography,LUPA:  Total Non Routine Med Sup Chgs,Does the facility operate an ICF/MR facility for purposes of Title XIX? (Y/N),Number of EPO units furnished for Line 13,"Income from imposition of interest, finance",Cardiac Catheterization,Radiology-Therapeutic,CORF,Anesthesiology,Radioisotope,LUPA Episodes:  Total Visits,Occupational Therapy,Total Charges,"Number of Times per week 
Patient receives Dialysis",City,Electrocardiology,Nursing Administration,HMO,Blood Clotting Factors for Hemoph.,Radiology-Diagnostic,Ambulance Services,Delivery Room and Labor Room,Speech Pathology,Report Status Code,Social Service,Other Special Purpose,Operation of Plant,Surgical Intensive Care Unit,Physicians' Private Office,Laboratory,Laboratory,Total Salaries,ASC (Distinct Part),Radioisotope,Central Services and Supply,Radioisotope,"If (SCH), enter the # of periods.",Other Special Care,Lesser of cost or charges,"Gift, Flower, Coffee Shop, Canteen","Does this facility operate 
transplant center? (Y/N)",Kidney Acquisition,Total,Cardiac Catheterization,Home Program Dialysis,Observation Beds (Distinct Unit),Other Reimbursable,Intensive Care Unit,Non-Physician Anesthetist Part A,"Blood Storing, Processing, Trans",Total Directly Assigned New Cap Rel Csts,Drugs Charged to Patients,Buildings,Laboratory,Hospital Provider Number,Cardiac Catheterization,ASC (Non Distinct Part),Occupational Therapy,RHC 18 Provider Number,OPT,Other Reimbursable,PBP Clinical Lab Services Program Only,"Blood Storing, Processing, Trans",ICF,Durable Medical Equipment Rented,NF,MRI,Electroencephalography,Maintenance of Personnel,Home Program Dialysis,Medical Supplies Charged to Patients,Administrative and General under Contract,Other Outpatient Services,Utilization Review SNF,Other Ancillary,Radiology-Diagnostic,Other Reimbursable,Central Services and Supply,TOTAL,Radiology-Diagnostic,Cardiac Catheterization,HHA,Pharmacy,Total Subprovider I Interns & Residents,Subprovider-IRF,Whole Blood & Packed Red Blood Cells,Rental of Provider space by suppliers,HRR adjustment amount,Hospice 3 Provider Number,Surgical Intensive Care Unit,Central Services and Supply,Operating Room,Electrocardiology,Home Program Dialysis,Coronary Intensive Care Unit,Emergency,Cost of physicians svcs in a teaching hospita,Whole Blood & Packed Red Blood Cells,HMO,Occupational Therapy,Total,Ambulance Services,CT Scan,Title XIX discharges,Subprovider II,OLTC,Net Revenue from Medicaid,Accounts Receivable,Contract Labor,Non-Physician Part B,Non-Physician Anesthetist Part B,"Number of patients in program at 
end of cost reporting period",ICF,Pass Through Cost for  Program Ancillary,Recovery Room,Home Office Personnel,OLTC,ICF,Physical Therapy,Clinic,Recovery Room,Clinic,Other Ancillary,Physician Part A,Observation Beds (Distinct Unit),Renal 9 Provider Number,Whole Blood & Packed Red Blood Cells,Total Costs,Respiratory Therapy,Electrocardiology,Ending Date of SCH status,Without Outliers:  Non Routine Med Sup Chgs,Total Number of Episodes,Land Improvements,Lung  Acquisition,Interns & Residents,Interns & Res Salary and Fringe Benefits,ASC (Non Distinct Part),Subprovider-IPF,Respiratory Therapy,Blood Clotting Factors for Hemoph.,"Medical certified lung
transplant center cert date",Speech Pathology,RHC,Coronary Care Unit,OLTC,Surgical Intensive Care Unit,Heart Acquisition,Interns & Residents,Less Observation Beds,Sale of medical and surgical supplies to,Observation Beds (Distinct Unit),Whole Blood & Packed Red Blood Cells,Observation Beds (Distinct Unit),CMHC,Observation Beds (Distinct Unit),Other Ancillary,Interns & Res Other Program Costs,Whole Blood & Packed Red Blood Cells,PBP Clinical Lab Services Program Only,Radiology-Diagnostic,HHA,Burn Intensive Care Unit,Ambulance Services,Laundry and Linen Service,Drugs Charged to Patients,Recovery Room,Sequestration adjustment,Physical Therapy,Radioisotope,Occupational Therapy,Speech Pathology,Total Program Inpatient Costs,LUPA Episodes:  Other Charges,MRI,Intestinal Acquisition,New Cap Related Csts Bldg & Fixtures,FQHC 2 Provider Number,Movable Equipment,Teaching Physician Salaries,Radiology-Diagnostic,Related Organization Transactions,CT Scan,Electrocardiology,Total,Pancreas Acquisition,Subtotal Salaries,Utilization Code (L/N/F),New Capital Equipment,Respiratory Therapy,Laboratory,Respiratory Therapy,"Percentage of patients re-using
dialyzers",Durable Medical Equipment Rented,ASC (Non Distinct Part),Coronary Care Unit,Renal Dialysis,Other Special Purpose,Investment Income-New Bldgs & Fixtures,Refunds and Rebates of Expenses,Laboratory,Physicians' Private Office,Radiology-Therapeutic,W/Out Outliers:  Number of Episodes,Medical Supplies Charged to Patients,New Capital Buildings and Fixtures,Speech Pathology,"Blood Storing, Processing, Trans",Other Assets,HHA,Physicians' Assistant,Other Ancillary,Clinic,RPCH/CAH Visits,Physician-Part B,New Cap Related Csts Movable Equipment,Electrocardiology,Heart Acquisition,Subtotal,Hospital Adults & Pediatrics,CT Scan,Line 2 times line 5,Land,Physician-Part B,"Number of patients in program at 
end of cost reporting period",Islet Acquisition,Renal Dialysis,LUPA Episodes:  Total Number of Episodes,Renal Dialysis,Is this hospital classified as a referral center? (Y/N),Observation Beds (Distinct Unit),Wage Related Costs RHC/FQHC,Pharmacy,Radioisotope,Anesthesiology,Kidney Acquisition,Subprovider I,Other Reimbursable,HHA,NF,Other Reimbursable,Other Special Care Unit,Burn Intensive Care Unit,Subtotal,Adults and Pediatrics,Impl. Dev. Charged to Patients,Sale of medical records and abstracts,SNF,Occupational Therapy,Blood Clotting Factors for Hemoph.,Minor Equipment Depreciable,Impl. Dev. Charged to Patients,Operation of Plant,Subprovider I,LUPA Episodes:  Total Visits,Operating Room,Drugs Charged to Patients,Negative Cost Centers,Electroencephalography,Anesthesiology,Inventory,Operating Room,Coronary Care Unit,"Gift, Flower, Coffee Shop, Canteen",Total,Observation Beds (Distinct Unit),Medicare Certified Lung TC term date,Pancreas Acquisition,Heart Acquisition,Recovery Room,Electrocardiology,Anesthesiology,OPPS payments,Other Reimbursable,CORF,Islet Acquisition,Blood Clotting Factors for Hemoph.,"Blood Storing, Processing, Trans",ASC (Non Distinct Part),CT Scan,Radiology-Therapeutic,Cardiac Catheterization,Other Ancillary,Other Organ Acquisition,Recovery Room,Respiratory Therapy,Other Special Care Unit,Intensive Care Unit,Subprovider I,Anesthesiology,Employee Benefits,Emergency,Laundry and Linen Service,RHC 8 Provider Number,Delivery Room and Labor Room,Nursing Administration,Speech Pathology,"Blood Storing, Processing, Trans",Int & Res (non approved teaching program,Total,Speech Pathology,Radiology-Diagnostic,Lung  Acquisition,Renal 4 Provider Number,Emergency,Drugs Charged to Patients,Subprovider-IPF,Other Special Care,MRI,OSP,Other Ancillary,Total Hospital,Durable Medical Equipment Rented,Speech Pathology,Anesthesiology,Subprovider I,Other Special Care Unit,Electrocardiology,Nursery,PBP Clinical Lab Services Program Only,Int & Res (non approved teaching program,Housekeeping,Medical and Other Services,"Epoietin amount form worksheet A
for home dialysis program",ASC (Non Distinct Part),MRI,Observation Beds (Distinct Unit),CT Scan,TOTAL,Subtotal Wage Related Csts,Clinic,Investments,Recovery Room,Cardiac Catheterization,Whole Blood & Packed Red Blood Cells,Coronary Care Unit,Radiology-Diagnostic,Home Office Personnel,Wage Related Costs Core,Total Charges,CMHC,Clinic,Recovery Room,Other Ancillary,Physical Therapy,General Fund Balance,Other Organ Acquisition,Maintenance and Repairs,Delivery Room and Labor Room,"Blood Storing, Processing, Trans",SSA State County Code,Other General Service,Occupational Therapy,NF,Hospice,Home Office:  Physician Part A,Other Organ Acquisition,Whole Blood & Packed Red Blood Cells,Title XIX discharges,Other Outpatient Services,Excluded Area Salaries,TOTAL,Ambulance Services,Depreciation-New Movable Equipment,OOT,Total Charges,Interns & Residents,Pharmacy,"Gift, Flower, Coffee Shop, Canteen",Clinic,MRI,"If Line 32, Col 1 is yes, enter the method used: (A, B, or E only)",Maintenance of Personnel,Radioisotope,Intravenous Therapy,Impl. Dev. Charged to Patients,Payment to cost ratio,Subprovider 1,With Outliers:  Total Visits,Outlier payments,Other Special Care Unit,New Cap Related Csts Movable Equipment,Blood Clotting Factors for Hemoph.,OSP,Radioisotope,Laboratory,Burn Intensive Care Unit,Other Ancillary,Impl. Dev. Charged to Patients,Building Improvements,Related Salaries,Adj for Speech therapy in excess of lim,Home Program Dialysis,Electroencephalography,Renal Dialysis,Home Program Dialysis,MRI,Electroencephalography,Total Inpatient Program Days,Cardiac Catheterization,Other General Service,Anesthesiology,ASC (Non Distinct Part),Radioisotope,Intravenous Therapy,Ambulance Services,Other Organ Acquisition,Title XIX discharges,Maintenance and Repairs,"Number of patients on transplant 
list",Nursing Administration,Radiology-Therapeutic,Other Ancillary,Pancreas Acquisition,Burn Intensive Care Unit,Social Service,Intravenous Therapy,Payments received from patients for amounts previously written off as charity care,Total unreimbursed cost for Medicaid and CHIP and state and local indigent care programs,HHA,Radiology-Diagnostic,ASC (Non Distinct Part),RHC,FQHC,Clinic,Intensive Care Unit,OOT,Ambulance Services,Durable Medical Equipment Sold,TOTAL,Housekeeping,Intestinal Acquisition,Pharmacy,Total,Respiratory Therapy,Observation Beds (Distinct Unit),Radiology-Diagnostic,Other Special Care Unit,Intravenous Therapy,MDH status beginning date (MM/DD/YY),ASC (Non Distinct Part),Nursing School,Total,Intestinal Acquisition,Total Hospital,Subprovider II,PBP Clinical Lab Services Program Only,Whole Blood & Packed Red Blood Cells,LUPA Episodes:  Total Visits,Social Service,Burn Intensive Care Unit,PBP Clinical Lab Services Program Only,SNF,FQHC 12 Provider Number,Speech Pathology,Cafeteria,Central Services and Supply,Nursery,SNF,Total Program Inpatient Costs,Respiratory Therapy,Net Salaries,New Cap Related Csts Bldg & Fixtures,Surgical Intensive Care Unit Program Cost,Total Fixed Assets,RHC,Total Subprovider II Interns & Residents,Subtotal,"Blood Storing, Processing, Trans",Emergency,Other Reimbursable,Other Outpatient Services,Electrocardiology,Heart Acquisition,Subprovider II,SNF,Radiology-Therapeutic,Provider-based physician adjustment,Burn Intensive Care Unit,Home Office Personnel,Adults & Pediatrics,Physical Therapy,Liver Acquisition,Medicaid HMO Days,Total Hospital,Maintenance of Personnel,Prepaid expenses,Delivery Room and Labor Room,LUPA:  Total Non Routine Med Sup Chgs,Received DSH or supplemental payments from Medicaid? (Y/N),Program Ancillary Services,Clinic,Electrocardiology,Radiology-Diagnostic,FQHC,Dietary under contract,Contract Labor,Renal Dialysis,Other Organ Acquisition,Interns & Res Other Program Costs,PEP Episodes:  Other Charges,Occupational Therapy,Clinic,Renal Dialysis,Intravenous Therapy,Cardiac Catheterization,Interns & Res Other Program Costs,ASC (Non Distinct Part),Non-Physician Part B,"Is this a teaching hospital or
affiliated with a teaching hospital? (Y/N)",Laboratory,Medical Supplies Charged to Patients,Burn Intensive Care Unit Program Cost,Interim payments,ICF,Durable Medical Equipment Rented,Speech Pathology,OSP,Radioisotope,IPF,net of Swing Bed and Private Room Diff,Total Visits,Pancreas Acquisition,Cardiac Catheterization,Renal Dialysis,Other Reimbursable,MRI,MDH status ending date (MM/DD/YY),Occupational Therapy,Durable Medical Equipment Sold,Clinic,Subprovider-IPF,Paramedical Education,Medical Supplies Charged to Patients,Operating Room,Home Program Dialysis,Are provider based physicians' costs included in Worksheet A? (Y/N),OOT,ASC (Non Distinct Part),Clinic,Subprovider 2,Physical Therapy,Other Reimbursable,Operating Room,PEP:  Total Non Routine Med Supply Chgs,Emergency,Employee Benefits,Other Organ Acquisition,Physical Therapy,Nursing School,Clinic,Clinic,ASC (Non Distinct Part),Other Reimbursable,Total Outpatient Program Pass Thru Cost,PEP Episodes:  Total Number of Episodes,Target Amount,Pass through Cost for Program Inpatient,Non-Physician Anesthetist Part A,Delivery Room and Labor Room,Other Ancillary,Intensive Care Unit,Radiology-Diagnostic,TOTAL,Other Ancillary,Out of State Medicaid paid days,Observation Beds (Distinct Unit),ASC (Non Distinct Part),Renal Dialysis,Hospice 2 Provider Number,Electroencephalography,Medical Supplies Charged to Patients,Total,Occupational Therapy,Radiology-Diagnostic,Radiology-Diagnostic,Total Salaries,Management and Administrative Services,Mortgage Payable,Other General Service,Cardiac Catheterization,CT Scan,Contract Labor,OLTC,Total Salaries,Physical Therapy,Medical Supplies Charged to Patients,Respiratory Therapy,OOT,HHA,Total Fund Balances,Number of periods hospital was in MDH status,Contract Labor:  Physician Part A,Blood Clotting Factors for Hemoph.,Surgical Intensive Care Unit,Nonpaid Workers,Occupational Therapy,OPPS payments,Teaching Physician Salaries,Renal Dialysis,Occupational Therapy,Leasehold Improvements,CT Scan,Other Nonreimbursable,Islet Acquisition,FQHC,Surgical Intensive Care Unit,Medical Supplies Charged to Patients,MRI,Clinic,Stand-alone CHIP Charges (Gross Revenue),Clinic,Speech Pathology,CAPD exchanges per day,Total,Vending Machines,Nonphysician Anesthetists,Emergency,Laboratory,Intestinal Acquisition,Radiology-Therapeutic,Other Outpatient Services,Lung  Acquisition,Drugs Charged to Patients,"Blood Storing, Processing, Trans",Impl. Dev. Charged to Patients,Respiratory Therapy,OPT,Operation of Plant,Radiology-Diagnostic,Emergency,Pharmacy,Land Improvements,Radioisotope,Adults & Pediatrics,Rental of quarters to employee and oths,Delivery Room and Labor Room,Observation Beds (Distinct Unit),Emergency,Physician Part A Teaching,Dietary,Excluded Area Salaries,Electrocardiology,Total,Other General Service,Other Special Care Unit,ASC (Non Distinct Part),ASC (Non Distinct Part),Drugs Charged to Patients,CT Scan,Government grants or appropriations or transfers for support of hospital operations,In State Medicaid paid days,Contract Labor:  Physician Part A,Other Ancillary,Blood Clotting Factors for Hemoph.,Other Special Care,Medical Supplies Charged to Patients,Medicaid Observation Days,Physicians' Private Office,Total,Other Special Care Unit,"Gift, Flower, Coffee Shop, Canteen",Other Ancillary,Other Organ Acquisition,Anesthesiology,Laboratory,SNF,MRI,Electroencephalography,Component rate ESRD,Investment Income-Other,Other Outpatient Services,Cardiac Catheterization,Clinic,Other Outpatient Services,Electroencephalography,Intensive Care Unit,Wage Related Costs RHC/FQHC,SNF,Laboratory,Net Income from Service to Patients,Subprovider-IRF,RHC 6 Provider Number,Outpatient Revenue,Total Liabilities and Fund Balances,Dietary under Contract,Physical Therapy,Renal 3 Provider Number,Organ acquisition charges,Durable Medical Equipment Sold,Coronary Care Unit,Total,Subprovider-IPF,Intravenous Therapy,Stand-alone CHIP cost,Contract Labor:  Physician Part A,CT Scan,Central Services and Supply,Operation of Plant,Durable Medical Equipment Rented,Speech Pathology,Drugs Charged to Patients,Employee Benefits,Emergency,Dietary under Contract,Lung  Acquisition,Delivery Room and Labor Room,Electroencephalography,Laundry and Linen Service,Emergency,HHA,Nursery,Burn Intensive Care Unit,Medical Supplies Charged to Patients,FI/Contractor's Name,Nonpaid Workers,MRI,SNF,Coronary Care Unit,Employee Benefits,"Blood Storing, Processing, Trans",CMHC,Home Program Dialysis,PEP:  Total Non Routine Med Supply Chgs,Research,Recovery Room,Whole Blood & Packed Red Blood Cells,Electroencephalography,Operating Room,Recovery Room,Renal Dialysis,CAPD exchanges per day,IRF,Speech Pathology,Durable Medical Equipment Rented,Drugs Charged to Patients,Medical Supplies Charged to Patients,Speech Pathology,CT Scan,Other Ancillary,Intravenous Therapy,Laboratory,Emergency,Operating Room,Blood Clotting Factors for Hemoph.,Medical Supplies Charged to Patients,Surgical Intensive Care Unit,Adults and Pediatrics,Total Other Medical Education Cost,Total,Home Office Salaries,Utilization Review-physicians compens,Total,Subtotal Other Wages and Related Csts,Adults & Pediatrics,Radioisotope,Cost of charity care (uninsured patients + patients w/ coverage not accepted by provider),SSA State Code,FQHC 9 Provider Number,Intravenous Therapy,Other Outpatient Services,ASC (Distinct Part),NF,Durable Medical Equipment Rented,CT Scan,Durable Medical Equipment Sold,Other Reimbursable,Radioisotope,Interns & Residents,SNF,Hospital Adults & Pediatrics,RHC/FQHC Combined,Emergency,Other Outpatient Services,Emergency,SNF,Renal Dialysis,RHC/FQHC Combined,Durable Medical Equipment Rented,Electrocardiology,Related  Salaries,Total Hospital,Hospital Adlts & Ped Swing Bed NF,Tentative settlement,Coronary Care Unit,RHC 19 Provider Number,ASC (Distinct Part),Renal 1 Provider Number,Cardiac Catheterization,Total,Movable Equipment,W/Out Outliers:  Number of Episodes,Amounts expected under 42 CFR,Total Allied Health,Radioisotope,Nursing Administration,Subtotal Wage Related Csts,Recovery Room,ASC (Non Distinct Part),Ambulance Services,Radiology-Therapeutic,New Cap Related Csts Movable Equipment,Laboratory,Radiology-Therapeutic,Other Ancillary,Total discharges,Burn Intensive Care Unit,ASC (Non Distinct Part),Liver Acquisition,Total Program General Inpatient Routine,IRF,Total Nonphysician Anesthetist Cost,Operating Room,SNF,RHC,Hospital Adlts & Ped Swing Bed SNF,Clinic,Radioisotope,Land,ASC (Non Distinct Part),Emergency,Electroencephalography,Total Bad Debt expense,Subprovider-IRF,Radiology-Therapeutic,Occupational Therapy,Title V discharges,Fiscal Year End Date,Observation Beds (Distinct Unit),Hospital Zip Code,Clinic,ICF,Recovery Room,Intensive Care Unit,Employee Benefits,CMHC,Medicare Certified Liver TC term date,Clinic,Health Information Technology Designated Assets,Charity care charges and uninsured discounts for the entire facility,Operation of Plant,Int & Res (non approved teaching program,"Blood Storing, Processing, Trans",Physician-Part A,FQHC,Electrocardiology,Drugs Charged to Patients,Home Office Salaries,Surgical Intensive Care Unit,"Average patient dialysis time 
including setup",Fixed Equipment,Contract Labor,OPT,Other Organ Acquisition,ASC (Distinct Part),Subtotal Other Wages and Related Csts,Impl. Dev. Charged to Patients,Other Ancillary,Cafeteria,Drugs Charged to Patients,MRI,Drugs Charged to Patients,Organ acquisition,Delivery Room and Labor Room,CT Scan,Emergency,"Salaries, Wages, and Fees Payable",Anesthesiology,Total discharges,Home Office Salaries,Burn Intensive Care Unit,Relief Payment,Intensive Care Unit,Deferred Income,Subprovider-IPF,Operating Room,"If this facility qualifies as a RPCH/CAH, has it elected the all inclusive payment for outpatient service? (Y/N)",Surgical Intensive Care Unit,ASC (Non Distinct Part),Respiratory Therapy,With Outliers:  Number of Episodes,Contract Labor: Pysician Part A,"Blood Storing, Processing, Trans",Clinic,Report Record Number,Laundry and Linen Service,Other Reimbursable,Adults and Pediatrics,"If this Hospital is claiming cost for renal services on Worksheet A, are they inpatient services only? (Y/N)",OOT,Hospital State,Wage Related Costs Other,Total Overhead Costs,Total,Other Adjustments (Summed),Renal Dialysis,Radiology-Therapeutic,Drugs Charged to Patients,RHC,Physical Therapy,Hospital Adults & Pediatrics,Medical Supplies Charged to Patients,Renal Dialysis,IPF,Occupational Therapy,Maintenance and Repairs,Total Hospital,Drugs Charged to Patients,Total,Home Program Dialysis,Other Outpatient Services,RHC,Subtotal,Durable Medical Equipment Rented,Coronary Care Unit,Physical Therapy,ASC (Non Distinct Part),Number of stations,Total Nonphysician Anesthetist Cost,NF,Hospital Title 18 Payment System (P/T/O),Delivery Room and Labor Room,Delivery Room and Labor Room,Respiratory Therapy,Speech Pathology,FQHC,CMHC,Interns & Residents,Anesthesiology,RPCH/CAH Visits,Subprovider I,Medical Supplies Charged to Patients,CORF,Observation Beds (Distinct Unit),Intravenous Therapy,Electrocardiology,Physician Part B,Unsecured Loans,PBP Clinical Lab Services Program Only,Deductibles and coinsurance related to line 24,Electroencephalography,Total Program General Inpatient Routine,PEP Episodes:  Total Visits,Durable Medical Equipment Sold,Laboratory,Other General Service,CT Scan,Laboratory,Intravenous Therapy,"Blood Storing, Processing, Trans",Durable Medical Equipment Rented,Beginning Date of SCH status,ASC (Non Distinct Part),New Capital Equipment,Notes Payable,Radioisotope,Medical Supplies Charged to Patients,Urban (1) or Rural (2),ASC (Non Distinct Part),Physical Therapy,Hospital Street Address,Occupational Therapy,Nursing Administration,IRF Provider Number,Blood Clotting Factors for Hemoph.,Non-Physician Anesthetist Part A,Liver Acquisition,Radiology-Diagnostic,Durable Medical Equipment Rented,Durable Medical Equipment Sold,Whole Blood & Packed Red Blood Cells,Intravenous Therapy,ASC (Non Distinct Part),With Outliers:  Total Charges,Renal Dialysis,Anesthesiology,Partial or full credits from manufacturers,Outpatient Rehab Provider,Drugs Charged to Patients,Electrocardiology,MSP-LCC reconciliation amount,MRI,Total Nursing School,Laundry and Linen Service,Surgical Intensive Care Unit,Laboratory,With Outliers:  Total Visits,Whole Blood & Packed Red Blood Cells,Islet Acquisition,Durable Medical Equipment Sold,Depreciation-New Bldgs & Fixtures,Total Hospital Interns & Residents,Respiratory Therapy,Durable Medical Equipment Rented,HHA,Pancreas Acquisition,Hospital Adults & Ped Swing Bed SNF,Other Reimbursable,Radiology-Diagnostic,Operating Room,Without Outliers:  Non Routine Med Sup Chgs,Total discharges,Title XVIII discharges,OLTC,Cardiac Catheterization,Surgical Intensive Care Unit,SNF,Operating Room,"Blood Storing, Processing, Trans",Interns & Residents,Medical Supplies Charged to Patients,Allowable bad debts,Without Outliers:  Other Charges,FQHC 10 Provider Number,Laboratory,Anesthesiology,HHA 1 Provider Number,With Outliers:  Total Visits,Hospital Adults & Pediatrics,Housekeeping,"Is this a New Hospital under
42 CFR 412.300 PPS capital
(Y/N)",Admin & Gen Under Contract,Impl. Dev. Charged to Patients,Emergency,Durable Medical Equipment Sold,Ambulance Services,RHC 14 Provider Number,Target Amount per Discharge,Whole Blood & Packed Red Blood Cells,"If an Organ Procurement Organization, enter the OPO number",Hospice,Other Ancillary,Home Program Dialysis,Other Special Care,Intravenous Therapy,LUPA Episodes:  Total Number of Episodes,Total,Intensive Care Unit,Admin & Gen Under Contract,Total Outpatient Program Pass Thru Cost,Fiscal Intermediary Number,Buildings and Fixtures,Is this a rural hospital qualifying for an exception to the certified registered nurse anesthetist the CRNA fee schedule? (Y/N),Other Outpatient Services,Other Ancillary,Surgical Intensive Care Unit,CMHC,Total Charges,Heart Acquisition,Burn Intensive Care Unit,Coronary Care Unit,Radiology-Diagnostic,Medical Records & Med Records Library,Drugs Charged to Patients,Electroencephalography,Land Improvements,Physical Therapy,Radiology-Diagnostic,Radiology-Therapeutic,Delivery Room and Labor Room,Operating Room,Cardiac Catheterization,Other Ancillary,Impl. Dev. Charged to Patients,Total,Delivery Room and Labor Room,Operating Room,Other Outpatient Services,Whole Blood & Packed Red Blood Cells,Medical Supplies Charged to Patients,CT Scan,CMS Region Code,ASC (Distinct Part),Subprovider-IRF,Intensive Care Unit,Organ Procurement,Liver Acquisition,Movable Equipment,Medical Records and Medical Rec. Library,Speech Pathology,OLTC,Speech Pathology,Radiology-Therapeutic,Renal Dialysis,Related Salaries,Clinic,Intravenous Therapy,Recovery Room,Total Allied Health,Electroencephalography,Intravenous Therapy,"Blood Storing, Processing, Trans",Non-physician Anesthetist,Subprovider I,Total Long-term Liabilities,Ambulance Services,Program Discharges,Operation of Plant,Operating Room,Emergency,Ambulance Services,Radiology-Therapeutic,Heart Acquisition,Speech Pathology,Physicians' Private Office,Subprovider-IRF,"Blood Storing, Processing, Trans",Cardiac Catheterization,RHC 5 Provider Number,Total Hospital,SNF,Number of stations,Organ Procurement,Medicare reimbursable bad debts for the entire hospital complex,Delivery Room and Labor Room,Whole Blood & Packed Red Blood Cells,Whole Blood & Packed Red Blood Cells,Occupational Therapy,Laboratory,RHC 15 Provider Number,CT Scan,Adults & Pediatrics,Electrocardiology,Radioisotope,RHC 4 Provider Number,Pancreas Acquisition,Recovery Room,Excluded Area Salaries,Total Hospital,MRI,Interns & Residents,certification date,Total Other Charges,"Average patient dialysis time 
including setup",Radiology-Therapeutic,Dietary,Medical Supplies Charged to Patients,Emergency,Total Operating Expense,net of Swing Bed and Private Room Diff,Total Other Charges,Other Capital,Laboratory,Adj for Physical therapy costs in excess,Speech Pathology,Radioisotope,Subprovider-IRF,Renal Dialysis,Nonpaid Workers,TOTAL,Interest expense on Medicare Overpaymts,Excluded Area Salaries,Operating Room,MRI,MRI,Hospice,Cost of patients approved for charity care and uninsured discounts,Laboratory,"Number of days in year dialysis 
furnished",ICF,Clinic,Recovery Room,Cardiac Catheterization,ASC (Non Distinct Part),Drugs Charged to Patients,Whole Blood & Packed Red Blood Cells,Cost of charity care,Whole Blood & Packed Red Blood Cells,Radiology-Diagnostic,HVBP payment adjustment amount,HHA,Land Improvements,Intensive Care Unit,Nursery,Other Organ Acquisition,Home Program Dialysis,Subtotal,Total discharges,Cardiac Catheterization,Excluded Area Salaries,Social Service,Medical Supplies Charged to Patients,Electroencephalography,Delivery Room and Labor Room,NF Provider Number,Radioisotope,Other Reimbursable,Net revenue from state/local govt indigent care (not Medicaid or CHIP),Anesthesiology,Physical Therapy,With Outliers:  Number of Episodes,Clinic,Total,Medical Records and Medical Rec. Library,net of Swing Bed and Private Room Diff,Medical Supplies Charged to Patients,Subprovider-IRF,Paramedical Education,Liver Acquisition,FQHC 5 Provider Number,Observation Beds (Distinct Unit),Net Income,Blood Clotting Factors for Hemoph.,Related Salaries,Other Ancillary,Subtotal Salaries,Other Ancillary,Radiology-Therapeutic,Maintenance and Repairs,Anesthesiology,MRI,Total cost,Emergency,With Outliers:  Number of Episodes,Clinic,Wage Related Costs Other,Subprovider-IPF,Laboratory,Delivery Room and Labor Room,Subprovider I,Renal Dialysis,Blood Clotting Factors for Hemoph.,Clinic,Physical Therapy,Other Reimbursable,Observation Beds (Distinct Unit),Nursing Administration,Electrocardiology,Without Outliers:  Total Charges,Total,OOT,CORF,RHC/FQHC Combined,Durable Medical Equipment Rented,Observation Beds (Distinct Unit),Physical Therapy,Occupational Therapy,ASC (Distinct Part),Organ Procurement,Whole Blood & Packed Red Blood Cells,New Cap Related Csts Bldg & Fixtures,Maintenance of Personnel,Coronary Care Unit,Program Inpatient Ancillary Service Cost,Radioisotope,Fiscal Year Begin Date,Management and Administrative Services,FQHC 1 Provider Number,Laundry and Linen Service,Payments received from patients for amounts previously written off as charity care,Electrocardiology,Recovery Room,Employee Benefits,Home Office Personnel,Renal Dialysis,NF,Other Current Liabilities,Clinic,SNF,Protested amounts,Non-Physician Anesthetist Part B,Have you established a new subprovider excluded unit under 42 CFR 413.40(f)(1)(I)?(Y/N),Radiology-Therapeutic,Speech Pathology,Electroencephalography,Administrative and General,Home Program Dialysis,With Outliers:  Total Charges,Observation Beds (Distinct Unit),Total,Speech Pathology,Administrative & General under contract,Subprovider-IRF,Radioisotope,Kidney Acquisition,Durable Medical Equipment Sold,CMHC,Other Ancillary,Impl. Dev. Charged to Patients,Drugs Charged to Patients,Other Outpatient Services,Impl. Dev. Charged to Patients,Other General Service,RHC,Lung  Acquisition,Other Reimbursable,Other Outpatient Services,Laundry and Linen Service,Beginning Date of SCH status,Cardiac Catheterization,Impl. Dev. Charged to Patients,Kidney Acquisition,Laboratory,With Outliers:  Non Routine Med Sup Chgs,CMHC 1 Provider Number,Speech Pathology,Teaching Physician Salaries,Recovery Room,Intravenous Therapy,Emergency,PEP Episodes:  Total Visits,Emergency,"Number of days in year dialysis 
furnished",ASC (Non Distinct Part),Central Services and Supply,Employee Benefits,Employee Benefits,Physician-Part B,Management and Administrative Services,Burn Intensive Care Unit,Other Special Purpose,Other Ancillary,Radioisotope,Recovery Room,Recovery Room,MRI,Home Program Dialysis,New Cap Related Csts Bldg & Fixtures,Subprovider I,"Sum of lines 3,4 divided by line 6",Occupational Therapy,Anesthesiology,Speech Pathology,Anesthesiology,NF,Nursery,Nursery,"Anesthetist, and Medical Education Costs",Physician-Part B,Drugs Charged to Patients,Nursery,Other General Service,Subprovider-IPF,ASC (Non Distinct Part),"Gift, Flower, Coffee Shop, Canteen",Home Office Name,Central Services and Supply,Radiology-Therapeutic,Interest Expense,CMHC,Administrative and General,CMHC,Purchase,Electroencephalography,"Number of patients in program at 
end of cost reporting period",Total,Impl. Dev. Charged to Patients,Cardiac Catheterization,Subprovider-IRF,Medical Supplies Charged to Patients,Physical Therapy,HHA,LUPA:  Total Non Routine Med Sup Chgs,RHC 9 Provider Number,Observation Beds (Distinct Unit),Cross Foot Adjustments,Movable Equipment,Cardiac Catheterization,Laboratory,Other Reimbursable,Occupational Therapy,Physical Therapy,Housekeeping under contract,MRI,Total Visits,Durable Medical Equipment Rented,Nonphysician Anesthetists,ICF Provider Number,Whole Blood & Packed Red Blood Cells,HHA,Maintenance of Personnel,Non-Physician Anesthetist Part A,Lung  Acquisition,MRI,Durable Medical Equipment Sold,Blood Clotting Factors for Hemoph.,"Anesthetist, and Medical Education Costs",Kidney Acquisition,Provider's actual MSA or CBSA,Subprovider II,Without Outliers:  Total Visits,Operation of Plant,Home Program Dialysis,"Blood Storing, Processing, Trans",Interns & Res Salary and Fringe Benefits,Anesthesiology,Burn Intensive Care Unit,Recovery Room,Recovery Room,Electrocardiology,Durable Medical Equipment Rented,PBP Clinical Lab Services Program Only,Adj for Respiratory therapy costs in excess,Hospital Type,Subtotal,Recovery Room,Home Office Salaries & Wage Related Csts,Total Current Assets,Subprovider-IRF,Utilization,Medical Supplies Charged to Patients,Occupational Therapy,Total Program General Inpatient Routine,Liver Acquisition,Whole Blood & Packed Red Blood Cells,Electroencephalography,Whole Blood & Packed Red Blood Cells,Subprovider I,Title XVIII discharges,Subprovider I,Electroencephalography,Total Charges:  LUPA Episodes,Other Organ Acquisition,Total Adults & Pediatrics,Renal Dialysis,Operating Room,Impl. Dev. Charged to Patients,Cardiac Catheterization,Total,CORF,Investment Income-New Movable Equip,CT Scan,Anesthesiology,CT Scan,Operating Cost and Target Amount,Subprovider-IRF,Blood Clotting Factors for Hemoph.,Intensive Care Unit,Subprovider-IPF,Blood Clotting Factors for Hemoph.,Nursery,Respiratory Therapy,New Cap Related Csts Movable Equipment,Total Other Income,Impl. Dev. Charged to Patients,Radiology-Therapeutic,Durable Medical Equipment Rented,Administrative and General,Respiratory Therapy,Subprovider-IPF,Laboratory,Renal Dialysis,Land,Recovery Room,CT Scan,Occupational Therapy,Buildings and Fixtures,Total Overhead Costs,Radiology-Therapeutic,Intensive Care Unit,Total,Electroencephalography,Total Facility FTEs,SNF,Outlier payments,Net Revenue from stand-alone SCHIP,Balance due provider/program,Radiology-Therapeutic,Physical Therapy,SNF,Without Outliers:  Total Visits,Operating Room,Operating Room,OPT,Other Reimbursable,Whole Blood & Packed Red Blood Cells,Medical Supplies Charged to Patients,Radiology-Diagnostic,Subtotal,Intensive Care Unit,Medical Supplies Charged to Patients,Renal Dialysis,Disp. And Retirement,Whole Blood & Packed Red Blood Cells,FQHC 6 Provider Number,Other Outpatient Services,Radiology-Therapeutic,Charity care charges and uninsured discounts for the entire facility,Research,"Sum of lines 3,4 divided by line 6",RHC,ICF,Delivery Room and Labor Room,Other Organ Acquisition,Drugs Charged to Patients,Observation Beds (Distinct Unit),Occupational Therapy,Total Other Assets,RHC 16 Provider Number,Maintenance of Personnel,Intravenous Therapy,Medical Records & Med Records Library,Delivery Room and Labor Room,Kidney Acquisition,Other Reimbursable,Excluded Areas,Heart Acquisition,Pharmacy,Other Outpatient Services,RHC 10 Provider Number,Intravenous Therapy,Land,Int & Res (non approved teaching program,RHC/FQHC Combined,Intravenous Therapy,Int & Res (non approved teaching program,Fixed Equipment,Electroencephalography,FQHC,HAC reduction adjustment amount,Other adjustments,Impl. Dev. Charged to Patients,Total Other Medical Education,Pharmacy,OPT,Delivery Room and Labor Room,Subtotal Salaries,Radiology-Therapeutic,Cost of charity care (patients covered by public program + patients w/ coverage accepted by provider),"Treatment capacity per day per
station",NF,Ambulance Trips,Radiology-Therapeutic,NF,Intravenous Therapy,Total,"Number of patients in program at 
end of cost reporting period",Title XVIII discharges,MRI,Maintenance of Personnel,Impl. Dev. Charged to Patients,Other Nonreimbursable,Other Nonreimbursable,Recovery Room,OLTC,Other Ancillary,Subtotal,Emergency,NF,Respiratory Therapy,Operating Room,Subprovider-IPF,Islet Acquisition,Radioisotope,Medical Records & Med Records Library,Durable Medical Equipment Rented,Allowable Inpatient Cost Plus Incentive Pt,Other Special Care Unit,Interns & Residents,Subprovider-IRF,IPF,Other General Service,Self Insurance,Radiology-Diagnostic,Other Nonreimbursable,Drugs Charged to Patients,Home Office Salaries & Wage Related Csts,NF,Drugs Charged to Patients,Total charges to state or local government programs for indigent care (not Medicaid or CHIP),Total Facility FTEs,Hospital PO Box,Operating Room,Intravenous Therapy,Physician Part B,Cost of patients approved for charity care and uninsured discounts,Surgical Intensive Care Unit,Number of Times per week Patient receives Dialysis,Total Liabilities,Radiology-Diagnostic,Electrocardiology,ESRD DME costs,PBP Clinical Lab Services Program Only,Anesthesiology,Total Non Routine Medical  Supply Charges,Hospital City,Total,Occupational Therapy,Coronary Care Unit,Surgical Intensive Care Unit,Respiratory Therapy,CT Scan,Subprovider-IPF,Parking Lot,Delivery Room and Labor Room,Hospice,Other Special Purpose,Total,Drugs Charged to Patients,Burn Intensive Care Unit,Electroencephalography,MRI,Pharmacy,ASC (Non Distinct Part),FQHC 3 Provider Number,Recovery Room,Renal 6 Provider Number,"Blood Storing, Processing, Trans",Clinic,Blood Clotting Factors for Hemoph.,Research,Other Reimbursable,Medicare Certified Islet TC term date,Other Special Purpose,CT Scan,Delivery Room and Labor Room,interns and residents,OPT,Other Ancillary,Total Hospital,Radiology-Therapeutic,Ambulance Services,Swing Bed SNF Provider Number,Less: Allowances for uncollectible notes and accounts receivable,Other Special Care Unit,Hospice,Burn Intensive Care Unit,"Blood Storing, Processing, Trans",FQHC 4 Provider Number,Sale of drugs to other than patients,Nursery,Radioisotope,Organ Procurement,Medical Supplies Charged to Patients,Other Outpatient Services,MRI,Other Outpatient Services,Research,IPF Provider Number,CT Scan,Operating Room,Notes Receivable,Housekeeping,Clinic,RHC,Total Subprovider I Interns & Residents,ICF,Occupational Therapy,Average times dialyzers re-used,Subtotal,Interns & Residents,Operating Room,Temporary Investments,Impl. Dev. Charged to Patients,Total,Cardiac Catheterization,Radioisotope,Intensive Care Unit,MRI,Other Reimbursable,SNF,Other Reimbursable,NF,Intravenous Therapy,Interns & Res Salary and Fringe Benefits,Clinic,RHC 20 Provider Number,Other Reimbursable,Operating Room,Coronary Intensive Care Unit,CT Scan,Clinic,OLTC,FQHC 11 Provider Number,IRF,Radiology-Therapeutic,Burn Intensive Care Unit,Cardiac Catheterization,ASC (Distinct Part),Cardiac Catheterization,NF,Drugs Charged to Patients,Radiology-Therapeutic,ICF,Intensive Care Unit,Hospice,Int & Res (non approved teaching program,Other Ancillary,Number of stations,Medicare Certified Kidney TC term date,Other Outpatient Services,Ending Date of SCH status,SNF,Cardiac Catheterization,FQHC 7 Provider Number,Durable Medical Equipment Rented,New Capital Equipment,OOT,Heart Acquisition,SNF,Subprovider-IRF,Operating Room,Total Swing Bed Cost,Building Improvements,"Blood Storing, Processing, Trans",Other Reimbursable,Total,Total Non Routine Medical  Supply Charges,Impl. Dev. Charged to Patients,Cost of patients approved for charity care and uninsured discounts,Land Improvements,Speech Pathology,Operating Room,Delivery Room and Labor Room,Home Office:  Physician Part A,MRI,Total Allied Health,RHC 7 Provider Number,"Blood Storing, Processing, Trans",Emergency,RHC 11 Provider Number,Housekeeping,Durable Medical Equipment Rented,net of Swing Bed Cost,Other Special Purpose,Ending Balance,Electrocardiology,Operating Room,Bonus Payment,"Net costs of Epoietin furnished to
all maintenance dialysis patients
by the provider",Surgical Intensive Care Unit,Speech Pathology,Blood Clotting Factors for Hemoph.,Renal Dialysis,Administrative and General under Contract,Other Special Care Unit,NF,Intravenous Therapy,Other Special Care Unit,Physical Therapy,Without Outliers:  Total Charges,Kidney Acquisition,RHC,Nursery,Renal Dialysis,ASC (Non Distinct Part),Other Current Assets,Medicaid charges,Renal 5 Provider Number,Radioisotope,Intravenous Therapy,Number of stations,Without Outliers:  Total Charges,Other Outpatient Services,"Gift, Flower, Coffee Shop, Canteen",Home Program Dialysis,Anesthesiology,net of Swing Bed and Private Room Diff,Outpatient Rehab Provider,Other Nonreimbursable,Electrocardiology,ASC (Non Distinct Part),Physical Therapy,New Capital Buildings and Fixtures,CT Scan,Excluded Area Salaries,Electroencephalography,Physical Therapy,Total,Intensive Care Unit,Physical Therapy,Home Program Dialysis,Other Ancillary,Other Outpatient Services,Recovery Room,Drugs Charged to Patients,Operating Room,Impl. Dev. Charged to Patients,Speech Pathology,Interns & Residents,Physical Therapy,Impl. Dev. Charged to Patients,Occupational Therapy,Total Adults & Peds,OSP,Respiratory Therapy,Int & Res (non approved teaching program,RHC 21 Provider Number,Whole Blood & Packed Red Blood Cells,Cardiac Catheterization,Title XVIII discharges,RHC 13 Provider Number,"Blood Storing, Processing, Trans",CT Scan,Renal 8 Provider Number,Research,Other Special Care Unit,Burn Intensive Care Unit,Total Nursing School,Title V discharges,Title XIX discharges,OPT,Coronary Care Unit,FQHC,Clinic,Other Ancillary,Adults and Pediatrics,Total reasonable charges,New Cap Related Csts Movable Equipment,Title XVIII discharges,Cardiac Catheterization,MCP Physician Payment Method (Y/N),OSP,Hospice,RHC 12 Provider Number,Islet Acquisition,Impl. Dev. Charged to Patients,"Medical certified liver 
transplant center cert date",Title XIX discharges,Without Outliers:  Other Charges,Nonpaid Workers,Recovery Room,Total,Other Long-term Liabilities,Home Program Dialysis,FQHC,Total Hospital,Radiology-Therapeutic,Burn Intensive Care Unit,Drugs Charged to Patients,"Blood Storing, Processing, Trans",Coronary Care Unit,Radiology-Therapeutic,Durable Medical Equipment Sold,Liver Acquisition,Surgical Intensive Care Unit,Speech Pathology,Drugs Charged to Patients,Blood Clotting Factors for Hemoph.,Fixed Equipment,Burn Intensive Care Unit,Notes and Loans Payable (short term),Whole Blood & Packed Red Blood Cells,NOT IN THIS FILE,Operation of Plant,Cardiac Catheterization,Radioisotope,Total Current Liabilities,"Blood Storing, Processing, Trans",Coronary Care Unit,ASC (Non Distinct Part),Other Outpatient Services,Medicare Certified Pancreas TC term date,Excluded Areas,Payments received from patients for amounts previously written off as charity care,Interns & Residents,"Blood Storing, Processing, Trans",Total Program Inpatient Costs,Hospital Name,Cafeteria,Operating Room,Intravenous Therapy,PEP Episodes:  Total Charges:,Nonphysician Anesthetists,Non-Physician Anesthetist Part B,MRI,Radiology-Diagnostic,PEP Episodes:  Other Charges,Coronary Care Unit,Radiology-Diagnostic,Medical Supplies Charged to Patients,Adults and Pediatrics,Emergency,Observation Beds (Distinct Unit),Other Medicaid Days,Renal 7 Provider Number,Electrocardiology,Total Number of Episodes,Blood Clotting Factors for Hemoph.,Home Program Dialysis,Intensive Care Unit,Occupational Therapy,Nursery,Medical Records and Medical Rec. Library,Total,Medical Supplies Charged to Patients,Other Special Care,Burn Intensive Care Unit,Administrative and General,or allied health costs?,CAH Visits,Labor and Delivery Days Title 18,Renal Dialysis,Hospital Adlts & Ped Swing Bed NF,ASC (Distinct Part),Inpatient Revenue,Physicians' Private Office,Laboratory,Intensive Care Unit,Other Ancillary,Cafeteria,MRI,Radiology-Diagnostic,Delivery Room and Labor Room,Anesthesiology,Observation Beds (Distinct Unit),Coronary Care Unit,Subprovider II,Net Patient Revenue,Interns & Residents,Buildings and Fixtures,Surgical Intensive Care Unit,HHA,Intravenous Therapy,OSP,Initial Physician Payment Method (Y/N),Recovery Room,Pass through Cost for Program Inpatient Routine,Recovery Room,Clinic,Hospice,Laboratory,Respiratory Therapy,Respiratory Therapy,Home Program Dialysis,Total Non Routine Medical  Supply Charges,Nonpaid Workers,Other Special Purpose,Whole Blood & Packed Red Blood Cells,Social Service,MRI,Whole Blood & Packed Red Blood Cells,"Anesthetist, and Medical Education Costs","Blood Storing, Processing, Trans",Speech Pathology,Subtotal Wage Related Csts,Accounts Payable,Subprovider I,Liver Acquisition,Cardiac Catheterization,OLTC,Hospice,"Number of patients transplanted 
during fiscal year",Begin Balance,Operating Room,Non-Physician Anesthetist Part B,Impl. Dev. Charged to Patients,Pancreas Acquisition,HHA,Total,Interns & Residents,Whole Blood & Packed Red Blood Cells,Durable Medical Equipment Sold,"Average patient dialysis time 
including setup",Other Outpatient Services,Operating Room,Cross Foot Adjustments,Liver Acquisition,PEP Episodes:  Total Visits,Occupational Therapy,New Cap Related Csts Bldg & Fixtures,Interns & Residents,Other Ancillary,Total prospective payment,Physician Part B,Coronary Care Unit Program Cost,Durable Medical Equipment Rented,Total customary charges,Observation Beds (Distinct Unit),Renal 2 Provider Number,Administrative & General under contract,"Gift, Flower, Coffee Shop, Canteen","Medicare certified heart
transplant center cert date",Major Movable Equipment,CT Scan,Blood Clotting Factors for Hemoph.,MRI,Observation Beds (Distinct Unit),Paid Losses,Subtotal Other Wages and Related Csts,Fixed Equipment,Total,Nursing School,Speech Pathology,Laboratory,Other Outpatient Services,Speech Pathology,Labor and Delivery,Maintenance and Repairs,Drugs Charged to Patients,Electrocardiology,PEP Episodes:  Total Number of Episodes,Total discharges,Drugs Charged to Patients,Deductibles and coinsurance,Speech Pathology,Respiratory Therapy,CT Scan,Total Salaries,Subprovider-IPF,Coronary Care Unit,PEP:  Total Number of Outlier Episodes,Dietary under contract,Recovery Room,Primary payer payments,Radiology-Therapeutic,Drugs Charged to Patients,Interns and residents,Physical Therapy,Physician Part A,Total,Durable Medical Equipment Sold,OSP,Housekeeping,Radioisotope,Subprovider II,Nursing School,Emergency,Impl. Dev. Charged to Patients,Fiscal Intermediary/MAC Create Date,Adj for Occupational therapy in excess of li,ASC (Non Distinct Part),Electrocardiology,Electroencephalography,Renal Dialysis,HHA 2 Provider Number,Utilization,Impl. Dev. Charged to Patients,Heart Acquisition,Interns & Residents,Emergency,SNF,Dietary,Subprovider II,Electroencephalography,RHC,Central Services and Supply,Durable Medical Equipment Rented,Zip Code,Interns & Residents,Emergency,Blood Clotting Factors for Hemoph.,Impl. Dev. Charged to Patients,Drugs Charged to Patients,Other Reimbursable,Net Salaries,Subprovider-IPF,Donations,Coronary Care Unit,Housekeeping under Contract,Durable Medical Equipment Sold,Impl. Dev. Charged to Patients,Electrocardiology,Interest Expense,RHC 25 Provider Number,Recovery Room,Respiratory Therapy,Whole Blood & Packed Red Blood Cells,Average times dialyzers re-used,ICF,Home Program Dialysis,Radiology-Diagnostic,Physical Therapy,Renal Dialysis,Total Allied Health Cost,Islet Acquisition,Renal Dialysis,Int & Res (non approved teaching program,Other Outpatient Services,ASC (Distinct Part),Durable Medical Equipment Rented,Emergency,Non-Physician Part B,Paramedical Education,Outpatient Rehab Provider,"Medicare certified kidney 
transplant center cert date",Other Special Care Unit,Subprovider-IRF,Total discharges,Ambulance Services,Observation Beds (Distinct Unit),ASC (Non Distinct Part),Other Special Purpose,Other Reimbursable,HHA,Electroencephalography,Coronary Care Unit,Radiology-Diagnostic,Cafeteria,Teaching Physician Salaries,Electrocardiology,"Number of Times per week
 Patient receives Dialysis",Wage Related Costs RHC/FQHC,New Cap Related Csts Movable Equipment,Net Salaries,OPT,Physical Therapy,Nonpaid Workers,Adults and Pediatrics,Interns & Res Salary and Fringe Benefits,CT Scan,Anesthesiology,"Number of days in year dialysis 
furnished",Census Division Code,Respiratory Therapy,Cardiac Catheterization,Durable Medical Equipment Sold,Nursing Administration,Medical Supplies Charged to Patients,Other Ancillary,IPF Provider Number,CORF,Impl. Dev. Charged to Patients,Renal Dialysis,ICF,Surgical Intensive Care Unit,Emergency,Pass Through Cost for  Program Ancillary,LUPA Episodes:  Total Number of Episodes,Radiology-Diagnostic,OSP,Negative Cost Centers,Medical and Other Services reimbursed by OPPS,Home Program Dialysis,Intravenous Therapy,RHC,RHC/FQHC Combined,Transitional corridor payment,Intravenous Therapy,Laboratory,"Sale of scrap, waste, etc.","Blood Storing, Processing, Trans",Impl. Dev. Charged to Patients,Administrative and General,Administrative and General,Islet Acquisition,Subprovider 2,Title V discharges,Home Office Street,Physicians' Private Office,Radioisotope,Teaching Physician Salaries,Other Reimbursable,Observation Beds (Distinct Unit),Recovery Room,Delivery Room and Labor Room,Emergency,Durable Medical Equipment Sold,Program Inpatient Ancillary Service Cost,Total Number of Outlier Episodes,Radiology-Therapeutic,Renal Dialysis,Radiology-Diagnostic,Intravenous Therapy,Other Special Purpose,Physicians' Private Office,Subprovider 2,"Number of Times per week
 Patient receives Dialysis",Total Hospital Interns & Residents,Nursery,Intravenous Therapy,Research,Does the hospital elect a fully prospective payment method for capital costs? (Y/N),Other Outpatient Services,Subprovider II,ASC (Non Distinct Part),Organ Procurement,Recovery Room,Hospice,Anesthesiology,Occupational Therapy,Surgical Intensive Care Unit,Subprovider 2,Social Service,Non-Physician Anesthetist Part A,Net Salaries,Nursing School,Electrocardiology,Total Number of Episodes,Paramedical Education,RHC,NF,Maintenance of Personnel,Intensive Care Unit,Radioisotope,Anesthesiology,"Are there any related organization or how office costs as defined in HCFA Pub. 15-I, chapter 10? (Y/N)",HHA,Home Program Dialysis,MRI,Electroencephalography,IPF,Subtotal,Other Outpatient Services,Respiratory Therapy,Adjusted reimburseable bad debts,FQHC,Anesthesiology,Physical Therapy,Pass Through Cost for  Program Ancillary,Delivery Room and Labor Room,Observation Beds (Distinct Unit),Impl. Dev. Charged to Patients,Hospital Adults & Pediatrics,Gross Revenue,Hospice,OLTC,Electroencephalography,Electrocardiology,Total,Impl. Dev. Charged to Patients,"Average patient dialysis time 
including setup",Cafeteria,Subprovider I,"Treatment capacity per day per
station",Impl. Dev. Charged to Patients,Home Office:  Physician Part A,Subtotal Other Wages and Related Csts,Other Ancillary,PEP:  Total Non Routine Med Supply Chgs,Occupational Therapy,Teaching Physician Salaries,Whole Blood & Packed Red Blood Cells,Operating Room,"Blood Storing, Processing, Trans","Number of patients in program at 
end of cost reporting period",Administrative and General,Other Nonreimbursable,Kidney Acquisition,Interns & Residents,Subprovider-IPF,Pancreas Acquisition,Physical Therapy,Subprovider-IRF,Speech Pathology,Anesthesiology,Radioisotope,Respiratory Therapy,Surgical Intensive Care Unit,Electrocardiology,Other Outpatient Services,Electroencephalography,PBP Clinical Lab Services Program Only,Radiology-Therapeutic,Other Nonreimbursable,CT Scan,Respiratory Therapy,ASC (Non Distinct Part),ASC (Non Distinct Part),Anesthesiology,CT Scan,Home Office Salaries & Wage Related Csts,Hospice 1 Provider Number,Recovery Room,IRF,Electrocardiology,Kidney Acquisition,Radiology-Diagnostic,ICF,Occupational Therapy,Other Reimbursable,Other Reimbursable,Anesthesiology,Buildings and Fixtures,Housekeeping,Land,Lung  Acquisition,Cardiac Catheterization,Hospital Adults & Pediatrics,Labor and Delivery Days -  Title XIX,Medical Supplies Charged to Patients,PBP Clinical Lab Services Program Only,Charity care charges and uninsured discounts for the entire facility,Hospice,Cafeteria,Laboratory,Labor and Delivery Days -  Title XIX,Operating Room,Occupational Therapy,Nursery,Other Special Care Unit,CMHC,"Number of patients in program at 
end of cost reporting period",Lung  Acquisition,Total Program General Inp. Rtn Service,SNF,Blood Clotting Factors for Hemoph.,Whole Blood & Packed Red Blood Cells,Excluded Area Salaries,Intravenous Therapy,"Does the facility qualify and is it receiving payments for 
disproportionate share? (Y/N)",W/Out Outliers:  Number of Episodes,Hospice,Hospice,Renal Dialysis,CMHC,Cardiac Catheterization,Emergency,Laboratory,Other Outpatient Services,Is this a New Hospital under 42 CFR 413.40(f)(1)(I) (TEFRA)? (Y/N),Intravenous Therapy,Emergency,Anesthesiology,Intravenous Therapy,Delivery Room and Labor Room,Intensive Care Unit,Program Inpatient Ancillary Service Cost,Ratio of line 15 to line 16,Impl. Dev. Charged to Patients,Coronary Care Unit,Housekeeping,"Blood Storing, Processing, Trans",Physician Part A Teaching,Observation Beds (Distinct Unit),Home Program Dialysis,Physical Therapy,Other Outpatient Services,CORF,Non-Physician Anesthetist Part A,Other Outpatient Services,Other Outpatient Services,Excluded Area Salaries,With Outliers:  Other Charges,Anesthesiology,Observation Beds (Distinct Unit),FQHC,Pancreas Acquisition,Subprovider-IPF,NF,Total Adults & Peds,Home Program Dialysis,PEP:  Total Number of Outlier Episodes,Subprovider-IRF,RHC 3 Provider Number,Other Special Care,OOT,Dietary,Dietary,Observation Beds (Distinct Unit),CORF,Delivery Room and Labor Room,RHC 24 Provider Number,OLTC,net of Swing Bed Cost,Durable Medical Equipment Rented,Clinic,Total unreimbursed and uncompensated care,Medicare allowable bad debts for the entire hospital complex,With Outliers:  Non Routine Med Sup Chgs,Radiology-Therapeutic,Drugs Charged to Patients,Laundry and Linen Service,Impl. Dev. Charged to Patients,Total,ASC (Non Distinct Part),Other Outpatient Services,"Percentage of patients re-using
dialyzers",Anesthesiology,Excess of customary charges,Respiratory Therapy,Occupational Therapy,Radioisotope,Clinic,Clinic,Intensive Care Unit,Operating Room,Home Program Dialysis,Total Charges:  LUPA Episodes,Emergency,FQHC,HHA,Cardiac Catheterization,IRF,Private grants or donations or endowment income restricted to funding charity care,"Blood Storing, Processing, Trans",Cash on Hand and in Banks,Total Income,Delivery Room and Labor Room,ASC (Distinct Part),Radioisotope,Radioisotope,Surgical Intensive Care Unit,Drugs Charged to Patients,Beginning FFY,Hospital Type (From CMS Hospitals Data Archive),Name and Num
,Curated Name and Num,Hospital type (modified),,Lon,Lat,INPATIENT ANCILLARY SERVICE COST APPORTIONMENT,INPATIENT ANCILLARY SERVICE COST APPORTIONMENT,TRIAL BALANCE OF EXPENSE ACCOUNTS,APPORTIONMENT OF MEDICAL AND OTHER HEALTH SERVICES,TRIAL BALANCE OF EXPENSE ACCOUNTS,COST ALLOCATION,HOSPITAL WAGE INDEX DATA,APPORTIONMENT OF MEDICAL AND OTHER HEALTH SERVICES,HOSPITAL WAGE INDEX DATA,HOSPITAL WAGE INDEX DATA,COMPUTATION OF RATIO OF COST TO CHARGES,COST ALLOCATION,NUMBER OF BEDS,S-10 DATA,TRIAL BALANCE OF EXPENSE ACCOUNTS,COMPUTATION OF RATIO OF COST TO CHARGES,CALCULATION OF REIMBURSEMENT SETTLEMENT (PPS),APPORTIONMENT OF INPATIENT ROUTINE SERVICE CAPITAL COSTS,Total Inpatient Days/Outpatient Visits,COST ALLOCATION,APPORTIONMENT OF INPATIENT/OUTPATIENT ANCILLARY SERVICE OTHER PASS THROUGH COSTS,COST ALLOCATION,APPORTIONMENT OF INPATIENT/OUTPATIENT ANCILLARY SERVICE OTHER PASS THROUGH COSTS,S-10 DATA,COST ALLOCATION,APPORTIONMENT OF INPATIENT/OUTPATIENT ANCILLARY SERVICE OTHER PASS THROUGH COSTS,APPORTIONMENT OF MEDICAL AND OTHER HEALTH SERVICES,CALCULATION OF REIMBURSEMENT SETTLEMENT,COST ALLOCATION,COST ALLOCATION,TRIAL BALANCE OF EXPENSE ACCOUNTS,ANALYSIS OF CHANGES IN NEW CAPITAL BALANCES,TRIAL BALANCE OF EXPENSE ACCOUNTS,COMPUTATION OF RATIO OF COST TO CHARGES,COMPUTATION OF RATIO OF COST TO CHARGES,APPORTIONMENT OF INPATIENT/OUTPATIENT ANCILLARY SERVICE OTHER PASS THROUGH COSTS,COST ALLOCATION,,NUMBER OF BEDS,COST ALLOCATION,APPORTIONMENT OF MEDICAL AND OTHER HEALTH SERVICES,ADJUSTMENTS,COST ALLOCATION,APPORTIONMENT OF INPATIENT/OUTPATIENT ANCILLARY SERVICE OTHER PASS THROUGH COSTS,INPATIENT ANCILLARY SERVICE COST APPORTIONMENT,COST ALLOCATION,TRIAL BALANCE OF EXPENSE ACCOUNTS,HHA STATISTICAL DATA,,APPORTIONMENT OF INPATIENT/OUTPATIENT ANCILLARY SERVICE OTHER PASS THROUGH COSTS,INPATIENT ANCILLARY SERVICE COST APPORTIONMENT,INPATIENT ANCILLARY SERVICE COST APPORTIONMENT,ALLOCATION OF NEW CAPITAL COSTS,,HOSPITAL WAGE INDEX DATA,COST ALLOCATION,ALLOCATION OF NEW CAPITAL COSTS,RECONCILIATION OF CAPITAL COST CENTERS,COST ALLOCATION,ADJUSTMENTS,COST ALLOCATION,ALLOCATION OF NEW CAPITAL COSTS,COST ALLOCATION,NUMBER OF BEDS,APPORTIONMENT OF INPATIENT/OUTPATIENT ANCILLARY SERVICE OTHER PASS THROUGH COSTS,COST ALLOCATION,COMPUTATION OF RATIO OF COST TO CHARGES,APPORTIONMENT OF INPATIENT/OUTPATIENT ANCILLARY SERVICE OTHER PASS THROUGH COSTS,HOSPITAL WAGE INDEX DATA,APPORTIONMENT OF INPATIENT/OUTPATIENT ANCILLARY SERVICE OTHER PASS THROUGH COSTS,COMPUTATION OF RATIO OF COST TO CHARGES,TRIAL BALANCE OF EXPENSE ACCOUNTS,ALLOCATION OF NEW CAPITAL COSTS,COMPUTATION OF INPATIENT OPERATING COSTS,COST ALLOCATION,APPORTIONMENT OF INPATIENT/OUTPATIENT ANCILLARY SERVICE OTHER PASS THROUGH COSTS,COST ALLOCATION,APPORTIONMENT OF INPATIENT/OUTPATIENT ANCILLARY SERVICE OTHER PASS THROUGH COSTS,TRIAL BALANCE OF EXPENSE ACCOUNTS,HOSPITAL WAGE INDEX DATA,ANALYSIS OF CHANGES IN NEW CAPITAL BALANCES,,,S-10 DATA,APPORTIONMENT OF INPATIENT/OUTPATIENT ANCILLARY SERVICE OTHER PASS THROUGH COSTS,ALLOCATION OF NEW CAPITAL COSTS,TRIAL BALANCE OF EXPENSE ACCOUNTS,APPORTIONMENT OF INPATIENT ROUTINE SERVICE CAPITAL COSTS,,INPATIENT ANCILLARY SERVICE COST APPORTIONMENT,COMPUTATION OF RATIO OF COST TO CHARGES,COMPUTATION OF INPATIENT OPERATING COSTS,COMPUTATION OF RATIO OF COST TO CHARGES,APPORTIONMENT OF MEDICAL AND OTHER HEALTH SERVICES,COMPUTATION OF RATIO OF COST TO CHARGES,TRIAL BALANCE OF EXPENSE ACCOUNTS,,COMPUTATION OF RATIO OF COST TO CHARGES,COMPUTATION OF INPATIENT OPERATING COSTS,S-10 DATA,S-10 DATA,INPATIENT ANCILLARY SERVICE COST APPORTIONMENT,HOSPITAL WAGE INDEX DATA,ANALYSIS OF CHANGES IN NEW CAPITAL BALANCES,INPATIENT ANCILLARY SERVICE COST APPORTIONMENT,TRIAL BALANCE OF EXPENSE ACCOUNTS,TRIAL BALANCE OF EXPENSE ACCOUNTS,APPORTIONMENT OF INPATIENT/OUTPATIENT ANCILLARY SERVICE OTHER PASS THROUGH COSTS,INPATIENT ANCILLARY SERVICE COST APPORTIONMENT,APPORTIONMENT OF INPATIENT/OUTPATIENT ANCILLARY SERVICE OTHER PASS THROUGH COSTS,HOSPITAL WAGE INDEX DATA,Total Inpatient Days/Outpatient Visits,TRIAL BALANCE OF EXPENSE ACCOUNTS,COST ALLOCATION,APPORTIONMENT OF MEDICAL AND OTHER HEALTH SERVICES,INPATIENT ANCILLARY SERVICE COST APPORTIONMENT,APPORTIONMENT OF INPATIENT/OUTPATIENT ANCILLARY SERVICE OTHER PASS THROUGH COSTS,Total Inpatient Days/Outpatient Visits,COST ALLOCATION,COMPUTATION OF RATIO OF COST TO CHARGES,TRIAL BALANCE OF EXPENSE ACCOUNTS,APPORTIONMENT OF MEDICAL AND OTHER HEALTH SERVICES,ALLOCATION OF NEW CAPITAL COSTS,APPORTIONMENT OF INPATIENT/OUTPATIENT ANCILLARY SERVICE OTHER PASS THROUGH COSTS,APPORTIONMENT OF INPATIENT/OUTPATIENT ANCILLARY SERVICE OTHER PASS THROUGH COSTS,INPATIENT ANCILLARY SERVICE COST APPORTIONMENT,INPATIENT ANCILLARY SERVICE COST APPORTIONMENT,ANALYSIS OF CHANGES IN NEW CAPITAL BALANCES,HOSPITAL WAGE INDEX DATA,HHA STATISTICAL DATA,BED DAYS AVAILABLE,APPORTIONMENT OF INPATIENT/OUTPATIENT ANCILLARY SERVICE OTHER PASS THROUGH COSTS,HOSPITAL WAGE INDEX DATA,TRIAL BALANCE OF EXPENSE ACCOUNTS,HOSPITAL WAGE INDEX DATA,APPORTIONMENT OF INPATIENT/OUTPATIENT ANCILLARY SERVICE OTHER PASS THROUGH COSTS,COMPUTATION OF INPATIENT OPERATING COSTS,,ALLOCATION OF NEW CAPITAL COSTS,HHA STATISTICAL DATA,COST ALLOCATION,COST ALLOCATION,COMPUTATION OF INPATIENT OPERATING COSTS,ANALYSIS OF CHANGES IN NEW CAPITAL BALANCES,COST ALLOCATION,COMPUTATION OF RATIO OF COST TO CHARGES,TRIAL BALANCE OF EXPENSE ACCOUNTS,APPORTIONMENT OF INPATIENT/OUTPATIENT ANCILLARY SERVICE OTHER PASS THROUGH COSTS,COMPUTATION OF RATIO OF COST TO CHARGES,COMPUTATION OF RATIO OF COST TO CHARGES,COST ALLOCATION,APPORTIONMENT OF MEDICAL AND OTHER HEALTH SERVICES,BED DAYS AVAILABLE,TRIAL BALANCE OF EXPENSE ACCOUNTS,ADJUSTMENTS,COST ALLOCATION,INPATIENT ANCILLARY SERVICE COST APPORTIONMENT,TRIAL BALANCE OF EXPENSE ACCOUNTS,HOSPITAL WAGE INDEX DATA,APPORTIONMENT OF INPATIENT/OUTPATIENT ANCILLARY SERVICE OTHER PASS THROUGH COSTS,INPATIENT ANCILLARY SERVICE COST APPORTIONMENT,INPATIENT ANCILLARY SERVICE COST APPORTIONMENT,HOSPITAL WAGE INDEX DATA,TRIAL BALANCE OF EXPENSE ACCOUNTS,APPORTIONMENT OF INPATIENT ROUTINE SERVICE OTHER PASS THROUGH COSTS,BED DAYS AVAILABLE,COST ALLOCATION,APPORTIONMENT OF INPATIENT/OUTPATIENT ANCILLARY SERVICE OTHER PASS THROUGH COSTS,HOSPITAL WAGE INDEX DATA,COST ALLOCATION,INPATIENT ANCILLARY SERVICE COST APPORTIONMENT,HOSPITAL WAGE INDEX DATA,INPATIENT ANCILLARY SERVICE COST APPORTIONMENT,HOSPITAL WAGE INDEX DATA,COMPUTATION OF RATIO OF COST TO CHARGES,HHA STATISTICAL DATA,COST ALLOCATION,BED DAYS AVAILABLE,APPORTIONMENT OF INPATIENT/OUTPATIENT ANCILLARY SERVICE OTHER PASS THROUGH COSTS,COST ALLOCATION,HOSPITAL WAGE INDEX DATA,COMPUTATION OF RATIO OF COST TO CHARGES,,Total Inpatient Days/Outpatient Visits,Total Inpatient Days/Outpatient Visits,COST ALLOCATION,APPORTIONMENT OF INPATIENT/OUTPATIENT ANCILLARY SERVICE OTHER PASS THROUGH COSTS,ANALYSIS OF CHANGES IN NEW CAPITAL BALANCES,BED DAYS AVAILABLE,,INPATIENT ANCILLARY SERVICE COST APPORTIONMENT,Medicaid Inpatient Days/Outpatient Visits,TRIAL BALANCE OF EXPENSE ACCOUNTS,INPATIENT ANCILLARY SERVICE COST APPORTIONMENT,APPORTIONMENT OF MEDICAL AND OTHER HEALTH SERVICES,,CALCULATION OF REIMBURSEMENT SETTLEMENT,ALLOCATION OF NEW CAPITAL COSTS,TRIAL BALANCE OF EXPENSE ACCOUNTS,RENAL STATISTICAL DATA,COST ALLOCATION,APPORTIONMENT OF INPATIENT/OUTPATIENT ANCILLARY SERVICE OTHER PASS THROUGH COSTS,APPORTIONMENT OF MEDICAL AND OTHER HEALTH SERVICES,APPORTIONMENT OF INPATIENT/OUTPATIENT ANCILLARY SERVICE OTHER PASS THROUGH COSTS,HHA STATISTICAL DATA,TRIAL BALANCE OF EXPENSE ACCOUNTS,ADJUSTMENTS,HOSPITAL WAGE INDEX DATA,INPATIENT ANCILLARY SERVICE COST APPORTIONMENT,CALCULATION OF REIMBURSEMENT SETTLEMENT,TRIAL BALANCE OF EXPENSE ACCOUNTS,,APPORTIONMENT OF INPATIENT/OUTPATIENT ANCILLARY SERVICE OTHER PASS THROUGH COSTS,INPATIENT ANCILLARY SERVICE COST APPORTIONMENT,HHA STATISTICAL DATA,Total Inpatient Days/Outpatient Visits,INPATIENT ANCILLARY SERVICE COST APPORTIONMENT,APPORTIONMENT OF MEDICAL AND OTHER HEALTH SERVICES,APPORTIONMENT OF INPATIENT/OUTPATIENT ANCILLARY SERVICE OTHER PASS THROUGH COSTS,TRIAL BALANCE OF EXPENSE ACCOUNTS,TRIAL BALANCE OF EXPENSE ACCOUNTS,APPORTIONMENT OF INPATIENT/OUTPATIENT ANCILLARY SERVICE OTHER PASS THROUGH COSTS,APPORTIONMENT OF INPATIENT/OUTPATIENT ANCILLARY SERVICE OTHER PASS THROUGH COSTS,COMPUTATION OF INPATIENT OPERATING COSTS,TRIAL BALANCE OF EXPENSE ACCOUNTS,HHA STATISTICAL DATA,HOSPITAL WAGE INDEX DATA,COMPUTATION OF RATIO OF COST TO CHARGES,APPORTIONMENT OF MEDICAL AND OTHER HEALTH SERVICES,COST ALLOCATION,COMPUTATION OF RATIO OF COST TO CHARGES,APPORTIONMENT OF INPATIENT/OUTPATIENT ANCILLARY SERVICE OTHER PASS THROUGH COSTS,APPORTIONMENT OF MEDICAL AND OTHER HEALTH SERVICES,INPATIENT ANCILLARY SERVICE COST APPORTIONMENT,TRIAL BALANCE OF EXPENSE ACCOUNTS,HHA STATISTICAL DATA,TRIAL BALANCE OF EXPENSE ACCOUNTS,TRIAL BALANCE OF EXPENSE ACCOUNTS,TRIAL BALANCE OF EXPENSE ACCOUNTS,RECONCILIATION OF CAPITAL COST CENTERS,COST ALLOCATION,INPATIENT ANCILLARY SERVICE COST APPORTIONMENT,APPORTIONMENT OF INPATIENT/OUTPATIENT ANCILLARY SERVICE OTHER PASS THROUGH COSTS,APPORTIONMENT OF MEDICAL AND OTHER HEALTH SERVICES,COST ALLOCATION,HHA STATISTICAL DATA,APPORTIONMENT OF INPATIENT/OUTPATIENT ANCILLARY SERVICE OTHER PASS THROUGH COSTS,,COMPUTATION OF RATIO OF COST TO CHARGES,APPORTIONMENT OF MEDICAL AND OTHER HEALTH SERVICES,TRIAL BALANCE OF EXPENSE ACCOUNTS,APPORTIONMENT OF MEDICAL AND OTHER HEALTH SERVICES,INPATIENT ANCILLARY SERVICE COST APPORTIONMENT,COMPUTATION OF RATIO OF COST TO CHARGES,HOSPITAL WAGE INDEX DATA,,HOSPITAL WAGE INDEX DATA,HOSPITAL WAGE INDEX DATA,TRIAL BALANCE OF EXPENSE ACCOUNTS,INPATIENT ANCILLARY SERVICE COST APPORTIONMENT,APPORTIONMENT OF MEDICAL AND OTHER HEALTH SERVICES,INPATIENT ANCILLARY SERVICE COST APPORTIONMENT,,TRIAL BALANCE OF EXPENSE ACCOUNTS,CALCULATION OF REIMBURSEMENT SETTLEMENT,ALLOCATION OF NEW CAPITAL COSTS,TRIAL BALANCE OF EXPENSE ACCOUNTS,Medicare Inpatient Days/Outpatient Visits,INPATIENT ANCILLARY SERVICE COST APPORTIONMENT,NUMBER OF BEDS,INPATIENT ANCILLARY SERVICE COST APPORTIONMENT,NUMBER OF BEDS,,TRIAL BALANCE OF EXPENSE ACCOUNTS,APPORTIONMENT OF INPATIENT/OUTPATIENT ANCILLARY SERVICE OTHER PASS THROUGH COSTS,COST ALLOCATION,COST ALLOCATION,COST ALLOCATION,COMPUTATION OF RATIO OF COST TO CHARGES,COST ALLOCATION,APPORTIONMENT OF INPATIENT/OUTPATIENT ANCILLARY SERVICE OTHER PASS THROUGH COSTS,Total Inpatient Days/Outpatient Visits,HOSPITAL WAGE INDEX DATA,APPORTIONMENT OF MEDICAL AND OTHER HEALTH SERVICES,APPORTIONMENT OF INPATIENT/OUTPATIENT ANCILLARY SERVICE OTHER PASS THROUGH COSTS,HOSPITAL WAGE INDEX DATA,TRIAL BALANCE OF EXPENSE ACCOUNTS,TRIAL BALANCE OF EXPENSE ACCOUNTS,APPORTIONMENT OF INPATIENT/OUTPATIENT ANCILLARY SERVICE OTHER PASS THROUGH COSTS,TRIAL BALANCE OF EXPENSE ACCOUNTS,TRIAL BALANCE OF EXPENSE ACCOUNTS,APPORTIONMENT OF MEDICAL AND OTHER HEALTH SERVICES,ANALYSIS OF CHANGES IN NEW CAPITAL BALANCES,Total Inpatient Days/Outpatient Visits,COMPUTATION OF RATIO OF COST TO CHARGES,TRIAL BALANCE OF EXPENSE ACCOUNTS,COST ALLOCATION,BED DAYS AVAILABLE,,INPATIENT ANCILLARY SERVICE COST APPORTIONMENT,TRIAL BALANCE OF EXPENSE ACCOUNTS,TRIAL BALANCE OF EXPENSE ACCOUNTS,CALCULATION OF REIMBURSEMENT SETTLEMENT,COMPUTATION OF RATIO OF COST TO CHARGES,Total Inpatient Days/Outpatient Visits,COST ALLOCATION,COMPUTATION OF RATIO OF COST TO CHARGES,HOSPITAL WAGE INDEX DATA,STATEMENT OF REVENUES AND EXPENSES,TRIAL BALANCE OF EXPENSE ACCOUNTS,HHA STATISTICAL DATA,APPORTIONMENT OF INPATIENT/OUTPATIENT ANCILLARY SERVICE OTHER PASS THROUGH COSTS,APPORTIONMENT OF MEDICAL AND OTHER HEALTH SERVICES,APPORTIONMENT OF INPATIENT/OUTPATIENT ANCILLARY SERVICE OTHER PASS THROUGH COSTS,TRIAL BALANCE OF EXPENSE ACCOUNTS,COST ALLOCATION,APPORTIONMENT OF INPATIENT/OUTPATIENT ANCILLARY SERVICE OTHER PASS THROUGH COSTS,APPORTIONMENT OF MEDICAL AND OTHER HEALTH SERVICES,COMPUTATION OF RATIO OF COST TO CHARGES,,BED DAYS AVAILABLE,HHA STATISTICAL DATA,CALCULATION OF REIMBURSEMENT SETTLEMENT,RECONCILIATION OF CAPITAL COST CENTERS,Total Inpatient Days/Outpatient Visits,,TRIAL BALANCE OF EXPENSE ACCOUNTS,APPORTIONMENT OF INPATIENT/OUTPATIENT ANCILLARY SERVICE OTHER PASS THROUGH COSTS,HHA STATISTICAL DATA,INPATIENT ANCILLARY SERVICE COST APPORTIONMENT,BALANCE SHEET,APPORTIONMENT OF INPATIENT/OUTPATIENT ANCILLARY SERVICE OTHER PASS THROUGH COSTS,TRIAL BALANCE OF EXPENSE ACCOUNTS,HOSPITAL WAGE INDEX DATA,,APPORTIONMENT OF INPATIENT ROUTINE SERVICE CAPITAL COSTS,HHA STATISTICAL DATA,COST ALLOCATION,APPORTIONMENT OF INPATIENT ROUTINE SERVICE CAPITAL COSTS,ANALYSIS OF CHANGES IN NEW CAPITAL BALANCES,COMPUTATION OF RATIO OF COST TO CHARGES,APPORTIONMENT OF INPATIENT/OUTPATIENT ANCILLARY SERVICE OTHER PASS THROUGH COSTS,APPORTIONMENT OF INPATIENT/OUTPATIENT ANCILLARY SERVICE OTHER PASS THROUGH COSTS,BED DAYS AVAILABLE,CALCULATION OF REIMBURSEMENT SETTLEMENT,COST ALLOCATION,APPORTIONMENT OF INPATIENT/OUTPATIENT ANCILLARY SERVICE OTHER PASS THROUGH COSTS,INPATIENT ANCILLARY SERVICE COST APPORTIONMENT,TRIAL BALANCE OF EXPENSE ACCOUNTS,Total Inpatient Days/Outpatient Visits,STATEMENT OF REVENUES AND EXPENSES,APPORTIONMENT OF MEDICAL AND OTHER HEALTH SERVICES,,APPORTIONMENT OF INPATIENT/OUTPATIENT ANCILLARY SERVICE OTHER PASS THROUGH COSTS,APPORTIONMENT OF INPATIENT/OUTPATIENT ANCILLARY SERVICE OTHER PASS THROUGH COSTS,APPORTIONMENT OF INPATIENT/OUTPATIENT ANCILLARY SERVICE OTHER PASS THROUGH COSTS,COST ALLOCATION,COST ALLOCATION,HOSPITAL IDENTIFICATION INFORMATION,APPORTIONMENT OF INPATIENT/OUTPATIENT ANCILLARY SERVICE OTHER PASS THROUGH COSTS,,TRIAL BALANCE OF EXPENSE ACCOUNTS,INPATIENT ANCILLARY SERVICE COST APPORTIONMENT,TRIAL BALANCE OF EXPENSE ACCOUNTS,TRIAL BALANCE OF EXPENSE ACCOUNTS,COST ALLOCATION,INPATIENT ANCILLARY SERVICE COST APPORTIONMENT,APPORTIONMENT OF MEDICAL AND OTHER HEALTH SERVICES,TRIAL BALANCE OF EXPENSE ACCOUNTS,TRIAL BALANCE OF EXPENSE ACCOUNTS,APPORTIONMENT OF MEDICAL AND OTHER HEALTH SERVICES,ANALYSIS OF CHANGES IN NEW CAPITAL BALANCES,APPORTIONMENT OF INPATIENT/OUTPATIENT ANCILLARY SERVICE OTHER PASS THROUGH COSTS,BALANCE SHEET,INPATIENT ANCILLARY SERVICE COST APPORTIONMENT,HOSPITAL WAGE INDEX DATA,APPORTIONMENT OF INPATIENT/OUTPATIENT ANCILLARY SERVICE OTHER PASS THROUGH COSTS,HOSPITAL WAGE INDEX DATA,ALLOCATION OF NEW CAPITAL COSTS,INPATIENT ANCILLARY SERVICE COST APPORTIONMENT,INPATIENT ANCILLARY SERVICE COST APPORTIONMENT,HOSPITAL WAGE INDEX DATA,INPATIENT ANCILLARY SERVICE COST APPORTIONMENT,TRIAL BALANCE OF EXPENSE ACCOUNTS,ANALYSIS OF CHANGES IN NEW CAPITAL BALANCES,CALCULATION OF REIMBURSEMENT SETTLEMENT,APPORTIONMENT OF INPATIENT/OUTPATIENT ANCILLARY SERVICE OTHER PASS THROUGH COSTS,HHA STATISTICAL DATA,APPORTIONMENT OF INPATIENT/OUTPATIENT ANCILLARY SERVICE OTHER PASS THROUGH COSTS,APPORTIONMENT OF INPATIENT/OUTPATIENT ANCILLARY SERVICE OTHER PASS THROUGH COSTS,RECONCILIATION OF CAPITAL COST CENTERS,TRIAL BALANCE OF EXPENSE ACCOUNTS,NUMBER OF BEDS,COMPUTATION OF RATIO OF COST TO CHARGES,COST ALLOCATION,Medicare Inpatient Days/Outpatient Visits,TRIAL BALANCE OF EXPENSE ACCOUNTS,INPATIENT ANCILLARY SERVICE COST APPORTIONMENT,COMPUTATION OF RATIO OF COST TO CHARGES,HOSPITAL WAGE INDEX DATA,APPORTIONMENT OF INPATIENT/OUTPATIENT ANCILLARY SERVICE OTHER PASS THROUGH COSTS,INPATIENT ANCILLARY SERVICE COST APPORTIONMENT,HHA STATISTICAL DATA,TRIAL BALANCE OF EXPENSE ACCOUNTS,COMPUTATION OF RATIO OF COST TO CHARGES,COMPUTATION OF RATIO OF COST TO CHARGES,APPORTIONMENT OF MEDICAL AND OTHER HEALTH SERVICES,INPATIENT ANCILLARY SERVICE COST APPORTIONMENT,INPATIENT ANCILLARY SERVICE COST APPORTIONMENT,COMPUTATION OF RATIO OF COST TO CHARGES,APPORTIONMENT OF INPATIENT/OUTPATIENT ANCILLARY SERVICE OTHER PASS THROUGH COSTS,COMPUTATION OF RATIO OF COST TO CHARGES,APPORTIONMENT OF INPATIENT/OUTPATIENT ANCILLARY SERVICE OTHER PASS THROUGH COSTS,TRIAL BALANCE OF EXPENSE ACCOUNTS,ALLOCATION OF NEW CAPITAL COSTS,COMPUTATION OF RATIO OF COST TO CHARGES,COMPUTATION OF RATIO OF COST TO CHARGES,TRIAL BALANCE OF EXPENSE ACCOUNTS,COMPUTATION OF RATIO OF COST TO CHARGES,ADJUSTMENTS,APPORTIONMENT OF INPATIENT/OUTPATIENT ANCILLARY SERVICE OTHER PASS THROUGH COSTS,,APPORTIONMENT OF MEDICAL AND OTHER HEALTH SERVICES,HOSPITAL WAGE INDEX DATA,COST ALLOCATION,COMPUTATION OF INPATIENT OPERATING COSTS,APPORTIONMENT OF MEDICAL AND OTHER HEALTH SERVICES,Medicare Inpatient Days/Outpatient Visits,,COST ALLOCATION,BED DAYS AVAILABLE,Total Inpatient Days/Outpatient Visits,,INPATIENT ANCILLARY SERVICE COST APPORTIONMENT,HOSPITAL WAGE INDEX DATA,INPATIENT ANCILLARY SERVICE COST APPORTIONMENT,COMPUTATION OF RATIO OF COST TO CHARGES,APPORTIONMENT OF INPATIENT/OUTPATIENT ANCILLARY SERVICE OTHER PASS THROUGH COSTS,CALCULATION OF REIMBURSEMENT SETTLEMENT (PPS),TRIAL BALANCE OF EXPENSE ACCOUNTS,COMPUTATION OF RATIO OF COST TO CHARGES,APPORTIONMENT OF MEDICAL AND OTHER HEALTH SERVICES,COST ALLOCATION,APPORTIONMENT OF INPATIENT ROUTINE SERVICE OTHER PASS THROUGH COSTS,APPORTIONMENT OF MEDICAL AND OTHER HEALTH SERVICES,ANALYSIS OF CHANGES IN NEW CAPITAL BALANCES,,INPATIENT ANCILLARY SERVICE COST APPORTIONMENT,APPORTIONMENT OF MEDICAL AND OTHER HEALTH SERVICES,Total Inpatient Days/Outpatient Visits,,APPORTIONMENT OF INPATIENT/OUTPATIENT ANCILLARY SERVICE OTHER PASS THROUGH COSTS,APPORTIONMENT OF MEDICAL AND OTHER HEALTH SERVICES,COST ALLOCATION,APPORTIONMENT OF INPATIENT/OUTPATIENT ANCILLARY SERVICE OTHER PASS THROUGH COSTS,CALCULATION OF REIMBURSEMENT SETTLEMENT,TRIAL BALANCE OF EXPENSE ACCOUNTS,COMPUTATION OF RATIO OF COST TO CHARGES,APPORTIONMENT OF INPATIENT/OUTPATIENT ANCILLARY SERVICE OTHER PASS THROUGH COSTS,APPORTIONMENT OF INPATIENT/OUTPATIENT ANCILLARY SERVICE OTHER PASS THROUGH COSTS,INPATIENT ANCILLARY SERVICE COST APPORTIONMENT,HHA STATISTICAL DATA,,RENAL STATISTICAL DATA,ADJUSTMENTS,INPATIENT ANCILLARY SERVICE COST APPORTIONMENT,APPORTIONMENT OF INPATIENT/OUTPATIENT ANCILLARY SERVICE OTHER PASS THROUGH COSTS,TRIAL BALANCE OF EXPENSE ACCOUNTS,TRIAL BALANCE OF EXPENSE ACCOUNTS,INPATIENT ANCILLARY SERVICE COST APPORTIONMENT,HHA STATISTICAL DATA,APPORTIONMENT OF MEDICAL AND OTHER HEALTH SERVICES,HHA STATISTICAL DATA,RENAL STATISTICAL DATA,,INPATIENT ANCILLARY SERVICE COST APPORTIONMENT,TRIAL BALANCE OF EXPENSE ACCOUNTS,Medicaid Inpatient Days/Outpatient Visits,COMPUTATION OF RATIO OF COST TO CHARGES,APPORTIONMENT OF MEDICAL AND OTHER HEALTH SERVICES,TRIAL BALANCE OF EXPENSE ACCOUNTS,APPORTIONMENT OF INPATIENT/OUTPATIENT ANCILLARY SERVICE OTHER PASS THROUGH COSTS,COMPUTATION OF RATIO OF COST TO CHARGES,HOSPITAL IDENTIFICATION INFORMATION,HOSPITAL WAGE INDEX DATA,COST ALLOCATION,HOSPITAL WAGE INDEX DATA,NUMBER OF BEDS,TRIAL BALANCE OF EXPENSE ACCOUNTS,APPORTIONMENT OF INPATIENT/OUTPATIENT ANCILLARY SERVICE OTHER PASS THROUGH COSTS,APPORTIONMENT OF MEDICAL AND OTHER HEALTH SERVICES,HOSPITAL WAGE INDEX DATA,COST ALLOCATION,APPORTIONMENT OF MEDICAL AND OTHER HEALTH SERVICES,HOSPITAL WAGE INDEX DATA,INPATIENT ANCILLARY SERVICE COST APPORTIONMENT,,Total Inpatient Days/Outpatient Visits,CALCULATION OF REIMBURSEMENT SETTLEMENT,COST ALLOCATION,,TRIAL BALANCE OF EXPENSE ACCOUNTS,ANALYSIS OF CHANGES IN NEW CAPITAL BALANCES,APPORTIONMENT OF INPATIENT/OUTPATIENT ANCILLARY SERVICE OTHER PASS THROUGH COSTS,COMPUTATION OF RATIO OF COST TO CHARGES,APPORTIONMENT OF MEDICAL AND OTHER HEALTH SERVICES,APPORTIONMENT OF MEDICAL AND OTHER HEALTH SERVICES,INPATIENT ANCILLARY SERVICE COST APPORTIONMENT,HOSPITAL WAGE INDEX DATA,COST ALLOCATION,ALLOCATION OF NEW CAPITAL COSTS,APPORTIONMENT OF INPATIENT/OUTPATIENT ANCILLARY SERVICE OTHER PASS THROUGH COSTS,BALANCE SHEET,APPORTIONMENT OF INPATIENT/OUTPATIENT ANCILLARY SERVICE OTHER PASS THROUGH COSTS,HOSPITAL IDENTIFICATION INFORMATION,APPORTIONMENT OF INPATIENT/OUTPATIENT ANCILLARY SERVICE OTHER PASS THROUGH COSTS,APPORTIONMENT OF INPATIENT/OUTPATIENT ANCILLARY SERVICE OTHER PASS THROUGH COSTS,APPORTIONMENT OF INPATIENT/OUTPATIENT ANCILLARY SERVICE OTHER PASS THROUGH COSTS,,COST ALLOCATION,APPORTIONMENT OF MEDICAL AND OTHER HEALTH SERVICES,APPORTIONMENT OF MEDICAL AND OTHER HEALTH SERVICES,COMPUTATION OF RATIO OF COST TO CHARGES,COST ALLOCATION,TRIAL BALANCE OF EXPENSE ACCOUNTS,COST ALLOCATION,APPORTIONMENT OF INPATIENT/OUTPATIENT ANCILLARY SERVICE OTHER PASS THROUGH COSTS,COST ALLOCATION,HOSPITAL WAGE INDEX DATA,INPATIENT ANCILLARY SERVICE COST APPORTIONMENT,APPORTIONMENT OF INPATIENT/OUTPATIENT ANCILLARY SERVICE OTHER PASS THROUGH COSTS,HOSPITAL WAGE INDEX DATA,APPORTIONMENT OF INPATIENT/OUTPATIENT ANCILLARY SERVICE OTHER PASS THROUGH COSTS,TRIAL BALANCE OF EXPENSE ACCOUNTS,APPORTIONMENT OF INPATIENT/OUTPATIENT ANCILLARY SERVICE OTHER PASS THROUGH COSTS,COMPUTATION OF RATIO OF COST TO CHARGES,ALLOCATION OF NEW CAPITAL COSTS,HOSPITAL WAGE INDEX DATA,INPATIENT ANCILLARY SERVICE COST APPORTIONMENT,APPORTIONMENT OF INPATIENT/OUTPATIENT ANCILLARY SERVICE OTHER PASS THROUGH COSTS,INPATIENT ANCILLARY SERVICE COST APPORTIONMENT,COST ALLOCATION,HOSPITAL WAGE INDEX DATA,Total Inpatient Days/Outpatient Visits,APPORTIONMENT OF INPATIENT ROUTINE SERVICE CAPITAL COSTS,ALLOCATION OF NEW CAPITAL COSTS,ADJUSTMENTS,CALCULATION OF REIMBURSEMENT SETTLEMENT (PPS),,INPATIENT ANCILLARY SERVICE COST APPORTIONMENT,TRIAL BALANCE OF EXPENSE ACCOUNTS,APPORTIONMENT OF INPATIENT/OUTPATIENT ANCILLARY SERVICE OTHER PASS THROUGH COSTS,INPATIENT ANCILLARY SERVICE COST APPORTIONMENT,COST ALLOCATION,APPORTIONMENT OF INPATIENT ROUTINE SERVICE CAPITAL COSTS,APPORTIONMENT OF INPATIENT/OUTPATIENT ANCILLARY SERVICE OTHER PASS THROUGH COSTS,CALCULATION OF REIMBURSEMENT SETTLEMENT,INPATIENT ANCILLARY SERVICE COST APPORTIONMENT,Medicare Inpatient Days/Outpatient Visits,INPATIENT ANCILLARY SERVICE COST APPORTIONMENT,RECONCILIATION OF CAPITAL COST CENTERS,COMPUTATION OF RATIO OF COST TO CHARGES,TRIAL BALANCE OF EXPENSE ACCOUNTS,Total Inpatient Days/Outpatient Visits,TRIAL BALANCE OF EXPENSE ACCOUNTS,COST ALLOCATION,S-10 DATA,BALANCE SHEET,HOSPITAL WAGE INDEX DATA,HOSPITAL WAGE INDEX DATA,HOSPITAL WAGE INDEX DATA,RENAL STATISTICAL DATA,COMPUTATION OF RATIO OF COST TO CHARGES,COMPUTATION OF INPATIENT OPERATING COSTS,INPATIENT ANCILLARY SERVICE COST APPORTIONMENT,HOSPITAL WAGE INDEX DATA,Total Inpatient Days/Outpatient Visits,ALLOCATION OF NEW CAPITAL COSTS,APPORTIONMENT OF INPATIENT/OUTPATIENT ANCILLARY SERVICE OTHER PASS THROUGH COSTS,INPATIENT ANCILLARY SERVICE COST APPORTIONMENT,APPORTIONMENT OF INPATIENT/OUTPATIENT ANCILLARY SERVICE OTHER PASS THROUGH COSTS,COMPUTATION OF RATIO OF COST TO CHARGES,ALLOCATION OF NEW CAPITAL COSTS,HOSPITAL WAGE INDEX DATA,TRIAL BALANCE OF EXPENSE ACCOUNTS,,COMPUTATION OF RATIO OF COST TO CHARGES,APPORTIONMENT OF INPATIENT ROUTINE SERVICE OTHER PASS THROUGH COSTS,APPORTIONMENT OF INPATIENT/OUTPATIENT ANCILLARY SERVICE OTHER PASS THROUGH COSTS,INPATIENT ANCILLARY SERVICE COST APPORTIONMENT,,HHA STATISTICAL DATA,HHA STATISTICAL DATA,ANALYSIS OF CHANGES IN NEW CAPITAL BALANCES,COMPUTATION OF RATIO OF COST TO CHARGES,HOSPITAL WAGE INDEX DATA,TRIAL BALANCE OF EXPENSE ACCOUNTS,APPORTIONMENT OF MEDICAL AND OTHER HEALTH SERVICES,ALLOCATION OF NEW CAPITAL COSTS,APPORTIONMENT OF INPATIENT/OUTPATIENT ANCILLARY SERVICE OTHER PASS THROUGH COSTS,INPATIENT ANCILLARY SERVICE COST APPORTIONMENT,,APPORTIONMENT OF INPATIENT/OUTPATIENT ANCILLARY SERVICE OTHER PASS THROUGH COSTS,COMPUTATION OF RATIO OF COST TO CHARGES,TRIAL BALANCE OF EXPENSE ACCOUNTS,Total Inpatient Days/Outpatient Visits,TRIAL BALANCE OF EXPENSE ACCOUNTS,COST ALLOCATION,HOSPITAL WAGE INDEX DATA,COMPUTATION OF RATIO OF COST TO CHARGES,ADJUSTMENTS,COMPUTATION OF RATIO OF COST TO CHARGES,INPATIENT ANCILLARY SERVICE COST APPORTIONMENT,INPATIENT ANCILLARY SERVICE COST APPORTIONMENT,ALLOCATION OF NEW CAPITAL COSTS,COST ALLOCATION,APPORTIONMENT OF INPATIENT/OUTPATIENT ANCILLARY SERVICE OTHER PASS THROUGH COSTS,TRIAL BALANCE OF EXPENSE ACCOUNTS,COST ALLOCATION,COST ALLOCATION,TRIAL BALANCE OF EXPENSE ACCOUNTS,COMPUTATION OF RATIO OF COST TO CHARGES,BED DAYS AVAILABLE,TRIAL BALANCE OF EXPENSE ACCOUNTS,TRIAL BALANCE OF EXPENSE ACCOUNTS,COMPUTATION OF RATIO OF COST TO CHARGES,APPORTIONMENT OF INPATIENT/OUTPATIENT ANCILLARY SERVICE OTHER PASS THROUGH COSTS,CALCULATION OF REIMBURSEMENT SETTLEMENT,TRIAL BALANCE OF EXPENSE ACCOUNTS,APPORTIONMENT OF INPATIENT/OUTPATIENT ANCILLARY SERVICE OTHER PASS THROUGH COSTS,APPORTIONMENT OF INPATIENT/OUTPATIENT ANCILLARY SERVICE OTHER PASS THROUGH COSTS,INPATIENT ANCILLARY SERVICE COST APPORTIONMENT,COMPUTATION OF INPATIENT OPERATING COSTS,HHA STATISTICAL DATA,APPORTIONMENT OF MEDICAL AND OTHER HEALTH SERVICES,TRIAL BALANCE OF EXPENSE ACCOUNTS,RECONCILIATION OF CAPITAL COST CENTERS,,ANALYSIS OF CHANGES IN NEW CAPITAL BALANCES,HOSPITAL WAGE INDEX DATA,APPORTIONMENT OF INPATIENT/OUTPATIENT ANCILLARY SERVICE OTHER PASS THROUGH COSTS,ADJUSTMENTS,APPORTIONMENT OF INPATIENT/OUTPATIENT ANCILLARY SERVICE OTHER PASS THROUGH COSTS,APPORTIONMENT OF MEDICAL AND OTHER HEALTH SERVICES,ANALYSIS OF CHANGES IN NEW CAPITAL BALANCES,COMPUTATION OF RATIO OF COST TO CHARGES,HOSPITAL WAGE INDEX DATA,HOSPITAL IDENTIFICATION INFORMATION,COST ALLOCATION,COMPUTATION OF RATIO OF COST TO CHARGES,APPORTIONMENT OF MEDICAL AND OTHER HEALTH SERVICES,APPORTIONMENT OF MEDICAL AND OTHER HEALTH SERVICES,RENAL STATISTICAL DATA,COMPUTATION OF RATIO OF COST TO CHARGES,APPORTIONMENT OF INPATIENT/OUTPATIENT ANCILLARY SERVICE OTHER PASS THROUGH COSTS,INPATIENT ANCILLARY SERVICE COST APPORTIONMENT,APPORTIONMENT OF INPATIENT/OUTPATIENT ANCILLARY SERVICE OTHER PASS THROUGH COSTS,COST ALLOCATION,ADJUSTMENTS,ADJUSTMENTS,INPATIENT ANCILLARY SERVICE COST APPORTIONMENT,COST ALLOCATION,INPATIENT ANCILLARY SERVICE COST APPORTIONMENT,HHA STATISTICAL DATA,INPATIENT ANCILLARY SERVICE COST APPORTIONMENT,TRIAL BALANCE OF EXPENSE ACCOUNTS,INPATIENT ANCILLARY SERVICE COST APPORTIONMENT,INPATIENT ANCILLARY SERVICE COST APPORTIONMENT,BALANCE SHEET,Total Inpatient Days/Outpatient Visits,ADJUSTMENTS,APPORTIONMENT OF INPATIENT/OUTPATIENT ANCILLARY SERVICE OTHER PASS THROUGH COSTS,INPATIENT ANCILLARY SERVICE COST APPORTIONMENT,Medicaid Inpatient Days/Outpatient Visits,HOSPITAL WAGE INDEX DATA,RECONCILIATION OF CAPITAL COST CENTERS,APPORTIONMENT OF MEDICAL AND OTHER HEALTH SERVICES,COST ALLOCATION,ANALYSIS OF CHANGES IN NEW CAPITAL BALANCES,BED DAYS AVAILABLE,APPORTIONMENT OF INPATIENT/OUTPATIENT ANCILLARY SERVICE OTHER PASS THROUGH COSTS,CALCULATION OF REIMBURSEMENT SETTLEMENT,BALANCE SHEET,HOSPITAL WAGE INDEX DATA,RENAL STATISTICAL DATA,COMPUTATION OF RATIO OF COST TO CHARGES,APPORTIONMENT OF MEDICAL AND OTHER HEALTH SERVICES,HHA STATISTICAL DATA,COMPUTATION OF RATIO OF COST TO CHARGES,,APPORTIONMENT OF MEDICAL AND OTHER HEALTH SERVICES,HOSPITAL WAGE INDEX DATA,COST ALLOCATION,COST ALLOCATION,COST ALLOCATION,TRIAL BALANCE OF EXPENSE ACCOUNTS,TRIAL BALANCE OF EXPENSE ACCOUNTS,INPATIENT ANCILLARY SERVICE COST APPORTIONMENT,TRIAL BALANCE OF EXPENSE ACCOUNTS,Medicaid Inpatient Days/Outpatient Visits,COST ALLOCATION,INPATIENT ANCILLARY SERVICE COST APPORTIONMENT,Medicare Inpatient Days/Outpatient Visits,ANALYSIS OF CHANGES IN NEW CAPITAL BALANCES,COST ALLOCATION,INPATIENT ANCILLARY SERVICE COST APPORTIONMENT,ADJUSTMENTS,BED DAYS AVAILABLE,INPATIENT ANCILLARY SERVICE COST APPORTIONMENT,INPATIENT ANCILLARY SERVICE COST APPORTIONMENT,BALANCE SHEET,INPATIENT ANCILLARY SERVICE COST APPORTIONMENT,HOSPITAL WAGE INDEX DATA,TRIAL BALANCE OF EXPENSE ACCOUNTS,HHA STATISTICAL DATA,INPATIENT ANCILLARY SERVICE COST APPORTIONMENT,COMPUTATION OF RATIO OF COST TO CHARGES,ALLOCATION OF NEW CAPITAL COSTS,APPORTIONMENT OF INPATIENT/OUTPATIENT ANCILLARY SERVICE OTHER PASS THROUGH COSTS,APPORTIONMENT OF MEDICAL AND OTHER HEALTH SERVICES,BALANCE SHEET,TRIAL BALANCE OF EXPENSE ACCOUNTS,TRIAL BALANCE OF EXPENSE ACCOUNTS,TRIAL BALANCE OF EXPENSE ACCOUNTS,APPORTIONMENT OF MEDICAL AND OTHER HEALTH SERVICES,APPORTIONMENT OF MEDICAL AND OTHER HEALTH SERVICES,,TRIAL BALANCE OF EXPENSE ACCOUNTS,ALLOCATION OF NEW CAPITAL COSTS,TRIAL BALANCE OF EXPENSE ACCOUNTS,INPATIENT ANCILLARY SERVICE COST APPORTIONMENT,COMPUTATION OF RATIO OF COST TO CHARGES,CALCULATION OF REIMBURSEMENT SETTLEMENT,INPATIENT ANCILLARY SERVICE COST APPORTIONMENT,COST ALLOCATION,COST ALLOCATION,APPORTIONMENT OF MEDICAL AND OTHER HEALTH SERVICES,APPORTIONMENT OF MEDICAL AND OTHER HEALTH SERVICES,TRIAL BALANCE OF EXPENSE ACCOUNTS,APPORTIONMENT OF MEDICAL AND OTHER HEALTH SERVICES,APPORTIONMENT OF MEDICAL AND OTHER HEALTH SERVICES,TRIAL BALANCE OF EXPENSE ACCOUNTS,APPORTIONMENT OF MEDICAL AND OTHER HEALTH SERVICES,COMPUTATION OF RATIO OF COST TO CHARGES,INPATIENT ANCILLARY SERVICE COST APPORTIONMENT,TRIAL BALANCE OF EXPENSE ACCOUNTS,COST ALLOCATION,BED DAYS AVAILABLE,COMPUTATION OF RATIO OF COST TO CHARGES,APPORTIONMENT OF INPATIENT/OUTPATIENT ANCILLARY SERVICE OTHER PASS THROUGH COSTS,TRIAL BALANCE OF EXPENSE ACCOUNTS,COST ALLOCATION,HOSPITAL WAGE INDEX DATA,,TRIAL BALANCE OF EXPENSE ACCOUNTS,HOSPITAL WAGE INDEX DATA,COMPUTATION OF RATIO OF COST TO CHARGES,INPATIENT ANCILLARY SERVICE COST APPORTIONMENT,ALLOCATION OF NEW CAPITAL COSTS,APPORTIONMENT OF INPATIENT/OUTPATIENT ANCILLARY SERVICE OTHER PASS THROUGH COSTS,APPORTIONMENT OF MEDICAL AND OTHER HEALTH SERVICES,INPATIENT ANCILLARY SERVICE COST APPORTIONMENT,COST ALLOCATION,,APPORTIONMENT OF INPATIENT/OUTPATIENT ANCILLARY SERVICE OTHER PASS THROUGH COSTS,INPATIENT ANCILLARY SERVICE COST APPORTIONMENT,TRIAL BALANCE OF EXPENSE ACCOUNTS,Medicare Inpatient Days/Outpatient Visits,APPORTIONMENT OF INPATIENT/OUTPATIENT ANCILLARY SERVICE OTHER PASS THROUGH COSTS,TRIAL BALANCE OF EXPENSE ACCOUNTS,INPATIENT ANCILLARY SERVICE COST APPORTIONMENT,BED DAYS AVAILABLE,APPORTIONMENT OF MEDICAL AND OTHER HEALTH SERVICES,COMPUTATION OF RATIO OF COST TO CHARGES,INPATIENT ANCILLARY SERVICE COST APPORTIONMENT,APPORTIONMENT OF INPATIENT ROUTINE SERVICE CAPITAL COSTS,APPORTIONMENT OF INPATIENT ROUTINE SERVICE CAPITAL COSTS,APPORTIONMENT OF INPATIENT/OUTPATIENT ANCILLARY SERVICE OTHER PASS THROUGH COSTS,APPORTIONMENT OF INPATIENT ROUTINE SERVICE CAPITAL COSTS,TRIAL BALANCE OF EXPENSE ACCOUNTS,TRIAL BALANCE OF EXPENSE ACCOUNTS,HOSPITAL WAGE INDEX DATA,CALCULATION OF REIMBURSEMENT SETTLEMENT,RENAL STATISTICAL DATA,APPORTIONMENT OF INPATIENT/OUTPATIENT ANCILLARY SERVICE OTHER PASS THROUGH COSTS,APPORTIONMENT OF INPATIENT/OUTPATIENT ANCILLARY SERVICE OTHER PASS THROUGH COSTS,APPORTIONMENT OF INPATIENT/OUTPATIENT ANCILLARY SERVICE OTHER PASS THROUGH COSTS,COST ALLOCATION,INPATIENT ANCILLARY SERVICE COST APPORTIONMENT,HOSPITAL WAGE INDEX DATA,APPORTIONMENT OF MEDICAL AND OTHER HEALTH SERVICES,BALANCE SHEET,APPORTIONMENT OF INPATIENT/OUTPATIENT ANCILLARY SERVICE OTHER PASS THROUGH COSTS,APPORTIONMENT OF MEDICAL AND OTHER HEALTH SERVICES,APPORTIONMENT OF INPATIENT/OUTPATIENT ANCILLARY SERVICE OTHER PASS THROUGH COSTS,COMPUTATION OF RATIO OF COST TO CHARGES,APPORTIONMENT OF INPATIENT/OUTPATIENT ANCILLARY SERVICE OTHER PASS THROUGH COSTS,HOSPITAL WAGE INDEX DATA,HOSPITAL WAGE INDEX DATA,HHA STATISTICAL DATA,COST ALLOCATION,COST ALLOCATION,ALLOCATION OF NEW CAPITAL COSTS,COST ALLOCATION,APPORTIONMENT OF MEDICAL AND OTHER HEALTH SERVICES,BALANCE SHEET,COMPUTATION OF RATIO OF COST TO CHARGES,COST ALLOCATION,APPORTIONMENT OF INPATIENT/OUTPATIENT ANCILLARY SERVICE OTHER PASS THROUGH COSTS,COMPUTATION OF RATIO OF COST TO CHARGES,HOSPITAL IDENTIFICATION INFORMATION,TRIAL BALANCE OF EXPENSE ACCOUNTS,COMPUTATION OF RATIO OF COST TO CHARGES,Total Inpatient Days/Outpatient Visits,COMPUTATION OF RATIO OF COST TO CHARGES,HOSPITAL WAGE INDEX DATA,COST ALLOCATION,TRIAL BALANCE OF EXPENSE ACCOUNTS,Total Inpatient Days/Outpatient Visits,APPORTIONMENT OF INPATIENT/OUTPATIENT ANCILLARY SERVICE OTHER PASS THROUGH COSTS,HOSPITAL WAGE INDEX DATA,INPATIENT ANCILLARY SERVICE COST APPORTIONMENT,COST ALLOCATION,ADJUSTMENTS,TRIAL BALANCE OF EXPENSE ACCOUNTS,COMPUTATION OF RATIO OF COST TO CHARGES,HOSPITAL WAGE INDEX DATA,HOSPITAL WAGE INDEX DATA,TRIAL BALANCE OF EXPENSE ACCOUNTS,APPORTIONMENT OF MEDICAL AND OTHER HEALTH SERVICES,COST ALLOCATION,,TRIAL BALANCE OF EXPENSE ACCOUNTS,COMPUTATION OF RATIO OF COST TO CHARGES,COST ALLOCATION,COMPUTATION OF RATIO OF COST TO CHARGES,CALCULATION OF REIMBURSEMENT SETTLEMENT,Medicaid Inpatient Days/Outpatient Visits,HHA STATISTICAL DATA,CALCULATION OF REIMBURSEMENT SETTLEMENT,TRIAL BALANCE OF EXPENSE ACCOUNTS,RECONCILIATION OF CAPITAL COST CENTERS,COST ALLOCATION,TRIAL BALANCE OF EXPENSE ACCOUNTS,COST ALLOCATION,INPATIENT ANCILLARY SERVICE COST APPORTIONMENT,Medicaid Inpatient Days/Outpatient Visits,INPATIENT ANCILLARY SERVICE COST APPORTIONMENT,COST ALLOCATION,ANALYSIS OF CHANGES IN NEW CAPITAL BALANCES,HOSPITAL WAGE INDEX DATA,ADJUSTMENTS,COMPUTATION OF RATIO OF COST TO CHARGES,INPATIENT ANCILLARY SERVICE COST APPORTIONMENT,INPATIENT ANCILLARY SERVICE COST APPORTIONMENT,APPORTIONMENT OF MEDICAL AND OTHER HEALTH SERVICES,INPATIENT ANCILLARY SERVICE COST APPORTIONMENT,APPORTIONMENT OF MEDICAL AND OTHER HEALTH SERVICES,APPORTIONMENT OF INPATIENT ROUTINE SERVICE OTHER PASS THROUGH COSTS,INPATIENT ANCILLARY SERVICE COST APPORTIONMENT,HOSPITAL WAGE INDEX DATA,APPORTIONMENT OF INPATIENT/OUTPATIENT ANCILLARY SERVICE OTHER PASS THROUGH COSTS,APPORTIONMENT OF MEDICAL AND OTHER HEALTH SERVICES,TRIAL BALANCE OF EXPENSE ACCOUNTS,ALLOCATION OF NEW CAPITAL COSTS,COST ALLOCATION,ALLOCATION OF NEW CAPITAL COSTS,Total Inpatient Days/Outpatient Visits,TRIAL BALANCE OF EXPENSE ACCOUNTS,RENAL STATISTICAL DATA,COST ALLOCATION,INPATIENT ANCILLARY SERVICE COST APPORTIONMENT,APPORTIONMENT OF INPATIENT/OUTPATIENT ANCILLARY SERVICE OTHER PASS THROUGH COSTS,COST ALLOCATION,APPORTIONMENT OF INPATIENT ROUTINE SERVICE CAPITAL COSTS,TRIAL BALANCE OF EXPENSE ACCOUNTS,APPORTIONMENT OF INPATIENT/OUTPATIENT ANCILLARY SERVICE OTHER PASS THROUGH COSTS,S-10 DATA,S-10 DATA,ALLOCATION OF NEW CAPITAL COSTS,COMPUTATION OF RATIO OF COST TO CHARGES,INPATIENT ANCILLARY SERVICE COST APPORTIONMENT,APPORTIONMENT OF INPATIENT/OUTPATIENT ANCILLARY SERVICE OTHER PASS THROUGH COSTS,COMPUTATION OF RATIO OF COST TO CHARGES,APPORTIONMENT OF MEDICAL AND OTHER HEALTH SERVICES,TRIAL BALANCE OF EXPENSE ACCOUNTS,COMPUTATION OF RATIO OF COST TO CHARGES,TRIAL BALANCE OF EXPENSE ACCOUNTS,APPORTIONMENT OF INPATIENT/OUTPATIENT ANCILLARY SERVICE OTHER PASS THROUGH COSTS,INPATIENT ANCILLARY SERVICE COST APPORTIONMENT,COST ALLOCATION,COMPUTATION OF RATIO OF COST TO CHARGES,HOSPITAL WAGE INDEX DATA,APPORTIONMENT OF MEDICAL AND OTHER HEALTH SERVICES,APPORTIONMENT OF INPATIENT/OUTPATIENT ANCILLARY SERVICE OTHER PASS THROUGH COSTS,APPORTIONMENT OF INPATIENT/OUTPATIENT ANCILLARY SERVICE OTHER PASS THROUGH COSTS,APPORTIONMENT OF MEDICAL AND OTHER HEALTH SERVICES,APPORTIONMENT OF INPATIENT ROUTINE SERVICE CAPITAL COSTS,TRIAL BALANCE OF EXPENSE ACCOUNTS,,COST ALLOCATION,TRIAL BALANCE OF EXPENSE ACCOUNTS,APPORTIONMENT OF MEDICAL AND OTHER HEALTH SERVICES,COST ALLOCATION,NUMBER OF BEDS,APPORTIONMENT OF INPATIENT ROUTINE SERVICE CAPITAL COSTS,APPORTIONMENT OF MEDICAL AND OTHER HEALTH SERVICES,COST ALLOCATION,HHA STATISTICAL DATA,TRIAL BALANCE OF EXPENSE ACCOUNTS,TRIAL BALANCE OF EXPENSE ACCOUNTS,INPATIENT ANCILLARY SERVICE COST APPORTIONMENT,COST ALLOCATION,,COST ALLOCATION,TRIAL BALANCE OF EXPENSE ACCOUNTS,TRIAL BALANCE OF EXPENSE ACCOUNTS,COMPUTATION OF RATIO OF COST TO CHARGES,BED DAYS AVAILABLE,COMPUTATION OF INPATIENT OPERATING COSTS,INPATIENT ANCILLARY SERVICE COST APPORTIONMENT,HOSPITAL WAGE INDEX DATA,RECONCILIATION OF CAPITAL COST CENTERS,COMPUTATION OF INPATIENT OPERATING COSTS,BALANCE SHEET,COMPUTATION OF RATIO OF COST TO CHARGES,Total Inpatient Days/Outpatient Visits,ANALYSIS OF CHANGES IN NEW CAPITAL BALANCES,APPORTIONMENT OF INPATIENT/OUTPATIENT ANCILLARY SERVICE OTHER PASS THROUGH COSTS,COST ALLOCATION,APPORTIONMENT OF INPATIENT/OUTPATIENT ANCILLARY SERVICE OTHER PASS THROUGH COSTS,APPORTIONMENT OF INPATIENT/OUTPATIENT ANCILLARY SERVICE OTHER PASS THROUGH COSTS,APPORTIONMENT OF MEDICAL AND OTHER HEALTH SERVICES,COMPUTATION OF RATIO OF COST TO CHARGES,ALLOCATION OF NEW CAPITAL COSTS,Total Inpatient Days/Outpatient Visits,TRIAL BALANCE OF EXPENSE ACCOUNTS,ADJUSTMENTS,COST ALLOCATION,HOSPITAL WAGE INDEX DATA,APPORTIONMENT OF INPATIENT ROUTINE SERVICE CAPITAL COSTS,APPORTIONMENT OF MEDICAL AND OTHER HEALTH SERVICES,TRIAL BALANCE OF EXPENSE ACCOUNTS,,Total Inpatient Days/Outpatient Visits,TRIAL BALANCE OF EXPENSE ACCOUNTS,BALANCE SHEET,APPORTIONMENT OF MEDICAL AND OTHER HEALTH SERVICES,HHA STATISTICAL DATA,S-10 DATA,COMPUTATION OF INPATIENT OPERATING COSTS,APPORTIONMENT OF INPATIENT/OUTPATIENT ANCILLARY SERVICE OTHER PASS THROUGH COSTS,TRIAL BALANCE OF EXPENSE ACCOUNTS,COST ALLOCATION,COMPUTATION OF RATIO OF COST TO CHARGES,HOSPITAL WAGE INDEX DATA,HOSPITAL WAGE INDEX DATA,APPORTIONMENT OF INPATIENT/OUTPATIENT ANCILLARY SERVICE OTHER PASS THROUGH COSTS,COST ALLOCATION,TRIAL BALANCE OF EXPENSE ACCOUNTS,HHA STATISTICAL DATA,COST ALLOCATION,COST ALLOCATION,ALLOCATION OF NEW CAPITAL COSTS,COMPUTATION OF RATIO OF COST TO CHARGES,APPORTIONMENT OF INPATIENT/OUTPATIENT ANCILLARY SERVICE OTHER PASS THROUGH COSTS,TRIAL BALANCE OF EXPENSE ACCOUNTS,COST ALLOCATION,HOSPITAL WAGE INDEX DATA,,APPORTIONMENT OF INPATIENT/OUTPATIENT ANCILLARY SERVICE OTHER PASS THROUGH COSTS,APPORTIONMENT OF MEDICAL AND OTHER HEALTH SERVICES,COMPUTATION OF INPATIENT OPERATING COSTS,CALCULATION OF REIMBURSEMENT SETTLEMENT,Medicaid Inpatient Days/Outpatient Visits,APPORTIONMENT OF MEDICAL AND OTHER HEALTH SERVICES,COST ALLOCATION,COMPUTATION OF RATIO OF COST TO CHARGES,APPORTIONMENT OF INPATIENT/OUTPATIENT ANCILLARY SERVICE OTHER PASS THROUGH COSTS,BED DAYS AVAILABLE,COMPUTATION OF INPATIENT OPERATING COSTS,HHA STATISTICAL DATA,COMPUTATION OF RATIO OF COST TO CHARGES,APPORTIONMENT OF MEDICAL AND OTHER HEALTH SERVICES,INPATIENT ANCILLARY SERVICE COST APPORTIONMENT,COST ALLOCATION,APPORTIONMENT OF MEDICAL AND OTHER HEALTH SERVICES,,APPORTIONMENT OF MEDICAL AND OTHER HEALTH SERVICES,COST ALLOCATION,APPORTIONMENT OF INPATIENT/OUTPATIENT ANCILLARY SERVICE OTHER PASS THROUGH COSTS,COMPUTATION OF RATIO OF COST TO CHARGES,TRIAL BALANCE OF EXPENSE ACCOUNTS,INPATIENT ANCILLARY SERVICE COST APPORTIONMENT,APPORTIONMENT OF INPATIENT/OUTPATIENT ANCILLARY SERVICE OTHER PASS THROUGH COSTS,COST ALLOCATION,,COMPUTATION OF RATIO OF COST TO CHARGES,COMPUTATION OF RATIO OF COST TO CHARGES,APPORTIONMENT OF INPATIENT/OUTPATIENT ANCILLARY SERVICE OTHER PASS THROUGH COSTS,Medicaid Inpatient Days/Outpatient Visits,APPORTIONMENT OF INPATIENT/OUTPATIENT ANCILLARY SERVICE OTHER PASS THROUGH COSTS,APPORTIONMENT OF INPATIENT/OUTPATIENT ANCILLARY SERVICE OTHER PASS THROUGH COSTS,APPORTIONMENT OF INPATIENT/OUTPATIENT ANCILLARY SERVICE OTHER PASS THROUGH COSTS,HHA STATISTICAL DATA,INPATIENT ANCILLARY SERVICE COST APPORTIONMENT,HOSPITAL WAGE INDEX DATA,TRIAL BALANCE OF EXPENSE ACCOUNTS,COST ALLOCATION,TRIAL BALANCE OF EXPENSE ACCOUNTS,TRIAL BALANCE OF EXPENSE ACCOUNTS,COMPUTATION OF RATIO OF COST TO CHARGES,APPORTIONMENT OF INPATIENT/OUTPATIENT ANCILLARY SERVICE OTHER PASS THROUGH COSTS,APPORTIONMENT OF INPATIENT/OUTPATIENT ANCILLARY SERVICE OTHER PASS THROUGH COSTS,APPORTIONMENT OF INPATIENT/OUTPATIENT ANCILLARY SERVICE OTHER PASS THROUGH COSTS,HHA STATISTICAL DATA,COMPUTATION OF INPATIENT OPERATING COSTS,COMPUTATION OF INPATIENT OPERATING COSTS,HOSPITAL WAGE INDEX DATA,APPORTIONMENT OF MEDICAL AND OTHER HEALTH SERVICES,APPORTIONMENT OF INPATIENT/OUTPATIENT ANCILLARY SERVICE OTHER PASS THROUGH COSTS,COST ALLOCATION,APPORTIONMENT OF INPATIENT/OUTPATIENT ANCILLARY SERVICE OTHER PASS THROUGH COSTS,INPATIENT ANCILLARY SERVICE COST APPORTIONMENT,APPORTIONMENT OF INPATIENT/OUTPATIENT ANCILLARY SERVICE OTHER PASS THROUGH COSTS,,APPORTIONMENT OF INPATIENT/OUTPATIENT ANCILLARY SERVICE OTHER PASS THROUGH COSTS,COST ALLOCATION,TRIAL BALANCE OF EXPENSE ACCOUNTS,,INPATIENT ANCILLARY SERVICE COST APPORTIONMENT,APPORTIONMENT OF INPATIENT/OUTPATIENT ANCILLARY SERVICE OTHER PASS THROUGH COSTS,APPORTIONMENT OF INPATIENT ROUTINE SERVICE OTHER PASS THROUGH COSTS,INPATIENT ANCILLARY SERVICE COST APPORTIONMENT,INPATIENT ANCILLARY SERVICE COST APPORTIONMENT,APPORTIONMENT OF INPATIENT/OUTPATIENT ANCILLARY SERVICE OTHER PASS THROUGH COSTS,HOSPITAL WAGE INDEX DATA,HOSPITAL WAGE INDEX DATA,BALANCE SHEET,HOSPITAL WAGE INDEX DATA,APPORTIONMENT OF MEDICAL AND OTHER HEALTH SERVICES,APPORTIONMENT OF INPATIENT/OUTPATIENT ANCILLARY SERVICE OTHER PASS THROUGH COSTS,HOSPITAL WAGE INDEX DATA,COST ALLOCATION,TRIAL BALANCE OF EXPENSE ACCOUNTS,APPORTIONMENT OF MEDICAL AND OTHER HEALTH SERVICES,APPORTIONMENT OF INPATIENT/OUTPATIENT ANCILLARY SERVICE OTHER PASS THROUGH COSTS,COST ALLOCATION,COST ALLOCATION,TRIAL BALANCE OF EXPENSE ACCOUNTS,BALANCE SHEET,,HOSPITAL WAGE INDEX DATA,ALLOCATION OF NEW CAPITAL COSTS,Medicaid Inpatient Days/Outpatient Visits,ALLOCATION OF NEW CAPITAL COSTS,APPORTIONMENT OF INPATIENT/OUTPATIENT ANCILLARY SERVICE OTHER PASS THROUGH COSTS,CALCULATION OF REIMBURSEMENT SETTLEMENT,HOSPITAL WAGE INDEX DATA,INPATIENT ANCILLARY SERVICE COST APPORTIONMENT,APPORTIONMENT OF MEDICAL AND OTHER HEALTH SERVICES,BALANCE SHEET,COMPUTATION OF RATIO OF COST TO CHARGES,COST ALLOCATION,COMPUTATION OF RATIO OF COST TO CHARGES,COST ALLOCATION,Total Inpatient Days/Outpatient Visits,APPORTIONMENT OF MEDICAL AND OTHER HEALTH SERVICES,INPATIENT ANCILLARY SERVICE COST APPORTIONMENT,INPATIENT ANCILLARY SERVICE COST APPORTIONMENT,S-10 DATA,APPORTIONMENT OF INPATIENT/OUTPATIENT ANCILLARY SERVICE OTHER PASS THROUGH COSTS,INPATIENT ANCILLARY SERVICE COST APPORTIONMENT,RENAL STATISTICAL DATA,RECONCILIATION OF CAPITAL COST CENTERS,ADJUSTMENTS,TRIAL BALANCE OF EXPENSE ACCOUNTS,ALLOCATION OF NEW CAPITAL COSTS,APPORTIONMENT OF INPATIENT/OUTPATIENT ANCILLARY SERVICE OTHER PASS THROUGH COSTS,ALLOCATION OF NEW CAPITAL COSTS,ALLOCATION OF NEW CAPITAL COSTS,COST ALLOCATION,TRIAL BALANCE OF EXPENSE ACCOUNTS,APPORTIONMENT OF MEDICAL AND OTHER HEALTH SERVICES,APPORTIONMENT OF INPATIENT/OUTPATIENT ANCILLARY SERVICE OTHER PASS THROUGH COSTS,APPORTIONMENT OF INPATIENT/OUTPATIENT ANCILLARY SERVICE OTHER PASS THROUGH COSTS,APPORTIONMENT OF MEDICAL AND OTHER HEALTH SERVICES,ALLOCATION OF NEW CAPITAL COSTS,HOSPITAL WAGE INDEX DATA,COMPUTATION OF RATIO OF COST TO CHARGES,APPORTIONMENT OF MEDICAL AND OTHER HEALTH SERVICES,HOSPITAL WAGE INDEX DATA,ANALYSIS OF CHANGES IN NEW CAPITAL BALANCES,APPORTIONMENT OF INPATIENT/OUTPATIENT ANCILLARY SERVICE OTHER PASS THROUGH COSTS,APPORTIONMENT OF INPATIENT ROUTINE SERVICE CAPITAL COSTS,ADJUSTMENTS,APPORTIONMENT OF MEDICAL AND OTHER HEALTH SERVICES,APPORTIONMENT OF INPATIENT/OUTPATIENT ANCILLARY SERVICE OTHER PASS THROUGH COSTS,APPORTIONMENT OF INPATIENT/OUTPATIENT ANCILLARY SERVICE OTHER PASS THROUGH COSTS,HOSPITAL WAGE INDEX DATA,HOSPITAL WAGE INDEX DATA,HOSPITAL WAGE INDEX DATA,COST ALLOCATION,COST ALLOCATION,COST ALLOCATION,ALLOCATION OF NEW CAPITAL COSTS,APPORTIONMENT OF INPATIENT/OUTPATIENT ANCILLARY SERVICE OTHER PASS THROUGH COSTS,APPORTIONMENT OF MEDICAL AND OTHER HEALTH SERVICES,APPORTIONMENT OF MEDICAL AND OTHER HEALTH SERVICES,INPATIENT ANCILLARY SERVICE COST APPORTIONMENT,S-10 DATA,,HOSPITAL WAGE INDEX DATA,APPORTIONMENT OF INPATIENT/OUTPATIENT ANCILLARY SERVICE OTHER PASS THROUGH COSTS,APPORTIONMENT OF MEDICAL AND OTHER HEALTH SERVICES,Medicaid Inpatient Days/Outpatient Visits,APPORTIONMENT OF MEDICAL AND OTHER HEALTH SERVICES,Total Inpatient Days/Outpatient Visits,ALLOCATION OF NEW CAPITAL COSTS,RECONCILIATION OF CAPITAL COST CENTERS,INPATIENT ANCILLARY SERVICE COST APPORTIONMENT,COST ALLOCATION,APPORTIONMENT OF INPATIENT/OUTPATIENT ANCILLARY SERVICE OTHER PASS THROUGH COSTS,COST ALLOCATION,APPORTIONMENT OF MEDICAL AND OTHER HEALTH SERVICES,APPORTIONMENT OF MEDICAL AND OTHER HEALTH SERVICES,COST ALLOCATION,APPORTIONMENT OF MEDICAL AND OTHER HEALTH SERVICES,TRIAL BALANCE OF EXPENSE ACCOUNTS,CALCULATION OF REIMBURSEMENT SETTLEMENT,ADJUSTMENTS,APPORTIONMENT OF INPATIENT/OUTPATIENT ANCILLARY SERVICE OTHER PASS THROUGH COSTS,COST ALLOCATION,APPORTIONMENT OF MEDICAL AND OTHER HEALTH SERVICES,TRIAL BALANCE OF EXPENSE ACCOUNTS,INPATIENT ANCILLARY SERVICE COST APPORTIONMENT,ALLOCATION OF NEW CAPITAL COSTS,HOSPITAL WAGE INDEX DATA,COST ALLOCATION,APPORTIONMENT OF INPATIENT/OUTPATIENT ANCILLARY SERVICE OTHER PASS THROUGH COSTS,STATEMENT OF REVENUES AND EXPENSES,COMPUTATION OF RATIO OF COST TO CHARGES,,STATEMENT OF PATIENT REVENUES AND OPERATING EXPENSES,BALANCE SHEET,HOSPITAL WAGE INDEX DATA,TRIAL BALANCE OF EXPENSE ACCOUNTS,,CALCULATION OF REIMBURSEMENT SETTLEMENT,APPORTIONMENT OF INPATIENT/OUTPATIENT ANCILLARY SERVICE OTHER PASS THROUGH COSTS,Total Inpatient Days/Outpatient Visits,APPORTIONMENT OF MEDICAL AND OTHER HEALTH SERVICES,COST ALLOCATION,APPORTIONMENT OF INPATIENT/OUTPATIENT ANCILLARY SERVICE OTHER PASS THROUGH COSTS,S-10 DATA,HOSPITAL WAGE INDEX DATA,COMPUTATION OF RATIO OF COST TO CHARGES,HOSPITAL WAGE INDEX DATA,TRIAL BALANCE OF EXPENSE ACCOUNTS,APPORTIONMENT OF MEDICAL AND OTHER HEALTH SERVICES,INPATIENT ANCILLARY SERVICE COST APPORTIONMENT,COST ALLOCATION,HOSPITAL WAGE INDEX DATA,APPORTIONMENT OF INPATIENT/OUTPATIENT ANCILLARY SERVICE OTHER PASS THROUGH COSTS,HOSPITAL WAGE INDEX DATA,TRIAL BALANCE OF EXPENSE ACCOUNTS,COST ALLOCATION,TRIAL BALANCE OF EXPENSE ACCOUNTS,TRIAL BALANCE OF EXPENSE ACCOUNTS,APPORTIONMENT OF INPATIENT/OUTPATIENT ANCILLARY SERVICE OTHER PASS THROUGH COSTS,TRIAL BALANCE OF EXPENSE ACCOUNTS,TRIAL BALANCE OF EXPENSE ACCOUNTS,BED DAYS AVAILABLE,INPATIENT ANCILLARY SERVICE COST APPORTIONMENT,,COST ALLOCATION,COMPUTATION OF RATIO OF COST TO CHARGES,ALLOCATION OF NEW CAPITAL COSTS,Medicaid Inpatient Days/Outpatient Visits,TRIAL BALANCE OF EXPENSE ACCOUNTS,COST ALLOCATION,COST ALLOCATION,COMPUTATION OF RATIO OF COST TO CHARGES,HHA STATISTICAL DATA,TRIAL BALANCE OF EXPENSE ACCOUNTS,INPATIENT ANCILLARY SERVICE COST APPORTIONMENT,APPORTIONMENT OF INPATIENT/OUTPATIENT ANCILLARY SERVICE OTHER PASS THROUGH COSTS,APPORTIONMENT OF INPATIENT/OUTPATIENT ANCILLARY SERVICE OTHER PASS THROUGH COSTS,INPATIENT ANCILLARY SERVICE COST APPORTIONMENT,APPORTIONMENT OF INPATIENT/OUTPATIENT ANCILLARY SERVICE OTHER PASS THROUGH COSTS,INPATIENT ANCILLARY SERVICE COST APPORTIONMENT,RENAL STATISTICAL DATA,BED DAYS AVAILABLE,APPORTIONMENT OF INPATIENT/OUTPATIENT ANCILLARY SERVICE OTHER PASS THROUGH COSTS,TRIAL BALANCE OF EXPENSE ACCOUNTS,APPORTIONMENT OF INPATIENT/OUTPATIENT ANCILLARY SERVICE OTHER PASS THROUGH COSTS,APPORTIONMENT OF MEDICAL AND OTHER HEALTH SERVICES,INPATIENT ANCILLARY SERVICE COST APPORTIONMENT,APPORTIONMENT OF INPATIENT/OUTPATIENT ANCILLARY SERVICE OTHER PASS THROUGH COSTS,COMPUTATION OF RATIO OF COST TO CHARGES,COMPUTATION OF RATIO OF COST TO CHARGES,APPORTIONMENT OF INPATIENT/OUTPATIENT ANCILLARY SERVICE OTHER PASS THROUGH COSTS,APPORTIONMENT OF MEDICAL AND OTHER HEALTH SERVICES,APPORTIONMENT OF INPATIENT/OUTPATIENT ANCILLARY SERVICE OTHER PASS THROUGH COSTS,APPORTIONMENT OF INPATIENT/OUTPATIENT ANCILLARY SERVICE OTHER PASS THROUGH COSTS,COMPUTATION OF RATIO OF COST TO CHARGES,APPORTIONMENT OF INPATIENT ROUTINE SERVICE CAPITAL COSTS,INPATIENT ANCILLARY SERVICE COST APPORTIONMENT,APPORTIONMENT OF INPATIENT ROUTINE SERVICE OTHER PASS THROUGH COSTS,APPORTIONMENT OF INPATIENT/OUTPATIENT ANCILLARY SERVICE OTHER PASS THROUGH COSTS,HOSPITAL WAGE INDEX DATA,ADJUSTMENTS,HOSPITAL WAGE INDEX DATA,HOSPITAL WAGE INDEX DATA,APPORTIONMENT OF INPATIENT ROUTINE SERVICE OTHER PASS THROUGH COSTS,INPATIENT ANCILLARY SERVICE COST APPORTIONMENT,S-10 DATA,HOSPITAL IDENTIFICATION INFORMATION,,TRIAL BALANCE OF EXPENSE ACCOUNTS,INPATIENT ANCILLARY SERVICE COST APPORTIONMENT,TRIAL BALANCE OF EXPENSE ACCOUNTS,COST ALLOCATION,INPATIENT ANCILLARY SERVICE COST APPORTIONMENT,TRIAL BALANCE OF EXPENSE ACCOUNTS,COMPUTATION OF RATIO OF COST TO CHARGES,COMPUTATION OF RATIO OF COST TO CHARGES,COST ALLOCATION,HOSPITAL WAGE INDEX DATA,HOSPITAL WAGE INDEX DATA,BED DAYS AVAILABLE,Total Inpatient Days/Outpatient Visits,APPORTIONMENT OF MEDICAL AND OTHER HEALTH SERVICES,COST ALLOCATION,COMPUTATION OF RATIO OF COST TO CHARGES,TRIAL BALANCE OF EXPENSE ACCOUNTS,COST ALLOCATION,Medicare Inpatient Days/Outpatient Visits,COMPUTATION OF RATIO OF COST TO CHARGES,INPATIENT ANCILLARY SERVICE COST APPORTIONMENT,HOSPITAL WAGE INDEX DATA,BED DAYS AVAILABLE,Total Inpatient Days/Outpatient Visits,CALCULATION OF REIMBURSEMENT SETTLEMENT,COST ALLOCATION,,COST ALLOCATION,,COMPUTATION OF RATIO OF COST TO CHARGES,HOSPITAL WAGE INDEX DATA,ANALYSIS OF CHANGES IN NEW CAPITAL BALANCES,HHA STATISTICAL DATA,CALCULATION OF REIMBURSEMENT SETTLEMENT,APPORTIONMENT OF INPATIENT/OUTPATIENT ANCILLARY SERVICE OTHER PASS THROUGH COSTS,INPATIENT ANCILLARY SERVICE COST APPORTIONMENT,TRIAL BALANCE OF EXPENSE ACCOUNTS,HOSPITAL WAGE INDEX DATA,APPORTIONMENT OF INPATIENT/OUTPATIENT ANCILLARY SERVICE OTHER PASS THROUGH COSTS,INPATIENT ANCILLARY SERVICE COST APPORTIONMENT,APPORTIONMENT OF MEDICAL AND OTHER HEALTH SERVICES,APPORTIONMENT OF INPATIENT/OUTPATIENT ANCILLARY SERVICE OTHER PASS THROUGH COSTS,RECONCILIATION OF CAPITAL COST CENTERS,INPATIENT ANCILLARY SERVICE COST APPORTIONMENT,INPATIENT ANCILLARY SERVICE COST APPORTIONMENT,INPATIENT ANCILLARY SERVICE COST APPORTIONMENT,Total Inpatient Days/Outpatient Visits,COST ALLOCATION,INPATIENT ANCILLARY SERVICE COST APPORTIONMENT,COMPUTATION OF RATIO OF COST TO CHARGES,COMPUTATION OF INPATIENT OPERATING COSTS,BED DAYS AVAILABLE,APPORTIONMENT OF INPATIENT/OUTPATIENT ANCILLARY SERVICE OTHER PASS THROUGH COSTS,COST ALLOCATION,TRIAL BALANCE OF EXPENSE ACCOUNTS,TRIAL BALANCE OF EXPENSE ACCOUNTS,Medicaid Inpatient Days/Outpatient Visits,TRIAL BALANCE OF EXPENSE ACCOUNTS,TRIAL BALANCE OF EXPENSE ACCOUNTS,ANALYSIS OF CHANGES IN NEW CAPITAL BALANCES,APPORTIONMENT OF MEDICAL AND OTHER HEALTH SERVICES,TRIAL BALANCE OF EXPENSE ACCOUNTS,COMPUTATION OF RATIO OF COST TO CHARGES,S-10 DATA,COST ALLOCATION,APPORTIONMENT OF INPATIENT/OUTPATIENT ANCILLARY SERVICE OTHER PASS THROUGH COSTS,APPORTIONMENT OF MEDICAL AND OTHER HEALTH SERVICES,Total Inpatient Days/Outpatient Visits,HOSPITAL IDENTIFICATION INFORMATION,APPORTIONMENT OF MEDICAL AND OTHER HEALTH SERVICES,,APPORTIONMENT OF INPATIENT/OUTPATIENT ANCILLARY SERVICE OTHER PASS THROUGH COSTS,TRIAL BALANCE OF EXPENSE ACCOUNTS,COMPUTATION OF RATIO OF COST TO CHARGES,APPORTIONMENT OF INPATIENT ROUTINE SERVICE CAPITAL COSTS,HOSPITAL WAGE INDEX DATA,COMPUTATION OF RATIO OF COST TO CHARGES,,APPORTIONMENT OF INPATIENT/OUTPATIENT ANCILLARY SERVICE OTHER PASS THROUGH COSTS,BALANCE SHEET,S-10 DATA,COST ALLOCATION,COMPUTATION OF RATIO OF COST TO CHARGES,TRIAL BALANCE OF EXPENSE ACCOUNTS,HOSPITAL WAGE INDEX DATA,COST ALLOCATION,APPORTIONMENT OF MEDICAL AND OTHER HEALTH SERVICES,APPORTIONMENT OF MEDICAL AND OTHER HEALTH SERVICES,HOSPITAL WAGE INDEX DATA,COST ALLOCATION,RENAL STATISTICAL DATA,ANALYSIS OF CHANGES IN NEW CAPITAL BALANCES,HOSPITAL WAGE INDEX DATA,COMPUTATION OF RATIO OF COST TO CHARGES,COMPUTATION OF RATIO OF COST TO CHARGES,COMPUTATION OF RATIO OF COST TO CHARGES,HOSPITAL WAGE INDEX DATA,COMPUTATION OF RATIO OF COST TO CHARGES,APPORTIONMENT OF INPATIENT/OUTPATIENT ANCILLARY SERVICE OTHER PASS THROUGH COSTS,HOSPITAL WAGE INDEX DATA,ALLOCATION OF NEW CAPITAL COSTS,ALLOCATION OF NEW CAPITAL COSTS,COMPUTATION OF RATIO OF COST TO CHARGES,CALCULATION OF REIMBURSEMENT SETTLEMENT,INPATIENT ANCILLARY SERVICE COST APPORTIONMENT,APPORTIONMENT OF INPATIENT/OUTPATIENT ANCILLARY SERVICE OTHER PASS THROUGH COSTS,INPATIENT ANCILLARY SERVICE COST APPORTIONMENT,BALANCE SHEET,APPORTIONMENT OF INPATIENT/OUTPATIENT ANCILLARY SERVICE OTHER PASS THROUGH COSTS,Total Inpatient Days/Outpatient Visits,HOSPITAL WAGE INDEX DATA,APPORTIONMENT OF INPATIENT ROUTINE SERVICE OTHER PASS THROUGH COSTS,COMPUTATION OF INPATIENT OPERATING COSTS,INPATIENT ANCILLARY SERVICE COST APPORTIONMENT,BALANCE SHEET,COST ALLOCATION,APPORTIONMENT OF INPATIENT/OUTPATIENT ANCILLARY SERVICE OTHER PASS THROUGH COSTS,,APPORTIONMENT OF INPATIENT ROUTINE SERVICE CAPITAL COSTS,APPORTIONMENT OF MEDICAL AND OTHER HEALTH SERVICES,APPORTIONMENT OF INPATIENT/OUTPATIENT ANCILLARY SERVICE OTHER PASS THROUGH COSTS,HHA STATISTICAL DATA,HOSPITAL WAGE INDEX DATA,TRIAL BALANCE OF EXPENSE ACCOUNTS,APPORTIONMENT OF MEDICAL AND OTHER HEALTH SERVICES,HOSPITAL IDENTIFICATION INFORMATION,TRIAL BALANCE OF EXPENSE ACCOUNTS,INPATIENT ANCILLARY SERVICE COST APPORTIONMENT,TRIAL BALANCE OF EXPENSE ACCOUNTS,,COST ALLOCATION,,HOSPITAL WAGE INDEX DATA,HOSPITAL WAGE INDEX DATA,APPORTIONMENT OF INPATIENT/OUTPATIENT ANCILLARY SERVICE OTHER PASS THROUGH COSTS,ADJUSTMENTS,INPATIENT ANCILLARY SERVICE COST APPORTIONMENT,COMPUTATION OF RATIO OF COST TO CHARGES,TRIAL BALANCE OF EXPENSE ACCOUNTS,COST ALLOCATION,APPORTIONMENT OF INPATIENT/OUTPATIENT ANCILLARY SERVICE OTHER PASS THROUGH COSTS,BED DAYS AVAILABLE,INPATIENT ANCILLARY SERVICE COST APPORTIONMENT,APPORTIONMENT OF INPATIENT/OUTPATIENT ANCILLARY SERVICE OTHER PASS THROUGH COSTS,NUMBER OF BEDS,APPORTIONMENT OF INPATIENT/OUTPATIENT ANCILLARY SERVICE OTHER PASS THROUGH COSTS,TRIAL BALANCE OF EXPENSE ACCOUNTS,Medicare Inpatient Days/Outpatient Visits,INPATIENT ANCILLARY SERVICE COST APPORTIONMENT,ANALYSIS OF CHANGES IN NEW CAPITAL BALANCES,INPATIENT ANCILLARY SERVICE COST APPORTIONMENT,COMPUTATION OF RATIO OF COST TO CHARGES,ALLOCATION OF NEW CAPITAL COSTS,CALCULATION OF REIMBURSEMENT SETTLEMENT,INPATIENT ANCILLARY SERVICE COST APPORTIONMENT,ALLOCATION OF NEW CAPITAL COSTS,INPATIENT ANCILLARY SERVICE COST APPORTIONMENT,APPORTIONMENT OF INPATIENT/OUTPATIENT ANCILLARY SERVICE OTHER PASS THROUGH COSTS,RENAL STATISTICAL DATA,APPORTIONMENT OF INPATIENT/OUTPATIENT ANCILLARY SERVICE OTHER PASS THROUGH COSTS,COMPUTATION OF RATIO OF COST TO CHARGES,,INPATIENT ANCILLARY SERVICE COST APPORTIONMENT,INPATIENT ANCILLARY SERVICE COST APPORTIONMENT,APPORTIONMENT OF MEDICAL AND OTHER HEALTH SERVICES,INPATIENT ANCILLARY SERVICE COST APPORTIONMENT,COMPUTATION OF RATIO OF COST TO CHARGES,COST ALLOCATION,HOSPITAL WAGE INDEX DATA,APPORTIONMENT OF INPATIENT/OUTPATIENT ANCILLARY SERVICE OTHER PASS THROUGH COSTS,Medicare Inpatient Days/Outpatient Visits,COMPUTATION OF RATIO OF COST TO CHARGES,INPATIENT ANCILLARY SERVICE COST APPORTIONMENT,COMPUTATION OF RATIO OF COST TO CHARGES,INPATIENT ANCILLARY SERVICE COST APPORTIONMENT,APPORTIONMENT OF INPATIENT/OUTPATIENT ANCILLARY SERVICE OTHER PASS THROUGH COSTS,INPATIENT ANCILLARY SERVICE COST APPORTIONMENT,HOSPITAL WAGE INDEX DATA,BALANCE SHEET,COMPUTATION OF RATIO OF COST TO CHARGES,CALCULATION OF REIMBURSEMENT SETTLEMENT,APPORTIONMENT OF MEDICAL AND OTHER HEALTH SERVICES,COMPUTATION OF INPATIENT OPERATING COSTS,HHA STATISTICAL DATA,COMPUTATION OF RATIO OF COST TO CHARGES,APPORTIONMENT OF INPATIENT/OUTPATIENT ANCILLARY SERVICE OTHER PASS THROUGH COSTS,HOSPITAL WAGE INDEX DATA,APPORTIONMENT OF INPATIENT/OUTPATIENT ANCILLARY SERVICE OTHER PASS THROUGH COSTS,TRIAL BALANCE OF EXPENSE ACCOUNTS,APPORTIONMENT OF INPATIENT/OUTPATIENT ANCILLARY SERVICE OTHER PASS THROUGH COSTS,APPORTIONMENT OF MEDICAL AND OTHER HEALTH SERVICES,APPORTIONMENT OF MEDICAL AND OTHER HEALTH SERVICES,,INPATIENT ANCILLARY SERVICE COST APPORTIONMENT,TRIAL BALANCE OF EXPENSE ACCOUNTS,BALANCE SHEET,APPORTIONMENT OF INPATIENT/OUTPATIENT ANCILLARY SERVICE OTHER PASS THROUGH COSTS,COMPUTATION OF RATIO OF COST TO CHARGES,,APPORTIONMENT OF MEDICAL AND OTHER HEALTH SERVICES,INPATIENT ANCILLARY SERVICE COST APPORTIONMENT,,COST ALLOCATION,HOSPITAL WAGE INDEX DATA,,COMPUTATION OF RATIO OF COST TO CHARGES,HOSPITAL WAGE INDEX DATA,COMPUTATION OF RATIO OF COST TO CHARGES,APPORTIONMENT OF INPATIENT/OUTPATIENT ANCILLARY SERVICE OTHER PASS THROUGH COSTS,TRIAL BALANCE OF EXPENSE ACCOUNTS,APPORTIONMENT OF INPATIENT/OUTPATIENT ANCILLARY SERVICE OTHER PASS THROUGH COSTS,APPORTIONMENT OF INPATIENT/OUTPATIENT ANCILLARY SERVICE OTHER PASS THROUGH COSTS,INPATIENT ANCILLARY SERVICE COST APPORTIONMENT,INPATIENT ANCILLARY SERVICE COST APPORTIONMENT,HHA STATISTICAL DATA,APPORTIONMENT OF MEDICAL AND OTHER HEALTH SERVICES,APPORTIONMENT OF MEDICAL AND OTHER HEALTH SERVICES,CALCULATION OF REIMBURSEMENT SETTLEMENT,Total Inpatient Days/Outpatient Visits,APPORTIONMENT OF INPATIENT/OUTPATIENT ANCILLARY SERVICE OTHER PASS THROUGH COSTS,APPORTIONMENT OF INPATIENT/OUTPATIENT ANCILLARY SERVICE OTHER PASS THROUGH COSTS,CALCULATION OF REIMBURSEMENT SETTLEMENT,APPORTIONMENT OF INPATIENT/OUTPATIENT ANCILLARY SERVICE OTHER PASS THROUGH COSTS,APPORTIONMENT OF INPATIENT/OUTPATIENT ANCILLARY SERVICE OTHER PASS THROUGH COSTS,HOSPITAL WAGE INDEX DATA,INPATIENT ANCILLARY SERVICE COST APPORTIONMENT,TRIAL BALANCE OF EXPENSE ACCOUNTS,HHA STATISTICAL DATA,APPORTIONMENT OF MEDICAL AND OTHER HEALTH SERVICES,TRIAL BALANCE OF EXPENSE ACCOUNTS,COMPUTATION OF RATIO OF COST TO CHARGES,ADJUSTMENTS,Total Inpatient Days/Outpatient Visits,ALLOCATION OF NEW CAPITAL COSTS,COST ALLOCATION,COST ALLOCATION,TRIAL BALANCE OF EXPENSE ACCOUNTS,Medicare Inpatient Days/Outpatient Visits,INPATIENT ANCILLARY SERVICE COST APPORTIONMENT,APPORTIONMENT OF MEDICAL AND OTHER HEALTH SERVICES,APPORTIONMENT OF INPATIENT/OUTPATIENT ANCILLARY SERVICE OTHER PASS THROUGH COSTS,HHA STATISTICAL DATA,Total Inpatient Days/Outpatient Visits,Total Inpatient Days/Outpatient Visits,COST ALLOCATION,INPATIENT ANCILLARY SERVICE COST APPORTIONMENT,APPORTIONMENT OF INPATIENT ROUTINE SERVICE OTHER PASS THROUGH COSTS,Medicare Inpatient Days/Outpatient Visits,COMPUTATION OF RATIO OF COST TO CHARGES,INPATIENT ANCILLARY SERVICE COST APPORTIONMENT,HOSPITAL WAGE INDEX DATA,INPATIENT ANCILLARY SERVICE COST APPORTIONMENT,CALCULATION OF REIMBURSEMENT SETTLEMENT,HHA STATISTICAL DATA,,INPATIENT ANCILLARY SERVICE COST APPORTIONMENT,ALLOCATION OF NEW CAPITAL COSTS,,HHA STATISTICAL DATA,Medicare Inpatient Days/Outpatient Visits,TRIAL BALANCE OF EXPENSE ACCOUNTS,,HOSPITAL WAGE INDEX DATA,ALLOCATION OF NEW CAPITAL COSTS,INPATIENT ANCILLARY SERVICE COST APPORTIONMENT,COST ALLOCATION,COST ALLOCATION,,COMPUTATION OF INPATIENT OPERATING COSTS,INPATIENT ANCILLARY SERVICE COST APPORTIONMENT,,TRIAL BALANCE OF EXPENSE ACCOUNTS,APPORTIONMENT OF MEDICAL AND OTHER HEALTH SERVICES,INPATIENT ANCILLARY SERVICE COST APPORTIONMENT,BED DAYS AVAILABLE,INPATIENT ANCILLARY SERVICE COST APPORTIONMENT,HHA STATISTICAL DATA,APPORTIONMENT OF INPATIENT/OUTPATIENT ANCILLARY SERVICE OTHER PASS THROUGH COSTS,NUMBER OF BEDS,HOSPITAL WAGE INDEX DATA,APPORTIONMENT OF INPATIENT/OUTPATIENT ANCILLARY SERVICE OTHER PASS THROUGH COSTS,HOSPITAL IDENTIFICATION INFORMATION,ANALYSIS OF CHANGES IN NEW CAPITAL BALANCES,,INPATIENT ANCILLARY SERVICE COST APPORTIONMENT,INPATIENT ANCILLARY SERVICE COST APPORTIONMENT,BED DAYS AVAILABLE,Medicare Inpatient Days/Outpatient Visits,HHA STATISTICAL DATA,COMPUTATION OF RATIO OF COST TO CHARGES,COST ALLOCATION,COMPUTATION OF RATIO OF COST TO CHARGES,INPATIENT ANCILLARY SERVICE COST APPORTIONMENT,HOSPITAL WAGE INDEX DATA,APPORTIONMENT OF INPATIENT/OUTPATIENT ANCILLARY SERVICE OTHER PASS THROUGH COSTS,APPORTIONMENT OF MEDICAL AND OTHER HEALTH SERVICES,BALANCE SHEET,APPORTIONMENT OF MEDICAL AND OTHER HEALTH SERVICES,APPORTIONMENT OF INPATIENT/OUTPATIENT ANCILLARY SERVICE OTHER PASS THROUGH COSTS,APPORTIONMENT OF INPATIENT/OUTPATIENT ANCILLARY SERVICE OTHER PASS THROUGH COSTS,COST ALLOCATION,COST ALLOCATION,APPORTIONMENT OF MEDICAL AND OTHER HEALTH SERVICES,INPATIENT ANCILLARY SERVICE COST APPORTIONMENT,TRIAL BALANCE OF EXPENSE ACCOUNTS,COMPUTATION OF RATIO OF COST TO CHARGES,INPATIENT ANCILLARY SERVICE COST APPORTIONMENT,INPATIENT ANCILLARY SERVICE COST APPORTIONMENT,ALLOCATION OF NEW CAPITAL COSTS,APPORTIONMENT OF MEDICAL AND OTHER HEALTH SERVICES,COST ALLOCATION,ALLOCATION OF NEW CAPITAL COSTS,HOSPITAL IDENTIFICATION INFORMATION,COST ALLOCATION,APPORTIONMENT OF INPATIENT ROUTINE SERVICE CAPITAL COSTS,Total Inpatient Days/Outpatient Visits,,TRIAL BALANCE OF EXPENSE ACCOUNTS,ANALYSIS OF CHANGES IN NEW CAPITAL BALANCES,COST ALLOCATION,APPORTIONMENT OF INPATIENT/OUTPATIENT ANCILLARY SERVICE OTHER PASS THROUGH COSTS,TRIAL BALANCE OF EXPENSE ACCOUNTS,INPATIENT ANCILLARY SERVICE COST APPORTIONMENT,COST ALLOCATION,APPORTIONMENT OF INPATIENT/OUTPATIENT ANCILLARY SERVICE OTHER PASS THROUGH COSTS,HOSPITAL WAGE INDEX DATA,INPATIENT ANCILLARY SERVICE COST APPORTIONMENT,APPORTIONMENT OF MEDICAL AND OTHER HEALTH SERVICES,COMPUTATION OF RATIO OF COST TO CHARGES,APPORTIONMENT OF INPATIENT/OUTPATIENT ANCILLARY SERVICE OTHER PASS THROUGH COSTS,INPATIENT ANCILLARY SERVICE COST APPORTIONMENT,COMPUTATION OF RATIO OF COST TO CHARGES,APPORTIONMENT OF MEDICAL AND OTHER HEALTH SERVICES,ADJUSTMENTS,COST ALLOCATION,BALANCE SHEET,APPORTIONMENT OF MEDICAL AND OTHER HEALTH SERVICES,COMPUTATION OF INPATIENT OPERATING COSTS,TRIAL BALANCE OF EXPENSE ACCOUNTS,TRIAL BALANCE OF EXPENSE ACCOUNTS,COST ALLOCATION,COST ALLOCATION,INPATIENT ANCILLARY SERVICE COST APPORTIONMENT,COST ALLOCATION,APPORTIONMENT OF MEDICAL AND OTHER HEALTH SERVICES,TRIAL BALANCE OF EXPENSE ACCOUNTS,APPORTIONMENT OF INPATIENT ROUTINE SERVICE OTHER PASS THROUGH COSTS,APPORTIONMENT OF INPATIENT/OUTPATIENT ANCILLARY SERVICE OTHER PASS THROUGH COSTS,APPORTIONMENT OF MEDICAL AND OTHER HEALTH SERVICES,,BED DAYS AVAILABLE,APPORTIONMENT OF INPATIENT ROUTINE SERVICE OTHER PASS THROUGH COSTS,RENAL STATISTICAL DATA,,S-10 DATA,APPORTIONMENT OF MEDICAL AND OTHER HEALTH SERVICES,COST ALLOCATION,APPORTIONMENT OF INPATIENT/OUTPATIENT ANCILLARY SERVICE OTHER PASS THROUGH COSTS,COMPUTATION OF RATIO OF COST TO CHARGES,COST ALLOCATION,,INPATIENT ANCILLARY SERVICE COST APPORTIONMENT,ALLOCATION OF NEW CAPITAL COSTS,COMPUTATION OF RATIO OF COST TO CHARGES,APPORTIONMENT OF INPATIENT/OUTPATIENT ANCILLARY SERVICE OTHER PASS THROUGH COSTS,,COST ALLOCATION,APPORTIONMENT OF INPATIENT/OUTPATIENT ANCILLARY SERVICE OTHER PASS THROUGH COSTS,HOSPITAL WAGE INDEX DATA,Medicaid Inpatient Days/Outpatient Visits,COMPUTATION OF RATIO OF COST TO CHARGES,HOSPITAL WAGE INDEX DATA,,HHA STATISTICAL DATA,RENAL STATISTICAL DATA,INPATIENT ANCILLARY SERVICE COST APPORTIONMENT,COST ALLOCATION,APPORTIONMENT OF MEDICAL AND OTHER HEALTH SERVICES,INPATIENT ANCILLARY SERVICE COST APPORTIONMENT,STATEMENT OF REVENUES AND EXPENSES,COMPUTATION OF INPATIENT OPERATING COSTS,HHA STATISTICAL DATA,TRIAL BALANCE OF EXPENSE ACCOUNTS,INPATIENT ANCILLARY SERVICE COST APPORTIONMENT,ADJUSTMENTS,APPORTIONMENT OF INPATIENT/OUTPATIENT ANCILLARY SERVICE OTHER PASS THROUGH COSTS,APPORTIONMENT OF MEDICAL AND OTHER HEALTH SERVICES,COST ALLOCATION,APPORTIONMENT OF INPATIENT/OUTPATIENT ANCILLARY SERVICE OTHER PASS THROUGH COSTS,TRIAL BALANCE OF EXPENSE ACCOUNTS,INPATIENT ANCILLARY SERVICE COST APPORTIONMENT,ADJUSTMENTS,HOSPITAL WAGE INDEX DATA,COMPUTATION OF RATIO OF COST TO CHARGES,TRIAL BALANCE OF EXPENSE ACCOUNTS,COST ALLOCATION,COST ALLOCATION,S-10 DATA,APPORTIONMENT OF MEDICAL AND OTHER HEALTH SERVICES,RENAL STATISTICAL DATA,COMPUTATION OF RATIO OF COST TO CHARGES,APPORTIONMENT OF INPATIENT/OUTPATIENT ANCILLARY SERVICE OTHER PASS THROUGH COSTS,APPORTIONMENT OF MEDICAL AND OTHER HEALTH SERVICES,INPATIENT ANCILLARY SERVICE COST APPORTIONMENT,INPATIENT ANCILLARY SERVICE COST APPORTIONMENT,APPORTIONMENT OF INPATIENT/OUTPATIENT ANCILLARY SERVICE OTHER PASS THROUGH COSTS,APPORTIONMENT OF INPATIENT/OUTPATIENT ANCILLARY SERVICE OTHER PASS THROUGH COSTS,S-10 DATA,INPATIENT ANCILLARY SERVICE COST APPORTIONMENT,APPORTIONMENT OF MEDICAL AND OTHER HEALTH SERVICES,CALCULATION OF REIMBURSEMENT SETTLEMENT (PPS),Total Inpatient Days/Outpatient Visits,ANALYSIS OF CHANGES IN NEW CAPITAL BALANCES,COST ALLOCATION,ALLOCATION OF NEW CAPITAL COSTS,TRIAL BALANCE OF EXPENSE ACCOUNTS,ALLOCATION OF NEW CAPITAL COSTS,CALCULATION OF REIMBURSEMENT SETTLEMENT,Total Inpatient Days/Outpatient Visits,APPORTIONMENT OF INPATIENT/OUTPATIENT ANCILLARY SERVICE OTHER PASS THROUGH COSTS,HOSPITAL WAGE INDEX DATA,COST ALLOCATION,APPORTIONMENT OF INPATIENT/OUTPATIENT ANCILLARY SERVICE OTHER PASS THROUGH COSTS,INPATIENT ANCILLARY SERVICE COST APPORTIONMENT,INPATIENT ANCILLARY SERVICE COST APPORTIONMENT,,COST ALLOCATION,INPATIENT ANCILLARY SERVICE COST APPORTIONMENT,S-10 DATA,COST ALLOCATION,COMPUTATION OF RATIO OF COST TO CHARGES,HHA STATISTICAL DATA,APPORTIONMENT OF INPATIENT/OUTPATIENT ANCILLARY SERVICE OTHER PASS THROUGH COSTS,APPORTIONMENT OF INPATIENT/OUTPATIENT ANCILLARY SERVICE OTHER PASS THROUGH COSTS,TRIAL BALANCE OF EXPENSE ACCOUNTS,COMPUTATION OF INPATIENT OPERATING COSTS,COST ALLOCATION,ALLOCATION OF NEW CAPITAL COSTS,COST ALLOCATION,COST ALLOCATION,,APPORTIONMENT OF INPATIENT/OUTPATIENT ANCILLARY SERVICE OTHER PASS THROUGH COSTS,STATEMENT OF REVENUES AND EXPENSES,COMPUTATION OF RATIO OF COST TO CHARGES,HOSPITAL WAGE INDEX DATA,COST ALLOCATION,HOSPITAL WAGE INDEX DATA,TRIAL BALANCE OF EXPENSE ACCOUNTS,COST ALLOCATION,HOSPITAL WAGE INDEX DATA,APPORTIONMENT OF INPATIENT/OUTPATIENT ANCILLARY SERVICE OTHER PASS THROUGH COSTS,APPORTIONMENT OF MEDICAL AND OTHER HEALTH SERVICES,CALCULATION OF REIMBURSEMENT SETTLEMENT,APPORTIONMENT OF INPATIENT/OUTPATIENT ANCILLARY SERVICE OTHER PASS THROUGH COSTS,HHA STATISTICAL DATA,APPORTIONMENT OF INPATIENT/OUTPATIENT ANCILLARY SERVICE OTHER PASS THROUGH COSTS,HOSPITAL WAGE INDEX DATA,INPATIENT ANCILLARY SERVICE COST APPORTIONMENT,APPORTIONMENT OF INPATIENT/OUTPATIENT ANCILLARY SERVICE OTHER PASS THROUGH COSTS,APPORTIONMENT OF MEDICAL AND OTHER HEALTH SERVICES,COST ALLOCATION,APPORTIONMENT OF MEDICAL AND OTHER HEALTH SERVICES,APPORTIONMENT OF MEDICAL AND OTHER HEALTH SERVICES,COMPUTATION OF RATIO OF COST TO CHARGES,INPATIENT ANCILLARY SERVICE COST APPORTIONMENT,APPORTIONMENT OF MEDICAL AND OTHER HEALTH SERVICES,COST ALLOCATION,HOSPITAL WAGE INDEX DATA,COST ALLOCATION,HHA STATISTICAL DATA,ADJUSTMENTS,COMPUTATION OF RATIO OF COST TO CHARGES,COMPUTATION OF RATIO OF COST TO CHARGES,Total Inpatient Days/Outpatient Visits,ALLOCATION OF NEW CAPITAL COSTS,COMPUTATION OF RATIO OF COST TO CHARGES,APPORTIONMENT OF INPATIENT/OUTPATIENT ANCILLARY SERVICE OTHER PASS THROUGH COSTS,COMPUTATION OF RATIO OF COST TO CHARGES,TRIAL BALANCE OF EXPENSE ACCOUNTS,,APPORTIONMENT OF INPATIENT/OUTPATIENT ANCILLARY SERVICE OTHER PASS THROUGH COSTS,RECONCILIATION OF CAPITAL COST CENTERS,HOSPITAL WAGE INDEX DATA,COST ALLOCATION,COMPUTATION OF INPATIENT OPERATING COSTS,COMPUTATION OF RATIO OF COST TO CHARGES,HOSPITAL IDENTIFICATION INFORMATION,HOSPITAL WAGE INDEX DATA,,HOSPITAL WAGE INDEX DATA,S-10 DATA,APPORTIONMENT OF INPATIENT/OUTPATIENT ANCILLARY SERVICE OTHER PASS THROUGH COSTS,INPATIENT ANCILLARY SERVICE COST APPORTIONMENT,HOSPITAL WAGE INDEX DATA,HOSPITAL WAGE INDEX DATA,COMPUTATION OF RATIO OF COST TO CHARGES,Total Inpatient Days/Outpatient Visits,BALANCE SHEET,APPORTIONMENT OF INPATIENT/OUTPATIENT ANCILLARY SERVICE OTHER PASS THROUGH COSTS,TRIAL BALANCE OF EXPENSE ACCOUNTS,CALCULATION OF REIMBURSEMENT SETTLEMENT,HOSPITAL WAGE INDEX DATA,,APPORTIONMENT OF MEDICAL AND OTHER HEALTH SERVICES,APPORTIONMENT OF INPATIENT/OUTPATIENT ANCILLARY SERVICE OTHER PASS THROUGH COSTS,APPORTIONMENT OF INPATIENT/OUTPATIENT ANCILLARY SERVICE OTHER PASS THROUGH COSTS,TRIAL BALANCE OF EXPENSE ACCOUNTS,INPATIENT ANCILLARY SERVICE COST APPORTIONMENT,HHA STATISTICAL DATA,INPATIENT ANCILLARY SERVICE COST APPORTIONMENT,RECONCILIATION OF CAPITAL COST CENTERS,APPORTIONMENT OF MEDICAL AND OTHER HEALTH SERVICES,HOSPITAL WAGE INDEX DATA,COST ALLOCATION,INPATIENT ANCILLARY SERVICE COST APPORTIONMENT,ALLOCATION OF NEW CAPITAL COSTS,INPATIENT ANCILLARY SERVICE COST APPORTIONMENT,TRIAL BALANCE OF EXPENSE ACCOUNTS,COMPUTATION OF RATIO OF COST TO CHARGES,APPORTIONMENT OF INPATIENT/OUTPATIENT ANCILLARY SERVICE OTHER PASS THROUGH COSTS,APPORTIONMENT OF INPATIENT/OUTPATIENT ANCILLARY SERVICE OTHER PASS THROUGH COSTS,APPORTIONMENT OF MEDICAL AND OTHER HEALTH SERVICES,INPATIENT ANCILLARY SERVICE COST APPORTIONMENT,TRIAL BALANCE OF EXPENSE ACCOUNTS,COST ALLOCATION,ALLOCATION OF NEW CAPITAL COSTS,APPORTIONMENT OF MEDICAL AND OTHER HEALTH SERVICES,APPORTIONMENT OF MEDICAL AND OTHER HEALTH SERVICES,COST ALLOCATION,,APPORTIONMENT OF INPATIENT/OUTPATIENT ANCILLARY SERVICE OTHER PASS THROUGH COSTS,TRIAL BALANCE OF EXPENSE ACCOUNTS,COMPUTATION OF RATIO OF COST TO CHARGES,APPORTIONMENT OF INPATIENT/OUTPATIENT ANCILLARY SERVICE OTHER PASS THROUGH COSTS,HHA STATISTICAL DATA,,TRIAL BALANCE OF EXPENSE ACCOUNTS,HOSPITAL WAGE INDEX DATA,APPORTIONMENT OF INPATIENT/OUTPATIENT ANCILLARY SERVICE OTHER PASS THROUGH COSTS,APPORTIONMENT OF MEDICAL AND OTHER HEALTH SERVICES,INPATIENT ANCILLARY SERVICE COST APPORTIONMENT,HHA STATISTICAL DATA,APPORTIONMENT OF INPATIENT/OUTPATIENT ANCILLARY SERVICE OTHER PASS THROUGH COSTS,RENAL STATISTICAL DATA,TRIAL BALANCE OF EXPENSE ACCOUNTS,COST ALLOCATION,TRIAL BALANCE OF EXPENSE ACCOUNTS,COST ALLOCATION,HOSPITAL WAGE INDEX DATA,HOSPITAL WAGE INDEX DATA,Total Inpatient Days/Outpatient Visits,TRIAL BALANCE OF EXPENSE ACCOUNTS,APPORTIONMENT OF MEDICAL AND OTHER HEALTH SERVICES,APPORTIONMENT OF INPATIENT/OUTPATIENT ANCILLARY SERVICE OTHER PASS THROUGH COSTS,TRIAL BALANCE OF EXPENSE ACCOUNTS,COST ALLOCATION,APPORTIONMENT OF INPATIENT/OUTPATIENT ANCILLARY SERVICE OTHER PASS THROUGH COSTS,COST ALLOCATION,RECONCILIATION OF CAPITAL COST CENTERS,ALLOCATION OF NEW CAPITAL COSTS,CALCULATION OF REIMBURSEMENT SETTLEMENT,TRIAL BALANCE OF EXPENSE ACCOUNTS,APPORTIONMENT OF INPATIENT/OUTPATIENT ANCILLARY SERVICE OTHER PASS THROUGH COSTS,COST ALLOCATION,TRIAL BALANCE OF EXPENSE ACCOUNTS,NUMBER OF BEDS,Total Inpatient Days/Outpatient Visits,COST ALLOCATION,COMPUTATION OF INPATIENT OPERATING COSTS,HOSPITAL WAGE INDEX DATA,INPATIENT ANCILLARY SERVICE COST APPORTIONMENT,COMPUTATION OF RATIO OF COST TO CHARGES,TRIAL BALANCE OF EXPENSE ACCOUNTS,COST ALLOCATION,APPORTIONMENT OF INPATIENT/OUTPATIENT ANCILLARY SERVICE OTHER PASS THROUGH COSTS,COST ALLOCATION,,TRIAL BALANCE OF EXPENSE ACCOUNTS,APPORTIONMENT OF MEDICAL AND OTHER HEALTH SERVICES,TRIAL BALANCE OF EXPENSE ACCOUNTS,COMPUTATION OF RATIO OF COST TO CHARGES,TRIAL BALANCE OF EXPENSE ACCOUNTS,TRIAL BALANCE OF EXPENSE ACCOUNTS,ANALYSIS OF CHANGES IN NEW CAPITAL BALANCES,APPORTIONMENT OF INPATIENT/OUTPATIENT ANCILLARY SERVICE OTHER PASS THROUGH COSTS,RENAL STATISTICAL DATA,RECONCILIATION OF CAPITAL COST CENTERS,COMPUTATION OF RATIO OF COST TO CHARGES,INPATIENT ANCILLARY SERVICE COST APPORTIONMENT,APPORTIONMENT OF INPATIENT ROUTINE SERVICE CAPITAL COSTS,COST ALLOCATION,APPORTIONMENT OF INPATIENT/OUTPATIENT ANCILLARY SERVICE OTHER PASS THROUGH COSTS,Total Inpatient Days/Outpatient Visits,HHA STATISTICAL DATA,,APPORTIONMENT OF MEDICAL AND OTHER HEALTH SERVICES,ALLOCATION OF NEW CAPITAL COSTS,ANALYSIS OF CHANGES IN NEW CAPITAL BALANCES,COMPUTATION OF RATIO OF COST TO CHARGES,APPORTIONMENT OF INPATIENT/OUTPATIENT ANCILLARY SERVICE OTHER PASS THROUGH COSTS,INPATIENT ANCILLARY SERVICE COST APPORTIONMENT,COMPUTATION OF RATIO OF COST TO CHARGES,APPORTIONMENT OF INPATIENT/OUTPATIENT ANCILLARY SERVICE OTHER PASS THROUGH COSTS,HOSPITAL WAGE INDEX DATA,APPORTIONMENT OF INPATIENT/OUTPATIENT ANCILLARY SERVICE OTHER PASS THROUGH COSTS,HHA STATISTICAL DATA,INPATIENT ANCILLARY SERVICE COST APPORTIONMENT,COST ALLOCATION,,INPATIENT ANCILLARY SERVICE COST APPORTIONMENT,COMPUTATION OF RATIO OF COST TO CHARGES,TRIAL BALANCE OF EXPENSE ACCOUNTS,HOSPITAL WAGE INDEX DATA,COST ALLOCATION,INPATIENT ANCILLARY SERVICE COST APPORTIONMENT,APPORTIONMENT OF MEDICAL AND OTHER HEALTH SERVICES,INPATIENT ANCILLARY SERVICE COST APPORTIONMENT,COMPUTATION OF INPATIENT OPERATING COSTS,COST ALLOCATION,,COMPUTATION OF RATIO OF COST TO CHARGES,HHA STATISTICAL DATA,TRIAL BALANCE OF EXPENSE ACCOUNTS,APPORTIONMENT OF INPATIENT/OUTPATIENT ANCILLARY SERVICE OTHER PASS THROUGH COSTS,INPATIENT ANCILLARY SERVICE COST APPORTIONMENT,COST ALLOCATION,INPATIENT ANCILLARY SERVICE COST APPORTIONMENT,INPATIENT ANCILLARY SERVICE COST APPORTIONMENT,APPORTIONMENT OF MEDICAL AND OTHER HEALTH SERVICES,COMPUTATION OF RATIO OF COST TO CHARGES,APPORTIONMENT OF INPATIENT/OUTPATIENT ANCILLARY SERVICE OTHER PASS THROUGH COSTS,COST ALLOCATION,TRIAL BALANCE OF EXPENSE ACCOUNTS,ADJUSTMENTS,,COMPUTATION OF RATIO OF COST TO CHARGES,COST ALLOCATION,HOSPITAL WAGE INDEX DATA,BALANCE SHEET,INPATIENT ANCILLARY SERVICE COST APPORTIONMENT,RENAL STATISTICAL DATA,TRIAL BALANCE OF EXPENSE ACCOUNTS,APPORTIONMENT OF INPATIENT/OUTPATIENT ANCILLARY SERVICE OTHER PASS THROUGH COSTS,COMPUTATION OF INPATIENT OPERATING COSTS,COST ALLOCATION,INPATIENT ANCILLARY SERVICE COST APPORTIONMENT,COMPUTATION OF RATIO OF COST TO CHARGES,APPORTIONMENT OF MEDICAL AND OTHER HEALTH SERVICES,INPATIENT ANCILLARY SERVICE COST APPORTIONMENT,Total Inpatient Days/Outpatient Visits,COST ALLOCATION,COST ALLOCATION,HHA STATISTICAL DATA,TRIAL BALANCE OF EXPENSE ACCOUNTS,Total Inpatient Days/Outpatient Visits,APPORTIONMENT OF INPATIENT/OUTPATIENT ANCILLARY SERVICE OTHER PASS THROUGH COSTS,INPATIENT ANCILLARY SERVICE COST APPORTIONMENT,APPORTIONMENT OF INPATIENT/OUTPATIENT ANCILLARY SERVICE OTHER PASS THROUGH COSTS,APPORTIONMENT OF MEDICAL AND OTHER HEALTH SERVICES,RECONCILIATION OF CAPITAL COST CENTERS,ALLOCATION OF NEW CAPITAL COSTS,ADJUSTMENTS,INPATIENT ANCILLARY SERVICE COST APPORTIONMENT,APPORTIONMENT OF INPATIENT/OUTPATIENT ANCILLARY SERVICE OTHER PASS THROUGH COSTS,APPORTIONMENT OF INPATIENT/OUTPATIENT ANCILLARY SERVICE OTHER PASS THROUGH COSTS,COMPUTATION OF INPATIENT OPERATING COSTS,INPATIENT ANCILLARY SERVICE COST APPORTIONMENT,TRIAL BALANCE OF EXPENSE ACCOUNTS,BED DAYS AVAILABLE,APPORTIONMENT OF INPATIENT ROUTINE SERVICE CAPITAL COSTS,APPORTIONMENT OF INPATIENT/OUTPATIENT ANCILLARY SERVICE OTHER PASS THROUGH COSTS,TRIAL BALANCE OF EXPENSE ACCOUNTS,INPATIENT ANCILLARY SERVICE COST APPORTIONMENT,RECONCILIATION OF CAPITAL COST CENTERS,STATEMENT OF REVENUES AND EXPENSES,APPORTIONMENT OF MEDICAL AND OTHER HEALTH SERVICES,COMPUTATION OF RATIO OF COST TO CHARGES,INPATIENT ANCILLARY SERVICE COST APPORTIONMENT,HOSPITAL WAGE INDEX DATA,COST ALLOCATION,COST ALLOCATION,APPORTIONMENT OF INPATIENT/OUTPATIENT ANCILLARY SERVICE OTHER PASS THROUGH COSTS,COST ALLOCATION,ANALYSIS OF CHANGES IN NEW CAPITAL BALANCES,INPATIENT ANCILLARY SERVICE COST APPORTIONMENT,APPORTIONMENT OF INPATIENT/OUTPATIENT ANCILLARY SERVICE OTHER PASS THROUGH COSTS,TRIAL BALANCE OF EXPENSE ACCOUNTS,ANALYSIS OF CHANGES IN NEW CAPITAL BALANCES,HOSPITAL WAGE INDEX DATA,TRIAL BALANCE OF EXPENSE ACCOUNTS,COST ALLOCATION,APPORTIONMENT OF INPATIENT/OUTPATIENT ANCILLARY SERVICE OTHER PASS THROUGH COSTS,APPORTIONMENT OF MEDICAL AND OTHER HEALTH SERVICES,Total Inpatient Days/Outpatient Visits,COST ALLOCATION,CALCULATION OF REIMBURSEMENT SETTLEMENT,S-10 DATA,CALCULATION OF REIMBURSEMENT SETTLEMENT,APPORTIONMENT OF INPATIENT/OUTPATIENT ANCILLARY SERVICE OTHER PASS THROUGH COSTS,APPORTIONMENT OF INPATIENT/OUTPATIENT ANCILLARY SERVICE OTHER PASS THROUGH COSTS,Total Inpatient Days/Outpatient Visits,HHA STATISTICAL DATA,APPORTIONMENT OF INPATIENT/OUTPATIENT ANCILLARY SERVICE OTHER PASS THROUGH COSTS,TRIAL BALANCE OF EXPENSE ACCOUNTS,TRIAL BALANCE OF EXPENSE ACCOUNTS,COMPUTATION OF RATIO OF COST TO CHARGES,APPORTIONMENT OF MEDICAL AND OTHER HEALTH SERVICES,APPORTIONMENT OF INPATIENT/OUTPATIENT ANCILLARY SERVICE OTHER PASS THROUGH COSTS,INPATIENT ANCILLARY SERVICE COST APPORTIONMENT,CALCULATION OF REIMBURSEMENT SETTLEMENT,COST ALLOCATION,ALLOCATION OF NEW CAPITAL COSTS,APPORTIONMENT OF INPATIENT/OUTPATIENT ANCILLARY SERVICE OTHER PASS THROUGH COSTS,ANALYSIS OF CHANGES IN NEW CAPITAL BALANCES,APPORTIONMENT OF INPATIENT/OUTPATIENT ANCILLARY SERVICE OTHER PASS THROUGH COSTS,,APPORTIONMENT OF INPATIENT/OUTPATIENT ANCILLARY SERVICE OTHER PASS THROUGH COSTS,INPATIENT ANCILLARY SERVICE COST APPORTIONMENT,S-10 DATA,COST ALLOCATION,CALCULATION OF REIMBURSEMENT SETTLEMENT,COST ALLOCATION,Total Inpatient Days/Outpatient Visits,APPORTIONMENT OF INPATIENT/OUTPATIENT ANCILLARY SERVICE OTHER PASS THROUGH COSTS,COST ALLOCATION,COST ALLOCATION,APPORTIONMENT OF MEDICAL AND OTHER HEALTH SERVICES,INPATIENT ANCILLARY SERVICE COST APPORTIONMENT,BALANCE SHEET,,COST ALLOCATION,APPORTIONMENT OF INPATIENT/OUTPATIENT ANCILLARY SERVICE OTHER PASS THROUGH COSTS,HOSPITAL WAGE INDEX DATA,APPORTIONMENT OF INPATIENT/OUTPATIENT ANCILLARY SERVICE OTHER PASS THROUGH COSTS,COST ALLOCATION,TRIAL BALANCE OF EXPENSE ACCOUNTS,HOSPITAL WAGE INDEX DATA,TRIAL BALANCE OF EXPENSE ACCOUNTS,TRIAL BALANCE OF EXPENSE ACCOUNTS,TRIAL BALANCE OF EXPENSE ACCOUNTS,,INPATIENT ANCILLARY SERVICE COST APPORTIONMENT,ANALYSIS OF CHANGES IN NEW CAPITAL BALANCES,TRIAL BALANCE OF EXPENSE ACCOUNTS,Total Inpatient Days/Outpatient Visits,APPORTIONMENT OF MEDICAL AND OTHER HEALTH SERVICES,COMPUTATION OF RATIO OF COST TO CHARGES,BALANCE SHEET,APPORTIONMENT OF INPATIENT/OUTPATIENT ANCILLARY SERVICE OTHER PASS THROUGH COSTS,TRIAL BALANCE OF EXPENSE ACCOUNTS,CALCULATION OF REIMBURSEMENT SETTLEMENT (PPS),CALCULATION OF REIMBURSEMENT SETTLEMENT,APPORTIONMENT OF MEDICAL AND OTHER HEALTH SERVICES,APPORTIONMENT OF INPATIENT/OUTPATIENT ANCILLARY SERVICE OTHER PASS THROUGH COSTS,TRIAL BALANCE OF EXPENSE ACCOUNTS,TRIAL BALANCE OF EXPENSE ACCOUNTS,APPORTIONMENT OF INPATIENT/OUTPATIENT ANCILLARY SERVICE OTHER PASS THROUGH COSTS,HOSPITAL WAGE INDEX DATA,INPATIENT ANCILLARY SERVICE COST APPORTIONMENT,S-10 DATA,RENAL STATISTICAL DATA,BED DAYS AVAILABLE,Medicare Inpatient Days/Outpatient Visits,APPORTIONMENT OF MEDICAL AND OTHER HEALTH SERVICES,TRIAL BALANCE OF EXPENSE ACCOUNTS,APPORTIONMENT OF INPATIENT/OUTPATIENT ANCILLARY SERVICE OTHER PASS THROUGH COSTS,ANALYSIS OF CHANGES IN NEW CAPITAL BALANCES,RENAL STATISTICAL DATA,Total Inpatient Days/Outpatient Visits,INPATIENT ANCILLARY SERVICE COST APPORTIONMENT,HOSPITAL WAGE INDEX DATA,COST ALLOCATION,ALLOCATION OF NEW CAPITAL COSTS,TRIAL BALANCE OF EXPENSE ACCOUNTS,APPORTIONMENT OF INPATIENT/OUTPATIENT ANCILLARY SERVICE OTHER PASS THROUGH COSTS,ALLOCATION OF NEW CAPITAL COSTS,INPATIENT ANCILLARY SERVICE COST APPORTIONMENT,ANALYSIS OF CHANGES IN NEW CAPITAL BALANCES,APPORTIONMENT OF INPATIENT/OUTPATIENT ANCILLARY SERVICE OTHER PASS THROUGH COSTS,TRIAL BALANCE OF EXPENSE ACCOUNTS,APPORTIONMENT OF MEDICAL AND OTHER HEALTH SERVICES,COST ALLOCATION,APPORTIONMENT OF INPATIENT ROUTINE SERVICE CAPITAL COSTS,COST ALLOCATION,APPORTIONMENT OF MEDICAL AND OTHER HEALTH SERVICES,HOSPITAL WAGE INDEX DATA,COMPUTATION OF RATIO OF COST TO CHARGES,COMPUTATION OF INPATIENT OPERATING COSTS,COMPUTATION OF RATIO OF COST TO CHARGES,HOSPITAL WAGE INDEX DATA,TRIAL BALANCE OF EXPENSE ACCOUNTS,Total Inpatient Days/Outpatient Visits,HOSPITAL WAGE INDEX DATA,,ALLOCATION OF NEW CAPITAL COSTS,COST ALLOCATION,APPORTIONMENT OF INPATIENT/OUTPATIENT ANCILLARY SERVICE OTHER PASS THROUGH COSTS,HOSPITAL WAGE INDEX DATA,COMPUTATION OF RATIO OF COST TO CHARGES,INPATIENT ANCILLARY SERVICE COST APPORTIONMENT,S-10 DATA,Total Inpatient Days/Outpatient Visits,,APPORTIONMENT OF MEDICAL AND OTHER HEALTH SERVICES,APPORTIONMENT OF INPATIENT/OUTPATIENT ANCILLARY SERVICE OTHER PASS THROUGH COSTS,HOSPITAL WAGE INDEX DATA,S-10 DATA,APPORTIONMENT OF INPATIENT ROUTINE SERVICE CAPITAL COSTS,RENAL STATISTICAL DATA,BALANCE SHEET,APPORTIONMENT OF MEDICAL AND OTHER HEALTH SERVICES,ALLOCATION OF NEW CAPITAL COSTS,CALCULATION OF REIMBURSEMENT SETTLEMENT,COST ALLOCATION,TRIAL BALANCE OF EXPENSE ACCOUNTS,HHA STATISTICAL DATA,,APPORTIONMENT OF INPATIENT ROUTINE SERVICE CAPITAL COSTS,APPORTIONMENT OF INPATIENT/OUTPATIENT ANCILLARY SERVICE OTHER PASS THROUGH COSTS,BED DAYS AVAILABLE,TRIAL BALANCE OF EXPENSE ACCOUNTS,TRIAL BALANCE OF EXPENSE ACCOUNTS,COST ALLOCATION,APPORTIONMENT OF INPATIENT ROUTINE SERVICE CAPITAL COSTS,ADJUSTMENTS,COST ALLOCATION,TRIAL BALANCE OF EXPENSE ACCOUNTS,TRIAL BALANCE OF EXPENSE ACCOUNTS,NUMBER OF BEDS,APPORTIONMENT OF INPATIENT/OUTPATIENT ANCILLARY SERVICE OTHER PASS THROUGH COSTS,COMPUTATION OF RATIO OF COST TO CHARGES,APPORTIONMENT OF MEDICAL AND OTHER HEALTH SERVICES,APPORTIONMENT OF INPATIENT/OUTPATIENT ANCILLARY SERVICE OTHER PASS THROUGH COSTS,TRIAL BALANCE OF EXPENSE ACCOUNTS,COMPUTATION OF RATIO OF COST TO CHARGES,,APPORTIONMENT OF MEDICAL AND OTHER HEALTH SERVICES,,APPORTIONMENT OF MEDICAL AND OTHER HEALTH SERVICES,INPATIENT ANCILLARY SERVICE COST APPORTIONMENT,TRIAL BALANCE OF EXPENSE ACCOUNTS,COST ALLOCATION,APPORTIONMENT OF INPATIENT/OUTPATIENT ANCILLARY SERVICE OTHER PASS THROUGH COSTS,,COMPUTATION OF RATIO OF COST TO CHARGES,APPORTIONMENT OF INPATIENT/OUTPATIENT ANCILLARY SERVICE OTHER PASS THROUGH COSTS,INPATIENT ANCILLARY SERVICE COST APPORTIONMENT,CALCULATION OF REIMBURSEMENT SETTLEMENT,COST ALLOCATION,COST ALLOCATION,BED DAYS AVAILABLE,APPORTIONMENT OF INPATIENT/OUTPATIENT ANCILLARY SERVICE OTHER PASS THROUGH COSTS,COMPUTATION OF RATIO OF COST TO CHARGES,,BALANCE SHEET,COST ALLOCATION,BED DAYS AVAILABLE,APPORTIONMENT OF INPATIENT ROUTINE SERVICE CAPITAL COSTS,APPORTIONMENT OF INPATIENT/OUTPATIENT ANCILLARY SERVICE OTHER PASS THROUGH COSTS,,ADJUSTMENTS,COST ALLOCATION,INPATIENT ANCILLARY SERVICE COST APPORTIONMENT,,TRIAL BALANCE OF EXPENSE ACCOUNTS,INPATIENT ANCILLARY SERVICE COST APPORTIONMENT,INPATIENT ANCILLARY SERVICE COST APPORTIONMENT,APPORTIONMENT OF INPATIENT/OUTPATIENT ANCILLARY SERVICE OTHER PASS THROUGH COSTS,TRIAL BALANCE OF EXPENSE ACCOUNTS,,APPORTIONMENT OF INPATIENT/OUTPATIENT ANCILLARY SERVICE OTHER PASS THROUGH COSTS,INPATIENT ANCILLARY SERVICE COST APPORTIONMENT,BALANCE SHEET,HOSPITAL WAGE INDEX DATA,INPATIENT ANCILLARY SERVICE COST APPORTIONMENT,COST ALLOCATION,Total Inpatient Days/Outpatient Visits,Total Inpatient Days/Outpatient Visits,APPORTIONMENT OF MEDICAL AND OTHER HEALTH SERVICES,RENAL STATISTICAL DATA,CALCULATION OF REIMBURSEMENT SETTLEMENT,HOSPITAL WAGE INDEX DATA,ALLOCATION OF NEW CAPITAL COSTS,BALANCE SHEET,APPORTIONMENT OF MEDICAL AND OTHER HEALTH SERVICES,APPORTIONMENT OF INPATIENT ROUTINE SERVICE CAPITAL COSTS,COST ALLOCATION,APPORTIONMENT OF INPATIENT/OUTPATIENT ANCILLARY SERVICE OTHER PASS THROUGH COSTS,INPATIENT ANCILLARY SERVICE COST APPORTIONMENT,INPATIENT ANCILLARY SERVICE COST APPORTIONMENT,COMPUTATION OF RATIO OF COST TO CHARGES,HOSPITAL WAGE INDEX DATA,APPORTIONMENT OF INPATIENT/OUTPATIENT ANCILLARY SERVICE OTHER PASS THROUGH COSTS,BED DAYS AVAILABLE,TRIAL BALANCE OF EXPENSE ACCOUNTS,COST ALLOCATION,APPORTIONMENT OF INPATIENT/OUTPATIENT ANCILLARY SERVICE OTHER PASS THROUGH COSTS,,APPORTIONMENT OF MEDICAL AND OTHER HEALTH SERVICES,COST ALLOCATION,APPORTIONMENT OF INPATIENT ROUTINE SERVICE CAPITAL COSTS,INPATIENT ANCILLARY SERVICE COST APPORTIONMENT,INPATIENT ANCILLARY SERVICE COST APPORTIONMENT,COST ALLOCATION,,NUMBER OF BEDS,APPORTIONMENT OF INPATIENT/OUTPATIENT ANCILLARY SERVICE OTHER PASS THROUGH COSTS,ALLOCATION OF NEW CAPITAL COSTS,COST ALLOCATION,COMPUTATION OF RATIO OF COST TO CHARGES,APPORTIONMENT OF INPATIENT/OUTPATIENT ANCILLARY SERVICE OTHER PASS THROUGH COSTS,COST ALLOCATION,APPORTIONMENT OF INPATIENT/OUTPATIENT ANCILLARY SERVICE OTHER PASS THROUGH COSTS,COMPUTATION OF RATIO OF COST TO CHARGES,BED DAYS AVAILABLE,APPORTIONMENT OF INPATIENT ROUTINE SERVICE OTHER PASS THROUGH COSTS,COST ALLOCATION,COST ALLOCATION,APPORTIONMENT OF MEDICAL AND OTHER HEALTH SERVICES,RENAL STATISTICAL DATA,,INPATIENT ANCILLARY SERVICE COST APPORTIONMENT,,HOSPITAL WAGE INDEX DATA,APPORTIONMENT OF INPATIENT/OUTPATIENT ANCILLARY SERVICE OTHER PASS THROUGH COSTS,,APPORTIONMENT OF INPATIENT/OUTPATIENT ANCILLARY SERVICE OTHER PASS THROUGH COSTS,TRIAL BALANCE OF EXPENSE ACCOUNTS,TRIAL BALANCE OF EXPENSE ACCOUNTS,COMPUTATION OF RATIO OF COST TO CHARGES,COMPUTATION OF RATIO OF COST TO CHARGES,INPATIENT ANCILLARY SERVICE COST APPORTIONMENT,INPATIENT ANCILLARY SERVICE COST APPORTIONMENT,COMPUTATION OF INPATIENT OPERATING COSTS,ANALYSIS OF CHANGES IN NEW CAPITAL BALANCES,INPATIENT ANCILLARY SERVICE COST APPORTIONMENT,COST ALLOCATION,ANALYSIS OF CHANGES IN NEW CAPITAL BALANCES,HHA STATISTICAL DATA,APPORTIONMENT OF MEDICAL AND OTHER HEALTH SERVICES,S-10 DATA,ANALYSIS OF CHANGES IN NEW CAPITAL BALANCES,TRIAL BALANCE OF EXPENSE ACCOUNTS,APPORTIONMENT OF MEDICAL AND OTHER HEALTH SERVICES,APPORTIONMENT OF INPATIENT/OUTPATIENT ANCILLARY SERVICE OTHER PASS THROUGH COSTS,HOSPITAL WAGE INDEX DATA,APPORTIONMENT OF INPATIENT/OUTPATIENT ANCILLARY SERVICE OTHER PASS THROUGH COSTS,APPORTIONMENT OF INPATIENT/OUTPATIENT ANCILLARY SERVICE OTHER PASS THROUGH COSTS,,APPORTIONMENT OF MEDICAL AND OTHER HEALTH SERVICES,COST ALLOCATION,,HOSPITAL WAGE INDEX DATA,INPATIENT ANCILLARY SERVICE COST APPORTIONMENT,COMPUTATION OF INPATIENT OPERATING COSTS,TRIAL BALANCE OF EXPENSE ACCOUNTS,ANALYSIS OF CHANGES IN NEW CAPITAL BALANCES,APPORTIONMENT OF INPATIENT/OUTPATIENT ANCILLARY SERVICE OTHER PASS THROUGH COSTS,APPORTIONMENT OF INPATIENT/OUTPATIENT ANCILLARY SERVICE OTHER PASS THROUGH COSTS,COMPUTATION OF INPATIENT OPERATING COSTS,RENAL STATISTICAL DATA,INPATIENT ANCILLARY SERVICE COST APPORTIONMENT,APPORTIONMENT OF INPATIENT/OUTPATIENT ANCILLARY SERVICE OTHER PASS THROUGH COSTS,APPORTIONMENT OF MEDICAL AND OTHER HEALTH SERVICES,APPORTIONMENT OF INPATIENT/OUTPATIENT ANCILLARY SERVICE OTHER PASS THROUGH COSTS,HOSPITAL WAGE INDEX DATA,TRIAL BALANCE OF EXPENSE ACCOUNTS,Total Inpatient Days/Outpatient Visits,INPATIENT ANCILLARY SERVICE COST APPORTIONMENT,INPATIENT ANCILLARY SERVICE COST APPORTIONMENT,INPATIENT ANCILLARY SERVICE COST APPORTIONMENT,HHA STATISTICAL DATA,COMPUTATION OF RATIO OF COST TO CHARGES,APPORTIONMENT OF INPATIENT/OUTPATIENT ANCILLARY SERVICE OTHER PASS THROUGH COSTS,COST ALLOCATION,APPORTIONMENT OF INPATIENT/OUTPATIENT ANCILLARY SERVICE OTHER PASS THROUGH COSTS,ALLOCATION OF NEW CAPITAL COSTS,BALANCE SHEET,S-10 DATA,,COMPUTATION OF RATIO OF COST TO CHARGES,COST ALLOCATION,RENAL STATISTICAL DATA,HHA STATISTICAL DATA,COMPUTATION OF RATIO OF COST TO CHARGES,COST ALLOCATION,TRIAL BALANCE OF EXPENSE ACCOUNTS,INPATIENT ANCILLARY SERVICE COST APPORTIONMENT,COMPUTATION OF INPATIENT OPERATING COSTS,Medicaid Inpatient Days/Outpatient Visits,COST ALLOCATION,COST ALLOCATION,INPATIENT ANCILLARY SERVICE COST APPORTIONMENT,TRIAL BALANCE OF EXPENSE ACCOUNTS,COST ALLOCATION,APPORTIONMENT OF MEDICAL AND OTHER HEALTH SERVICES,HOSPITAL WAGE INDEX DATA,COST ALLOCATION,COMPUTATION OF RATIO OF COST TO CHARGES,APPORTIONMENT OF INPATIENT/OUTPATIENT ANCILLARY SERVICE OTHER PASS THROUGH COSTS,Medicaid Inpatient Days/Outpatient Visits,INPATIENT ANCILLARY SERVICE COST APPORTIONMENT,APPORTIONMENT OF MEDICAL AND OTHER HEALTH SERVICES,APPORTIONMENT OF INPATIENT/OUTPATIENT ANCILLARY SERVICE OTHER PASS THROUGH COSTS,INPATIENT ANCILLARY SERVICE COST APPORTIONMENT,INPATIENT ANCILLARY SERVICE COST APPORTIONMENT,APPORTIONMENT OF INPATIENT/OUTPATIENT ANCILLARY SERVICE OTHER PASS THROUGH COSTS,INPATIENT ANCILLARY SERVICE COST APPORTIONMENT,APPORTIONMENT OF INPATIENT/OUTPATIENT ANCILLARY SERVICE OTHER PASS THROUGH COSTS,APPORTIONMENT OF MEDICAL AND OTHER HEALTH SERVICES,HOSPITAL WAGE INDEX DATA,COMPUTATION OF RATIO OF COST TO CHARGES,APPORTIONMENT OF INPATIENT/OUTPATIENT ANCILLARY SERVICE OTHER PASS THROUGH COSTS,INPATIENT ANCILLARY SERVICE COST APPORTIONMENT,Medicare Inpatient Days/Outpatient Visits,TRIAL BALANCE OF EXPENSE ACCOUNTS,APPORTIONMENT OF MEDICAL AND OTHER HEALTH SERVICES,COST ALLOCATION,,COMPUTATION OF RATIO OF COST TO CHARGES,COST ALLOCATION,Total Inpatient Days/Outpatient Visits,,APPORTIONMENT OF INPATIENT/OUTPATIENT ANCILLARY SERVICE OTHER PASS THROUGH COSTS,APPORTIONMENT OF MEDICAL AND OTHER HEALTH SERVICES,,TRIAL BALANCE OF EXPENSE ACCOUNTS,COST ALLOCATION,COST ALLOCATION,APPORTIONMENT OF INPATIENT/OUTPATIENT ANCILLARY SERVICE OTHER PASS THROUGH COSTS,Total Inpatient Days/Outpatient Visits,Total Inpatient Days/Outpatient Visits,COMPUTATION OF RATIO OF COST TO CHARGES,TRIAL BALANCE OF EXPENSE ACCOUNTS,ALLOCATION OF NEW CAPITAL COSTS,APPORTIONMENT OF INPATIENT/OUTPATIENT ANCILLARY SERVICE OTHER PASS THROUGH COSTS,TRIAL BALANCE OF EXPENSE ACCOUNTS,INPATIENT ANCILLARY SERVICE COST APPORTIONMENT,CALCULATION OF REIMBURSEMENT SETTLEMENT,RECONCILIATION OF CAPITAL COST CENTERS,Total Inpatient Days/Outpatient Visits,APPORTIONMENT OF INPATIENT/OUTPATIENT ANCILLARY SERVICE OTHER PASS THROUGH COSTS,RENAL STATISTICAL DATA,COMPUTATION OF RATIO OF COST TO CHARGES,Total Inpatient Days/Outpatient Visits,,COST ALLOCATION,APPORTIONMENT OF INPATIENT/OUTPATIENT ANCILLARY SERVICE OTHER PASS THROUGH COSTS,,Total Inpatient Days/Outpatient Visits,HHA STATISTICAL DATA,COST ALLOCATION,APPORTIONMENT OF MEDICAL AND OTHER HEALTH SERVICES,ALLOCATION OF NEW CAPITAL COSTS,BALANCE SHEET,INPATIENT ANCILLARY SERVICE COST APPORTIONMENT,TRIAL BALANCE OF EXPENSE ACCOUNTS,BED DAYS AVAILABLE,APPORTIONMENT OF INPATIENT/OUTPATIENT ANCILLARY SERVICE OTHER PASS THROUGH COSTS,APPORTIONMENT OF INPATIENT ROUTINE SERVICE CAPITAL COSTS,INPATIENT ANCILLARY SERVICE COST APPORTIONMENT,INPATIENT ANCILLARY SERVICE COST APPORTIONMENT,INPATIENT ANCILLARY SERVICE COST APPORTIONMENT,COST ALLOCATION,TRIAL BALANCE OF EXPENSE ACCOUNTS,ALLOCATION OF NEW CAPITAL COSTS,COMPUTATION OF RATIO OF COST TO CHARGES,APPORTIONMENT OF INPATIENT/OUTPATIENT ANCILLARY SERVICE OTHER PASS THROUGH COSTS,INPATIENT ANCILLARY SERVICE COST APPORTIONMENT,APPORTIONMENT OF INPATIENT/OUTPATIENT ANCILLARY SERVICE OTHER PASS THROUGH COSTS,ANALYSIS OF CHANGES IN NEW CAPITAL BALANCES,TRIAL BALANCE OF EXPENSE ACCOUNTS,BALANCE SHEET,INPATIENT ANCILLARY SERVICE COST APPORTIONMENT,HOSPITAL IDENTIFICATION INFORMATION,HOSPITAL WAGE INDEX DATA,APPORTIONMENT OF INPATIENT/OUTPATIENT ANCILLARY SERVICE OTHER PASS THROUGH COSTS,APPORTIONMENT OF INPATIENT/OUTPATIENT ANCILLARY SERVICE OTHER PASS THROUGH COSTS,BALANCE SHEET,TRIAL BALANCE OF EXPENSE ACCOUNTS,BED DAYS AVAILABLE,APPORTIONMENT OF INPATIENT/OUTPATIENT ANCILLARY SERVICE OTHER PASS THROUGH COSTS,COMPUTATION OF RATIO OF COST TO CHARGES,,HOSPITAL WAGE INDEX DATA,S-10 DATA,HOSPITAL WAGE INDEX DATA,APPORTIONMENT OF INPATIENT/OUTPATIENT ANCILLARY SERVICE OTHER PASS THROUGH COSTS,COMPUTATION OF INPATIENT OPERATING COSTS,,HOSPITAL WAGE INDEX DATA,APPORTIONMENT OF INPATIENT/OUTPATIENT ANCILLARY SERVICE OTHER PASS THROUGH COSTS,INPATIENT ANCILLARY SERVICE COST APPORTIONMENT,HHA STATISTICAL DATA,TRIAL BALANCE OF EXPENSE ACCOUNTS,HOSPITAL WAGE INDEX DATA,APPORTIONMENT OF INPATIENT/OUTPATIENT ANCILLARY SERVICE OTHER PASS THROUGH COSTS,APPORTIONMENT OF INPATIENT/OUTPATIENT ANCILLARY SERVICE OTHER PASS THROUGH COSTS,HHA STATISTICAL DATA,BED DAYS AVAILABLE,APPORTIONMENT OF INPATIENT/OUTPATIENT ANCILLARY SERVICE OTHER PASS THROUGH COSTS,APPORTIONMENT OF INPATIENT/OUTPATIENT ANCILLARY SERVICE OTHER PASS THROUGH COSTS,COST ALLOCATION,INPATIENT ANCILLARY SERVICE COST APPORTIONMENT,APPORTIONMENT OF INPATIENT/OUTPATIENT ANCILLARY SERVICE OTHER PASS THROUGH COSTS,,,TRIAL BALANCE OF EXPENSE ACCOUNTS,HHA STATISTICAL DATA,APPORTIONMENT OF MEDICAL AND OTHER HEALTH SERVICES,COST ALLOCATION,APPORTIONMENT OF INPATIENT ROUTINE SERVICE CAPITAL COSTS,APPORTIONMENT OF INPATIENT/OUTPATIENT ANCILLARY SERVICE OTHER PASS THROUGH COSTS,BED DAYS AVAILABLE,TRIAL BALANCE OF EXPENSE ACCOUNTS,APPORTIONMENT OF MEDICAL AND OTHER HEALTH SERVICES,COMPUTATION OF RATIO OF COST TO CHARGES,NUMBER OF BEDS,COMPUTATION OF RATIO OF COST TO CHARGES,HOSPITAL WAGE INDEX DATA,,Total Inpatient Days/Outpatient Visits,Medicare Inpatient Days/Outpatient Visits,APPORTIONMENT OF INPATIENT/OUTPATIENT ANCILLARY SERVICE OTHER PASS THROUGH COSTS,Medicaid Inpatient Days/Outpatient Visits,ALLOCATION OF NEW CAPITAL COSTS,STATEMENT OF PATIENT REVENUES AND OPERATING EXPENSES,TRIAL BALANCE OF EXPENSE ACCOUNTS,APPORTIONMENT OF MEDICAL AND OTHER HEALTH SERVICES,Medicare Inpatient Days/Outpatient Visits,COMPUTATION OF RATIO OF COST TO CHARGES,HOSPITAL WAGE INDEX DATA,APPORTIONMENT OF INPATIENT/OUTPATIENT ANCILLARY SERVICE OTHER PASS THROUGH COSTS,APPORTIONMENT OF INPATIENT/OUTPATIENT ANCILLARY SERVICE OTHER PASS THROUGH COSTS,COST ALLOCATION,COMPUTATION OF RATIO OF COST TO CHARGES,COST ALLOCATION,APPORTIONMENT OF INPATIENT ROUTINE SERVICE OTHER PASS THROUGH COSTS,COST ALLOCATION,STATEMENT OF REVENUES AND EXPENSES,HOSPITAL WAGE INDEX DATA,ANALYSIS OF CHANGES IN NEW CAPITAL BALANCES,Medicare Inpatient Days/Outpatient Visits,Medicaid Inpatient Days/Outpatient Visits,INPATIENT ANCILLARY SERVICE COST APPORTIONMENT,COST ALLOCATION,RENAL STATISTICAL DATA,APPORTIONMENT OF INPATIENT/OUTPATIENT ANCILLARY SERVICE OTHER PASS THROUGH COSTS,COMPUTATION OF INPATIENT OPERATING COSTS,INPATIENT ANCILLARY SERVICE COST APPORTIONMENT,COST ALLOCATION,TRIAL BALANCE OF EXPENSE ACCOUNTS,INPATIENT ANCILLARY SERVICE COST APPORTIONMENT,INPATIENT ANCILLARY SERVICE COST APPORTIONMENT,COST ALLOCATION,TRIAL BALANCE OF EXPENSE ACCOUNTS,HHA STATISTICAL DATA,TRIAL BALANCE OF EXPENSE ACCOUNTS,ALLOCATION OF NEW CAPITAL COSTS,COST ALLOCATION,TRIAL BALANCE OF EXPENSE ACCOUNTS,APPORTIONMENT OF MEDICAL AND OTHER HEALTH SERVICES,APPORTIONMENT OF INPATIENT/OUTPATIENT ANCILLARY SERVICE OTHER PASS THROUGH COSTS,COMPUTATION OF INPATIENT OPERATING COSTS,APPORTIONMENT OF INPATIENT/OUTPATIENT ANCILLARY SERVICE OTHER PASS THROUGH COSTS,APPORTIONMENT OF INPATIENT/OUTPATIENT ANCILLARY SERVICE OTHER PASS THROUGH COSTS,HOSPITAL WAGE INDEX DATA,BALANCE SHEET,INPATIENT ANCILLARY SERVICE COST APPORTIONMENT,TRIAL BALANCE OF EXPENSE ACCOUNTS,APPORTIONMENT OF INPATIENT/OUTPATIENT ANCILLARY SERVICE OTHER PASS THROUGH COSTS,TRIAL BALANCE OF EXPENSE ACCOUNTS,Total Inpatient Days/Outpatient Visits,RENAL STATISTICAL DATA,ANALYSIS OF CHANGES IN NEW CAPITAL BALANCES,APPORTIONMENT OF MEDICAL AND OTHER HEALTH SERVICES,HOSPITAL WAGE INDEX DATA,INPATIENT ANCILLARY SERVICE COST APPORTIONMENT,COST ALLOCATION,COMPUTATION OF RATIO OF COST TO CHARGES,APPORTIONMENT OF INPATIENT/OUTPATIENT ANCILLARY SERVICE OTHER PASS THROUGH COSTS,HOSPITAL WAGE INDEX DATA,INPATIENT ANCILLARY SERVICE COST APPORTIONMENT,APPORTIONMENT OF MEDICAL AND OTHER HEALTH SERVICES,RENAL STATISTICAL DATA,APPORTIONMENT OF MEDICAL AND OTHER HEALTH SERVICES,INPATIENT ANCILLARY SERVICE COST APPORTIONMENT,COST ALLOCATION,COST ALLOCATION,HHA STATISTICAL DATA,APPORTIONMENT OF INPATIENT/OUTPATIENT ANCILLARY SERVICE OTHER PASS THROUGH COSTS,RECONCILIATION OF CAPITAL COST CENTERS,HOSPITAL WAGE INDEX DATA,APPORTIONMENT OF INPATIENT/OUTPATIENT ANCILLARY SERVICE OTHER PASS THROUGH COSTS,CALCULATION OF REIMBURSEMENT SETTLEMENT,HOSPITAL WAGE INDEX DATA,COMPUTATION OF INPATIENT OPERATING COSTS,INPATIENT ANCILLARY SERVICE COST APPORTIONMENT,CALCULATION OF REIMBURSEMENT SETTLEMENT,APPORTIONMENT OF INPATIENT/OUTPATIENT ANCILLARY SERVICE OTHER PASS THROUGH COSTS,,HOSPITAL WAGE INDEX DATA,ALLOCATION OF NEW CAPITAL COSTS,,BALANCE SHEET,APPORTIONMENT OF MEDICAL AND OTHER HEALTH SERVICES,INPATIENT ANCILLARY SERVICE COST APPORTIONMENT,INPATIENT ANCILLARY SERVICE COST APPORTIONMENT,INPATIENT ANCILLARY SERVICE COST APPORTIONMENT,,HOSPITAL WAGE INDEX DATA,ANALYSIS OF CHANGES IN NEW CAPITAL BALANCES,APPORTIONMENT OF MEDICAL AND OTHER HEALTH SERVICES,ADJUSTMENTS,COST ALLOCATION,COMPUTATION OF RATIO OF COST TO CHARGES,COST ALLOCATION,ALLOCATION OF NEW CAPITAL COSTS,BED DAYS AVAILABLE,TRIAL BALANCE OF EXPENSE ACCOUNTS,APPORTIONMENT OF INPATIENT/OUTPATIENT ANCILLARY SERVICE OTHER PASS THROUGH COSTS,APPORTIONMENT OF INPATIENT/OUTPATIENT ANCILLARY SERVICE OTHER PASS THROUGH COSTS,HHA STATISTICAL DATA,Total Inpatient Days/Outpatient Visits,APPORTIONMENT OF INPATIENT/OUTPATIENT ANCILLARY SERVICE OTHER PASS THROUGH COSTS,CALCULATION OF REIMBURSEMENT SETTLEMENT,APPORTIONMENT OF MEDICAL AND OTHER HEALTH SERVICES,APPORTIONMENT OF INPATIENT/OUTPATIENT ANCILLARY SERVICE OTHER PASS THROUGH COSTS,TRIAL BALANCE OF EXPENSE ACCOUNTS,TRIAL BALANCE OF EXPENSE ACCOUNTS,COMPUTATION OF RATIO OF COST TO CHARGES,INPATIENT ANCILLARY SERVICE COST APPORTIONMENT,HHA STATISTICAL DATA,HOSPITAL WAGE INDEX DATA,INPATIENT ANCILLARY SERVICE COST APPORTIONMENT,CALCULATION OF REIMBURSEMENT SETTLEMENT,APPORTIONMENT OF INPATIENT/OUTPATIENT ANCILLARY SERVICE OTHER PASS THROUGH COSTS,APPORTIONMENT OF MEDICAL AND OTHER HEALTH SERVICES,CALCULATION OF REIMBURSEMENT SETTLEMENT,COST ALLOCATION,HOSPITAL WAGE INDEX DATA,ANALYSIS OF CHANGES IN NEW CAPITAL BALANCES,INPATIENT ANCILLARY SERVICE COST APPORTIONMENT,COMPUTATION OF RATIO OF COST TO CHARGES,HOSPITAL WAGE INDEX DATA,APPORTIONMENT OF INPATIENT/OUTPATIENT ANCILLARY SERVICE OTHER PASS THROUGH COSTS,TRIAL BALANCE OF EXPENSE ACCOUNTS,TRIAL BALANCE OF EXPENSE ACCOUNTS,APPORTIONMENT OF INPATIENT/OUTPATIENT ANCILLARY SERVICE OTHER PASS THROUGH COSTS,INPATIENT ANCILLARY SERVICE COST APPORTIONMENT,HOSPITAL IDENTIFICATION INFORMATION,ADJUSTMENTS,APPORTIONMENT OF INPATIENT/OUTPATIENT ANCILLARY SERVICE OTHER PASS THROUGH COSTS,APPORTIONMENT OF MEDICAL AND OTHER HEALTH SERVICES,APPORTIONMENT OF INPATIENT/OUTPATIENT ANCILLARY SERVICE OTHER PASS THROUGH COSTS,TRIAL BALANCE OF EXPENSE ACCOUNTS,,RENAL STATISTICAL DATA,APPORTIONMENT OF MEDICAL AND OTHER HEALTH SERVICES,TRIAL BALANCE OF EXPENSE ACCOUNTS,HOSPITAL WAGE INDEX DATA,COMPUTATION OF RATIO OF COST TO CHARGES,Medicaid Inpatient Days/Outpatient Visits,TRIAL BALANCE OF EXPENSE ACCOUNTS,COST ALLOCATION,APPORTIONMENT OF INPATIENT/OUTPATIENT ANCILLARY SERVICE OTHER PASS THROUGH COSTS,TRIAL BALANCE OF EXPENSE ACCOUNTS,HOSPITAL WAGE INDEX DATA,APPORTIONMENT OF INPATIENT/OUTPATIENT ANCILLARY SERVICE OTHER PASS THROUGH COSTS,,HOSPITAL WAGE INDEX DATA,APPORTIONMENT OF INPATIENT/OUTPATIENT ANCILLARY SERVICE OTHER PASS THROUGH COSTS,INPATIENT ANCILLARY SERVICE COST APPORTIONMENT,INPATIENT ANCILLARY SERVICE COST APPORTIONMENT,INPATIENT ANCILLARY SERVICE COST APPORTIONMENT,TRIAL BALANCE OF EXPENSE ACCOUNTS,HOSPITAL WAGE INDEX DATA,INPATIENT ANCILLARY SERVICE COST APPORTIONMENT,ANALYSIS OF CHANGES IN NEW CAPITAL BALANCES,COST ALLOCATION,HOSPITAL WAGE INDEX DATA,APPORTIONMENT OF INPATIENT/OUTPATIENT ANCILLARY SERVICE OTHER PASS THROUGH COSTS,TRIAL BALANCE OF EXPENSE ACCOUNTS,INPATIENT ANCILLARY SERVICE COST APPORTIONMENT,TRIAL BALANCE OF EXPENSE ACCOUNTS,,COST ALLOCATION,APPORTIONMENT OF INPATIENT/OUTPATIENT ANCILLARY SERVICE OTHER PASS THROUGH COSTS,APPORTIONMENT OF MEDICAL AND OTHER HEALTH SERVICES,RENAL STATISTICAL DATA,TRIAL BALANCE OF EXPENSE ACCOUNTS,INPATIENT ANCILLARY SERVICE COST APPORTIONMENT,APPORTIONMENT OF INPATIENT/OUTPATIENT ANCILLARY SERVICE OTHER PASS THROUGH COSTS,COST ALLOCATION,COST ALLOCATION,APPORTIONMENT OF INPATIENT ROUTINE SERVICE OTHER PASS THROUGH COSTS,TRIAL BALANCE OF EXPENSE ACCOUNTS,APPORTIONMENT OF INPATIENT/OUTPATIENT ANCILLARY SERVICE OTHER PASS THROUGH COSTS,TRIAL BALANCE OF EXPENSE ACCOUNTS,APPORTIONMENT OF MEDICAL AND OTHER HEALTH SERVICES,COMPUTATION OF RATIO OF COST TO CHARGES,INPATIENT ANCILLARY SERVICE COST APPORTIONMENT,APPORTIONMENT OF MEDICAL AND OTHER HEALTH SERVICES,HOSPITAL WAGE INDEX DATA,TRIAL BALANCE OF EXPENSE ACCOUNTS,Total Inpatient Days/Outpatient Visits,,INPATIENT ANCILLARY SERVICE COST APPORTIONMENT,COST ALLOCATION,Total Inpatient Days/Outpatient Visits,COMPUTATION OF RATIO OF COST TO CHARGES,APPORTIONMENT OF INPATIENT/OUTPATIENT ANCILLARY SERVICE OTHER PASS THROUGH COSTS,TRIAL BALANCE OF EXPENSE ACCOUNTS,COMPUTATION OF RATIO OF COST TO CHARGES,INPATIENT ANCILLARY SERVICE COST APPORTIONMENT,COST ALLOCATION,ALLOCATION OF NEW CAPITAL COSTS,Medicare Inpatient Days/Outpatient Visits,COST ALLOCATION,TRIAL BALANCE OF EXPENSE ACCOUNTS,HOSPITAL WAGE INDEX DATA,APPORTIONMENT OF INPATIENT/OUTPATIENT ANCILLARY SERVICE OTHER PASS THROUGH COSTS,RENAL STATISTICAL DATA,HOSPITAL WAGE INDEX DATA,RECONCILIATION OF CAPITAL COST CENTERS,HOSPITAL WAGE INDEX DATA,COMPUTATION OF RATIO OF COST TO CHARGES,APPORTIONMENT OF INPATIENT/OUTPATIENT ANCILLARY SERVICE OTHER PASS THROUGH COSTS,COST ALLOCATION,TRIAL BALANCE OF EXPENSE ACCOUNTS,TRIAL BALANCE OF EXPENSE ACCOUNTS,INPATIENT ANCILLARY SERVICE COST APPORTIONMENT,APPORTIONMENT OF MEDICAL AND OTHER HEALTH SERVICES,RENAL STATISTICAL DATA,HOSPITAL IDENTIFICATION INFORMATION,APPORTIONMENT OF INPATIENT/OUTPATIENT ANCILLARY SERVICE OTHER PASS THROUGH COSTS,INPATIENT ANCILLARY SERVICE COST APPORTIONMENT,APPORTIONMENT OF MEDICAL AND OTHER HEALTH SERVICES,TRIAL BALANCE OF EXPENSE ACCOUNTS,APPORTIONMENT OF INPATIENT/OUTPATIENT ANCILLARY SERVICE OTHER PASS THROUGH COSTS,INPATIENT ANCILLARY SERVICE COST APPORTIONMENT,,COMPUTATION OF RATIO OF COST TO CHARGES,APPORTIONMENT OF MEDICAL AND OTHER HEALTH SERVICES,INPATIENT ANCILLARY SERVICE COST APPORTIONMENT,TRIAL BALANCE OF EXPENSE ACCOUNTS,COST ALLOCATION,APPORTIONMENT OF INPATIENT/OUTPATIENT ANCILLARY SERVICE OTHER PASS THROUGH COSTS,COMPUTATION OF INPATIENT OPERATING COSTS,HHA STATISTICAL DATA,TRIAL BALANCE OF EXPENSE ACCOUNTS,COST ALLOCATION,COST ALLOCATION,CALCULATION OF REIMBURSEMENT SETTLEMENT,INPATIENT ANCILLARY SERVICE COST APPORTIONMENT,APPORTIONMENT OF INPATIENT/OUTPATIENT ANCILLARY SERVICE OTHER PASS THROUGH COSTS,APPORTIONMENT OF INPATIENT/OUTPATIENT ANCILLARY SERVICE OTHER PASS THROUGH COSTS,Total Inpatient Days/Outpatient Visits,CALCULATION OF REIMBURSEMENT SETTLEMENT,APPORTIONMENT OF INPATIENT/OUTPATIENT ANCILLARY SERVICE OTHER PASS THROUGH COSTS,APPORTIONMENT OF MEDICAL AND OTHER HEALTH SERVICES,ADJUSTMENTS,ALLOCATION OF NEW CAPITAL COSTS,APPORTIONMENT OF INPATIENT/OUTPATIENT ANCILLARY SERVICE OTHER PASS THROUGH COSTS,HOSPITAL WAGE INDEX DATA,COST ALLOCATION,COMPUTATION OF RATIO OF COST TO CHARGES,BED DAYS AVAILABLE,Total Inpatient Days/Outpatient Visits,,COST ALLOCATION,INPATIENT ANCILLARY SERVICE COST APPORTIONMENT,HOSPITAL WAGE INDEX DATA,APPORTIONMENT OF MEDICAL AND OTHER HEALTH SERVICES,COST ALLOCATION,TRIAL BALANCE OF EXPENSE ACCOUNTS,APPORTIONMENT OF INPATIENT/OUTPATIENT ANCILLARY SERVICE OTHER PASS THROUGH COSTS,TRIAL BALANCE OF EXPENSE ACCOUNTS,APPORTIONMENT OF INPATIENT/OUTPATIENT ANCILLARY SERVICE OTHER PASS THROUGH COSTS,COMPUTATION OF INPATIENT OPERATING COSTS,HHA STATISTICAL DATA,APPORTIONMENT OF MEDICAL AND OTHER HEALTH SERVICES,APPORTIONMENT OF MEDICAL AND OTHER HEALTH SERVICES,INPATIENT ANCILLARY SERVICE COST APPORTIONMENT,APPORTIONMENT OF INPATIENT/OUTPATIENT ANCILLARY SERVICE OTHER PASS THROUGH COSTS,COMPUTATION OF RATIO OF COST TO CHARGES,COST ALLOCATION,Total Inpatient Days/Outpatient Visits,RENAL STATISTICAL DATA,Total Inpatient Days/Outpatient Visits,Medicaid Inpatient Days/Outpatient Visits,APPORTIONMENT OF MEDICAL AND OTHER HEALTH SERVICES,ALLOCATION OF NEW CAPITAL COSTS,,APPORTIONMENT OF MEDICAL AND OTHER HEALTH SERVICES,COMPUTATION OF RATIO OF COST TO CHARGES,COST ALLOCATION,,APPORTIONMENT OF MEDICAL AND OTHER HEALTH SERVICES,COMPUTATION OF RATIO OF COST TO CHARGES,APPORTIONMENT OF INPATIENT/OUTPATIENT ANCILLARY SERVICE OTHER PASS THROUGH COSTS,INPATIENT ANCILLARY SERVICE COST APPORTIONMENT,COMPUTATION OF RATIO OF COST TO CHARGES,NUMBER OF BEDS,HOSPITAL WAGE INDEX DATA,HOSPITAL WAGE INDEX DATA,HOSPITAL WAGE INDEX DATA,COST ALLOCATION,APPORTIONMENT OF INPATIENT/OUTPATIENT ANCILLARY SERVICE OTHER PASS THROUGH COSTS,HHA STATISTICAL DATA,TRIAL BALANCE OF EXPENSE ACCOUNTS,TRIAL BALANCE OF EXPENSE ACCOUNTS,Total Inpatient Days/Outpatient Visits,HOSPITAL WAGE INDEX DATA,TRIAL BALANCE OF EXPENSE ACCOUNTS,ALLOCATION OF NEW CAPITAL COSTS,COST ALLOCATION,,Total Inpatient Days/Outpatient Visits,APPORTIONMENT OF INPATIENT/OUTPATIENT ANCILLARY SERVICE OTHER PASS THROUGH COSTS,APPORTIONMENT OF MEDICAL AND OTHER HEALTH SERVICES,APPORTIONMENT OF INPATIENT/OUTPATIENT ANCILLARY SERVICE OTHER PASS THROUGH COSTS,Medicaid Inpatient Days/Outpatient Visits,CALCULATION OF REIMBURSEMENT SETTLEMENT,TRIAL BALANCE OF EXPENSE ACCOUNTS,INPATIENT ANCILLARY SERVICE COST APPORTIONMENT,CALCULATION OF REIMBURSEMENT SETTLEMENT,COST ALLOCATION,APPORTIONMENT OF MEDICAL AND OTHER HEALTH SERVICES,COMPUTATION OF RATIO OF COST TO CHARGES,COMPUTATION OF INPATIENT OPERATING COSTS,TRIAL BALANCE OF EXPENSE ACCOUNTS,INPATIENT ANCILLARY SERVICE COST APPORTIONMENT,APPORTIONMENT OF INPATIENT/OUTPATIENT ANCILLARY SERVICE OTHER PASS THROUGH COSTS,Medicaid Inpatient Days/Outpatient Visits,STATEMENT OF REVENUES AND EXPENSES,COMPUTATION OF RATIO OF COST TO CHARGES,Total Inpatient Days/Outpatient Visits,INPATIENT ANCILLARY SERVICE COST APPORTIONMENT,COST ALLOCATION,APPORTIONMENT OF INPATIENT/OUTPATIENT ANCILLARY SERVICE OTHER PASS THROUGH COSTS,APPORTIONMENT OF INPATIENT/OUTPATIENT ANCILLARY SERVICE OTHER PASS THROUGH COSTS,RENAL STATISTICAL DATA,HOSPITAL WAGE INDEX DATA,TRIAL BALANCE OF EXPENSE ACCOUNTS,RENAL STATISTICAL DATA,COST ALLOCATION,HOSPITAL WAGE INDEX DATA,HOSPITAL WAGE INDEX DATA,INPATIENT ANCILLARY SERVICE COST APPORTIONMENT,HHA STATISTICAL DATA,INPATIENT ANCILLARY SERVICE COST APPORTIONMENT,HOSPITAL WAGE INDEX DATA,APPORTIONMENT OF INPATIENT/OUTPATIENT ANCILLARY SERVICE OTHER PASS THROUGH COSTS,COMPUTATION OF RATIO OF COST TO CHARGES,APPORTIONMENT OF INPATIENT/OUTPATIENT ANCILLARY SERVICE OTHER PASS THROUGH COSTS,RENAL STATISTICAL DATA,HOSPITAL WAGE INDEX DATA,COST ALLOCATION,COMPUTATION OF RATIO OF COST TO CHARGES,HOSPITAL WAGE INDEX DATA,TRIAL BALANCE OF EXPENSE ACCOUNTS,COMPUTATION OF RATIO OF COST TO CHARGES,APPORTIONMENT OF MEDICAL AND OTHER HEALTH SERVICES,INPATIENT ANCILLARY SERVICE COST APPORTIONMENT,APPORTIONMENT OF INPATIENT/OUTPATIENT ANCILLARY SERVICE OTHER PASS THROUGH COSTS,APPORTIONMENT OF MEDICAL AND OTHER HEALTH SERVICES,APPORTIONMENT OF INPATIENT/OUTPATIENT ANCILLARY SERVICE OTHER PASS THROUGH COSTS,APPORTIONMENT OF INPATIENT/OUTPATIENT ANCILLARY SERVICE OTHER PASS THROUGH COSTS,ALLOCATION OF NEW CAPITAL COSTS,APPORTIONMENT OF INPATIENT/OUTPATIENT ANCILLARY SERVICE OTHER PASS THROUGH COSTS,APPORTIONMENT OF INPATIENT/OUTPATIENT ANCILLARY SERVICE OTHER PASS THROUGH COSTS,APPORTIONMENT OF INPATIENT/OUTPATIENT ANCILLARY SERVICE OTHER PASS THROUGH COSTS,COMPUTATION OF RATIO OF COST TO CHARGES,APPORTIONMENT OF INPATIENT/OUTPATIENT ANCILLARY SERVICE OTHER PASS THROUGH COSTS,TRIAL BALANCE OF EXPENSE ACCOUNTS,COST ALLOCATION,INPATIENT ANCILLARY SERVICE COST APPORTIONMENT,APPORTIONMENT OF INPATIENT/OUTPATIENT ANCILLARY SERVICE OTHER PASS THROUGH COSTS,APPORTIONMENT OF INPATIENT/OUTPATIENT ANCILLARY SERVICE OTHER PASS THROUGH COSTS,APPORTIONMENT OF INPATIENT/OUTPATIENT ANCILLARY SERVICE OTHER PASS THROUGH COSTS,APPORTIONMENT OF INPATIENT/OUTPATIENT ANCILLARY SERVICE OTHER PASS THROUGH COSTS,HOSPITAL WAGE INDEX DATA,,COST ALLOCATION,Medicare Inpatient Days/Outpatient Visits,APPORTIONMENT OF MEDICAL AND OTHER HEALTH SERVICES,COST ALLOCATION,INPATIENT ANCILLARY SERVICE COST APPORTIONMENT,NUMBER OF BEDS,ALLOCATION OF NEW CAPITAL COSTS,APPORTIONMENT OF INPATIENT/OUTPATIENT ANCILLARY SERVICE OTHER PASS THROUGH COSTS,COST ALLOCATION,INPATIENT ANCILLARY SERVICE COST APPORTIONMENT,ANALYSIS OF CHANGES IN NEW CAPITAL BALANCES,TRIAL BALANCE OF EXPENSE ACCOUNTS,ANALYSIS OF CHANGES IN NEW CAPITAL BALANCES,TRIAL BALANCE OF EXPENSE ACCOUNTS,APPORTIONMENT OF INPATIENT/OUTPATIENT ANCILLARY SERVICE OTHER PASS THROUGH COSTS,NUMBER OF BEDS,Medicaid Inpatient Days/Outpatient Visits,APPORTIONMENT OF INPATIENT/OUTPATIENT ANCILLARY SERVICE OTHER PASS THROUGH COSTS,INPATIENT ANCILLARY SERVICE COST APPORTIONMENT,S-10 DATA,NUMBER OF BEDS,COST ALLOCATION,COST ALLOCATION,Total Inpatient Days/Outpatient Visits,APPORTIONMENT OF INPATIENT/OUTPATIENT ANCILLARY SERVICE OTHER PASS THROUGH COSTS,INPATIENT ANCILLARY SERVICE COST APPORTIONMENT,TRIAL BALANCE OF EXPENSE ACCOUNTS,APPORTIONMENT OF INPATIENT ROUTINE SERVICE OTHER PASS THROUGH COSTS,COMPUTATION OF RATIO OF COST TO CHARGES,RENAL STATISTICAL DATA,COST ALLOCATION,COMPUTATION OF INPATIENT OPERATING COSTS,NUMBER OF BEDS,COST ALLOCATION,APPORTIONMENT OF INPATIENT/OUTPATIENT ANCILLARY SERVICE OTHER PASS THROUGH COSTS,HOSPITAL WAGE INDEX DATA,APPORTIONMENT OF MEDICAL AND OTHER HEALTH SERVICES,,HHA STATISTICAL DATA,Medicaid Inpatient Days/Outpatient Visits,ALLOCATION OF NEW CAPITAL COSTS,INPATIENT ANCILLARY SERVICE COST APPORTIONMENT,TRIAL BALANCE OF EXPENSE ACCOUNTS,INPATIENT ANCILLARY SERVICE COST APPORTIONMENT,APPORTIONMENT OF INPATIENT/OUTPATIENT ANCILLARY SERVICE OTHER PASS THROUGH COSTS,INPATIENT ANCILLARY SERVICE COST APPORTIONMENT,INPATIENT ANCILLARY SERVICE COST APPORTIONMENT,,APPORTIONMENT OF MEDICAL AND OTHER HEALTH SERVICES,APPORTIONMENT OF MEDICAL AND OTHER HEALTH SERVICES,APPORTIONMENT OF INPATIENT/OUTPATIENT ANCILLARY SERVICE OTHER PASS THROUGH COSTS,APPORTIONMENT OF INPATIENT/OUTPATIENT ANCILLARY SERVICE OTHER PASS THROUGH COSTS,COMPUTATION OF RATIO OF COST TO CHARGES,COMPUTATION OF RATIO OF COST TO CHARGES,COMPUTATION OF INPATIENT OPERATING COSTS,CALCULATION OF REIMBURSEMENT SETTLEMENT,APPORTIONMENT OF INPATIENT/OUTPATIENT ANCILLARY SERVICE OTHER PASS THROUGH COSTS,COST ALLOCATION,TRIAL BALANCE OF EXPENSE ACCOUNTS,COST ALLOCATION,HOSPITAL WAGE INDEX DATA,INPATIENT ANCILLARY SERVICE COST APPORTIONMENT,APPORTIONMENT OF INPATIENT/OUTPATIENT ANCILLARY SERVICE OTHER PASS THROUGH COSTS,INPATIENT ANCILLARY SERVICE COST APPORTIONMENT,APPORTIONMENT OF INPATIENT/OUTPATIENT ANCILLARY SERVICE OTHER PASS THROUGH COSTS,COST ALLOCATION,HOSPITAL WAGE INDEX DATA,COST ALLOCATION,APPORTIONMENT OF INPATIENT/OUTPATIENT ANCILLARY SERVICE OTHER PASS THROUGH COSTS,HOSPITAL WAGE INDEX DATA,HHA STATISTICAL DATA,INPATIENT ANCILLARY SERVICE COST APPORTIONMENT,APPORTIONMENT OF INPATIENT/OUTPATIENT ANCILLARY SERVICE OTHER PASS THROUGH COSTS,COST ALLOCATION,ALLOCATION OF NEW CAPITAL COSTS,INPATIENT ANCILLARY SERVICE COST APPORTIONMENT,TRIAL BALANCE OF EXPENSE ACCOUNTS,Medicaid Inpatient Days/Outpatient Visits,TRIAL BALANCE OF EXPENSE ACCOUNTS,HHA STATISTICAL DATA,INPATIENT ANCILLARY SERVICE COST APPORTIONMENT,,BED DAYS AVAILABLE,TRIAL BALANCE OF EXPENSE ACCOUNTS,TRIAL BALANCE OF EXPENSE ACCOUNTS,HOSPITAL WAGE INDEX DATA,COMPUTATION OF RATIO OF COST TO CHARGES,TRIAL BALANCE OF EXPENSE ACCOUNTS,INPATIENT ANCILLARY SERVICE COST APPORTIONMENT,,Total Inpatient Days/Outpatient Visits,COMPUTATION OF INPATIENT OPERATING COSTS,APPORTIONMENT OF INPATIENT/OUTPATIENT ANCILLARY SERVICE OTHER PASS THROUGH COSTS,INPATIENT ANCILLARY SERVICE COST APPORTIONMENT,S-10 DATA,S-10 DATA,HHA STATISTICAL DATA,TRIAL BALANCE OF EXPENSE ACCOUNTS,APPORTIONMENT OF MEDICAL AND OTHER HEALTH SERVICES,HOSPITAL WAGE INDEX DATA,APPORTIONMENT OF INPATIENT/OUTPATIENT ANCILLARY SERVICE OTHER PASS THROUGH COSTS,COMPUTATION OF RATIO OF COST TO CHARGES,APPORTIONMENT OF INPATIENT/OUTPATIENT ANCILLARY SERVICE OTHER PASS THROUGH COSTS,APPORTIONMENT OF INPATIENT/OUTPATIENT ANCILLARY SERVICE OTHER PASS THROUGH COSTS,RENAL STATISTICAL DATA,COST ALLOCATION,CALCULATION OF REIMBURSEMENT SETTLEMENT,INPATIENT ANCILLARY SERVICE COST APPORTIONMENT,APPORTIONMENT OF INPATIENT/OUTPATIENT ANCILLARY SERVICE OTHER PASS THROUGH COSTS,APPORTIONMENT OF INPATIENT/OUTPATIENT ANCILLARY SERVICE OTHER PASS THROUGH COSTS,APPORTIONMENT OF MEDICAL AND OTHER HEALTH SERVICES,ALLOCATION OF NEW CAPITAL COSTS,APPORTIONMENT OF INPATIENT ROUTINE SERVICE CAPITAL COSTS,APPORTIONMENT OF INPATIENT/OUTPATIENT ANCILLARY SERVICE OTHER PASS THROUGH COSTS,APPORTIONMENT OF MEDICAL AND OTHER HEALTH SERVICES,HHA STATISTICAL DATA,INPATIENT ANCILLARY SERVICE COST APPORTIONMENT,APPORTIONMENT OF INPATIENT/OUTPATIENT ANCILLARY SERVICE OTHER PASS THROUGH COSTS,COST ALLOCATION,APPORTIONMENT OF INPATIENT/OUTPATIENT ANCILLARY SERVICE OTHER PASS THROUGH COSTS,Medicaid Inpatient Days/Outpatient Visits,S-10 DATA,APPORTIONMENT OF INPATIENT/OUTPATIENT ANCILLARY SERVICE OTHER PASS THROUGH COSTS,BALANCE SHEET,STATEMENT OF REVENUES AND EXPENSES,APPORTIONMENT OF INPATIENT/OUTPATIENT ANCILLARY SERVICE OTHER PASS THROUGH COSTS,COST ALLOCATION,APPORTIONMENT OF MEDICAL AND OTHER HEALTH SERVICES,TRIAL BALANCE OF EXPENSE ACCOUNTS,COST ALLOCATION,INPATIENT ANCILLARY SERVICE COST APPORTIONMENT,Beginning FFY,Hospital Type (From CMS Hospitals Data Archive),Name and Num
,Curated Name and Num,Hospital type (modified),Type of Control of Hospital (See Table I) (S2_1_C1_21),Lon,Lat,Electroencephalography (D3_HOS_C2_70),Other Outpatient Services (D3_IPF_C2_93),Nonphysician Anesthetists (A_C2_19),"COST REIMBURSED SERVICES NOT SUBJECT TO DEDUCTIBLES AND COINSURANCE - CHARGES, Durable Medical Equipment Rented (D_5_HOS_C4_96)",Medical Records and Medical Rec. Library (A_C2_16),"Net Expense for Cost Allocation, Total (B_1_C0_200)","PAID HOURS RELATED TO SALARIES, Dietary (S3_2_C5_34)","PPS REIMBURSED SERVICES -  CHARGES, CT Scan (D_5_HOS_C2_57)","ADJUSTED SALARIES, SNF (S3_2_C4_9)","ADJUSTED SALARIES, Social Service (S3_2_C4_42)",Speech Pathology (C_1_C2_68),Research (B_1_C26_191),Coronary Care Unit (S3_1_C2_9),Stand-alone CHIP -- Costs minus net revenue (0 min) (S10_C1_12),Subprovider-IRF (A_C2_41),"Total Outpatient Charges, Delivery Room and Labor Room (C_1_C7_52)",IPPS Interim payment (E_A_HOS_C1_72),Adults & Pediatrics (D_1_HOS_C7_30),Hospice (S3_1_C8_24),Int & Res (non approved teaching program (B_1_C22_100),CT Scan (D_4_IRF_C13_57),"Net Expense for Cost Allocation, Drugs Charged to Patients (B_1_C0_73)",Delivery Room and Labor Room (D_4_HOS_C3_52),Cost of Uncompensated Care (S10_C1_30),"Allocation of Interns & Residents Program Costs, Radiology-Diagnostic (B_1_C22_54)",MRI (D_4_HOS_C4_58),"PPS SERVICES COST, Respiratory Therapy (D_5_HOS_C5_65)",Allowable bad debts for dual eligibles beneficiaries (E_B_HOS_C1_36),Kidney Acquisition (B_1_C26_105),Occupational Therapy (B_1_C26_67),MRI (A_C2_58),"Beginning Balances, Subtotal (A7_1_C1_8)",Medical Supplies Charged to Patients (A_C6_71),Respiratory Therapy (C_1_C6_65),PBP Clinical Lab Services Program Only (C_1_C5_61),Speech Pathology (D_4_IPF_C11_68),"Allocation of Interns & Residents Program Costs, Physical Therapy (B_1_C22_66)",RHC 2 Provider Number (S2_1_C2_1501),OLTC (S3_1_C2_21),Lung  Acquisition (B_1_C21_108),"COST REIMBURSED SERVICES SUBJECT TO DEDUCTIBLES  AND COINSURANCE - CHARGES, Other Outpatient Services (D_5_HOS_C3_93)","Trade, Quantity, and Time Discounts (A8_C2_4)",CT Scan (B_1_C26_57),Electrocardiology (D_4_IRF_C13_69),Speech Pathology (D3_SNF_C3_68),"Allocation of Interns & Residents Salary and Fringes, MRI (B_1_C21_58)",Whole Blood & Packed Red Blood Cells (A_C2_62),"HHA I, Total Number of Outlier Episodes (S4_HHA1_C5_37)",Premiums (S2_1_C1_11801),"Blood Storing, Processing, Trans (D_4_IRF_C11_63)",Radiology-Diagnostic (D3_IRF_C3_54),Home Program Dialysis (D3_SNF_C2_94),"TOTAL CAPITAL COSTS AFTER COST ALLOCATION, Delivery Room and Labor Room (B_2_C26_52)",Medicare Certified Heart TC term date (S2_1_C2_127),"ADJUSTED SALARIES, Interns & Residents (S3_2_C4_7)","Allocation of Interns & Residents Salary and Fringes, Respiratory Therapy (B_1_C21_65)",Islet Acquisition (B_2_C26_111),"Depreciation, Total (A7_3_C9_3)",Clinic (B_1_C26_90),Cafeteria employees and guests (A8_C2_14),"Allocation of Interns & Residents Program Costs, Other Special Care Unit (B_1_C22_35)",Physical Therapy (B_2_C26_66),Medical Supplies Charged to Patients (B_1_C26_71),Subprovider 1 (S3_1_C2_18),Medical Supplies Charged to Patients (D_4_HOS_C12_71),MRI (B_1_C26_58),"Total Inpatient Charges, Laboratory (C_1_C6_60)",Speech Pathology (D_4_HOS_C12_68),"AVERAGE HOURLY WAGE, Non-Physician Part B (S3_2_C6_6)",Physical Therapy (D_4_HOS_C11_66),Subprovider-IRF (C_1_C5_41),Clinic (A_C1_90),Observation Beds (Distinct Unit) (B_2_C26_9201),Total Program Excludable Costs (D1_IRF_C1_52),"Allocation of Interns & Residents Salary and Fringes, Radiology-Diagnostic (B_1_C21_54)",MRI (D_4_HOS_C3_58),CMHC (B_1_C26_99),Radiology-Therapeutic (D_4_HOS_C2_55),Durable Medical Equipment Sold (A_C1_97),"ADJUSTED SALARIES, Dietary (S3_2_C4_34)","Disposals and Retirements, Land Improvements (A7_1_C7_2)",certification date (S2_1_C1_131),RHC 17 Provider Number (S2_1_C2_1516),Cost To Charge Ratio (S10_C1_1),Recovery Room (D_4_IPF_C11_51),"TOTAL CAPITAL COSTS AFTER COST ALLOCATION, Cardiac Catheterization (B_2_C26_59)",Electroencephalography (A_C1_70),Coronary Intensive Care Unit (D_1_HOS_C4_32),ASC 1 Provider Number (S2_1_C2_13),Medical Supplies Charged to Patients (D3_IPF_C2_71),"Total Inpatient Charges, Delivery Room and Labor Room (C_1_C6_52)",Intensive Care Unit Program Cost (D1_HOS_C5_43),"Total Inpatient Charges, Other Special Care Unit (C_1_C6_35)","PPS REIMBURSED SERVICES -  CHARGES, Medical Supplies Charged to Patients (D_5_HOS_C2_71)",Electrocardiology (C_1_C6_69),Administrative and General (A_C1_5),Urban/Rural Indicator at beginning (S2_1_C1_26),Respiratory Therapy (C_1_C7_65),Utilization Review - Physician Compen (D1_SNF_C1_85),State or local govt (not Medicaid or CHIP) -- Costs minus net revenue (0 min) (S10_C1_16),Total costs for patients covered by a state or local government program (S10_C1_15),Observation Beds (Distinct Unit) (D3_IPF_C2_9201),"AMOUNT REPORTED, Subtotal Salaries (S3_3_C2_3)","Disposals and Retirements, Building Improvements (A7_1_C7_4)",Impl. Dev. Charged to Patients (D3_HOS_C3_72),Drugs Charged to Patients (A_C2_73),Subprovider-IRF (A_C6_41),Physical Therapy (D_4_HOS_C3_66),Surgical Intensive Care Unit (D3_HOS_C2_34),Intravenous Therapy (D_4_IRF_C13_64),"ADJUSTED SALARIES, Physician-Part A (S3_2_C4_4)",Subprovider 1 (S3_1_C8_18),Dietary (A_C2_10),Other Special Purpose (B_1_C26_117),"COST REIMBURSED SERVICES SUBJECT TO DEDUCTIBLES  AND COINSURANCE - CHARGES, Durable Medical Equipment Rented (D_5_HOS_C3_96)",Impl. Dev. Charged to Patients (D3_IPF_C2_72),Recovery Room (D_4_HOS_C11_51),IRF (S3_1_C8_17),Renal Dialysis (B_1_C26_74),"Total Inpatient Charges, Adults & Pediatrics (C_1_C6_30)",Kidney Acquisition (A_C6_105),"COST SERVICES NOT SUBJECT TO DEDUCTIBLES AND COINSURANCE - COST, Blood Storing, Processing, Trans (D_5_HOS_C7_63)",Ambulance Services (B_2_C26_95),Emergency (D_4_HOS_C10_91),Other Outpatient Services (D_4_IPF_C11_93),MRI (D3_SNF_C3_58),"Blood Storing, Processing, Trans (D3_SNF_C3_63)","Donations, Land (A7_1_C3_1)","AVERAGE HOURLY WAGE, Home Office:  Physician Part A (S3_2_C6_15)","HHA II, With Outliers:  Non Routine Med Sup Chgs (S4_HHA2_C2_38)",OLTC (S3_1_C3_21),Impl. Dev. Charged to Patients (D_4_HOS_C11_72),"AMOUNT REPORTED, Interns & Residents (S3_2_C2_2550)",Subprovider II (A_C6_4201),"ADJUSTED SALARIES, Admin & Gen Under Contract (S3_2_C4_29)",Respiratory Therapy (D_4_HOS_C13_65),"General Inpatient Routine Service Cost, net of Swing Bed Cost (D1_IPF_C1_27)",Renal 10 Provider Number (S2_1_C2_1809),"TOTAL CAPITAL COSTS AFTER COST ALLOCATION, NF (B_2_C26_45)","HHA III, PEP Episodes:  Total Number of Episodes (S4_HHA3_C4_36)","Net Expense for Cost Allocation, Intestinal Acquisition (B_1_C0_110)",Int & Res (non approved teaching program (B_1_C26_100),Total Program Excludable Costs (D1_IPF_C1_52),"Fully Depreciated Assets, Assets (A7_1_C7_7)",Other Ancillary (B_1_C26_76),Total Costs (C_1_C3_202),Surgical Intensive Care Unit (A_C6_34),Total (D_4_IPF_C11_200),Lung  Acquisition (C_1_C6_108),Electrocardiology (C_1_C7_69),"Allocation of Interns & Residents Salary and Fringes, Adults and Pediatrics (B_1_C21_30)","PPS SERVICES COST, Drugs Charged to Patients (D_5_HOS_C5_73)",IPF (S3_1_C5_16),Other Capital (A_C6_3),Television and Radio Service (A8_C2_8),"Allocation of Interns & Residents Salary and Fringes, Laboratory (B_1_C21_60)",Anesthesiology (D3_HOS_C3_53),Cafeteria (A_C6_11),"ADJUSTED SALARIES, Total Salaries (S3_2_C4_1)",Electroencephalography (D_4_IPF_C11_70),Burn Intensive Care Unit (D3_IPF_C2_33),Other Outpatient Services (D3_SNF_C3_93),"AMOUNT REPORTED, Non-Physician Anesthetist Part B (S3_2_C2_3)",Whole Blood & Packed Red Blood Cells (A_C1_62),Subprovider-IPF (D_3_HOS_C9_40),Total Hospital (S3_1_C3_7),"Allocation of Interns & Residents Program Costs, Impl. Dev. Charged to Patients (B_1_C22_72)",Occupational Therapy (D_4_HOS_C3_67),"AVERAGE HOURLY WAGE, Housekeeping under Contract (S3_2_C6_33)","Net Expense for Cost Allocation, ICF (B_1_C0_4501)",Radiology-Therapeutic (D3_SNF_C2_55),"AVERAGE HOURLY WAGE, Total Salaries (S3_2_C6_1)",CT Scan (D3_IPF_C3_57),"AMOUNT REPORTED, Physician-Part A (S3_2_C2_4)",ASC (Non Distinct Part) (C_1_C5_75),"HHA III, Total Other Charges (S4_HHA3_C5_34)","Net Expense for Cost Allocation, Research (B_1_C0_191)",Burn Intensive Care Unit (S3_1_C5_10),Delivery Room and Labor Room (D_4_HOS_C4_52),"Net Expense for Cost Allocation, Subprovider I (B_1_C0_42)","AVERAGE HOURLY WAGE, Total Overhead Costs (S3_3_C6_7)",Whole Blood & Packed Red Blood Cells (C_1_C5_62),Organ Procurement (D4_PANCREAS_C1_69),Hospital Adlts & Ped Swing Bed SNF (S3_1_C8_5),Total Hospital Interns & Residents (S3_1_C11_14),"Allocation of Interns & Residents Program Costs, Intravenous Therapy (B_1_C22_64)",Physical Therapy (D_4_IRF_C11_66),"Disposals and Retirements, Building Improvements (A7_1_C5_4)",Surgical Intensive Care Unit (S3_1_C5_11),HHA 3 Provider Number (S2_1_C2_1202),Durable Medical Equipment Rented (D3_IPF_C3_96),RHC/FQHC Combined (S3_1_C7_26),Burn Intensive Care Unit (A_C2_33),Physical Therapy (D3_IPF_C3_66),"COST REIMBURSED SERVICES SUBJECT TO DEDUCTIBLES  AND COINSURANCE - CHARGES, Delivery Room and Labor Room (D_5_HOS_C3_52)",Out of State Medicaid eligible days (S2_1_C4_24),Aggregate amount collected from patients (E_B_HOS_C1_15),OSP (B_2_C26_9940),Intensive Care Unit (A_C6_31),"Number of Times per week
 Patient receives Dialysis (S5_C2_2)",Laboratory (B_1_C26_60),Total Outpatient Program Pass Thru Cost (D_4_IPF_C6_200),"COST REIMBURSED SERVICES SUBJECT TO DEDUCTIBLES  AND COINSURANCE - CHARGES, Radioisotope (D_5_HOS_C3_56)",Medical Supplies Charged to Patients (D_4_IRF_C11_71),"HHA I, Without Outliers:  Other Charges (S4_HHA1_C1_34)",Renal Dialysis (A_C1_74),Telephone Services (A8_C2_7),"ADJUSTED SALARIES, Home Office Salaries (S3_2_C4_1401)",Anesthesiology (D3_HOS_C2_53),Payment to cost ratio (E_B_HOS_C101_5),Delivery Room and Labor Room (A_C2_52),Swing Bed NF Provider Number (S2_1_C2_8),Delivery Room and Labor Room (D_4_HOS_C12_52),Respiratory Therapy (D3_SNF_C2_65),"HHA I, With Outliers:  Total Charges (S4_HHA1_C2_35)",Hospital Adults & Pediatrics (S3_1_C8_1),Observation Beds (Distinct Unit) (D3_SNF_C2_9201),"COST SERVICES SUBJECT TO DEDUCTIBLES AND COINSURANCE - COST, Radiology-Therapeutic (D_5_HOS_C6_55)","Blood Storing, Processing, Trans (D_4_SNF_C11_63)",Interns & Res Salary and Fringe Benefits (A_C1_21),Occupational Therapy (A_C2_67),Operating Room (D_4_HOS_C11_50),Operating Room (D_4_HOS_C4_50),Pass through Cost for Program Inpatient (D1_IRF_C1_50),OPT (A_C6_9920),"HHA II, Total Visits (S4_HHA2_C5_33)","ADJUSTED SALARIES, Non-Physician Anesthetist Part B (S3_2_C4_21)","Total Outpatient Charges, Anesthesiology (C_1_C7_53)","COST SERVICES SUBJECT TO DEDUCTIBLES AND COINSURANCE - COST, Operating Room (D_5_HOS_C6_50)",Hospice (B_1_C21_116),Respiratory Therapy (C_1_C2_65),Whole Blood & Packed Red Blood Cells (D_4_SNF_C11_62),"PPS SERVICES COST, Electroencephalography (D_5_HOS_C5_70)",PBP Clinical Lab Services Program Only (D3_HOS_C3_61),OLTC (A_C6_46),"HHA III, Without Outliers:  Non Routine Med Sup Chgs (S4_HHA3_C1_38)",New Capital Buildings and Fixtures (A_C6_1),Adults and Pediatrics (A_C6_30),Utilization Review SNF (A_C6_114),"Total, New Cap Related Csts Bldg & Fixtures (A7_3_C15_1)",Physicians' Private Office (B_1_C26_192),Intravenous Therapy (D3_SNF_C2_64),FQHC (D_4_HOS_C3_89),"PPS REIMBURSED SERVICES -  CHARGES, Operating Room (D_5_HOS_C2_50)",Heart Acquisition (B_1_C22_106),"HHA II, PEP Episodes:  Total Charges: (S4_HHA2_C4_35)",Electrocardiology (D_4_HOS_C10_69),In State Medicaid eligible days (S2_1_C2_24),Intestinal Acquisition (C_1_C6_110),"COST SERVICES SUBJECT TO DEDUCTIBLES AND COINSURANCE - COST, Occupational Therapy (D_5_HOS_C6_67)",Pancreas Acquisition (A_C2_109),"COST REIMBURSED SERVICES NOT SUBJECT TO DEDUCTIBLES AND COINSURANCE - CHARGES, Radioisotope (D_5_HOS_C4_56)",CT Scan (D3_SNF_C3_57),Cardiac Catheterization (C_1_C5_59),"ADJUSTED SALARIES, Home Office Salaries & Wage Related Csts (S3_2_C4_14)",RHC 22 Provider Number (S2_1_C2_1521),"AVERAGE HOURLY WAGE, Management and Administrative Services (S3_2_C6_12)","PAID HOURS RELATED TO SALARIES, Nursing Administration (S3_2_C5_38)",Cardiac Catheterization (A_C2_59),Respiratory Therapy (D3_HOS_C2_65),"PPS REIMBURSED SERVICES -  CHARGES, Recovery Room (D_5_HOS_C2_51)","Blood Storing, Processing, Trans (D3_IRF_C2_63)",Does the hospital qualify as RPCH/CAH? (Y/N) (S2_1_C1_105),Other Reimbursable (A_C1_98),Excess of reasonable cost over reasonable charges (E_B_HOS_C1_20),OOT (B_2_C26_9930),Radiology-Diagnostic (A_C2_54),Hospice (S3_1_C6_24),Physical Therapy (D3_SNF_C3_66),Total Facility (S3_1_C2_27),Laboratory (D3_IPF_C3_60),Labor and Delivery (S3_1_C2_32),FQHC 8 Provider Number (S2_1_C2_1607),Speech Pathology (A_C6_68),Physical Therapy (D_4_HOS_C2_66),"Net Expense for Cost Allocation, Electroencephalography (B_1_C0_70)",Pancreas Acquisition (B_1_C26_109),Adults and Pediatrics (B_1_C26_30),Int & Res (non approved teaching program (C_1_C6_100),Intestinal Acquisition (B_1_C22_110),Other Outpatient Services (D_4_HOS_C2_93),Outpatient Rehab Provider (S3_1_C10_25),"AMOUNT REPORTED, Physician Part A (S3_2_C3_22)","COST REIMBURSED SERVICES SUBJECT TO DEDUCTIBLES  AND COINSURANCE - CHARGES, Renal Dialysis (D_5_HOS_C3_74)",Laboratory (D_4_IPF_C13_60),"PAID HOURS RELATED TO SALARIES, Home Office Salaries & Wage Related Csts (S3_2_C5_14)",Heart Acquisition (A_C1_106),Electrocardiology (A_C1_69),Total Other Medical Education (D_4_IPF_C4_200),Subprovider-IPF (A_C1_40),Other Nonreimbursable (A_C2_194),"PPS REIMBURSED SERVICES -  CHARGES, Other Ancillary (D_5_HOS_C2_76)","Purchases, Buildings and Fixtures (A7_1_C2_3)",SNF (S3_1_C8_19),"Total Inpatient Charges, OLTC (C_1_C6_46)",Laboratory (A_C2_60),NF (B_1_C26_45),Subprovider 1 (S3_1_C3_18),MDH status beginning date  (MM/DD/YY) (S2_1_C1_3801),Intensive Care Unit (D3_IPF_C2_31),Emergency (A_C2_91),FQHC (A_C6_89),Medical and Other Services reimbursed by OPPS (E_B_HOS_C101_2),"Total Inpatient Charges, Intensive Care Unit (C_1_C6_31)",SNF (S3_1_C9_19),Surgical Intensive Care Unit (B_1_C26_34),Intestinal Acquisition (C_1_C7_110),"ADJUSTED SALARIES, Wage Related Costs Core (S3_2_C4_17)",Less Contractual Allowance and Discounts on Patients' Accounts (G3_C1_2),Nonpaid Workers (A_C1_193),"HHA I, LUPA Episodes:  Other Charges (S4_HHA1_C3_34)",Total Other Medical Education (D_4_IRF_C4_200),"COST REIMBURSED SERVICES NOT SUBJECT TO DEDUCTIBLES AND COINSURANCE - CHARGES, Speech Pathology (D_5_HOS_C4_68)",Drugs Charged to Patients (D_4_HOS_C13_73),MRI (A_C6_58),"Allocation of Interns & Residents Program Costs, Occupational Therapy (B_1_C22_67)",Other Reimbursable (D_4_IRF_C11_98),"COST SERVICES SUBJECT TO DEDUCTIBLES AND COINSURANCE - COST, CT Scan (D_5_HOS_C6_57)",Renal Dialysis (C_1_C6_74),Is this hospital an All-Inclusive rate provider? (Y/N) (S2_1_C1_115),Surgical Intensive Care Unit (S3_1_C3_11),"HHA I, PEP:  Total Number of Outlier Episodes (S4_HHA1_C4_37)",Ancillary service charges (E_B_HOS_C1_12),"Depreciation, New Cap Related Csts Bldg & Fixtures (A7_3_C9_1)",Total Facility FTEs (S3_1_C10_27),Hospital County (S2_1_C4_2),Observation Beds (Distinct Unit) (A_C6_9201),Medical Supplies Charged to Patients (D_4_SNF_C11_71),"HHA III, Without Outliers:  Total Visits (S4_HHA3_C1_33)",Medical Supplies Charged to Patients (D3_SNF_C2_71),Payroll taxes payable (G_C1THRU4_39),Electroencephalography (D_4_HOS_C13_70),Cardiac Catheterization (A_C6_59),"ADJUSTED SALARIES, Total (S3_3_C4_6)",SNF Provider Number (S2_1_C2_9),Other Special Care Unit (D_1_HOS_C6_35),"HHA III, PEP Episodes:  Total Charges: (S4_HHA3_C4_35)",Nonpaid Workers (B_1_C22_193),Total (D_1_HOS_C4_200),"Donations, Building Improvements (A7_1_C3_4)","Blood Storing, Processing, Trans (C_1_C7_63)",Respiratory Therapy (D_4_IRF_C11_65),Medical Supplies Charged to Patients (D_4_IPF_C11_71),Other Special Care (S3_1_C3_12),Ancillary service other pass through costs (E_B_HOS_C1_9),"Net Expense for Cost Allocation, Liver Acquisition (B_1_C0_107)",Recovery Room (D_4_HOS_C3_51),Radioisotope (D3_IRF_C2_56),Other Ancillary (A_C6_76),Title V discharges (S3_1_C12_1),Total Other Expenses (G3_C1_28),"COST REIMBURSED SERVICES NOT SUBJECT TO DEDUCTIBLES AND COINSURANCE - CHARGES, Home Program Dialysis (D_5_HOS_C4_94)",Home Office PO Box (S2_1_C2_142),Radioisotope (D_4_SNF_C11_56),Drugs Charged to Patients (D_4_HOS_C4_73),Electrocardiology (D_4_IRF_C11_69),"Allocation of Interns & Residents Program Costs, Radiology-Therapeutic (B_1_C22_55)",Drugs Charged to Patients (B_1_C21_73),Geographic MSA (MSA),Radiology-Diagnostic (D_4_HOS_C11_54),RHC 1 Provider Number (S2_1_C2_15),Blood Clotting Factors for Hemoph. (A_C1_6250),Radiology-Diagnostic (D3_IPF_C3_54),Utilization Review SNF (A_C2_114),Drugs Charged to Patients (A_C1_73),Nursery (B_1_C26_43),Other Reimbursable (D3_SNF_C3_98),"PPS SERVICES COST, Physical Therapy (D_5_HOS_C5_66)","Gift, Flower, Coffee Shop, Canteen (A_C1_190)",CORF (A_C6_9910),"COST REIMBURSED SERVICES NOT SUBJECT TO DEDUCTIBLES AND COINSURANCE - CHARGES, Renal Dialysis (D_5_HOS_C4_74)","Beginning Balances, Fixed Equipment (A7_1_C1_5)",Delivery Room and Labor Room (D_4_IPF_C11_52),Total Assets (G_C1THRU4_36),Renal Dialysis (D3_HOS_C3_74),"PAID HOURS RELATED TO SALARIES, Social Service (S3_2_C5_42)",Total Nursing School (D_4_IPF_C2_200),"AMOUNT REPORTED, Total (S3_3_C2_6)","TOTAL CAPITAL COSTS AFTER COST ALLOCATION, Laboratory (B_2_C26_60)",Electrocardiology (D3_SNF_C3_69),CT Scan (D3_IRF_C2_57),"AMOUNT REPORTED, Housekeeping under contract (S3_2_C2_33)",Anesthesiology (D3_IPF_C3_53),ASC (Distinct Part) (A_C1_115),"Donations, Movable Equipment (A7_1_C3_6)",Line 2 times line 5 (E_B_HOS_C1_6),Occupational Therapy (D_4_IPF_C11_67),"HHA II, Total Number of Outlier Episodes (S4_HHA2_C5_37)",Anesthesiology (D_4_HOS_C3_53),Respiratory Therapy (D_4_HOS_C11_65),"Insurance, New Cap Related Csts Movable Equipment (A7_3_C5_2)",Total Salaries (A_C6_200),Burn Intensive Care Unit (S3_1_C2_10),Emergency (C_1_C5_91),"Allocation of Interns & Residents Salary and Fringes, Intravenous Therapy (B_1_C21_64)",IPF (S3_1_C6_16),Other Special Care Unit (A_C2_35),TOTAL (D3_IPF_C2_200),CT Scan (C_1_C5_57),"AMOUNT REPORTED, Medical Records & Med Records Library (S3_2_C2_41)",Speech Pathology (D_4_HOS_C3_68),Emergency (D3_IRF_C3_91),"HHA I, Total Charges:  LUPA Episodes (S4_HHA1_C3_35)",Respiratory Therapy (A_C1_65),Total (C_1_C7_202),Adults & Pediatrics (C_1_C5_30),"COST SERVICES SUBJECT TO DEDUCTIBLES AND COINSURANCE - COST, Blood Clotting Factors for Hemoph. (D_5_HOS_C6_6250)",Delivery Room and Labor Room (D3_SNF_C2_52),ASC (Non Distinct Part) (D3_IPF_C2_75),RHC (C_1_C5_88),Anesthesiology (D_4_HOS_C10_53),OLTC (C_1_C5_46),Other Ancillary (D_4_HOS_C12_76),Intestinal Acquisition (A_C6_110),Durable Medical Equipment Sold (B_2_C26_97),Lung  Acquisition (C_1_C7_108),Liver Acquisition (C_1_C5_107),Durable Medical Equipment Sold (A_C6_97),SNF (C_1_C5_44),Laundry and Linen Service (A8_C2_13),Other Ancillary (D_4_HOS_C2_76),MDH status ending date (MM/DD/YY) (S2_1_C2_3801),"COST REIMBURSED SERVICES NOT SUBJECT TO DEDUCTIBLES AND COINSURANCE - CHARGES, Other Ancillary (D_5_HOS_C4_76)","AMOUNT REPORTED, Physician Part A (S3_2_C2_2201)","Net Expense for Cost Allocation, Interns & Res Other Program Costs (B_1_C0_22)",Total Program Excludable Costs (D1_HOS_C1_52),"COST SERVICES SUBJECT TO DEDUCTIBLES AND COINSURANCE - COST, Radiology-Diagnostic (D_5_HOS_C6_54)",HHA (S3_1_C6_22),RHC 23 Provider Number (S2_1_C2_1522),"Net Expense for Cost Allocation, Blood Storing, Processing, Trans (B_1_C0_63)",Intensive Care Unit (S3_1_C3_8),Title XVIII discharges (S3_1_C13_1),IRF Provider Number (S2_1_C2_5),PBP Clinical Lab Services Program Only (D3_HOS_C2_61),"AVERAGE HOURLY WAGE, Physician-Part A (S3_2_C6_4)",Coronary Care Unit (D3_IRF_C2_32),Electroencephalography (C_1_C6_70),Respiratory Therapy (D_4_IRF_C13_65),IPPS Payment amount (unadjusted) (E_A_HOS_C1_59),Islet Acquisition (A_C2_111),"Total Inpatient Charges, MRI (C_1_C6_58)","PPS SERVICES COST, Emergency (D_5_HOS_C5_91)",Hospice (B_1_C22_116),Total Patient Days (D_3_HOS_C6_200),"COST SERVICES SUBJECT TO DEDUCTIBLES AND COINSURANCE - COST, Durable Medical Equipment Sold (D_5_HOS_C6_97)","Disposals and Retirements, Fixed Equipment (A7_1_C7_5)",Organ Procurement (D4_ISLET_C1_69),Intravenous Therapy (D3_HOS_C2_64),"PPS SERVICES COST, Operating Room (D_5_HOS_C5_50)",Hospice (S3_1_C9_24),State (S2_1_C2_143),Electroencephalography (D_4_IRF_C13_70),"PPS REIMBURSED SERVICES -  CHARGES, Whole Blood & Packed Red Blood Cells (D_5_HOS_C2_62)","Net Expense for Cost Allocation, Other Special Purpose (B_1_C0_117)",Anesthesiology (D_4_IRF_C13_53),Transitional corridor payment (E_B_HOS_C1_8),Intestinal Acquisition (A_C1_110),"Total Outpatient Charges, Laboratory (C_1_C7_60)",Radiology-Therapeutic (D_4_IPF_C11_55),Observation Beds (Distinct Unit) (D_4_HOS_C11_9201),Electroencephalography (D3_IRF_C2_70),"HHA I, LUPA:  Total Non Routine Med Sup Chgs (S4_HHA1_C3_38)",Does the facility operate an ICF/MR facility for purposes of Title XIX? (Y/N) (S2_1_C1_93),Number of EPO units furnished for Line 13 (S5_C1_15),"Income from imposition of interest, finance (A8_C2_21)",Cardiac Catheterization (D3_IPF_C3_59),Radiology-Therapeutic (D_4_HOS_C11_55),CORF (A_C1_9910),Anesthesiology (A_C2_53),Radioisotope (D3_HOS_C2_56),"HHA II, LUPA Episodes:  Total Visits (S4_HHA2_C3_33)","COST REIMBURSED SERVICES NOT SUBJECT TO DEDUCTIBLES AND COINSURANCE - CHARGES, Occupational Therapy (D_5_HOS_C4_67)","HHA II, Total Charges (S4_HHA2_C5_35)","Number of Times per week 
Patient receives Dialysis (S5_C3_2)",City (S2_1_C1_143),Electrocardiology (D3_HOS_C3_69),Nursing Administration (A_C1_13),HMO (S3_1_C7_2),"Total Outpatient Charges, Blood Clotting Factors for Hemoph. (C_1_C7_6250)","PPS REIMBURSED SERVICES -  CHARGES, Radiology-Diagnostic (D_5_HOS_C2_54)",Ambulance Services (A_C6_95),Delivery Room and Labor Room (D_4_IRF_C13_52),Speech Pathology (C_1_C5_68),Report Status Code (RPT_STUS_CD),"AVERAGE HOURLY WAGE, Social Service (S3_2_C6_42)",Other Special Purpose (B_1_C21_117),"ADJUSTED SALARIES, Operation of Plant (S3_2_C4_30)",Surgical Intensive Care Unit (S3_1_C2_11),Physicians' Private Office (A_C1_192),Laboratory (D_4_HOS_C10_60),"COST SERVICES SUBJECT TO DEDUCTIBLES AND COINSURANCE - COST, Laboratory (D_5_HOS_C6_60)","PAID HOURS RELATED TO SALARIES, Total Salaries (S3_2_C5_1)",ASC (Distinct Part) (B_1_C21_115),"PPS SERVICES COST, Radioisotope (D_5_HOS_C5_56)","AVERAGE HOURLY WAGE, Central Services and Supply (S3_2_C6_39)",Radioisotope (D3_SNF_C3_56),"If (SCH), enter the # of periods. (S2_1_C1_35)",Other Special Care (S3_1_C8_12),Lesser of cost or charges (E_B_HOS_C1_21),"Gift, Flower, Coffee Shop, Canteen (B_1_C26_190)","Does this facility operate 
transplant center? (Y/N) (S2_1_C1_125)",Kidney Acquisition (A_C2_105),"Beginning Balances, Total (A7_1_C1_10)",Cardiac Catheterization (D_4_SNF_C11_59),Home Program Dialysis (C_1_C5_94),"COST REIMBURSED SERVICES NOT SUBJECT TO DEDUCTIBLES AND COINSURANCE - CHARGES, Observation Beds (Distinct Unit) (D_5_HOS_C4_9201)","COST SERVICES SUBJECT TO DEDUCTIBLES AND COINSURANCE - COST, Other Reimbursable (D_5_HOS_C6_98)",Intensive Care Unit (D3_SNF_C2_31),"AVERAGE HOURLY WAGE, Non-Physician Anesthetist Part A (S3_2_C6_2)","Allocation of Interns & Residents Program Costs, Blood Storing, Processing, Trans (B_1_C22_63)","TOTAL CAPITAL COSTS AFTER COST ALLOCATION, Total Directly Assigned New Cap Rel Csts (B_2_C0_202)",Drugs Charged to Patients (D_4_IRF_C11_73),Buildings (G_C1THRU4_15),Laboratory (D_4_HOS_C13_60),Hospital Provider Number (PRVDR_NUM),Cardiac Catheterization (D_4_HOS_C13_59),ASC (Non Distinct Part) (D_4_HOS_C11_75),Occupational Therapy (D_4_IPF_C13_67),RHC 18 Provider Number (S2_1_C2_1517),"Net Expense for Cost Allocation, OPT (B_1_C0_9920)","PPS REIMBURSED SERVICES -  CHARGES, Other Reimbursable (D_5_HOS_C2_98)","COST SERVICES SUBJECT TO DEDUCTIBLES AND COINSURANCE - COST, PBP Clinical Lab Services Program Only (D_5_HOS_C6_61)","Blood Storing, Processing, Trans (C_1_C6_63)",ICF (B_1_C26_4501),Durable Medical Equipment Rented (A_C6_96),"Allocation of Interns & Residents Salary and Fringes, NF (B_1_C21_45)",MRI (D_4_HOS_C2_58),"Allocation of Interns & Residents Salary and Fringes, Electroencephalography (B_1_C21_70)","ADJUSTED SALARIES, Maintenance of Personnel (S3_2_C4_37)",Home Program Dialysis (D3_HOS_C2_94),Medical Supplies Charged to Patients (D_4_HOS_C11_71),"AVERAGE HOURLY WAGE, Administrative and General under Contract (S3_2_C6_28)",Other Outpatient Services (D_4_IRF_C13_93),Utilization Review SNF (A_C1_114),Other Ancillary (D_4_HOS_C13_76),Radiology-Diagnostic (C_1_C5_54),Other Reimbursable (B_2_C26_98),"ADJUSTED SALARIES, Central Services and Supply (S3_2_C4_39)",TOTAL (D3_SNF_C3_200),Radiology-Diagnostic (D_4_IPF_C13_54),Cardiac Catheterization (D3_SNF_C2_59),HHA (B_1_C22_101),"AMOUNT REPORTED, Pharmacy (S3_2_C2_40)",Total Subprovider I Interns & Residents (S3_1_C9_18),Subprovider-IRF (D_1_HOS_C7_41),"TOTAL CAPITAL COSTS AFTER COST ALLOCATION, Whole Blood & Packed Red Blood Cells (B_2_C26_62)",Rental of Provider space by suppliers (A8_C2_6),HRR adjustment amount (E_A_HOS_C1_7094),Hospice 3 Provider Number (S2_1_C2_1402),Surgical Intensive Care Unit (D3_SNF_C2_34),Central Services and Supply (A_C6_14),Operating Room (D_4_IPF_C11_50),Electrocardiology (D3_IRF_C3_69),Home Program Dialysis (B_1_C21_94),Coronary Intensive Care Unit (D_1_HOS_C6_32),Emergency (D_4_HOS_C4_91),Cost of physicians svcs in a teaching hospita (E_B_HOS_C1_23),Whole Blood & Packed Red Blood Cells (D3_IPF_C2_62),HMO (S3_1_C6_2),Occupational Therapy (D3_IPF_C3_67),"Taxes, Total (A7_3_C6_3)",Ambulance Services (C_1_C5_95),CT Scan (A_C1_57),Title XIX discharges (S3_1_C14_17),Subprovider II (A_C2_4201),"Allocation of Interns & Residents Salary and Fringes, OLTC (B_1_C21_46)",Net Revenue from Medicaid (S10_C1_2),Accounts Receivable (G_C1THRU4_4),"PAID HOURS RELATED TO SALARIES, Contract Labor (S3_2_C5_11)","PAID HOURS RELATED TO SALARIES, Non-Physician Part B (S3_2_C5_6)","AMOUNT REPORTED, Non-Physician Anesthetist Part B (S3_2_C2_21)","Number of patients in program at 
end of cost reporting period (S5_C4_1)","Total Inpatient Charges, ICF (C_1_C6_4501)",Pass Through Cost for  Program Ancillary (D1_IPF_C1_51),Recovery Room (D3_HOS_C3_51),"AVERAGE HOURLY WAGE, Home Office Personnel (S3_2_C6_8)",OLTC (S3_1_C8_21),"TOTAL CAPITAL COSTS AFTER COST ALLOCATION, ICF (B_2_C26_4501)",Physical Therapy (D_4_IRF_C13_66),Clinic (D3_SNF_C3_90),Recovery Room (D_4_IRF_C11_51),Clinic (C_1_C6_90),Other Ancillary (B_2_C26_76),"AMOUNT REPORTED, Physician Part A (S3_2_C2_22)",Observation Beds (Distinct Unit) (A_C1_9201),Renal 9 Provider Number (S2_1_C2_1808),"Total Outpatient Charges, Whole Blood & Packed Red Blood Cells (C_1_C7_62)",Total Costs (D_3_HOS_C5_200),Respiratory Therapy (D_4_HOS_C2_65),Electrocardiology (D3_SNF_C2_69),Ending Date of SCH status (S2_1_C2_3601),"HHA II, Without Outliers:  Non Routine Med Sup Chgs (S4_HHA2_C1_38)","HHA III, Total Number of Episodes (S4_HHA3_C5_36)","Donations, Land Improvements (A7_1_C3_2)",Lung  Acquisition (C_1_C5_108),"AMOUNT REPORTED, Interns & Residents (S3_2_C3_25)",Interns & Res Salary and Fringe Benefits (A_C6_21),"COST SERVICES NOT SUBJECT TO DEDUCTIBLES AND COINSURANCE - COST, ASC (Non Distinct Part) (D_5_HOS_C7_75)","TOTAL CAPITAL COSTS AFTER COST ALLOCATION, Subprovider-IPF (B_2_C26_40)",Respiratory Therapy (D_4_HOS_C10_65),Blood Clotting Factors for Hemoph. (D3_IPF_C2_6250),"Medical certified lung
transplant center cert date (S2_1_C1_129)",Speech Pathology (D_4_IRF_C13_68),RHC (C_1_C6_88),Coronary Care Unit (A_C1_32),OLTC (S3_1_C9_21),Surgical Intensive Care Unit (A_C1_34),Heart Acquisition (B_1_C26_106),"AVERAGE HOURLY WAGE, Interns & Residents (S3_2_C6_7)",Less Observation Beds (C_1_C5_201),Sale of medical and surgical supplies to (A8_C2_16),Observation Beds (Distinct Unit) (C_1_C7_9201),Whole Blood & Packed Red Blood Cells (D3_SNF_C3_62),Observation Beds (Distinct Unit) (D3_HOS_C3_9201),CMHC (B_2_C26_99),Observation Beds (Distinct Unit) (B_1_C26_9201),Other Ancillary (D_4_HOS_C3_76),Interns & Res Other Program Costs (A_C2_22),Whole Blood & Packed Red Blood Cells (B_1_C26_62),"Net Expense for Cost Allocation, PBP Clinical Lab Services Program Only (B_1_C0_61)",Radiology-Diagnostic (A_C6_54),HHA (C_1_C5_101),Burn Intensive Care Unit (S3_1_C4_10),Ambulance Services (A_C2_95),Laundry and Linen Service (A_C2_8),Drugs Charged to Patients (C_1_C6_73),Recovery Room (D_4_HOS_C10_51),Sequestration adjustment (E_B_HOS_C1_4001),Physical Therapy (A_C2_66),Radioisotope (D_4_HOS_C2_56),Occupational Therapy (D_4_HOS_C11_67),Speech Pathology (D3_HOS_C2_68),Total Program Inpatient Costs (D1_HOS_C1_49),"HHA II, LUPA Episodes:  Other Charges (S4_HHA2_C3_34)","PPS REIMBURSED SERVICES -  CHARGES, MRI (D_5_HOS_C2_58)",Intestinal Acquisition (A_C2_110),"Insurance, New Cap Related Csts Bldg & Fixtures (A7_3_C5_1)",FQHC 2 Provider Number (S2_1_C2_1601),"Beginning Balances, Movable Equipment (A7_1_C1_6)","ADJUSTED SALARIES, Teaching Physician Salaries (S3_2_C4_1602)",Radiology-Diagnostic (D_4_HOS_C13_54),Related Organization Transactions (A8_C2_12),CT Scan (D_4_IRF_C11_57),"PPS REIMBURSED SERVICES -  CHARGES, Electrocardiology (D_5_HOS_C2_69)","Fully Depreciated Assets, Total (A7_1_C7_10)",Pancreas Acquisition (C_1_C7_109),"PAID HOURS RELATED TO SALARIES, Subtotal Salaries (S3_3_C5_3)",Utilization Code (L/N/F) (UTIL_CODE),"Net Expense for Cost Allocation, New Capital Equipment (B_1_C0_2)",Respiratory Therapy (C_1_C5_65),"COST SERVICES NOT SUBJECT TO DEDUCTIBLES AND COINSURANCE - COST, Laboratory (D_5_HOS_C7_60)","COST REIMBURSED SERVICES NOT SUBJECT TO DEDUCTIBLES AND COINSURANCE - CHARGES, Respiratory Therapy (D_5_HOS_C4_65)","Percentage of patients re-using
dialyzers (S5_C1_10)",Durable Medical Equipment Rented (C_1_C6_96),ASC (Non Distinct Part) (D_4_HOS_C12_75),Coronary Care Unit (D3_HOS_C2_32),Renal Dialysis (D_4_HOS_C11_74),Other Special Purpose (B_1_C22_117),Investment Income-New Bldgs & Fixtures (A8_C2_1),Refunds and Rebates of Expenses (A8_C2_5),Laboratory (D3_HOS_C2_60),"Net Expense for Cost Allocation, Physicians' Private Office (B_1_C0_192)",Radiology-Therapeutic (D3_HOS_C2_55),"HHA I, W/Out Outliers:  Number of Episodes (S4_HHA1_C1_36)",Medical Supplies Charged to Patients (D3_HOS_C2_71),New Capital Buildings and Fixtures (A_C2_1),Speech Pathology (D3_SNF_C2_68),"Blood Storing, Processing, Trans (D3_IPF_C2_63)",Other Assets (G_C1THRU4_34),HHA (S3_1_C11_22),Physicians' Assistant (A8_C2_29),Other Ancillary (D_4_IRF_C13_76),Clinic (D3_IRF_C2_90),RPCH/CAH Visits (S3_1_C7_15),"PAID HOURS RELATED TO SALARIES, Physician-Part B (S3_2_C5_5)","Total, New Cap Related Csts Movable Equipment (A7_3_C15_2)","COST SERVICES SUBJECT TO DEDUCTIBLES AND COINSURANCE - COST, Electrocardiology (D_5_HOS_C6_69)","Net Expense for Cost Allocation, Heart Acquisition (B_1_C0_106)","Disposals and Retirements, Subtotal (A7_1_C5_8)",Hospital Adults & Pediatrics (S3_1_C4_1),CT Scan (D_4_HOS_C11_57),Line 2 times line 5 (E_B_HOS_C101_6),Land (G_C1THRU4_12),"ADJUSTED SALARIES, Physician-Part B (S3_2_C4_5)","Number of patients in program at 
end of cost reporting period (S5_C6_1)",Islet Acquisition (C_1_C7_111),"PPS REIMBURSED SERVICES -  CHARGES, Renal Dialysis (D_5_HOS_C2_74)","HHA II, LUPA Episodes:  Total Number of Episodes (S4_HHA2_C3_36)",Renal Dialysis (C_1_C5_74),Is this hospital classified as a referral center? (Y/N) (S2_1_C1_116),"COST REIMBURSED SERVICES SUBJECT TO DEDUCTIBLES  AND COINSURANCE - CHARGES, Observation Beds (Distinct Unit) (D_5_HOS_C3_9201)","AMOUNT REPORTED, Wage Related Costs RHC/FQHC (S3_2_C3_24)","Net Expense for Cost Allocation, Pharmacy (B_1_C0_15)","Net Expense for Cost Allocation, Radioisotope (B_1_C0_56)","Allocation of Interns & Residents Salary and Fringes, Anesthesiology (B_1_C21_53)",Kidney Acquisition (A_C1_105),Subprovider I (A_C2_42),Other Reimbursable (D3_SNF_C2_98),HHA (A_C6_101),NF (S3_1_C7_20),Other Reimbursable (B_1_C21_98),Other Special Care Unit (D3_IPF_C2_35),Burn Intensive Care Unit (S3_1_C6_10),"Fully Depreciated Assets, Subtotal (A7_1_C7_8)","Allocation of Interns & Residents Program Costs, Adults and Pediatrics (B_1_C22_30)",Impl. Dev. Charged to Patients (D3_IRF_C3_72),Sale of medical records and abstracts (A8_C2_18),SNF (S3_1_C3_19),Occupational Therapy (D3_SNF_C2_67),Blood Clotting Factors for Hemoph. (D3_IRF_C3_6250),Minor Equipment Depreciable (G_C1THRU4_25),Impl. Dev. Charged to Patients (D3_IRF_C2_72),"AVERAGE HOURLY WAGE, Operation of Plant (S3_2_C6_30)",Subprovider I (A_C1_42),"HHA III, LUPA Episodes:  Total Visits (S4_HHA3_C3_33)",Operating Room (D3_IRF_C3_50),Drugs Charged to Patients (C_1_C5_73),Negative Cost Centers (B_2_C26_201),Electroencephalography (D_4_HOS_C3_70),"COST REIMBURSED SERVICES SUBJECT TO DEDUCTIBLES  AND COINSURANCE - CHARGES, Anesthesiology (D_5_HOS_C3_53)",Inventory (G_C1THRU4_7),Operating Room (A_C2_50),Coronary Care Unit (A_C6_32),"Gift, Flower, Coffee Shop, Canteen (A_C6_190)","COST SERVICES NOT SUBJECT TO DEDUCTIBLES AND COINSURANCE - COST, Total (D_5_HOS_C7_200)","PPS REIMBURSED SERVICES -  CHARGES, Observation Beds (Distinct Unit) (D_5_HOS_C2_9201)",Medicare Certified Lung TC term date (S2_1_C2_129),Pancreas Acquisition (A_C1_109),Heart Acquisition (B_2_C26_106),Recovery Room (A_C6_51),Electrocardiology (D3_IPF_C3_69),Anesthesiology (C_1_C5_53),OPPS payments (E_B_HOS_C101_3),Other Reimbursable (D3_IPF_C2_98),"Net Expense for Cost Allocation, CORF (B_1_C0_9910)","Net Expense for Cost Allocation, Islet Acquisition (B_1_C0_111)","COST REIMBURSED SERVICES SUBJECT TO DEDUCTIBLES  AND COINSURANCE - CHARGES, Blood Clotting Factors for Hemoph. (D_5_HOS_C3_6250)","PPS REIMBURSED SERVICES -  CHARGES, Blood Storing, Processing, Trans (D_5_HOS_C2_63)",ASC (Non Distinct Part) (A_C2_75),"PPS SERVICES COST, CT Scan (D_5_HOS_C5_57)","COST SERVICES NOT SUBJECT TO DEDUCTIBLES AND COINSURANCE - COST, Radiology-Therapeutic (D_5_HOS_C7_55)",Cardiac Catheterization (A_C1_59),"COST SERVICES SUBJECT TO DEDUCTIBLES AND COINSURANCE - COST, Other Ancillary (D_5_HOS_C6_76)",Other Organ Acquisition (C_1_C6_112),Recovery Room (D3_SNF_C3_51),Respiratory Therapy (A_C6_65),"Net Expense for Cost Allocation, Other Special Care Unit (B_1_C0_35)",Intensive Care Unit (S3_1_C4_8),"Total Inpatient Charges, Subprovider I (C_1_C6_42)",Anesthesiology (D_4_IPF_C11_53),Employee Benefits (A_C2_4),Emergency (B_1_C21_91),"AVERAGE HOURLY WAGE, Laundry and Linen Service (S3_2_C6_31)",RHC 8 Provider Number (S2_1_C2_1507),Delivery Room and Labor Room (A_C1_52),"ADJUSTED SALARIES, Nursing Administration (S3_2_C4_38)",Speech Pathology (C_1_C7_68),"Blood Storing, Processing, Trans (D3_IRF_C3_63)",Int & Res (non approved teaching program (B_2_C26_100),Total (D_4_HOS_C1_200),"COST SERVICES NOT SUBJECT TO DEDUCTIBLES AND COINSURANCE - COST, Speech Pathology (D_5_HOS_C7_68)",Radiology-Diagnostic (D3_SNF_C3_54),Lung  Acquisition (B_1_C26_108),Renal 4 Provider Number (S2_1_C2_1803),Emergency (D_4_HOS_C12_91),Drugs Charged to Patients (D3_HOS_C2_73),Subprovider-IPF (A_C2_40),Other Special Care (S3_1_C6_12),MRI (D_4_HOS_C11_58),OSP (A_C1_9940),Other Ancillary (D3_IRF_C3_76),Total Hospital (S3_1_C5_14),"PPS SERVICES COST, Durable Medical Equipment Rented (D_5_HOS_C5_96)",Speech Pathology (C_1_C6_68),Anesthesiology (D3_IPF_C2_53),Subprovider I (D_1_HOS_C4_42),Other Special Care Unit (D_1_HOS_C7_35),Electrocardiology (D_4_IPF_C11_69),Nursery (D_1_HOS_C4_43),PBP Clinical Lab Services Program Only (A_C2_61),Int & Res (non approved teaching program (A_C6_100),"PAID HOURS RELATED TO SALARIES, Housekeeping (S3_2_C5_32)",Medical and Other Services (E_B_HOS_C1_1),"Epoietin amount form worksheet A
for home dialysis program (S5_C1_14)",ASC (Non Distinct Part) (D_4_HOS_C2_75),MRI (D_4_SNF_C11_58),Observation Beds (Distinct Unit) (D_4_SNF_C11_9201),"Allocation of Interns & Residents Salary and Fringes, CT Scan (B_1_C21_57)",TOTAL (D3_IPF_C3_200),"AVERAGE HOURLY WAGE, Subtotal Wage Related Csts (S3_3_C6_5)","COST REIMBURSED SERVICES SUBJECT TO DEDUCTIBLES  AND COINSURANCE - CHARGES, Clinic (D_5_HOS_C3_90)",Investments (G_C1THRU4_31),Recovery Room (D_4_IPF_C13_51),"COST REIMBURSED SERVICES NOT SUBJECT TO DEDUCTIBLES AND COINSURANCE - CHARGES, Cardiac Catheterization (D_5_HOS_C4_59)",Whole Blood & Packed Red Blood Cells (D_4_IRF_C13_62),Coronary Care Unit (C_1_C5_32),Radiology-Diagnostic (D_4_HOS_C4_54),"AMOUNT REPORTED, Home Office Personnel (S3_2_C2_8)","AMOUNT REPORTED, Wage Related Costs Core (S3_2_C2_17)","HHA III, Total Charges (S4_HHA3_C5_35)","Net Expense for Cost Allocation, CMHC (B_1_C0_99)",Clinic (B_1_C21_90),"TOTAL CAPITAL COSTS AFTER COST ALLOCATION, Recovery Room (B_2_C26_51)",Other Ancillary (B_1_C21_76),"PPS REIMBURSED SERVICES -  CHARGES, Physical Therapy (D_5_HOS_C2_66)",General Fund Balance (G_C1THRU4_52),Other Organ Acquisition (C_1_C5_112),"Net Expense for Cost Allocation, Maintenance and Repairs (B_1_C0_6)",Delivery Room and Labor Room (D_4_HOS_C10_52),"Blood Storing, Processing, Trans (C_1_C5_63)",SSA State County Code (ST_CTY_CD),Other General Service (A_C2_18),Occupational Therapy (C_1_C7_67),NF (S3_1_C11_20),Hospice (C_1_C5_116),"AMOUNT REPORTED, Home Office:  Physician Part A (S3_2_C2_15)",Other Organ Acquisition (B_1_C26_112),Whole Blood & Packed Red Blood Cells (A_C6_62),Title XIX discharges (S3_1_C14_1),Other Outpatient Services (D_4_HOS_C13_93),"ADJUSTED SALARIES, Excluded Area Salaries (S3_2_C4_10)",TOTAL (D3_SNF_C2_202),Ambulance Services (B_1_C21_95),Depreciation-New Movable Equipment (A8_C2_27),OOT (A_C6_9930),Total Charges (C_1_C8_202),"AMOUNT REPORTED, Interns & Residents (S3_2_C3_2551)","AVERAGE HOURLY WAGE, Pharmacy (S3_2_C6_40)","Gift, Flower, Coffee Shop, Canteen (A_C2_190)","COST SERVICES NOT SUBJECT TO DEDUCTIBLES AND COINSURANCE - COST, Clinic (D_5_HOS_C7_90)","Allocation of Interns & Residents Program Costs, MRI (B_1_C22_58)","If Line 32, Col 1 is yes, enter the method used: (A, B, or E only) (S2_1_C2_115)",Maintenance of Personnel (A_C6_12),"Total Outpatient Charges, Radioisotope (C_1_C7_56)","Net Expense for Cost Allocation, Intravenous Therapy (B_1_C0_64)",Impl. Dev. Charged to Patients (C_1_C5_72),Payment to cost ratio (E_B_HOS_C1_5),Subprovider 1 (S3_1_C7_18),"HHA II, With Outliers:  Total Visits (S4_HHA2_C2_33)",Outlier payments (E_B_HOS_C101_4),Other Special Care Unit (A_C1_35),"Depreciation, New Cap Related Csts Movable Equipment (A7_3_C9_2)",Blood Clotting Factors for Hemoph. (B_1_C26_6250),OSP (A_C6_9940),"Allocation of Interns & Residents Salary and Fringes, Radioisotope (B_1_C21_56)",Laboratory (D3_SNF_C3_60),Burn Intensive Care Unit (S3_1_C7_10),Other Ancillary (D3_SNF_C3_76),"Allocation of Interns & Residents Salary and Fringes, Impl. Dev. Charged to Patients (B_1_C21_72)","Beginning Balances, Building Improvements (A7_1_C1_4)","AMOUNT REPORTED, Related Salaries (S3_2_C3_1402)",Adj for Speech therapy in excess of lim (A8_C2_31),Home Program Dialysis (C_1_C7_94),Electroencephalography (D3_IRF_C3_70),Renal Dialysis (D3_SNF_C3_74),"COST SERVICES NOT SUBJECT TO DEDUCTIBLES AND COINSURANCE - COST, Home Program Dialysis (D_5_HOS_C7_94)",MRI (D3_HOS_C2_58),"COST SERVICES NOT SUBJECT TO DEDUCTIBLES AND COINSURANCE - COST, Electroencephalography (D_5_HOS_C7_70)",Total Inpatient Program Days (D_3_HOS_C8_200),Cardiac Catheterization (D3_IRF_C3_59),"ADJUSTED SALARIES, Other General Service (S3_2_C4_43)",Anesthesiology (D_4_IRF_C11_53),"COST REIMBURSED SERVICES NOT SUBJECT TO DEDUCTIBLES AND COINSURANCE - CHARGES, ASC (Non Distinct Part) (D_5_HOS_C4_75)",Radioisotope (A_C6_56),Intravenous Therapy (B_2_C26_64),Ambulance Services (B_1_C22_95),Other Organ Acquisition (B_2_C26_112),Title XIX discharges (S3_1_C14_16),Maintenance and Repairs (A_C6_6),"Number of patients on transplant 
list (S5_C1_11)","Net Expense for Cost Allocation, Nursing Administration (B_1_C0_13)",Radiology-Therapeutic (D3_IPF_C2_55),Other Ancillary (D_4_HOS_C1_76),"Net Expense for Cost Allocation, Pancreas Acquisition (B_1_C0_109)",Burn Intensive Care Unit (D_1_HOS_C7_33),Social Service (A_C2_17),Intravenous Therapy (D_4_IRF_C11_64),Payments received from patients for amounts previously written off as charity care (S10_C2_22),Total unreimbursed cost for Medicaid and CHIP and state and local indigent care programs (S10_C1_19),HHA (B_2_C26_101),"Total Inpatient Charges, Radiology-Diagnostic (C_1_C6_54)",ASC (Non Distinct Part) (D3_HOS_C3_75),RHC (D_4_HOS_C2_88),FQHC (C_1_C5_89),"COST REIMBURSED SERVICES NOT SUBJECT TO DEDUCTIBLES AND COINSURANCE - CHARGES, Clinic (D_5_HOS_C4_90)",Intensive Care Unit (A_C2_31),OOT (C_1_C7_9930),Ambulance Services (A_C1_95),Durable Medical Equipment Sold (D_4_HOS_C12_97),TOTAL (D3_HOS_C3_200),"Net Expense for Cost Allocation, Housekeeping (B_1_C0_9)",Intestinal Acquisition (C_1_C5_110),"PAID HOURS RELATED TO SALARIES, Pharmacy (S3_2_C5_40)","COST REIMBURSED SERVICES NOT SUBJECT TO DEDUCTIBLES AND COINSURANCE - CHARGES, Total (D_5_HOS_C4_200)",Respiratory Therapy (D_4_HOS_C12_65),Observation Beds (Distinct Unit) (D_4_HOS_C2_9201),"COST REIMBURSED SERVICES SUBJECT TO DEDUCTIBLES  AND COINSURANCE - CHARGES, Radiology-Diagnostic (D_5_HOS_C3_54)",Other Special Care Unit (D_1_HOS_C4_35),Intravenous Therapy (A_C2_64),MDH status beginning date (MM/DD/YY) (S2_1_C1_38),ASC (Non Distinct Part) (B_1_C22_75),Nursing School (A_C1_20),"PPS SERVICES COST, Total (D_5_HOS_C5_200)",Intestinal Acquisition (B_1_C26_110),Total Hospital (S3_1_C2_14),Subprovider II (D_1_HOS_C4_4201),"COST REIMBURSED SERVICES SUBJECT TO DEDUCTIBLES  AND COINSURANCE - CHARGES, PBP Clinical Lab Services Program Only (D_5_HOS_C3_61)","Allocation of Interns & Residents Salary and Fringes, Whole Blood & Packed Red Blood Cells (B_1_C21_62)","HHA I, LUPA Episodes:  Total Visits (S4_HHA1_C3_33)",Social Service (A_C1_17),Burn Intensive Care Unit (A_C1_33),PBP Clinical Lab Services Program Only (D3_IRF_C2_61),SNF (B_1_C26_44),FQHC 12 Provider Number (S2_1_C2_1611),"Net Expense for Cost Allocation, Speech Pathology (B_1_C0_68)",Cafeteria (A_C2_11),Central Services and Supply (A_C2_14),Nursery (C_1_C5_43),SNF (S3_1_C5_19),Total Program Inpatient Costs (D1_IRF_C1_49),Respiratory Therapy (D3_IRF_C2_65),"AVERAGE HOURLY WAGE, Net Salaries (S3_3_C6_1)","Other Capital Related Costs, New Cap Related Csts Bldg & Fixtures (A7_3_C7_1)",Surgical Intensive Care Unit Program Cost (D1_HOS_C5_46),Total Fixed Assets (G_C1THRU4_30),RHC (C_1_C7_88),Total Subprovider II Interns & Residents (S3_1_C10_1801),"Purchases, Subtotal (A7_1_C2_8)","Blood Storing, Processing, Trans (D_4_IRF_C13_63)",Emergency (B_1_C26_91),Other Reimbursable (D_4_HOS_C2_98),Other Outpatient Services (D_4_HOS_C4_93),"PPS SERVICES COST, Electrocardiology (D_5_HOS_C5_69)",Heart Acquisition (C_1_C6_106),"TOTAL CAPITAL COSTS AFTER COST ALLOCATION, Subprovider II (B_2_C26_4201)",SNF (S3_1_C10_19),Radiology-Therapeutic (A_C6_55),Provider-based physician adjustment (A8_C2_10),"Allocation of Interns & Residents Program Costs, Burn Intensive Care Unit (B_1_C22_33)","ADJUSTED SALARIES, Home Office Personnel (S3_2_C4_8)",Adults & Pediatrics (D_1_HOS_C6_30),"COST SERVICES NOT SUBJECT TO DEDUCTIBLES AND COINSURANCE - COST, Physical Therapy (D_5_HOS_C7_66)",Liver Acquisition (A_C1_107),Medicaid HMO Days (S2_1_C5_24),Total Hospital (S3_1_C8_14),Maintenance of Personnel (A_C1_12),Prepaid expenses (G_C1THRU4_8),"COST SERVICES NOT SUBJECT TO DEDUCTIBLES AND COINSURANCE - COST, Delivery Room and Labor Room (D_5_HOS_C7_52)","HHA II, LUPA:  Total Non Routine Med Sup Chgs (S4_HHA2_C3_38)",Received DSH or supplemental payments from Medicaid? (Y/N) (S10_C1_3),Program Ancillary Services (D1_SNF_C1_84),Clinic (D_4_IPF_C13_90),Electrocardiology (A_C2_69),Radiology-Diagnostic (B_1_C26_54),FQHC (C_1_C6_89),"AMOUNT REPORTED, Dietary under contract (S3_2_C2_35)","ADJUSTED SALARIES, Contract Labor (S3_2_C4_11)",Renal Dialysis (D_4_IPF_C11_74),"Net Expense for Cost Allocation, Other Organ Acquisition (B_1_C0_112)",Interns & Res Other Program Costs (A_C1_22),"HHA II, PEP Episodes:  Other Charges (S4_HHA2_C4_34)","Net Expense for Cost Allocation, Occupational Therapy (B_1_C0_67)","Net Expense for Cost Allocation, Clinic (B_1_C0_90)",Renal Dialysis (B_2_C26_74),Intravenous Therapy (C_1_C5_64),Cardiac Catheterization (D_4_IPF_C11_59),Interns & Res Other Program Costs (A_C6_22),ASC (Non Distinct Part) (B_1_C21_75),"ADJUSTED SALARIES, Non-Physician Part B (S3_2_C4_6)","Is this a teaching hospital or
affiliated with a teaching hospital? (Y/N) (S2_1_C1_56)",Laboratory (D_4_HOS_C12_60),"PPS SERVICES COST, Medical Supplies Charged to Patients (D_5_HOS_C5_71)",Burn Intensive Care Unit Program Cost (D1_HOS_C5_45),Interim payments (E_B_HOS_C1_41),ICF (S3_1_C7_2001),"COST SERVICES SUBJECT TO DEDUCTIBLES AND COINSURANCE - COST, Durable Medical Equipment Rented (D_5_HOS_C6_96)",Speech Pathology (B_1_C26_68),OSP (C_1_C7_9940),Radioisotope (D_4_IRF_C11_56),IPF (S3_1_C3_16),"General Inpatient Routine Service Cost, net of Swing Bed and Private Room Diff (D1_SNF_C1_37)","HHA I, Total Visits (S4_HHA1_C5_33)",Pancreas Acquisition (C_1_C5_109),"PPS REIMBURSED SERVICES -  CHARGES, Cardiac Catheterization (D_5_HOS_C2_59)",Renal Dialysis (D3_SNF_C2_74),Other Reimbursable (B_1_C22_98),"COST SERVICES SUBJECT TO DEDUCTIBLES AND COINSURANCE - COST, MRI (D_5_HOS_C6_58)",MDH status ending date (MM/DD/YY) (S2_1_C2_38),"COST REIMBURSED SERVICES SUBJECT TO DEDUCTIBLES  AND COINSURANCE - CHARGES, Occupational Therapy (D_5_HOS_C3_67)",Durable Medical Equipment Sold (B_1_C26_97),Clinic (D_4_HOS_C3_90),Subprovider-IPF (C_1_C5_40),Paramedical Education (A_C6_23),Medical Supplies Charged to Patients (D3_SNF_C3_71),Operating Room (D_4_HOS_C2_50),Home Program Dialysis (B_1_C22_94),Are provider based physicians' costs included in Worksheet A? (Y/N) (S2_1_C1_144),OOT (C_1_C5_9930),ASC (Non Distinct Part) (C_1_C6_75),Clinic (D_4_HOS_C10_90),Subprovider 2 (S3_1_C7_1801),Physical Therapy (D_4_SNF_C11_66),Other Reimbursable (D_4_HOS_C11_98),Operating Room (D_4_HOS_C13_50),"HHA II, PEP:  Total Non Routine Med Supply Chgs (S4_HHA2_C4_38)",Emergency (D3_IPF_C3_91),"PAID HOURS RELATED TO SALARIES, Employee Benefits (S3_2_C5_26)",Other Organ Acquisition (A_C1_112),"Net Expense for Cost Allocation, Physical Therapy (B_1_C0_66)",Nursing School (A_C2_20),Clinic (A_C6_90),Clinic (C_1_C7_90),ASC (Non Distinct Part) (D_4_HOS_C13_75),Other Reimbursable (D_4_HOS_C10_98),Total Outpatient Program Pass Thru Cost (D_4_HOS_C6_200),"HHA II, PEP Episodes:  Total Number of Episodes (S4_HHA2_C4_36)",Target Amount (D1_HOS_C1_56),Pass through Cost for Program Inpatient (D1_IPF_C1_50),"AMOUNT REPORTED, Non-Physician Anesthetist Part A (S3_2_C2_2)","COST SERVICES SUBJECT TO DEDUCTIBLES AND COINSURANCE - COST, Delivery Room and Labor Room (D_5_HOS_C6_52)",Other Ancillary (D_4_HOS_C11_76),Intensive Care Unit (B_1_C26_31),Radiology-Diagnostic (D_4_IRF_C11_54),TOTAL (D3_IRF_C2_200),Other Ancillary (D_4_HOS_C4_76),Out of State Medicaid paid days (S2_1_C3_24),Observation Beds (Distinct Unit) (D_4_IPF_C11_9201),ASC (Non Distinct Part) (B_1_C26_75),Renal Dialysis (A_C6_74),Hospice 2 Provider Number (S2_1_C2_1401),Electroencephalography (D3_HOS_C3_70),Medical Supplies Charged to Patients (D_4_HOS_C3_71),Total (D_3_HOS_C9_200),Occupational Therapy (D3_IRF_C3_67),Radiology-Diagnostic (D3_IPF_C2_54),Radiology-Diagnostic (D_4_HOS_C3_54),"AMOUNT REPORTED, Total Salaries (S3_2_C2_1)","PAID HOURS RELATED TO SALARIES, Management and Administrative Services (S3_2_C5_12)",Mortgage Payable (G_C1THRU4_46),"PAID HOURS RELATED TO SALARIES, Other General Service (S3_2_C5_43)","PPS SERVICES COST, Cardiac Catheterization (D_5_HOS_C5_59)",CT Scan (D_4_IPF_C13_57),"AMOUNT REPORTED, Contract Labor (S3_2_C2_11)","Net Expense for Cost Allocation, OLTC (B_1_C0_46)",Total Salaries (A_C1_200),"COST REIMBURSED SERVICES SUBJECT TO DEDUCTIBLES  AND COINSURANCE - CHARGES, Physical Therapy (D_5_HOS_C3_66)",Medical Supplies Charged to Patients (D_4_HOS_C4_71),Respiratory Therapy (B_1_C26_65),"Net Expense for Cost Allocation, OOT (B_1_C0_9930)",HHA (A_C1_101),Total Fund Balances (G_C1THRU4_53),Number of periods hospital was in MDH status (S2_1_C1_37),"ADJUSTED SALARIES, Contract Labor:  Physician Part A (S3_2_C4_13)","TOTAL CAPITAL COSTS AFTER COST ALLOCATION, Blood Clotting Factors for Hemoph. (B_2_C26_6250)",Surgical Intensive Care Unit (S3_1_C7_11),Nonpaid Workers (B_2_C26_193),Occupational Therapy (D_4_HOS_C10_67),OPPS payments (E_B_HOS_C1_3),"ADJUSTED SALARIES, Teaching Physician Salaries (S3_2_C4_16)",Renal Dialysis (D3_IRF_C3_74),"PPS SERVICES COST, Occupational Therapy (D_5_HOS_C5_67)",Leasehold Improvements (G_C1THRU4_17),"Total Outpatient Charges, CT Scan (C_1_C7_57)","Net Expense for Cost Allocation, Other Nonreimbursable (B_1_C0_194)",Islet Acquisition (C_1_C6_111),FQHC (B_1_C21_89),Surgical Intensive Care Unit (S3_1_C8_11),"COST REIMBURSED SERVICES SUBJECT TO DEDUCTIBLES  AND COINSURANCE - CHARGES, Medical Supplies Charged to Patients (D_5_HOS_C3_71)",MRI (D3_IRF_C3_58),Clinic (D3_SNF_C2_90),Stand-alone CHIP Charges (Gross Revenue) (S10_C1_10),Clinic (D_4_IRF_C13_90),Speech Pathology (D3_HOS_C3_68),CAPD exchanges per day (S5_C4_4),"Other Capital Related Costs, Total (A7_3_C7_3)",Vending Machines (A8_C2_20),Nonphysician Anesthetists (A_C1_19),Emergency (B_2_C26_91),Laboratory (D_4_IRF_C11_60),Intestinal Acquisition (B_2_C26_110),"TOTAL CAPITAL COSTS AFTER COST ALLOCATION, Radiology-Therapeutic (B_2_C26_55)",Other Outpatient Services (B_1_C26_93),Lung  Acquisition (A_C6_108),"PPS REIMBURSED SERVICES -  CHARGES, Drugs Charged to Patients (D_5_HOS_C2_73)","Blood Storing, Processing, Trans (D_4_HOS_C13_63)",Impl. Dev. Charged to Patients (D_4_HOS_C13_72),"COST SERVICES SUBJECT TO DEDUCTIBLES AND COINSURANCE - COST, Respiratory Therapy (D_5_HOS_C6_65)",OPT (B_2_C26_9920),"PAID HOURS RELATED TO SALARIES, Operation of Plant (S3_2_C5_30)","Total Outpatient Charges, Radiology-Diagnostic (C_1_C7_54)","COST SERVICES NOT SUBJECT TO DEDUCTIBLES AND COINSURANCE - COST, Emergency (D_5_HOS_C7_91)","ADJUSTED SALARIES, Pharmacy (S3_2_C4_40)","Beginning Balances, Land Improvements (A7_1_C1_2)",Radioisotope (D_4_IPF_C11_56),Adults & Pediatrics (D_1_HOS_C4_30),Rental of quarters to employee and oths (A8_C2_15),"PPS SERVICES COST, Delivery Room and Labor Room (D_5_HOS_C5_52)",Observation Beds (Distinct Unit) (D_4_HOS_C13_9201),Emergency (D_4_HOS_C13_91),"AMOUNT REPORTED, Physician Part A Teaching (S3_2_C3_2201)","AVERAGE HOURLY WAGE, Dietary (S3_2_C6_34)","AVERAGE HOURLY WAGE, Excluded Area Salaries (S3_2_C6_10)",Electrocardiology (B_1_C26_69),Total (B_1_C26_202),"Net Expense for Cost Allocation, Other General Service (B_1_C0_18)","TOTAL CAPITAL COSTS AFTER COST ALLOCATION, Other Special Care Unit (B_2_C26_35)",ASC (Non Distinct Part) (D_4_IRF_C11_75),"PPS REIMBURSED SERVICES -  CHARGES, ASC (Non Distinct Part) (D_5_HOS_C2_75)","COST REIMBURSED SERVICES NOT SUBJECT TO DEDUCTIBLES AND COINSURANCE - CHARGES, Drugs Charged to Patients (D_5_HOS_C4_73)",CT Scan (D3_HOS_C3_57),Government grants or appropriations or transfers for support of hospital operations (S10_C1_18),In State Medicaid paid days (S2_1_C1_24),"PAID HOURS RELATED TO SALARIES, Contract Labor:  Physician Part A (S3_2_C5_13)",Other Ancillary (D_4_SNF_C11_76),"COST SERVICES NOT SUBJECT TO DEDUCTIBLES AND COINSURANCE - COST, Blood Clotting Factors for Hemoph. (D_5_HOS_C7_6250)",Other Special Care (S3_1_C7_12),"COST SERVICES SUBJECT TO DEDUCTIBLES AND COINSURANCE - COST, Medical Supplies Charged to Patients (D_5_HOS_C6_71)",Medicaid Observation Days (S3_1_C8_28),Physicians' Private Office (B_2_C26_192),"Interest, Total (A7_3_C11_3)",Other Special Care Unit (D3_SNF_C2_35),"Net Expense for Cost Allocation, Gift, Flower, Coffee Shop, Canteen (B_1_C0_190)",Other Ancillary (D_4_IPF_C13_76),Other Organ Acquisition (B_1_C22_112),"COST SERVICES SUBJECT TO DEDUCTIBLES AND COINSURANCE - COST, Anesthesiology (D_5_HOS_C6_53)","PPS SERVICES COST, Laboratory (D_5_HOS_C5_60)","Net Expense for Cost Allocation, SNF (B_1_C0_44)","PPS SERVICES COST, MRI (D_5_HOS_C5_58)",Electroencephalography (A_C6_70),Component rate ESRD (E_B_HOS_C1_33),Investment Income-Other (A8_C2_3),Other Outpatient Services (D_4_IRF_C11_93),"Allocation of Interns & Residents Program Costs, Cardiac Catheterization (B_1_C22_59)","PPS SERVICES COST, Clinic (D_5_HOS_C5_90)",Other Outpatient Services (A_C6_93),Electroencephalography (D3_SNF_C2_70),"TOTAL CAPITAL COSTS AFTER COST ALLOCATION, Intensive Care Unit (B_2_C26_31)","AMOUNT REPORTED, Wage Related Costs RHC/FQHC (S3_2_C2_24)","Allocation of Interns & Residents Program Costs, SNF (B_1_C22_44)",Laboratory (D_4_HOS_C11_60),Net Income from Service to Patients (G3_C1_5),"Total Inpatient Charges, Subprovider-IRF (C_1_C6_41)",RHC 6 Provider Number (S2_1_C2_1505),Outpatient Revenue (G2_C2_28),Total Liabilities and Fund Balances (G_C1THRU4_54),"PAID HOURS RELATED TO SALARIES, Dietary under Contract (S3_2_C5_35)",Physical Therapy (A_C6_66),Renal 3 Provider Number (S2_1_C2_1802),Organ acquisition charges (E_B_HOS_C1_13),Durable Medical Equipment Sold (D_4_HOS_C10_97),Coronary Care Unit (S3_1_C8_9),"COST REIMBURSED SERVICES SUBJECT TO DEDUCTIBLES  AND COINSURANCE - CHARGES, Total (D_5_HOS_C3_200)","Allocation of Interns & Residents Program Costs, Subprovider-IPF (B_1_C22_40)",Intravenous Therapy (D_4_SNF_C11_64),Stand-alone CHIP cost (S10_C1_11),"AVERAGE HOURLY WAGE, Contract Labor:  Physician Part A (S3_2_C6_13)","Total Inpatient Charges, CT Scan (C_1_C6_57)","PAID HOURS RELATED TO SALARIES, Central Services and Supply (S3_2_C5_39)",Operation of Plant (A_C1_7),"COST SERVICES NOT SUBJECT TO DEDUCTIBLES AND COINSURANCE - COST, Durable Medical Equipment Rented (D_5_HOS_C7_96)",Speech Pathology (D3_IRF_C3_68),Drugs Charged to Patients (B_1_C22_73),"AVERAGE HOURLY WAGE, Employee Benefits (S3_2_C6_26)",Emergency (D_4_HOS_C11_91),"AVERAGE HOURLY WAGE, Dietary under Contract (S3_2_C6_35)",Lung  Acquisition (A_C1_108),"Net Expense for Cost Allocation, Delivery Room and Labor Room (B_1_C0_52)",Electroencephalography (A_C2_70),Laundry and Linen Service (A_C1_8),Emergency (D_4_IPF_C13_91),HHA (A_C2_101),Nursery (A_C6_43),Burn Intensive Care Unit (S3_1_C3_10),Medical Supplies Charged to Patients (D3_IRF_C3_71),FI/Contractor's Name (S2_1_C2_140),Nonpaid Workers (B_1_C26_193),MRI (C_1_C5_58),"TOTAL CAPITAL COSTS AFTER COST ALLOCATION, SNF (B_2_C26_44)",Coronary Care Unit (S3_1_C7_9),Employee Benefits (A_C1_4),"Allocation of Interns & Residents Salary and Fringes, Blood Storing, Processing, Trans (B_1_C21_63)",CMHC (B_1_C21_99),Home Program Dialysis (C_1_C6_94),"HHA III, PEP:  Total Non Routine Med Supply Chgs (S4_HHA3_C4_38)",Research (A_C2_191),Recovery Room (D3_IRF_C2_51),Whole Blood & Packed Red Blood Cells (D_4_IPF_C13_62),Electroencephalography (D_4_IRF_C11_70),Operating Room (D3_IPF_C3_50),Recovery Room (D_4_HOS_C4_51),Renal Dialysis (D3_IRF_C2_74),CAPD exchanges per day (S5_C6_4),IRF (S3_1_C3_17),Speech Pathology (D_4_HOS_C2_68),Durable Medical Equipment Rented (A_C1_96),Drugs Charged to Patients (D_4_HOS_C2_73),"COST REIMBURSED SERVICES NOT SUBJECT TO DEDUCTIBLES AND COINSURANCE - CHARGES, Medical Supplies Charged to Patients (D_5_HOS_C4_71)",Speech Pathology (D3_IRF_C2_68),CT Scan (D_4_HOS_C10_57),Other Ancillary (C_1_C7_76),Intravenous Therapy (C_1_C6_64),Laboratory (D_4_HOS_C3_60),"COST SERVICES SUBJECT TO DEDUCTIBLES AND COINSURANCE - COST, Emergency (D_5_HOS_C6_91)",Operating Room (D_4_HOS_C12_50),Blood Clotting Factors for Hemoph. (D_4_HOS_C12_6250),Medical Supplies Charged to Patients (C_1_C5_71),Surgical Intensive Care Unit (D_1_HOS_C4_34),Adults and Pediatrics (D3_HOS_C2_30),Total Other Medical Education Cost (D_3_HOS_C3_200),Total (D_4_HOS_C12_200),"AVERAGE HOURLY WAGE, Home Office Salaries (S3_2_C6_1401)",Utilization Review-physicians compens (A8_C2_25),"PAID HOURS RELATED TO SALARIES, Total (S3_3_C5_6)","AMOUNT REPORTED, Subtotal Other Wages and Related Csts (S3_3_C2_4)",Adults & Pediatrics (D_3_HOS_C9_30),Radioisotope (D3_IPF_C2_56),Cost of charity care (uninsured patients + patients w/ coverage not accepted by provider) (S10_C1_23),SSA State Code (STATE),FQHC 9 Provider Number (S2_1_C2_1608),Intravenous Therapy (A_C1_64),Other Outpatient Services (D3_SNF_C2_93),ASC (Distinct Part) (A_C6_115),"Net Expense for Cost Allocation, NF (B_1_C0_45)",Durable Medical Equipment Rented (D3_HOS_C2_96),CT Scan (A_C6_57),Durable Medical Equipment Sold (C_1_C7_97),Other Reimbursable (C_1_C6_98),"Allocation of Interns & Residents Program Costs, Radioisotope (B_1_C22_56)","AMOUNT REPORTED, Interns & Residents (S3_2_C2_2551)","PAID HOURS RELATED TO SALARIES, SNF (S3_2_C5_9)",Hospital Adults & Pediatrics (S3_1_C3_1),RHC/FQHC Combined (S3_1_C10_26),"PPS REIMBURSED SERVICES -  CHARGES, Emergency (D_5_HOS_C2_91)",Other Outpatient Services (B_1_C22_93),Emergency (C_1_C7_91),SNF (A_C6_44),"Net Expense for Cost Allocation, Renal Dialysis (B_1_C0_74)",RHC/FQHC Combined (S3_1_C6_26),Durable Medical Equipment Rented (C_1_C7_96),Electrocardiology (D3_HOS_C2_69),"AMOUNT REPORTED, Related  Salaries (S3_2_C2_1402)",Total Hospital (S3_1_C3_14),Hospital Adlts & Ped Swing Bed NF (S3_1_C8_6),Tentative settlement (E_B_HOS_C1_42),"Net Expense for Cost Allocation, Coronary Care Unit (B_1_C0_32)",RHC 19 Provider Number (S2_1_C2_1518),"Net Expense for Cost Allocation, ASC (Distinct Part) (B_1_C0_115)",Renal 1 Provider Number (S2_1_C2_18),"Total Inpatient Charges, Cardiac Catheterization (C_1_C6_59)","AVERAGE HOURLY WAGE, Total (S3_3_C6_6)","Disposals and Retirements, Movable Equipment (A7_1_C5_6)","HHA III, W/Out Outliers:  Number of Episodes (S4_HHA3_C1_36)",Amounts expected under 42 CFR (E_B_HOS_C1_16),Total Allied Health (D_4_IPF_C3_200),Radioisotope (D3_SNF_C2_56),Nursing Administration (A_C6_13),"AMOUNT REPORTED, Subtotal Wage Related Csts (S3_3_C2_5)",Recovery Room (D_4_HOS_C13_51),ASC (Non Distinct Part) (D3_IRF_C2_75),"COST REIMBURSED SERVICES SUBJECT TO DEDUCTIBLES  AND COINSURANCE - CHARGES, Ambulance Services (D_5_HOS_C3_95)",Radiology-Therapeutic (D_4_IPF_C13_55),"Lease, New Cap Related Csts Movable Equipment (A7_3_C10_2)",Laboratory (D3_IRF_C2_60),Radiology-Therapeutic (D3_HOS_C3_55),Other Ancillary (D3_IRF_C2_76),Total discharges (S3_1_C15_14),"Allocation of Interns & Residents Salary and Fringes, Burn Intensive Care Unit (B_1_C21_33)",ASC (Non Distinct Part) (D3_SNF_C2_75),Liver Acquisition (C_1_C7_107),Total Program General Inpatient Routine (D1_HOS_C1_41),IRF (S3_1_C5_17),Total Nonphysician Anesthetist Cost (D_4_IRF_C1_102),"Allocation of Interns & Residents Program Costs, Operating Room (B_1_C22_50)",SNF (A_C1_44),RHC (A_C6_88),Hospital Adlts & Ped Swing Bed SNF (S3_1_C7_5),Clinic (A_C2_90),Radioisotope (A_C2_56),"Disposals and Retirements, Land (A7_1_C5_1)","PPS SERVICES COST, ASC (Non Distinct Part) (D_5_HOS_C5_75)",Emergency (A_C6_91),Electroencephalography (C_1_C5_70),Total Bad Debt expense (S10_C1_26),"Net Expense for Cost Allocation, Subprovider-IRF (B_1_C0_41)",Radiology-Therapeutic (D_4_HOS_C13_55),"COST SERVICES NOT SUBJECT TO DEDUCTIBLES AND COINSURANCE - COST, Occupational Therapy (D_5_HOS_C7_67)",Title V discharges (S3_1_C12_14),Fiscal Year End Date (FY_END_DT),"COST SERVICES SUBJECT TO DEDUCTIBLES AND COINSURANCE - COST, Observation Beds (Distinct Unit) (D_5_HOS_C6_9201)",Hospital Zip Code (S2_1_C3_2),Clinic (D_4_HOS_C11_90),ICF (A_C6_4501),"Total Inpatient Charges, Recovery Room (C_1_C6_51)",Intensive Care Unit (D_1_HOS_C7_31),"AMOUNT REPORTED, Employee Benefits (S3_2_C2_26)",CMHC (C_1_C5_99),Medicare Certified Liver TC term date (S2_1_C2_128),Clinic (D_4_SNF_C11_90),Health Information Technology Designated Assets (G_C1THRU4_27),Charity care charges and uninsured discounts for the entire facility (S10_C1_20),"Net Expense for Cost Allocation, Operation of Plant (B_1_C0_7)",Int & Res (non approved teaching program (C_1_C5_100),"Blood Storing, Processing, Trans (A_C6_63)","PAID HOURS RELATED TO SALARIES, Physician-Part A (S3_2_C5_4)","Net Expense for Cost Allocation, FQHC (B_1_C0_89)","COST REIMBURSED SERVICES SUBJECT TO DEDUCTIBLES  AND COINSURANCE - CHARGES, Electrocardiology (D_5_HOS_C3_69)","COST SERVICES NOT SUBJECT TO DEDUCTIBLES AND COINSURANCE - COST, Drugs Charged to Patients (D_5_HOS_C7_73)","AMOUNT REPORTED, Home Office Salaries (S3_2_C3_1401)","Allocation of Interns & Residents Program Costs, Surgical Intensive Care Unit (B_1_C22_34)","Average patient dialysis time 
including setup (S5_C1_3)","Disposals and Retirements, Fixed Equipment (A7_1_C5_5)","AVERAGE HOURLY WAGE, Contract Labor (S3_2_C6_11)",OPT (C_1_C7_9920),Other Organ Acquisition (C_1_C7_112),ASC (Distinct Part) (C_1_C7_115),"PAID HOURS RELATED TO SALARIES, Subtotal Other Wages and Related Csts (S3_3_C5_4)",Impl. Dev. Charged to Patients (C_1_C6_72),Other Ancillary (D_4_IRF_C11_76),"ADJUSTED SALARIES, Cafeteria (S3_2_C4_36)",Drugs Charged to Patients (B_2_C26_73),"TOTAL CAPITAL COSTS AFTER COST ALLOCATION, MRI (B_2_C26_58)",Drugs Charged to Patients (C_1_C7_73),Organ acquisition (E_B_HOS_C1_10),Delivery Room and Labor Room (D3_IRF_C3_52),CT Scan (D_4_HOS_C2_57),Emergency (D3_HOS_C2_91),"Salaries, Wages, and Fees Payable (G_C1THRU4_38)",Anesthesiology (D_4_IPF_C13_53),Total discharges (S3_1_C15_17),"AMOUNT REPORTED, Home Office Salaries (S3_2_C2_1401)",Burn Intensive Care Unit (D_3_HOS_C9_33),Relief Payment (D1_HOS_C1_62),Intensive Care Unit (D3_IRF_C2_31),Deferred Income (G_C1THRU4_41),"Allocation of Interns & Residents Salary and Fringes, Subprovider-IPF (B_1_C21_40)",Operating Room (D_4_HOS_C3_50),"If this facility qualifies as a RPCH/CAH, has it elected the all inclusive payment for outpatient service? (Y/N) (S2_1_C1_106)",Surgical Intensive Care Unit (D_1_HOS_C6_34),"COST REIMBURSED SERVICES SUBJECT TO DEDUCTIBLES  AND COINSURANCE - CHARGES, ASC (Non Distinct Part) (D_5_HOS_C3_75)",Respiratory Therapy (D_4_IPF_C11_65),"HHA I, With Outliers:  Number of Episodes (S4_HHA1_C2_37)","AMOUNT REPORTED, Contract Labor: Pysician Part A (S3_2_C2_13)","Blood Storing, Processing, Trans (A_C2_63)","COST SERVICES SUBJECT TO DEDUCTIBLES AND COINSURANCE - COST, Clinic (D_5_HOS_C6_90)",Report Record Number (RPT_REC_NUM),Laundry and Linen Service (A_C6_8),Other Reimbursable (D3_IRF_C3_98),Adults and Pediatrics (A_C2_30),"If this Hospital is claiming cost for renal services on Worksheet A, are they inpatient services only? (Y/N) (S2_1_C1_145)",OOT (B_1_C26_9930),Hospital State (S2_1_C2_2),"AMOUNT REPORTED, Wage Related Costs Other (S3_2_C2_18)","ADJUSTED SALARIES, Total Overhead Costs (S3_3_C4_7)",Total (D_4_IRF_C13_200),Other Adjustments (Summed) (A8_C2_33),Renal Dialysis (D3_IPF_C3_74),"Total Outpatient Charges, Radiology-Therapeutic (C_1_C7_55)",Drugs Charged to Patients (A_C6_73),RHC (B_1_C21_88),Physical Therapy (D_4_IPF_C13_66),Hospital Adults & Pediatrics (S3_1_C5_1),Medical Supplies Charged to Patients (D3_HOS_C3_71),Renal Dialysis (D_4_HOS_C13_74),IPF (S3_1_C2_16),Occupational Therapy (D_4_HOS_C4_67),Maintenance and Repairs (A_C2_6),Total Hospital (S3_1_C6_14),Drugs Charged to Patients (D3_IPF_C3_73),"Fully Depreciated Assets, Total (A7_1_C4_7)",Home Program Dialysis (D3_IPF_C2_94),Other Outpatient Services (C_1_C7_93),RHC (B_2_C26_88),Subtotal (E_B_HOS_C1_32),Durable Medical Equipment Rented (D3_IPF_C2_96),"TOTAL CAPITAL COSTS AFTER COST ALLOCATION, Coronary Care Unit (B_2_C26_32)",Physical Therapy (D3_HOS_C3_66),ASC (Non Distinct Part) (D_4_HOS_C3_75),Number of stations (S5_C1_6),Total Nonphysician Anesthetist Cost (D_4_IPF_C1_200),NF (C_1_C5_45),Hospital Title 18 Payment System (P/T/O) (S2_1_C7_3),Delivery Room and Labor Room (D3_IPF_C3_52),Delivery Room and Labor Room (D3_HOS_C2_52),"COST REIMBURSED SERVICES SUBJECT TO DEDUCTIBLES  AND COINSURANCE - CHARGES, Respiratory Therapy (D_5_HOS_C3_65)",Speech Pathology (D3_IPF_C3_68),FQHC (C_1_C7_89),CMHC (B_1_C22_99),"AMOUNT REPORTED, Interns & Residents (S3_2_C3_2550)",Anesthesiology (D_4_HOS_C4_53),RPCH/CAH Visits (S3_1_C6_15),Subprovider I (C_1_C5_42),Medical Supplies Charged to Patients (D3_IPF_C3_71),CORF (C_1_C6_9910),Observation Beds (Distinct Unit) (D3_SNF_C3_9201),Intravenous Therapy (D_4_IPF_C11_64),Electrocardiology (D3_IRF_C2_69),"ADJUSTED SALARIES, Physician Part B (S3_2_C4_23)",Unsecured Loans (G_C1THRU4_48),"Total Inpatient Charges, PBP Clinical Lab Services Program Only (C_1_C6_61)",Deductibles and coinsurance related to line 24 (E_B_HOS_C1_26),"COST REIMBURSED SERVICES NOT SUBJECT TO DEDUCTIBLES AND COINSURANCE - CHARGES, Electroencephalography (D_5_HOS_C4_70)",Total Program General Inpatient Routine (D1_IRF_C1_41),"HHA I, PEP Episodes:  Total Visits (S4_HHA1_C4_33)",Durable Medical Equipment Sold (C_1_C5_97),Laboratory (D_4_HOS_C4_60),"AMOUNT REPORTED, Other General Service (S3_2_C2_43)",CT Scan (D_4_IPF_C11_57),Laboratory (A_C1_60),Intravenous Therapy (D_4_HOS_C11_64),"COST SERVICES SUBJECT TO DEDUCTIBLES AND COINSURANCE - COST, Blood Storing, Processing, Trans (D_5_HOS_C6_63)","PPS REIMBURSED SERVICES -  CHARGES, Durable Medical Equipment Rented (D_5_HOS_C2_96)",Beginning Date of SCH status (S2_1_C1_36),ASC (Non Distinct Part) (D3_IRF_C3_75),New Capital Equipment (A_C6_2),Notes Payable (G_C1THRU4_47),Radioisotope (D_4_HOS_C11_56),Medical Supplies Charged to Patients (C_1_C7_71),Urban (1) or Rural (2) (S2_1_C1_27),"COST SERVICES SUBJECT TO DEDUCTIBLES AND COINSURANCE - COST, ASC (Non Distinct Part) (D_5_HOS_C6_75)",Physical Therapy (D3_SNF_C2_66),Hospital Street Address (S2_1_C1_1),"Allocation of Interns & Residents Salary and Fringes, Occupational Therapy (B_1_C21_67)","AVERAGE HOURLY WAGE, Nursing Administration (S3_2_C6_38)",IRF Provider Number (S2_1_C1_5),Blood Clotting Factors for Hemoph. (C_1_C5_6250),"PAID HOURS RELATED TO SALARIES, Non-Physician Anesthetist Part A (S3_2_C5_2)",Liver Acquisition (C_1_C6_107),Radiology-Diagnostic (D_4_HOS_C2_54),Durable Medical Equipment Rented (A_C2_96),Durable Medical Equipment Sold (D_4_HOS_C3_97),Whole Blood & Packed Red Blood Cells (D_4_HOS_C12_62),Intravenous Therapy (D3_IPF_C2_64),ASC (Non Distinct Part) (D3_HOS_C2_75),"HHA III, With Outliers:  Total Charges (S4_HHA3_C2_35)","PPS SERVICES COST, Renal Dialysis (D_5_HOS_C5_74)","PPS REIMBURSED SERVICES -  CHARGES, Anesthesiology (D_5_HOS_C2_53)",Partial or full credits from manufacturers (E_B_HOS_C1_3998),Outpatient Rehab Provider (S3_1_C11_25),Drugs Charged to Patients (D_4_HOS_C12_73),Electrocardiology (D_4_HOS_C2_69),MSP-LCC reconciliation amount (E_B_HOS_C1_38),MRI (D_4_IRF_C11_58),Total Nursing School (D_4_HOS_C2_200),"AMOUNT REPORTED, Laundry and Linen Service (S3_2_C2_31)",Surgical Intensive Care Unit (D3_IRF_C2_34),Laboratory (A_C6_60),"HHA III, With Outliers:  Total Visits (S4_HHA3_C2_33)","PPS SERVICES COST, Whole Blood & Packed Red Blood Cells (D_5_HOS_C5_62)",Islet Acquisition (A_C1_111),Durable Medical Equipment Sold (C_1_C6_97),Depreciation-New Bldgs & Fixtures (A8_C2_26),Total Hospital Interns & Residents (S3_1_C9_14),Respiratory Therapy (B_2_C26_65),Durable Medical Equipment Rented (B_1_C26_96),HHA (B_1_C21_101),Pancreas Acquisition (A_C6_109),Hospital Adults & Ped Swing Bed SNF (S3_1_C6_5),Other Reimbursable (D3_IPF_C3_98),"PPS SERVICES COST, Radiology-Diagnostic (D_5_HOS_C5_54)",Operating Room (D_4_IRF_C11_50),"HHA I, Without Outliers:  Non Routine Med Sup Chgs (S4_HHA1_C1_38)",Total discharges (S3_1_C15_18),Title XVIII discharges (S3_1_C13_2),OLTC (B_1_C26_46),Cardiac Catheterization (D3_HOS_C2_59),Surgical Intensive Care Unit (D_3_HOS_C9_34),SNF (S3_1_C6_19),"Total Outpatient Charges, Operating Room (C_1_C7_50)","Blood Storing, Processing, Trans (D3_IPF_C3_63)","ADJUSTED SALARIES, Interns & Residents (S3_2_C4_25)",Medical Supplies Charged to Patients (D3_IRF_C2_71),Allowable bad debts (E_B_HOS_C1_34),"HHA III, Without Outliers:  Other Charges (S4_HHA3_C1_34)",FQHC 10 Provider Number (S2_1_C2_1609),Laboratory (D3_IPF_C2_60),"TOTAL CAPITAL COSTS AFTER COST ALLOCATION, Anesthesiology (B_2_C26_53)",HHA 1 Provider Number (S2_1_C2_12),"HHA I, With Outliers:  Total Visits (S4_HHA1_C2_33)",Hospital Adults & Pediatrics (S3_1_C6_1),Housekeeping (A_C1_9),"Is this a New Hospital under
42 CFR 412.300 PPS capital
(Y/N) (S2_1_C1_47)","PAID HOURS RELATED TO SALARIES, Admin & Gen Under Contract (S3_2_C5_29)",Impl. Dev. Charged to Patients (B_2_C26_72),Emergency (D3_IPF_C2_91),"Net Expense for Cost Allocation, Durable Medical Equipment Sold (B_1_C0_97)",Ambulance Services (B_1_C26_95),RHC 14 Provider Number (S2_1_C2_1513),Target Amount per Discharge (D1_HOS_C1_55),Whole Blood & Packed Red Blood Cells (D3_SNF_C2_62),"If an Organ Procurement Organization, enter the OPO number (S2_1_C1_134)",Hospice (A_C6_116),"COST REIMBURSED SERVICES SUBJECT TO DEDUCTIBLES  AND COINSURANCE - CHARGES, Other Ancillary (D_5_HOS_C3_76)",Home Program Dialysis (D3_IRF_C2_94),Other Special Care (S3_1_C5_12),Intravenous Therapy (D3_IPF_C3_64),"HHA I, LUPA Episodes:  Total Number of Episodes (S4_HHA1_C3_36)",Total (D_4_HOS_C13_200),Intensive Care Unit (S3_1_C2_8),"AVERAGE HOURLY WAGE, Admin & Gen Under Contract (S3_2_C6_29)",Total Outpatient Program Pass Thru Cost (D_4_IRF_C6_200),Fiscal Intermediary Number (FI_NUM),"Disposals and Retirements, Buildings and Fixtures (A7_1_C7_3)",Is this a rural hospital qualifying for an exception to the certified registered nurse anesthetist the CRNA fee schedule? (Y/N) (S2_1_C1_108),Other Outpatient Services (D3_HOS_C2_93),Other Ancillary (D3_HOS_C2_76),Surgical Intensive Care Unit (S3_1_C4_11),CMHC (S3_1_C6_25),"HHA I, Total Charges (S4_HHA1_C5_35)",Heart Acquisition (C_1_C5_106),"Net Expense for Cost Allocation, Burn Intensive Care Unit (B_1_C0_33)","Total Inpatient Charges, Coronary Care Unit (C_1_C6_32)",Radiology-Diagnostic (D3_IRF_C2_54),"ADJUSTED SALARIES, Medical Records & Med Records Library (S3_2_C4_41)",Drugs Charged to Patients (D_4_HOS_C11_73),"COST SERVICES SUBJECT TO DEDUCTIBLES AND COINSURANCE - COST, Electroencephalography (D_5_HOS_C6_70)",Land Improvements (G_C1THRU4_13),"COST SERVICES SUBJECT TO DEDUCTIBLES AND COINSURANCE - COST, Physical Therapy (D_5_HOS_C6_66)",Radiology-Diagnostic (D_4_IPF_C11_54),Radiology-Therapeutic (D_4_HOS_C10_55),Delivery Room and Labor Room (B_1_C26_52),"Net Expense for Cost Allocation, Operating Room (B_1_C0_50)","COST REIMBURSED SERVICES SUBJECT TO DEDUCTIBLES  AND COINSURANCE - CHARGES, Cardiac Catheterization (D_5_HOS_C3_59)",Other Ancillary (D3_IPF_C3_76),Impl. Dev. Charged to Patients (A_C1_72),Total (C_1_C5_202),Delivery Room and Labor Room (D3_HOS_C3_52),Operating Room (D3_HOS_C3_50),Other Outpatient Services (B_2_C26_93),"COST SERVICES SUBJECT TO DEDUCTIBLES AND COINSURANCE - COST, Whole Blood & Packed Red Blood Cells (D_5_HOS_C6_62)","Allocation of Interns & Residents Program Costs, Medical Supplies Charged to Patients (B_1_C22_71)","TOTAL CAPITAL COSTS AFTER COST ALLOCATION, CT Scan (B_2_C26_57)",CMS Region Code (REGION),ASC (Distinct Part) (B_1_C26_115),Subprovider-IRF (D_1_HOS_C4_41),Intensive Care Unit (S3_1_C8_8),Organ Procurement (D4_INTESTINE_C1_69),Liver Acquisition (A_C6_107),"Disposals and Retirements, Movable Equipment (A7_1_C7_6)","Net Expense for Cost Allocation, Medical Records and Medical Rec. Library (B_1_C0_16)",Speech Pathology (D_4_HOS_C4_68),OLTC (A_C2_46),Speech Pathology (D3_IPF_C2_68),"Allocation of Interns & Residents Salary and Fringes, Radiology-Therapeutic (B_1_C21_55)",Renal Dialysis (D_4_IPF_C13_74),"AVERAGE HOURLY WAGE, Related Salaries (S3_2_C6_1402)",Clinic (D3_IPF_C3_90),"COST REIMBURSED SERVICES NOT SUBJECT TO DEDUCTIBLES AND COINSURANCE - CHARGES, Intravenous Therapy (D_5_HOS_C4_64)","Total Outpatient Charges, Recovery Room (C_1_C7_51)",Total Allied Health (D_4_IRF_C3_200),Electroencephalography (D3_IPF_C3_70),Intravenous Therapy (C_1_C7_64),"COST REIMBURSED SERVICES SUBJECT TO DEDUCTIBLES  AND COINSURANCE - CHARGES, Blood Storing, Processing, Trans (D_5_HOS_C3_63)",Non-physician Anesthetist (A8_C2_28),"Allocation of Interns & Residents Salary and Fringes, Subprovider I (B_1_C21_42)",Total Long-term Liabilities (G_C1THRU4_50),"COST SERVICES SUBJECT TO DEDUCTIBLES AND COINSURANCE - COST, Ambulance Services (D_5_HOS_C6_95)",Program Discharges (D1_HOS_C1_54),Operation of Plant (A_C6_7),Operating Room (A_C6_50),"Net Expense for Cost Allocation, Emergency (B_1_C0_91)","Net Expense for Cost Allocation, Ambulance Services (B_1_C0_95)",Radiology-Therapeutic (D3_IPF_C3_55),Heart Acquisition (B_1_C21_106),"PPS SERVICES COST, Speech Pathology (D_5_HOS_C5_68)",Physicians' Private Office (A_C6_192),Subprovider-IRF (D_3_HOS_C9_41),"Blood Storing, Processing, Trans (D_4_IPF_C11_63)","COST SERVICES SUBJECT TO DEDUCTIBLES AND COINSURANCE - COST, Cardiac Catheterization (D_5_HOS_C6_59)",RHC 5 Provider Number (S2_1_C2_1504),Total Hospital (S3_1_C5_7),SNF (D_3_HOS_C9_44),Number of stations (S5_C2_6),Organ Procurement (D4_KIDNEY_C1_69),Medicare reimbursable bad debts for the entire hospital complex (S10_C1_27),"COST REIMBURSED SERVICES NOT SUBJECT TO DEDUCTIBLES AND COINSURANCE - CHARGES, Delivery Room and Labor Room (D_5_HOS_C4_52)","Allocation of Interns & Residents Program Costs, Whole Blood & Packed Red Blood Cells (B_1_C22_62)",Whole Blood & Packed Red Blood Cells (D_4_HOS_C13_62),Occupational Therapy (C_1_C5_67),"Allocation of Interns & Residents Program Costs, Laboratory (B_1_C22_60)",RHC 15 Provider Number (S2_1_C2_1514),CT Scan (D3_IRF_C3_57),"TOTAL CAPITAL COSTS AFTER COST ALLOCATION, Adults & Pediatrics (B_2_C26_30)",Electrocardiology (C_1_C5_69),Radioisotope (D_4_HOS_C12_56),RHC 4 Provider Number (S2_1_C2_1503),Pancreas Acquisition (B_1_C22_109),Recovery Room (D_4_IRF_C13_51),"ADJUSTED SALARIES, Excluded Area Salaries (S3_3_C4_2)",Total Hospital (S3_1_C7_14),"Total Outpatient Charges, MRI (C_1_C7_58)","PAID HOURS RELATED TO SALARIES, Interns & Residents (S3_2_C5_7)",certification date (S2_1_C1_132),"HHA I, Total Other Charges (S4_HHA1_C5_34)","Average patient dialysis time 
including setup (S5_C3_3)",Radiology-Therapeutic (D3_IRF_C3_55),"Net Expense for Cost Allocation, Dietary (B_1_C0_10)","COST SERVICES NOT SUBJECT TO DEDUCTIBLES AND COINSURANCE - COST, Medical Supplies Charged to Patients (D_5_HOS_C7_71)",Emergency (D3_HOS_C3_91),Total Operating Expense (G3_C1_4),"General Inpatient Routine Service Cost, net of Swing Bed and Private Room Diff (D1_IRF_C1_37)","HHA II, Total Other Charges (S4_HHA2_C5_34)",Other Capital (A_C2_3),Laboratory (D3_HOS_C3_60),Adj for Physical therapy costs in excess (A8_C2_24),Speech Pathology (D_4_HOS_C13_68),"COST SERVICES NOT SUBJECT TO DEDUCTIBLES AND COINSURANCE - COST, Radioisotope (D_5_HOS_C7_56)",Subprovider-IRF (B_1_C26_41),Renal Dialysis (D_4_HOS_C12_74),Nonpaid Workers (A_C2_193),TOTAL (D3_IRF_C3_200),Interest expense on Medicare Overpaymts (A8_C2_22),"PAID HOURS RELATED TO SALARIES, Excluded Area Salaries (S3_2_C5_10)","Total Inpatient Charges, Operating Room (C_1_C6_50)",MRI (A_C1_58),"Net Expense for Cost Allocation, MRI (B_1_C0_58)",Hospice (B_1_C26_116),Cost of patients approved for charity care and uninsured discounts (S10_C1_21),"COST REIMBURSED SERVICES NOT SUBJECT TO DEDUCTIBLES AND COINSURANCE - CHARGES, Laboratory (D_5_HOS_C4_60)","Number of days in year dialysis 
furnished (S5_C2_5)",ICF (C_1_C5_4501),Clinic (D_4_HOS_C13_90),"COST REIMBURSED SERVICES SUBJECT TO DEDUCTIBLES  AND COINSURANCE - CHARGES, Recovery Room (D_5_HOS_C3_51)",Cardiac Catheterization (D3_SNF_C3_59),ASC (Non Distinct Part) (D3_SNF_C3_75),Drugs Charged to Patients (D_4_HOS_C3_73),Whole Blood & Packed Red Blood Cells (D_4_HOS_C3_62),Cost of charity care (S10_C3_23),Whole Blood & Packed Red Blood Cells (D3_IRF_C2_62),"COST SERVICES NOT SUBJECT TO DEDUCTIBLES AND COINSURANCE - COST, Radiology-Diagnostic (D_5_HOS_C7_54)",HVBP payment adjustment amount (E_A_HOS_C1_7093),HHA (S3_1_C10_22),"Disposals and Retirements, Land Improvements (A7_1_C5_2)","Allocation of Interns & Residents Program Costs, Intensive Care Unit (B_1_C22_31)","TOTAL CAPITAL COSTS AFTER COST ALLOCATION, Nursery (B_2_C26_43)",Other Organ Acquisition (A_C6_112),Home Program Dialysis (B_2_C26_94),Subtotal (E_B_HOS_C1_40),Total discharges (S3_1_C15_21),Cardiac Catheterization (D_4_HOS_C4_59),"AVERAGE HOURLY WAGE, Excluded Area Salaries (S3_3_C6_2)","Net Expense for Cost Allocation, Social Service (B_1_C0_17)",Medical Supplies Charged to Patients (D_4_HOS_C13_71),Electroencephalography (D3_IPF_C2_70),Delivery Room and Labor Room (D3_SNF_C3_52),NF Provider Number (S2_1_C2_10),Radioisotope (B_1_C26_56),Other Reimbursable (D3_HOS_C3_98),Net revenue from state/local govt indigent care (not Medicaid or CHIP) (S10_C1_13),"Net Expense for Cost Allocation, Anesthesiology (B_1_C0_53)",Physical Therapy (C_1_C2_66),"HHA II, With Outliers:  Number of Episodes (S4_HHA2_C2_37)",Clinic (D_4_IRF_C11_90),Total (D_4_SNF_C13_200),Medical Records and Medical Rec. Library (A_C6_16),"General Inpatient Routine Service Cost, net of Swing Bed and Private Room Diff (D1_IPF_C1_37)","Net Expense for Cost Allocation, Medical Supplies Charged to Patients (B_1_C0_71)","TOTAL CAPITAL COSTS AFTER COST ALLOCATION, Subprovider-IRF (B_2_C26_41)","Net Expense for Cost Allocation, Paramedical Education (B_1_C0_23)",Liver Acquisition (B_1_C21_107),FQHC 5 Provider Number (S2_1_C2_1604),Observation Beds (Distinct Unit) (D_4_IRF_C11_9201),Net Income (G3_C1_29),"Total Inpatient Charges, Blood Clotting Factors for Hemoph. (C_1_C6_6250)","ADJUSTED SALARIES, Related Salaries (S3_2_C4_1402)",Other Ancillary (B_1_C22_76),"AVERAGE HOURLY WAGE, Subtotal Salaries (S3_3_C6_3)",Other Ancillary (A_C1_76),Radiology-Therapeutic (B_1_C26_55),"AMOUNT REPORTED, Maintenance and Repairs (S3_2_C2_29)",Anesthesiology (D_4_HOS_C2_53),"COST REIMBURSED SERVICES SUBJECT TO DEDUCTIBLES  AND COINSURANCE - CHARGES, MRI (D_5_HOS_C3_58)",Total cost (E_B_HOS_C1_11),Emergency (D_4_IRF_C13_91),"HHA III, With Outliers:  Number of Episodes (S4_HHA3_C2_37)",Clinic (D_4_HOS_C2_90),"ADJUSTED SALARIES, Wage Related Costs Other (S3_2_C4_18)",Subprovider-IPF (D3_HOS_C2_40),Laboratory (D_4_HOS_C2_60),"PPS REIMBURSED SERVICES -  CHARGES, Delivery Room and Labor Room (D_5_HOS_C2_52)",Subprovider I (B_1_C26_42),"COST SERVICES NOT SUBJECT TO DEDUCTIBLES AND COINSURANCE - COST, Renal Dialysis (D_5_HOS_C7_74)","PPS SERVICES COST, Blood Clotting Factors for Hemoph. (D_5_HOS_C5_6250)",Clinic (C_1_C5_90),Physical Therapy (D3_HOS_C2_66),"COST REIMBURSED SERVICES NOT SUBJECT TO DEDUCTIBLES AND COINSURANCE - CHARGES, Other Reimbursable (D_5_HOS_C4_98)",Observation Beds (Distinct Unit) (B_1_C22_9201),"AMOUNT REPORTED, Nursing Administration (S3_2_C2_38)","Allocation of Interns & Residents Salary and Fringes, Electrocardiology (B_1_C21_69)","HHA I, Without Outliers:  Total Charges (S4_HHA1_C1_35)",Total (A8_C2_50),OOT (C_1_C6_9930),CORF (C_1_C7_9910),RHC/FQHC Combined (S3_1_C9_26),Durable Medical Equipment Rented (B_2_C26_96),Observation Beds (Distinct Unit) (C_1_C5_9201),Physical Therapy (D_4_HOS_C4_66),Occupational Therapy (C_1_C2_67),ASC (Distinct Part) (A_C2_115),Organ Procurement (D4_LUNG_C1_69),Whole Blood & Packed Red Blood Cells (D_4_IRF_C11_62),"Interest, New Cap Related Csts Bldg & Fixtures (A7_3_C11_1)","AMOUNT REPORTED, Maintenance of Personnel (S3_2_C2_37)","Allocation of Interns & Residents Salary and Fringes, Coronary Care Unit (B_1_C21_32)",Program Inpatient Ancillary Service Cost (D1_IRF_C1_48),Radioisotope (C_1_C5_56),Fiscal Year Begin Date (FY_BGN_DT),"AMOUNT REPORTED, Management and Administrative Services (S3_2_C2_12)",FQHC 1 Provider Number (S2_1_C2_16),"ADJUSTED SALARIES, Laundry and Linen Service (S3_2_C4_31)",Payments received from patients for amounts previously written off as charity care (S10_C1_22),Electrocardiology (D_4_HOS_C13_69),Recovery Room (D3_HOS_C2_51),"ADJUSTED SALARIES, Employee Benefits (S3_2_C4_26)","PAID HOURS RELATED TO SALARIES, Home Office Personnel (S3_2_C5_8)",Renal Dialysis (C_1_C7_74),NF (S3_1_C9_20),Other Current Liabilities (G_C1THRU4_44),Clinic (D_4_HOS_C12_90),SNF (A_C2_44),Protested amounts (E_B_HOS_C1_44),"PAID HOURS RELATED TO SALARIES, Non-Physician Anesthetist Part B (S3_2_C5_3)",Have you established a new subprovider excluded unit under 42 CFR 413.40(f)(1)(I)?(Y/N) (S2_1_C1_86),"PPS SERVICES COST, Radiology-Therapeutic (D_5_HOS_C5_55)",Speech Pathology (D_4_IRF_C11_68),Electroencephalography (D_4_IPF_C13_70),Administrative and General (A_C2_5),Home Program Dialysis (D3_IRF_C3_94),"HHA II, With Outliers:  Total Charges (S4_HHA2_C2_35)",Observation Beds (Distinct Unit) (D3_IRF_C2_9201),"Lease, Total (A7_3_C10_3)","COST REIMBURSED SERVICES SUBJECT TO DEDUCTIBLES  AND COINSURANCE - CHARGES, Speech Pathology (D_5_HOS_C3_68)","ADJUSTED SALARIES, Administrative & General under contract (S3_2_C4_28)","Allocation of Interns & Residents Program Costs, Subprovider-IRF (B_1_C22_41)",Radioisotope (D3_IPF_C3_56),Kidney Acquisition (B_2_C26_105),Durable Medical Equipment Sold (D3_HOS_C3_97),CMHC (A_C1_99),Other Ancillary (C_1_C6_76),Impl. Dev. Charged to Patients (D_4_HOS_C4_72),Drugs Charged to Patients (D_4_IPF_C13_73),"PPS SERVICES COST, Other Outpatient Services (D_5_HOS_C5_93)",Impl. Dev. Charged to Patients (D3_IPF_C3_72),Other General Service (A_C6_18),"Net Expense for Cost Allocation, RHC (B_1_C0_88)",Lung  Acquisition (B_2_C26_108),"PPS SERVICES COST, Other Reimbursable (D_5_HOS_C5_98)","COST REIMBURSED SERVICES NOT SUBJECT TO DEDUCTIBLES AND COINSURANCE - CHARGES, Other Outpatient Services (D_5_HOS_C4_93)","Net Expense for Cost Allocation, Laundry and Linen Service (B_1_C0_8)",Beginning Date of SCH status (S2_1_C1_3601),Cardiac Catheterization (D_4_HOS_C2_59),Impl. Dev. Charged to Patients (A_C6_72),Kidney Acquisition (C_1_C7_105),Laboratory (D_4_SNF_C11_60),"HHA I, With Outliers:  Non Routine Med Sup Chgs (S4_HHA1_C2_38)",CMHC 1 Provider Number (S2_1_C2_17),Speech Pathology (A_C2_68),"AVERAGE HOURLY WAGE, Teaching Physician Salaries (S3_2_C6_16)",Recovery Room (D_4_HOS_C12_51),"PPS REIMBURSED SERVICES -  CHARGES, Intravenous Therapy (D_5_HOS_C2_64)",Emergency (D3_SNF_C3_91),"HHA III, PEP Episodes:  Total Visits (S4_HHA3_C4_33)",Emergency (D_4_IPF_C11_91),"Number of days in year dialysis 
furnished (S5_C1_5)",ASC (Non Distinct Part) (A_C6_75),"Net Expense for Cost Allocation, Central Services and Supply (B_1_C0_14)",Employee Benefits (A_C6_4),"Net Expense for Cost Allocation, Employee Benefits (B_1_C0_4)","AMOUNT REPORTED, Physician-Part B (S3_2_C2_5)","ADJUSTED SALARIES, Management and Administrative Services (S3_2_C4_12)",Burn Intensive Care Unit (S3_1_C8_10),Other Special Purpose (A_C1_117),"COST SERVICES NOT SUBJECT TO DEDUCTIBLES AND COINSURANCE - COST, Other Ancillary (D_5_HOS_C7_76)",Radioisotope (D_4_HOS_C13_56),Recovery Room (A_C2_51),"Allocation of Interns & Residents Program Costs, Recovery Room (B_1_C22_51)",MRI (D_4_IPF_C13_58),Home Program Dialysis (B_1_C26_94),"Lease, New Cap Related Csts Bldg & Fixtures (A7_3_C10_1)","TOTAL CAPITAL COSTS AFTER COST ALLOCATION, Subprovider I (B_2_C26_42)","Sum of lines 3,4 divided by line 6 (E_B_HOS_C1_7)",Occupational Therapy (A_C6_67),Anesthesiology (D_4_SNF_C11_53),"Allocation of Interns & Residents Program Costs, Speech Pathology (B_1_C22_68)",Anesthesiology (A_C6_53),NF (S3_1_C2_20),Nursery (S3_1_C8_13),"Allocation of Interns & Residents Salary and Fringes, Nursery (B_1_C21_43)","Total Program Inpatient Operating Cost excluding Capital Related, Nonphysician, Anesthetist, and Medical Education Costs (D1_IPF_C1_53)","AVERAGE HOURLY WAGE, Physician-Part B (S3_2_C6_5)",Drugs Charged to Patients (D3_SNF_C3_73),"Total Inpatient Charges, Nursery (C_1_C6_43)",Other General Service (A_C1_18),Subprovider-IPF (B_1_C26_40),ASC (Non Distinct Part) (D_4_IRF_C13_75),"Gift, Flower, Coffee Shop, Canteen (B_1_C22_190)",Home Office Name (S2_1_C1_141),Central Services and Supply (A_C1_14),"PPS REIMBURSED SERVICES -  CHARGES, Radiology-Therapeutic (D_5_HOS_C2_55)",Interest Expense (A_C6_113),CMHC (C_1_C6_99),Administrative and General (A_C6_5),CMHC (A_C6_99),"Fully Depreciated Assets, Purchase (A7_1_C2_7)",Electroencephalography (D_4_SNF_C11_70),"Number of patients in program at 
end of cost reporting period (S5_C5_1)","Total, Total (A7_3_C15_3)",Impl. Dev. Charged to Patients (C_1_C7_72),Cardiac Catheterization (D3_HOS_C3_59),Subprovider-IRF (D_1_HOS_C6_41),"Allocation of Interns & Residents Salary and Fringes, Medical Supplies Charged to Patients (B_1_C21_71)",Physical Therapy (D_4_HOS_C10_66),HHA (S3_1_C9_22),"HHA III, LUPA:  Total Non Routine Med Sup Chgs (S4_HHA3_C3_38)",RHC 9 Provider Number (S2_1_C2_1508),"PPS SERVICES COST, Observation Beds (Distinct Unit) (D_5_HOS_C5_9201)",Cross Foot Adjustments (B_2_C26_200),"Purchases, Movable Equipment (A7_1_C2_6)","Total Outpatient Charges, Cardiac Catheterization (C_1_C7_59)",Laboratory (D_4_IRF_C13_60),Other Reimbursable (D3_IRF_C2_98),Occupational Therapy (C_1_C6_67),Physical Therapy (D_4_HOS_C13_66),"ADJUSTED SALARIES, Housekeeping under contract (S3_2_C4_33)",MRI (D_4_IRF_C13_58),"HHA III, Total Visits (S4_HHA3_C5_33)",Durable Medical Equipment Rented (D3_IRF_C3_96),"Net Expense for Cost Allocation, Nonphysician Anesthetists (B_1_C0_19)",ICF Provider Number (S2_1_C2_1001),Whole Blood & Packed Red Blood Cells (D3_IRF_C3_62),HHA (C_1_C7_101),Maintenance of Personnel (A_C2_12),"ADJUSTED SALARIES, Non-Physician Anesthetist Part A (S3_2_C4_20)",Lung  Acquisition (B_1_C22_108),MRI (D3_IPF_C3_58),"COST REIMBURSED SERVICES SUBJECT TO DEDUCTIBLES  AND COINSURANCE - CHARGES, Durable Medical Equipment Sold (D_5_HOS_C3_97)",Blood Clotting Factors for Hemoph. (D3_IRF_C2_6250),"Total Program Inpatient Operating Cost excluding Capital Related, Nonphysician, Anesthetist, and Medical Education Costs (D1_IRF_C1_53)",Kidney Acquisition (B_1_C21_105),Provider's actual MSA or CBSA (S2_1_C3_3),Subprovider II (C_1_C5_4201),"HHA II, Without Outliers:  Total Visits (S4_HHA2_C1_33)",Operation of Plant (A_C2_7),Home Program Dialysis (D_4_HOS_C2_94),"Blood Storing, Processing, Trans (D3_HOS_C3_63)","Allocation of Interns & Residents Salary and Fringes, Interns & Res Salary and Fringe Benefits (B_1_C21_21)",Anesthesiology (D3_SNF_C3_53),Burn Intensive Care Unit (D3_HOS_C2_33),"COST SERVICES SUBJECT TO DEDUCTIBLES AND COINSURANCE - COST, Recovery Room (D_5_HOS_C6_51)",Recovery Room (C_1_C5_51),Electrocardiology (D_4_IPF_C13_69),"Net Expense for Cost Allocation, Durable Medical Equipment Rented (B_1_C0_96)",PBP Clinical Lab Services Program Only (A_C6_61),Adj for Respiratory therapy costs in excess (A8_C2_23),Hospital Type (S2_1_C4_3),Subtotal (C_1_C5_200),Recovery Room (B_1_C26_51),"AMOUNT REPORTED, Home Office Salaries & Wage Related Csts (S3_2_C2_14)",Total Current Assets (G_C1THRU4_11),Subprovider-IRF (D3_IRF_C2_40),Utilization (S5_C2_8),Medical Supplies Charged to Patients (A_C1_71),Occupational Therapy (D_4_HOS_C12_67),Total Program General Inpatient Routine (D1_IPF_C1_41),Liver Acquisition (B_1_C26_107),Whole Blood & Packed Red Blood Cells (D3_HOS_C2_62),Electroencephalography (C_1_C7_70),"COST REIMBURSED SERVICES SUBJECT TO DEDUCTIBLES  AND COINSURANCE - CHARGES, Whole Blood & Packed Red Blood Cells (D_5_HOS_C3_62)",Subprovider I (D3_HOS_C2_42),Title XVIII discharges (S3_1_C13_14),"Allocation of Interns & Residents Program Costs, Subprovider I (B_1_C22_42)",Electroencephalography (B_1_C26_70),"HHA III, Total Charges:  LUPA Episodes (S4_HHA3_C3_35)",Other Organ Acquisition (A_C2_112),Total Adults & Pediatrics (S3_1_C8_7),Renal Dialysis (D_4_IRF_C11_74),Operating Room (D3_HOS_C2_50),Impl. Dev. Charged to Patients (D_4_IRF_C11_72),"COST SERVICES NOT SUBJECT TO DEDUCTIBLES AND COINSURANCE - COST, Cardiac Catheterization (D_5_HOS_C7_59)","Insurance, Total (A7_3_C5_3)",CORF (B_2_C26_9910),Investment Income-New Movable Equip (A8_C2_2),CT Scan (D3_HOS_C2_57),Anesthesiology (D_4_HOS_C13_53),CT Scan (D_4_SNF_C11_57),"Difference between Adjusted Inpatient, Operating Cost and Target Amount (D1_HOS_C1_57)",Subprovider-IRF (D3_SNF_C2_41),Blood Clotting Factors for Hemoph. (A_C2_6250),Intensive Care Unit (S3_1_C5_8),Subprovider-IPF (D_1_HOS_C4_40),Blood Clotting Factors for Hemoph. (D_4_HOS_C10_6250),Nursery (A_C2_43),Respiratory Therapy (D3_IRF_C3_65),"Other Capital Related Costs, New Cap Related Csts Movable Equipment (A7_3_C7_2)",Total Other Income (G3_C1_25),"PPS SERVICES COST, Impl. Dev. Charged to Patients (D_5_HOS_C5_72)",Radiology-Therapeutic (C_1_C5_55),Durable Medical Equipment Rented (D3_IRF_C2_96),"AMOUNT REPORTED, Administrative and General (S3_2_C2_27)","Net Expense for Cost Allocation, Respiratory Therapy (B_1_C0_65)","Net Expense for Cost Allocation, Subprovider-IPF (B_1_C0_40)",Laboratory (D_4_IPF_C11_60),Renal Dialysis (B_1_C22_74),"Disposals and Retirements, Land (A7_1_C7_1)",Recovery Room (D3_IRF_C3_51),CT Scan (D_4_HOS_C12_57),Occupational Therapy (A_C1_67),"Beginning Balances, Buildings and Fixtures (A7_1_C1_3)","PAID HOURS RELATED TO SALARIES, Total Overhead Costs (S3_3_C5_7)",Radiology-Therapeutic (A_C2_55),"Allocation of Interns & Residents Salary and Fringes, Intensive Care Unit (B_1_C21_31)",Total (D_4_HOS_C11_200),"COST REIMBURSED SERVICES SUBJECT TO DEDUCTIBLES  AND COINSURANCE - CHARGES, Electroencephalography (D_5_HOS_C3_70)",Total Facility FTEs (S3_1_C9_27),"Allocation of Interns & Residents Salary and Fringes, SNF (B_1_C21_44)",Outlier payments (E_B_HOS_C1_4),Net Revenue from stand-alone SCHIP (S10_C1_9),Balance due provider/program (E_B_HOS_C1_43),Radiology-Therapeutic (D_4_HOS_C4_55),Physical Therapy (D_4_IPF_C11_66),SNF (S3_1_C11_19),"HHA I, Without Outliers:  Total Visits (S4_HHA1_C1_33)",Operating Room (D_4_HOS_C1_50),Operating Room (A_C1_50),OPT (A_C1_9920),Other Reimbursable (C_1_C5_98),"COST SERVICES NOT SUBJECT TO DEDUCTIBLES AND COINSURANCE - COST, Whole Blood & Packed Red Blood Cells (D_5_HOS_C7_62)",Medical Supplies Charged to Patients (D_4_IPF_C13_71),Radiology-Diagnostic (D3_HOS_C2_54),Subtotal (E_B_HOS_C1_30),"Net Expense for Cost Allocation, Intensive Care Unit (B_1_C0_31)",Medical Supplies Charged to Patients (B_2_C26_71),Renal Dialysis (D_4_HOS_C2_74),"Fully Depreciated Assets, Disp. And Retirement (A7_1_C5_7)",Whole Blood & Packed Red Blood Cells (D_4_IPF_C11_62),FQHC 6 Provider Number (S2_1_C2_1605),Other Outpatient Services (D_4_HOS_C11_93),Radiology-Therapeutic (D3_SNF_C3_55),Charity care charges and uninsured discounts for the entire facility (S10_C2_20),Research (B_1_C22_191),"Sum of lines 3,4 divided by line 6 (E_B_HOS_C101_7)",RHC (B_1_C26_88),ICF (S3_1_C8_2001),Delivery Room and Labor Room (D_4_IRF_C11_52),Other Organ Acquisition (B_1_C21_112),Drugs Charged to Patients (B_1_C26_73),"COST SERVICES NOT SUBJECT TO DEDUCTIBLES AND COINSURANCE - COST, Observation Beds (Distinct Unit) (D_5_HOS_C7_9201)",Occupational Therapy (D3_HOS_C2_67),Total Other Assets (G_C1THRU4_35),RHC 16 Provider Number (S2_1_C2_1515),"Net Expense for Cost Allocation, Maintenance of Personnel (B_1_C0_12)",Intravenous Therapy (D_4_HOS_C10_64),"PAID HOURS RELATED TO SALARIES, Medical Records & Med Records Library (S3_2_C5_41)",Delivery Room and Labor Room (D_4_IPF_C13_52),"Net Expense for Cost Allocation, Kidney Acquisition (B_1_C0_105)",Other Reimbursable (A_C6_98),"ADJUSTED SALARIES, Excluded Areas (S3_2_C4_19)",Heart Acquisition (A_C6_106),Pharmacy (A_C2_15),Other Outpatient Services (A_C2_93),RHC 10 Provider Number (S2_1_C2_1509),Intravenous Therapy (D3_IRF_C3_64),"Beginning Balances, Land (A7_1_C1_1)",Int & Res (non approved teaching program (A_C2_100),RHC/FQHC Combined (S3_1_C8_26),"COST SERVICES SUBJECT TO DEDUCTIBLES AND COINSURANCE - COST, Intravenous Therapy (D_5_HOS_C6_64)",Int & Res (non approved teaching program (C_1_C7_100),Fixed Equipment (G_C1THRU4_19),Electroencephalography (D_4_HOS_C2_70),FQHC (A_C2_89),HAC reduction adjustment amount (E_A_HOS_C1_7099),Other adjustments (E_B_HOS_C1_39),"COST REIMBURSED SERVICES SUBJECT TO DEDUCTIBLES  AND COINSURANCE - CHARGES, Impl. Dev. Charged to Patients (D_5_HOS_C3_72)",Total Other Medical Education (D_4_HOS_C4_200),Pharmacy (A_C1_15),OPT (A_C2_9920),Delivery Room and Labor Room (D_4_SNF_C11_52),"ADJUSTED SALARIES, Subtotal Salaries (S3_3_C4_3)",Radiology-Therapeutic (D3_IRF_C2_55),Cost of charity care (patients covered by public program + patients w/ coverage accepted by provider) (S10_C2_23),"Treatment capacity per day per
station (S5_C1_7)",NF (S3_1_C5_20),Ambulance Trips (S3_1_C6_29),"COST REIMBURSED SERVICES NOT SUBJECT TO DEDUCTIBLES AND COINSURANCE - CHARGES, Radiology-Therapeutic (D_5_HOS_C4_55)",NF (A_C6_45),Intravenous Therapy (D_4_HOS_C3_64),"Disposals and Retirements, Total (A7_1_C5_10)","Number of patients in program at 
end of cost reporting period (S5_C1_1)",Title XVIII discharges (S3_1_C13_17),MRI (D3_HOS_C3_58),"PAID HOURS RELATED TO SALARIES, Maintenance of Personnel (S3_2_C5_37)","Net Expense for Cost Allocation, Impl. Dev. Charged to Patients (B_1_C0_72)",Other Nonreimbursable (B_2_C26_194),Other Nonreimbursable (A_C6_194),Recovery Room (D_4_SNF_C11_51),"TOTAL CAPITAL COSTS AFTER COST ALLOCATION, OLTC (B_2_C26_46)",Other Ancillary (D3_HOS_C3_76),"Donations, Subtotal (A7_1_C3_8)",Emergency (D_4_IRF_C11_91),NF (A_C2_45),"PPS REIMBURSED SERVICES -  CHARGES, Respiratory Therapy (D_5_HOS_C2_65)","Allocation of Interns & Residents Salary and Fringes, Operating Room (B_1_C21_50)",Subprovider-IPF (D_1_HOS_C6_40),Islet Acquisition (B_1_C22_111),"PPS REIMBURSED SERVICES -  CHARGES, Radioisotope (D_5_HOS_C2_56)","AVERAGE HOURLY WAGE, Medical Records & Med Records Library (S3_2_C6_41)",Durable Medical Equipment Rented (C_1_C5_96),Allowable Inpatient Cost Plus Incentive Pt (D1_HOS_C1_63),Other Special Care Unit (C_1_C5_35),"ADJUSTED SALARIES, Interns & Residents (S3_2_C4_2550)",Subprovider-IRF (A_C1_41),IPF (S3_1_C8_16),"AVERAGE HOURLY WAGE, Other General Service (S3_2_C6_43)",Self Insurance (S2_1_C3_11801),"TOTAL CAPITAL COSTS AFTER COST ALLOCATION, Radiology-Diagnostic (B_2_C26_54)",Other Nonreimbursable (B_1_C21_194),Drugs Charged to Patients (D_4_SNF_C11_73),"AMOUNT REPORTED, Home Office Salaries & Wage Related Csts (S3_2_C3_14)","Total Inpatient Charges, NF (C_1_C6_45)",Drugs Charged to Patients (D3_HOS_C3_73),Total charges to state or local government programs for indigent care (not Medicaid or CHIP) (S10_C1_14),Total Facility FTEs (S3_1_C11_27),Hospital PO Box (S2_1_C2_1),"COST REIMBURSED SERVICES SUBJECT TO DEDUCTIBLES  AND COINSURANCE - CHARGES, Operating Room (D_5_HOS_C3_50)",Intravenous Therapy (D_4_HOS_C4_64),"AMOUNT REPORTED, Physician Part B (S3_2_C2_23)",Cost of patients approved for charity care and uninsured discounts (S10_C2_21),Surgical Intensive Care Unit (D_1_HOS_C7_34),Number of Times per week Patient receives Dialysis (S5_C1_2),Total Liabilities (G_C1THRU4_51),"COST REIMBURSED SERVICES NOT SUBJECT TO DEDUCTIBLES AND COINSURANCE - CHARGES, Radiology-Diagnostic (D_5_HOS_C4_54)",Electrocardiology (B_2_C26_69),ESRD DME costs (E_B_HOS_C1_29),PBP Clinical Lab Services Program Only (B_1_C26_61),Anesthesiology (A_C1_53),"HHA III, Total Non Routine Medical  Supply Charges (S4_HHA3_C5_38)",Hospital City (S2_1_C1_2),Total (D_1_HOS_C6_200),Occupational Therapy (D_4_IRF_C11_67),Coronary Care Unit (S3_1_C4_9),Surgical Intensive Care Unit (A_C2_34),Respiratory Therapy (A_C2_65),"Allocation of Interns & Residents Program Costs, CT Scan (B_1_C22_57)",Subprovider-IPF (D_1_HOS_C7_40),Parking Lot (A8_C2_9),"Allocation of Interns & Residents Salary and Fringes, Delivery Room and Labor Room (B_1_C21_52)",Hospice (A_C1_116),Other Special Purpose (A_C2_117),Total (S3_1_C2_7),Drugs Charged to Patients (D_4_IPF_C11_73),Burn Intensive Care Unit (C_1_C5_33),"PPS REIMBURSED SERVICES -  CHARGES, Electroencephalography (D_5_HOS_C2_70)",MRI (D_4_HOS_C13_58),Pharmacy (A_C6_15),ASC (Non Distinct Part) (C_1_C7_75),FQHC 3 Provider Number (S2_1_C2_1602),"COST SERVICES NOT SUBJECT TO DEDUCTIBLES AND COINSURANCE - COST, Recovery Room (D_5_HOS_C7_51)",Renal 6 Provider Number (S2_1_C2_1805),"PPS SERVICES COST, Blood Storing, Processing, Trans (D_5_HOS_C5_63)",Clinic (D3_IRF_C3_90),Blood Clotting Factors for Hemoph. (A_C6_6250),Research (B_1_C21_191),Other Reimbursable (D_4_HOS_C3_98),Medicare Certified Islet TC term date (S2_1_C2_132),Other Special Purpose (C_1_C7_117),CT Scan (D_4_HOS_C4_57),Delivery Room and Labor Room (D3_IPF_C2_52),interns and residents (E_B_HOS_C1_28),OPT (B_1_C26_9920),"Net Expense for Cost Allocation, Other Ancillary (B_1_C0_76)",Total Hospital (S3_1_C4_7),Radiology-Therapeutic (D_4_HOS_C12_55),Ambulance Services (C_1_C6_95),Swing Bed SNF Provider Number (S2_1_C2_7),Less: Allowances for uncollectible notes and accounts receivable (G_C1THRU4_6),Other Special Care Unit (B_1_C26_35),Hospice (S3_1_C3_24),Burn Intensive Care Unit (D_1_HOS_C6_33),"Blood Storing, Processing, Trans (D_4_HOS_C11_63)",FQHC 4 Provider Number (S2_1_C2_1603),Sale of drugs to other than patients (A8_C2_17),"Allocation of Interns & Residents Program Costs, Nursery (B_1_C22_43)",Radioisotope (D3_HOS_C3_56),Organ Procurement (D4_HEART_C1_69),Medical Supplies Charged to Patients (A_C2_71),Other Outpatient Services (D3_IRF_C2_93),MRI (D3_IRF_C2_58),Other Outpatient Services (D_4_IPF_C13_93),Research (A_C1_191),IPF Provider Number (S2_1_C1_4),CT Scan (D_4_HOS_C13_57),Operating Room (D3_IPF_C2_50),Notes Receivable (G_C1THRU4_3),"AMOUNT REPORTED, Housekeeping (S3_2_C2_32)",Clinic (D3_HOS_C2_90),RHC (B_1_C22_88),Total Subprovider I Interns & Residents (S3_1_C10_18),ICF (S3_1_C10_2001),"PPS REIMBURSED SERVICES -  CHARGES, Occupational Therapy (D_5_HOS_C2_67)",Average times dialyzers re-used (S5_C2_9),Subtotal (E_B_HOS_C1_27),"AMOUNT REPORTED, Interns & Residents (S3_2_C3_2552)","TOTAL CAPITAL COSTS AFTER COST ALLOCATION, Operating Room (B_2_C26_50)",Temporary Investments (G_C1THRU4_2),"PPS REIMBURSED SERVICES -  CHARGES, Impl. Dev. Charged to Patients (D_5_HOS_C2_72)",Total (D_1_HOS_C7_200),Cardiac Catheterization (B_1_C26_59),Radioisotope (D_4_HOS_C3_56),Intensive Care Unit (D3_HOS_C2_31),MRI (D3_IPF_C2_58),Other Reimbursable (C_1_C7_98),"AMOUNT REPORTED, SNF (S3_2_C2_9)",Other Reimbursable (D_4_HOS_C12_98),NF (S3_1_C3_20),Intravenous Therapy (A_C6_64),"Net Expense for Cost Allocation, Interns & Res Salary and Fringe Benefits (B_1_C0_21)",Clinic (D_4_IPF_C11_90),RHC 20 Provider Number (S2_1_C2_1519),"COST SERVICES NOT SUBJECT TO DEDUCTIBLES AND COINSURANCE - COST, Other Reimbursable (D_5_HOS_C7_98)",Operating Room (B_1_C26_50),Coronary Intensive Care Unit (D_1_HOS_C7_32),CT Scan (D3_IPF_C2_57),Clinic (D3_IPF_C2_90),"Allocation of Interns & Residents Program Costs, OLTC (B_1_C22_46)",FQHC 11 Provider Number (S2_1_C2_1610),IRF (S3_1_C2_17),Radiology-Therapeutic (D_4_IRF_C13_55),"TOTAL CAPITAL COSTS AFTER COST ALLOCATION, Burn Intensive Care Unit (B_2_C26_33)","Net Expense for Cost Allocation, Cardiac Catheterization (B_1_C0_59)",ASC (Distinct Part) (C_1_C6_115),Cardiac Catheterization (D_4_HOS_C10_59),"Allocation of Interns & Residents Program Costs, NF (B_1_C22_45)",Drugs Charged to Patients (D_4_IRF_C13_73),"Total Inpatient Charges, Radiology-Therapeutic (C_1_C6_55)",ICF (S3_1_C3_2001),Intensive Care Unit (D_3_HOS_C9_31),"Net Expense for Cost Allocation, Hospice (B_1_C0_116)",Int & Res (non approved teaching program (B_1_C21_100),"PPS SERVICES COST, Other Ancillary (D_5_HOS_C5_76)",Number of stations (S5_C4_6),Medicare Certified Kidney TC term date (S2_1_C2_126),Other Outpatient Services (D3_IPF_C3_93),Ending Date of SCH status (S2_1_C2_36),"AVERAGE HOURLY WAGE, SNF (S3_2_C6_9)",Cardiac Catheterization (D_4_IRF_C13_59),FQHC 7 Provider Number (S2_1_C2_1606),Durable Medical Equipment Rented (D_4_HOS_C12_96),New Capital Equipment (A_C2_2),OOT (A_C2_9930),Heart Acquisition (C_1_C7_106),"Total Inpatient Charges, SNF (C_1_C6_44)",Subprovider-IRF (D3_IPF_C2_41),Operating Room (D3_IRF_C2_50),Total Swing Bed Cost (D1_HOS_C1_26),"Purchases, Building Improvements (A7_1_C2_4)","Blood Storing, Processing, Trans (D3_HOS_C2_63)",Other Reimbursable (B_1_C26_98),"Donations, Total (A7_1_C3_10)","HHA I, Total Non Routine Medical  Supply Charges (S4_HHA1_C5_38)","COST SERVICES SUBJECT TO DEDUCTIBLES AND COINSURANCE - COST, Impl. Dev. Charged to Patients (D_5_HOS_C6_72)",Cost of patients approved for charity care and uninsured discounts (S10_C3_21),"Purchases, Land Improvements (A7_1_C2_2)",Speech Pathology (A_C1_68),"COST SERVICES NOT SUBJECT TO DEDUCTIBLES AND COINSURANCE - COST, Operating Room (D_5_HOS_C7_50)",Delivery Room and Labor Room (D_4_HOS_C13_52),"PAID HOURS RELATED TO SALARIES, Home Office:  Physician Part A (S3_2_C5_15)",MRI (D_4_HOS_C12_58),Total Allied Health (D_4_HOS_C3_200),RHC 7 Provider Number (S2_1_C2_1506),"COST REIMBURSED SERVICES NOT SUBJECT TO DEDUCTIBLES AND COINSURANCE - CHARGES, Blood Storing, Processing, Trans (D_5_HOS_C4_63)",Emergency (B_1_C22_91),RHC 11 Provider Number (S2_1_C2_1510),"ADJUSTED SALARIES, Housekeeping (S3_2_C4_32)",Durable Medical Equipment Rented (D3_HOS_C3_96),"General Inpatient Routine Service Cost, net of Swing Bed Cost (D1_IRF_C1_27)",Other Special Purpose (A_C6_117),"Fully Depreciated Assets, Ending Balance (A7_1_C6_7)",Electrocardiology (D_4_HOS_C3_69),Operating Room (D_4_IRF_C13_50),Bonus Payment (D1_HOS_C1_58),"Net costs of Epoietin furnished to
all maintenance dialysis patients
by the provider (S5_C1_13)",Surgical Intensive Care Unit (D3_IPF_C2_34),Speech Pathology (D_4_HOS_C11_68),"PPS REIMBURSED SERVICES -  CHARGES, Blood Clotting Factors for Hemoph. (D_5_HOS_C2_6250)",Renal Dialysis (D_4_HOS_C4_74),"PAID HOURS RELATED TO SALARIES, Administrative and General under Contract (S3_2_C5_28)",Other Special Care Unit (A_C6_35),NF (S3_1_C8_20),Intravenous Therapy (D3_SNF_C3_64),Other Special Care Unit (D3_HOS_C2_35),Physical Therapy (D3_IRF_C3_66),"HHA II, Without Outliers:  Total Charges (S4_HHA2_C1_35)",Kidney Acquisition (C_1_C5_105),RHC (D_4_HOS_C3_88),"Net Expense for Cost Allocation, Nursery (B_1_C0_43)",Renal Dialysis (D_4_SNF_C11_74),ASC (Non Distinct Part) (B_2_C26_75),Other Current Assets (G_C1THRU4_9),Medicaid charges (S10_C1_6),Renal 5 Provider Number (S2_1_C2_1804),"Total Inpatient Charges, Radioisotope (C_1_C6_56)",Intravenous Therapy (B_1_C26_64),Number of stations (S5_C3_6),"HHA III, Without Outliers:  Total Charges (S4_HHA3_C1_35)",Other Outpatient Services (C_1_C6_93),"Gift, Flower, Coffee Shop, Canteen (B_1_C21_190)",Home Program Dialysis (A_C1_94),Anesthesiology (D3_SNF_C2_53),"General Inpatient Routine Service Cost, net of Swing Bed and Private Room Diff (D1_HOS_C1_37)",Outpatient Rehab Provider (S3_1_C7_25),Other Nonreimbursable (B_1_C26_194),"Net Expense for Cost Allocation, Electrocardiology (B_1_C0_69)",ASC (Non Distinct Part) (D3_IPF_C3_75),Physical Therapy (A_C1_66),"Net Expense for Cost Allocation, New Capital Buildings and Fixtures (B_1_C0_1)","COST SERVICES NOT SUBJECT TO DEDUCTIBLES AND COINSURANCE - COST, CT Scan (D_5_HOS_C7_57)","PAID HOURS RELATED TO SALARIES, Excluded Area Salaries (S3_3_C5_2)","Allocation of Interns & Residents Program Costs, Electroencephalography (B_1_C22_70)",Physical Therapy (C_1_C7_66),Total (D_4_IRF_C11_200),Intensive Care Unit (S3_1_C7_8),Physical Therapy (D3_IPF_C2_66),"COST SERVICES SUBJECT TO DEDUCTIBLES AND COINSURANCE - COST, Home Program Dialysis (D_5_HOS_C6_94)",Other Ancillary (D_4_HOS_C10_76),Other Outpatient Services (D3_HOS_C3_93),Recovery Room (D3_IPF_C2_51),Drugs Charged to Patients (D_4_SNF_C13_73),Operating Room (D3_SNF_C3_50),Impl. Dev. Charged to Patients (D_4_IPF_C11_72),"PPS REIMBURSED SERVICES -  CHARGES, Speech Pathology (D_5_HOS_C2_68)","AMOUNT REPORTED, Interns & Residents (S3_2_C3_2553)",Physical Therapy (C_1_C6_66),Impl. Dev. Charged to Patients (D_4_IRF_C13_72),Occupational Therapy (D3_SNF_C3_67),Total Adults & Peds (S3_1_C6_7),OSP (A_C2_9940),"COST SERVICES NOT SUBJECT TO DEDUCTIBLES AND COINSURANCE - COST, Respiratory Therapy (D_5_HOS_C7_65)","Net Expense for Cost Allocation, Int & Res (non approved teaching program (B_1_C0_100)",RHC 21 Provider Number (S2_1_C2_1520),"Total Inpatient Charges, Whole Blood & Packed Red Blood Cells (C_1_C6_62)","Allocation of Interns & Residents Salary and Fringes, Cardiac Catheterization (B_1_C21_59)",Title XVIII discharges (S3_1_C13_16),RHC 13 Provider Number (S2_1_C2_1512),"Blood Storing, Processing, Trans (D_4_HOS_C3_63)","COST REIMBURSED SERVICES SUBJECT TO DEDUCTIBLES  AND COINSURANCE - CHARGES, CT Scan (D_5_HOS_C3_57)",Renal 8 Provider Number (S2_1_C2_1807),Research (A_C6_191),"Allocation of Interns & Residents Salary and Fringes, Other Special Care Unit (B_1_C21_35)",Burn Intensive Care Unit (B_1_C26_33),Total Nursing School (D_4_IRF_C2_200),Title V discharges (S3_1_C12_17),Title XIX discharges (S3_1_C14_18),OPT (C_1_C5_9920),Coronary Care Unit (A_C2_32),FQHC (B_2_C26_89),Clinic (D_4_HOS_C4_90),Other Ancillary (A_C2_76),Adults and Pediatrics (D3_SNF_C2_30),Total reasonable charges (E_B_HOS_C1_14),"Interest, New Cap Related Csts Movable Equipment (A7_3_C11_2)",Title XVIII discharges (S3_1_C13_18),Cardiac Catheterization (D_4_HOS_C11_59),MCP Physician Payment Method (Y/N) (S5_C1_21),OSP (C_1_C5_9940),Hospice (S3_1_C11_24),RHC 12 Provider Number (S2_1_C2_1511),Islet Acquisition (B_1_C26_111),Impl. Dev. Charged to Patients (D_4_IPF_C13_72),"Medical certified liver 
transplant center cert date (S2_1_C1_128)",Title XIX discharges (S3_1_C14_14),"HHA II, Without Outliers:  Other Charges (S4_HHA2_C1_34)",Nonpaid Workers (B_1_C21_193),"COST REIMBURSED SERVICES NOT SUBJECT TO DEDUCTIBLES AND COINSURANCE - CHARGES, Recovery Room (D_5_HOS_C4_51)",Total (B_2_C26_202),Other Long-term Liabilities (G_C1THRU4_49),Home Program Dialysis (D3_IPF_C3_94),FQHC (A_C1_89),Total Hospital (S3_1_C4_14),Radiology-Therapeutic (D_4_SNF_C11_55),Burn Intensive Care Unit (D_1_HOS_C4_33),Drugs Charged to Patients (D3_IPF_C2_73),"Blood Storing, Processing, Trans (D3_SNF_C2_63)",Coronary Care Unit (D3_SNF_C2_32),"Net Expense for Cost Allocation, Radiology-Therapeutic (B_1_C0_55)",Durable Medical Equipment Sold (A_C2_97),Liver Acquisition (B_2_C26_107),Surgical Intensive Care Unit (C_1_C5_34),Speech Pathology (D_4_SNF_C11_68),Drugs Charged to Patients (D3_IRF_C3_73),Blood Clotting Factors for Hemoph. (D_4_HOS_C3_6250),"Donations, Fixed Equipment (A7_1_C3_5)",Burn Intensive Care Unit (A_C6_33),Notes and Loans Payable (short term) (G_C1THRU4_40),Whole Blood & Packed Red Blood Cells (D3_HOS_C3_62),NOT IN THIS FILE (TRNSMTL_NUM),"AMOUNT REPORTED, Operation of Plant (S3_2_C2_30)",Cardiac Catheterization (D_4_HOS_C12_59),Radioisotope (D_4_IPF_C13_56),Total Current Liabilities (G_C1THRU4_45),"Blood Storing, Processing, Trans (A_C1_63)",Coronary Care Unit (S3_1_C5_9),ASC (Non Distinct Part) (D_4_IPF_C11_75),Other Outpatient Services (C_1_C5_93),Medicare Certified Pancreas TC term date (S2_1_C2_130),"AMOUNT REPORTED, Excluded Areas (S3_2_C2_19)",Payments received from patients for amounts previously written off as charity care (S10_C3_22),"ADJUSTED SALARIES, Interns & Residents (S3_2_C4_2552)","Blood Storing, Processing, Trans (D_4_HOS_C2_63)",Total Program Inpatient Costs (D1_IPF_C1_49),Hospital Name (S2_1_C1_3),"AMOUNT REPORTED, Cafeteria (S3_2_C2_36)",Operating Room (D_4_SNF_C11_50),Intravenous Therapy (D3_HOS_C3_64),"HHA I, PEP Episodes:  Total Charges: (S4_HHA1_C4_35)",Nonphysician Anesthetists (A_C6_19),"AVERAGE HOURLY WAGE, Non-Physician Anesthetist Part B (S3_2_C6_3)",MRI (D_4_IPF_C11_58),Radiology-Diagnostic (D_4_SNF_C11_54),"HHA I, PEP Episodes:  Other Charges (S4_HHA1_C4_34)",Coronary Care Unit (S3_1_C3_9),Radiology-Diagnostic (D_4_HOS_C10_54),Medical Supplies Charged to Patients (D_4_HOS_C10_71),"Net Expense for Cost Allocation, Adults and Pediatrics (B_1_C0_30)",Emergency (D3_SNF_C2_91),Observation Beds (Distinct Unit) (D_4_HOS_C3_9201),Other Medicaid Days (S2_1_C6_24),Renal 7 Provider Number (S2_1_C2_1806),Electrocardiology (A_C6_69),"HHA II, Total Number of Episodes (S4_HHA2_C5_36)","COST REIMBURSED SERVICES NOT SUBJECT TO DEDUCTIBLES AND COINSURANCE - CHARGES, Blood Clotting Factors for Hemoph. (D_5_HOS_C4_6250)","Net Expense for Cost Allocation, Home Program Dialysis (B_1_C0_94)",Intensive Care Unit (D_1_HOS_C4_31),Occupational Therapy (D_4_HOS_C2_67),Nursery (S3_1_C5_13),Medical Records and Medical Rec. Library (A_C1_16),"PPS REIMBURSED SERVICES -  CHARGES, Total (D_5_HOS_C2_200)",Medical Supplies Charged to Patients (C_1_C6_71),Other Special Care (S3_1_C2_12),"Total Inpatient Charges, Burn Intensive Care Unit (C_1_C6_33)","ADJUSTED SALARIES, Administrative and General (S3_2_C4_27)",or allied health costs? (S2_1_C1_60),CAH Visits (S3_1_C8_15),Labor and Delivery Days Title 18 (S3_1_C6_32),Renal Dialysis (D_4_HOS_C3_74),Hospital Adlts & Ped Swing Bed NF (S3_1_C7_6),ASC (Distinct Part) (B_2_C26_115),Inpatient Revenue (G2_C1_28),Physicians' Private Office (A_C2_192),"PPS REIMBURSED SERVICES -  CHARGES, Laboratory (D_5_HOS_C2_60)",Intensive Care Unit (S3_1_C6_8),Other Ancillary (C_1_C5_76),"PAID HOURS RELATED TO SALARIES, Cafeteria (S3_2_C5_36)",MRI (D_4_HOS_C10_58),Radiology-Diagnostic (D_4_IRF_C13_54),"Allocation of Interns & Residents Program Costs, Delivery Room and Labor Room (B_1_C22_52)","Total Inpatient Charges, Anesthesiology (C_1_C6_53)",Observation Beds (Distinct Unit) (B_1_C21_9201),Coronary Care Unit (D_3_HOS_C9_32),"Net Expense for Cost Allocation, Subprovider II (B_1_C0_4201)",Net Patient Revenue (G3_C1_3),"ADJUSTED SALARIES, Interns & Residents (S3_2_C4_2553)","Donations, Buildings and Fixtures (A7_1_C3_3)",Surgical Intensive Care Unit (S3_1_C6_11),HHA (S3_1_C7_22),Intravenous Therapy (D3_IRF_C2_64),OSP (B_1_C26_9940),Initial Physician Payment Method (Y/N) (S5_C2_21),Recovery Room (D_4_HOS_C2_51),Pass through Cost for Program Inpatient Routine (D1_HOS_C1_50),Recovery Room (D3_SNF_C2_51),Clinic (B_1_C22_90),Hospice (A_C2_116),Laboratory (D3_IRF_C3_60),Respiratory Therapy (D3_IPF_C2_65),"Allocation of Interns & Residents Program Costs, Respiratory Therapy (B_1_C22_65)",Home Program Dialysis (A_C6_94),"HHA II, Total Non Routine Medical  Supply Charges (S4_HHA2_C5_38)",Nonpaid Workers (A_C6_193),Other Special Purpose (B_2_C26_117),"Net Expense for Cost Allocation, Whole Blood & Packed Red Blood Cells (B_1_C0_62)",Social Service (A_C6_17),"COST REIMBURSED SERVICES NOT SUBJECT TO DEDUCTIBLES AND COINSURANCE - CHARGES, MRI (D_5_HOS_C4_58)",Whole Blood & Packed Red Blood Cells (D_4_HOS_C2_62),"Total Program Inpatient Operating Cost excluding Capital Related, Nonphysician, Anesthetist, and Medical Education Costs (D1_HOS_C1_53)","Blood Storing, Processing, Trans (D_4_HOS_C10_63)",Speech Pathology (D_4_IPF_C13_68),"ADJUSTED SALARIES, Subtotal Wage Related Csts (S3_3_C4_5)",Accounts Payable (G_C1THRU4_37),Subprovider I (D3_IPF_C2_42),Liver Acquisition (A_C2_107),Cardiac Catheterization (D_4_IRF_C11_59),OLTC (A_C1_46),Hospice (S3_1_C10_24),"Number of patients transplanted 
during fiscal year (S5_C1_12)","Fully Depreciated Assets, Begin Balance (A7_1_C1_7)","COST REIMBURSED SERVICES NOT SUBJECT TO DEDUCTIBLES AND COINSURANCE - CHARGES, Operating Room (D_5_HOS_C4_50)","ADJUSTED SALARIES, Non-Physician Anesthetist Part B (S3_2_C4_3)",Impl. Dev. Charged to Patients (D3_SNF_C3_72),Pancreas Acquisition (B_1_C21_109),HHA (C_1_C6_101),Total (D_4_SNF_C11_200),"ADJUSTED SALARIES, Interns & Residents (S3_2_C4_2551)",Whole Blood & Packed Red Blood Cells (D3_IPF_C3_62),"PPS REIMBURSED SERVICES -  CHARGES, Durable Medical Equipment Sold (D_5_HOS_C2_97)","Average patient dialysis time 
including setup (S5_C4_3)","COST SERVICES SUBJECT TO DEDUCTIBLES AND COINSURANCE - COST, Other Outpatient Services (D_5_HOS_C6_93)",Operating Room (D3_SNF_C2_50),Cross Foot Adjustments (B_1_C26_200),Liver Acquisition (B_1_C22_107),"HHA II, PEP Episodes:  Total Visits (S4_HHA2_C4_33)",Occupational Therapy (D_4_HOS_C13_67),"Taxes, New Cap Related Csts Bldg & Fixtures (A7_3_C6_1)","AMOUNT REPORTED, Interns & Residents (S3_2_C2_7)",Other Ancillary (D_4_IPF_C11_76),Total prospective payment (E_B_HOS_C1_24),"AMOUNT REPORTED, Physician Part B (S3_2_C3_23)",Coronary Care Unit Program Cost (D1_HOS_C5_44),Durable Medical Equipment Rented (D3_SNF_C2_96),Total customary charges (E_B_HOS_C1_18),Observation Beds (Distinct Unit) (D_4_HOS_C10_9201),Renal 2 Provider Number (S2_1_C2_1801),"AMOUNT REPORTED, Administrative & General under contract (S3_2_C2_28)","Gift, Flower, Coffee Shop, Canteen (B_2_C26_190)","Medicare certified heart
transplant center cert date (S2_1_C1_127)",Major Movable Equipment (G_C1THRU4_23),"COST REIMBURSED SERVICES NOT SUBJECT TO DEDUCTIBLES AND COINSURANCE - CHARGES, CT Scan (D_5_HOS_C4_57)",Blood Clotting Factors for Hemoph. (D3_HOS_C2_6250),MRI (D3_SNF_C2_58),Observation Beds (Distinct Unit) (D3_IRF_C3_9201),Paid Losses (S2_1_C2_11801),"ADJUSTED SALARIES, Subtotal Other Wages and Related Csts (S3_3_C4_4)","Purchases, Fixed Equipment (A7_1_C2_5)","COST SERVICES SUBJECT TO DEDUCTIBLES AND COINSURANCE - COST, Total (D_5_HOS_C6_200)",Nursing School (A8_C2_19),"Allocation of Interns & Residents Salary and Fringes, Speech Pathology (B_1_C21_68)",Laboratory (C_1_C5_60),"Net Expense for Cost Allocation, Other Outpatient Services (B_1_C0_93)",Speech Pathology (B_2_C26_68),Labor and Delivery (S3_1_C3_32),Maintenance and Repairs (A_C1_6),Drugs Charged to Patients (D_4_HOS_C10_73),Electrocardiology (D_4_HOS_C12_69),"HHA I, PEP Episodes:  Total Number of Episodes (S4_HHA1_C4_36)",Total discharges (S3_1_C15_1),Drugs Charged to Patients (D_4_HOS_C1_73),Deductibles and coinsurance (E_B_HOS_C1_25),"COST SERVICES SUBJECT TO DEDUCTIBLES AND COINSURANCE - COST, Speech Pathology (D_5_HOS_C6_68)",Respiratory Therapy (D_4_IPF_C13_65),CT Scan (A_C2_57),Total Salaries (A_C2_200),"Total Inpatient Charges, Subprovider-IPF (C_1_C6_40)",Coronary Care Unit (D3_IPF_C2_32),"HHA III, PEP:  Total Number of Outlier Episodes (S4_HHA3_C4_37)","ADJUSTED SALARIES, Dietary under contract (S3_2_C4_35)",Recovery Room (D3_IPF_C3_51),Primary payer payments (E_B_HOS_C1_31),Radiology-Therapeutic (D_4_HOS_C3_55),"COST REIMBURSED SERVICES SUBJECT TO DEDUCTIBLES  AND COINSURANCE - CHARGES, Drugs Charged to Patients (D_5_HOS_C3_73)",Interns and residents (E_B_HOS_C1_22),Physical Therapy (B_1_C26_66),"ADJUSTED SALARIES, Physician Part A (S3_2_C4_22)","Purchases, Total (A7_1_C2_10)",Durable Medical Equipment Sold (D3_HOS_C2_97),OSP (C_1_C6_9940),"AVERAGE HOURLY WAGE, Housekeeping (S3_2_C6_32)",Radioisotope (D_4_HOS_C4_56),Subprovider II (A_C1_4201),Nursing School (A_C6_20),Emergency (D_4_SNF_C11_91),Impl. Dev. Charged to Patients (D3_SNF_C2_72),Fiscal Intermediary/MAC Create Date (FI_CREAT_DT),Adj for Occupational therapy in excess of li (A8_C2_30),ASC (Non Distinct Part) (D_4_HOS_C4_75),"COST SERVICES NOT SUBJECT TO DEDUCTIBLES AND COINSURANCE - COST, Electrocardiology (D_5_HOS_C7_69)",Electroencephalography (D_4_HOS_C11_70),Renal Dialysis (A_C2_74),HHA 2 Provider Number (S2_1_C2_1201),Utilization (S5_C1_8),"COST REIMBURSED SERVICES NOT SUBJECT TO DEDUCTIBLES AND COINSURANCE - CHARGES, Impl. Dev. Charged to Patients (D_5_HOS_C4_72)",Heart Acquisition (A_C2_106),"AMOUNT REPORTED, Interns & Residents (S3_2_C2_25)",Emergency (C_1_C6_91),SNF (S3_1_C7_19),Dietary (A_C1_10),Subprovider II (B_1_C26_4201),Electroencephalography (D_4_HOS_C10_70),RHC (A_C1_88),"AMOUNT REPORTED, Central Services and Supply (S3_2_C2_39)",Durable Medical Equipment Rented (D_4_HOS_C3_96),Zip Code (S2_1_C3_143),"AMOUNT REPORTED, Interns & Residents (S3_2_C2_2552)",Emergency (D_4_HOS_C1_91),Blood Clotting Factors for Hemoph. (D3_HOS_C3_6250),Impl. Dev. Charged to Patients (D3_HOS_C2_72),Drugs Charged to Patients (D3_IRF_C2_73),Other Reimbursable (A_C2_98),"PAID HOURS RELATED TO SALARIES, Net Salaries (S3_3_C5_1)",Subprovider-IPF (D3_IPF_C2_40),"Fully Depreciated Assets, Donations (A7_1_C3_7)",Coronary Care Unit (B_1_C26_32),"PAID HOURS RELATED TO SALARIES, Housekeeping under Contract (S3_2_C5_33)",Durable Medical Equipment Sold (D_4_HOS_C13_97),Impl. Dev. Charged to Patients (A_C2_72),Electrocardiology (D3_IPF_C2_69),Interest Expense (A_C2_113),RHC 25 Provider Number (S2_1_C2_1524),"Allocation of Interns & Residents Salary and Fringes, Recovery Room (B_1_C21_51)",Respiratory Therapy (D_4_SNF_C11_65),"COST REIMBURSED SERVICES NOT SUBJECT TO DEDUCTIBLES AND COINSURANCE - CHARGES, Whole Blood & Packed Red Blood Cells (D_5_HOS_C4_62)",Average times dialyzers re-used (S5_C1_9),ICF (A_C2_4501),Home Program Dialysis (D3_SNF_C3_94),Radiology-Diagnostic (D_4_HOS_C12_54),"Allocation of Interns & Residents Salary and Fringes, Physical Therapy (B_1_C21_66)",Renal Dialysis (B_1_C21_74),Total Allied Health Cost (D_3_HOS_C2_200),Islet Acquisition (A_C6_111),Renal Dialysis (D_4_IRF_C13_74),Int & Res (non approved teaching program (A_C1_100),"COST SERVICES NOT SUBJECT TO DEDUCTIBLES AND COINSURANCE - COST, Other Outpatient Services (D_5_HOS_C7_93)",ASC (Distinct Part) (C_1_C5_115),Durable Medical Equipment Rented (D3_SNF_C3_96),"COST REIMBURSED SERVICES SUBJECT TO DEDUCTIBLES  AND COINSURANCE - CHARGES, Emergency (D_5_HOS_C3_91)","AMOUNT REPORTED, Non-Physician Part B (S3_2_C2_6)",Paramedical Education (A_C1_23),Outpatient Rehab Provider (S3_1_C8_25),"Medicare certified kidney 
transplant center cert date (S2_1_C1_126)",Other Special Care Unit (D3_IRF_C2_35),"Allocation of Interns & Residents Salary and Fringes, Subprovider-IRF (B_1_C21_41)",Total discharges (S3_1_C15_16),Ambulance Services (C_1_C7_95),Observation Beds (Distinct Unit) (D_4_IPF_C13_9201),ASC (Non Distinct Part) (A_C1_75),Other Special Purpose (C_1_C6_117),Other Reimbursable (D3_HOS_C2_98),HHA (B_1_C26_101),Electroencephalography (B_2_C26_70),Coronary Care Unit (S3_1_C6_9),"Net Expense for Cost Allocation, Radiology-Diagnostic (B_1_C0_54)",Cafeteria (A_C1_11),"AMOUNT REPORTED, Teaching Physician Salaries (S3_2_C2_16)",Electrocardiology (D_4_HOS_C4_69),"Number of Times per week
 Patient receives Dialysis (S5_C6_2)","ADJUSTED SALARIES, Wage Related Costs RHC/FQHC (S3_2_C4_24)","Taxes, New Cap Related Csts Movable Equipment (A7_3_C6_2)","ADJUSTED SALARIES, Net Salaries (S3_3_C4_1)",OPT (C_1_C6_9920),Physical Therapy (D_4_HOS_C12_66),"Net Expense for Cost Allocation, Nonpaid Workers (B_1_C0_193)",Adults and Pediatrics (A_C1_30),Interns & Res Salary and Fringe Benefits (A_C2_21),CT Scan (D3_SNF_C2_57),"PPS SERVICES COST, Anesthesiology (D_5_HOS_C5_53)","Number of days in year dialysis 
furnished (S5_C5_2)",Census Division Code (CENSUS),Respiratory Therapy (D_4_HOS_C4_65),Cardiac Catheterization (D3_IRF_C2_59),"PPS SERVICES COST, Durable Medical Equipment Sold (D_5_HOS_C5_97)",Nursing Administration (A_C2_13),Medical Supplies Charged to Patients (D_4_HOS_C2_71),Other Ancillary (D3_SNF_C2_76),IPF Provider Number (S2_1_C2_4),CORF (C_1_C5_9910),"COST SERVICES NOT SUBJECT TO DEDUCTIBLES AND COINSURANCE - COST, Impl. Dev. Charged to Patients (D_5_HOS_C7_72)",Renal Dialysis (D3_HOS_C2_74),ICF (A_C1_4501),"Allocation of Interns & Residents Salary and Fringes, Surgical Intensive Care Unit (B_1_C21_34)",Emergency (D_4_HOS_C2_91),Pass Through Cost for  Program Ancillary (D1_IRF_C1_51),"HHA III, LUPA Episodes:  Total Number of Episodes (S4_HHA3_C3_36)",Radiology-Diagnostic (A_C1_54),"Net Expense for Cost Allocation, OSP (B_1_C0_9940)",Negative Cost Centers (B_1_C26_201),Medical and Other Services reimbursed by OPPS (E_B_HOS_C1_2),Home Program Dialysis (D3_HOS_C3_94),Intravenous Therapy (D_4_IPF_C13_64),RHC (D_4_HOS_C4_88),RHC/FQHC Combined (S3_1_C11_26),Transitional corridor payment (E_B_HOS_C101_8),Intravenous Therapy (D_4_HOS_C13_64),"COST REIMBURSED SERVICES SUBJECT TO DEDUCTIBLES  AND COINSURANCE - CHARGES, Laboratory (D_5_HOS_C3_60)","Sale of scrap, waste, etc. (A8_C2_11)","Blood Storing, Processing, Trans (B_2_C26_63)",Impl. Dev. Charged to Patients (D_4_SNF_C11_72),"PAID HOURS RELATED TO SALARIES, Administrative and General (S3_2_C5_27)","Net Expense for Cost Allocation, Administrative and General (B_1_C0_5)",Islet Acquisition (C_1_C5_111),Subprovider 2 (S3_1_C3_1801),Title V discharges (S3_1_C12_16),Home Office Street (S2_1_C1_142),Physicians' Private Office (B_1_C22_192),Radioisotope (D3_IRF_C3_56),"ADJUSTED SALARIES, Teaching Physician Salaries (S3_2_C4_1601)","COST REIMBURSED SERVICES SUBJECT TO DEDUCTIBLES  AND COINSURANCE - CHARGES, Other Reimbursable (D_5_HOS_C3_98)","Net Expense for Cost Allocation, Observation Beds (Distinct Unit) (B_1_C0_9201)",Recovery Room (A_C1_51),Delivery Room and Labor Room (D_4_HOS_C2_52),Emergency (A_C1_91),Durable Medical Equipment Sold (D_4_HOS_C2_97),Program Inpatient Ancillary Service Cost (D1_HOS_C1_48),"HHA III, Total Number of Outlier Episodes (S4_HHA3_C5_37)","COST REIMBURSED SERVICES SUBJECT TO DEDUCTIBLES  AND COINSURANCE - CHARGES, Radiology-Therapeutic (D_5_HOS_C3_55)","COST SERVICES SUBJECT TO DEDUCTIBLES AND COINSURANCE - COST, Renal Dialysis (D_5_HOS_C6_74)",Radiology-Diagnostic (D3_HOS_C3_54),Intravenous Therapy (D_4_HOS_C2_64),Other Special Purpose (C_1_C5_117),Physicians' Private Office (B_1_C21_192),Subprovider 2 (S3_1_C8_1801),"Number of Times per week
 Patient receives Dialysis (S5_C4_2)",Total Hospital Interns & Residents (S3_1_C10_14),Nursery (S3_1_C7_13),"COST SERVICES NOT SUBJECT TO DEDUCTIBLES AND COINSURANCE - COST, Intravenous Therapy (D_5_HOS_C7_64)",Research (B_2_C26_191),Does the hospital elect a fully prospective payment method for capital costs? (Y/N) (S2_1_C1_48),"PPS REIMBURSED SERVICES -  CHARGES, Other Outpatient Services (D_5_HOS_C2_93)","Total Inpatient Charges, Subprovider II (C_1_C6_4201)","Net Expense for Cost Allocation, ASC (Non Distinct Part) (B_1_C0_75)",Organ Procurement (D4_LIVER_C1_69),"PPS SERVICES COST, Recovery Room (D_5_HOS_C5_51)",Hospice (C_1_C6_116),Anesthesiology (D_4_HOS_C1_53),Occupational Therapy (D3_IPF_C2_67),"Total Inpatient Charges, Surgical Intensive Care Unit (C_1_C6_34)",Subprovider 2 (S3_1_C2_1801),"AMOUNT REPORTED, Social Service (S3_2_C2_42)","ADJUSTED SALARIES, Non-Physician Anesthetist Part A (S3_2_C4_2)","AMOUNT REPORTED, Net Salaries (S3_3_C2_1)","Net Expense for Cost Allocation, Nursing School (B_1_C0_20)",Electrocardiology (D_4_HOS_C11_69),"HHA I, Total Number of Episodes (S4_HHA1_C5_36)",Paramedical Education (A_C2_23),RHC (A_C2_88),NF (S3_1_C10_20),"AVERAGE HOURLY WAGE, Maintenance of Personnel (S3_2_C6_37)",Intensive Care Unit (A_C1_31),"TOTAL CAPITAL COSTS AFTER COST ALLOCATION, Radioisotope (B_2_C26_56)","Allocation of Interns & Residents Program Costs, Anesthesiology (B_1_C22_53)","Are there any related organization or how office costs as defined in HCFA Pub. 15-I, chapter 10? (Y/N) (S2_1_C1_140)",HHA (S3_1_C8_22),Home Program Dialysis (D_4_HOS_C11_94),"COST SERVICES NOT SUBJECT TO DEDUCTIBLES AND COINSURANCE - COST, MRI (D_5_HOS_C7_58)",Electroencephalography (D_4_HOS_C4_70),IPF (S3_1_C7_16),Subtotal (E_B_HOS_C1_37),Other Outpatient Services (A_C1_93),Respiratory Therapy (D3_SNF_C3_65),Adjusted reimburseable bad debts (E_B_HOS_C1_35),FQHC (B_1_C22_89),"COST REIMBURSED SERVICES NOT SUBJECT TO DEDUCTIBLES AND COINSURANCE - CHARGES, Anesthesiology (D_5_HOS_C4_53)",Physical Therapy (C_1_C5_66),Pass Through Cost for  Program Ancillary (D1_HOS_C1_51),Delivery Room and Labor Room (A_C6_52),Observation Beds (Distinct Unit) (D3_IPF_C3_9201),Impl. Dev. Charged to Patients (D_4_HOS_C3_72),Hospital Adults & Pediatrics (S3_1_C7_1),Gross Revenue (G3_C1_1),Hospice (C_1_C7_116),OLTC (S3_1_C11_21),Electroencephalography (D3_SNF_C3_70),"Allocation of Interns & Residents Program Costs, Electrocardiology (B_1_C22_69)",Total (D_4_IPF_C13_200),Impl. Dev. Charged to Patients (D_4_HOS_C10_72),"Average patient dialysis time 
including setup (S5_C2_3)","AVERAGE HOURLY WAGE, Cafeteria (S3_2_C6_36)",Subprovider I (A_C6_42),"Treatment capacity per day per
station (S5_C2_7)",Impl. Dev. Charged to Patients (B_1_C26_72),"ADJUSTED SALARIES, Home Office:  Physician Part A (S3_2_C4_15)","AVERAGE HOURLY WAGE, Subtotal Other Wages and Related Csts (S3_3_C6_4)",Other Ancillary (D3_IPF_C2_76),"HHA I, PEP:  Total Non Routine Med Supply Chgs (S4_HHA1_C4_38)",Occupational Therapy (D3_HOS_C3_67),"PAID HOURS RELATED TO SALARIES, Teaching Physician Salaries (S3_2_C5_16)",Whole Blood & Packed Red Blood Cells (D_4_HOS_C10_62),Operating Room (C_1_C5_50),"Blood Storing, Processing, Trans (D_4_IPF_C13_63)","Number of patients in program at 
end of cost reporting period (S5_C3_1)","AVERAGE HOURLY WAGE, Administrative and General (S3_2_C6_27)",Other Nonreimbursable (B_1_C22_194),Kidney Acquisition (C_1_C6_105),"AMOUNT REPORTED, Interns & Residents (S3_2_C2_2553)",Subprovider-IPF (A_C6_40),Pancreas Acquisition (C_1_C6_109),"COST REIMBURSED SERVICES NOT SUBJECT TO DEDUCTIBLES AND COINSURANCE - CHARGES, Physical Therapy (D_5_HOS_C4_66)",Subprovider-IRF (D3_IRF_C2_41),Speech Pathology (D_4_HOS_C10_68),"COST SERVICES NOT SUBJECT TO DEDUCTIBLES AND COINSURANCE - COST, Anesthesiology (D_5_HOS_C7_53)",Radioisotope (D_4_HOS_C10_56),Respiratory Therapy (D_4_HOS_C3_65),"TOTAL CAPITAL COSTS AFTER COST ALLOCATION, Surgical Intensive Care Unit (B_2_C26_34)",Electrocardiology (D_4_SNF_C11_69),Other Outpatient Services (D_4_HOS_C10_93),Electroencephalography (D_4_HOS_C12_70),"Total Outpatient Charges, PBP Clinical Lab Services Program Only (C_1_C7_61)",Radiology-Therapeutic (D_4_IRF_C11_55),Other Nonreimbursable (A_C1_194),"Net Expense for Cost Allocation, CT Scan (B_1_C0_57)",Respiratory Therapy (D3_IPF_C3_65),ASC (Non Distinct Part) (D_4_HOS_C10_75),ASC (Non Distinct Part) (D_4_IPF_C13_75),Anesthesiology (D_4_HOS_C12_53),CT Scan (D_4_HOS_C3_57),"AVERAGE HOURLY WAGE, Home Office Salaries & Wage Related Csts (S3_2_C6_14)",Hospice 1 Provider Number (S2_1_C2_14),"Net Expense for Cost Allocation, Recovery Room (B_1_C0_51)",IRF (S3_1_C6_17),"COST REIMBURSED SERVICES NOT SUBJECT TO DEDUCTIBLES AND COINSURANCE - CHARGES, Electrocardiology (D_5_HOS_C4_69)",Kidney Acquisition (B_1_C22_105),Radiology-Diagnostic (D3_SNF_C2_54),ICF (S3_1_C2_2001),Occupational Therapy (B_2_C26_67),Other Reimbursable (D_4_HOS_C13_98),"Net Expense for Cost Allocation, Other Reimbursable (B_1_C0_98)",Anesthesiology (D3_IRF_C3_53),"Disposals and Retirements, Buildings and Fixtures (A7_1_C5_3)",Housekeeping (A_C6_9),"Purchases, Land (A7_1_C2_1)",Lung  Acquisition (A_C2_108),Cardiac Catheterization (D_4_IPF_C13_59),Hospital Adults & Pediatrics (S3_1_C2_1),Labor and Delivery Days -  Title XIX (S3_1_C7_32),Medical Supplies Charged to Patients (D_4_IRF_C13_71),PBP Clinical Lab Services Program Only (D3_IRF_C3_61),Charity care charges and uninsured discounts for the entire facility (S10_C3_20),Hospice (S3_1_C2_24),"Net Expense for Cost Allocation, Cafeteria (B_1_C0_11)","Net Expense for Cost Allocation, Laboratory (B_1_C0_60)",Labor and Delivery Days -  Title XIX (S3_1_C8_32),Operating Room (D_4_HOS_C10_50),Occupational Therapy (D3_IRF_C2_67),Nursery (A_C1_43),Other Special Care Unit (D_3_HOS_C9_35),CMHC (C_1_C7_99),"Number of patients in program at 
end of cost reporting period (S5_C2_1)","Net Expense for Cost Allocation, Lung  Acquisition (B_1_C0_108)",Total Program General Inp. Rtn Service (D1_SNF_C1_74),SNF (S3_1_C2_19),"Net Expense for Cost Allocation, Blood Clotting Factors for Hemoph. (B_1_C0_6250)",Whole Blood & Packed Red Blood Cells (D_4_HOS_C11_62),"AMOUNT REPORTED, Excluded Area Salaries (S3_2_C2_10)","COST REIMBURSED SERVICES SUBJECT TO DEDUCTIBLES  AND COINSURANCE - CHARGES, Intravenous Therapy (D_5_HOS_C3_64)","Does the facility qualify and is it receiving payments for 
disproportionate share? (Y/N) (S2_1_C1_22)","HHA II, W/Out Outliers:  Number of Episodes (S4_HHA2_C1_36)",Hospice (S3_1_C7_24),Hospice (B_2_C26_116),Renal Dialysis (D3_IPF_C2_74),CMHC (A_C2_99),Cardiac Catheterization (D3_IPF_C2_59),Emergency (D_4_HOS_C3_91),Laboratory (D3_SNF_C2_60),Other Outpatient Services (D3_IRF_C3_93),Is this a New Hospital under 42 CFR 413.40(f)(1)(I) (TEFRA)? (Y/N) (S2_1_C1_85),"PPS SERVICES COST, Intravenous Therapy (D_5_HOS_C5_64)","COST REIMBURSED SERVICES NOT SUBJECT TO DEDUCTIBLES AND COINSURANCE - CHARGES, Emergency (D_5_HOS_C4_91)",Anesthesiology (D_4_HOS_C11_53),Intravenous Therapy (D_4_HOS_C12_64),Delivery Room and Labor Room (C_1_C5_52),Intensive Care Unit (C_1_C5_31),Program Inpatient Ancillary Service Cost (D1_IPF_C1_48),Ratio of line 15 to line 16 (E_B_HOS_C1_17),Impl. Dev. Charged to Patients (D_4_HOS_C12_72),"Allocation of Interns & Residents Program Costs, Coronary Care Unit (B_1_C22_32)",Housekeeping (A_C2_9),"Blood Storing, Processing, Trans (B_1_C26_63)","ADJUSTED SALARIES, Physician Part A Teaching (S3_2_C4_2201)",Observation Beds (Distinct Unit) (D3_HOS_C2_9201),Home Program Dialysis (D_4_HOS_C3_94),Physical Therapy (D3_IRF_C2_66),Other Outpatient Services (D_4_HOS_C3_93),CORF (B_1_C26_9910),"AMOUNT REPORTED, Non-Physician Anesthetist Part A (S3_2_C2_20)",Other Outpatient Services (B_1_C21_93),Other Outpatient Services (D_4_HOS_C12_93),"AMOUNT REPORTED, Excluded Area Salaries (S3_3_C2_2)","HHA I, With Outliers:  Other Charges (S4_HHA1_C2_34)",Anesthesiology (D3_IRF_C2_53),Observation Beds (Distinct Unit) (D_4_HOS_C12_9201),FQHC (B_1_C26_89),Pancreas Acquisition (B_2_C26_109),Subprovider-IPF (D3_SNF_C2_40),NF (A_C1_45),Total Adults & Peds (S3_1_C7_7),Home Program Dialysis (A_C2_94),"HHA II, PEP:  Total Number of Outlier Episodes (S4_HHA2_C4_37)",Subprovider-IRF (D3_HOS_C2_41),RHC 3 Provider Number (S2_1_C2_1502),Other Special Care (S3_1_C4_12),OOT (A_C1_9930),Dietary (A_C6_10),"AMOUNT REPORTED, Dietary (S3_2_C2_34)",Observation Beds (Distinct Unit) (C_1_C6_9201),CORF (A_C2_9910),Delivery Room and Labor Room (D3_IRF_C2_52),RHC 24 Provider Number (S2_1_C2_1523),OLTC (S3_1_C10_21),"General Inpatient Routine Service Cost, net of Swing Bed Cost (D1_HOS_C1_27)",Durable Medical Equipment Rented (D_4_HOS_C10_96),Clinic (D3_HOS_C3_90),Total unreimbursed and uncompensated care (S10_C1_31),Medicare allowable bad debts for the entire hospital complex (S10_C1_2701),"HHA III, With Outliers:  Non Routine Med Sup Chgs (S4_HHA3_C2_38)",Radiology-Therapeutic (A_C1_55),"COST SERVICES SUBJECT TO DEDUCTIBLES AND COINSURANCE - COST, Drugs Charged to Patients (D_5_HOS_C6_73)","PAID HOURS RELATED TO SALARIES, Laundry and Linen Service (S3_2_C5_31)",Impl. Dev. Charged to Patients (D_4_HOS_C2_72),Total (C_1_C6_202),ASC (Non Distinct Part) (D_4_SNF_C11_75),Other Outpatient Services (D_4_SNF_C11_93),"Percentage of patients re-using
dialyzers (S5_C2_10)",Anesthesiology (B_1_C26_53),Excess of customary charges (E_B_HOS_C1_19),Respiratory Therapy (D3_HOS_C3_65),Occupational Therapy (D_4_SNF_C11_67),Radioisotope (D_4_IRF_C13_56),"PPS REIMBURSED SERVICES -  CHARGES, Clinic (D_5_HOS_C2_90)",Clinic (B_2_C26_90),Intensive Care Unit (D_1_HOS_C6_31),Operating Room (D_4_IPF_C13_50),"COST REIMBURSED SERVICES SUBJECT TO DEDUCTIBLES  AND COINSURANCE - CHARGES, Home Program Dialysis (D_5_HOS_C3_94)","HHA II, Total Charges:  LUPA Episodes (S4_HHA2_C3_35)",Emergency (D3_IRF_C2_91),FQHC (D_4_HOS_C4_89),"Net Expense for Cost Allocation, HHA (B_1_C0_101)",Cardiac Catheterization (D_4_HOS_C3_59),IRF (S3_1_C7_17),Private grants or donations or endowment income restricted to funding charity care (S10_C1_17),"Blood Storing, Processing, Trans (D_4_HOS_C12_63)",Cash on Hand and in Banks (G_C1THRU4_1),Total Income (G3_C1_26),Delivery Room and Labor Room (D_4_HOS_C11_52),ASC (Distinct Part) (B_1_C22_115),"COST SERVICES SUBJECT TO DEDUCTIBLES AND COINSURANCE - COST, Radioisotope (D_5_HOS_C6_56)",Radioisotope (A_C1_56),"Net Expense for Cost Allocation, Surgical Intensive Care Unit (B_1_C0_34)",Drugs Charged to Patients (D3_SNF_C2_73),Beginning FFY,Hospital Type (From CMS Hospitals Data Archive),Name and Num
8432,SOUTHWEST GENERAL HEALTH CENTER (360155),General Short Term (Acute Care Hospitals),Voluntary Nonprofit-Other,-81.83291,41.37208,,,,,1793476.0,244717766.0,71334.0,10784758.0,945252.0,1896206.0,,122342.0,16.0,,789874.0,1259627.0,38324890.0,936446.0,1538.0,,,17536804.0,,25106843.0,,,58198.0,,,1628277.0,802118.0,306661912.0,,8308031.0,,,,,,,,-41489.0,2079832.0,,2405.0,,,8.0,,,21141.0,,150877.0,,,,,12717009.0,2707585.0,-750292.0,,501185.0,6522443.0,,1782450.0,1618095.0,53830166.0,1627.0,48.07,,2891890.0,1421547.0,,152584.0,,,,,,1059303.0,4266868.0,,,0.223508,,,,4531.0,,9443.0,4137481.0,4237266.0,,1782450.0,12484536.0,13266273.0,1.0,860587.0,,,,,88091129.0,368708.0,5037375.0,,-47157.0,,,,,,,508482.0,,,,4035.0,,71593377.0,,,,6852171.0,,,3325.0,,,,,,,,1903597.0,,6434988.0,,,,,,205657.0,,,217941035.0,,505.0,,13859670.0,,4006205.0,,,,,320034.0,-825687.0,100836471.0,,,,,,,77380.0,,,15.85,,,26.07,3529.0,,,,77745.0,,,,24.96,,,,,,,,,,,,,27477.0,,1.0,,,,,12905593.0,108240.0,,,,,,,4643043.0,,778857.0,,20747.0,136882.0,63350.0,47954.0,,,,,297595.0,,,100894.0,,,,38413222.0,,,,,,,,,-652422.0,-641648.0,,8536613.0,7982625.0,,,16398628.0,,,6412270.0,9.0,,,,,,,,,67.5,41711.25,,3592178.0,4015468.0,535.0,N,,,,5281800.0,1384.0,261815.0,326.0,60352.0,,,-245.0,,,,32774623.0,,,,,,,,,,965237.0,,2461550.0,5529550.0,,1420271.0,3708.0,,6562638.0,,,,,3370162.0,,,17263287.0,,,,25995415.0,701039473.0,,,,,,-87690.0,,,,,N,,,114459.0,5998424.0,1863.16,CUYAHOGA,,,,160801.0,10011944.0,,,117127146.0,365919,,,,79922.0,,1673328.0,,,,1500.0,,,7918.0,,,13240941.0,,,,,,,,1680,,,,8172.0,,,1400569.0,,196786.0,,,,15310725.0,,356880136.0,,65285.47,,117160817.0,502334.0,1566.0,44199.0,584781.0,,,,,,,,,24895.0,-11928815.0,,12530229.0,,3814.0,,2407153.0,2079832.0,2002700.0,,198.0,72767.0,1112157.0,514379982.0,32774623.0,,,,,4643043.0,,,,,,,,2498139.0,-3540.0,,,,,,2621598.0,,18589.0,,1644919.0,7300.0,5673.0,36T155,,,,,,42636135.0,,5892320.0,1297955.0,,79922.0,,1994645.0,,,3072857.0,,,,,330615.0,,,,93885987.0,,,,2472.0,N,,-29531.0,,,,3699827.0,731391.0,,,,,,808683.0,1323087.0,1711.0,,6932818.0,,,401575.0,4,29.04,,1120531.0,,194668.0,26565694.0,33.0,3868647.71,,144936.0,17.55,,,,25069.0,782569.0,N,,303822821.0,,,,,,,,,,174816198.0,1500.0,360155,,,,,,,,4589831.0,,,,,,,,,160.39,,,,11981720.0,,725233.0,640116.0,,,,3165690.0,,100894.0,,,,,,-33820.0,,2797.0,,2244.0,,,,10849.0,4759.0,,,652121.0,,,,9446943.0,53289923.0,14327.77,17103.94,,,,16750.0,747076.0,,,,,190.0,,187105.0,,,,,,,,12546.0,,,,,,,,,409453.0,3592178.0,,,,,2816208.0,,,,,1662823.0,,,,,,,,,,,-164011.0,4685541.0,,,-94122.0,47450495.0,3135760.0,,1749782.0,,,357726.0,47528920.0,,3133121.0,,50037.0,,101714312.0,,,,,3370880.0,113711551.0,,3324354.79,F,6948963.0,2187481.0,,,,,,5501868.0,,,-25074.0,-259233.0,26565694.0,4647405.0,,1037.0,7817429.0,4592447.0,9654.0,1105.0,9323994.0,,,,,,,6948963.0,,,1938912.0,,,,7255650.0,,,,,,,N,,,3293280.0,256018.0,,,,,-50735.0,,,,,116550642.0,,3414.0,-13008.0,4745.0,464152.0,,,7825.0,21.65,,,4520.0,21074498.0,10597.0,,,2549564.0,28322450.0,-17171.0,,23227.0,,,,,,11415.0,6422882.0,,,,,,356846.0,,346849.0,,,,,,-9320.0,,,,,2977209.0,,12.2,,1391105.0,1323087.0,695942.0,181.0,,,,13747.0,,,6408579.0,21168156.0,1523691.0,,,,,,,916173.0,,,,,2521.0,,,111563.12,25069.0,,,,,,410660.0,29.52,,202598035.0,,,,5895682.0,,,25995415.0,,,,251154.0,,592106.0,149783738.0,,5541558.0,4751.0,2116858.0,36170,3892940.0,1839042.0,,3880496.0,,,,211.0,,12445599.0,2635890.0,,,,975094341.0,,35.24,,,,,,3324213.0,,18329393.0,,,,,,6718585.0,,,,26184.0,,,,421788.0,,,,,,,2468040.0,,36371.0,,,,,,,,,41.0,-80899.0,,1559159.0,,,,,1225709.0,,639683.0,2868459.0,88113.0,16042968.0,,,,,1587799.0,,,,25560785.0,2711105.0,,87728.02,108637.0,244327.0,,,,,,,,16710356.0,,248.0,,,,416.0,1896206.0,,,2498139.0,,252946.0,2031444.0,1242039.0,1401651.0,,2833126.0,51740.0,26.05,,,94527850.0,,,6969739.0,,12530229.0,,,420672.0,,,16.77,,-5605223.0,,,22829.0,,,3442.0,61350.0,,3786174.0,,,Y,640116.0,,1498987.0,11932935.0,,6347.0,765348.0,,,,,954677.0,1584110.0,,,,,,822115.0,N,2046833.0,408341.0,,14067066.0,,,401575.0,,,13140.0,2498139.0,18589.0,,,,,,,,,,6434988.0,-7960.0,36838.0,,,Y,,,15952.0,,,,,,63307.0,52857.44,,4476792.0,,-5488.0,9533128.0,,,108240.0,,,188907.0,,,,8787553.0,,4362153.0,,24.0,,,,,,,,333979.0,39631.0,,100592836.0,60.0,7467204.0,,,,765348.0,,100592836.0,5442.0,,2183927.0,,2031156.0,,,2304875.0,,,,829624.0,17946855.0,,,,421789.0,46441266.0,9112017.0,,,,,1348.0,779.0,,,89109.0,,,-37749.0,,868819.0,250.0,,,,,18738010.0,,,,,51746.36,42063760.0,,3091172.0,8563080.0,,50517.0,,11237.0,,,,14.85,23.25,3287663.0,244717766.0,,,,,108637.0,270143.0,809414.0,1498.0,29830.0,,,,,2563.0,1077067.0,413947.0,,346684.0,,,,178828.0,1194707.0,270332.0,,,-39026.0,,,201257.0,,,382177.0,246714.0,,19473.0,25359354.0,6736780.0,,521257137.0,,200.2,-279070.0,,,,4531.0,5822.0,,,,77.27,18228630.0,41325.5,1127782.0,,35558.0,,28.79,,31.7,,1656796.0,,75732.0,,1820808.0,-127645.0,,35759.0,,,1618095.0,152603.0,84.0,1245552.0,,,,,16247.0,3007.0,,,1387.0,,,,6935.0,,,,,142749.0,8399706.0,,,108240.0,,16398628.0,,6522443.0,,34328337.0,,91883618.0,,,3368572.56,3074273.0,,,1465121.0,36,,,,,,,,,,,,34245.39,77380.0,,6408579.0,,45888564.0,-50599.0,,,,6412270.0,,90520.0,,-66511.0,2978756.0,,,,,34.77,1763366.0,,,108240.0,,,25995415.0,,,,,,340417.0,,,13674.0,,,,14810999.0,,,,949009.0,,,544045.0,341416.0,,,,,95932150.0,1491007.0,,,,2011-12-31,,44130-3497,,,7097288.0,184274.0,1245552.0,,,,,6555115.0,4566884.0,,,,,,23227.0,,,,175117.0,53.42,,,,44217.77,29029583.0,,653461.0,279976.0,257858.0,51120175.0,,,,6852171.0,2085293.0,,315.0,,,,,,,,N,,,,8.0,2304875.0,1461384.0,,784730,-3540.0,,6048652.0,,,OH,,31424087.0,,-5071201.0,,,,,,,1790895.0,,36.0,,4640448.0,28132.0,192559.0,,,,,14000071.0,,381625.0,674557.0,,,,,P,,4751.0,,1906.0,,,,,,,2163.0,,,,22178.0,,,,3986199.0,,1736564.0,651.0,,,4382.0,,3505635.0,,,,,,-23274.0,,,8901185.0,1.0,,787772.0,18697 BAGLEY ROAD,,31.72,1 S ACUTE REHAB,,,,,,,,,,,,9543065.0,,,18738010.0,,1092.0,,,75732.0,,-192379.0,,,,,,,98614.0,,,,,,1423737.0,,67277.0,,2189.0,,,,2002.0,79360931.0,373.0,,156092.0,2251.0,,,689408.0,632456.0,367253,362.0,22829.0,1363450.0,N,71575.1,230842.0,312575.0,,,,,,,-212069.0,,,,,154.0,1500.0,20.0,26.6,108240.0,15201,50523878.0,N,,,,,3235321.0,,,11148663.0,102526.0,2002700.0,,,8568392.0,1809.0,,,2923306.0,13277569.0,,,,218486010.0,2573.0,4108845.0,,,,350313.0,5.0,,4035.0,6344.0,,,59396543.0,2928383.0,,,7650.0,,,,24680.0,,11987435.0,108240.0,,,,,,171051436.0,,,-21233.0,-2875.0,6787794.0,,,,405.0,,,,,,,,,,183989.0,,,,1628277.0,,,1421.0,2072426.0,3322400.0,1271438.0,,,,13390851.0,1267.0,12861298.0,,,,,,1757404.0,,1387798.0,256646581.0,2891890.0,,74932.0,2325614.0,,,,2891890.0,,,1096562.0,,535288.35,62872148.0,426689.0,787662.0,3880496.0,1465121.0,,,,,,,,,,3706363.0,,,,33.75,,,67566.0,,,14000555.0,,,23.51,2661678.0,,,,,538227.0,,,3218413.0,,,,,-71859.0,6434988.0,5375577.0,168001.0,67751.0,,,,18725272.0,,,,26.49,,,1903597.0,,,25069.0,,,,,,,20747.0,,,,2711641.0,2029572.0,,,1323087.0,,2986434.0,-11928815.0,,,,,,,,,,,202043.0,,,1096562.0,538227.0,2011-01-01 00:00:00,4050.0,,75732.0,,,3135760.0,1521696.0,,,,7760197.0,524025.0,548756.0,,,,,,,21991127.0,,,,,,842825.0,,,,,,,,,,,-3809902.0,,,,,-36047.0,,,,,220.0,2297.0,,58380.0,,4015468.0,,,,,,,1071188.0,-98495.0,29225262.0,,4050.0,,184204.0,,,929766.0,,,,,,,,,,-616846.0,,2521.0,,3174164.0,,144988.0,2989291.0,4382.0,6404204.0,,,,725233.0,,-1303752.0,,-2271113.0,,,,,15485576.0,12980163.0,,2423.0,,2029572.0,,,,,2748.0,5498022.0,,,,4742880.0,,584781.0,,,,,,,4775062.0,,,,,,,2680542.0,,17460,,,3993854.0,,335556.0,,,,,4546823.0,,,,,General Short Term,220148833.0,4546823.0,,50430257.0,,,,,2969161.0,,,,,,5673.0,,,,,47954.0,,21927290.0,,,74932.0,,-16853.0,8399706.0,,,,,,,8266.0,,455981.0,12344.0,,6606859.0,1840016.0,,,13266273.0,1346309.0,3187346.0,505.0,,,716.0,10784758.0,894844.0,173396357.0,1258995.84,,,19473.0,,,,23026.0,,,,,,17160.0,,7763417.0,,,,,8573005.0,14009163.0,4710655.0,106476.0,,,,,,,2880925.0,,,,,,,21074498.0,,829624.0,211922029.0,,,,104563.43,,,,4018548.0,,19014568.0,,,,7255650.0,,,,,15181741.0,,,,,,,3165690.0,,,88057458.0,,2241242.0,,,,,,,1938912.0,,206.0,212947.0,,15434582.0,1381003.0,-6494.0,,,,,,,244327.0,,3814.0,,1271438.0,19.15,,,,,878609.0,8266.0,,,1403409.0,,,,,4525773.0,,,,,,,2880925.0,,,207096398.0,,321026.0,,,1577201.0,,MIDDLEBURG HEIGHTS,36371.0,,,,607972.0,,188907.0,-20836.0,,1606170.0,202109.0,212.0,,,,,-93500.0,,,,,120609.0,,,,,,1031962.0,,,,,,,,,,-24686168.0,,3650.0,,,,-15760.0,,83374.0,,,,15626.0,,71612.0,SWGHC MENTAL HEALTH SERVICES,,7401.0,,1363450.0,15952.0,,,,,,14009163.0,,2630242.0,,4217193.0,1681935.0,,,7506786.0,,,949009.0,,,,,,,,26652407.0,189012.0,109744.0,101157.0,,,19.0,,,,,,,,,,,1970612.0,,,,,,,27.6,,,,,,,4149252.0,,24120.0,,,992809.0,,,74181.0,,4346046.0,5312.0,251610.0,,,,3133121.0,108240.0,,,,,1363450.0,,2891890.0,,,,,,,,,,,5254.8,,,,,464227.0,,,,683992.0,,,,55100498.0,,1397336.0,,,,,,,,32774623.0,,17889195.0,1926474.0,,4350181.0,8536613.0,,569533.74,,16690863.0,250.0,117.0,82671.0,,,,609.0,,1628.0,,1627.0,,8003317.0,,114825.0,22829.0,,,,,,,376.0,,,,,,,,,,,,1211482.0,,,,,114459.0,211904.0,,,,,,,,,,211.0,,,,15485576.0,163584232.0,,,,,,900646.0,9837.0,,,,,,,147240.0,,,,5747491.0,,A,1127782.0,,,36044962.0,280990.0,,,,,4018548.0,639683.0,,,3379821.0,SOUTHWEST GENERAL HEALTH CENTER,1921733.0,,,112770.0,,,,,,5840.0,8573005.0,7817429.0,15083827.0,,,,,-45922.0,,,,6344.0,,,2002700.0,91883618.0,19569942.0,,,13253966.0,Y,,,,,,461788271.0,5111458.0,2046833.0,3059.0,,44000.75,2468040.0,,,13133534.0,,,,282005935.0,,,,162.0,,,,,1309732.0,,,1242328.0,29801.0,35360.0,,,,,23152.0,,-53790.0,,,44907322.0,992809.0,,25995415.0,10440037.0,,,,,33.99,,,,,,,,220.0,,,,,,8688.0,,,,,,,,17971381.0,,2919870.0,,114459.0,,,842825.0,96544.0,,105448969.0,,,,,,3074273.0,46134.0,1842.0,,,12931429.0,,8037.0,,1903597.0,21168156.0,3370880.0,52.0,13674.0,,1088.0,,,772761.0,156053745.0,12851039.0,,,6347.0,145.0,9092.0,,,,8207094.0,,6969739.0,,,12.22,,,,,,2024-09-20 00:00:00,,,,,,,,,,,15978778.0,,,,,,725233.0,,,,,,11545323.0,688679.0,,3893888.53,5838628.0,,5895682.0,36889.76,,,90514.0,2034518.0,,,,,,,,6932818.0,,,,,,,,,,,822115.0,68296.0,,,,,1139.0,,,,,,4685541.0,,2244.0,6422091.0,1921733.0,,,,246714.0,,101448309.0,,592106.0,,13570737.0,,,1427722.0,,3.0,,,,1543517.0,,,36S155,,,,,,,51690.0,,4390495.0,,,16708856.0,,,,,,,380.0,,45246.0,,466754.69,29493443.0,,,,,,903.0,,,,1857119.0,,5183372.0,,25560785.0,,,,1767771.0,,508482.0,,,,1714.23,87.0,,2660.0,N,,,,,956661.0,9304.0,,19239.0,,,1896206.0,,101204674.0,,,1243.0,27125.0,,,,4282505.0,41265.0,,N,30414.0,,,,238.0,14001647.0,,32605.0,1576.0,,,8207449.0,1311866.0,,,,979.0,983045408.0,7376441.0,,,,,11545323.0,,14.85,,,18329393.0,,69.53,,2135.0,205237.0,,,26652407.0,,,28.4,,,,-15272.0,,,4046410.0,357726.0,,731391.0,,,,,,,,4668271.0,927022.0,8436.0,,,9543065.0,,,361530,2649745.0,2423.0,,,66940.0,,69255.0,,,1015.0,429.0,-4933.0,,,,212.0,2.0,,,9436040.0,10.0,206943.0,8621055.0,596.0,21927290.0,1350032.0,545656.0,,,,,1348787.0,13.0,,,12164536.0,,N,,,264279.0,,,,,299693.0,,N,,,,,2923306.0,8787553.0,410660.0,,4217193.0,,1903839.0,2116858.0,,,,1396744.0,,,,,,13113545.0,,6788.0,,,,,,979.0,,,,,,,,,,,,,,32774623.0,,3906.0,27975302.0,262840.0,,,,6205.95,,460714359.0,,,,6027096.0,89390.0,857036.0,,,524025.0,156178.0,3059.0,,,,978.0,,3231476.0,,,,356846.0,13913575.0,31966213.0,,,,219048.0,,678146.0,2011,Acute Care Hospitals,SOUTHWEST GENERAL HEALTH CENTER (360155)
14091,SOUTHWEST GENERAL HEALTH CENTER (360155),General Short Term (Acute Care Hospitals),Voluntary Nonprofit-Other,-81.83291,41.37208,,,,,2090154.0,252657301.0,69165.0,11056499.0,899452.0,1876588.0,,124512.0,16.0,,842835.0,1348451.0,38568760.0,811890.0,,,,17603047.0,,21794278.0,,,65414.0,99134.0,,1760537.0,802240.0,311692739.0,,8100030.0,,,,,,,,-37393.0,2006813.0,,668.0,,,10.0,,,18061.0,,147560.0,,,,,11423812.0,2621649.0,-774873.0,,456734.0,7134712.0,,1816502.0,1675550.0,60347559.0,,,,3016455.0,1325395.0,,139182.0,,,,,,917205.0,4268111.0,,,0.212545,,,,4636.0,,20847.0,3940230.0,4248624.0,,1816502.0,13578816.0,13656550.0,1.0,1169158.0,,,,,91175659.0,368708.0,5316403.0,,-43640.0,,,,,,,498375.0,,,,4011.0,,70720652.0,,,,9134161.0,,,1383.0,,,,,,,,1987266.0,,7313141.0,,,,,,172519.0,,,226149721.0,,514.0,,15343394.0,,3938304.0,,,,,280493.0,-838844.0,102371498.0,,,,,,,75762.0,,,14.94,,,27.15,2968.0,,,,76666.0,,,,26.45,,,,,,,,,,,,,18343.0,,17.0,,,,,13802439.0,111498.0,,,,,,,5400342.0,,773963.0,,37001.0,75794.0,90555.0,47837.0,,,,,311653.0,,,93697.0,,,,41817979.0,,,,,,,,,-1669024.0,-4635847.0,,7208692.0,7414602.0,,,20063817.0,,,6276405.0,1.0,,,,,46.0,,,,37.5,39500.44,,3448355.0,4112284.0,6199.0,N,,,,5363659.0,,266572.0,321.0,63709.0,,,-1171.0,,,,34448354.0,,,,,,,,,,887764.0,,2875572.0,5835901.0,,3794097.0,3374.0,,7124430.0,,,,,3621439.0,,,17086128.0,,,,24988097.0,776807725.0,,,,,,,,,,,N,,,121490.0,4836984.0,1815.96,CUYAHOGA,,,,154876.0,3206161.0,,,119922887.0,365919,,,,81451.0,,2110997.0,,,,1539.0,,,4353.0,,,11527290.0,,,,,,,,1680,,,,11183.0,,,1284300.0,,159134.0,,,,15181741.0,,438016377.0,,62877.25,,119934210.0,506050.0,773.0,44980.0,2214631.0,141.0,,,,,,,,21984.0,-14252943.0,,13434596.0,,3789.0,,2438490.0,2006813.0,1469019.0,,319.0,82555.0,1109194.0,572814230.0,34448354.0,,,,,5400342.0,,,,,,,,2419261.0,-2810.0,,,,,,2344644.0,,16096.0,,1773683.0,7320.0,5724.0,36T155,,,,,,43099550.0,,4710663.0,1410142.0,,81451.0,,2545563.0,,,3285932.0,,,,,324335.0,,,,105696995.0,,,,1200.0,N,,-16291.0,,,,3430287.0,703165.0,,,,,,479461.0,1304895.0,1837.0,,7787755.0,,,388384.0,4,29.85,,1158656.0,,202395.0,28650731.0,9.0,3770221.45,,129106.0,18.21,,,,24154.0,752421.0,N,,308853648.0,,,,,,,,,,178560057.0,1539.0,360155,,,,,,,,4754361.0,,,,,,,,,145.53,,,,11768320.0,,740318.0,567419.0,,,,3494451.0,,93697.0,,,-56872.0,,,-33820.0,,1262.0,,2269.0,,,,12609.0,2231.0,,,645205.0,,,,9077573.0,54284081.0,28427.88,,,,,14101.0,769697.0,,,,,,,143688.0,,,,,,,,10270.0,,,,,,,,,396385.0,3448355.0,,,,,2959520.0,,,,,2429035.0,,,,,,,,,,,-327440.0,4911916.0,,,-4756.0,48425376.0,3208339.0,,1713105.0,,,363017.0,47610432.0,,2320954.0,,41442.0,,105448969.0,,,,,3669960.0,122778037.0,,3335180.56,F,6864215.0,2214854.0,,,,,,5568126.0,,,-236570.0,-617047.0,28650731.0,4258251.0,,911.0,8187809.0,3900117.0,2918.0,122.0,32451505.0,,,,,,14186.0,6864215.0,,,3747182.0,,,,7255649.0,767601.0,,,,,,N,,,3689059.0,258181.0,,,,,-50068.0,,,,,125617128.0,,689.0,-5875.0,4758.0,519531.0,,,1571.0,22.74,,,6225.0,21240006.0,,,,2892168.0,31692906.0,,,24145.0,,,,,,6087.0,6323897.0,,,,,,326645.0,,333530.0,,,,,,-9049.0,,,,,2457365.0,,12.1,,1378911.0,1304895.0,700725.0,2069.0,,,,9926.0,,,8017455.0,21124195.0,1627031.0,,,,,,,994969.0,3399.0,,,,2263.0,,,9459.35,24154.0,,,,,,368178.0,27.41,,245677151.0,,,,6222659.0,,,24988097.0,,,,284824.0,,523130.0,161137386.0,,5811983.0,15239.0,2291876.0,36170,,1989501.0,,3749934.0,,,,209.0,,12946376.0,2392484.0,,,,1064006838.0,,35.98,,,,,,3403230.0,,21100537.0,,,,,,6586828.0,,,,19807.0,,,,421788.0,,,,,,,1981925.0,,34809.0,,,,,,,,,47.0,-72732.0,,1627773.0,,,,,1341289.0,,623204.0,3923983.0,102347.0,17314310.0,,,,,1662047.0,,,,25758767.0,3082252.0,,96040.37,121383.0,274177.0,,,,,,,,17545725.0,,243.0,,,,445.0,1876588.0,,,2419261.0,,243239.0,2167758.0,1380155.0,1315830.0,,2895563.0,36001.0,26.82,,,94785291.0,,,16919134.0,,13400871.0,,,276131.0,,,15.52,,-6833368.0,,,21749.0,,,3459.0,60956.0,,3636751.0,,,Y,567419.0,,1674214.0,11735180.0,,214940.0,1279935.0,,,,,1022267.0,1513676.0,,,,,,,N,2292965.0,440549.0,,14667803.0,,,388384.0,,,13176.0,2419261.0,16096.0,,,,,,,,,,7313141.0,-9160.0,37561.0,,,Y,,,29746.0,,,,,,69504.0,47380.39,,4579621.0,,-7436.0,10986622.0,,,111498.0,,,158418.0,,,,9131437.0,,4577333.0,,6.0,,,,,,,,335784.0,58705.0,,102123416.0,193.0,,,,,1279935.0,,102123416.0,,,2211471.0,,2134878.0,,,2483281.0,,,,992985.0,18566441.0,,,,421789.0,46982704.0,9232741.0,,,,,2389.0,,,,83146.0,,,-22694.0,,826296.0,238.0,,,,,19799128.0,,,,,50959.64,44466000.0,,3455360.0,8568392.0,,51466.0,,20461.0,,,,13.26,23.6,2176142.0,252657301.0,,,,,121383.0,258268.0,753088.0,1329.0,36384.0,,,,,3629.0,899625.0,1793823.0,,332543.0,,,,190603.0,1147293.0,254980.0,,,-3885.0,,,182581.0,,,358941.0,,,19225.0,28952719.0,6696700.0,,579748378.0,,4455.36,-277745.0,,,,4636.0,107.0,,,,68.25,19541951.0,40651.9,1166251.0,,40333.0,,34.49,,48.24,,1654482.0,,88530.0,,1701506.0,-159367.0,,35252.0,,,1675550.0,136324.0,51.0,1385039.0,,,,,14276.0,1536.0,,,3656.0,,,,6954.0,,,,,176097.0,8561555.0,,,111498.0,,20063817.0,,7134712.0,,32537704.0,,101527998.0,,,3400185.44,3770454.0,,,1465326.0,36,,,,,,,,,,,,31670.19,75762.0,,8017455.0,,54147710.0,-53846.0,,,,6276405.0,,88938.0,,4156.0,3122121.0,,,,,35.27,3442678.0,,,111498.0,,,24988097.0,,,,,,354055.0,,,14088.0,,,,14557476.0,,,,904092.0,,,543094.0,327460.0,,,-255725.0,,83457425.0,1544182.0,,,,2012-12-31,,44130-3497,,,7355800.0,167013.0,1385039.0,,,,1582678.0,6894191.0,4400632.0,,,,,,24145.0,,,,254265.0,45.02,,,,65004.88,31783856.0,,685736.0,279926.0,289150.0,58354886.0,,,,9134161.0,10087586.0,,286.0,,,,,,,,N,,,,10.0,2483281.0,1574040.0,,780927,-2810.0,,10113557.0,,,OH,,32483352.0,,-5647247.0,,,,,,,1985757.0,,36.0,,4858653.0,26912.0,163000.0,1582678.0,,,,14555001.0,,353318.0,695601.0,,,,,P,,15239.0,,1525.0,,,,,,,5056.0,,,,16520.0,218605.0,,,4056510.0,,1814697.0,484.0,,,,,3568819.0,,,,,,-31281.0,,,9048049.0,1.0,,876318.0,18697 BAGLEY ROAD,,33.03,1 S ACUTE REHAB,,,,,,,,,,,,9751440.0,,,19799128.0,,548.0,,,88530.0,,-156656.0,,,,,,,96347.0,,,,,,1479284.0,,46643.0,,2609.0,,,,1695.0,92484123.0,41.0,,145353.0,167865.0,,,766428.0,627691.0,367253,494.0,21749.0,116212.0,N,71764.89,264243.0,394178.0,,,,,,,-250201.0,,,,,167.0,1539.0,20.0,27.69,111498.0,15201,54000224.0,N,,,,,2960558.0,,,11379160.0,94815.0,1469019.0,,,8568392.0,,,,2924617.0,12633130.0,,,,226462681.0,8427.0,4234833.0,,,,251095.0,5.0,,4011.0,6220.0,,,64434522.0,2866311.0,,,6660.0,,,,16244.0,,13096183.0,111498.0,,,,,,226714794.0,,,-21785.0,-1787985.0,7172946.0,,,,,,,,,,,,,,414321.0,,,,1760537.0,,,1357.0,1921326.0,2209398.0,1247749.0,,,,13845828.0,1034.0,10540969.0,,,,,,1652930.0,,1610599.0,266910244.0,3016455.0,,63426.0,2381592.0,,,,3016455.0,,,1080866.0,,548549.28,69248741.0,424205.0,806042.0,3749934.0,1465326.0,,,,,,,,,,4143881.0,,,376.0,35.82,,,63051.0,,,14671959.0,,,23.86,2743546.0,,,,,511608.0,,,3254181.0,,,,,-54023.0,7313141.0,5878619.0,155765.0,68101.0,,,,26256612.0,,,,27.33,,,1987266.0,,,24154.0,,,,,13770.0,,37001.0,,,,2627243.0,2286603.0,,,1304895.0,,2698709.0,-14252943.0,,,,,,,,,,,1533317.0,,,1080866.0,511608.0,2012-01-01 00:00:00,7238.0,,88530.0,,,3208339.0,1634336.0,,,,11008718.0,562934.0,544116.0,,,,,,,25017868.0,,,,,,976696.0,,,,,,,,,,,,,,,,66133.0,,,,,160.0,1213.0,,60545.0,,4112284.0,,,,,,,1217428.0,2516636.0,31621505.0,767601.0,7238.0,,171893.0,,,1036213.0,,,,,,,,,,-318992.0,,2263.0,,3118304.0,54.11,88615.0,2721374.0,,7306152.0,,,,740318.0,,-2394.0,,-4314939.0,,1582678.0,,,14072907.0,16340824.0,,2413.0,,2286603.0,,,,,2570.0,11533010.0,,,,5496944.0,,2214631.0,,,,,,,4530284.0,,,,,,,2756381.0,,17460,,,3790662.0,,392739.0,,,,,4906531.0,,,,,General Short Term,228891716.0,4906531.0,,65102430.0,,,,,2922645.0,,,,,,5724.0,,,,,47837.0,,25733027.0,,,63426.0,,-26178.0,8561555.0,,,,,,,9481.0,,430384.0,8602.0,,8831183.0,2356238.0,,,13656550.0,1351478.0,3614583.0,514.0,,,368.0,11056499.0,967908.0,174816199.0,1227972.58,,,19225.0,,,,25209.0,,,,,,14673.0,,8063973.0,,,,,8244985.0,14560833.0,4861478.0,109778.0,,,,,,,3301759.0,,,,,,,21240006.0,,992985.0,278128656.0,,,,72155.03,,,,3947665.0,,19240243.0,,,,7255650.0,,,,,14936825.0,,,,,,,3494451.0,,,91164336.0,,2678555.0,,,,,,,3747182.0,,176.0,217734.0,,17696850.0,1233414.0,-67387.0,,,,,,,274177.0,,3789.0,,1247749.0,20.36,,,,,945086.0,9481.0,,3643345.0,1061909.0,,,,,4201877.0,,,,,,218605.0,3301759.0,,,276878991.0,,223442.0,,,1620651.0,,MIDDLEBURG HEIGHTS,34809.0,,,,621024.0,,158418.0,-21609.0,,1653498.0,203883.0,207.0,,,,,-118240.0,,,,,109045.0,,,,,,1108038.0,,,,,,,,,,-24199425.0,,3660.0,,,,-7103.0,,72757.0,,,,21746.0,,73484.0,SWGHC MENTAL HEALTH SERVICES,,22216.0,,116212.0,29746.0,,,,,,14560833.0,,2402150.0,,5373945.0,1472416.0,,,8098694.0,,,904092.0,,,,,,,,26487672.0,172920.0,98384.0,79853.0,,,19.0,,,,,,,,,,,1919512.0,,,,,,,28.4,,,,,,,3775506.0,,37824.0,,,1176456.0,,,52099.0,,4767085.0,,227139.0,,,,2320954.0,111498.0,,,,,116212.0,,3016455.0,,1582678.0,,,,,,,,,6711.22,,,,,464997.0,,,,587685.0,,,5835171.0,61742401.0,,1541243.0,,,,,,,,34448354.0,,18216045.0,1056495.0,,4480964.0,7208692.0,,580219.47,,18872355.0,238.0,92.0,60299.0,,,,4359.0,,1811.0,,,,9060576.0,,122174.0,21749.0,,,,,,,381.0,,,,,,,,,,,,1272091.0,,,,,121490.0,260506.0,,,,,,,,,,209.0,,,,14072907.0,226714794.0,,,,,,819456.0,4143.0,,,,,,,125492.0,,,,12004884.0,,E,1166251.0,,,50164197.0,300117.0,,,,,3947665.0,623204.0,,,3290823.0,SOUTHWEST GENERAL HEALTH CENTER,1787468.0,,,88739.0,,,,,,5856.0,8244985.0,8187809.0,15774709.0,,,,,-1136611.0,,,,6220.0,,,1469019.0,101527998.0,20370249.0,,,13642964.0,Y,,,,,,492922310.0,4713930.0,2292965.0,2894.0,,41063.03,1981925.0,,,14374290.0,,,,295862963.0,,,,232.0,,,,,1151823.0,,,1179113.0,29431.0,14415.0,,,,,18536.0,,-57614.0,,,45265788.0,1176456.0,,24988097.0,13856848.0,,,,,33.69,,,,,,,,160.0,,,,,,11060.0,,,,,,,,18593189.0,,3045565.0,,121490.0,,,976696.0,82777.0,,113539301.0,,,,,8990110.0,3770454.0,9349.0,9.0,,,13802439.0,,7318.0,,1987266.0,21124195.0,3669960.0,42.0,14088.0,,,,,716510.0,164786828.0,14740150.0,,,214940.0,1046.0,5832.0,,,,8497046.0,,15901416.0,,,12.29,,,,,,2024-08-14 00:00:00,,,,,,,,,,,22043755.0,,,,,,740318.0,,,,,,12125282.0,630890.0,,3915400.03,5794110.0,,6222659.0,148198.0,,,79681.0,2087194.0,,,,,,,,7787755.0,,,,,,,,,,,,70078.0,,,,,1133.0,,,,,,4911916.0,,2269.0,6436060.0,1787468.0,,,,,,105010164.0,,523130.0,,14289977.0,,1541.0,1389715.0,,3.0,,,,1791471.0,,,36S155,,,,,,,45485.0,,4375675.0,,,17544186.0,,,,,,,107.0,,45354.0,,460276.58,31364647.0,,,,,,450.0,,,,1978331.0,,5732658.0,,25758767.0,,,,1570562.0,,498375.0,,,,1657.67,82.0,,2737.0,N,,,,,986557.0,,,9488.0,,,1876588.0,,104762082.0,,,1120.0,20758.0,,,,4410878.0,34380.0,,Y,30698.0,,,,296.0,14672507.0,,18083.0,117506.0,,,8497401.0,1192821.0,,,,809.0,1072670688.0,7962288.0,,,,,12125282.0,,16.7,,,21100537.0,,58.0,,3043.0,233513.0,,,26616000.0,,,29.64,,,,3561.0,,,4064030.0,363017.0,,703165.0,,,,,,,,4555447.0,965819.0,3444.0,,,9751440.0,,,361530,2816601.0,2413.0,,,52254.0,,63471.0,,,7786.0,50239.0,-7308.0,,,,207.0,,,,10195950.0,10.0,419919.0,9235872.0,521.0,25733027.0,1427879.0,494136.0,,,,,1215366.0,13.0,,,12682331.0,,N,,,230370.0,,,,,238283.0,,N,,,,,2924617.0,9131437.0,368178.0,,5373945.0,,3057019.0,2291876.0,,,,1528555.0,,,,,,13586423.0,,47148.0,,,,,,809.0,,,,,,,,,,,,,,34448354.0,,6049.0,25718261.0,591886.0,,,,7314.13,,491192608.0,,,,6287237.0,97336.0,823978.0,,,562934.0,137703.0,2894.0,,,,1811.0,,3203787.0,,,13932.0,326645.0,17799553.0,37783902.0,,,,222986.0,,445496.0,2012,Acute Care Hospitals,SOUTHWEST GENERAL HEALTH CENTER (360155)
20356,SOUTHWEST GENERAL HEALTH CENTER (360155),General Short Term (Acute Care Hospitals),Voluntary Nonprofit-Other,-81.83291,41.37208,,,,,2123579.0,257533923.0,66011.0,12789659.0,901180.0,2301383.0,,127186.0,16.0,,815703.0,1339498.0,38103795.0,822566.0,1825.0,,,19135038.0,,23236375.0,,,47280.0,177463.0,,1735377.0,838490.0,324864691.0,,9677546.0,,,,,,,,-45392.0,1755171.0,,1374.0,,,18.0,,,16794.0,,206961.0,,,,,-1410713.0,2546097.0,-828653.0,,396245.0,8244057.0,,2190293.0,1791280.0,61631988.0,,,,2991379.0,1353794.0,,121721.0,,,,,,957154.0,4424673.0,,,0.204758,,477255.0,,4761.0,,5543.0,4012520.0,3911463.0,,2190293.0,13946430.0,13664513.0,1.0,1252250.0,,,,,95484695.0,368708.0,4576304.0,,-67710.0,,,,,,,623824.0,,,,3861.0,,70593334.0,,,,10281036.0,,,2577.0,,,,,,,,1957958.0,,7272629.0,,,,,,205782.0,,,232605576.0,,542.0,,15740309.0,,5247470.0,,,,,185743.0,-913232.0,106757560.0,,,,,,,73730.0,,,15.73,,4947.0,27.51,3104.0,,,,80836.0,,,,27.29,,,,,,,,,,,,,26024.0,,9.0,,,,,13996166.0,104170.0,,,,,,,5071042.0,,810254.0,,77114.0,80463.0,122798.0,47308.0,,,,,311972.0,,,83167.0,,,,21504323.0,,,,,,,,,-1688742.0,-630350.0,,3322184.0,6414977.0,,,16980228.0,,,6307732.0,,,,,,51.0,3834771.0,,,,49832.14,5276151.0,4080467.0,4251486.0,19376.0,N,,,,5307602.0,1669.0,258099.0,311.0,72886.0,9.0,,-312.0,,,,35716863.0,,,,,,,,,,1008961.0,,2924557.0,6186929.0,,2049462.0,3202.0,,7414252.0,,,,,4098827.0,,,16025530.0,,,,23633263.0,861319012.0,,,,,,,,,,,N,,1.0,148576.0,-1410713.0,1865.62,CUYAHOGA,,,,139097.0,2375823.0,,-55563.0,121181910.0,365919,,,,81153.0,,1647655.0,,,,1430.0,,,,,,,,,,,,,,1680,,,,10737.0,,,1556237.0,,258199.0,,,,14936825.0,,469648855.0,,75109.97,,121029832.0,630233.0,644.0,40688.0,2339647.0,,,,,,,,,33880.0,-19898478.0,,13953160.0,,3474.0,,2869285.0,1755171.0,1457255.0,,,76713.0,1132489.0,629097249.0,35716863.0,,,,,5071042.0,,,,,,,,2355356.0,-6281.0,,,,,,2769033.0,,14717.0,,1445807.0,7300.0,5571.0,36T155,,,,,,43394768.0,,4980260.0,1469103.0,,81153.0,,3762726.0,,1026010.0,3098620.0,,,,,442443.0,,,,111032056.0,,,,1440.0,N,,-11883.0,,,,1903985.0,596441.0,,,,,,628698.0,1734107.0,2170.0,,8238671.0,,,350253.0,4,30.64,,1286256.0,,196519.0,28151321.0,2223.0,3880782.5,,120028.0,19.19,386.0,,,24910.0,945946.0,N,,321007882.0,,,,,,,,15778820.0,,180605253.0,1430.0,360155,,,,,,,,4896608.0,,,,,,,,,139.69,,,,12830270.0,,792719.0,529779.0,,,,3934413.0,,83167.0,,,-182348.0,,,-33819.0,,942.0,,2211.0,,,,13076.0,4354.0,,,656305.0,,,,9264939.0,58527245.0,20579.75,,,,,20375.0,743776.0,,,,,,,195236.0,,,,,,,,6504.0,,,,,,,,,478155.0,4080467.0,,,,,3029598.0,,,,,3115557.0,,,,,,,,,,,-80385.0,4459471.0,,,29904.0,48993140.0,2984797.0,250582.0,1737124.0,,,425765.0,47193932.0,,3389994.0,,66443.0,,113539301.0,,,,,4009875.0,121700725.0,,3444131.75,F,258314.0,2173759.0,,,,,,5425794.0,,,-1165837.0,-702189.0,28151321.0,3936055.0,468923.0,894.0,8195843.0,5953060.0,7401.0,1184.0,90278619.0,,,,,,19680.95,258314.0,,,16188044.0,,,,7147094.0,1084226.0,,,,,,N,,,4721140.0,253066.0,,,,,-46696.0,,,,,124539816.0,,2961.0,2526.0,4380.0,513808.0,,,6921.0,22.9,,,4739.0,22998767.0,,,,3297292.0,26086543.0,,,22687.0,,,,,,12573.0,1749032.0,,,,,,251597.0,,299137.0,,1533546.0,,,,-5024.0,,,,,2931554.0,,12.16,,1566204.0,1734107.0,722151.0,5471.0,,,,12434.0,,,9032738.0,20168654.0,1524159.0,,,,,,,1163825.0,,,,,2236.0,,,4734.75,24910.0,,,,,,412458.0,24.71,,211490095.0,,,,6492762.0,,,23633263.0,,,,304776.0,,920476.0,211497773.0,,6149356.0,19165.0,1847678.0,36170,3939224.0,2479257.0,,3484516.0,,,,230.0,,13195993.0,2349237.0,,,,1136001959.0,,36.46,,,,,,3844712.0,436402.0,18899159.0,,,,,,,,,,15359.0,,,,421788.0,,,,,,,2029185.0,,33187.0,,,,,,81915.0,,,30.0,-91754.0,,3090413.0,,,,,1496538.0,,40867.0,5000517.0,116919.0,17335249.0,,,,,1452376.0,,,,25909216.0,3089796.0,,106840.18,121150.0,238115.0,,,,215774.0,,,,20143606.0,,238.0,,,,413.0,2301383.0,,,2354343.0,,228313.0,2219753.0,1592363.0,1589660.0,,2626937.0,42763.0,27.26,,,89971065.0,,,13214371.0,,13921792.0,,,396857.0,,,15.41,-75545.0,-6994813.0,,,20835.0,,,3835.0,60610.0,,4935965.0,,,Y,529779.0,,1942792.0,12804431.0,,216598.0,971661.0,,,,,1075891.0,1556548.0,,817034.0,,,,,N,2371833.0,601833.0,,16249250.0,,,350253.0,,,13140.0,2355356.0,14717.0,,5675166.0,,,,,,,,7272629.0,-12554.0,38220.0,,,Y,,,26218.0,,,,,,74932.0,40537.2,,4990747.0,,-2788.0,12496221.0,,,104170.0,,,185407.0,,,,8371281.0,,4240946.0,,9.0,,,,,,,,281696.0,53830.0,,106267631.0,,,,546649.0,,971661.0,,106267631.0,,,2170205.0,,2398278.0,,,940213.0,,,,1082375.0,20767616.0,,,,421789.0,52617416.0,9527051.0,,,,,1044.0,,,,79071.0,,,-15662.0,,1116842.0,175.0,,1109058.0,,,28021926.0,,,,,56180.15,46987586.0,,3895531.0,8568392.0,,51829.0,,46823.0,,,,14.5,24.02,2938107.0,257533923.0,,,,,121150.0,222858.0,783331.0,1538.0,7238.0,,,,,4521.0,2280458.0,1102978.0,,515314.0,,,,192261.0,1169907.0,304035.0,,,-26599.0,,,211493.0,,,338240.0,,,16975.0,5538442.0,6456843.0,,635828084.0,,4420.17,-291896.0,,,,4761.0,27426.0,,,,129.9,22425399.0,41317.58,1294184.0,,29849.0,,45.09,,49.0,,1983996.0,,87910.0,,1290652.0,-165679.0,,33712.0,,,1791280.0,125069.0,29.0,1371125.0,,,,,16932.0,6900.0,,,4830.0,,,,5475.0,,,,,160726.0,9528324.0,,1431924.0,104170.0,,16980228.0,,8244057.0,,31088935.0,,120009359.0,,,3471949.5,1911874.0,,2543.0,4179889.0,36,,327823.0,,,,,,,,,,31430.43,73730.0,,9032738.0,,59477029.0,-51674.0,,,,6307732.0,,86870.0,,94994.0,3514307.0,,,,21279369.0,34.9,14963368.0,,,104170.0,4120.0,,23633263.0,,,,,,290434.0,102720.0,,14136.0,,,,14358024.0,,,,906742.0,,,529228.0,369560.0,108555.0,,-246868.0,,25456893.0,1563854.0,,,,2013-12-31,,44130-3497,,,6914203.0,158053.0,1371125.0,,,,3019456.0,20559296.0,5322329.0,,,,,,22687.0,,,,1111855.0,47.21,,,,27817.75,28885921.0,,559233.0,383080.0,416866.0,73822328.0,,,,10281036.0,10612534.0,,273.0,,,,,,,,N,,,,17.0,940213.0,1268674.0,,780928,-6281.0,,6750727.0,,,OH,,34667176.0,,-9872972.0,,26021200.0,,,,,2251996.0,,36.0,,4791572.0,25992.0,161739.0,3036715.0,,,,16401332.0,,519346.0,684876.0,,,,,P,,19165.0,,1613.0,,,,,,,1523.0,,,,9447.0,279446.0,,,4415028.0,,1675828.0,468.0,,,,,3652678.0,,,,,,-195295.0,,,10044874.0,1.0,,920119.0,18697 BAGLEY ROAD,,34.8,1 S ACUTE REHAB,,,,,,,,18772.0,,,,4303947.0,,,28021926.0,,232.0,,,87910.0,,-229481.0,,,,,-14278.0,,96689.0,,,,,,1640031.0,,53157.0,,2760.0,,7065360.0,,1558.0,79149709.0,334.0,,122691.0,298040.0,,,899163.0,204940.0,367253,673.0,20835.0,65062.0,N,69828.87,300780.0,459683.0,,,,,,,-445387.0,,,,10188.0,153.0,1430.0,20.0,28.04,104170.0,15201,59695236.0,N,,,,,2708703.0,,,11936111.0,84193.0,1457255.0,,,8568392.0,,,468923.0,3249702.0,13091335.0,,,,232927384.0,11637.0,3698179.0,,,,88232.0,5.0,,3861.0,6305.0,,,56288473.0,3137812.0,,,8686.0,,,,19567.0,,13264478.0,104170.0,,73568.0,,,,191910886.0,,,-26845.0,-2154207.0,8156987.0,,,,,,,,,,,,,,537094.0,,,,1735377.0,,,952.0,2046244.0,2958910.0,1281283.0,,,,14097173.0,1264.0,14992568.0,,,,,,1844613.0,,1675901.0,277432401.0,2991379.0,,100323.0,2281946.0,,,,2989553.0,,,951109.0,,549445.07,51225588.0,415818.0,1140975.0,3484516.0,4209680.0,,,,,,,,,,18133847.0,,,17410.0,38.91,,,99943.0,,,16594826.0,,,24.27,3213956.0,,,,,474782.0,,,1302874.0,,,,,-30804.0,7272629.0,6854865.0,148473.0,66564.0,,,,22052760.0,,,,27.77,,5840976.0,1957958.0,,,24910.0,,,,,,,77114.0,,,,2548209.0,2441478.0,,,1734107.0,,2423264.0,-19898478.0,,,,,,,,,,,874265.0,,,951109.0,474782.0,2013-01-01 00:00:00,,,87910.0,29791.0,,2984797.0,1827689.0,,,,10027069.0,734656.0,538798.0,,,,1550193.0,,,24895096.0,,,,,,1504367.0,,238.0,,,,,,,,,-3855261.0,,,,,89545.0,,,,,114.0,9129.0,,44441.0,,4251486.0,72145.0,,,,,,1376314.0,-2301773.0,26903976.0,1084226.0,,,205177.0,,,1077899.0,,,,,,,,,,-706343.0,,2236.0,,3026765.0,55.09,76459.0,2730643.0,,7270516.0,,,,792719.0,7156842.0,-27377.0,,-4415841.0,,3036715.0,,,3580498.0,15286492.0,680557.0,2163.0,,2441478.0,,,,,8529.0,8128194.0,18532133.0,,,5861794.0,,2339647.0,,,,,,,4372049.0,,,,284.0,,,2505216.0,,17460,,,4358634.0,,530561.0,,,,,5028288.0,,,,,General Short Term,236042941.0,5028288.0,,77909076.0,,,,,2820089.0,,,,,,5571.0,,,,,47308.0,,20152905.0,,,100323.0,,-191016.0,9528324.0,,,,,,,8959.0,,461203.0,8505.0,,16514318.0,2004526.0,5907089.0,,13664513.0,1435661.0,3768834.0,542.0,,,1719.0,12789659.0,986672.0,178560057.0,1270331.19,2074826.0,,16975.0,,,,41367.0,,,,,,13163.0,,7306183.0,,,,,7629395.0,16415378.0,4503023.0,143599.0,,,,,,1072.0,13994825.0,,,,,,,22998767.0,,1082375.0,301768714.0,,,1026010.0,71006.99,,,,3633368.0,,20869145.0,,,33656.0,7255650.0,,,,,13824970.0,,,,,,,3934413.0,,,95636773.0,,13953958.0,,,,,,,16188044.0,,159.0,181989.0,,15916157.0,1662536.0,-54804.0,,,,,,,238115.0,,3474.0,,1281283.0,20.52,,,,,1003030.0,8959.0,,2590299.0,1793844.0,,,,,3776843.0,,,,,,279446.0,13994825.0,,,258151082.0,,405241.0,,,159127.0,,MIDDLEBURG HEIGHTS,33187.0,,,,623107.0,,185407.0,-24802.0,,1657562.0,292211.0,202.0,,,,,-17685.0,,,,,71035.0,,,,,,1476626.0,,,,,,,7156842.0,,,-23957495.0,,3650.0,,,,-627.0,,55873.0,,,,11639.0,,79745.0,SWGHC MENTAL HEALTH SERVICES,,26323.0,,65062.0,26218.0,,,,,,16415378.0,,2672426.0,,4685113.0,1551224.0,3834771.0,,7229484.0,3163.0,,906742.0,,,,,,,,23791384.0,241176.0,132702.0,117445.0,,,15.0,,,2218463.0,,7065360.0,,,945014.0,,,1901868.0,,,,,,,28.67,,,,,,,3592133.0,,25823.0,,,1879183.0,,,72739.0,,18204505.0,,222093.0,,,,3389994.0,104170.0,,,,,65062.0,,2991379.0,,4619393.0,,,,,,,,,10769.66,,,,,394743.0,,,,776828.0,,,12893738.0,69669834.0,,1223517.0,817034.0,,,,,,,35716863.0,,17440238.0,1868504.0,,4639733.0,3322184.0,,580875.5,,20614556.0,175.0,60.0,92773.0,,,,4610.0,,228.0,,,,9693939.0,,106899.0,20835.0,,,,,,,356.0,,,,,,,,,,,,1302561.0,,,,,148576.0,228713.0,,,,,,,,,,230.0,,,,19359318.0,191910886.0,,,,,,863701.0,9129.0,,3195957.0,,,,,110576.0,,,,12954153.0,,D,1294184.0,5675166.0,,66240196.0,249530.0,,,,,3633368.0,70658.0,,,3232547.0,SOUTHWEST GENERAL HEALTH CENTER,1784404.0,,556818.0,85928.0,,,,,,5840.0,7629395.0,8195843.0,17191627.0,,,,,-903051.0,,,,6305.0,,,1457255.0,120009359.0,19958231.0,,,13684307.0,Y,,,,,,508461771.0,4378812.0,2371833.0,2946.0,,38551.0,2029185.0,,,13697219.0,,,,282970843.0,,,,134.0,62016.0,,,,1221795.0,,,1082184.0,23543.0,32096.0,,,,,19241.0,,-56925.0,,,44424899.0,1879183.0,,23633263.0,30270617.0,,,,,33.66,,1582678.0,,,,,,114.0,,,,,,1248.0,,,,,,,,20810413.0,,3015229.0,,148576.0,,,1504367.0,56480.0,,108304066.0,,,,,102885.0,1911874.0,,2223.0,,,13996166.0,,7320.0,3285.0,1957958.0,20168654.0,4009875.0,42.0,14136.0,,4917.0,,,476334.0,171164770.0,14057682.0,,,216598.0,1149.0,14046.0,,,,8501701.0,,13118003.0,,,13.74,,,,,,2024-08-14 00:00:00,,,,,,,,,,,26120530.0,,,,,,792719.0,,,,,,10696048.0,590487.0,,4025007.25,5299920.0,,6492762.0,148715.87,,,126142.0,2533754.0,,,,,,,,8238671.0,,,,,,,,,,,,72063.0,,,,,1125.0,,,,,,4459471.0,,2211.0,8084770.0,1784404.0,,,,,,109733946.0,,920476.0,,14990652.0,,2161.0,277328.0,,3.0,,,,1752628.0,,,36S155,,,,,,,38554.0,,4603972.0,,,20142176.0,,,,,,,27426.0,,41410.0,,479243.41,34639644.0,,,,,,,,,,2103527.0,,5630542.0,,25909216.0,,,,1521813.0,,623824.0,,,,1701.88,63.0,,3878.0,N,,,,,1059419.0,2788026.0,,20926.0,,,2301383.0,,109244017.0,,,1089.0,24107.0,,,,4083290.0,28003.0,,Y,28283.0,,,,271.0,16595058.0,,15977.0,193726.0,,,8502056.0,1547238.0,-4472.0,,,1112.0,1144289855.0,6837172.0,,,,,10696048.0,,14.51,,,18899159.0,,68.73,,9013.0,225191.0,,,23924673.0,,,28.55,,,,2843.0,,,3612210.0,425765.0,,596441.0,,,,,,,,4315649.0,967075.0,6383.0,,,4303947.0,,,361530,3070545.0,2163.0,,,62462.0,,52424.0,,,207.0,4266.0,-8898.0,,,,202.0,3.0,,,34554121.0,10.0,106245.0,9880642.0,506.0,20152905.0,1353963.0,626973.0,,,,,1146049.0,12.0,,,12852580.0,,N,,23.0,385315.0,,,,,189479.0,,N,39153.0,,,72145.0,3249702.0,8371281.0,412458.0,,4685113.0,,3052454.0,1847678.0,,,,1407199.0,,,,,,13759322.0,,5680.0,,,,,,1112.0,,,,,,,,,,,,,,35716863.0,,4373.0,28236892.0,826297.0,,1569062.0,,7232.25,,506904710.0,,,,1749032.0,123666.0,811540.0,,,734656.0,112353.0,2946.0,,,,,,3019157.0,,,7068.0,251597.0,17435279.0,22052760.0,,,,214704.0,,408299.0,2013,Acute Care Hospitals,SOUTHWEST GENERAL HEALTH CENTER (360155)
24389,SOUTHWEST GENERAL HEALTH CENTER (360155),General Short Term (Acute Care Hospitals),Voluntary Nonprofit-Other,-81.83291,41.37208,,7119.0,,,1747440.0,278332308.0,67750.0,19843542.0,836976.0,2445682.0,,130575.0,5.0,,393992.0,1433854.0,38754946.0,1195531.0,1700.0,,,22010323.0,1768.0,16040310.0,,,47848.0,194253.0,,1869992.0,610961.0,321891018.0,,10643051.0,,,,,,,,-64654.0,1946997.0,,2218.0,,,10.0,,,13050.0,,418545.0,,,,,1267812.0,911334.0,-850038.0,,608905.0,7310577.0,,2197795.0,1605871.0,63470485.0,,,7.0,2730816.0,576377.0,,118035.0,,,,,,976954.0,4639675.0,,,0.210896,,552339.0,,1685.0,,18380.0,4702574.0,2547539.0,,2197795.0,14097850.0,14471258.0,1.0,1524367.0,,,,,94165197.0,368707.0,5138409.0,,-58617.0,99.0,,,,,,560810.0,,20931.0,,3679.0,748527.0,73253567.0,,,,10581226.0,,,12461.0,,,,,,,,2078098.0,,7549102.0,,,,,,295105.0,,557395.0,251567952.0,,433.0,,16908633.0,,5690215.0,,,-13721.0,,210617.0,-945275.0,106081396.0,,,,,,928.0,73365.0,,,13.38,,,27.61,4922.0,,,,77214.0,,,,27.24,,,,,,3.0,53081.0,,,,,,33374.0,,9.0,,,,,13852427.0,105642.0,,,,326071.0,,,4527548.0,,1052376.0,,5277.0,92749.0,82591.0,48006.0,,,,,275555.0,5069.0,,83531.0,,,,15792809.0,,,,,,,,,-912632.0,-4402718.0,,8993471.0,7051378.0,,,17043908.0,,,6265975.0,81.0,,,,,38.0,4046734.0,,,,52530.57,5470079.0,4030965.0,4499137.0,3875.0,N,,,,4403386.0,1561.0,229025.0,311.0,89305.0,9.0,,-155.0,,,,38436950.0,,,,,,,10.0,,,923818.0,,2808596.0,5747807.0,1047983.0,101626539.0,3204.0,,6975848.0,,,,,4501184.0,,,23768598.0,,,,25758159.0,905769335.0,,,,,,,,,,1259468.0,N,,,,1267812.0,1856.5,CUYAHOGA,,,,145352.0,2605411.0,,-138807.0,122148265.0,365919,,,,82173.0,,1917207.0,,,,10829.0,,,,,,869767.0,,,,,,,,1680,155.0,,,19444.0,,,1415572.0,,208492.0,,,,13824970.0,,471036683.0,440228.0,80519.88,,122299479.0,764000.0,2038.0,40293.0,2323861.0,267.0,,,,,,,,35110.0,-12886429.0,,16039923.0,,3437.0,,3261645.0,1946997.0,1299029.0,,,64658.0,1141361.0,665596507.0,38436950.0,,,,,4527548.0,,1047983.0,,,,,,2429830.0,-1920.0,,,,,,3582177.0,,16093.0,,1528276.0,11680.0,5435.0,36T155,,,,,,44109407.0,,5279148.0,1669728.0,,82173.0,,6596151.0,,89610.0,3513255.0,,,,,367793.0,,,,111189781.0,,,,5000.0,N,,-6339.0,,30.0,,1666616.0,679807.0,,,,,,598896.0,1879942.0,3089.0,,8488318.0,,,407413.0,2,30.37,,1392700.0,,168424.0,28236937.0,344.0,3842447.91,,286148.0,18.19,,,,31942.0,1007035.0,N,,317937841.0,,,,,,,,15904628.0,,274332001.0,4612.0,360155,207.0,,,,,,,4858645.0,,,,,,,,,122.05,,,,12590407.0,,722854.0,493018.0,,,,4001783.0,,83445.0,,,-50552.0,,,-33820.0,10.0,589.0,,680.0,,,,12911.0,6294.0,,,707465.0,,,,9942671.0,59820883.0,15887.51,,,,,32999.0,828238.0,,,,,,,10027.0,10189.0,,,,,23193.0,,21508.0,,,,,,,,,654114.0,4030965.0,,,,,870436.0,,,,,4185332.0,,,,,,,,,,,-99780.0,4849368.0,,,21415.0,48458957.0,3036966.0,380955.0,1388076.0,,,335443.0,48116754.0,,3467955.0,,82798.0,,106704127.0,,178.0,,,4729422.0,143496426.0,,3412332.17,F,390255.0,2295515.0,,,,,,1770640.0,711.0,,-79666.0,-568589.0,28236937.0,3821489.0,586527.0,934.0,7474104.0,8960884.0,10333.0,145.0,17125657.0,,,,,,19813.45,390255.0,,,11570378.0,,,,7147094.0,1053742.0,,,,,748527.0,N,,,4819562.0,720483.0,,,,,-48436.0,,,,,146335517.0,,,-1275.0,4380.0,457341.0,,,,23.33,,,2616.0,26565375.0,,,,3296460.0,29636818.0,,,31598.0,,,,,,12014.0,1344958.0,,,,,,390435.0,,455092.0,,1542000.0,,,,-10435.0,,,,,3990409.0,,11.72,,1471298.0,1879942.0,772537.0,1139.0,,,,11719.0,,,9622629.0,19680487.0,1465797.0,,,,,,,1125592.0,5739.0,,,,2315.0,,,4648.0,31942.0,,,,,,462484.0,27.4,,188305476.0,,,,2266780.0,,,25758159.0,,,,432621.0,,762603.0,190339309.0,,6937241.0,14469.0,1992196.0,36170,,2522295.0,,4196763.0,,,,442.0,,13627205.0,2201299.0,,,,1192854855.0,,37.86,,,,,,4386676.0,1126364.0,21862884.0,,,,,,,,,,16023.0,,,,421788.0,,,,,,,2175869.0,,31291.0,,,,,-72123.0,33734.0,,,43.0,-98625.0,,4230878.0,98.0,,,,1258621.0,,14083.0,8890152.0,147388.0,17403914.0,,,,,2075590.0,,,,26930570.0,3431328.0,,104744.08,154457.0,254411.0,,,,,,,,22605987.0,,238.0,,,,357.0,2445682.0,,,2421746.0,,241892.0,2100428.0,1623969.0,1454677.0,,1671141.0,59804.0,27.07,,,191683532.0,,,126526770.0,,16009447.0,,,448117.0,,,14.85,-10747.0,-7588820.0,,,20412.0,,,3641.0,60816.0,,6427257.0,,,Y,493018.0,,1929734.0,12565843.0,,213294.0,1074533.0,10.0,,,,1071974.0,568186.0,86334.0,1414670.0,,,,,N,14642383.0,541310.0,,18646200.0,,,407413.0,,,13140.0,2429830.0,16093.0,,6465474.0,,,,,,,31.0,7549102.0,-5000.0,35800.0,,,Y,,,3569.0,,3.0,,4207.0,,99163.0,38076.48,,4478093.0,,-6548.0,2931029.0,,,107065.0,,,262106.0,,,,12850913.0,1.0,2764179.0,,51.0,,,,,,,8983.0,191956.0,103580.0,1417.0,105862726.0,,,,625948.0,,1074533.0,,105862726.0,,,2288361.0,,2558641.0,,,1301590.0,,,,1208940.0,23680414.0,,3903.0,,368708.0,60566457.0,9435429.0,,,,,1570.0,,,,71999.0,,,-17772.0,,2139723.0,65.0,,1268186.0,1709328.0,,27814813.0,,,,,59704.96,49668025.0,,3965441.0,8568392.0,2.0,53872.0,,3136.0,,905.0,,14.42,24.12,2937893.0,278332308.0,,,,,154457.0,244371.0,779145.0,1945.0,9096.0,,,,,5866.0,2548441.0,4222530.0,,498857.0,,,,1161302.0,1056577.0,260461.0,,,-1905.0,,,228886.0,-5506.0,,934504.0,,,8895.0,5981439.0,6273771.0,,674159110.0,,4159.92,-202493.0,,,,1685.0,4334.0,,,,143.09,24327840.0,39748.89,1401857.0,,27178.0,,36.69,995.0,51.27,,2147785.0,,89215.0,,1191547.0,-184617.0,,20783.0,,,1605871.0,194070.0,43.0,1211100.0,,,,,22262.0,1581.0,,,7844.0,,6567.0,,5475.0,,,,,126620.0,10655382.0,3393805.0,242595.0,55089.0,,17043908.0,,7310577.0,,32461322.0,,140671563.0,,,3437315.68,2376123.0,4899.0,13480.0,1201927.0,36,,,,,,,,,,,,30551.5,73365.0,,9622629.0,,64137350.0,-52261.0,422833.0,,,6265975.0,,86870.0,,23042.0,961250.0,,,,20553029.0,35.54,3367654.0,,,105642.0,,,25758159.0,,,,,,205551.0,134156.0,,14236.0,,,,14563758.0,,,,835054.0,,,130892.0,610898.0,,,-201476.0,,12759450.0,1149067.0,138.0,,,2014-12-31,,44130-3497,,,7543794.0,410901.0,1211100.0,,,,7180871.0,5945571.0,5861271.0,,,,,,31598.0,,,,235352.0,67.63,,,,24983.51,33368870.0,,515065.0,477557.0,424020.0,81397523.0,,,,10581226.0,11258911.0,,246.0,,,,,,,33657.0,N,,,,10.0,1301590.0,1342121.0,,617558,-1920.0,,10091102.0,Y,,OH,,34768751.0,,-3648650.0,6019.0,24807620.0,,,,,1840849.0,,36.0,,5429052.0,25018.0,149036.0,2561478.0,,8656177.0,,18860327.0,,179861.0,677451.0,,,,,P,,14469.0,,1669.0,,,,,,,4527.0,,,,6165.0,299706.0,,,4873420.0,,1065157.0,608.0,,,,,3589565.0,,,,,,-11961.0,,120.0,9660026.0,1.0,,837706.0,18697 BAGLEY ROAD,,35.79,ACUTE REHAB,,,,,,,,4086.0,,,,3172316.0,,,27814813.0,,3281.0,,,89215.0,,-229555.0,,,,,-13196.0,,105195.0,,,,,,1590278.0,3.0,98010.0,,2759.0,,6454383.0,,1401.0,80137263.0,43.0,,84383.0,293424.0,,,1126015.0,338777.0,367253,451.0,20412.0,63953.0,N,72974.25,378805.0,570391.0,,,,,,,-235243.0,,,,1018.0,126.0,10829.0,32.0,28.48,105642.0,15201,69004205.0,N,28054.0,20366.0,,,2943270.0,,,4570526.0,69522.0,1299029.0,,,8553892.0,,2.0,586527.0,3646652.0,13835447.0,,,,251958724.0,8598.0,4059263.0,172383.0,,,121012.0,5.0,,3679.0,8810.0,,,65726779.0,2707693.0,,,7776.0,,,,,,13901910.0,105642.0,,5434251.0,,,,221946146.0,,,-23645.0,-2812562.0,8502540.0,,22.0,,,,86.0,,,,,196.0,,,491022.0,,,,1869992.0,,,924.0,3155419.0,2963560.0,1496840.0,,,,14464181.0,1941.0,16102617.0,,,,,,1774289.0,,1839557.0,291218737.0,2730816.0,,117908.0,2239500.0,,,,2690198.0,,,605984.0,,565062.68,56294410.0,401722.0,898753.0,4196763.0,1253897.0,,,,8.0,,,,,,13244312.0,,,48617.0,42.32,14500.0,,97520.0,,,19047772.0,,,24.28,3175345.0,,,,,1116494.0,,,968845.0,,,,,-1275.0,7549102.0,6006570.0,213946.0,119549.0,,,,21168221.0,,,,27.55,,5944438.0,2078098.0,,,31942.0,,,,,,,5277.0,,,,911334.0,2477810.0,,,1879942.0,,2684928.0,-12886429.0,,,,,,,,,,,3862620.0,,,605984.0,1188617.0,2014-01-01 00:00:00,,,89215.0,51970.0,,3036966.0,1397078.0,,,,9723217.0,759053.0,474712.0,,,,605534.0,,,27442021.0,,,,,,913355.0,,2743.0,,,,27344.0,,,28191.0,9446.0,,,,,,86135.0,,,,,64.0,5990.0,,44116.0,,4499137.0,1629610.0,,,54.0,,,1373389.0,4805943.0,32647030.0,1053742.0,,,204910.0,,263.0,1110655.0,,,,,,,,,,-776963.0,,2315.0,,3181594.0,53.18,66312.0,2852636.0,,7543596.0,,,,722854.0,2647376.0,-400997.0,,-4517541.0,,2561478.0,,,9383726.0,15075851.0,624875.0,1435.0,,2477810.0,,,,,6214.0,22338753.0,21246151.0,,,6095129.0,2.0,2323861.0,,,,,,,4466325.0,,,,5419.0,,,1553106.0,,17460,,,4814359.0,,581625.0,,,,,5848643.0,,,,,General Short Term,256144056.0,5848643.0,,73922018.0,,,,,3014215.0,,,,,,5435.0,,,,,48006.0,6.0,20458388.0,,,117908.0,,-7196.0,10655382.0,,,,,,,8608.0,,424202.0,11283.0,,16056549.0,2268936.0,5944438.0,,14471258.0,1461086.0,3629631.0,355.0,,,431.0,19843542.0,997789.0,180605253.0,1276394.72,2051144.0,,16403.0,,,,26179.0,,-2425.0,,,,14677.0,,6882557.0,,,,,7399337.0,18875254.0,6342655.0,152043.0,,,,,,,12056468.0,,,,,,,26565375.0,,1208940.0,205431133.0,,,89610.0,61697.12,,,,4113918.0,,23727623.0,339224.0,,87.0,7147095.0,,,,,13582734.0,,,,,,,4001783.0,,,94013983.0,,12042385.0,,,,,,,11570378.0,,111.0,163419.0,,18280313.0,2005544.0,-69659.0,,,3318.0,,,,254411.0,,3437.0,,1496840.0,21.05,,,,,991393.0,8608.0,,3125892.0,1795898.0,,,,,4026136.0,,,,,,299706.0,12056468.0,,,280697374.0,,408356.0,,,161692.0,,MIDDLEBURG HEIGHTS,31291.0,,,,595744.0,,261178.0,-21683.0,,1680215.0,244814.0,201.0,,,,,-24216.0,,,,,114793.0,,,,,,1372749.0,,,,,459840.0,,2647376.0,,,-27869540.0,,3650.0,,,,-1005.0,,138352.0,,,,20899.0,,75816.0,SWGHC MENTAL HEALTH SERVICES,,40018.0,,63953.0,3569.0,,,,,,18875254.0,,3600525.0,,5027611.0,2108497.0,4046734.0,1025.0,10208898.0,72158.0,,835054.0,,,,,,,,27420439.0,72583.0,214598.0,,,,15.0,,,2120760.0,,6454383.0,,,1181288.0,,2364.0,2177282.0,,170744.0,,,1379.0,,27.4,,,,,,,4109163.0,,13346.0,,,1978223.0,,,112523.0,,13310365.0,,240671.0,,2.0,,3467955.0,107065.0,,,,,63953.0,,2730816.0,-200.0,7180871.0,2.0,,,,,,,,7483.62,,,,,242466.0,,,,642804.0,,,9832187.0,89299098.0,,1453720.0,1414670.0,,,195559.0,,,,38244642.0,,18575368.0,1751940.0,,4194011.0,8993471.0,,595614.18,,20852942.0,78.0,200.0,122067.0,,20366.0,5435.0,7916.0,,697.0,,,,9909725.0,,99243.0,20412.0,,,,,,,385.0,,,,,,,,,,,,342359.0,,,459840.0,,158791.0,359910.0,,207.0,,,,,,,,442.0,,,,25288354.0,221946146.0,,,,,,728514.0,42381.0,,3204425.0,,,,,71509.0,,,,16271143.0,,F,1401857.0,6465474.0,,58751228.0,256196.0,,,1714834.0,,4113918.0,66053.0,,,3476699.0,SOUTHWEST GENERAL HEALTH CENTER,1778542.0,1.0,22331.0,111093.0,,,,1.0,,1825.0,7399337.0,7474104.0,16414344.0,,,,,-962046.0,,,,8810.0,,,1299029.0,140671563.0,20021951.0,,,14492230.0,Y,,,1209.0,,,528810401.0,4272830.0,14642383.0,3926.0,557395.0,35712.83,2175869.0,,,13119455.0,,510.0,,297200176.0,,,,272.0,349.0,,,,1686788.0,,,1095064.0,16302.0,33801.0,,,,,24526.0,,-58241.0,,,44534577.0,1978223.0,,25758159.0,18892546.0,,,,,33.52,,4619393.0,,,,,,69.0,,,,,,3573.0,,,,,,,,23717422.0,,914784.0,,158791.0,,,913355.0,98628.0,,125682111.0,,,,,1692633.0,2376123.0,,344.0,,,13852427.0,905099.0,15996.0,3285.0,2078098.0,19680487.0,4729422.0,60.0,14236.0,,690.0,,,489114.0,185356011.0,13822723.0,,,213294.0,2159.0,14927.0,1354.0,,,8410368.0,,126517510.0,,,13.76,,,,,,2018-01-31 00:00:00,,,,,208239.0,,,,,,28125137.0,,,,,,722854.0,,,,,,11385920.0,349549.0,,4007946.35,5367494.0,,2266780.0,173668.35,,,125701.0,4804635.0,,,,,,,,8488318.0,,,23193.0,,,,,,,,,114418.0,,,,,1177.0,,,,,,4849368.0,,680.0,7226003.0,1778542.0,,,,,,108478164.0,,762603.0,,14969823.0,,1637.0,147573.0,,3.0,,,,2766225.0,,,36S155,,,740726.0,,,,34504.0,,4414084.0,,,22595158.0,,,,,,,4334.0,,55437.0,,465363.71,38359669.0,,,,,,,,,,2021083.0,,5718671.0,,26930570.0,,,,1388967.0,,560810.0,,,,1692.09,74.0,,4457.0,N,145986.0,,,,1227000.0,,,29004.0,,,2445682.0,,108259494.0,,,1120.0,27932.0,,,,5844632.0,56768.0,,Y,32131.0,,,,313.0,19051053.0,739194.0,17444.0,190726.0,,,8410723.0,1895389.0,-6630.0,,,1624.0,1202969511.0,9333657.0,,,,10.0,11385920.0,,14.42,,,21862884.0,,95.11,,3523.0,262341.0,,,27552053.0,,,31.14,,,,-65814.0,,,2444246.0,335443.0,,679807.0,,,,28054.0,,,,4656830.0,1031131.0,6377.0,,,3172316.0,3.0,,361530,3256344.0,1435.0,,,62550.0,,91133.0,,,198.0,7899791.0,-3833.0,,,,201.0,,,,18002039.0,10.0,108125.0,9465089.0,500.0,20458388.0,884588.0,507201.0,,,,,1062476.0,12.0,,,13259243.0,,N,,,487588.0,10128.0,,,8664.0,202023.0,,N,406099.0,,,1629610.0,3646652.0,12850913.0,462484.0,,5027611.0,,3388392.0,1992196.0,,,,886831.0,,,,,145986.0,14094297.0,,4256.0,,,,,,1624.0,,,,,,,,,,,,,,38436950.0,,1076.0,24930462.0,755418.0,,1593226.0,,7612.06,,527258348.0,,,,1344958.0,126849.0,760486.0,,,759053.0,27653.0,3926.0,,,,,,3052292.0,1324.0,,12294.0,390435.0,16218237.0,22037988.0,4.0,,,234173.0,,324146.0,2014,Acute Care Hospitals,SOUTHWEST GENERAL HEALTH CENTER (360155)
33260,SOUTHWEST GENERAL HEALTH CENTER (360155),General Short Term (Acute Care Hospitals),Voluntary Nonprofit-Other,-81.83291,41.37208,,5005.0,,,1442047.0,277067996.0,67631.0,15422448.0,12358.0,2898381.0,,140450.0,,,537462.0,1366717.0,35550806.0,1763677.0,1576.0,,,22137891.0,2459.0,6637552.0,,,212607.0,168993.0,,1816505.0,560025.0,436847410.0,,9522431.0,,,,,,,,-38282.0,1981988.0,,180.0,,,15.0,,,10438.0,,723871.0,,,,,2764757.0,923140.0,-870194.0,,615298.0,7581817.0,,2618683.0,1555852.0,61027770.0,,,43.0,2721524.0,568327.0,203794.0,100238.0,,,,,,1014470.0,4900104.0,,,0.215744,,567635.0,,,,13342.0,5221942.0,261830.0,,2618683.0,13880563.0,12592986.0,1.0,1580657.0,,,,,96612948.0,368707.0,3833404.0,,-115520.0,540.0,,,,,,546371.0,,702.0,3.0,3617.0,782604.0,68795125.0,,,,9800916.0,,,,,,,,,,,2205761.0,145.0,8520143.0,,,,,,289847.0,,480614.0,255783527.0,,99.0,,18387289.0,,6987895.0,,,-33252.0,,217278.0,-950322.0,106453078.0,,,,,,947.0,68985.0,,,13.92,,,28.12,4718.0,,,,82964.0,,,,28.35,,,,,,16.0,,,,,,,44195.0,,19.0,,,,,13812594.0,106296.0,,,,312018.0,,,4009263.0,,1245930.0,,4341.0,5409.0,72317.0,41953.0,,,,,283177.0,8813.0,,63182.0,,,,15765922.0,,,,,,,,,-1214038.0,-5013372.0,,11631834.0,7142920.0,,,17677295.0,,,5869842.0,51.0,,,,,,3996065.0,,,,48506.26,5517949.0,3814282.0,4389726.0,7383.0,N,,,,3751821.0,1437.0,22172.0,309.0,87088.0,9.0,,-100.0,,,,39506056.0,,,,,,,,,,989523.0,,3049703.0,4265593.0,867756.0,9143098.0,219.0,,7095720.0,,,,,4217011.0,,,28836385.0,,,,25166777.0,886959387.0,,,,,,,,,,1026380.0,N,,4.0,203921.0,2764757.0,1818.45,CUYAHOGA,,,,11994.0,2757934.0,,-103465.0,124186045.0,365919,,,,73860.0,,1883352.0,6.0,,,16620.0,,24.0,2453.0,,,3465554.0,,,,,,,,1680,204.0,,,24681.0,,,1376727.0,,11619.0,,,,13589618.0,,473162344.0,342377.0,85104.72,,123857854.0,739298.0,229.0,40590.0,2495007.0,1615.0,,,,,,,553.0,31267.0,-20350465.0,,16455458.0,,3508.0,,2869604.0,1981988.0,1453149.0,,736.0,61682.0,1184031.0,701034206.0,39506056.0,,,,,4009263.0,,867756.0,,,,,,200761.0,-523.0,,,,,,4208084.0,106.0,17739.0,,1443810.0,14275.0,4891.0,36T155,,,,,,40497690.0,,4974720.0,1844218.0,,73860.0,,7320182.0,,80609.0,4039298.0,,,,,362543.0,,,,119220672.0,2.0,,,4947.0,N,,-11541.0,1262.0,293.0,,1915988.0,547948.0,,,,,,447793.0,1595377.0,3394.0,,8443132.0,,,414046.0,4,34.06,,1459643.0,,175951.0,24947388.0,,3785577.35,,398842.0,18.41,,,,42695.0,999781.0,N,,432884973.0,,,,,,,,16099015.0,,281824775.0,,360155,157.0,,,,,,,4361950.0,,,,,,,,,84.71,,,,11376920.0,,806880.0,42790.0,,,,4304395.0,,62932.0,,,-43798.0,,,-41820.0,18.0,705.0,,,,,,13565.0,10316.0,,,758232.0,2.0,,,14573072.0,61521315.0,21025.66,,,,,33307.0,724399.0,,,,,,,7441.0,8078.0,,1190988.0,,,22600.0,,3015.0,,,,,,,,,743800.0,3814282.0,,,,,,,,,,4435551.0,,6485307.0,,,,3031704.0,,,,,-126675.0,5778709.0,,,17457.0,39318765.0,2529944.0,415822.0,1392333.0,,,362224.0,44062689.0,,4037146.0,,73441.0,,125675226.0,,262.0,,,4784546.0,156935851.0,,3428994.95,F,543395.0,2372897.0,,,,,,,512.0,,-253918.0,-454729.0,24947388.0,3826967.0,1102043.0,1005.0,4690760.0,11008563.0,869.0,,21622665.0,,,,,,21634.25,543395.0,,,9725295.0,,,,7147094.0,1146797.0,,,,,782604.0,N,,,5133698.0,991861.0,,,,,-43203.0,,,,,159774942.0,,,-51540.0,372.0,42864.0,,,,24.41,,,1185.0,26685680.0,,,,4618274.0,27542918.0,,,42589.0,6308.0,,,,,11488.0,1520444.0,,,,,,284659.0,157103.0,349180.0,,1547550.0,,,,-12788.0,,,,,5282515.0,,11.2,,1491797.0,1595377.0,786611.0,2228.0,,,,1173.0,,,10726690.0,14926005.0,1671650.0,,,,,,,1217756.0,29795.0,,,,2228.0,,,3131.25,42695.0,,,,,,377238.0,25.96,,180854418.0,,,,,,,25166777.0,,,,476930.0,,41752.0,185483153.0,,7254272.0,8425.0,1884374.0,36170,,2597650.0,,4282113.0,,,,349.0,,13436985.0,181475.0,,,,1185590210.0,,39.65,,,,,,4529936.0,1102180.0,17757602.0,,,,,,,,,,1459.0,,,,368707.0,,,,,,,1969523.0,,26364.0,20.0,,,,,21991.0,,,39.0,-96807.0,,4055810.0,7899.0,,,,1042291.0,,17417.0,10568489.0,179923.0,13442166.0,,,,,2846545.0,,,,23222533.0,3603267.0,,108176.9,203349.0,999204.0,,572.0,,,,,,27088377.0,,236.0,,,,351.0,2898381.0,,,199852.0,,245917.0,2108924.0,1524323.0,1416817.0,,1709131.0,41678.0,27.77,,,188081246.0,,,19942727.0,,16423463.0,,,362669.0,,,2.86,-43546.0,-8489758.0,,,17075.0,,,3830.0,54510.0,,7586929.0,,,Y,42790.0,,1999865.0,11376920.0,,221662.0,1097857.0,3.0,,,,1057499.0,602754.0,97712.0,1328025.0,,,,,N,15900332.0,831251.0,,20316809.0,,,414046.0,,1.0,13140.0,200761.0,17739.0,,7846136.0,,,,,,,39.0,8520143.0,,3807.0,,,Y,,,2198.0,,1.0,,11930.0,,92183.0,37190.5,,4488916.0,,-580.0,2988089.0,,,107551.0,,,256540.0,,,,16177151.0,2.0,2582774.0,,18.0,,,,,,,8493.0,202736.0,133260.0,1920.0,105736528.0,,,,756626.0,,1097857.0,,105736528.0,,,2362474.0,,2966950.0,,,980272.0,,,,1206082.0,25634806.0,,9135.0,92.0,368708.0,63044511.0,7199295.0,,,,,1128.0,,,,74825.0,,,-11944.0,,2374398.0,,,1261335.0,1637609.0,,33364662.0,,,,,59786.88,47985732.0,,4288989.0,8553892.0,5.0,47259.0,,2573.0,1.0,1094.0,,15.0,24.87,2445907.0,277067996.0,,,,,203349.0,219120.0,779862.0,1492.0,7212.0,,,,,5306.0,2627543.0,5337269.0,,519978.0,,,,1218458.0,78969.0,279875.0,,,-5853.0,,,233540.0,-547.0,,1530816.0,,,,6525447.0,6169313.0,,704858866.0,,4159.92,-201645.0,,,,,572.0,,,,135.92,24493673.0,43833.61,1470865.0,,39861.0,,53.98,1000.0,53.29,,2374741.0,,79597.0,,1612253.0,-185602.0,,30584.0,,,1555852.0,29585.0,,1317307.0,,,,,23122.0,866.0,,,5836.0,,11981.0,,5475.0,,,,,192963.0,9678008.0,2985537.0,204525.0,,,17677295.0,,7581817.0,,28905598.0,,154761077.0,,,3457232.61,2078129.0,4098.0,21502.0,555576.0,36,,,,,,,,,,,,5938.2,68985.0,,10726690.0,,69610157.0,-2016.0,422038.0,,,5869842.0,,83260.0,,58455.0,,,,,18366463.0,35.92,7351540.0,,,106296.0,,-15.0,25166777.0,4.0,,,,,189976.0,260019.0,,13571.0,,,,14273846.0,,,,11750.0,,,161135.0,805577.0,,,-197995.0,,22761183.0,1264791.0,2207.0,,,2015-12-31,,44130-3497,,,6863734.0,623152.0,1317307.0,,,,8674248.0,2599793.0,6045885.0,,,,,,42589.0,,,,723432.0,52.22,,,,28237.66,25928985.0,,541696.0,442358.0,391873.0,88095643.0,,,,9800916.0,10977947.0,,240.0,,,,,,,77360.0,N,,,9.0,11.0,980272.0,1251245.0,,763767,-523.0,,10698523.0,Y,,OH,,36091323.0,,-10068106.0,2280.0,25879433.0,,,,,1488993.0,,36.0,,5678956.0,21258.0,52653.0,1493377.0,,9078068.0,,20578887.0,,,661535.0,,,,,P,,8425.0,,2145.0,,,,,,,4235.0,,,,9241.0,314197.0,,,5127257.0,,1105320.0,755.0,,,,,3656730.0,,,,,,-35380.0,,135.0,10484921.0,1.0,,79674.0,18697 BAGLEY ROAD,,32.89,ACUTE REHAB,,,,,,,,3077.0,,,,2978975.0,23250.0,,33364662.0,,47.0,,,79597.0,,-228319.0,,,,,-3388.0,,115121.0,,,,,,1563736.0,6.0,86738.0,,2947.0,,5483718.0,,129.0,87753997.0,,,96349.0,326533.0,,,1134664.0,520845.0,367253,392.0,17075.0,43490.0,N,74187.97,288021.0,535131.0,,,,,,,-117991.0,,,,664.0,126.0,16620.0,47.0,29.73,106296.0,15201,81640961.0,N,551.0,10258.0,,,3243237.0,,,,56356.0,1453149.0,,,8580364.0,,4.0,1102043.0,3905638.0,14390246.0,,,,256100360.0,4994.0,3757095.0,140290.0,,,121194.0,5.0,,3617.0,10329.0,,,65544988.0,2468043.0,,,10382.0,,,,88.0,,13962909.0,106296.0,,5949924.0,,,,234882029.0,,,-29960.0,-3288342.0,8461646.0,,1864.0,,,,250.0,,,,,8.0,,,517379.0,,,,1816505.0,,,919.0,4881452.0,2461606.0,1614758.0,,,,13449343.0,2016.0,17468139.0,,,,,1121.0,1793022.0,,1688325.0,297418461.0,2721524.0,,104708.0,1914762.0,,,,2666542.0,,,603811.0,,540309.42,54406960.0,427716.0,870245.0,4282113.0,560890.0,,,,11.0,,,,,,1620100.0,,,19215.0,46.23,,,96063.0,,,20791086.0,,,24.62,3363682.0,,,,,1447975.0,,,1127068.0,,,,,-51540.0,8520143.0,6256550.0,154965.0,99097.0,,,,13072551.0,,,,28.27,,7211433.0,2205761.0,,,42695.0,,,,,,,4341.0,,,,923140.0,2377150.0,,,1595377.0,,2971888.0,-20350465.0,,,,,3031704.0,,,,,,4816502.0,,,603811.0,1447975.0,2015-01-01 00:00:00,,,79597.0,5314.0,,2529944.0,2007594.0,,,,8127502.0,762629.0,89068.0,,,,1945645.0,,,29433378.0,,,,,,2367532.0,,5311.0,,,,34635.0,,,85991.0,296.0,,,,,,75184.0,,,,,,12653.0,,38815.0,,4389726.0,1712497.0,,,55.0,,-157103.0,1432338.0,-325660.0,29695476.0,1146797.0,,,215216.0,,399.0,1135358.0,,,,,,,-748.0,,,-873798.0,,2228.0,,3015343.0,53.01,2570.0,2821910.0,,8520143.0,,,,806880.0,8295896.0,-549703.0,,-4506979.0,,1493377.0,,,12175229.0,16247269.0,528811.0,1469.0,,2377150.0,,,,2552.0,5008.0,9279779.0,23072166.0,,,5150739.0,1.0,2495007.0,,,,,,,5194417.0,,,,2084.0,,,1608893.0,,17460,,,4974255.0,,560527.0,,,,,5963284.0,,,,,General Short Term,260535911.0,5963284.0,,82604015.0,,,,394.0,2927952.0,,,,,,4891.0,,,,,41953.0,14.0,17913591.0,,,104708.0,,-26741.0,9678008.0,,,,,,,10208.0,,431750.0,8907.0,,10012658.0,2513026.0,7254839.0,,12592986.0,1481661.0,3896486.0,,,,248.0,15422448.0,992758.0,274332001.0,1272943.57,2640778.0,,11886.0,,,,15251.0,,,,3.0,,16241.0,,7045844.0,,,,,6565107.0,20582115.0,7887534.0,148747.0,,,,,,,1081941.0,,,,,,,26685680.0,,1206082.0,202477083.0,,,80609.0,65834.84,,,,3684824.0,,24038248.0,310562.0,,227.0,7147095.0,,,,,12859302.0,,,,23250.0,,,4304395.0,,,96941139.0,4751.0,1064524.0,,,,,,,9725295.0,,104.0,136537.0,,14841449.0,1682816.0,-94766.0,,,1632.0,,,,999204.0,,3508.0,,1614758.0,22.07,,,,,1068222.0,10208.0,,3698880.0,1756091.0,,,,,3126102.0,,,,,,314197.0,1081941.0,,,287679191.0,,402906.0,,,175492.0,,MIDDLEBURG HEIGHTS,26364.0,,,,594995.0,,255593.0,-28910.0,,1622406.0,229585.0,189.0,,,,,-72474.0,,,,,85889.0,,,,,,1151170.0,,,,,396830.0,,8295896.0,,,-27305400.0,,3650.0,,,,-1786.0,,135342.0,,,,16277.0,,81178.0,SWGHC MENTAL HEALTH SERVICES,,25147.0,,43490.0,2198.0,,,,394.0,,20582115.0,,3932864.0,,5968715.0,2722781.0,3996065.0,1448.0,11271146.0,30068.0,,11750.0,,,,,,,,30148556.0,,208398.0,289.0,,,15.0,,,2176615.0,,5483718.0,,,4868885.0,,3190.0,2282995.0,,138090.0,,,851.0,,2.08,,,,,,,281547.0,,3872.0,,,1857729.0,,,105579.0,,1642831.0,26473.0,245072.0,,2.0,,4037146.0,107551.0,,,,,43490.0,,2721524.0,-200.0,8674248.0,,,,,,,,,27947.63,,,,,247589.0,,,,630612.0,,,10975779.0,116534230.0,,1332361.0,1328025.0,,,556390.0,,,,38362665.0,,13001318.0,1367555.0,,4252980.0,11631834.0,,546247.62,,21532027.0,46.0,,158809.0,,10258.0,94.0,29430.0,,,,,,8127385.0,,10049.0,17075.0,,,,,,,404.0,,,,,,,,,,,,35.0,,,396830.0,,203921.0,520767.0,,110.0,,,,,,,,349.0,,,,28274244.0,234882029.0,,,,,,251400.0,,,3896426.0,,,,,30805.0,,,,16100041.0,,F,1470865.0,7846136.0,,52797162.0,271817.0,,,1637609.0,,3684824.0,22731.0,,,3305190.0,SOUTHWEST GENERAL HEALTH CENTER,1867923.0,,17394.0,137350.0,,,,,,,6565107.0,4690760.0,15628563.0,,1008.0,1.0,,-1463008.0,,,,10329.0,,,1453149.0,154761077.0,13400027.0,,,12612095.0,Y,,,1170.0,,,486044429.0,4247573.0,15900332.0,4183.0,480614.0,36151.42,1969523.0,,,12289488.0,,,,303943908.0,,,,267.0,1053.0,,,,2394117.0,,,1148371.0,14581.0,60630.0,,,,,24736.0,,-7727.0,,,39854605.0,1857729.0,,25166777.0,14833738.0,,,,,32.13,,7180871.0,,,,,,2.0,,,,,,,,,,,,,,25666677.0,,,,203921.0,,,2367532.0,105510.0,,127610351.0,,,,,1685000.0,2078129.0,,106.0,,,13834363.0,935361.0,17807.0,3285.0,2205761.0,14926005.0,4784546.0,46.0,13571.0,,,,,489072.0,191681933.0,16071427.0,,,221662.0,8427.0,3228.0,8194.0,,,8253550.0,,19942727.0,,,13.89,,,,,,2024-02-14 00:00:00,,,,,188020.0,,,,,,25915331.0,,,,,,806880.0,,,,,,9104758.0,147081.0,,3975242.57,5476281.0,,,179191.92,,,150594.0,6284506.0,,,1.0,,,,,8443132.0,,,22600.0,,,,,,,,,82440.0,,,,,1395.0,,,,,,5778709.0,,,6496104.0,1867923.0,,,,,,110390482.0,,41752.0,,13897462.0,,,161443.0,,3.0,,204.0,,2863235.0,,,36S155,,,449025.0,,,,37056.0,,4115302.0,,,27071757.0,,,,,,,,,53408.0,,425003.5,38985260.0,,,,,,606.0,,,1724871.0,2220491.0,,6106171.0,,23222533.0,,,,1215910.0,,546371.0,,,,1659.58,624.0,,5731.0,N,505909.0,,,,1256910.0,,,44004.0,,,2898381.0,,109673932.0,,,1177.0,31193.0,,,,6911177.0,111863.0,,Y,36568.0,,,,320.0,20791133.0,799044.0,1151.0,212246.0,,,8253885.0,1813967.0,-3941.0,,,1392.0,1190903295.0,3577806.0,,,,,9104758.0,,14.98,,,17757602.0,,73.59,,1241.0,282749.0,,,30245781.0,,,29.68,,,,-187577.0,,,2503176.0,362224.0,,547948.0,1611.0,,,551.0,,,1.0,3787168.0,1071760.0,12958.0,,,2978975.0,9.0,,361530,3354165.0,1469.0,,,6335.0,,96073.0,,,52.0,1650323.0,-4670.0,,,,189.0,1.0,,,3681734.0,10.0,170155.0,9602130.0,433.0,17913591.0,864781.0,507345.0,,,,,118257.0,12.0,,,13049234.0,,N,,,553445.0,2990.0,,13086.0,9701.0,19044.0,,N,369528.0,,,1712497.0,3905638.0,16177151.0,377238.0,,5968715.0,,3578267.0,1884374.0,,,,889684.0,,,,,505909.0,13060984.0,,965.0,6308.0,,,,,1392.0,,,,,,,,,1008213.0,,,,,39506056.0,,673.0,17206041.0,795968.0,,2130981.0,,7105.25,,484556004.0,,,,1520444.0,161226.0,815169.0,,,762629.0,23050.0,4183.0,,,,4270.0,,3737592.0,813.0,31.0,8734.0,284659.0,19174777.0,16538105.0,3.0,,,240585.0,,12271.0,2015,Acute Care Hospitals,SOUTHWEST GENERAL HEALTH CENTER (360155)
39408,SOUTHWEST GENERAL HEALTH CENTER (360155),General Short Term (Acute Care Hospitals),Voluntary Nonprofit-Other,-81.83291,41.37208,,1070.0,,,1262427.0,292472520.0,59342.0,20457039.0,,3163638.0,,146744.0,,,570861.0,1168883.0,38923056.0,2160630.0,1875.0,,,24859147.0,3617.0,1744150.0,,,92438.0,271392.0,,1924758.0,610043.0,447064842.0,,9275198.0,,,,,,,,-36074.0,2170543.0,,,,,30.0,,,11999.0,,800230.0,,,,,2942912.0,896651.0,-847542.0,,709332.0,6159166.0,,2838807.0,1616238.0,62049221.0,23393.0,,13.0,3314016.0,531442.0,394807.0,166363.0,,9.0,,,,928115.0,5190341.0,,,0.219633,1.0,587838.0,,,,22056.0,5703012.0,5971914.0,,2838807.0,13660393.0,9769249.0,1.0,1353144.0,,,,,104093305.0,368708.0,4200759.0,,-112617.0,142.0,,,,,,643159.0,,,48.0,3839.0,849081.0,67631723.0,,,,9763564.0,,,,,,,,,,,2056118.0,97.0,9415694.0,,,,,,310815.0,,504544.0,273672429.0,,141.0,,18631175.0,,6226445.0,,,-19617.0,,249985.0,-937287.0,105843986.0,,,,,,1156.0,56364.0,,,14.4,,,29.03,4583.0,,7182345.0,,83831.0,,,,32.11,,,,,,6.0,,,,,,,38716.0,,10.0,,,,,13932578.0,118487.0,,,,340113.0,,,4735812.0,,1273943.0,,8966.0,,152611.0,40164.0,,,,,269711.0,9208.0,,112560.0,,,,17784180.0,,,,,,,,,-559867.0,-4545401.0,,12339355.0,6594354.0,,,31049929.0,,,5885161.0,16.0,,,,,,3803978.0,,,,45874.24,6093733.0,3809726.0,6477354.0,,N,,,,3165849.0,1706.0,,255.0,80103.0,9.0,,-180.0,,,,39473070.0,,,,,,,,,,1083626.0,,3367213.0,2913591.0,1183184.0,13784774.0,,,6815979.0,,,,,4184833.0,,,25384160.0,,,,27817381.0,933117818.0,,,,,,,,,,1229839.0,N,,8.0,64238.0,2942912.0,1754.41,CUYAHOGA,-26412.0,,,,7614389.0,,-323927.0,133471441.0,,,,,69423.0,,2292635.0,14.0,,,19270.0,,366.0,,,,2211241.0,,,,,,,,1680,127.0,,,17536.0,,,1160407.0,,294661.0,,,,12866186.0,,478507452.0,499539.0,87888.96,,133796433.0,755194.0,,79754.0,2707586.0,4842.0,,,,,,,937.0,33145.0,-11726217.0,,17860519.0,,3987.0,,2782213.0,2170543.0,1433040.0,,1745.0,59380.0,1175382.0,760785430.0,39473070.0,,,,,4735812.0,,1183184.0,,,,,,,-2449.0,,,,,,4876502.0,,19570.0,,1502340.0,14640.0,4991.0,36T155,,,,,,44109688.0,,4941710.0,2307718.0,,69423.0,,7392476.0,,103637.0,6545160.0,,,,,438268.0,,,,122035374.0,4.0,,,2830.0,N,,-30579.0,24.0,573.0,,1810221.0,629041.0,,,,,,466075.0,1574008.0,3454.0,,11722110.0,,,434811.0,4,36.0,,1568349.0,,197559.0,26130068.0,,3646335.21,,307146.0,19.05,,,,13388.0,1546279.0,N,,443102405.0,,,,,,,,17595948.0,,294791506.0,,360155,185.0,,,,,,,4269388.0,,,,,,,,,64.49,,,,10949193.0,,853831.0,,,,,4396267.0,,112297.0,,,-49769.0,,,-41820.0,54.0,765.0,,,,,,11998.0,9027.0,,,802857.0,,,,15307525.0,71669497.0,16087.83,,,,,36709.0,818330.0,,,,,,,11821.0,9759.0,,1591131.0,,,17109.0,,,,,,,,,,,790126.0,3809726.0,,,,,,,,,,1989710.0,,9718498.0,,,,3779923.0,,,,,-157046.0,6649949.0,,,58949.0,40384674.0,2683893.0,488470.0,1339736.0,,,351281.0,47401710.0,,5129018.0,,73133.0,,127603465.0,,223.0,,,6105130.0,160529868.0,,3431532.5,F,586643.0,2498857.0,,,,,,,370.0,,,-737757.0,26130068.0,3385885.0,1484400.0,1035.0,4792241.0,11376961.0,,534.0,10010702.0,,,,,,20882.0,586643.0,,,5658752.0,,,,6255347.0,1106555.0,,,,,849081.0,N,,,5042385.0,643907.0,,,,,-172442.0,,,,,161584597.0,,,-1927.0,,,,,,25.47,,,2633.0,29685760.0,,,,7224433.0,26782660.0,,,13388.0,3021106.0,,,,,11275.0,1630771.0,,,,,,638410.0,5213637.0,530042.0,,1499431.0,,,,-13403.0,,,,,4874658.0,,11.84,,1783417.0,1574008.0,826472.0,,,,,,,,12663141.0,16044900.0,2243313.0,,,,,,,1141691.0,91733.0,,,,2261.0,,,3141.75,13388.0,,,,,,373950.0,26.81,,191205644.0,,,,,,,27817381.0,,,,528772.0,,1036815.0,197425876.0,,7025431.0,487.0,1964114.0,36170,,2469486.0,,4856939.0,,,,229.0,,13884520.0,,,,,1246046101.0,,39.65,,,,,,3522294.0,1091500.0,18432303.0,,,,,,,,,,,,,,368707.0,,,,,,,1952206.0,,27547.0,12.0,,,,,24783.0,,,43.0,-180643.0,,4050509.0,9807.0,,,,928939.0,,43076.0,11719081.0,259325.0,12937644.0,,,,,2758478.0,,,,24462196.0,3628801.0,,110506.01,64238.0,394852.0,,,,,,,,31369874.0,,194.0,,,,320.0,3163638.0,,,,,247598.0,2132101.0,1710202.0,1203189.0,,2436284.0,55085.0,29.62,,,191307601.0,,,29178125.0,,17835965.0,,,478935.0,,,,-44354.0,-8302026.0,,,18181.0,,,3991.0,51910.0,,8868378.0,,,Y,,,1862073.0,10949193.0,,220282.0,889561.0,,,,,1078914.0,554202.0,98187.0,1300724.0,,,,,N,17955607.0,761533.0,,23942392.0,,,434811.0,,,13176.0,,19570.0,,8399060.0,,,,,,,230.0,9415694.0,,,,,Y,,24810.0,3435.0,,,,13600.0,,98042.0,43790.28,,4633646.0,,-2239.0,3036248.0,,,118815.0,,,274106.0,,,,16170007.0,1.0,3445582.0,,14.0,,7182345.0,,,,,6318.0,276979.0,100125.0,1198.0,105563447.0,,,,716121.0,,889561.0,,105563447.0,,,2488179.0,,3222768.0,,,996186.0,,,,1408848.0,30048672.0,,16503.0,13538.0,368708.0,60348604.0,5482243.0,,,,,1363.0,,,,77606.0,,,-11338.0,,2471425.0,,,1323433.0,2004423.0,,29875657.0,,,,,61582.41,49577098.0,,4381473.0,8580365.0,,42296.0,,5939.0,224.0,1558.0,,15.64,25.66,2533209.0,292472520.0,,,,,64238.0,246454.0,789016.0,1087.0,7222.0,,,,,2132.0,2472602.0,5702578.0,,884798.0,,,,1358988.0,,359503.0,,,,,,258485.0,-39492.0,,1718471.0,,,,11437393.0,6600669.0,,762331102.0,,4191.0,-186034.0,,,,,,,,,137.94,23424373.0,44831.9,1576502.0,,56456.0,,37.48,1201.0,52.56,,2626239.0,,83347.0,,1496050.0,-188294.0,,31492.0,,,1616238.0,,,1389928.0,,,,,20788.0,1070.0,,,20530.0,,23903.0,,5490.0,,,,,255548.0,9511909.0,3086936.0,265738.0,3.0,,31049929.0,,6159166.0,,30913446.0,,183663689.0,,,3454842.33,1885747.0,2727.0,,479220.0,36,,,,,,,,,,,,,56364.0,,12663141.0,,71338085.0,,448042.0,,,5885161.0,,71004.0,,-7379.0,,,,,20597224.0,38.63,3860921.0,,,118487.0,,-306.0,27817381.0,117.0,,,,,255093.0,352009.0,,14168.0,,,,16967600.0,,,,,,,151826.0,460596.0,891748.0,,-186164.0,,3166927.0,1435986.0,2872.0,,,2016-12-31,,44130-3497,,,6425534.0,634674.0,1389928.0,,,,13295421.0,2212157.0,6276174.0,,,,,,13388.0,,,,72149.0,55.29,,,,23309.83,27127733.0,,478759.0,568486.0,457051.0,102053482.0,,,,9763564.0,11695140.0,,256.0,,,,,,,82405.0,N,,,13.0,22.0,996186.0,1302273.0,,763768,-2449.0,,9978495.0,Y,,OH,,40910724.0,,-1702284.0,,27754865.0,,,,,1285557.0,,36.0,,5630487.0,21684.0,37777.0,4621173.0,,10199420.0,,24232529.0,,,718025.0,,,,,P,,487.0,,2291.0,,,,,,,5917.0,,,,9654.0,338805.0,,,5877203.0,,1619457.0,968.0,,,,,3758046.0,,,,,,-9560.0,,109.0,10345437.0,1.0,,,18697 BAGLEY ROAD,,34.31,ACUTE REHAB,,,,,,,,1895.0,,,,4114147.0,25187.0,,29875657.0,,-445.0,,,83347.0,,-175064.0,,,,,,,131577.0,,,,,,2053081.0,12.0,104681.0,,2715.0,,6237204.0,,,90182468.0,160.0,,117394.0,293090.0,,,1055707.0,579400.0,367253,841.0,18181.0,43664.0,N,77730.21,347090.0,537247.0,,,,,,,-157254.0,,,,463.0,118.0,19270.0,40.0,26.45,118487.0,15201,82709391.0,N,42066.0,10589.0,,,3599479.0,,,,68506.0,1433040.0,,,9089528.0,,2.0,1484400.0,4551732.0,15166376.0,,,,274062523.0,323.0,4091587.0,199645.0,,,173626.0,5.0,,3839.0,9485.0,,,65923681.0,2349646.0,,,10372.0,,,,,,13559169.0,118487.0,,5052639.0,,,,225689967.0,,,-31996.0,-3024213.0,8917800.0,,2326.0,,5168.0,,263.0,,,,,,,,442554.0,,,,1924758.0,,,2066.0,5026584.0,2557335.0,1488550.0,,,,13884520.0,1664.0,18117139.0,,,,,1007.0,1612879.0,,1781753.0,304198737.0,3314016.0,,106278.0,1982645.0,,,,3201399.0,,,816827.0,,541064.16,53531752.0,431234.0,943074.0,4856939.0,485863.0,,,,71.0,,,,,,959829.0,,,172457.0,48.9,15890.0,,94576.0,,,24423483.0,,,25.66,3475475.0,,,,,1002123.0,,,1210209.0,,,,,-1927.0,9415694.0,5107636.0,229791.0,96311.0,,,,12894112.0,,,,30.24,,7675645.0,2056118.0,,,13388.0,,,,,24976.0,,8966.0,,,,896651.0,2526397.0,,,1574008.0,,3210555.0,-11726217.0,,,,,3804235.0,,,,,,5139520.0,,,816827.0,1002123.0,2016-01-01 00:00:00,,,83347.0,6643.0,,2683893.0,1641425.0,,,,7076084.0,879946.0,,,,,1754011.0,,,32311923.0,,,,,,9987534.0,,,,,,74127.0,,,210025.0,,,,,,,116180.0,,,,,,6797.0,,34613.0,,6477354.0,1653647.0,,,66.0,,-376869.0,1646537.0,8894425.0,37396389.0,1106555.0,,,200510.0,,258.0,1055732.0,,,,,,,,,,-698730.0,,2261.0,,3315650.0,52.99,,2837730.0,,9415694.0,,,,853831.0,7439217.0,-581202.0,,-5373917.0,,4621173.0,,,12925998.0,17315519.0,531796.0,1876.0,,2526397.0,,,,1020342.0,5590.0,9718069.0,24018100.0,,,5473994.0,5.0,2707586.0,,,,,,,5361176.0,,,,3919.0,,,2269921.0,,17460,,,5109578.0,,566693.0,,,,,6093421.0,,,,,General Short Term,276052233.0,6093421.0,,85983505.0,,,,55870.0,3252515.0,,,,,,4991.0,,,,,40164.0,12.0,18905211.0,,,106278.0,,,9511909.0,,,,,,,11542.0,,377127.0,12951.0,,3667960.0,2760747.0,7719939.0,,9769249.0,1485498.0,4206869.0,,,,326.0,20457039.0,1015776.0,281824776.0,1274010.02,2509087.0,,12812.0,,,,34836.0,,,,1.0,,17441.0,,7205106.0,,,,,6663325.0,24238963.0,7564042.0,142999.0,,,,,,,911794.0,,,,,,,29685760.0,,1408848.0,201216346.0,,,103637.0,65434.86,,,,4251168.0,,26739033.0,423250.0,,568.0,7147095.0,,,,,13323092.0,,,,25187.0,,,4396267.0,,,103768313.0,4246.0,480609.0,,,,,,,5658752.0,,132.0,136834.0,,15543109.0,1631625.0,-41140.0,,,1690.0,,1.0,,394852.0,,3987.0,,1488550.0,21.9,,,,,1200185.0,11542.0,,3655254.0,1720335.0,,,,,3343950.0,,,,,,338805.0,523685.0,,,281081576.0,,439219.0,,,189293.0,,MIDDLEBURG HEIGHTS,27547.0,,,,602902.0,,272950.0,-31964.0,,1753379.0,325181.0,154.0,,,,,-270145.0,36911663.0,,,,191086.0,,,,,,1344139.0,,,,,420700.0,,7439217.0,,,-39599553.0,,3660.0,,,,-2660.0,,129796.0,,,,19452.0,,82969.0,SWGHC MENTAL HEALTH SERVICES,,90576.0,,43664.0,3435.0,,,,55870.0,,24238963.0,,4557568.0,,6656606.0,3180551.0,3803978.0,840.0,9603700.0,55917.0,,,,,,,,,,31855614.0,,176875.0,,,,15.0,,,1895408.0,,6237204.0,,,4799559.0,,2172.0,2523097.0,,188850.0,,,195.0,,,,,,,,,,,9187.0,,1.0,1893300.0,,,118120.0,,1009548.0,525053.0,244307.0,,5.0,,5129018.0,118815.0,,,,,43664.0,,3314016.0,-200.0,13295421.0,,,,,,,,,154877.45,,,,,341299.0,,,,452550.0,,144639.0,6252362.0,123053486.0,,1334384.0,1300724.0,,,825966.0,,,,39473070.0,,10512714.0,1351517.0,,4341190.0,12339355.0,,541064.16,,23046598.0,48.0,109.0,136225.0,,10589.0,7648.0,78035.0,,,,23393.0,,8072614.0,,,18181.0,,,,,,,356.0,,,,,,,,,,,,,,,420700.0,,64238.0,563058.0,,137.0,,,,,,,,229.0,,,,30521946.0,225689967.0,,,,,,181262.0,,,3939375.0,,,,,39160.0,,,,12840902.0,,I,1576502.0,8399060.0,,55391609.0,277512.0,,,2004423.0,,4251168.0,49719.0,,,3626465.0,SOUTHWEST GENERAL HEALTH CENTER,1934379.0,,25347.0,176933.0,,,,,,,6663325.0,4792241.0,15221574.0,,831.0,,,-1415352.0,,,,9485.0,,,1433040.0,183663689.0,12614447.0,,,9789555.0,Y,,,629.0,,,486422846.0,3692659.0,17955607.0,3503.0,504544.0,30611.36,1952206.0,,,13110076.0,,,,315636130.0,,,,178.0,2324.0,,,,2800203.0,,,1288831.0,19355.0,52871.0,,,,,27169.0,,-2877.0,,,42525208.0,1893300.0,,27817381.0,16165094.0,,,,,32.84,,8674248.0,,,,,,,,,,,,,,,,,,,,30102778.0,,,,64238.0,,,9987534.0,123322.0,,133460613.0,,,,,124500.0,1885747.0,529055.0,,,,13967512.0,1089456.0,19816.0,3294.0,2056118.0,16044900.0,6105130.0,63.0,14168.0,,,,,597486.0,198635290.0,17995208.0,,,220282.0,23793.0,6434.0,12551.0,,,8844013.0,,29178125.0,,,13.9,,,,,,2024-02-14 00:00:00,,,,,182760.0,,,,,,26533251.0,,,,,,853831.0,,,,,,10128705.0,187896.0,,3972596.66,6220585.0,,,188075.0,,,142372.0,6402081.0,,,,,,,,11722110.0,,,17109.0,,,,,,,,,81501.0,,,,,1346.0,,,1279564.0,,,6649949.0,,,5886644.0,1934379.0,,,,,,117652833.0,,1036815.0,,13362355.0,,,217169.0,,3.0,,142.0,,2836956.0,,,36S155,,,723550.0,,,,53803.0,,4177717.0,,,31350604.0,,,,,,,,,60750.0,,289095.73,39308010.0,,,,,,,,,1852129.0,2159438.0,,6565580.0,,24462196.0,,,,1167055.0,,643159.0,,,,1588.19,646.0,,6210.0,N,1155245.0,,5539676.0,,1974971.0,,,37253.0,,,3163638.0,,117372294.0,,,1216.0,32702.0,,,,6530249.0,119838.0,,Y,38206.0,,,,376.0,24423038.0,856918.0,,190509.0,,,8844348.0,2076299.0,-946.0,,,909.0,1248753948.0,4425200.0,,,,,10128705.0,,15.64,,,18432303.0,,80.9,,3812.0,341374.0,,,31927076.0,,,33.86,,,,-733657.0,,,3239589.0,351281.0,,629041.0,2614.0,,,42066.0,,,2.0,3172905.0,1185017.0,12431.0,,,4114147.0,,,361530,3272695.0,1876.0,,,,,106067.0,,,148.0,818044.0,-5216.0,,,,154.0,,,,3123951.0,10.0,57275.0,9505089.0,400.0,18905211.0,1143090.0,347130.0,,,,,,,,,13278989.0,,N,,,637647.0,,,281.0,12068.0,,,N,404436.0,,,1653647.0,4551732.0,16170007.0,373950.0,,6656606.0,,3635328.0,1964114.0,,,,1200874.0,,,,,1155245.0,13278989.0,,2804.0,3021106.0,,,,,909.0,,,,,,,,,1473384.0,,,,,39473070.0,,1009.0,13463231.0,680851.0,,2239867.0,,7036.86,,485260671.0,,,,1630771.0,50850.0,895716.0,,,879946.0,27042.0,3503.0,,,,9560.0,,3788434.0,984.0,,10063.0,638410.0,27454120.0,15105353.0,,,,221806.0,,,2016,Acute Care Hospitals,SOUTHWEST GENERAL HEALTH CENTER (360155)
45530,SOUTHWEST GENERAL HEALTH CENTER (360155),General Short Term (Acute Care Hospitals),Voluntary Nonprofit-Other,-81.83291,41.37208,,543.0,,,1076318.0,313002794.0,62567.0,19249367.0,,3168936.0,,143381.0,,,512861.0,1056594.0,37356169.0,2018191.0,1748.0,,,25315988.0,6889.0,7853485.0,,,122002.0,257517.0,,2170702.0,377751.0,470584215.0,,13792740.0,,,,,,,,-19100.0,2219108.0,,,,,55.0,,,11681.0,,679431.0,,,,,2606663.0,1043586.0,-833928.0,,754928.0,7756645.0,,2269127.0,1358970.0,62353905.0,41334.0,,4.0,3455453.0,619857.0,439606.0,186149.0,,38.0,,,,992305.0,5403234.0,,,0.223512,,588815.0,,,,4066.0,5982665.0,5312044.0,,2269127.0,13057034.0,10508211.0,1.0,2143103.0,,,,,109832065.0,368708.0,3641265.0,,-114612.0,64.0,,,,,,568504.0,,,13.0,3614.0,867802.0,68118604.0,,,,11250926.0,,,,,,,,,,,2215205.0,47.0,9483257.0,,,,,,250555.0,,935651.0,293824943.0,,142.0,,19824403.0,,7550129.0,,,-1080.0,,202510.0,-942194.0,111016160.0,,,,,,609.0,56210.0,,,17.29,,,29.79,5089.0,,12732715.0,,83441.0,,,,33.52,,,,,,2.0,,,,,,,27165.0,,3.0,,,,,14962865.0,126372.0,,,,366249.0,,,4688825.0,,1146953.0,,10814.0,,359310.0,40542.0,,,,,263516.0,9845.0,,135146.0,,,,19465984.0,,,,,,,,,-621969.0,-4708430.0,,12250398.0,6979784.0,,,33087375.0,,,5457252.0,9.0,,,,,,4000264.0,,,,45742.48,4804791.0,5471572.0,5985541.0,16933.0,N,,,,3504675.0,1693.0,,255.0,76842.0,9.0,,-45.0,,,,41197176.0,,,,,,,,,,1107532.0,,3553567.0,2572464.0,1284529.0,1308480.0,,,7161439.0,,,,,4032279.0,,,25391246.0,,,,30825713.0,982606890.0,,,,,,,,,,1962505.0,N,,4.0,41355.0,2606663.0,1793.83,CUYAHOGA,-29546.0,,,,8565463.0,,-238810.0,142081935.0,,,,,70389.0,,2482583.0,5.0,,,29000.0,,102.0,2050.0,,,2605407.0,,,,,,,,1680,183.0,,,17151.0,,,1196782.0,,260674.0,,,,13316208.0,,498170646.0,434871.0,86706.11,,142673285.0,759385.0,,48570.0,3131740.0,4024.0,,,,,,,339.0,29248.0,-11584045.0,,18111134.0,,3381.0,,2593994.0,2219108.0,1431356.0,,2080.0,72551.0,1194507.0,813214689.0,41197176.0,,,,,4688825.0,,1284529.0,,,,,,,-1649.0,,,,,,4439799.0,,19817.0,,1467952.0,14600.0,4745.0,36T155,,,,,,42080492.0,,5079533.0,2117311.0,,70389.0,,9529739.0,,61545.0,7897605.0,,,,,361319.0,,,,119758623.0,,,,3059.0,N,,-18722.0,47.0,87.0,,1674843.0,564827.0,,,,,,450469.0,1573063.0,3970.0,,11756313.0,,,487726.0,4,36.55,,1548476.0,,193677.0,24862748.0,,3726722.61,,336642.0,18.59,,,,8480.0,1714531.0,N,,466621778.0,,,,,,,,17677886.0,,296099985.0,,360155,178.0,,,,,,,5754344.0,,,,,,,,,66.6,,,,12381909.0,,961132.0,,,,,4496893.0,,135013.0,,,-20168.0,,,,63.0,487.0,,,,,,16951.0,7161.0,,,816812.0,,,,15071974.0,76919761.0,17605.26,,,,,32074.0,814006.0,,,,,,,14434.0,24687.0,,1787656.0,,,16160.0,,,,,,,,,,,749158.0,5471572.0,,,,,,,,,,2577681.0,,12091987.0,,327.0,,4348663.0,,,,,-154550.0,6803138.0,,,32951.0,41076551.0,2621835.0,484372.0,1295072.0,,,415933.0,45817113.0,,4926033.0,,68917.0,,133467499.0,,294.0,,,5553815.0,177163692.0,,3500991.72,F,615888.0,2570040.0,,,,,,,202.0,,,-905404.0,24862748.0,3598767.0,310671.0,1031.0,4351496.0,11627956.0,,893.0,9178796.0,,,,,,18706.43,615888.0,,,15491159.0,,,,6255346.0,1044695.0,,,,,867802.0,N,,,5252434.0,1107601.0,,,,,-131672.0,,,,,179341766.0,,13338.0,2738.0,,,,,28650.0,25.13,,,11113.0,30694662.0,,,,8309778.0,28356281.0,,,8480.0,3266663.0,,,,,9399.0,1397301.0,,,,,,657727.0,9744492.0,454189.0,,1535107.0,,,,-11127.0,,,,,8047030.0,,12.14,,1936279.0,1573063.0,955680.0,4039.0,,,,,,,12633121.0,14881111.0,1905204.0,,2.0,,,,,1448203.0,93168.0,,,,2378.0,,,3132.0,8480.0,,,,,,342956.0,28.22,,232176264.0,,,,,,,30825713.0,,,,463516.0,,863318.0,231728513.0,,7431543.0,4698.0,1964588.0,36170,,2704401.0,,5327923.0,,,,255.0,,14435889.0,,,,,1314585310.0,,40.86,,,,,,4895664.0,1117132.0,18267123.0,,,,,,,,,,,,,,368708.0,,,,,,,1901234.0,,25397.0,37.0,,,,,24767.0,,,64.0,-42477.0,,3871110.0,51.0,,,,905299.0,,-8098.0,14579172.0,202407.0,16589654.0,,,,,2490321.0,,,,23861591.0,3847421.0,,109693.09,41355.0,759523.0,,,,,,,,32207976.0,,194.0,,,,391.0,3168936.0,,,,,275245.0,2151686.0,1683815.0,1239564.0,,2211188.0,87003.0,30.55,,,177580757.0,,,11355542.0,,18086580.0,,,454719.0,,,,-36718.0,-8690465.0,,,17472.0,,,3954.0,52443.0,,9181297.0,,,Y,,,1911244.0,12381909.0,,212319.0,935858.0,5.0,,,,1212054.0,584455.0,80456.0,1351368.0,,,,,N,15633958.0,782365.0,,23634009.0,,,487726.0,,,13140.0,,19817.0,,6145127.0,,,,,,,,9483257.0,,,,,Y,,44261.0,6043.0,,,,25838.0,,94330.0,38529.29,,4844380.0,,-16608.0,4650646.0,,,126759.0,,,218481.0,,,,16493804.0,2.0,3192422.0,,28.0,,12732715.0,,,,,5182.0,272997.0,97460.0,1794.0,110878111.0,,,,622557.0,,935858.0,,110878111.0,,,2559773.0,,3550921.0,,,1079649.0,,,,1259690.0,29433061.0,,9489.0,16974.0,368708.0,67012930.0,5119611.0,,,,,1113.0,,,,84389.0,,,-16959.0,,2397040.0,,,1495486.0,3042790.0,,36820739.0,,,,,61613.93,53768467.0,,4482357.0,9089528.0,1.0,43248.0,,7618.0,235.0,1554.0,,15.86,26.36,2692180.0,313002794.0,,,,,41355.0,244523.0,847235.0,1183.0,7866.75,,,,,2706.0,2431854.0,5728702.0,,978417.0,,,,1284533.0,,262479.0,,,,,,353987.0,-210617.0,,1698854.0,,,,10432237.0,6216801.0,,814764346.0,,3813.48,-205194.0,,,,,,,,,137.24,27037528.0,51691.29,1556923.0,,45486.0,,35.59,1384.0,55.68,,2675284.0,,77632.0,,1525740.0,-188294.0,,35034.0,,,1358970.0,,,1256411.0,,,,,18487.0,8288.0,,,22391.0,,21460.0,,5475.0,,,,,224188.0,10363319.0,4170095.0,234859.0,,,33087375.0,,7756645.0,,29740191.0,,179625346.0,,,3526463.73,2015507.0,2446.0,10502.0,1000854.0,36,,,,,,,,,,,,,56210.0,,12633121.0,,76123761.0,,454322.0,,,5457252.0,,70810.0,,100229.0,,,,,19419119.0,40.29,14364113.0,,,126372.0,,-14.0,30825713.0,30.0,,,,,230268.0,98680.0,,14358.0,,,,16643478.0,,,,,,,177307.0,922488.0,,,-216697.0,,15890821.0,1303089.0,648.0,,,2017-12-31,,44130-3497,,,6335460.0,547122.0,1256411.0,,,,14503895.0,4508783.0,6620902.0,,,,,,8480.0,,,,1127046.0,53.16,,,,25472.01,23963051.0,,493866.0,564985.0,294172.0,108615977.0,,,,11250926.0,12574771.0,,245.0,,,,,,,93785.0,N,,,2.0,51.0,1079649.0,1249969.0,,763769,-1649.0,,9969121.0,Y,,OH,,42593446.0,,-1066989.0,10475.0,22111841.0,,,,,1500339.0,,36.0,,5686805.0,20539.0,30183.0,1208474.0,,10843942.0,,23942548.0,,,647410.0,,,,,P,,4698.0,,2602.0,,,,,,,1402.0,,,,5900.0,337084.0,,,5563414.0,,1412204.0,609.0,,,,,3943768.0,,,,,,-7876.0,,42.0,10077630.0,1.0,,,18697 BAGLEY ROAD,,34.39,ACUTE REHAB,,,,,,,,3391.0,,,,4352126.0,3165.0,,36820739.0,,78.0,,,77632.0,,-129893.0,,,,,,,120488.0,,,,,,2068923.0,41.0,97154.0,,3151.0,,5885000.0,,,99026930.0,213.0,,101611.0,424831.0,,,932731.0,360876.0,367253,1960.0,17472.0,47259.0,N,78755.82,331483.0,562064.0,,,,,,,-154772.0,,,,844.0,143.0,29000.0,40.0,28.13,126372.0,15201,94654316.0,N,36750.0,7241.0,,,3640510.0,,,,66378.0,1431356.0,,,9123805.0,,2.0,310671.0,4959122.0,16473772.0,,,,294233714.0,3310.0,4246525.0,225975.0,,,168383.0,5.0,,3614.0,9523.0,,,69385769.0,2201560.0,,,12827.0,,,,,,13119493.0,126372.0,,5194064.0,,,,211821869.0,,,-32448.0,-3143636.0,8798348.0,,16.0,,8386.0,,133.0,,,,,,,,617195.0,,,,2170702.0,,,1146.0,4995582.0,2714199.0,1334927.0,,,,14435889.0,1756.0,20424771.0,,,,,10542.0,1697341.0,,1888209.0,324586839.0,3455453.0,,98165.0,2048293.0,,,,3341287.0,,,798984.0,,547588.67,56197930.0,426106.0,705330.0,5327923.0,1007767.0,,,,,,,,,,4181591.0,,,367286.0,52.71,,,96689.0,,,24218610.0,,,26.36,3531856.0,,,,,1557317.0,,,1001594.0,,,,,2738.0,9483257.0,6364543.0,330367.0,91555.0,,,,19881385.0,,,,31.2,,7305305.0,2215205.0,,,8480.0,,,,,62440.0,,10814.0,,,,1043586.0,2143955.0,,,1573063.0,,3096447.0,-11584045.0,,,,,4378209.0,,,,,,5134186.0,,,798984.0,1557317.0,2017-01-01 00:00:00,,,77632.0,6913.0,,2621835.0,1371096.0,,,,7826228.0,1767616.0,,,,,733815.0,,,37967544.0,,,,,,10361080.0,,2648.0,,,,60216.0,,,161614.0,,,,,,,85574.0,,,,,,22501.0,,34672.0,,5985541.0,1353853.0,,,69.0,,-416976.0,1721229.0,8910335.0,39305145.0,1044695.0,,,217432.0,,100.0,926218.0,,,,,,,,,,-757208.0,,2378.0,,2850249.0,55.85,,4240575.0,,9483257.0,,,,961132.0,2321855.0,-591816.0,,-5036504.0,,1208474.0,,,12866286.0,15273898.0,596203.0,1477.0,,2143955.0,,,,1056181.0,5437.0,5369518.0,20066819.0,,,5543066.0,2.0,3131740.0,,,,,,,5786791.0,,,,2746.0,,,2025039.0,,17460,,,5438412.0,,571605.0,,,,,6040223.0,,,,,General Short Term,296811395.0,6040223.0,,79234829.0,,,,64490.0,2757848.0,,,,,,4745.0,,,,,40542.0,4.0,19626834.0,,,98165.0,,,10363319.0,,,,,,,11626.0,,390265.0,14031.0,,12054555.0,2533652.0,7342003.0,,10508211.0,1562581.0,4141064.0,,,,2573.0,19249367.0,1143004.0,294791505.0,1270508.8,2515881.0,,12362.0,,,,46586.0,,,,,,16857.0,,7682596.0,,,,,7337422.0,23953713.0,7484587.0,167018.0,,,,,,,3172639.0,,,,,,,30694662.0,,1259690.0,241355060.0,,,61545.0,65212.0,,,,4657915.0,,27191267.0,1234823.0,,989.0,6255346.0,,,,,15623955.0,,,,3165.0,,,4496893.0,,,109240715.0,33188.0,3180737.0,,,,,,,15491159.0,,109.0,101305.0,,15176187.0,1575485.0,-67568.0,,,1132.0,,2.0,,759523.0,,3381.0,,1334927.0,21.95,,,,,1096930.0,11626.0,,3753048.0,1702352.0,,,,,3051387.0,,,,,,337084.0,3172639.0,,,266442133.0,,515529.0,,,175854.0,,MIDDLEBURG HEIGHTS,25397.0,,,,634670.0,,217872.0,-32448.0,,1839129.0,228777.0,154.0,,,,5.0,-235294.0,56810443.0,,,,156874.0,,,,,,1354046.0,,,,,752969.0,,2321855.0,,,-44402531.0,,3650.0,,,,-39.0,,142438.0,,,,20889.0,,82103.0,SWGHC MENTAL HEALTH SERVICES,,98433.0,,47259.0,6043.0,,,,64490.0,,23953713.0,,4628505.0,,5442171.0,2918198.0,4000264.0,462.0,8417280.0,51527.0,,,,,,,,,,34810666.0,,215681.0,,,,15.0,,,1980760.0,,5885000.0,,,1002744.0,,1994.0,2635587.0,,196196.0,,,142.0,,,,,,,,,,,44447.0,,,2396565.0,,,129293.0,,4180406.0,34277.0,274943.0,,11.0,,4926033.0,126759.0,,,,,47259.0,,3455453.0,-200.0,14503895.0,,,,,,,,,155576.58,,,,,309598.0,,,,448506.0,,500143.0,6309761.0,132660196.0,,1279762.0,1351368.0,,,777322.0,,,,41197176.0,,10340155.0,1449227.0,,4564811.0,12250398.0,,547588.67,,23720702.0,65.0,180.0,89958.0,,7241.0,9644.0,71214.0,,,,41334.0,,7468727.0,,,17472.0,,,,,,,303.0,,,,,,,,,,,,,,,752999.0,,41355.0,594516.0,,171.0,,,,,,,,255.0,,,,30544172.0,211821869.0,,,,,,147197.0,,,3924095.0,,,,,33237.0,,,,12701125.0,,L,1556923.0,6145127.0,,54620264.0,293022.0,,,3049723.0,,4657915.0,-1185.0,,,3100804.0,SOUTHWEST GENERAL HEALTH CENTER,2080305.0,,15320.0,112202.0,,,,,,,7337422.0,4351496.0,15850530.0,,967.0,,,-1396732.0,,,,9523.0,,,1431356.0,179625346.0,12419293.0,,,10525624.0,Y,,,402.0,,,502861620.0,3897758.0,15633958.0,3067.0,935651.0,31133.05,1901234.0,,,12886080.0,,,,335019076.0,,,,90.0,3973.0,,,,2569753.0,,,1289330.0,18970.0,37056.0,,,,,24076.0,,,,,41377314.0,2396565.0,,30825713.0,12952677.0,,,,,32.71,,13295421.0,,,,,,,,,,,,,,,,,,,,29508647.0,,,,41355.0,1005.0,,10361080.0,124914.0,,124472904.0,,,,,725000.0,2015507.0,3434793.0,,,,15003246.0,1861743.0,20521.0,3285.0,2215205.0,14881111.0,5553815.0,51.0,14358.0,,,,,553543.0,213708728.0,18190065.0,,,212319.0,22110.0,11165.0,6442.0,,,9417468.0,,11355542.0,,,15.09,,,,,,2024-02-14 00:00:00,,,,,141931.0,,,,,,31791481.0,,,,,,961132.0,,,,,,7821276.0,162091.0,,4048580.39,5279486.0,,,181174.15,,,113869.0,6438383.0,,,,,,,,11756313.0,,,16160.0,,,,,,,,,82901.0,,,,,1284.0,,,2445137.0,,,6803138.0,,,6642028.0,2080305.0,,,,,,123676604.0,,863318.0,,14035879.0,,,187968.0,,3.0,,362.0,,2619080.0,,,36S155,,,983446.0,,,,51003.0,,4787419.0,,,32178976.0,,,,,,,,,58595.0,,288771.42,46391700.0,,,,,,517.0,,,2075228.0,2101441.0,,6569651.0,,23861591.0,,,,1291269.0,,568504.0,,,,1624.23,648.0,,4507.0,N,617248.0,,9461165.0,,1858343.0,,,27207.0,,,3168936.0,,123538555.0,,,1225.0,26061.0,,,,6513749.0,126491.0,,Y,40642.0,,,,701.0,24218688.0,991759.0,,276140.0,,,9418283.0,1870046.0,,,,928.0,1317625966.0,4419484.0,,,,,7821276.0,,15.86,,,18267123.0,,79.13,,6579.0,331545.0,,,34891276.0,,,36.45,,,,-652016.0,,,2535042.0,415933.0,,564827.0,986.0,,,36750.0,,,9.0,3089830.0,1191942.0,5976.0,,,4352126.0,,,361530,3169635.0,1477.0,,,,,109133.0,,,487.0,,-2956.0,,,,154.0,,,,7681422.0,10.0,92364.0,10156703.0,408.0,19626834.0,1037240.0,315506.0,,,,,,,,,13706490.0,,N,,2.0,643727.0,23688.0,,468.0,13307.0,,,N,337001.0,,,1353853.0,4959122.0,16493804.0,342956.0,,5442171.0,,3816723.0,1964588.0,,1005.0,,1025261.0,,,,,617248.0,13706490.0,,11278.0,3266663.0,,,,,928.0,,,,,,,,,1358006.0,,,,,41197176.0,,1210.0,22432657.0,949531.0,,1948247.0,,6397.11,,501370621.0,,,,1397301.0,32875.0,882422.0,,,1767616.0,58349.0,3067.0,,,,12394.0,,4187593.0,1134.0,,8188.0,657727.0,21391668.0,22486792.0,5.0,,,221404.0,,,2017,Acute Care Hospitals,SOUTHWEST GENERAL HEALTH CENTER (360155)
51593,SOUTHWEST GENERAL HEALTH CENTER (360155),General Short Term (Acute Care Hospitals),Voluntary Nonprofit-Other,-81.83291,41.37208,,119044.0,,,1019730.0,318234659.0,68870.0,20598363.0,,3425730.0,,143469.0,,,512892.0,1047638.0,36215214.0,1808550.0,1061.0,,,28228782.0,8692.0,6929971.0,,,99553.0,259760.0,,2277846.0,313840.0,466448598.0,,13930297.0,,,,,,,,-39215.0,2190259.0,,,,,48.0,,,9986.0,,358369.0,,,,,2229433.0,945617.0,-862689.0,,818988.0,7596007.0,,2137781.0,1131585.0,56943025.0,45162.0,,6.0,3409341.0,549912.0,420337.0,171363.0,,4.0,,,,1089517.0,,,,0.22049,,473280.0,,,,14888.0,7238140.0,4445356.0,,2137781.0,12912297.0,10530651.0,1.0,2470875.0,,,,,112283968.0,,3807677.0,,-112805.0,95.0,,,,,,572990.0,,,,3540.0,870815.0,66608267.0,,,,10758631.0,3.0,,,,,,,,,,2343838.0,,10166148.0,,,,,,272689.0,,1779397.0,299315630.0,,124.0,,21279487.0,,8113296.0,,,-1080.0,,157906.0,-992190.0,115163217.0,,,,,,905.0,57305.0,,,17.59,,,30.34,3737.0,,12803791.0,,86669.0,,,,33.43,,,,,,3.0,,,,,,,15652.0,,14.0,,,,,15427080.0,139519.0,,,,359935.0,,,4603416.0,,968685.0,,5400.0,,319139.0,39351.0,,,,,272045.0,10544.0,,126048.0,,,,22509460.0,,,,,,,,,-532223.0,-5260089.0,,12063608.0,6666536.0,,,32158718.0,,,4852166.0,38.0,,,,,,3365592.0,,,,50422.06,6123665.0,4977697.0,5668304.0,16726.0,N,,,,3300865.0,981.0,,258.0,66976.0,,,,,,,40188962.0,,,,,,,,,,1237181.0,,3629873.0,3014777.0,1135868.0,3890624.0,,,7605431.0,,,,,3940575.0,,,25689891.0,,,,31379541.0,1014702291.0,,,,,,,,,,1859379.0,N,,4.0,35573.0,2229433.0,1825.44,CUYAHOGA,-35907.0,,,,8474107.0,,-720814.0,144871148.0,,,,,69779.0,,2379832.0,,,,34936.0,,1.0,2526.0,,,6217900.0,,,,,,,,1680,266.0,,,13787.0,,,1147981.0,,310529.0,,,,15623955.0,,494997718.0,384587.0,92846.95,,145354424.0,676282.0,,47103.0,3037494.0,1935.0,,,,,,,,32748.0,-16172112.0,,17206142.0,,3621.0,,2211574.0,2190259.0,1481274.0,,1800.0,68715.0,1285847.0,862395774.0,40188962.0,,,,,4603416.0,,1135868.0,,,,,,,-1099.0,,,,,,3841260.0,95.0,19803.0,,1442617.0,14600.0,4525.0,36T155,,,,,,40659777.0,,5425170.0,2049039.0,,69779.0,,,,60837.0,8469834.0,,,,,357529.0,,,,121448496.0,,,,1958.0,N,,-42341.0,219.0,47.0,,1564746.0,531473.0,,,,,,437898.0,1830201.0,4089.0,,12083052.0,,,531043.0,4,36.9,,1519376.0,,203559.0,20993738.0,,3796265.61,,244736.0,19.09,,,,7414.0,1508649.0,N,,462486161.0,,,,,,,,15624311.0,,299858993.0,,360155,158.0,,,,,,,5931743.0,,,,,,,,,61.24,,,2.0,12109176.0,,985560.0,,,,,4813263.0,,126005.0,,,,,,,44.0,1947.0,,,,,,15355.0,7176.0,,,847977.0,,,,13585708.0,82006425.0,14316.34,,,,,23637.0,744232.0,,,,,,,17660.0,41129.0,,2008013.0,,,18319.0,,,,,,,,,,,797599.0,4977697.0,,,,,,,,,,3051176.0,,14021217.0,,,,4575674.0,5.0,,,,-223642.0,6524393.0,,,40960.0,43796239.0,2613653.0,515123.0,1821077.0,,,395565.0,42590090.0,,5388439.0,,76690.0,,124472904.0,,568.0,,,5136349.0,,,3556031.52,F,676039.0,2624996.0,,,,,5917.0,,517.0,,,-944385.0,20993738.0,3342475.0,396373.0,993.0,4333984.0,11575624.0,,,4802004.0,,,,,,21461.97,676039.0,,,6842476.0,,,,6255346.0,1175301.0,,,86583.0,,870815.0,N,,,5517433.0,806555.0,,,,,-49190.0,,,,,,,565.0,-360.0,,,,,1195.0,26.02,,,4133.0,34221463.0,,,,8956097.0,28812008.0,,,7319.0,3290766.0,,,,,8561.0,1198004.0,,,,,,478324.0,9562037.0,467706.0,,1616651.0,,,,-10292.0,,,,,6455811.0,,13.36,,2066342.0,1830201.0,1135823.0,3851.0,,,,,,,13138910.0,15736912.0,1915860.0,,,,,,,1472332.0,56415.0,,,,2714.0,,,2483.23,7414.0,,,,,,303774.0,28.07,,225096190.0,,,,,,,31379541.0,,,,399811.0,,1045224.0,226251560.0,,7722141.0,5132.0,1913728.0,36170,,3066661.0,,4920085.0,,,,177.0,21.0,14847187.0,,,,,1357504074.0,,42.93,,,,,,3822849.0,1144799.0,19377358.0,,,,,,,,,,,,,,368708.0,,,,,,,2158863.0,,23732.0,,,,,,22277.0,,,27.0,-60458.0,,4117471.0,321.0,,,,1153127.0,,86.0,14934174.0,180822.0,16828431.0,,,,,2543399.0,,,,22972848.0,3724483.0,,111810.3,34999.0,624461.0,,574.0,,,,,,32963832.0,,197.0,,,,370.0,3425730.0,,,,,314794.0,2173261.0,1828622.0,1195137.0,,2156991.0,77206.0,30.85,,,180286793.0,,,13298613.0,,17181588.0,,,460525.0,,,,-94516.0,-9089070.0,,,16076.0,,,4716.0,51367.0,,7959952.0,,,,,,1997322.0,12109176.0,,107351.0,696150.0,17.0,,,,1328925.0,539551.0,73120.0,1386863.0,,,,,N,14808626.0,697342.0,,25204088.0,,,531043.0,,,13140.0,,19803.0,,6304828.0,,,,,,,,10166148.0,,,,,Y,,61632.0,7145.0,,,,31801.0,,73985.0,38569.96,,5960085.0,,-20329.0,4393854.0,,,140117.0,,,249052.0,,,,15977880.0,3.0,3078973.0,,3.0,,12803791.0,,,,,5783.0,276452.0,82973.0,3407.0,115018634.0,,,,493138.0,,696150.0,,115018634.0,,,2614704.0,,3505311.0,,,994765.0,,,,1192347.0,31213419.0,,8157.0,22312.0,401443.0,68463914.0,5703672.0,,,,,533.0,,,,80541.0,,,-20164.0,,2262683.0,,,1450161.0,2990326.0,,38797694.0,,,,,58388.28,56045895.0,,4799469.0,9123805.0,,42584.0,,3094.0,234.0,1550.0,,15.82,27.06,3065652.0,318234659.0,,,,5917.0,34999.0,245183.0,786167.0,856.0,7403.58,,,,,3233.0,2362485.0,5771491.0,,858731.0,,,,1280635.0,,233756.0,,,,,,303283.0,-176631.0,,1610543.0,,,,12684477.0,6010986.0,,864746798.0,,1924.28,-184595.0,,,,,574.0,,,,134.36,27999030.0,51618.98,1535753.0,,47379.0,,36.72,1270.0,55.79,,2520390.0,,83714.0,,1453875.0,-203877.0,,29820.0,,,1131585.0,,,1308364.0,,,,,20321.0,6291.0,,,13388.0,,18228.0,,5475.0,,,,,232694.0,10798170.0,6379299.0,216981.0,,,32158718.0,,7596007.0,,27590031.0,,182726673.0,,,3577751.44,1690915.0,2894.0,9.0,1540888.0,36,,,,,,,,,,,,,57305.0,,13138910.0,,79685652.0,,446644.0,,,4852166.0,,71905.0,,36923.0,,,,,20131627.0,40.49,6699312.0,,,139519.0,,,31379541.0,,,,,,167813.0,107356.0,,14506.0,,,,15171886.0,,,,,,,137125.0,622203.0,,1869.0,-188574.0,,19727280.0,1312086.0,297.0,,,2018-12-31,,44130-3497,,,6141975.0,448086.0,1308364.0,,,,12091603.0,7047621.0,6852761.0,,,,,,7319.0,,,,11549.0,48.63,,,,21719.92,22377513.0,,541521.0,550506.0,217821.0,119850425.0,,,,10758631.0,13125800.0,,228.0,,,,,,,106729.0,N,,,,44.0,994765.0,1221192.0,,763770,-1099.0,,10610929.0,Y,,OH,,42770310.0,,-5132365.0,12915.0,25396466.0,,,,,1413741.0,52.0,36.0,,5894697.0,18664.0,28868.0,,,11194755.0,,25452767.0,,,572319.0,131.0,,,,P,68.0,5132.0,,2401.0,,,,,,,4856.0,,,,21579.0,372001.0,,,5835770.0,,1393591.0,776.0,,,,,4094887.0,,,,,,-9514.0,,61.0,10843178.0,1.0,,,18697 BAGLEY ROAD,,36.3,ACUTE REHAB,,,,,,,,4005.0,,,38746.0,4700569.0,396.0,,38797694.0,,138.0,,,83714.0,,-94357.0,,,,,,,100387.0,,,,,,2007780.0,9.0,66477.0,,3468.0,,5550705.0,,,105393899.0,,,91418.0,466931.0,,,773241.0,147670.0,367253,1754.0,16076.0,38808.0,N,79891.06,307869.0,473734.0,,,,,,,-329324.0,,,,889.0,138.0,34936.0,40.0,29.34,139519.0,15201,,N,43152.0,726.0,,,3641257.0,,,,60099.0,1481274.0,,,9125405.0,,4.0,396373.0,4747635.0,17585411.0,,9.0,,299699510.0,2941.0,4426833.0,96674.0,,,159121.0,5.0,,3540.0,9302.0,,,,2168952.0,,,11794.0,,,,117.0,,14399461.0,139519.0,,6031143.0,,,,198984381.0,,,-32140.0,-3416876.0,8610531.0,,87.0,,9195.0,,43.0,,,,,,,,660717.0,,,,2277846.0,,,1070.0,4790808.0,3085745.0,1048687.0,,,,14847187.0,1536.0,20659597.0,,,,,6989.0,1833650.0,,1680229.0,334406771.0,3409341.0,,109438.0,1818415.0,,,,3296810.0,86583.0,,763400.0,,548765.4,52652269.0,362019.0,578286.0,4920085.0,1553930.0,,,,,,,,,,2448658.0,,,409973.0,51.53,,,90988.0,,,25756134.0,,,27.06,3985745.0,,,,,1185930.0,,,843488.0,,,,,-360.0,10166148.0,6226407.0,308277.0,102541.0,,,,19124138.0,,,,31.44,,7097301.0,2343838.0,,,7414.0,,,,,1561.0,,5400.0,,,,945617.0,1926248.0,,,1830201.0,,3111725.0,-16172112.0,,,,,4611581.0,,,,,,5118686.0,,,763400.0,1185930.0,2018-01-01 00:00:00,,,83714.0,13042.0,15.0,2613653.0,1416473.0,,86583.0,,12090179.0,1501334.0,,,,,677640.0,,,38645876.0,,,,,,9515118.0,,2.0,,,,53502.0,,,233448.0,,,,,,,95021.0,,,,,,17417.0,,40117.0,,5668304.0,1465451.0,,,56.0,,-577351.0,1899551.0,4409348.0,34339389.0,1175301.0,,,215928.0,,121.0,914346.0,,,,,,,,,,-797199.0,,2714.0,,3193884.0,54.76,,4662374.0,,10166148.0,,,,985560.0,2517713.0,-536257.0,,-4187689.0,,,,,12739647.0,18594053.0,434154.0,1447.0,,1926248.0,,,,973122.0,5198.0,9231940.0,22897773.0,,,5687618.0,3.0,3037494.0,,,,,,,5420364.0,,,,1644.0,,,1985628.0,,17460,,,5720837.0,,488954.0,,,,,5849139.0,,,,,General Short Term,302750686.0,5849139.0,,84812731.0,,,,85750.0,3162799.0,,,,,,4525.0,,,,,39351.0,11.0,19690412.0,,,109438.0,,,10798170.0,,,,,,,11639.0,,396448.0,12357.0,,12657561.0,2528361.0,7142097.0,,10530651.0,1689670.0,4543669.0,,,,1791.0,20598363.0,1263265.0,296099985.0,1279436.27,2393100.0,,12986.0,,,,36126.0,,,,,,16903.0,,8671118.0,,,,,5667064.0,25456125.0,7405550.0,146484.0,,,,,1.0,,907856.0,,,,,,,34221463.0,,1192347.0,229898194.0,,,60837.0,65954.14,,,,4699359.0,,29926565.0,1459813.0,,480.0,6255346.0,,,,,15754120.0,,,,396.0,,,4813263.0,,,111800692.0,25804.0,907770.0,,,,,,,6842476.0,,105.0,93654.0,,16090818.0,1526497.0,-63209.0,,,309.0,,1.0,,624461.0,,3621.0,,1048687.0,22.46,,,,,1119742.0,11639.0,,463089.0,1471980.0,,,,,3290872.0,,,,,,372001.0,907856.0,,,268746158.0,,571100.0,,,177536.0,,MIDDLEBURG HEIGHTS,23732.0,,,,688696.0,,248147.0,-36433.0,,1983941.0,208943.0,157.0,,,,,-82051.0,52763099.0,,,,110134.0,,,,,,1244191.0,,118.0,,,1438680.0,,2517713.0,,,-48479416.0,,3650.0,,,,-2911.0,,124032.0,,,522.0,12280.0,,85791.0,SWGHC MENTAL HEALTH SERVICES,,53905.0,,38808.0,7145.0,,,,85750.0,,25456125.0,,4305694.0,,5345982.0,2630788.0,3365592.0,586.0,7430536.0,37903.0,,,,,,,,,,37374262.0,,164563.0,316.0,,,15.0,,,1548765.0,,5550705.0,,,972979.0,,1941.0,2448372.0,,483754.0,,,30091.0,,,,,,,,,,,18877.0,,32735.0,2123586.0,,,90738.0,,2461786.0,1600.0,313724.0,,6.0,,5388439.0,140117.0,,,,,38808.0,,3409341.0,-200.0,14503895.0,112.0,,,,,,,,155384.0,,,,,305789.0,,,,422772.0,,644061.0,5730641.0,129347735.0,,1258826.0,1386863.0,,,675933.0,,,,40188962.0,,10600375.0,1780846.0,,5262197.0,12063608.0,,548765.4,,28828337.0,30.0,87.0,52679.0,,726.0,10908.0,37270.0,,,,45162.0,,7229514.0,,,16076.0,,,,,,,290.0,,,,,,,,,,,,,,,1438724.0,,35573.0,652805.0,,139.0,,,,,,,,177.0,,,,28363958.0,198984381.0,,,,,,138048.0,,,3926642.0,,,,,34811.0,,,,13726781.0,,M,1535753.0,6304828.0,,69761777.0,291022.0,,,3000556.0,,4699359.0,13128.0,,,3466573.0,SOUTHWEST GENERAL HEALTH CENTER,2159170.0,,13504.0,141678.0,,,,,,,5667064.0,4333984.0,15503777.0,,1099.0,,,-1268050.0,,,,9302.0,,,1481274.0,182726673.0,12443232.0,,,10554866.0,Y,,,1169.0,,,497046741.0,3612521.0,14808626.0,2588.0,1779397.0,34255.79,2158863.0,,,12416054.0,,,,347091248.0,,,,119.0,2163.0,,,,2261471.0,,,1156756.0,14535.0,36229.0,,,,,27257.0,,-8852.0,,,38748830.0,2123586.0,,31379541.0,22344910.0,,,,,33.75,,14503895.0,,,,,,,,,,,,,,,,,,,,31284481.0,,,,35573.0,,,9515118.0,116621.0,,141509428.0,,,,,4150000.0,1690915.0,141714.0,95.0,,,15451692.0,2138452.0,19976.0,,2343838.0,15736912.0,5136349.0,58.0,14506.0,,,,,526893.0,219388137.0,18162235.0,,,107351.0,10613.0,3358.0,3122.0,,,10712546.0,,13298613.0,,,15.63,,,,,,2024-02-14 00:00:00,,,,,138434.0,,,,,,30486571.0,,,,,,985560.0,,,,,,8050977.0,166468.0,,4104796.92,5644576.0,,,172685.0,,,94862.0,6424695.0,,,,,,,,12083052.0,,,18319.0,,,,,,,,,88225.0,,,,,1160.0,,,2486588.0,,,6524393.0,,,6485228.0,2159170.0,,,,,,126647879.0,,1045224.0,,13841150.0,,,161239.0,,3.0,,,,2637785.0,,,36S155,,,859417.0,,,,45315.0,,4937760.0,,,32928896.0,,,,,,,,,52745.0,,288064.85,48034134.0,,,,,,590.0,,,2314709.0,2069022.0,,6462624.0,,22972848.0,,,,941668.0,,572990.0,,,,1656.68,743.0,,3969.0,N,926718.0,,9649574.0,,1614038.0,,,27580.0,,,3425730.0,,126503296.0,,15.0,1189.0,29647.0,,,,6382038.0,116739.0,,Y,37767.0,,,,348.0,25756272.0,1018649.0,,303505.0,,,10713361.0,1579789.0,,,,706.0,1361793539.0,3833018.0,,,,,8050977.0,,15.81,,,19377358.0,,77.85,20.0,4886.0,310246.0,,,37427156.0,,,36.64,,,,-308169.0,,,2465688.0,395565.0,,531473.0,,,,43152.0,,,3.0,3386958.0,1211705.0,5798.0,,,4700569.0,,,361530,3255719.0,1447.0,,,,,106787.0,,,233.0,131615.0,-2631.0,,,,157.0,,,,7955477.0,10.0,95831.0,10745441.0,455.0,19690412.0,1062466.0,284407.0,,,,,,,,,14219328.0,,N,,,477584.0,28861.0,,2796.0,13026.0,,132.0,N,325279.0,,,1465451.0,4747635.0,15977880.0,303774.0,,5345982.0,,3701207.0,1913728.0,,,,1029191.0,271.0,,,,926718.0,14219328.0,,6798.0,3290766.0,,,,,706.0,,,,,,,,,1452162.0,,,,,40188962.0,,1443.0,21864145.0,1016487.0,,2149697.0,,6267.39,,495108300.0,,,,1198004.0,28159.0,796675.0,,,1501334.0,53259.0,2588.0,,,,11526.0,,4167093.0,1070.0,,20374.0,478324.0,24551502.0,25342038.0,5.0,,,223419.0,,,2018,Acute Care Hospitals,SOUTHWEST GENERAL HEALTH CENTER (360155)
57624,SOUTHWEST GENERAL HEALTH CENTER (360155),General Short Term (Acute Care Hospitals),Voluntary Nonprofit-Other,-81.83291,41.37208,,,,,1199362.0,342518721.0,68870.0,16021594.0,,3128535.0,,156621.0,,,620106.0,1343929.0,35411270.0,1674255.0,800.0,,,29246926.0,9167.0,7382585.0,,,126951.0,236330.0,,2504638.0,299334.0,472904734.0,,13311160.0,,,,,,,,-20356.0,2381793.0,,,,,50.0,,,11066.0,,339606.0,,,,,-969993.0,1127491.0,-899674.0,,1001837.0,9081538.0,,2584784.0,1210032.0,58322105.0,49783.0,,11.0,3916781.0,635190.0,488096.0,161036.0,,,,,,1127948.0,5676855.0,,,0.224582,1.0,510608.0,,,,14556.0,7383428.0,4778634.0,,2584784.0,13604011.0,11708457.0,1.0,2593394.0,,,,,116476178.0,368708.0,3778238.0,,-134471.0,264.0,,,,,,665339.0,,,39.0,3609.0,879863.0,69541942.0,,,,10820652.0,,,,,,,,,,,2464660.0,,10608882.0,,,,,-414.0,262022.0,12138599.0,2138111.0,322334249.0,,160.0,,20971740.0,,8087821.0,,,-1920.0,,164668.0,-1008168.0,120246222.0,,,,,,936.0,51830.0,,,17.41,,,31.66,5057.0,,13313483.0,,88078.0,,,,35.03,,,,,,5.0,,,,,,,13635.0,,3.0,,,,,16260504.0,171383.0,,,,329099.0,,,4475758.0,,973758.0,,10182.0,,291430.0,38849.0,,,,,295525.0,11228.0,,122945.0,,,,24218734.0,,,,,,,,,-722992.0,-5427173.0,,11297489.0,6933910.0,,,34102599.0,,,4974412.0,17.0,,,,,,4038228.0,,,,50422.06,5765327.0,4183515.0,6237921.0,,N,,,,3803757.0,800.0,,243.0,79016.0,,,,,,,41343002.0,,,,,,,,,,1197247.0,,3709386.0,3678920.0,2749038.0,2574953.0,,,7685250.0,,,,,3612857.0,,,33659031.0,,,,33810901.0,1072466778.0,,,,,,,,,,1957247.0,N,,7.0,37353.0,-969993.0,1833.71,CUYAHOGA,-34388.0,,,,9204504.0,,-485650.0,151512030.0,,,,,69671.0,,2093747.0,,,,31945.0,,321.0,,,,7859869.0,,,,,,,,1680,251.0,,,17519.0,,,1061559.0,,354097.0,,,,15754120.0,,532276123.0,361410.0,92846.95,,151565069.0,634098.0,,65849.0,3171431.0,1751.0,,,,,,,,31243.0,-21126231.0,,17671339.0,,3601.0,,2336295.0,2381793.0,1513650.0,,803.0,63424.0,1237630.0,906744509.0,41343002.0,,,,,4475758.0,,2749038.0,,,,,,,-1224.0,,,,,,3487636.0,,16329.0,,1363180.0,14600.0,4495.0,36T155,,,,,,40064577.0,,6191186.0,1983687.0,,69671.0,,10378782.0,,77665.0,7837150.0,,,,,410221.0,,,,123292487.0,,,,1159.0,N,,-44121.0,235.0,39.0,,1909866.0,495218.0,,,,,,439907.0,1821630.0,4045.0,,12204047.0,,,644528.0,4,33.7,,1671980.0,,215394.0,20235802.0,,3798323.75,,280041.0,19.07,,,,7665.0,1597940.0,N,,468942297.0,,,,,,,,14910843.0,,302422825.0,,360155,82.0,,,,,,,4859525.0,,,,,,,,,67.27,,,,13500813.0,,984208.0,,,,,5079850.0,,122781.0,,,-5670.0,,,,47.0,1349.0,,,,,,17385.0,5595.0,,,871532.0,1.0,,,13518121.0,97479183.0,8017.44,,,,,22448.0,814024.0,,,,,,,20091.0,39515.0,,3249037.0,,,21229.0,,,,,,,,,,,758690.0,4183515.0,,,,,,,,,,2686608.0,,15922707.0,,423.0,,7394386.0,,,,,-221895.0,6470597.0,,,38440.0,44683983.0,2313586.0,524724.0,2154444.0,,,431310.0,43043012.0,,4920582.0,,68665.0,,127005532.0,,500.0,,,5711789.0,215153070.0,,3562653.98,F,696343.0,2653533.0,,,,,16799.0,,399.0,,,-597637.0,20235802.0,3524829.0,422013.0,914.0,4273255.0,13961398.0,,,19131061.0,,,,200.0,,22361.65,696343.0,,,3101275.0,,11.0,,6255346.0,1216595.0,,,,,879863.0,N,,,5496099.0,855056.0,,,,,-6370.0,,,,,217331144.0,,,-2311.0,,,,,,28.64,,,5048.0,35964008.0,,,,4983816.0,31866170.0,,,7665.0,2952550.0,,,,,12554.0,1389192.0,,,,,,478466.0,10126674.0,383621.0,,1686668.0,,,,-10742.0,,,,,15900120.0,,14.7,,1972756.0,1821630.0,1245151.0,,,,,,,,12462931.0,15304589.0,1831100.0,,,,2.0,,,1758556.0,47583.0,,,,2654.0,,-414.0,2483.23,7665.0,,,,,,296832.0,29.04,,261054994.0,,,,,,,33810901.0,,,,410040.0,,1205259.0,244381528.0,,7577606.0,6383.0,1865875.0,36170,,3160141.0,,5331493.0,,,,181.0,,14809389.0,,,,,1435264091.0,,45.31,,,,,,4414417.0,1281170.0,20624499.0,,,,,,,,,,,,,,401443.0,,,,,,,2238383.0,,23120.0,13.0,,,,,21729.0,,,36.0,-49234.0,,4587439.0,51.0,,,,1280312.0,,714.0,15856406.0,165856.0,16952893.0,,,,,2611958.0,,,,22863149.0,3635765.0,,111810.3,37353.0,764004.0,,,,,,,,34171428.0,,182.0,,,,326.0,3128535.0,,,,,360740.0,2386978.0,1907514.0,1085575.0,,2045528.0,43005.0,32.06,,,170424210.0,,,16489538.0,,17646785.0,,,505116.0,,,,-97393.0,-9178030.0,,,15478.0,,,4749.0,51913.0,,8842676.0,,,,,,1736826.0,13500813.0,,126574.0,311986.0,4.0,,,,1374415.0,614180.0,81520.0,1588116.0,,,,,N,13977928.0,923851.0,,25699634.0,,,644528.0,,,13140.0,,16329.0,,7463602.0,,,,,,,,10608882.0,,,,,Y,,79710.0,7986.0,,,,27715.0,,87049.0,38569.96,,6620056.0,,-11401.0,3987489.0,1.0,,171931.0,,,239574.0,,,,17919863.0,2.0,2715066.0,,9.0,,13313483.0,,,,,6667.0,251504.0,95683.0,3048.0,119519324.0,,,,629809.0,,311986.0,,119519324.0,,,2642791.0,,3156842.0,,,966004.0,,,,1255416.0,31802775.0,,,15848.0,639139.0,69129119.0,6089120.0,,,,,866.0,,,,92550.0,,,-21938.0,,1971387.0,,,1391186.0,2447977.0,,39413566.0,,,,,58388.28,56782797.0,,5066621.0,9125405.0,1.0,41549.0,,5590.0,286.0,2343.0,,16.38,27.94,3057664.0,342518721.0,,,,16799.0,37353.0,267731.0,870418.0,865.0,6546.0,,,,,2700.0,2272002.0,5775829.0,,870396.0,,,,1251486.0,,213622.0,,,,,,346208.0,-236774.0,,1554405.0,,,,3642672.0,6448456.0,,909107451.0,,2293.53,-196295.0,,,,,,,,,147.57,30343284.0,51618.98,1689217.0,,46750.0,,50.64,2034.0,55.19,,2385930.0,,92121.0,,1577148.0,-103898.0,,26287.0,,,1210032.0,,,1411186.0,,,,,23851.0,4311.0,,,14455.0,,,,5475.0,,,,,217869.0,11181547.0,7409546.0,309203.0,,,34102599.0,,9081538.0,,28010632.0,,184916421.0,,,3577217.42,1277990.0,3096.0,3440.0,1676818.0,36,,,,,,,,,,,,,51830.0,,12462931.0,,77730532.0,,439108.0,,,4974412.0,,66430.0,,11835.0,,,,,21827898.0,42.35,3024601.0,,,171383.0,,,33810901.0,106.0,,,,,148505.0,118209.0,4.0,14977.0,,,,15401229.0,,,,,,,147862.0,674543.0,,4814.0,-118454.0,,23658035.0,1504663.0,579.0,,,2019-12-31,,44130-3497,,,5624547.0,414512.0,1411186.0,,,,7167818.0,7502021.0,6957816.0,,,,,,7665.0,,,,65553.0,38.91,,,,14563.44,18423327.0,,557880.0,471453.0,192049.0,130576000.0,,,,10820652.0,14583804.0,,215.0,,,,,,,129176.0,N,,,,43.0,966004.0,1134474.0,,763771,-1224.0,,10838738.0,Y,,OH,,44356130.0,,-10316571.0,3414.0,24983157.0,,,,,1527343.0,,36.0,,5676579.0,18254.0,29861.0,7151624.0,,8891288.0,,25924039.0,,,549210.0,1415.0,,,,P,,6383.0,,4020.0,,,,,,,5203.0,,,,15253.0,394685.0,,,5927602.0,,1372879.0,626.0,,,,,4307935.0,,,,,,-10997.0,,94.0,12006746.0,1.0,,,18697 BAGLEY ROAD,,36.13,ACUTE REHAB,,,,,,,,5265.0,,,,5085120.0,18287.0,,39413566.0,,-25.0,,,92121.0,,-74839.0,,,,,,,100187.0,,,,,,2234524.0,19.0,49265.0,,3877.0,,5513377.0,,,123456890.0,,,73548.0,480199.0,,,880611.0,130913.0,367253,1521.0,15478.0,31266.0,N,79891.06,257530.0,546147.0,,,,,,,-271324.0,,,,665.0,121.0,31945.0,40.0,30.85,171383.0,15201,114194189.0,N,26266.0,29457.0,,,3147827.0,,,,60439.0,1513650.0,,,9216800.0,,4.0,422013.0,4791093.0,18661537.0,,,,322725717.0,3504.0,4111388.0,80949.0,,,123180.0,5.0,,3609.0,10410.0,,,74574011.0,2318693.0,,,18734.0,,,,,,13548184.0,171383.0,,12256746.0,,,,221652817.0,,,-46684.0,-3582368.0,8165700.0,,14.0,,10682.0,,164.0,,,,,,,,744150.0,,,,2504638.0,,,1577.0,4494283.0,3057664.0,1214106.0,,,,14809389.0,1598.0,21680795.0,,,,,8.0,1911805.0,,1724682.0,363644952.0,3916781.0,,99908.0,1815738.0,,,,3782310.0,,,672649.0,,530096.01,63152539.0,389279.0,589226.0,5331493.0,1684819.0,,,,,,,,,,1925831.0,,,226236.0,44.92,,,80997.0,,,26236193.0,,,27.94,3835960.0,,,,,1303589.0,,,951279.0,,,,,-2311.0,10608882.0,7359984.0,350303.0,118446.0,,,,34464868.0,,,,32.68,,7221044.0,2464660.0,,,7665.0,,,,,6336.0,,10182.0,,,,1127491.0,1869255.0,,,1821630.0,,2672837.0,-21126231.0,,,,,7428774.0,,,,,,5099732.0,,,672649.0,1303589.0,2019-01-01 00:00:00,,,92121.0,8001.0,,2313586.0,1953198.0,,,,25129427.0,1283046.0,,,,,1732871.0,,,43975592.0,,,,,,8904896.0,,793.0,,,,51650.0,,,150342.0,,,,,,,93724.0,,,,,,8480.0,,51574.0,,6237921.0,2523897.0,,,103.0,,-619368.0,1994292.0,2040403.0,44463657.0,1216595.0,,,238034.0,,231.0,1012940.0,,,,,,,,,,-1016171.0,,2654.0,,3371569.0,54.41,,4628984.0,,10608882.0,,,,984208.0,6225958.0,-507659.0,,-6653376.0,,7151624.0,,,11993832.0,13864691.0,465241.0,1265.0,,1869255.0,,,,1029410.0,4962.0,6433870.0,26027643.0,,,6200036.0,7.0,3171431.0,,,,,,,5184242.0,,,,1584.0,,,1884492.0,,17460,,,5785440.0,,449707.0,,,,,6745839.0,,,,,General Short Term,325412325.0,6745839.0,,81665858.0,,,,59227.0,3336759.0,,,,,,4495.0,,,,,38849.0,,20212740.0,,,99908.0,,,11181547.0,,,,,,,11449.0,,279298.0,7175.0,,38682065.0,2054273.0,7267147.0,,11708457.0,1608658.0,4472983.0,,,,1517.0,16021594.0,1318772.0,299858993.0,1266230.88,2399143.0,,14305.0,,,,23146.0,,,,,,13856.0,,9153309.0,,,,,6127216.0,25937929.0,7880030.0,139573.0,,,,,,,249727.0,,,,,,,35964008.0,,1255416.0,280186055.0,,,77665.0,65954.14,,,,4804429.0,,30734871.0,1399470.0,,,6255346.0,,,,,15688568.0,,,,18287.0,,,5079850.0,,,116423139.0,27.0,249013.0,,,,,,,1316912.0,,85.0,97177.0,,16918486.0,1554893.0,-85537.0,,,10328.0,,1.0,,764004.0,,3601.0,,1214106.0,22.95,,,,,1245074.0,11449.0,,186500.0,1579632.0,,,,,3140563.0,,,,,,394685.0,249727.0,,,287894595.0,,538020.0,,,182682.0,,MIDDLEBURG HEIGHTS,23120.0,,,,671460.0,,238638.0,-48654.0,,2035483.0,294876.0,142.0,,,,,-35814.0,53541959.0,,,,128394.0,54.0,,,,,1715651.0,,,,,1712216.0,,6225958.0,,,-57970030.0,,3650.0,,,,6205.0,,114225.0,,,475.0,19938.0,,87199.0,SWGHC MENTAL HEALTH SERVICES,16.0,65550.0,,31266.0,7986.0,,,,59227.0,,25937929.0,,3862479.0,,3216003.0,2450186.0,4038228.0,1074.0,9253958.0,36495.0,,,,,,,,,,40563910.0,,211212.0,,,,15.0,,,1908726.0,,5513377.0,,,960994.0,,2471.0,2496173.0,,796821.0,,,,,,,,,,,,,,21505.0,,237696.0,1675852.0,,,60344.0,,1934546.0,91395.0,359083.0,,11.0,,4920582.0,171931.0,,,,,31266.0,,3916781.0,-200.0,21655519.0,,,,,,,,,132383.36,,,,,268006.0,,,,356847.0,,380295.0,7906777.0,130796446.0,,1237230.0,1588116.0,,,631559.0,,,,41343002.0,,11496415.0,1666343.0,,5867227.0,11297489.0,,530096.01,,34863750.0,27.0,256.0,46407.0,,29457.0,6781.0,36593.0,,,,49783.0,,7459415.0,,,15478.0,,,-414.0,,,,304.0,,,,,,,,,,,,,,,1712216.0,,37353.0,676097.0,,61.0,,,,,,,,181.0,,,,26904675.0,221652817.0,,,,,,145517.0,,,3842761.0,,,,,36920.0,,,,,,N,1689217.0,7463602.0,,66241778.0,290451.0,,,2458356.0,,4804429.0,8715.0,,,3633591.0,SOUTHWEST GENERAL HEALTH CENTER,2216445.0,,9815.0,120136.0,,,,,,,6127216.0,4273255.0,15058668.0,,2067.0,,,-1089137.0,,,,10410.0,,,1513650.0,184916421.0,13401898.0,,,11739532.0,Y,,,970.0,,,530646951.0,3770057.0,13977928.0,2776.0,2138111.0,34255.79,2238383.0,,,13539893.0,,,,367287624.0,,,,,,,,,2094334.0,,,1159429.0,13325.0,9211.0,,,,,25269.0,,-3039.0,,,39555376.0,1675852.0,,33810901.0,17324043.0,,,,,32.67,,14503895.0,,,,,,,,,,,,,,,,,,,,31857866.0,,,,37353.0,1208.0,,8904896.0,111292.0,,152070321.0,,,,,4470957.0,1277990.0,,,,,16296115.0,1669728.0,19464.0,,2464660.0,15304589.0,5711789.0,43.0,14977.0,,,,,567667.0,244125628.0,18134640.0,,,126574.0,12875.0,13890.0,2413.0,,,12434238.0,,16489538.0,,,12.59,,,,,,2024-02-14 00:00:00,,,,,153428.0,,,,,,33139190.0,,,,,,984208.0,,,,,,5914902.0,179917.0,,4092749.99,5836884.0,,,182111.0,,,141958.0,6399641.0,,,,,,,,12204047.0,,,21229.0,,,,,,,,,99976.0,,,,,1252.0,,,2539212.0,,,6470597.0,,,7002147.0,2216445.0,,,,,,131232528.0,,1205259.0,,13756350.0,,,185017.0,,3.0,,154.0,,3129195.0,,,36S155,,,803954.0,,,,38091.0,,5122573.0,,,34139483.0,,,,,,,,,44954.0,,288064.85,54664690.0,,,,,,,,,3795267.0,2181060.0,,6265667.0,,22863149.0,,,,1121875.0,,665339.0,,,,1672.26,784.0,,4503.0,N,584844.0,,9641651.0,,2194781.0,216.0,,20908.0,,,3128535.0,,130505630.0,,,1078.0,36443.0,,,,6881323.0,113126.0,,Y,33621.0,,,,305.0,26236168.0,960042.0,,312129.0,,,12435053.0,1393302.0,,,,558.0,1439754402.0,4048321.0,,,,,5914902.0,,16.29,,,20624499.0,,87.75,,1440.0,335929.0,,,40618902.0,,,40.75,,,,-298160.0,,,2241600.0,431310.0,,495218.0,,,,26266.0,,,,3242064.0,1255461.0,1537.0,,,5085120.0,114.0,,361530,3604511.0,1265.0,,,,,109116.0,,,256.0,11121.0,-2714.0,,,,142.0,,,,7751748.0,10.0,149483.0,10857448.0,489.0,20212740.0,939907.0,225201.0,,,,,,,,,14029452.0,,N,,,436805.0,7595.0,,2779.0,20839.0,,123.0,N,318975.0,,,2523897.0,4791093.0,17919863.0,296832.0,,3216003.0,,3620362.0,1865875.0,,1208.0,,912169.0,,,,,584844.0,14029452.0,,6950.0,2952550.0,,,,,558.0,,,,,,,,,5285860.0,,,,,41343002.0,,2155.0,23238991.0,1144847.0,,2138909.0,,6267.39,,528519582.0,,,,1373795.0,29688.0,697982.0,,,1283046.0,52060.0,2776.0,,,,5041.0,,3936830.0,515.0,14.0,7761.0,478466.0,18233204.0,42324737.0,7.0,,,230413.0,,,2019,Acute Care Hospitals,SOUTHWEST GENERAL HEALTH CENTER (360155)
61618,SOUTHWEST GENERAL HEALTH CENTER (360155),General Short Term (Acute Care Hospitals),Voluntary Nonprofit-Other,-81.83291,41.37208,,,,,1175441.0,336509287.0,69998.54,13075674.0,,3025740.0,,136655.0,,,628561.0,1034799.0,34636369.0,1467281.0,698.0,,,30104995.0,2558.0,6714196.0,,,124525.0,151669.0,,2298631.0,254266.0,486292997.0,,10997594.0,,,,,,,,-9840.0,2246016.0,,,,,96.0,,,14714.0,,337996.0,,,,,-1425434.0,1572158.0,-704536.0,,1007167.0,8082115.0,,2438775.0,1061752.0,47335893.0,27613.0,,8.0,3667801.0,891449.0,514316.0,182586.0,,,,,,1212857.0,5691726.0,,,0.245652,1.0,561416.0,,,,4954.0,7052443.0,5641682.0,,2438775.0,12388637.0,12038632.0,1.0,2141422.0,,,,,112851451.0,388097.0,4237931.0,,-145147.0,173.0,,,,,2284020.0,618058.0,,4860.0,21.0,3143.0,853075.0,79655909.0,,,,10320464.0,,,,,,,,,,,2498550.0,34.0,11371956.0,,,,,,378753.0,12905725.0,1371454.0,317314190.0,,203.0,,15658334.0,,6940857.0,,,-2160.0,,142154.0,-786301.0,117755146.0,,,,,,278.0,56730.0,,,18.47,,,32.3,4877.0,,13190974.0,,80467.0,,,,35.13,,,,,,5.0,,,,,,,10274.0,,2.0,,,,,17172258.0,156326.0,,,,302110.0,,,3821542.0,,948421.0,,9392.0,,421391.0,39196.0,,,,,299309.0,6706.0,,138281.0,,,,21271328.0,,,,,,,,,-240865.0,-5614227.0,,11674092.0,6739485.0,,,31692230.0,,,4399420.0,107.0,,,,,,4275894.0,,,,48408.56,6876467.0,3336978.0,5844384.0,11952.0,N,,,,3490752.0,698.0,,251.0,94683.0,9.0,,,,,,47459602.0,,,,,,,,,,882519.0,,3709428.0,3450450.0,1920595.0,11891476.0,,,8820280.0,,,,,3508354.0,,,28695275.0,,,,32101250.0,943994572.0,,,,,,,,,,2070025.0,N,,3.0,41975.0,-1425434.0,1750.06,CUYAHOGA,-40917.0,,,,14074897.0,,-330776.0,146239472.0,,,,,67345.0,,2259983.0,2.0,,,38492.0,,187.0,4891.0,,,10336912.0,,,,,,,,1680,363.0,,,19166.0,,,918525.0,,267533.0,,,,15688567.0,,593328591.0,341046.0,81551.5,,146533073.0,590500.0,,57302.0,2691125.0,2157.0,,,,,,,207.0,25270.0,-19396046.0,,16254494.0,,3089.0,,2226922.0,2246016.0,1449480.0,,2703.0,84217.0,1264668.0,785348871.0,47459602.0,,,,,3821542.0,,1920595.0,,,,,,,-1455.0,,,,,,3306161.0,,13466.0,,1431857.0,12078.0,4021.0,36T155,,,,,,38438180.0,,5676378.0,1526967.0,,67345.0,,7188510.0,,78110.0,8403460.0,,,,,389512.0,,,,88788727.0,,,,2167.0,N,,-50945.0,4083.0,283.0,,1916284.0,354917.0,,,,,,333128.0,1982936.0,3996.0,,9746840.0,,,543926.0,2,37.1,,1729850.0,,206619.0,15304732.0,,3645139.97,,181754.0,19.87,,,,8600.0,1553744.0,N,,484114923.0,,,,,,,,15203297.0,,314303122.0,,360155,72.0,,,,,,,4915051.0,,,,,,,,,53.89,,,,12478737.0,,946223.0,,,,,5072295.0,,138232.0,,,-19342.0,,,,97.0,324.0,,,,,,18895.0,7043.0,,,888757.0,1.0,,,14073757.0,95095914.0,14359.24,,,,,24228.0,736379.0,,,,,,,15545.0,27977.0,,3030987.0,,,4757.0,,,,,,,,,,,1311092.0,3336978.0,,,,,,,,,,3485743.0,,9489276.0,,,,6761523.0,,,,,-210560.0,6013798.0,,,67502.0,49448228.0,1939724.0,149621.0,2247280.0,,,341631.0,43329440.0,,3747164.0,,57858.0,,130414801.0,,604.0,,,4144050.0,213897449.0,,3410671.24,F,526727.0,2972364.0,,,,,3567.0,,34.0,,,-360418.0,15304732.0,3351097.0,243789.0,1123.0,3013960.0,14745033.0,,,18555525.0,,,,177.0,,21876.28,526727.0,,,17340267.0,,,,6255346.0,1187246.0,,,31899.0,,853075.0,N,,,5863019.0,589082.0,,,,,-4076.0,,,,,216075523.0,,258.0,40.0,,,,,376.0,28.79,,,8408.0,37378376.0,11744.0,,,6933941.0,28811312.0,,,8600.0,1676411.0,,,,,8668.0,1214897.0,,,,,,305991.0,9752189.0,317242.0,,1675506.0,,,,-10767.0,,,,,6647461.0,,15.07,,1893830.0,1982936.0,941986.0,3234.0,,,,,,,9109151.0,15350685.0,2142401.0,,,,7.0,,,1539895.0,57984.0,,,,2222.0,,,2138.25,8600.0,,,,,,330978.0,28.52,,294989264.0,,,,,,,32101250.0,,,,404035.0,,858852.0,250466758.0,,8156239.0,497.0,1941707.0,36170,,2646655.0,,5900176.0,,,,183.0,,14132867.0,,,,,1291719872.0,,43.89,,,,,,2886157.0,1289546.0,20168068.0,,,,,,,,,,,,,,639139.0,,,,,,,1924356.0,,20963.0,452.0,,,,,19618.0,,,26.0,-39235.0,,4828570.0,141.0,,,,1486773.0,,2196.0,15662079.0,146108.0,15872015.0,,,,,1859349.0,,,,22552205.0,3337264.0,,115270.06,41975.0,552448.0,,,,,,,,32045071.0,,188.0,,,,436.0,3025740.0,,,,,316808.0,,1769773.0,918525.0,,2137685.0,33989.0,32.43,,,169961026.0,,,22855656.0,,16229940.0,,,313792.0,,,,-116667.0,-9057187.0,,,13491.0,,,4576.0,49662.0,,8096578.0,,,,,,1356208.0,12478737.0,,131089.0,685307.0,1.0,,,,1316574.0,926158.0,78357.0,1610637.0,1.0,,,,N,8617956.0,969386.0,,22605784.0,,,543926.0,,,13908.0,,13466.0,,7152150.0,,,,,,,,11371956.0,,,,,Y,,59445.0,5190.0,,,,30693.0,,83301.0,36519.34,,6302472.0,,4270.0,3226113.0,1.0,,156469.0,,,354525.0,,,,14765077.0,5.0,2661732.0,,,,13190974.0,,,,,1569.0,254730.0,98259.0,3986.0,117307847.0,,,,582686.0,,685307.0,,117307847.0,,,2961597.0,,3080671.0,,,895065.0,,,,1214254.0,27278264.0,,16029.0,22958.0,666511.0,59908397.0,5655454.0,,,,,722.0,,,,74872.0,,,-15975.0,,1949811.0,,,1438473.0,2389234.0,,33875853.0,,,,,60090.83,48103034.0,,5059363.0,9216800.0,,42303.0,,4914.0,44.0,1740.0,,17.33,28.49,2123751.0,336509287.0,,,,3567.0,41975.0,265074.0,842312.0,1005.0,6126.25,,,,,3107.0,2193126.0,5373818.0,,867339.0,,,,1087164.0,,173381.0,,,,,,516328.0,-261961.0,,1175793.0,,,,-3907482.0,6030880.0,,787459684.0,,2304.73,-76605.0,,,,,,,,,146.1,32663395.0,47629.0,1747144.0,,44628.0,,45.91,1971.0,56.88,,2299913.0,,97986.0,,1470043.0,,,4329.0,,,1061752.0,,,1385062.0,,,,,24155.0,10629.0,,,18607.0,,39494.0,,5490.0,,,,,203631.0,10925494.0,5567520.0,428989.0,7.0,,31692230.0,,8082115.0,,25847481.0,,153386861.0,,,3431156.73,1580372.0,675.0,5439.0,1484213.0,36,,,,,,,,,,,,,56730.0,,9109151.0,,62155110.0,,483096.0,,,4399420.0,,68808.0,,-85698.0,,,,,24172649.0,42.62,13348819.0,,,156326.0,,-12.0,32101250.0,64.0,,,,,144066.0,86133.0,19.0,14111.0,,,,15135553.0,,,,,,,197921.0,436512.0,,1270.0,-56924.0,,19904535.0,1451965.0,5189.0,,,2020-12-31,,44130-3497,,,4489554.0,449253.0,1385062.0,,,,5579095.0,6097359.0,6723883.0,,,,,,8600.0,,,,3980269.0,47.73,,,,20485.49,15502656.0,,454931.0,437420.0,172355.0,132982617.0,,,,10320464.0,11538334.0,,211.0,,,,,,,96468.0,N,,,2.0,93.0,895065.0,1188754.0,,760896,-1455.0,,15260193.0,Y,,OH,,42350198.0,,-9162907.0,6781.0,23127548.0,,,,,1198016.0,1.0,38.0,,6207509.0,16641.0,29795.0,623376.0,,7745185.0,,22437797.0,,,500384.0,4721.0,,,,P,,497.0,,3051.0,,,,,,,1969.0,,,,4278.0,372061.0,,,4913261.0,,1438874.0,238.0,,,,,4266109.0,,,,,,-10657.0,,14.0,11406083.0,1.0,,,18697 BAGLEY ROAD,,40.96,ACUTE REHAB,,,,,,,,28901.0,,,12946.0,4694837.0,,,33875853.0,,178.0,,,97986.0,,-64010.0,,,,,,,98003.0,,,,,,1901180.0,52.0,55459.0,,4127.0,,7624910.0,,,106601553.0,,,10891.0,357365.0,,,748911.0,106534.0,367253,2180.0,13491.0,33847.0,N,79635.84,220722.0,496181.0,,,,,,,-270129.0,,,,4113.0,223.0,38492.0,33.0,31.37,156326.0,15201,121614989.0,N,22682.0,31683.0,,,2593342.0,,,,75437.0,1449480.0,,,9372171.0,,6.0,243789.0,4231255.0,17277263.0,,,,317656984.0,260.0,3542653.0,79224.0,,,119537.0,5.0,,3143.0,8244.0,,,68286476.0,2257259.0,,,13921.0,,,,,,12344496.0,156326.0,,10887326.0,,,,258172674.0,,,-20805.0,-3381497.0,7703662.0,,50.0,,6052.0,,49.0,,,,,,,,632262.0,,,,2298631.0,,,1390.0,4600822.0,2123751.0,787130.0,,,,14132867.0,1694.0,17270402.0,,,,,57.0,2263562.0,,1732641.0,355905333.0,3667801.0,,83128.0,1934947.0,,,,3541512.0,31899.0,,698811.0,,496041.33,50614967.0,353296.0,512756.0,5900176.0,1497828.0,,,,,,,,,,1723107.0,,,102054.0,42.75,,,83068.0,,,22669906.0,,,28.49,3904304.0,,,,,908114.0,,,820973.0,,,,,40.0,11371956.0,6487128.0,352365.0,105207.0,,,,18966261.0,,,,33.0,,8383594.0,2498550.0,,,8600.0,,,,,,,9392.0,,,,1572158.0,1606244.0,,,1982936.0,,2041554.0,-19396046.0,,,,,6802440.0,,,,,,4861704.0,,,698811.0,908114.0,2020-01-01 00:00:00,,,97986.0,13615.0,,1939724.0,1676432.0,,31899.0,,39319858.0,1078020.0,,,,,1572152.0,,,42761013.0,,,,,,7300603.0,,1256.0,,,,67102.0,,,128085.0,3332.0,,,,,,126799.0,,,,,,17676.0,,36552.0,,5844384.0,1945291.0,,,95.0,,-623381.0,1924213.0,2196182.0,34728217.0,1187246.0,,,230213.0,,31.0,933281.0,,,,,,,,,,-1144188.0,,2222.0,,3024730.0,54.27,,4562472.0,,11369210.0,,,,946223.0,4477191.0,-2417370.0,,-4019797.0,,623376.0,,,12200819.0,13912433.0,621201.0,1233.0,,1606244.0,,,,678289.0,4235.0,10158061.0,28311686.0,,,5731758.0,4.0,2691125.0,,,,,,,4535595.0,,,,2015.0,,,1955099.0,,17460,,,5486555.0,,426382.0,,,,,6390722.0,,,,,General Short Term,321142727.0,6390722.0,,109822776.0,,,,83681.0,3072505.0,,,,,,4021.0,,,,,39196.0,2.0,16024085.0,,,83128.0,,,10925494.0,,,,,,,11433.0,,142162.0,7689.0,,33210655.0,2726034.0,8435220.0,,12038632.0,1913303.0,4874542.0,,,,4035.0,13075674.0,1264344.0,302422825.0,1205430.73,2682852.0,,9715.0,,,,37589.0,,199.0,,,,10612.0,,8824351.0,,,,,5855212.0,22449684.0,6842266.0,114655.0,,,,,,,241090.0,,,,,,,37378376.0,,1214254.0,313544789.0,,,78110.0,62723.25,,,,4421979.0,,32052599.0,1422255.0,,47.0,6255346.0,,,,,11708298.0,,,,,,,5072295.0,,,112557850.0,161.0,238894.0,,,,,,,17340267.0,,93.0,89040.0,,16396826.0,1720726.0,-30521.0,,,8789.0,,3.0,,552448.0,,3089.0,,787130.0,23.11,,,,,1182579.0,11433.0,,4369928.0,1697933.0,,,,,3145217.0,,,,,,372061.0,241090.0,,,342861833.0,,264307.0,,,165474.0,,MIDDLEBURG HEIGHTS,20963.0,,,,959887.0,,354247.0,-21608.0,,2042628.0,240937.0,155.0,,,,,-118670.0,47101253.0,,,,82807.0,85.0,,,,,1451280.0,,,,,1074547.0,,4477191.0,,,-52504684.0,,3660.0,,,,-9055.0,,81953.0,,,,15609.0,,78686.0,SWGHC MENTAL HEALTH SERVICES,,57917.0,,33847.0,5190.0,,,,83681.0,,22449684.0,,4206699.0,,3975914.0,2409013.0,4275894.0,157.0,11235061.0,43549.0,,,,,,,,,,37204558.0,,200999.0,,,,15.0,,,2196608.0,,7624910.0,,,747315.0,,567.0,2508534.0,,517811.0,,,,,,,,,,,,,,22416.0,,27372.0,1575573.0,,,76214.0,,1738918.0,155371.0,315871.0,,3.0,,3747164.0,156469.0,,,,,33847.0,,3667801.0,-80.0,22278895.0,,,,,,,,,135476.37,,,,,281317.0,,,,300905.0,,443394.0,10387979.0,121048621.0,,1046651.0,1610637.0,,,555021.0,,,,47459602.0,,10765213.0,1096791.0,,5304907.0,11674092.0,,496041.33,,29965478.0,69.0,180.0,32981.0,,31683.0,6557.0,50624.0,,,,27613.0,,6573746.0,,,13491.0,,,,,,,290.0,,,,,,,,,,,,,,,1074547.0,,41975.0,512114.0,,76.0,,,,,,,,183.0,,,,27404116.0,258172674.0,,,,,,145420.0,,,3964638.0,,,,,34061.0,,,,,,N,1747144.0,7152150.0,,84689159.0,297356.0,,,2399415.0,,4421979.0,15811.0,,,3403483.0,SOUTHWEST GENERAL HEALTH CENTER,,,11117.0,46180.0,,,,,,,5855212.0,3013960.0,20290999.0,,437.0,,,-1015601.0,,,,8244.0,,,1449480.0,153386861.0,8926828.0,,,12059186.0,Y,,,84.0,,,508532739.0,3584112.0,8617956.0,3150.0,1371454.0,26251.0,1924356.0,,,11389362.0,,,,351997851.0,,,,30.0,328.0,,,,1917776.0,,,1162485.0,18214.0,28906.0,,,,,23387.0,,-6195.0,,,40023279.0,1575573.0,,32101250.0,19756070.0,,,,,33.08,,21655519.0,,,,,,,,,,,,,,,,,,,,27354345.0,,,,41975.0,,,7300603.0,108974.0,,149511890.0,,,,,4678000.0,1580372.0,,,,,17209938.0,1680985.0,16839.0,3294.0,2498550.0,15350685.0,4144050.0,26.0,14111.0,,,,,508174.0,238597486.0,19619259.0,,,131089.0,19218.0,11887.0,27673.0,,,11382013.0,,22855656.0,,,15.83,,,,,,2023-12-21 00:00:00,,,,,220435.0,,,,,,34664795.0,,2189273.0,,,,946223.0,,,,,,6181012.0,166242.0,,3906712.57,5386956.0,,,145667.78,,,114478.0,7901750.0,,,,,,,,9746840.0,,,4757.0,,,,,,,,,93610.0,,,,,1437.0,,,2353314.0,,,6013798.0,,,6509454.0,,,,,,,126690717.0,,858852.0,,16523496.0,,,171310.0,,3.0,,5544.0,,3230569.0,,,36S155,,,840317.0,,,,44305.0,,4840727.0,,,32006579.0,,,,,,,,,42128.0,,285263.51,57036955.0,,,,,,1129.0,,,3520231.0,2013666.0,,5684277.0,,22552205.0,,,,1142094.0,,618058.0,,,,1591.95,634.0,,4041.0,N,444969.0,,9585276.0,,2218709.0,216.0,,25670.0,,,3025740.0,,126243418.0,,,1372.0,35567.0,,,,5124086.0,59613.0,,Y,29231.0,,,,265.0,22670084.0,912109.0,,232287.0,,,11382828.0,1388385.0,,,,880.0,1295992423.0,4363903.0,,,,,6181012.0,,17.33,,,20168068.0,,77.15,,912.0,333133.0,,,37218629.0,,,42.27,,,,-187766.0,,,2360350.0,341631.0,,354917.0,811.0,,,22682.0,,,,2767533.0,1203717.0,6539.0,,,4694837.0,16.0,,361530,3528650.0,1233.0,,,,,101953.0,,,249.0,11179.0,-349376.0,,,,155.0,,,,6338449.0,10.0,-51032.0,11929370.0,460.0,16024085.0,928478.0,193738.0,,,,,,,,,13391967.0,,N,,,486321.0,16709.0,,50118.0,18510.0,,,N,276871.0,,,1945291.0,4231255.0,14765077.0,330978.0,,3975914.0,,3665604.0,1941707.0,,,,903036.0,,,,,444969.0,13391967.0,,6685.0,1676411.0,,,,,880.0,,,,,,,,2189273.0,7222000.0,,,,,47459602.0,,2486.0,22376275.0,972711.0,,1982999.0,,6502.17,,506371001.0,,,,1191749.0,33375.0,754905.0,,,1078020.0,67220.0,3150.0,,,,16101.0,,3802559.0,538.0,19.0,5584.0,305991.0,39757910.0,29303173.0,,,,198766.0,,,2020,Acute Care Hospitals,SOUTHWEST GENERAL HEALTH CENTER (360155)
65145,SOUTHWEST GENERAL HEALTH CENTER (360155),General Short Term (Acute Care Hospitals),Voluntary Nonprofit-Other,-81.83291,41.37208,,3250.0,,,1169196.0,358141420.0,68095.49,13841917.0,,3197978.0,,137479.0,,,640758.0,1173827.0,36407193.0,1250897.0,521.0,,,33943974.0,66.0,5794617.0,1962.0,,125451.0,142864.0,,2532042.0,534099.0,491808386.0,,15566490.0,,,,,,,,-3871.0,2469842.0,,,,,97.0,,,7324.0,,691645.0,,31944.0,,,-5484329.0,2422033.0,-768823.0,,940361.0,7744898.0,,3234256.0,1542754.0,51261370.0,33738.0,,4.0,3779156.0,1396213.0,533614.0,141708.0,4548.0,,,,,1285989.0,5534892.0,,,0.236507,,622529.0,,,,1111.0,6830234.0,5001540.0,,3234256.0,13690996.0,13128996.0,1.0,2547011.0,,,,,125638229.0,604106.0,4535512.0,,-142944.0,145.0,,,,,2457702.0,570250.0,,,,3424.0,826189.0,88174922.0,,,,10228389.0,,,,,,,,,,,2519723.0,,11624867.0,,,,,,322473.0,15165994.0,1464433.0,338809467.0,,103.0,,16749256.0,36989.0,7773227.0,,,-2160.0,4548.0,127555.0,-892745.0,129431753.0,,,,,,28.0,56575.0,,,20.52,,,34.54,4735.0,,15141670.0,,79965.0,,,,37.38,,,,,,3.0,18100.0,,,,,,7099.0,,21.0,,,,,18309013.0,129124.0,,,,345671.0,,,3831056.0,,1339941.0,,12385.0,,386530.0,44120.0,,,,,319285.0,2699.0,,110292.0,,,,24724204.0,,,,,,,,,-883631.0,-5707027.0,,10024705.0,6806548.0,,,30671204.0,,,4450280.0,152.0,,,,,,4743831.0,,,,50315.7,9789891.0,4482742.0,5776584.0,3666.0,N,,,,3864930.0,441.0,,251.0,73688.0,9.0,,-75.0,,,,49072980.0,,,,,,,,,,866412.0,,4069775.0,3343607.0,1917318.0,18706949.0,,,9709848.0,,,,,3583019.0,,,25201215.0,,,,33204857.0,1043614339.0,,,,,,,,,,2228616.0,N,,3.0,84533.0,-5484329.0,1800.99,CUYAHOGA,-53391.0,,,,12652499.0,,-270103.0,159942181.0,,,,,70183.0,,2147943.0,,,,24055.0,,,2881.0,,,12859504.0,,,,,,,,1680,471.0,,,17085.0,,,741241.0,,292625.0,,,,11708298.0,,614338132.0,292129.0,82624.36,,160277147.0,634731.0,,47613.0,3634337.0,2062.0,,,,,,,,32133.0,-35937189.0,,16828509.0,,2797.0,,1814897.0,2469842.0,1470967.0,,,63654.0,1371195.0,880687267.0,49072980.0,,,,,3831056.0,,1917318.0,,,,,,,-1934.0,,,,,18300.0,2828182.0,,10366.0,,1422334.0,12045.0,3918.0,36T155,,,,,,40205386.0,,6494261.0,1470537.0,,70183.0,,5422102.0,,99941.0,7159849.0,,,,,359062.0,,,,98937976.0,,,,1958.0,N,,-49009.0,9.0,213.0,,2050663.0,352204.0,,,,,,300122.0,2224538.0,4406.0,,10186494.0,,,686607.0,1,38.71,,1800491.0,,225350.0,15563431.0,1739.0,3747764.73,,219602.0,21.34,,,,15226.0,1456008.0,N,,489630312.0,,,,,,,,16492104.0,,314968838.0,,360155,32.0,,,,,,,4941177.0,,,,,,,,,59.37,,,,13493008.0,,1013475.0,,,,,5487730.0,,110292.0,,,-40495.0,,,,49.0,645.0,,,,,,22124.0,4352.0,,,1002738.0,,,,17603848.0,97403248.0,10754.55,,,,,17236.0,741149.0,,,,,,,12323.0,23637.0,,3800459.0,,,1353.0,,,,,,,,,,,1226457.0,4482742.0,,,,,,,,,31.44,2322687.0,,9226107.0,,,,8191766.0,,30106.0,,,-192661.0,6081564.0,,,51007.0,61780533.0,2016857.0,,2885620.0,,,380760.0,42108114.0,,4576410.0,,76092.0,,127224043.0,12500.0,845.0,,,4344918.0,191256931.0,,3556536.4,F,418044.0,2984551.0,,,,,420.0,,,,,-403937.0,15563431.0,3266835.0,216987.0,918.0,2747476.0,18325564.0,,,19808144.0,,,,,,21559.92,418044.0,,,37562750.0,,,,6525404.0,1338015.0,,,,,826189.0,N,,,6483134.0,662185.0,4851.0,,,,-12422.0,,,,,193435005.0,15961.0,,8224.0,,,,,,29.35,,,11668.0,41287647.0,1984.0,,,7963798.0,30885062.0,,,13487.0,1634499.0,,,,,7875.0,1225327.0,,,,,,221643.0,10545823.0,328358.0,,1827734.0,,,,-19111.0,,,,,16747630.0,,16.44,,2228743.0,2224538.0,1329216.0,981.0,,,,,,,9208526.0,17605600.0,2363197.0,,,,,,,1617037.0,61937.0,,,,2056.0,,,2097.0,15226.0,,,,,,247212.0,26.5,,309747887.0,,,,,,,33204857.0,,,,340772.0,,1010813.0,287678330.0,,8254767.0,4435.0,1896610.0,36170,,3080804.0,,6636176.0,,,,189.0,,14600657.0,,,,,1432556888.0,,46.87,,,,,,3810218.0,1387680.0,24520562.0,,,,,,,,,,,,,,666511.0,,,,,,,1814074.0,,21021.0,103.0,,,,,15943.0,,,30.0,-66026.0,,5291228.0,44.0,,,,1228753.0,,,13764551.0,126028.0,17495233.0,,,,,2068219.0,,,,21920100.0,4267685.0,,116765.5,70271.0,766281.0,,,,,,,,32439371.0,,188.0,,,,327.0,3197978.0,,,,,412263.0,,1895938.0,749438.0,,1960995.0,18026.0,34.62,,,177664257.0,,,31248121.0,,16803955.0,,,293017.0,,,,-330798.0,-9319562.0,,,14332.0,,,4919.0,53327.0,,7515698.0,,,,,,1159736.0,13493008.0,,146277.0,521261.0,,,32444.0,,1487643.0,1485626.0,66436.0,1694157.0,,,,,Y,9234320.0,1045324.0,,24835235.0,,,686607.0,,1.0,13870.0,,10366.0,,8076795.0,,,,,,,,11624867.0,,,,,Y,,46322.0,6202.0,,,,15610.0,,64017.0,36295.82,,7806184.0,,-53400.0,3084503.0,1.0,,129166.0,,,305237.0,,,,13355489.0,3.0,2404471.0,,,,15141670.0,,,,,449.0,245694.0,91509.0,6013.0,129029432.0,,,,646386.0,,521261.0,,129029432.0,,,2965440.0,,2863543.0,,,912800.0,,,,1227156.0,29502002.0,,3752.0,26871.0,748373.0,67522897.0,5557132.0,,,,,1054.0,,,,88734.0,,,-44409.0,,1765909.0,,,1467187.0,2316996.0,,40499692.0,,,,,61345.22,54776615.0,,5472521.0,9372171.0,,46312.0,,7987.0,,1059.0,,18.89,30.16,2052875.0,358068506.0,,,,420.0,70271.0,268591.0,877612.0,706.0,5978.0,,,,,2192.0,1890692.0,4221948.0,,825076.0,,,,1125645.0,,268361.0,,,,,,799857.0,-244606.0,,892401.0,,,,306503.0,6577600.0,,884520832.0,,2549.07,-63641.0,,,,,14262.0,,,,152.69,36592287.0,47481.64,1820300.0,,46558.0,,43.82,1176.0,57.38,,2990243.0,,104584.0,,1836037.0,-8197.0,,2102.0,,,1542754.0,,,1339488.0,,,,,24125.0,3127.0,,,12412.0,,10122.0,,5475.0,,,,,199783.0,11322459.0,6199802.0,503730.0,,,30671204.0,,7744898.0,,27464381.0,,166001841.0,,,3573268.95,1434061.0,287.0,966.0,1402718.0,36,,,,,,,,,,,,,56575.0,,9208526.0,,67978269.0,,473215.0,,,4450280.0,,68620.0,,,,,,,24860725.0,44.76,15899919.0,,,129124.0,,,33204857.0,,,,,,93712.0,65355.0,,14596.0,,,,15186474.0,,,,,,,316256.0,475698.0,,175.0,-74577.0,,17582867.0,1536896.0,6167.0,,,2021-12-31,,44130-3497,,,4727042.0,334188.0,1339488.0,,,,5015749.0,5952344.0,7020735.0,,,,,,13487.0,,,,1845671.0,48.47,,,,16732.55,17324890.0,,510439.0,376423.0,421337.0,153333946.0,,,,10228389.0,14366496.0,,220.0,,,,,,,61801.0,N,,,,94.0,912800.0,1168892.0,,741726,-1934.0,,13233738.0,Y,,OH,,46207089.0,,-25358375.0,3127.0,29317441.0,,,,,887995.0,,38.0,,6359965.0,17010.0,19781.0,,,7617846.0,,24602962.0,,,432264.0,17724.0,,,,P,,4435.0,,2263.0,,,,,,,359.0,,,,9561.0,391575.0,,,4964404.0,,1339928.0,153.0,,,,,4629289.0,,,,,,-14457.0,,118.0,14685813.0,1.0,,,18697 BAGLEY ROAD,,44.21,ACUTE REHAB,,,,,,,,7398.0,,,,5002074.0,,,40499692.0,,42.0,,,104584.0,,-76606.0,,,,,,0.5,110719.0,,,,,,1901798.0,93.0,74887.0,,4655.0,,8107133.0,,,113344366.0,,9349.0,6504.0,293785.0,,,602759.0,60889.0,367253,2025.0,14332.0,31408.0,N,76990.58,205753.0,400293.0,,,,,,,-244991.0,,,,1101.0,177.0,24055.0,33.0,32.73,129124.0,15201,106145228.0,N,30996.0,35519.0,,,1999527.0,,,,39227.0,1470967.0,,,9242690.0,,8.0,216987.0,5162005.0,18326460.0,,,,339197157.0,2860.0,3309216.0,94402.0,,,103374.0,5.0,,3424.0,7151.0,,,60562683.0,2261630.0,,,9712.0,,,,,,13334953.0,129124.0,,10881184.0,,,,220712783.0,,,-40932.0,-3696864.0,8340265.0,,13.0,,7862.0,,,,,,,,,,533806.0,,,,2532042.0,1962.0,,1129.0,4042089.0,2052875.0,1001679.0,,,,14600657.0,1392.0,19814782.0,1016.0,,,,26.0,2380463.0,,1635785.0,394078609.0,3779156.0,,108225.0,1902661.0,,,,3652212.0,,,621067.0,,484058.86,53351153.0,453171.0,897916.0,6636176.0,1407771.0,,,,,,,,,,1542940.0,,,63430.0,39.52,170461.0,,81010.0,,,24793880.0,,,30.16,3794468.0,,,,,1077712.0,,,824473.0,,,,,8224.0,11624867.0,6336699.0,311063.0,97150.0,,,,25785895.0,,,,35.23,,8981308.0,2519723.0,,,15226.0,,,,,22321.0,,12385.0,,,,2422033.0,1493073.0,,,2224538.0,,1520211.0,-35937189.0,,,,,8245157.0,,,,,,3821580.0,,,621067.0,1077712.0,2021-01-01 00:00:00,,,104584.0,5053.0,,2016857.0,1590453.0,,,,43874738.0,1036654.0,,,,,1884215.0,,,43549250.0,,,,,,8061512.0,,212.0,,,,51290.0,,,152799.0,,,,,,,112725.0,,,,,,6272.0,,60646.0,,5776584.0,1959500.0,,,46.0,,-761315.0,1962846.0,-6169206.0,39214306.0,1338015.0,,,235568.0,,335.0,957903.0,,,,,,,,,,-1287627.0,,2056.0,,2817508.0,62.06,,4170556.0,,11619270.0,,,,1013475.0,6286375.0,-2115358.0,,-11142081.0,,,,,10442749.0,16098005.0,648814.0,1214.0,,1493073.0,,,,672848.0,3955.0,12130172.0,34415091.0,,,6179739.0,3.0,3634337.0,,,,,,,3977774.0,,,,2362.0,,,1819287.0,,17460,,,5785922.0,,426918.0,50936.0,,,,6637359.0,,,,,General Short Term,341519844.0,6637359.0,,107117844.0,,,,98278.0,2892769.0,,,,,,3918.0,,,,,44120.0,,16055648.0,,,108225.0,,,11322459.0,,,,,,,11240.0,,197393.0,2970.0,,38338896.0,2960049.0,9025156.0,,13128996.0,1948174.0,5265137.0,,,,1149.0,13841917.0,1438865.0,314303122.0,1236008.4,2888857.0,,4723.0,,0.5,,25350.0,,-41355.0,,,,7861.0,,9461250.0,,,,,5674593.0,24607033.0,6394286.0,88599.0,,1587365.0,,,,,140222.0,,,,,,,41287647.0,,1227156.0,329556031.0,,,99941.0,59629.32,,,,4272941.0,,36294240.0,1466143.0,,,6255346.0,,,,,9862627.0,,,,,,,5487730.0,,,125303263.0,87.0,140222.0,,,,,,,37562750.0,,91.0,106377.0,,20349532.0,1754382.0,-48476.0,,,6690.0,,,,766281.0,,2797.0,,1001679.0,24.67,,,,,1291890.0,11240.0,,4308715.0,1760271.0,,,,,3379096.0,,,,,,391575.0,140222.0,,,326659802.0,,253255.0,,,186570.0,,MIDDLEBURG HEIGHTS,21021.0,,,,955142.0,,305209.0,-40932.0,,2235055.0,206621.0,155.0,,,,,-248300.0,49155374.0,,,,59298.0,,,,,,1196787.0,,,4804.0,,1174857.0,,6286375.0,,,-54277859.0,,3650.0,,,,47599.0,,77215.0,,,,17981.0,,79233.0,SWGHC MENTAL HEALTH SERVICES,,44137.0,,31408.0,6202.0,,,,98278.0,,24602229.0,,4514918.0,,4034710.0,2000586.0,4743831.0,1644.0,9563138.0,40282.0,,,,,,32444.0,,,,37068469.0,,199588.0,,,,15.0,,,2624110.0,,8107133.0,,,647199.0,,134.0,2675455.0,,435863.0,,,912.0,,,,,,,,,,,21500.0,,99963.0,1595729.0,,,86998.0,,1547993.0,40980.0,411687.0,,,,4576410.0,129166.0,,,,,31408.0,,3779156.0,,20691530.0,,,,,,,,,135781.7,,,,,257178.0,,,,249168.0,,611420.0,9544379.0,132632013.0,,1105581.0,1694157.0,,,645263.0,,,,49072980.0,,10859004.0,1073472.0,,6417423.0,10024705.0,,484058.86,,39730033.0,100.0,217.0,24521.0,,35519.0,8701.0,49607.0,,,,33738.0,,6825574.0,,,14332.0,,,,,,,243.0,,,,,,,,,,,,,,,1174868.0,,84533.0,400368.0,,32.0,,,,,,,,189.0,,,,26934853.0,220712783.0,,,,,,103064.0,,,4205963.0,,,,,26498.0,,,,,,O,1820300.0,8076795.0,,105947019.0,310072.0,,,2319508.0,,4272941.0,5053.0,,,3139981.0,SOUTHWEST GENERAL HEALTH CENTER,,,14872.0,29132.0,,,,,,,5674593.0,2747476.0,20983389.0,,,,,-805462.0,,,,7151.0,,,1470967.0,166001841.0,9277057.0,,,13142397.0,Y,,,,,,553478619.0,3385397.0,9234320.0,2678.0,1464433.0,27036.0,1814074.0,,,12078194.0,,,,394385112.0,,,,,,,,,1585506.0,,,1368672.0,11456.0,33494.0,,,,,18889.0,,-6615.0,,,39279932.0,1595729.0,,33204857.0,35053286.0,,,,,33.09,,22278895.0,,,,,,,,,,,,,,,,,,,,29551407.0,,,,84533.0,,,8061512.0,91646.0,,144300675.0,,,,,950000.0,1434061.0,,1739.0,,,18362146.0,1661667.0,15330.0,3285.0,2519723.0,17605600.0,4344918.0,16.0,14596.0,,,,,602776.0,265049177.0,19267893.0,,,146277.0,18229.0,4071.0,29383.0,,,13477616.0,,31248121.0,,,14.98,,,,,,2022-05-26 00:00:00,,,,,182055.0,,,,,9349.0,37248670.0,,2273671.0,,,,1013475.0,,,,,,6182153.0,138058.0,,4040595.26,4888280.0,,,177075.68,,,116767.0,6398642.0,,,,,,,,10186494.0,,,1353.0,,,,,,,,,83155.0,,,,,1484.0,,,2744341.0,,,6081564.0,,,7245140.0,,,,,,,139903920.0,,1010813.0,,18482236.0,,,160832.0,,3.0,,1292.0,,3511052.0,,,36S155,,,788008.0,,,,31416.0,,5362400.0,,,32415316.0,,,,,,,14262.0,,34701.0,,285565.32,54927747.0,,,,,,632.0,,,4352901.0,2198585.0,,6338727.0,,21920100.0,,,,1059435.0,,570250.0,,,,1647.6,541.0,,3902.0,N,544927.0,,10578921.0,,2122762.0,3888.0,,15915.0,,,3197978.0,,139533543.0,,,1111.0,35329.0,,,,5679177.0,47820.0,2093.0,Y,24976.0,,,,295.0,24793922.0,905388.0,,190960.0,,,13478431.0,1242676.0,,,,634.0,1437999451.0,4566854.0,,,,,6182153.0,,18.88,,,24520562.0,,85.7,,3881.0,335533.0,,,37076038.0,,,46.02,,,,-267192.0,,,2328452.0,380760.0,,352204.0,,,,30996.0,,,,2811745.0,1385858.0,5519.0,,,5002074.0,,,361530,3739623.0,1214.0,,,,,89336.0,,,148.0,18041234.0,-2642.0,270057.0,,,155.0,,,,6092566.0,10.0,-10279.0,13018935.0,627.0,16055648.0,898587.0,109230.0,,,,,,,,,13895314.0,,N,,80.0,524730.0,8435.0,,108.0,12123.0,,,N,291587.0,,,1959500.0,5162005.0,13355489.0,247212.0,,4034710.0,,4254927.0,1896610.0,,,,888311.0,,,,,544927.0,13895314.0,,4433.0,1634499.0,,,,,634.0,,,,,,,,2273671.0,10673509.0,,,,,49072980.0,,4785.0,19559168.0,821241.0,,2283173.0,,6360.0,,551869621.0,,,,1183308.0,69307.0,738617.0,,,1036654.0,70512.0,2678.0,,,,,,3967106.0,225.0,,11443.0,221643.0,34332552.0,38645399.0,,,,238067.0,,,2021,Acute Care Hospitals,SOUTHWEST GENERAL HEALTH CENTER (360155)
70723,SOUTHWEST GENERAL HEALTH CENTER (360155),General Short Term (Acute Care Hospitals),Voluntary Nonprofit-Other,-81.83291,41.37208,,87765.0,,,1119529.0,374841955.0,68095.49,15021064.0,,3076331.0,,115336.0,,,680392.0,1240501.0,33856894.0,975850.0,2011.0,,,31829205.0,89.0,5047682.0,1844.0,,149952.0,150768.0,,2758691.0,744521.0,485493757.0,,14712662.0,,,,,,,,-3530.0,2877147.0,,,,,83.0,,,10656.0,,1681823.0,,95384.0,,,-6370934.0,1914273.0,-869573.0,,808552.0,9096704.0,,3806238.0,1769771.0,46261381.0,21167.0,,3.0,3850190.0,1163966.0,485794.0,150443.0,4587.0,,,,,1341817.0,5546347.0,,,0.252456,,700705.0,,,,268.0,8028826.0,4313897.0,,3806238.0,13457249.0,12097796.0,1.0,2752013.0,,,,,128959525.0,657498.0,4256287.0,,-178272.0,117.0,,,,,2526838.0,632723.0,,,,3153.0,945632.0,82040173.0,,,,9775663.0,,,,,,,,,,,2485693.0,79.0,11101092.0,,,,,,260984.0,17501820.0,1492539.0,358110431.0,,192.0,,16612389.0,114383.0,8327463.0,,,-2040.0,4587.0,139028.0,-937578.0,132105030.0,,,,,,42.0,60955.0,,,22.41,,,36.33,4307.0,,15958683.0,,64999.0,,,,37.84,,,,,,2.0,,,,,,,4569.0,,,,,,,18405895.0,152353.0,,,,374828.0,,,3609345.0,,2369287.0,,6053.0,,305177.0,46301.0,,,,,353028.0,5029.0,,121029.0,,,,26945745.0,,,,,,,,,-541318.0,-6665560.0,,9718245.0,6583850.0,,,33413333.0,,,4250182.0,423.0,,,,,,4681568.0,,,,50315.7,9095208.0,4174667.0,6443662.0,,N,,,,4160705.0,1710.0,,250.0,54271.0,,,-235.0,,,,51264800.0,,,,,,,,,,938220.0,,4641494.0,2362059.0,1453152.0,7917235.0,,,9236158.0,,,,,3822068.0,,,22218909.0,,,,32979686.0,1018969629.0,,,,,,,,,,2248168.0,N,,3.0,27789.0,-6370934.0,1743.34,CUYAHOGA,-64407.0,,,,,,-388153.0,168070263.0,,,,,69254.0,,2488739.0,6.0,,,29202.0,,,,,,27389039.0,,,,,,,,1680,470.0,,,10038.0,,,976539.0,,332692.0,,,,9862627.0,,543076192.0,279954.0,82624.36,,167535304.0,612036.0,,45980.0,4209554.0,2077.0,,,,,,,430.0,60525.0,-21831591.0,,18176633.0,,2123.0,,1407186.0,2877147.0,1332458.0,,865.0,79170.0,1508662.0,905417468.0,51292468.0,,,,,3609345.0,,1453152.0,,,,,,,-1657.0,,,,,51125.0,2438391.0,,10829.0,,1463920.0,8760.0,3637.0,36T155,,,,,,38143852.0,,6914809.0,1694004.0,,69254.0,,5504867.0,,103805.0,8549555.0,,,,,389800.0,,,,101413476.0,,,,,N,,-66872.0,17.0,376.0,,2510360.0,277661.0,,,,,,303637.0,2162890.0,5201.0,,11150357.0,,,818520.0,1,37.23,,1817442.0,,221257.0,13863040.0,,3635891.89,,221272.0,22.24,,,,5473.0,1242331.0,N,,483315683.0,,,,,,,,16512267.0,,322886073.0,,360155,9.0,,,,,,,4627873.0,,,,,,,,,74.84,,,,14383927.0,,1056055.0,,,,,5644678.0,,121029.0,,,-120541.0,,,,182.0,1474.0,,,,,,20785.0,4400.0,,,1153912.0,1.0,,,15091523.0,106497234.0,48468.05,,,,,13995.0,740752.0,,,,,,,12969.0,25492.0,,3357166.0,,,214.0,,,,,,,,,,,1113951.0,4174667.0,,,,,,,,,30.57,1990149.0,,7967076.0,,,,8653416.0,,91203.0,,,-201337.0,6236606.0,,,54481.0,47182618.0,1692610.0,334914.0,3332316.0,,,361531.0,39827885.0,,4736322.0,,99790.0,,123454296.0,37500.0,970.0,,,4292522.0,191005886.0,,3485890.04,F,587514.0,3428149.0,,,,,3320.0,,,,,-657928.0,13863040.0,3321231.0,272943.0,1053.0,2811248.0,18619933.0,,,22885136.0,,,,,,23834.7,587514.0,,,9860746.0,,,,6525404.0,1419419.0,,,,,945632.0,N,,,6660623.0,637173.0,4300.0,,,,-29034.0,,,,,193183960.0,45999.0,,7047.0,,,,,,29.63,,,9080.0,38782415.0,,,,6372270.0,37217547.0,,,5473.0,1252546.0,,,,,4380.0,1490954.0,,,,,,368365.0,11003257.0,407386.0,,1776215.0,,,,-10217.0,,,,,6678062.0,,13.96,,2334415.0,2162890.0,1376895.0,,,,,,,,9852868.0,14149121.0,2623222.0,,,,,,,1553328.0,53910.0,,,,2331.0,,,2097.0,5473.0,,,,,,224782.0,25.47,,236771329.0,,,,,,,32979686.0,,,8600.0,328141.0,,1097062.0,273199930.0,,8731917.0,4815.0,1967139.0,36170,,3238764.0,,5461894.0,,,,300.0,,13882971.0,,,,,1418506013.0,,48.16,,,,,,3101867.0,1532568.0,25819905.0,,,,,,,,,,,,,,748374.0,,,,,,,2105584.0,,18771.0,34.0,,,,,13714.0,,,,-52987.0,,4992283.0,50.0,,,,1334940.0,,888.0,17319246.0,123402.0,17145067.0,,,,,2120053.0,,,,21326326.0,4820736.0,,116765.5,27789.0,766216.0,,,,,,,,36943304.0,,191.0,,,,409.0,3076331.0,,,,,487311.0,,1978309.0,976539.0,,2269243.0,60082.0,36.65,,,173544139.0,,,20951287.0,,18152079.0,,,306662.0,,,,-578652.0,-10753739.0,,,13324.0,,,5201.0,54655.0,,6700860.0,,,,,,963629.0,14383927.0,,141802.0,4672975.0,,,95384.0,,1603238.0,1122816.0,75363.0,1868858.0,,,,,Y,9458731.0,1326542.0,,26251653.0,,,818520.0,,,12410.0,,10829.0,,8508886.0,,,,,,,,11101092.0,,,,,Y,,38338.0,4486.0,,,,20879.0,,54219.0,42365.21,,9067116.0,,-42871.0,2557442.0,3.0,,152353.0,,,246989.0,,,,12717870.0,5.0,2509004.0,,,,15958683.0,,,,,62.0,282270.0,50136.0,6228.0,131460560.0,,,,707199.0,,4672975.0,,131460560.0,,,3417932.0,,2892516.0,,,923118.0,,,,1094853.0,31783112.0,,,38268.0,924128.0,71121165.0,4019962.0,,,,,1016.0,,,,100989.0,,,-42357.0,,1658143.0,,,1335338.0,2446972.0,,42285768.0,,,,,61345.22,54695547.0,,5623647.0,9242690.0,,48170.0,,4760.0,,148.0,,19.7,32.56,2148216.0,374627311.0,,,,3320.0,27789.0,300297.0,860864.0,728.0,5690.5,,,,,1869.0,1907967.0,4241582.0,,664588.0,,,,1178917.0,,304124.0,,,,,,652881.0,-264739.0,,798092.0,,,,10191347.0,6051342.0,,909861884.0,,2831.31,-115094.0,,,,,,,,,162.22,34964958.0,47481.64,1836745.0,,58936.0,,48.3,147.0,50.08,,4060203.0,,88785.0,,1807792.0,,,2192.0,,,1769771.0,,,1519345.0,,,,,20471.0,,,,20583.0,,,,5475.0,,,,,210985.0,11072484.0,5758836.0,389961.0,,,33413333.0,,9096704.0,,25432492.0,,175107662.0,,,3540048.59,5596093.0,,2777.0,1079420.0,36,,,,,,,,,,,,,60955.0,,9852868.0,,68873082.0,,549766.0,,,4250182.0,,69715.0,,,,,,,23109230.0,47.48,8544889.0,,,152353.0,,-10156.0,32979686.0,,,,,,97325.0,107784.0,,13802.0,,,,14187662.0,,,6686.0,,,,274584.0,464315.0,,1156.0,-75330.0,,14824581.0,1636474.0,7112.0,,,2022-12-31,,44130-3497,,,4347827.0,270718.0,1519345.0,,,,2822078.0,4275674.0,7116036.0,,,,,,5473.0,,,,151908.0,96.41,,,,54158.55,16361821.0,,584199.0,281852.0,580497.0,149749815.0,,,,9775663.0,11635424.0,,211.0,,,,,,,94910.0,N,,,1.0,80.0,923118.0,1199638.0,,743408,-1657.0,,14008974.0,Y,,OH,,46543641.0,,-9395155.0,,22949682.0,,,,,979771.0,,34.0,,6869057.0,15367.0,15800.0,1119325.0,,8753694.0,,26422838.0,,,399118.0,14908.0,,,,P,,4815.0,,2650.0,,,,,,,93.0,,,,20630.0,400888.0,,,5462724.0,,1564255.0,235.0,,,,,4924028.0,,,,,,-15171.0,,,15937687.0,1.0,,,18697 BAGLEY ROAD,,42.99,ACUTE REHAB,,,,,,,,1163.0,,,,5850326.0,15957.0,,42285768.0,,-322.0,,,88785.0,,-40432.0,,,,,,1.5,141894.0,,,,,,2232524.0,108.0,,,4563.0,,6561803.0,,,125924466.0,,9022.0,6289.0,242195.0,,,434972.0,138534.0,367253,1580.0,13324.0,33097.0,N,76990.58,169606.0,314932.0,,,,,,,-692273.0,,,,215.0,244.0,29202.0,24.0,32.29,152353.0,15201,108540546.0,N,20074.0,25640.0,,,2098823.0,,,,53221.0,1332458.0,,,9390164.0,,4.0,272943.0,7289490.0,21878502.0,,,,358439130.0,3787.0,3545884.0,86602.0,,,236521.0,5.0,,3153.0,6023.0,,,55432882.0,2118002.0,,,9486.0,,,,,,14187400.0,152353.0,,9737441.0,,,,187261744.0,,,-43503.0,-4145551.0,9388772.0,,20.0,,5913.0,,,,,,,,,,422959.0,,,,2758691.0,1844.0,,1247.0,3527819.0,2148216.0,911681.0,,,,13882971.0,1151.0,20646915.0,3120.0,,,,10743.0,2539168.0,,1682998.0,396673546.0,3850190.0,,160315.0,1729678.0,,,,3830283.0,,,704988.0,,426410.22,51275302.0,498038.0,1119946.0,5461894.0,1079420.0,,,,,,,,,,1241655.0,,,,36.86,,,133287.0,,,26580510.0,,,32.56,3794777.0,,,,,958871.0,,,984352.0,,,,,7047.0,11101092.0,7439578.0,297911.0,99464.0,,,,-49282068.0,,,,37.15,,9318100.0,2485693.0,,,5473.0,,,,,9120.0,,6053.0,,,,1914273.0,1315996.0,,,2162890.0,,1668725.0,-21831591.0,,,,,8717823.0,,,,,,3699422.0,,,704988.0,958871.0,2022-01-01 00:00:00,,,88785.0,,,1692610.0,2046156.0,,,,42593932.0,955957.0,,,,,2027777.0,,,46417565.0,,,,,,8435872.0,,674.0,,,,51360.0,,,144678.0,,,,,,,100372.0,,,,,,,,74545.0,,6443662.0,1680488.0,,,5.0,,,2066053.0,7061240.0,42453791.0,1419419.0,,,276884.0,,,1368599.0,,,,,,,,,,-1592576.0,,2331.0,,2424652.0,59.55,,4997477.0,,11097241.0,,,,1056055.0,5161341.0,-520973.0,,-10477841.0,,1119325.0,,,10305759.0,19772223.0,545371.0,1281.0,,1315996.0,,,,558498.0,4614.0,11591498.0,33218183.0,,,5708126.0,2.0,4209554.0,,,,,,,6220605.0,,,,2032.0,,,2118800.0,,17460,,,5827412.0,,356596.0,153084.0,,,,8111731.0,,,,,General Short Term,360429279.0,8111731.0,,109875588.0,,,,124110.0,2460854.0,,,,,,3637.0,,,,,46301.0,,15080336.0,,,160315.0,,,11072484.0,,,,,,,9577.0,,219183.0,11793.0,,-32084376.0,3785373.0,9365902.0,,12097796.0,2160111.0,5079505.0,,,,,15021064.0,1547385.0,314968837.0,1230034.41,3152353.0,,6462.0,,1.5,,49635.0,,-6057.0,,,,8605.0,,9790595.0,,,,,5405931.0,26425314.0,6202772.0,83033.0,,1163949.0,,,,,163123.0,,,,,,,38782415.0,,1094853.0,259656465.0,,,103805.0,59629.32,,,,3920984.0,,33911364.0,1484639.0,,214.0,6525403.0,,,,,9710719.0,,,,15880.0,,,5644678.0,,,129494484.0,27206.0,162235.0,,,,,,,9860746.0,,95.0,135202.0,,21373643.0,1097610.0,-54323.0,,,6452.0,,,,766216.0,16627.0,2123.0,,911681.0,22.35,,,,,1388052.0,9577.0,,719731.0,1714968.0,,,,,2786429.0,,,,,,400888.0,163123.0,,,269876262.0,,214257.0,,,188249.0,,MIDDLEBURG HEIGHTS,18771.0,,,,1020820.0,,246947.0,-45503.0,,2175631.0,325069.0,167.0,,,,,-294845.0,50929190.0,,,,101822.0,,,,,,1983068.0,,,20616.0,,1191321.0,,5161341.0,,,-58866844.0,,3650.0,,,,-284.0,,67391.0,,,714.0,15825.0,,64457.0,SWGHC MENTAL HEALTH SERVICES,,35806.0,,33097.0,4486.0,,,,124110.0,,26404698.0,,5021983.0,,5297496.0,1614544.0,4681568.0,,7639551.0,31647.0,,,,,,95384.0,,,,44212034.0,,158792.0,,,,15.0,,,2549729.0,,6561803.0,,,767856.0,,20.0,2010673.0,,367394.0,,,23009.0,,,,,,,,,,,6705.0,,175755.0,1290074.0,,,,,1242543.0,147474.0,484646.0,,,,4736322.0,152353.0,,,,,33097.0,,3850190.0,28620.0,20646906.0,,,,,,,,,112714.35,,,,,276429.0,,,,326959.0,,637160.0,34544938.0,128381854.0,,848857.0,1868858.0,,,580033.0,,,,51292468.0,,8575363.0,1099390.0,,7618495.0,9718245.0,,426410.22,,46097790.0,158.0,57.0,15066.0,,25640.0,5263.0,44537.0,,,,21167.0,,6198178.0,,,13324.0,,,,,,,190.0,,,,,,,,,,,,,,,1191321.0,,27789.0,542160.0,,7.0,,,,,,,,300.0,,,,26818026.0,187261744.0,,,,,,80229.0,,,4215363.0,,,,,25709.0,,,,,,Q,1836745.0,8508886.0,,82614518.0,328695.0,,,2446972.0,,3920984.0,888.0,,,2685636.0,SOUTHWEST GENERAL HEALTH CENTER,,,19156.0,45751.0,,,,,,,5405931.0,2811248.0,21961154.0,,,,,-644660.0,,,,6023.0,,,1332458.0,175107662.0,10163451.0,,,12107843.0,Y,,,,,,515972638.0,3446197.0,9458731.0,2043.0,1492539.0,27036.0,2105584.0,,,11761478.0,,,,406864893.0,,,,1253.0,1158.0,,,,1246588.0,,3458.0,1082282.0,12143.0,9868.0,,,,,23823.0,,-2779.0,,,37389494.0,1290074.0,,32979686.0,28385162.0,,,,,30.58,,20691530.0,,,,,,,,,,,,,,,,,,,,31861949.0,,,,27789.0,,,8435872.0,86086.0,,147149719.0,,,,,5850000.0,5596093.0,,,,,18425202.0,1730360.0,14874.0,,2485693.0,14149121.0,4292522.0,29.0,13802.0,,,,,743845.0,265212986.0,17459572.0,,,141802.0,19491.0,2476.0,32679.0,,,15859127.0,,20951287.0,,,15.78,,,,,,2023-06-02 00:00:00,,,,,228368.0,,,,,9022.0,36705379.0,,2299995.0,,,,1056055.0,,,,,,5956523.0,130547.0,,3912300.26,3867323.0,,,187817.41,,,61312.0,4808491.0,,,,,,,,11150357.0,,,214.0,,,,,,,,,95344.0,,,,,1389.0,,,2767383.0,,,6236606.0,,,7679557.0,,,,,,,143377455.0,,1097062.0,,18938051.0,,,209448.0,,3.0,,405.0,,3244071.0,,,36S155,,,665569.0,,,,29414.0,,5631482.0,,,36914102.0,,,,,,,,,31442.0,,285565.32,58458435.0,,,,,,,,,4730658.0,2404841.0,,7265250.0,,21326326.0,,,,1082376.0,,632723.0,,,,1605.13,121.0,,2892.0,N,551859.0,,11270531.0,,2819998.0,3240.0,,14271.0,,,3076331.0,,142828369.0,,,1326.0,23114.0,,,,5253408.0,35532.0,1729.0,Y,28757.0,,,,,26580265.0,970781.0,,157427.0,,,15860422.0,1191803.0,,,,973.0,1425834522.0,3925079.0,,,,,5956523.0,,21.61,,,25819905.0,,103.33,,,337588.0,,,44216523.0,,,42.4,,,,-243760.0,,,2457363.0,361531.0,,277661.0,1795.0,,,20074.0,,,37.0,2113209.0,1671396.0,1937.0,,,5850326.0,,,361530,4707363.0,1281.0,,,,,85290.0,,,,,-2214.0,,,,167.0,,,,4438797.0,10.0,100586.0,12881711.0,658.0,15080336.0,915448.0,142603.0,,,,,,,,,13868844.0,,N,,9.0,440296.0,,,199.0,1552.0,,187.0,N,310109.0,,,1680488.0,7289490.0,12717870.0,224782.0,,5297496.0,,4808981.0,1967139.0,,,,911457.0,,,,,551859.0,13868844.0,,,1252546.0,,,,,973.0,,,,,,,,2299995.0,11439991.0,,,,,51292468.0,,3059.0,22366928.0,650706.0,,2276172.0,,6360.0,,513088545.0,,,,1385752.0,22316.0,819445.0,,,955957.0,57928.0,2043.0,,,,5027.0,,3959395.0,75.0,23.0,5817.0,368365.0,7836846.0,-21893029.0,,,,224978.0,,,2022,Acute Care Hospitals,SOUTHWEST GENERAL HEALTH CENTER (360155)
78591,SOUTHWEST GENERAL HEALTH CENTER (360155),General Short Term (Acute Care Hospitals),Voluntary Nonprofit-Other,-81.83291,41.37208,,63925.0,,,1169155.0,379610191.0,63774.75,16280055.0,,3237572.0,,1912.0,,,768257.0,1392956.0,34937080.0,1041536.0,,,,30960264.0,,,908.0,,162820.0,74148.0,,2930228.0,702108.0,496584298.0,,15835564.0,,,,,,,,-3426.0,2980837.0,,,,,98.0,,,5883.0,,1986546.0,,223484.0,,,-6421354.0,742131.0,-939741.0,,802954.0,9124457.0,,3071581.0,1906140.0,54937102.0,32260.0,,5.0,4060410.0,449441.0,472527.0,106033.0,3565.0,,,,,1271174.0,5538389.0,,,,,692851.0,,,,1084.0,10159060.0,4155032.0,,3071581.0,14313143.0,10707702.0,1.0,3239820.0,,,,,134191526.0,692803.0,4035323.0,,-196350.0,199.0,,,,,2661807.0,3850154.0,,,,3342.0,937665.0,104167587.0,,,,11964071.0,,,,,,,,,,,2620889.0,,6338467.0,,,,,,126493.0,18275778.0,1794370.0,362216930.0,,180.0,,16602789.0,281379.0,7904664.0,,,-2349.0,,203421.0,-1074533.0,135299537.0,,,,,,31.0,63875.0,,,21.85,,,37.81,2875.0,,16310393.0,,636.0,,,,37.7,,,,,,2.0,865.0,,,,,,6595.0,,,,,,,18023980.0,122788.0,,,,373728.0,,,4341783.0,,3036050.0,,11110.0,,362392.0,49905.0,,,,,381128.0,5970.0,,87362.0,,,,28501362.0,,,,,,,,,-717550.0,-6798222.0,,9755623.0,7150835.0,,,35742290.0,,,4253313.0,346.0,,,,,,5351114.0,,,,56390.13,8046642.0,4156154.0,6724622.0,2051.0,N,,,,3849897.0,,,244.0,32277.0,10.0,,-225.0,,,,55174584.0,,,,,,,,,,1438212.0,,2336697.0,2755000.0,2503103.0,3899749.0,,,9403177.0,,,,,4681663.0,,,24839902.0,,,,34558312.0,1210632625.0,,,,,,,,,,2811555.0,N,,4.0,18695.0,-6421354.0,1715.93,CUYAHOGA,-73615.0,,,,,,-111889.0,176940864.0,,,,,69862.0,,3416943.0,,,,29948.0,,,,,,31200921.0,,,,,,,,1680,118.0,,,7228.0,,,1639066.0,,341053.0,,,,9710719.0,,535759043.0,247229.0,80407.52,,176766680.0,635546.0,,28387.0,4606091.0,1872.0,,-45116.0,,,,,,45737.0,-31170066.0,,17952152.0,,1547.0,,1078322.0,2980837.0,1474674.0,,854.0,78585.0,1649346.0,1013672627.0,55210701.0,,,,,4341783.0,,2503103.0,,,,,,,-1923.0,,,,,74415.0,2609545.0,,14089.0,,1569008.0,8760.0,3735.0,36T155,,,,,,41850857.0,,7450106.0,1514306.0,,69862.0,,5228850.0,,129290.0,8587110.0,,,,,115968.0,,,,124857854.0,,,,,N,,-37328.0,116.0,,,2934728.0,335287.0,,,,,,416285.0,2433099.0,7387.0,,9993337.0,,,875237.0,1,40.26,,2039164.0,,226753.0,16076997.0,,3578385.21,,172475.0,24.3,,,,3273.0,767976.0,N,,494406224.0,,,,,,,,17621867.0,,326598746.0,,360155,13.0,,,,,,,6797250.0,,,,,,,,,77.94,,,9.0,12802957.0,,1140922.0,,,,,5992963.0,,87362.0,,,-151334.0,,,,179.0,1101.0,,,,,,22068.0,6856.0,,,1190682.0,1.0,,,,120385968.0,66979.82,,,,,9648.0,740481.0,,,,,,,10800.0,42219.0,,2829723.0,,,139.0,,,,,,,,,,,403763.0,4156154.0,,,,,,,,,31.05,2395001.0,,8947177.0,,,,8404056.0,24.0,187533.0,,,-297681.0,7834412.0,,,51984.0,52231633.0,1894686.0,489554.0,3359418.0,,,394869.0,39514913.0,,5033802.0,,76991.0,,126500905.0,87500.0,200.0,,,4069114.0,205495137.0,,3502356.11,F,815712.0,3413542.0,,,,,2127.0,,8.0,,,-1104884.0,16076997.0,3763280.0,164032.0,1447.0,3426185.0,18692686.0,,,16082813.0,,,,,,20650.33,815712.0,,,3477492.0,,,,6525404.0,1381389.0,,,,,937665.0,N,,,6812988.0,585557.0,3565.0,,,,-8043.0,,,,,206981014.0,71666.0,,4519.0,,,,,,33.72,,,11862.0,36929041.0,,,,7133322.0,41076461.0,,,3273.0,1319463.0,,,,,3568.0,2026470.0,,,,,,455887.0,12458917.0,397705.0,,2154112.0,,,,-13981.0,,,,,11664177.0,7130.0,17.18,,2521944.0,2433099.0,1700489.0,413.0,,,,,,,11131571.0,14694849.0,1425789.0,,,,,,,1861331.0,39948.0,,,,2673.0,,,1266.25,3273.0,,,,,,156592.0,25.72,,258106677.0,,,,,,,34558312.0,,,14769.0,323571.0,,1360174.0,276333452.0,,9689775.0,15809.0,2055830.0,36170,,3716388.0,,4784461.0,,,,225.0,,12776054.0,,,,,1614211672.0,,49.0,,,,,,3439840.0,1531944.0,26569683.0,,,,,,,,,,,,,,924129.0,,,,,,,2199154.0,,17701.0,,,,,,13960.0,,,,-56971.0,,5318832.0,57.0,,,,1551606.0,,,,158340.0,18761855.0,,,,,2013518.0,,,,21412150.0,4877058.0,,121914.63,18695.0,913604.0,,,,,,,,34118680.0,,199.0,,,,403.0,3237572.0,,,,,543424.0,,1966785.0,1639066.0,,1652070.0,26738.0,37.97,,,160074398.0,,,11161981.0,,17927598.0,,,391978.0,,,,-595911.0,-12196741.0,,,13179.0,,,7387.0,58910.0,,6367388.0,,,,,,628457.0,12802957.0,,133586.0,6950190.0,,,223484.0,,1777025.0,485657.0,72949.0,1833330.0,,-30702.0,,,Y,11746972.0,1043877.0,,23985869.0,,,875237.0,,,7300.0,,14089.0,,6597997.0,,,,,,,,6338467.0,,,,,Y,,82033.0,3814.0,,,,29654.0,,30679.0,38240.11,,9666851.0,,,2375949.0,,,122788.0,,,116845.0,,,,13108967.0,1.0,1949459.0,,,,16310393.0,,,,,31.0,195317.0,43036.0,1499.0,134530915.0,,,,693548.0,,6950190.0,,134530915.0,,,3399561.0,,3892981.0,,,1066652.0,,,,1389594.0,29382326.0,,5355.0,36712.0,1666077.0,80723957.0,4298404.0,,,,,774.0,,,,97030.0,,,-61146.0,,1640510.0,,,1031018.0,2361807.0,,45152477.0,,,,,60472.5,57463148.0,,5973493.0,9390164.0,,52168.0,,7773.0,,22.0,,19.93,34.26,2978123.0,379178230.0,,,,2127.0,18695.0,299191.0,,723.0,6442.5,,,,,2263.0,1875747.0,4726739.0,,341517.0,,,,1177599.0,,329246.0,,,,,,267143.0,-208994.0,,790639.0,,,,2727850.0,7263348.0,,1019654447.0,,2279.03,-74938.0,,,,,,,,,165.56,41294250.0,46955.96,2056843.0,,36035.0,,57.47,24.0,58.62,,4816806.0,,99965.0,,2125476.0,,,1127.0,,,1906140.0,,,1556411.0,,,,,636.0,930.0,,,16629.0,,16056.0,,5475.0,,,,,146646.0,12247369.0,7549147.0,485056.0,,,35742290.0,,9124457.0,,27440073.0,,182532787.0,,,3575778.43,8016842.0,,1563.0,,36,,,,,,,,,,,,,63875.0,,11131571.0,,85807539.0,,566719.0,,,4253313.0,,72635.0,,,,,,,24016858.0,49.48,2691902.0,,,122788.0,,-26807.0,34558312.0,,,,,,93924.0,53073.0,,15473.0,,,,13947731.0,,,8626.0,,,,132131.0,389712.0,,537.0,-124094.0,,,1798172.0,,,,2023-12-31,,44130-3497,,,5386511.0,250594.0,1556411.0,,,,2149306.0,,7288167.0,,,,,,3273.0,,,,604293.0,103.77,,,,73422.32,19244171.0,,862301.0,271517.0,585742.0,158711591.0,,,,11964071.0,22355531.0,,204.0,,,,,,,115722.0,N,,,,94.0,1066652.0,1293708.0,,775738,-1923.0,,15927922.0,Y,,OH,,47536730.0,,-16778632.0,2008.0,23159000.0,,,,,1164389.0,,20.0,,7727459.0,15186.0,10489.0,,,9275004.0,,24357767.0,,,432959.0,4757.0,,,,P,,15809.0,,967.0,,,,,,,368.0,,,,11251.0,394798.0,,,5214847.0,,1176081.0,171.0,,,,,4917366.0,,,,,,-62571.0,,18.0,14565945.0,1.0,,,18697 BAGLEY ROAD,,43.15,ACUTE REHAB,,,,,,,,8854.0,,,,5801744.0,3820.0,,45152477.0,,88.0,,,99965.0,,-33964.0,,,,,,3.51,144409.0,,,,,,1678511.0,151.0,,,5231.0,,6524268.0,,,139657283.0,,63871.0,3316.0,184713.0,,,321767.0,225399.0,367253,1881.0,13179.0,20162.0,N,75933.73,177743.0,225209.0,,,,,,,-182551.0,,,,1222.0,267.0,29948.0,24.0,34.52,122788.0,15201,118384977.0,N,34641.0,20832.0,,,2733301.0,,,,35028.0,1474674.0,,,9640175.0,,1.0,164032.0,8082421.0,23589314.0,,,,362582764.0,11061.0,3901245.0,69682.0,,,345937.0,5.0,,3342.0,6332.0,,,58860217.0,2275922.0,,,3937.0,,,,,,15279169.0,122788.0,,12793910.0,,,,180786334.0,,,-41641.0,-5354188.0,9756964.0,,18.0,,7927.0,,,,,,,,,,,,,,2930228.0,,,693.0,4122701.0,3025849.0,862456.0,,,,12776054.0,1069.0,21692830.0,7196.5,,,,16.0,2485069.0,,1629782.0,410780257.0,4060410.0,,122728.0,1612700.0,,,,4034684.0,,,475989.0,,372965.0,64653240.0,609056.0,1241276.0,4784461.0,,,,,,,,,,,,,,-18610.0,45.92,7958.0,,186419.0,,,24477697.0,,,34.26,4137119.0,,,,,896837.0,,,1471864.0,,,,,4519.0,6338467.0,7627537.0,301614.0,90831.0,,,,4257406.0,,,,38.36,,7696005.0,2620889.0,,,3273.0,,,,,952736.0,,11110.0,,,,742131.0,1726573.0,,,2433099.0,,2259312.0,-31170066.0,,,,,8477671.0,,,,,,3894193.0,,,475989.0,896837.0,2023-01-01 00:00:00,,,99965.0,,,1894686.0,2197512.0,,,,25671211.0,931694.0,,,,,1408418.0,,,42782871.0,,,,,,8707423.0,,313.0,,,,63279.0,,,139890.0,,,,,,,99176.0,,,,,,,,74432.0,,6724622.0,1976629.0,,,,,,2094556.0,-1315570.0,39526831.0,1381389.0,,,55544.0,,46.0,1171198.0,,,,,,,,,,-1561477.0,,2673.0,,1863944.0,66.89,,6560310.0,,6334418.0,,,,1140922.0,4377557.0,-556514.0,,-10927671.0,,,,,10571335.0,21837410.0,685798.0,968.0,,1726573.0,,,,550155.0,6182.0,6261449.0,26890292.0,,,6860518.0,4.0,4606091.0,,,,,,,8320640.0,,,,1055.0,,,1546037.0,,17460,,,5785925.0,,305045.0,344275.0,,,,8076571.0,,,,,General Short Term,364977765.0,8076571.0,,101495155.0,,,,132515.0,1833845.0,,,,,,3735.0,,,,,49905.0,,18631804.0,,,122728.0,,,12247369.0,,,,,,,5347.0,,278700.0,4785.0,,32730477.0,3234152.0,7739430.0,,10707702.0,2283740.0,3138136.0,,,,363.0,16280055.0,1720231.0,322886072.0,1261050.3,3435511.0,,6156.0,,3.51,,110155.0,,2274.0,,,,11634.0,,10668960.0,,,,,5889896.0,24367614.0,6550008.0,84060.0,,885.0,,,,,,,,,,,,36929041.0,,1389594.0,274189490.0,,,129290.0,56077.82,,,,3651372.0,,33129089.0,1377693.0,,,6525403.0,,,,,9106426.0,,,,3775.0,,,5992963.0,,,134365710.0,48.0,,,,,,,,2785295.0,,76.0,143840.0,,22474401.0,1173517.0,-76808.0,,,7491.0,-60602.0,,,913604.0,33867.0,1547.0,,862456.0,26.3,,,,,1506546.0,5347.0,,7068600.0,1655073.0,,,,,2572568.0,,,,,,394798.0,,,,259425591.0,,240495.0,,,241688.0,,MIDDLEBURG HEIGHTS,17701.0,,,,1012382.0,,116814.0,-48381.0,,2280409.0,99310.0,175.0,,,,,-411236.0,63984978.0,,,,91757.0,,,,,,397350.0,,,56759.0,,1455269.0,,4377557.0,,,-62271423.0,,3650.0,,,,-34.0,,67051.0,,,,11827.0,,,SWGHC MENTAL HEALTH SERVICES,,30271.0,,20162.0,3814.0,,,,132515.0,,24310855.0,,5874316.0,,5000591.0,1496306.0,5351114.0,236.0,8540169.0,16131.0,,,,,,223484.0,,,,45816819.0,,117679.0,,,,15.0,,,3116311.0,,6524268.0,,,761214.0,,,2712693.0,,638134.0,,,15527.0,,,,,,,,,,,14254.0,,742814.0,1515588.0,,-60602.0,,,,257969.0,541352.0,,,,5033802.0,122788.0,,,1816.0,,20162.0,,4060410.0,7320.0,20646021.0,,,,,,,,,111713.49,,,,,178064.0,,,,603209.0,,797890.0,9130360.0,,,1044761.0,1833330.0,,,448592.0,,,,55210701.0,,9040577.0,1699840.0,,8177249.0,9755623.0,,372965.0,,57256267.0,154.0,,26299.0,,20832.0,8414.0,32693.0,,,,32260.0,,7751120.0,,,13179.0,,,,,,,115.0,,,,,,,,,,,,,,,1455273.0,,18695.0,832546.0,,13.0,,,,,,,,225.0,,,,28193202.0,180786334.0,,,,,,59917.0,,,4536893.0,,,,,23863.0,,,,,,T,2056843.0,6597997.0,,78639257.0,353642.0,,,2361807.0,,3651372.0,,,,1990437.0,SOUTHWEST GENERAL HEALTH CENTER,,,17850.0,33012.0,,,,,,,5889896.0,3426185.0,24572940.0,,,116.0,,-57769.0,,,,6332.0,,,1474674.0,182532787.0,12282551.0,,,10718703.0,Y,,,30.0,,137004.0,604486285.0,3839627.0,11746972.0,2007.0,1794370.0,43266.0,2199154.0,,,14750965.0,,,,413508107.0,,-15486.0,,1403.0,,,,,1292130.0,,3762.0,1137945.0,9422.0,17618.0,,,,,354149.0,,-639.0,,,36905368.0,1515588.0,,34558312.0,30612515.0,,,,,29.98,,20646906.0,,,,,,,,,,,,,,,,,,,,29522429.0,,,,18695.0,,,8707423.0,83670.0,,150704469.0,,,,,54755.0,8016842.0,,,,,18035469.0,1713115.0,15545.0,3650.0,2620889.0,14694849.0,4069114.0,17.0,15473.0,,,,,855660.0,276249342.0,10878876.0,,,133586.0,12777.0,9847.0,,,,16300058.0,,11161981.0,,,15.92,,,,,,2024-06-18 00:00:00,,,,,242967.0,,,,,63871.0,45977355.0,,2320508.0,,,,1140922.0,,,,,,6239347.0,136306.0,,3875321.11,3120648.0,,,210790.21,,,36459.0,5331761.0,,,,,,,,9993337.0,,,139.0,,,,,,,,,85078.0,,,,,372.0,,,2983350.0,,,7834412.0,,,7092418.0,,,,,,,147141764.0,,1360174.0,,20914209.0,,,261589.0,,3.0,,,,3479093.0,,,36S155,,,741307.0,,,,18671.0,,5343747.0,,,34088732.0,,,,,,,,,31813.0,,285748.67,52907854.0,,,,,,,,,4919198.0,2614151.0,,6719657.0,,21412150.0,,,,989285.0,,3850154.0,,,,1591.14,64.0,,179.0,N,575931.0,,12330071.0,,2628117.0,4536.0,,24747.0,,,3237572.0,,146596626.0,,,1731.0,23357.0,,,,5838195.0,35438.0,908.0,Y,39207.0,,,,,24477830.0,1001565.0,,120063.0,,,16301353.0,1317415.0,-1000.0,,,1005.0,1624140732.0,3999841.0,,,,,6239347.0,,19.93,,,26569683.0,,109.19,,,384973.0,,,45824388.0,,,37.51,,,,-183433.0,,,2029584.0,394869.0,,335287.0,,,,34641.0,,,,2021092.0,1823845.0,3153.0,,,5801744.0,,,361530,4764725.0,968.0,,,,,85656.0,,,62.0,171589.0,-2444.0,,,,175.0,116.0,,,,10.0,500003.0,12959292.0,757.0,18631804.0,705014.0,370470.0,,,,,,,,,12405100.0,,Y,,,221964.0,6021.0,,1107.0,206.0,,,N,272899.0,,,1976629.0,8082421.0,13108967.0,156592.0,,5000591.0,,4887510.0,2055830.0,,,,710093.0,,,,,575931.0,12405100.0,,1318.0,1319463.0,,,,,1005.0,,,,,,,,2320508.0,11208640.0,,,,,55210701.0,,1082.0,,,,2365064.0,,5819.5,,600539045.0,,,,1950182.0,15422.0,743744.0,,,931694.0,18739.0,2007.0,,,,6272.0,,5096073.0,115.0,4.0,,455887.0,14076141.0,35458327.0,,,,253481.0,,,2023,Acute Care Hospitals,SOUTHWEST GENERAL HEALTH CENTER (360155)
