,Curated Name and Num,"Hospital type, text","Control type, text",Lon,Lat,RPT_REC_NUM,PRVDR_NUM,FI_NUM,RPT_STUS_CD,FI_CREAT_DT,FY_BGN_DT,FY_END_DT,UTIL_CODE,TRNSMTL_NUM,STATE,ST_CTY_CD,CENSUS,REGION,MSA,A_C1_114,A_C2_114,A_C2_61,B_1_C21_100,B_1_C21_94,B_1_C22_100,B_1_C22_42,B_1_C22_94,B_1_C26_200,C_1_C6_100,C_1_C7_100,C_1_C7_111,D3_HOS_C2_42,D3_HOS_C2_43,D3_HOS_C2_61,D3_HOS_C3_61,D3_IPF_C2_42,D3_IPF_C2_94,D3_IPF_C3_94,D3_IRF_C2_61,D3_IRF_C2_94,D3_IRF_C3_61,D3_IRF_C3_94,D3_SNF_C2_40,D3_SNF_C2_41,D_1_HOS_C4_4201,D_4_HOS_C12_94,D_4_HOS_C4_74,D_4_SNF_C13_200,D_5_HOS_C2_94,D_5_HOS_C3_61,D_5_HOS_C4_94,D_5_HOS_C6_61,D_5_HOS_C7_94,E_B_HOS_C101_3,E_B_HOS_C101_4,E_B_HOS_C101_6,E_B_HOS_C101_7,E_B_HOS_C101_8,E_B_HOS_C1_3998,E_B_HOS_C1_4001,S3_1_C10_1801,S3_1_C2_1801,S3_1_C2_32,S3_1_C3_1801,S3_1_C3_32,S3_1_C5_19,S3_1_C5_20,S3_1_C7_1801,S3_1_C8_1801,S3_1_C9_18,S3_2_C2_1401,S3_2_C2_1402,S3_2_C2_2550,S3_2_C2_2551,S3_2_C2_2552,S3_2_C2_2553,S3_2_C3_1401,S3_2_C3_1402,S3_2_C3_24,S3_2_C3_2550,S3_2_C3_2551,S3_2_C3_2552,S3_2_C3_2553,S3_2_C4_1401,S3_2_C4_1402,S3_2_C4_1601,S3_2_C4_1602,S3_2_C4_2550,S3_2_C4_2551,S3_2_C4_2552,S3_2_C4_2553,S3_2_C6_1401,S3_2_C6_1402,S4_HHA2_C1_34,S4_HHA2_C2_34,S4_HHA2_C2_38,S4_HHA2_C3_34,S4_HHA2_C4_34,S4_HHA2_C4_37,S4_HHA2_C5_34,S4_HHA3_C1_33,S4_HHA3_C1_34,S4_HHA3_C1_35,S4_HHA3_C1_36,S4_HHA3_C1_38,S4_HHA3_C2_33,S4_HHA3_C2_34,S4_HHA3_C2_35,S4_HHA3_C2_37,S4_HHA3_C2_38,S4_HHA3_C3_33,S4_HHA3_C3_34,S4_HHA3_C3_35,S4_HHA3_C3_36,S4_HHA3_C3_38,S4_HHA3_C4_33,S4_HHA3_C4_34,S4_HHA3_C4_35,S4_HHA3_C4_36,S4_HHA3_C4_37,S4_HHA3_C4_38,S4_HHA3_C5_33,S4_HHA3_C5_34,S4_HHA3_C5_35,S4_HHA3_C5_36,S4_HHA3_C5_37,S4_HHA3_C5_38,A7_1_C1_10,A7_1_C1_4,A7_1_C1_5,A7_1_C1_6,A7_1_C1_8,A7_1_C2_10,A7_1_C2_5,A7_1_C2_6,A7_1_C2_8,A7_1_C7_10,A7_1_C7_5,A7_1_C7_6,A7_1_C7_8,A7_3_C10_3,A7_3_C15_3,A7_3_C9_3,A8_C2_14,A8_C2_18,A8_C2_4,A8_C2_5,A8_C2_50,A_C1_200,A_C1_30,A_C2_200,A_C2_30,A_C2_74,A_C6_200,A_C6_30,B_1_C0_200,B_1_C0_30,B_1_C0_74,B_1_C26_202,B_1_C26_30,B_1_C26_74,B_2_C26_202,B_2_C26_30,B_2_C26_74,C_1_C3_202,C_1_C5_200,C_1_C5_202,C_1_C5_30,C_1_C5_74,C_1_C6_202,C_1_C6_30,C_1_C6_74,C_1_C8_202,D1_HOS_C1_27,D1_HOS_C1_37,D1_HOS_C1_41,D1_HOS_C1_48,D1_HOS_C1_49,D1_HOS_C1_50,D1_HOS_C1_51,D1_HOS_C1_52,D1_HOS_C1_53,D3_HOS_C2_30,D3_HOS_C2_74,D3_HOS_C3_200,D3_HOS_C3_74,D_1_HOS_C4_200,D_1_HOS_C4_30,D_1_HOS_C6_200,D_1_HOS_C6_30,D_1_HOS_C7_200,D_1_HOS_C7_30,D_3_HOS_C6_200,D_3_HOS_C8_200,S10_C1_1,S10_C1_26,S10_C1_27,S10_C1_30,S10_C1_31,S10_C2_20,S10_C2_21,S10_C2_23,S10_C3_20,S10_C3_21,S10_C3_23,S2_1_C1_26,S2_1_C1_27,S2_1_C4_3,S3_1_C10_14,S3_1_C10_27,S3_1_C13_1,S3_1_C13_14,S3_1_C15_1,S3_1_C15_14,S3_1_C2_1,S3_1_C2_14,S3_1_C2_27,S3_1_C2_7,S3_1_C3_1,S3_1_C3_14,S3_1_C3_7,S3_1_C6_1,S3_1_C6_14,S3_1_C6_7,S3_1_C8_1,S3_1_C8_14,S3_1_C8_7,A7_1_C1_1,A7_1_C1_3,A7_1_C2_3,A7_3_C11_3,A7_3_C7_3,A8_C2_1,A8_C2_10,A8_C2_12,A8_C2_3,A_C1_40,A_C2_113,A_C2_3,A_C2_40,B_1_C0_40,B_1_C26_40,B_2_C26_40,C_1_C5_40,C_1_C6_40,C_1_C7_202,D1_IPF_C1_27,D1_IPF_C1_37,D1_IPF_C1_41,D1_IPF_C1_49,D1_IPF_C1_50,D1_IPF_C1_52,D1_IPF_C1_53,D3_IPF_C2_40,D_1_HOS_C4_40,D_1_HOS_C6_40,D_1_HOS_C7_40,E_B_HOS_C1_17,S3_1_C14_1,S3_1_C14_14,S3_1_C14_16,S3_1_C15_16,S3_1_C2_16,S3_1_C3_16,S3_1_C6_16,S3_1_C7_1,S3_1_C7_14,S3_1_C7_16,S3_1_C7_7,S3_1_C8_16,S3_2_C2_1,S3_2_C2_10,S3_2_C2_27,S3_2_C2_30,S3_2_C2_32,S3_2_C2_34,S3_2_C2_38,S3_2_C2_41,S3_2_C2_43,S3_3_C2_1,S3_3_C2_2,S3_3_C2_3,S3_3_C2_6,S3_3_C4_1,S3_3_C4_2,S3_3_C4_3,S3_3_C4_6,S3_3_C4_7,B_1_C26_201,D_4_HOS_C12_200,D_5_HOS_C2_200,D_5_HOS_C5_200,E_B_HOS_C1_2,E_B_HOS_C1_24,E_B_HOS_C1_26,E_B_HOS_C1_27,E_B_HOS_C1_3,E_B_HOS_C1_30,E_B_HOS_C1_32,E_B_HOS_C1_34,E_B_HOS_C1_35,E_B_HOS_C1_36,E_B_HOS_C1_37,E_B_HOS_C1_40,E_B_HOS_C1_41,E_B_HOS_C1_43,A7_1_C1_2,A7_1_C5_10,A7_1_C5_6,A7_1_C5_8,A7_1_C7_2,A7_1_C7_3,A7_1_C7_4,A8_C2_26,A8_C2_27,B_2_C0_202,S3_1_C11_14,S3_1_C11_27,S3_2_C2_26,S3_2_C2_29,S3_2_C2_31,S3_2_C2_40,S3_2_C2_42,S3_2_C4_1,S3_2_C4_10,S3_2_C4_26,S3_2_C4_27,S3_2_C4_29,S3_2_C4_30,S3_2_C4_31,S3_2_C4_32,S3_2_C4_34,S3_2_C4_38,S3_2_C4_40,S3_2_C4_41,S3_2_C4_42,S3_2_C5_1,S3_2_C6_1,S3_3_C5_1,S3_3_C5_3,S3_3_C6_1,S3_3_C6_3,S3_3_C6_6,B_1_C21_30,B_1_C22_30,B_2_C26_200,E_B_HOS_C1_28,E_B_HOS_C1_42,S3_1_C9_14,S3_1_C9_27,A7_1_C2_4,A7_1_C5_4,B_1_C0_43,B_1_C26_43,B_2_C26_43,C_1_C5_201,C_1_C5_43,C_1_C6_43,D_1_HOS_C4_43,S10_C1_19,S10_C1_2,S10_C1_20,S10_C1_21,S10_C1_23,S10_C1_6,S3_1_C7_13,S3_1_C8_13,S3_1_C8_28,S3_2_C2_17,S3_2_C2_18,S3_2_C2_21,S3_2_C4_17,S3_2_C4_18,S3_2_C4_21,S3_2_C5_27,S3_2_C6_27,S3_3_C2_5,S3_3_C4_5,S3_3_C5_7,S3_3_C6_5,S3_3_C6_7,A8_C2_9,A7_3_C5_3,A8_C2_15,A_C2_45,A_C6_45,B_1_C0_45,B_1_C26_45,B_2_C26_45,C_1_C5_45,C_1_C6_45,A7_3_C6_3,A8_C2_20,A8_C2_7,A8_C2_8,C_1_C7_74,D_5_HOS_C3_200,D_5_HOS_C3_74,D_5_HOS_C6_200,D_5_HOS_C6_74,E_B_HOS_C1_1,E_B_HOS_C1_11,E_B_HOS_C1_12,E_B_HOS_C1_14,E_B_HOS_C1_18,E_B_HOS_C1_19,E_B_HOS_C1_21,E_B_HOS_C1_25,S3_1_C7_2,S3_2_C2_11,S3_2_C2_13,S3_2_C2_14,S3_2_C2_19,S3_2_C2_39,S3_2_C4_11,S3_2_C4_13,S3_2_C4_14,S3_2_C4_19,S3_2_C4_39,S3_2_C5_10,S3_2_C5_11,S3_2_C5_13,S3_2_C5_14,S3_2_C5_26,S3_2_C5_30,S3_2_C5_32,S3_2_C5_34,S3_2_C5_38,S3_2_C5_39,S3_2_C5_41,S3_2_C5_42,S3_2_C6_10,S3_2_C6_11,S3_2_C6_13,S3_2_C6_14,S3_2_C6_26,S3_2_C6_30,S3_2_C6_32,S3_2_C6_34,S3_2_C6_38,S3_2_C6_39,S3_2_C6_41,S3_2_C6_42,S3_3_C2_4,S3_3_C4_4,S3_3_C5_2,S3_3_C5_4,S3_3_C6_2,S3_3_C6_4,A7_1_C2_1,A8_C2_11,A_C1_43,A_C2_43,D_4_HOS_C11_200,D_4_HOS_C12_74,D_4_HOS_C13_200,D_4_HOS_C3_200,D_4_HOS_C6_200,D_5_HOS_C2_74,D_5_HOS_C4_200,D_5_HOS_C5_74,D_5_HOS_C7_200,E_B_HOS_C1_20,E_B_HOS_C1_31,E_B_HOS_C1_9,S10_C1_10,S10_C1_11,S10_C1_9,S2_1_C2_24,S2_1_C4_24,S3_1_C6_2,S3_2_C2_22,S3_2_C2_23,S3_2_C2_4,S3_2_C2_5,S3_2_C4_22,S3_2_C4_23,S3_2_C4_3,S3_2_C4_4,S3_2_C4_5,S3_2_C5_3,S3_2_C5_4,S3_2_C5_40,S3_2_C5_5,S3_2_C6_3,S3_2_C6_4,S3_2_C6_40,S3_2_C6_5,S3_3_C5_6,A7_1_C2_2,A_C6_113,E_B_HOS_C1_38,A7_1_C3_10,A7_1_C3_3,A7_1_C3_4,A7_1_C3_6,A7_1_C3_8,A8_C2_16,S10_C1_22,S10_C2_22,S10_C3_22,S2_1_C1_24,S2_1_C1_37,S2_1_C3_24,S3_2_C2_2,S3_2_C2_20,S3_2_C4_2,S3_2_C4_20,S3_2_C5_2,S3_2_C6_2,A7_1_C5_3,A_C1_41,A_C1_44,A_C2_41,A_C2_44,A_C6_40,A_C6_41,B_1_C0_41,B_1_C26_41,B_2_C26_41,C_1_C5_41,C_1_C6_41,D1_IPF_C1_48,D1_IPF_C1_51,D1_IRF_C1_27,D1_IRF_C1_37,D1_IRF_C1_41,D1_IRF_C1_48,D1_IRF_C1_49,D1_IRF_C1_50,D1_IRF_C1_51,D1_IRF_C1_52,D1_IRF_C1_53,D3_IPF_C2_200,D3_IPF_C2_74,D3_IPF_C3_200,D3_IPF_C3_74,D3_IRF_C2_200,D3_IRF_C2_41,D3_IRF_C2_74,D3_IRF_C3_200,D3_IRF_C3_74,D_1_HOS_C4_41,D_1_HOS_C6_41,D_1_HOS_C7_41,S3_1_C13_16,S3_1_C13_17,S3_1_C14_17,S3_1_C15_17,S3_1_C2_17,S3_1_C3_17,S3_1_C6_17,S3_1_C7_17,S3_1_C8_17,S3_2_C2_9,S3_2_C4_36,S3_2_C5_36,S3_2_C6_36,A8_C2_17,A_C1_95,A_C2_95,B_1_C0_44,B_1_C0_95,B_1_C26_44,B_1_C26_95,B_2_C26_44,B_2_C26_95,C_1_C5_44,C_1_C5_95,C_1_C6_44,C_1_C7_95,D1_SNF_C1_37,D1_SNF_C1_74,D1_SNF_C1_84,D3_SNF_C2_202,D3_SNF_C3_200,E_B_HOS_C1_5,E_B_HOS_C1_6,S2_1_C5_24,S3_1_C10_19,S3_1_C2_19,S3_1_C3_19,S3_1_C6_19,S3_1_C7_19,S3_1_C8_19,S3_2_C4_9,S3_2_C5_31,S3_2_C5_9,S3_2_C6_31,S3_2_C6_9,S4_HHA1_C1_33,S4_HHA1_C1_35,S4_HHA1_C1_36,S4_HHA1_C1_38,S4_HHA1_C2_33,S4_HHA1_C2_35,S4_HHA1_C2_37,S4_HHA1_C2_38,S4_HHA1_C3_33,S4_HHA1_C3_35,S4_HHA1_C3_36,S4_HHA1_C3_38,S4_HHA1_C4_33,S4_HHA1_C4_35,S4_HHA1_C4_36,S4_HHA1_C5_33,S4_HHA1_C5_35,S4_HHA1_C5_36,S4_HHA1_C5_37,S4_HHA1_C5_38,A_C1_105,A_C1_74,A_C2_105,A_C2_109,A_C6_105,B_1_C0_105,B_1_C0_109,B_1_C22_40,B_1_C26_105,B_1_C26_109,B_2_C26_105,B_2_C26_109,C_1_C5_105,C_1_C5_109,C_1_C6_105,D4_KIDNEY_C1_69,D4_PANCREAS_C1_69,D_3_HOS_C2_200,D_3_HOS_C5_200,D_3_HOS_C9_200,D_3_HOS_C9_30,E_B_HOS_C1_4,S3_1_C13_2,S3_1_C7_32,S3_1_C8_32,S3_2_C2_12,S3_2_C4_12,S3_2_C5_12,S3_2_C6_12,B_2_C26_201,D1_HOS_C1_26,E_B_HOS_C1_7,E_B_HOS_C1_8,S3_1_C6_5,S3_1_C8_5,S3_1_C8_6,S3_2_C5_29,S3_2_C6_29,S4_HHA1_C4_38,A8_C2_2,S10_C1_13,S10_C1_14,S10_C1_15,S10_C1_16,A8_C2_21,A8_C2_6,A_C6_43,S3_2_C2_28,S3_2_C4_28,S3_2_C5_28,S3_2_C6_28,A8_C2_13,A_C1_45,S3_1_C10_20,S3_1_C2_20,S3_1_C3_20,S3_1_C4_1,S3_1_C4_14,S3_1_C4_7,S3_1_C7_20,S3_1_C8_20,A7_1_C5_5,A8_C2_28,A_C6_44,S10_C1_12,S3_2_C2_3,D_4_HOS_C1_200,S3_1_C7_5,S3_2_C2_24,S3_2_C2_6,S3_2_C4_24,S3_2_C4_6,S3_2_C5_6,S3_2_C6_6,A8_C2_22,S3_1_C6_29,S3_1_C7_6,A_C6_95,S3_1_C6_15,S3_1_C7_15,S3_1_C8_15,S10_C1_18,C_1_C6_95,S4_HHA1_C1_34,S4_HHA1_C2_34,S4_HHA1_C3_34,S4_HHA1_C4_34,S4_HHA1_C5_34,S3_2_C2_35,S3_2_C4_35,A7_1_C5_2,D_5_HOS_C3_95,D_5_HOS_C6_95,A7_1_C1_7,A7_1_C2_7,A7_1_C4_7,A7_1_C5_7,A7_1_C6_7,A7_1_C7_1,A7_1_C7_7,A_C1_106,A_C1_107,A_C2_106,A_C2_107,A_C6_106,A_C6_107,A_C6_74,B_1_C0_106,B_1_C0_107,B_1_C26_100,B_1_C26_106,B_1_C26_107,B_2_C26_100,B_2_C26_106,B_2_C26_107,C_1_C5_100,C_1_C5_106,C_1_C5_107,C_1_C6_106,C_1_C6_107,C_1_C6_109,C_1_C7_105,C_1_C7_106,C_1_C7_107,C_1_C7_109,D4_HEART_C1_69,D4_LIVER_C1_69,S3_2_C2_16,S3_2_C2_25,S3_2_C2_7,S3_2_C4_16,S3_2_C4_25,S3_2_C4_43,S3_2_C4_7,S3_2_C5_16,S3_2_C5_43,S3_2_C5_7,S3_2_C6_16,S3_2_C6_43,S3_2_C6_7,S5_C1_11,S5_C1_13,S5_C1_15,S5_C1_2,S5_C1_3,S5_C1_5,S5_C1_6,S5_C1_7,S5_C1_8,S5_C2_1,A_C2_94,S5_C1_12,S5_C2_3,S5_C4_6,S4_HHA1_C4_37,A_C1_46,A_C2_46,A_C6_46,B_1_C0_46,B_1_C26_46,B_2_C26_46,C_1_C5_46,C_1_C6_46,S3_1_C10_21,S3_1_C15_21,S3_1_C2_21,S3_1_C3_21,S3_1_C8_21,B_1_C22_44,S3_1_C9_19,A_C2_100,B_1_C0_100,A_C1_42,A_C2_42,A_C6_42,B_1_C0_42,B_1_C26_42,B_2_C26_42,C_1_C5_42,C_1_C6_42,D_1_HOS_C4_42,S3_1_C15_18,S3_1_C2_18,S3_1_C3_18,S3_1_C8_18,E_B_HOS_C1_23,A8_C2_24,S3_1_C12_1,S3_1_C12_14,S3_1_C5_1,S3_1_C5_14,S3_1_C5_7,A8_C2_29,A_C1_94,B_1_C0_94,B_1_C26_94,B_2_C26_94,C_1_C5_94,C_1_C6_94,C_1_C7_94,D_5_HOS_C4_74,D_5_HOS_C7_74,E_B_HOS_C1_33,E_B_HOS_C1_44,S10_C1_17,S5_C2_2,S5_C2_5,S5_C2_6,S5_C2_7,S5_C4_2,S5_C4_3,S5_C6_1,S5_C6_2,S5_C6_4,S3_2_C5_35,S3_2_C6_35,A_C6_100,A_C1_109,B_1_C21_40,B_1_C21_41,B_1_C21_43,B_1_C22_41,B_1_C22_43,D_3_HOS_C9_40,D_3_HOS_C9_41,D_4_IPF_C11_200,D_4_IPF_C3_200,D_4_IPF_C6_200,D_4_IRF_C11_200,D_4_IRF_C3_200,D_4_IRF_C6_200,S3_2_C2_36,A_C6_3,D1_HOS_C1_54,D1_HOS_C1_55,D1_HOS_C1_56,D1_HOS_C1_57,D1_HOS_C1_58,D1_HOS_C1_63,S3_2_C2_8,S3_2_C4_8,S3_2_C5_8,S3_2_C6_8,S3_1_C11_19,D3_SNF_C2_30,D_4_HOS_C4_200,D_4_IPF_C4_200,D_4_IRF_C4_200,S5_C1_1,S5_C1_10,S5_C1_9,S5_C4_1,D_3_HOS_C9_44,D_4_HOS_C11_74,D_4_HOS_C13_74,D_4_HOS_C2_200,D_4_HOS_C3_74,D_4_IRF_C2_200,D_4_SNF_C11_200,A8_C2_30,S2_1_C6_24,D_4_IPF_C1_200,A8_C2_19,A7_1_C5_1,A8_C2_31,A7_1_C3_5,A_C1_4201,A_C2_4201,A_C6_4201,B_1_C0_4201,B_1_C26_4201,B_2_C26_4201,C_1_C5_4201,C_1_C6_4201,A8_C2_23,S3_2_C5_37,D3_HOS_C2_40,A_C1_108,A_C2_108,A_C6_108,A_C6_109,B_1_C0_108,B_1_C21_74,B_1_C26_108,B_2_C26_108,C_1_C5_108,C_1_C6_108,D3_HOS_C2_94,D3_HOS_C3_94,D4_LUNG_C1_69,D_4_HOS_C11_94,D_4_HOS_C2_74,D_4_HOS_C2_94,D_4_IPF_C2_200,D_4_IRF_C13_200,S5_C2_8,B_1_C22_74,S3_2_C2_33,S3_2_C4_33,S3_2_C5_33,S3_2_C6_33,C_1_C7_108,S3_2_C2_2201,S3_2_C4_2201,S3_1_C5_13,A_C6_94,S5_C1_14,B_1_C0_61,B_1_C26_61,C_1_C5_61,C_1_C6_61,C_1_C7_61,D3_SNF_C2_74,D3_SNF_C3_74,S5_C4_4,D_5_HOS_C3_94,S3_2_C2_15,S3_2_C4_15,S3_2_C5_15,S3_2_C6_15,E_B_HOS_C1_22,S5_C5_1,S5_C5_2,B_1_C21_44,D_4_IRF_C11_74,D1_HOS_C1_62,D_4_IPF_C13_200,A7_1_C3_1,D3_HOS_C2_41,S3_1_C10_18,S3_1_C14_18,S3_1_C7_18,A_C1_110,A_C2_110,B_1_C0_110,B_1_C26_110,B_2_C26_110,C_1_C6_110,B_1_C21_105,B_1_C21_107,B_1_C22_105,B_1_C22_107,S3_2_C2_37,S3_2_C4_37,S3_2_C6_37,A_C1_100,A_C6_110,B_1_C22_106,B_1_C22_108,B_1_C22_109,B_1_C22_110,C_1_C7_110,S3_1_C12_16,S3_1_C5_16,S3_2_C3_22,S3_2_C3_23,S3_2_C3_25,D3_SNF_C2_94,D3_SNF_C3_94,D_4_HOS_C3_94,S3_1_C11_21,E_B_HOS_C101_5,S3_2_C3_14,S4_HHA2_C1_33,S4_HHA2_C1_35,S4_HHA2_C1_36,S4_HHA2_C1_38,S4_HHA2_C3_33,S4_HHA2_C3_35,S4_HHA2_C3_36,S4_HHA2_C5_33,S4_HHA2_C5_35,S4_HHA2_C5_36,S4_HHA2_C5_38,A7_1_C3_2,B_1_C21_45,B_1_C22_45,S3_1_C9_20,E_B_HOS_C1_29,D3_IRF_C2_40,A8_C2_25,A_C6_114,D1_SNF_C1_85,A_C1_4501,A_C2_4501,B_1_C0_4501,B_1_C26_4501,B_2_C26_4501,C_1_C5_4501,C_1_C6_4501,S3_1_C10_2001,S3_1_C2_2001,S3_1_C3_2001,S3_1_C8_2001,B_1_C21_95,B_1_C22_95,B_1_C21_46,B_1_C22_46,S3_1_C9_21,D_4_IPF_C11_74,S2_1_C1_11801,S2_1_C2_11801,S2_1_C3_11801,S5_C2_10,S5_C2_9,S5_C3_1,S5_C3_2,S5_C3_3,S5_C3_6,A7_1_C3_7,C_1_C5_110,S3_1_C7_2001,S3_1_C5_17,S4_HHA2_C3_38,S4_HHA2_C4_33,S4_HHA2_C4_35,S4_HHA2_C4_36,S3_1_C13_18,A_C6_4501,D_3_HOS_C3_200,B_1_C21_106,B_1_C21_108,B_1_C21_109,D_4_IRF_C13_74,A_C6_61,A_C1_111,A_C2_111,B_1_C0_111,B_1_C26_111,B_2_C26_111,C_1_C5_111,C_1_C6_111,D_5_HOS_C6_94,D3_IPF_C2_41,A_C6_111,B_1_C22_111,D4_ISLET_C1_69,D4_INTESTINE_C1_69,D_4_SNF_C11_74,B_1_C21_42,S4_HHA2_C4_38,S4_HHA2_C2_33,S4_HHA2_C2_35,S4_HHA2_C2_37,S4_HHA2_C5_37,S3_1_C12_17,S3_1_C6_32,E_B_HOS_C1_10,E_B_HOS_C1_13,S10_C1_2701,S3_2_C3_2201,E_B_HOS_C1_15,E_B_HOS_C1_16,E_B_HOS_C101_2,D_4_IPF_C13_74,S2_1_C2_1202,S2_1_C2_13,S2_1_C2_1510,S2_1_C2_1511,S2_1_C2_1512,S2_1_C2_1513,S2_1_C2_1514,S2_1_C2_1515,S2_1_C2_1516,S2_1_C2_1517,S2_1_C2_1518,S2_1_C2_1519,S2_1_C2_1520,S2_1_C2_1521,S2_1_C2_1522,S2_1_C2_1523,S2_1_C2_1524,S2_1_C2_1601,S2_1_C2_1602,S2_1_C2_1603,S2_1_C2_1604,S2_1_C2_1605,S2_1_C2_1606,S2_1_C2_1607,S2_1_C2_1608,S2_1_C1_3601,S2_1_C2_3601,S2_1_C1_3801,S2_1_C2_3801,S2_1_C2_130,S2_1_C2_132,S2_1_C1_1,S2_1_C1_2,S2_1_C3_2,S2_1_C4_2,S2_1_C1_3,S2_1_C3_3,S2_1_C7_3,S2_1_C1_21,S2_1_C1_22,S2_1_C1_47,S2_1_C1_48,S2_1_C1_56,S2_1_C1_60,S2_1_C1_85,S2_1_C1_86,S2_1_C1_93,S2_1_C1_105,S2_1_C1_106,S2_1_C1_108,S2_1_C1_115,S2_1_C1_116,S2_1_C1_125,S2_1_C1_140,S2_1_C1_144,S2_1_C1_145,S2_1_C1_4,S2_1_C2_4,S2_1_C2_140,S2_1_C1_141,S2_1_C1_142,S2_1_C1_143,S2_1_C2_143,S2_1_C3_143,S2_1_C2_115,S10_C1_3,S2_1_C2_1,S2_1_C2_10,S2_1_C2_7,S2_1_C1_38,S2_1_C2_38,S2_1_C1_5,S2_1_C2_5,S2_1_C2_9,S2_1_C2_12,S2_1_C2_14,S2_1_C1_36,S2_1_C2_36,S2_1_C1_126,S2_1_C2_8,S2_1_C2_15,S2_1_C2_1501,S2_1_C2_142,S2_1_C2_18,S2_1_C2_1502,S2_1_C2_1503,S2_1_C2_1504,S5_C1_21,S2_1_C1_127,S2_1_C1_128,S2_1_C2_1801,S2_1_C2_1401,S5_C2_21,S2_1_C1_129,S2_1_C1_134,S2_1_C2_17,S2_1_C1_131,S2_1_C2_1505,S2_1_C2_1506,S2_1_C2_1507,S2_1_C2_1508,S2_1_C2_1509,S2_1_C2_1802,S2_1_C2_1803,S2_1_C2_1804,S2_1_C2_1201,S2_1_C2_126,S2_1_C2_127,S2_1_C2_128,S2_1_C2_1805,S2_1_C2_16,S2_1_C2_1001,S2_1_C2_1806,S2_1_C2_1807,S2_1_C2_1808,S2_1_C2_1809,S2_1_C1_132,S2_1_C2_129,A_C1_6250,A_C2_6250,A_C6_6250,B_1_C0_6250,B_1_C21_101,B_1_C21_115,B_1_C21_116,B_1_C21_117,B_1_C21_89,B_1_C21_99,B_1_C22_101,B_1_C22_115,B_1_C22_116,B_1_C22_117,B_1_C22_89,B_1_C22_99,B_1_C26_6250,B_2_C26_6250,C_1_C2_65,C_1_C2_67,C_1_C2_68,C_1_C5_6250,C_1_C6_9920,C_1_C6_9930,C_1_C6_9940,C_1_C7_6250,C_1_C7_89,D3_HOS_C3_6250,D3_SNF_C2_32,D3_SNF_C2_34,D3_SNF_C2_35,D3_SNF_C2_96,D3_SNF_C3_96,D_4_HOS_C12_6250,D_4_HOS_C1_73,D_4_HOS_C1_76,D_4_HOS_C1_91,D_4_HOS_C2_56,D_4_HOS_C2_62,D_4_HOS_C2_67,D_4_HOS_C2_68,D_4_HOS_C2_71,D_4_HOS_C2_72,D_4_HOS_C3_6250,D_4_HOS_C3_88,D_4_HOS_C3_89,D_4_HOS_C3_98,D_4_HOS_C4_52,D_4_HOS_C4_53,D_4_HOS_C4_55,D_4_HOS_C4_56,D_4_HOS_C4_59,D_4_HOS_C4_60,D_4_HOS_C4_64,D_4_HOS_C4_66,D_4_HOS_C4_67,D_4_HOS_C4_68,D_4_HOS_C4_69,D_4_HOS_C4_70,D_4_HOS_C4_71,D_4_HOS_C4_72,D_4_HOS_C4_73,D_4_HOS_C4_76,D_4_HOS_C4_88,D_4_HOS_C4_89,D_4_HOS_C4_93,D_4_IPF_C11_71,D_4_IPF_C13_51,D_4_IPF_C13_55,D_4_IPF_C13_56,D_4_IPF_C13_58,D_4_IPF_C13_59,D_4_IPF_C13_62,D_4_IPF_C13_63,D_4_IPF_C13_64,D_4_IPF_C13_65,D_4_IPF_C13_66,D_4_IPF_C13_67,D_4_IPF_C13_68,D_4_IPF_C13_75,D_4_IPF_C13_76,D_4_IPF_C13_9201,D_4_IPF_C13_93,D_4_IRF_C13_51,D_4_IRF_C13_53,D_4_IRF_C13_55,D_4_IRF_C13_57,D_4_IRF_C13_58,D_4_IRF_C13_59,D_4_IRF_C13_62,D_4_IRF_C13_63,D_4_IRF_C13_66,D_4_IRF_C13_68,D_4_IRF_C13_70,D_4_IRF_C13_71,D_4_IRF_C13_72,D_4_IRF_C13_75,D_4_IRF_C13_76,D_4_IRF_C13_93,D_4_SNF_C11_52,D_4_SNF_C11_58,D_4_SNF_C11_62,D_4_SNF_C11_64,D_4_SNF_C11_69,D_4_SNF_C11_72,D_4_SNF_C11_75,D_4_SNF_C11_9201,D_4_SNF_C13_73,D_5_HOS_C2_6250,D_5_HOS_C3_6250,D_5_HOS_C4_96,D_5_HOS_C4_98,D_5_HOS_C5_6250,D_5_HOS_C6_6250,D_5_HOS_C7_96,D_5_HOS_C7_98,S3_1_C11_25,S3_1_C4_10,S3_1_C4_11,S3_1_C6_25,S3_1_C7_25,S3_1_C8_25,S3_1_C9_22,A7_3_C10_1,A7_3_C10_2,A7_3_C15_1,A7_3_C15_2,A7_3_C9_1,A7_3_C9_2,A8_C2_33,A_C1_15,A_C1_16,A_C1_17,A_C1_5,A_C1_65,A_C1_66,A_C1_67,A_C1_69,A_C1_9,A_C2_1,A_C2_10,A_C2_15,A_C2_16,A_C2_17,A_C2_2,A_C2_4,A_C2_5,A_C2_50,A_C2_51,A_C2_53,A_C2_54,A_C2_55,A_C2_60,A_C2_63,A_C2_65,A_C2_66,A_C2_67,A_C2_68,A_C2_69,A_C2_7,A_C2_70,A_C2_71,A_C2_73,A_C2_9,A_C6_15,A_C6_16,A_C6_17,A_C6_5,B_1_C0_1,B_1_C0_10,B_1_C0_15,B_1_C0_16,B_1_C0_17,B_1_C0_2,B_1_C0_4,B_1_C0_5,B_1_C0_50,B_1_C0_51,B_1_C0_53,B_1_C0_54,B_1_C0_55,B_1_C0_57,B_1_C0_58,B_1_C0_60,B_1_C0_63,B_1_C0_64,B_1_C0_65,B_1_C0_66,B_1_C0_67,B_1_C0_68,B_1_C0_69,B_1_C0_7,B_1_C0_70,B_1_C0_71,B_1_C0_72,B_1_C0_73,B_1_C0_9,B_1_C0_90,B_1_C0_91,B_1_C26_50,B_1_C26_51,B_1_C26_53,B_1_C26_54,B_1_C26_55,B_1_C26_57,B_1_C26_58,B_1_C26_60,B_1_C26_63,B_1_C26_64,B_1_C26_65,B_1_C26_66,B_1_C26_67,B_1_C26_68,B_1_C26_69,B_1_C26_70,B_1_C26_71,B_1_C26_72,B_1_C26_73,B_1_C26_90,B_1_C26_91,B_2_C26_50,B_2_C26_51,B_2_C26_53,B_2_C26_54,B_2_C26_55,B_2_C26_57,B_2_C26_58,B_2_C26_60,B_2_C26_63,B_2_C26_64,B_2_C26_65,B_2_C26_66,B_2_C26_67,B_2_C26_68,B_2_C26_69,B_2_C26_70,B_2_C26_71,B_2_C26_72,B_2_C26_73,B_2_C26_90,B_2_C26_91,C_1_C5_50,C_1_C5_51,C_1_C5_53,C_1_C5_54,C_1_C5_55,C_1_C5_57,C_1_C5_58,C_1_C5_60,C_1_C5_63,C_1_C5_64,C_1_C5_65,C_1_C5_66,C_1_C5_67,C_1_C5_68,C_1_C5_69,C_1_C5_70,C_1_C5_71,C_1_C5_72,C_1_C5_73,C_1_C5_90,C_1_C5_91,C_1_C6_50,C_1_C6_51,C_1_C6_53,C_1_C6_54,C_1_C6_55,C_1_C6_57,C_1_C6_58,C_1_C6_60,C_1_C6_63,C_1_C6_64,C_1_C6_65,C_1_C6_66,C_1_C6_67,C_1_C6_68,C_1_C6_69,C_1_C6_70,C_1_C6_71,C_1_C6_72,C_1_C6_73,C_1_C6_90,C_1_C6_91,D3_HOS_C2_50,D3_HOS_C2_51,D3_HOS_C2_53,D3_HOS_C2_54,D3_HOS_C2_55,D3_HOS_C2_57,D3_HOS_C2_58,D3_HOS_C2_60,D3_HOS_C2_63,D3_HOS_C2_64,D3_HOS_C2_65,D3_HOS_C2_66,D3_HOS_C2_67,D3_HOS_C2_68,D3_HOS_C2_69,D3_HOS_C2_70,D3_HOS_C2_71,D3_HOS_C2_72,D3_HOS_C2_73,D3_HOS_C2_90,D3_HOS_C2_91,D3_HOS_C3_50,D3_HOS_C3_51,D3_HOS_C3_53,D3_HOS_C3_54,D3_HOS_C3_55,D3_HOS_C3_57,D3_HOS_C3_58,D3_HOS_C3_60,D3_HOS_C3_63,D3_HOS_C3_64,D3_HOS_C3_65,D3_HOS_C3_66,D3_HOS_C3_67,D3_HOS_C3_68,D3_HOS_C3_69,D3_HOS_C3_70,D3_HOS_C3_71,D3_HOS_C3_72,D3_HOS_C3_73,D3_HOS_C3_90,D3_HOS_C3_91,D_4_HOS_C10_50,D_4_HOS_C10_51,D_4_HOS_C10_53,D_4_HOS_C10_54,D_4_HOS_C10_55,D_4_HOS_C10_57,D_4_HOS_C10_58,D_4_HOS_C10_60,D_4_HOS_C10_63,D_4_HOS_C10_64,D_4_HOS_C10_65,D_4_HOS_C10_66,D_4_HOS_C10_67,D_4_HOS_C10_68,D_4_HOS_C10_69,D_4_HOS_C10_70,D_4_HOS_C10_71,D_4_HOS_C10_72,D_4_HOS_C10_73,D_4_HOS_C10_90,D_4_HOS_C10_91,A7_3_C11_1,A7_3_C7_1,A7_3_C7_2,A_C1_10,A_C1_13,A_C1_18,A_C1_194,A_C1_7,A_C1_90,A_C2_13,A_C2_18,A_C2_194,A_C2_8,A_C2_90,A_C6_1,A_C6_11,A_C6_194,A_C6_90,B_1_C0_11,B_1_C0_13,B_1_C0_18,B_1_C0_194,B_1_C0_8,B_1_C26_190,B_1_C26_194,B_2_C26_190,B_2_C26_194,C_1_C7_90,A_C1_98,A_C2_14,A_C2_6,A_C2_98,A_C6_2,A_C6_4,A_C6_98,B_1_C0_14,B_1_C0_6,B_1_C0_98,B_1_C26_98,B_2_C26_98,C_1_C5_98,C_1_C7_98,D_4_HOS_C12_73,D_4_HOS_C12_98,D_5_HOS_C2_73,D_5_HOS_C2_98,D_5_HOS_C5_73,D_5_HOS_C5_98,A_C1_4,A_C1_54,A_C1_6,A_C1_60,A_C1_8,A_C6_7,B_1_C26_193,B_2_C26_193,A_C6_10,B_1_C26_191,B_2_C26_191,D_4_HOS_C12_90,D_5_HOS_C2_90,D_5_HOS_C5_90,A_C2_191,A_C6_6,B_1_C0_191,B_1_C0_21,B_1_C21_21,B_1_C21_90,B_1_C22_90,A_C1_50,A_C1_52,A_C2_52,A_C6_13,A_C6_14,A_C6_52,A_C6_8,A_C6_9,B_1_C0_52,B_1_C26_52,B_2_C26_52,C_1_C5_52,C_1_C6_52,C_1_C7_50,C_1_C7_52,C_1_C7_54,C_1_C7_60,C_1_C7_71,C_1_C7_73,D_4_HOS_C12_50,D_5_HOS_C2_50,D_5_HOS_C5_50,A_C1_68,A_C1_73,A_C2_57,A_C2_58,A_C6_66,A_C6_67,A_C6_68,A_C6_69,A_C6_73,C_1_C7_65,C_1_C7_69,D_4_HOS_C12_54,D_4_HOS_C12_60,D_4_HOS_C12_65,D_4_HOS_C12_69,D_5_HOS_C2_54,D_5_HOS_C2_60,D_5_HOS_C2_65,D_5_HOS_C2_69,D_5_HOS_C5_54,D_5_HOS_C5_60,D_5_HOS_C5_65,D_5_HOS_C5_69,A7_3_C5_1,A7_3_C5_2,A_C1_76,A_C2_76,A_C6_54,B_1_C0_76,B_1_C26_76,B_2_C26_76,C_1_C5_76,A7_3_C6_1,A7_3_C6_2,A_C1_14,A_C1_31,A_C2_31,A_C6_50,A_C6_60,A_C6_65,B_1_C0_31,B_1_C26_31,B_2_C26_31,C_1_C5_31,C_1_C6_31,C_1_C7_66,D1_HOS_C5_43,D3_HOS_C2_31,D_1_HOS_C4_31,D_1_HOS_C6_31,D_1_HOS_C7_31,D_5_HOS_C3_54,D_5_HOS_C3_65,D_5_HOS_C6_54,D_5_HOS_C6_65,S3_1_C2_8,S3_1_C3_8,S3_1_C6_8,S3_1_C8_8,A_C1_190,A_C1_32,A_C1_34,A_C1_51,A_C1_53,A_C1_56,A_C1_57,A_C1_58,A_C1_59,A_C1_64,A_C1_70,A_C1_91,A_C2_190,A_C2_32,A_C2_34,A_C2_56,A_C2_59,A_C2_64,A_C2_91,A_C6_19,A_C6_57,A_C6_59,A_C6_70,A_C6_91,B_1_C0_190,B_1_C0_23,B_1_C0_32,B_1_C0_34,B_1_C0_56,B_1_C0_59,B_1_C26_192,B_1_C26_32,B_1_C26_34,B_1_C26_56,B_1_C26_59,B_2_C26_192,B_2_C26_32,B_2_C26_34,B_2_C26_56,B_2_C26_59,C_1_C5_32,C_1_C5_34,C_1_C5_56,C_1_C5_59,C_1_C6_32,C_1_C6_34,C_1_C6_56,C_1_C6_59,C_1_C7_51,C_1_C7_53,C_1_C7_56,C_1_C7_57,C_1_C7_58,C_1_C7_59,C_1_C7_64,C_1_C7_70,C_1_C7_72,C_1_C7_91,D3_HOS_C2_32,D3_HOS_C2_34,D3_HOS_C2_52,D3_HOS_C2_56,D3_HOS_C2_59,D3_HOS_C3_52,D3_HOS_C3_56,D3_HOS_C3_59,D_1_HOS_C4_32,D_1_HOS_C4_34,D_1_HOS_C6_32,D_1_HOS_C6_34,D_1_HOS_C7_32,D_1_HOS_C7_34,D_4_HOS_C10_52,D_4_HOS_C10_56,D_4_HOS_C10_59,D_4_HOS_C11_50,D_4_HOS_C12_51,D_4_HOS_C12_52,D_4_HOS_C12_53,D_4_HOS_C12_56,D_4_HOS_C12_57,D_4_HOS_C12_58,D_4_HOS_C12_59,D_4_HOS_C12_64,D_4_HOS_C12_66,D_4_HOS_C12_70,D_4_HOS_C12_71,D_4_HOS_C12_72,D_4_HOS_C12_91,D_4_HOS_C13_50,D_4_HOS_C3_50,D_5_HOS_C2_51,D_5_HOS_C2_52,D_5_HOS_C2_53,D_5_HOS_C2_56,D_5_HOS_C2_57,D_5_HOS_C2_58,D_5_HOS_C2_59,D_5_HOS_C2_64,D_5_HOS_C2_66,D_5_HOS_C2_70,D_5_HOS_C2_71,D_5_HOS_C2_72,D_5_HOS_C2_91,D_5_HOS_C3_73,D_5_HOS_C4_60,D_5_HOS_C4_72,D_5_HOS_C4_73,D_5_HOS_C5_51,D_5_HOS_C5_52,D_5_HOS_C5_53,D_5_HOS_C5_56,D_5_HOS_C5_57,D_5_HOS_C5_58,D_5_HOS_C5_59,D_5_HOS_C5_64,D_5_HOS_C5_66,D_5_HOS_C5_70,D_5_HOS_C5_71,D_5_HOS_C5_72,D_5_HOS_C5_91,D_5_HOS_C6_73,D_5_HOS_C7_60,D_5_HOS_C7_72,D_5_HOS_C7_73,S3_1_C2_11,S3_1_C2_9,S3_1_C3_11,S3_1_C3_9,S3_1_C6_11,S3_1_C6_9,S3_1_C7_11,S3_1_C7_8,S3_1_C7_9,S3_1_C8_11,S3_1_C8_9,A_C1_71,A_C6_71,B_1_C0_192,C_1_C6_76,C_1_C7_67,C_1_C7_68,C_1_C7_76,D3_HOS_C2_76,D3_HOS_C3_76,D_4_HOS_C10_76,D_4_HOS_C12_76,D_5_HOS_C2_76,D_5_HOS_C5_76,A_C2_62,A_C6_53,A_C6_62,B_1_C0_62,B_1_C26_62,B_2_C26_62,C_1_C5_62,C_1_C6_62,C_1_C7_62,D3_HOS_C2_62,D3_HOS_C3_62,D_4_HOS_C10_62,D_4_HOS_C12_62,D_5_HOS_C2_62,D_5_HOS_C4_54,D_5_HOS_C5_62,D_5_HOS_C7_54,A_C1_101,A_C1_192,A_C2_192,A_C2_22,A_C6_31,B_1_C0_22,D3_IPF_C2_50,D3_IPF_C2_51,D3_IPF_C2_53,D3_IPF_C2_54,D3_IPF_C2_56,D3_IPF_C2_60,D3_IPF_C2_65,D3_IPF_C2_66,D3_IPF_C2_67,D3_IPF_C2_68,D3_IPF_C2_69,D3_IPF_C2_71,D3_IPF_C2_72,D3_IPF_C2_73,D3_IPF_C2_91,D3_IPF_C3_50,D3_IPF_C3_51,D3_IPF_C3_53,D3_IPF_C3_54,D3_IPF_C3_56,D3_IPF_C3_60,D3_IPF_C3_65,D3_IPF_C3_66,D3_IPF_C3_67,D3_IPF_C3_68,D3_IPF_C3_69,D3_IPF_C3_71,D3_IPF_C3_72,D3_IPF_C3_73,D3_IPF_C3_91,D3_IRF_C2_50,D3_IRF_C2_51,D3_IRF_C2_53,D3_IRF_C2_54,D3_IRF_C2_56,D3_IRF_C2_60,D3_IRF_C2_65,D3_IRF_C2_66,D3_IRF_C2_67,D3_IRF_C2_68,D3_IRF_C2_69,D3_IRF_C2_71,D3_IRF_C2_72,D3_IRF_C2_73,D3_IRF_C2_90,D3_IRF_C3_50,D3_IRF_C3_51,D3_IRF_C3_53,D3_IRF_C3_54,D3_IRF_C3_56,D3_IRF_C3_60,D3_IRF_C3_65,D3_IRF_C3_66,D3_IRF_C3_67,D3_IRF_C3_68,D3_IRF_C3_69,D3_IRF_C3_71,D3_IRF_C3_72,D3_IRF_C3_73,D3_IRF_C3_90,D_4_HOS_C12_67,D_5_HOS_C2_67,D_5_HOS_C5_67,A_C1_116,A_C2_101,A_C2_116,B_1_C0_101,B_1_C0_116,B_1_C26_101,B_1_C26_116,B_2_C26_101,B_2_C26_116,C_1_C5_101,C_1_C5_116,D3_SNF_C2_54,D3_SNF_C2_60,D3_SNF_C2_66,D3_SNF_C2_67,D3_SNF_C2_68,D3_SNF_C2_71,D3_SNF_C2_73,D3_SNF_C3_54,D3_SNF_C3_60,D3_SNF_C3_66,D3_SNF_C3_67,D3_SNF_C3_68,D3_SNF_C3_71,D3_SNF_C3_73,S3_1_C10_22,S3_1_C10_24,S3_1_C8_22,A7_3_C11_2,A_C1_23,A_C1_35,A_C1_55,A_C1_75,A_C2_23,A_C2_35,A_C2_75,A_C6_22,A_C6_23,A_C6_35,A_C6_55,A_C6_56,A_C6_75,B_1_C0_35,B_1_C0_75,B_1_C22_31,B_1_C22_50,B_1_C22_60,B_1_C26_35,B_1_C26_75,B_2_C26_35,B_2_C26_75,C_1_C5_35,C_1_C5_75,C_1_C6_35,C_1_C6_75,C_1_C7_55,C_1_C7_75,D3_HOS_C2_75,D3_HOS_C3_75,D3_IPF_C2_57,D3_IPF_C2_58,D3_IPF_C2_90,D3_IPF_C3_57,D3_IPF_C3_58,D3_IPF_C3_90,D3_IRF_C2_55,D3_IRF_C2_57,D3_IRF_C2_58,D3_IRF_C2_70,D3_IRF_C2_75,D3_IRF_C2_91,D3_IRF_C3_55,D3_IRF_C3_57,D3_IRF_C3_58,D3_IRF_C3_70,D3_IRF_C3_75,D3_IRF_C3_91,D_1_HOS_C4_35,D_3_HOS_C9_31,D_4_HOS_C10_75,D_4_HOS_C12_55,D_4_HOS_C12_75,D_5_HOS_C2_55,D_5_HOS_C2_75,D_5_HOS_C3_72,D_5_HOS_C3_91,D_5_HOS_C5_55,D_5_HOS_C5_75,D_5_HOS_C6_72,D_5_HOS_C6_91,S3_1_C2_12,S3_1_C3_12,S3_1_C7_12,S3_1_C8_12,D_5_HOS_C3_60,D_5_HOS_C6_60,A_C6_192,S3_1_C6_22,A_C1_62,A_C1_97,A_C2_97,B_1_C0_97,B_1_C26_97,B_2_C26_97,C_1_C5_97,C_1_C7_97,D3_SNF_C2_62,D3_SNF_C2_69,D3_SNF_C3_62,D3_SNF_C3_69,A_C1_88,A_C1_93,A_C2_88,A_C2_93,A_C6_88,A_C6_93,B_1_C0_88,B_1_C0_93,B_1_C26_88,B_1_C26_93,B_2_C26_88,B_2_C26_93,C_1_C7_88,C_1_C7_93,D_5_HOS_C3_50,D_5_HOS_C3_66,D_5_HOS_C3_68,D_5_HOS_C3_69,D_5_HOS_C3_71,D_5_HOS_C3_93,D_5_HOS_C6_50,D_5_HOS_C6_66,D_5_HOS_C6_68,D_5_HOS_C6_69,D_5_HOS_C6_71,D_5_HOS_C6_93,S3_1_C10_26,S3_1_C6_26,S3_1_C7_26,S3_1_C8_26,A_C1_19,A_C2_19,A_C2_72,B_1_C0_19,C_1_C5_88,C_1_C6_88,D3_SNF_C2_65,D3_SNF_C2_90,D3_SNF_C2_91,D3_SNF_C3_65,D3_SNF_C3_90,D3_SNF_C3_91,D_4_HOS_C11_53,D_4_HOS_C1_53,D_5_HOS_C3_53,D_5_HOS_C3_90,D_5_HOS_C6_53,D_5_HOS_C6_90,A_C1_9201,B_1_C0_9201,B_1_C26_9201,B_2_C26_9201,C_1_C5_9201,C_1_C6_9201,C_1_C7_9201,D3_HOS_C2_9201,D3_HOS_C3_9201,D_4_HOS_C10_9201,D_4_HOS_C12_9201,D_5_HOS_C2_9201,D_5_HOS_C5_9201,A_C6_101,C_1_C7_101,A_C6_76,S3_1_C7_22,C_1_C7_63,D_4_HOS_C12_63,D_5_HOS_C2_63,D_5_HOS_C5_63,A_C2_193,B_1_C0_193,E_B_HOS_C1_39,A_C6_190,A_C6_58,C_1_C5_93,A_C6_18,D_5_HOS_C3_67,D_5_HOS_C6_67,A_C1_191,C_1_C6_116,C_1_C7_116,D_5_HOS_C3_51,D_5_HOS_C3_63,D_5_HOS_C6_51,D_5_HOS_C6_63,S3_1_C4_8,A_C1_21,A_C1_63,A_C2_21,A_C6_21,A_C6_51,A_C6_63,A_C6_64,B_1_C21_194,B_1_C21_31,B_1_C21_50,B_1_C21_51,B_1_C21_52,B_1_C21_53,B_1_C21_54,B_1_C21_55,B_1_C21_56,B_1_C21_57,B_1_C21_58,B_1_C21_59,B_1_C21_60,B_1_C21_63,B_1_C21_65,B_1_C21_69,B_1_C21_70,B_1_C21_91,B_1_C22_194,B_1_C22_51,B_1_C22_52,B_1_C22_53,B_1_C22_54,B_1_C22_55,B_1_C22_56,B_1_C22_57,B_1_C22_58,B_1_C22_59,B_1_C22_63,B_1_C22_65,B_1_C22_69,B_1_C22_70,B_1_C22_91,D_4_HOS_C11_51,D_4_HOS_C11_52,D_4_HOS_C11_54,D_4_HOS_C11_55,D_4_HOS_C11_57,D_4_HOS_C11_58,D_4_HOS_C11_59,D_4_HOS_C11_60,D_4_HOS_C11_64,D_4_HOS_C11_70,D_4_HOS_C11_73,D_4_HOS_C11_90,D_4_HOS_C11_91,D_4_HOS_C13_51,D_4_HOS_C13_52,D_4_HOS_C13_53,D_4_HOS_C13_54,D_4_HOS_C13_55,D_4_HOS_C13_57,D_4_HOS_C13_58,D_4_HOS_C13_59,D_4_HOS_C13_60,D_4_HOS_C13_64,D_4_HOS_C13_73,D_4_HOS_C13_90,D_4_HOS_C13_91,D_4_HOS_C3_51,D_4_HOS_C3_52,D_4_HOS_C3_53,D_4_HOS_C3_54,D_4_HOS_C3_55,D_4_HOS_C3_57,D_4_HOS_C3_58,D_4_HOS_C3_59,D_4_HOS_C3_60,D_4_HOS_C3_64,D_4_HOS_C3_70,D_4_HOS_C3_73,D_4_HOS_C3_90,D_4_HOS_C3_91,D_5_HOS_C3_52,D_5_HOS_C3_55,D_5_HOS_C3_56,D_5_HOS_C3_57,D_5_HOS_C3_58,D_5_HOS_C3_59,D_5_HOS_C3_64,D_5_HOS_C3_70,D_5_HOS_C6_52,D_5_HOS_C6_55,D_5_HOS_C6_56,D_5_HOS_C6_57,D_5_HOS_C6_58,D_5_HOS_C6_59,D_5_HOS_C6_64,D_5_HOS_C6_70,S3_1_C6_24,S3_1_C7_24,S3_1_C8_24,B_1_C26_117,B_2_C26_117,C_1_C5_117,D_5_HOS_C3_62,D_5_HOS_C6_62,D_5_HOS_C3_76,D_5_HOS_C4_91,D_5_HOS_C6_76,D_5_HOS_C7_91,A_C2_12,A_C6_12,B_1_C0_12,A_C1_193,A_C1_33,A_C2_33,B_1_C0_33,B_1_C26_33,B_2_C26_33,C_1_C5_33,C_1_C6_33,D3_HOS_C2_33,D_1_HOS_C4_33,D_1_HOS_C6_33,D_1_HOS_C7_33,S3_1_C2_10,S3_1_C3_10,S3_1_C6_10,S3_1_C8_10,A_C6_116,S3_1_C2_24,D_5_HOS_C3_75,D_5_HOS_C6_75,D3_IPF_C2_55,D3_IPF_C2_59,D3_IPF_C2_63,D3_IPF_C2_64,D3_IPF_C2_76,D3_IPF_C3_55,D3_IPF_C3_59,D3_IPF_C3_63,D3_IPF_C3_64,D3_IPF_C3_76,D_5_HOS_C4_55,D_5_HOS_C4_57,D_5_HOS_C4_58,D_5_HOS_C4_64,D_5_HOS_C4_69,D_5_HOS_C4_90,D_5_HOS_C7_55,D_5_HOS_C7_57,D_5_HOS_C7_58,D_5_HOS_C7_64,D_5_HOS_C7_69,D_5_HOS_C7_90,D_5_HOS_C4_53,D_5_HOS_C7_53,A_C1_96,A_C2_96,B_1_C0_96,B_1_C26_96,B_2_C26_96,C_1_C6_98,C_1_C7_96,D_5_HOS_C3_98,D_5_HOS_C6_98,A_C2_117,A_C1_11,A_C1_112,A_C2_11,A_C2_112,A_C6_112,A_C6_191,A_C6_32,B_1_C0_112,B_1_C21_191,B_1_C21_32,B_1_C21_34,B_1_C21_35,B_1_C21_66,B_1_C21_75,B_1_C22_191,B_1_C22_32,B_1_C22_34,B_1_C22_35,B_1_C22_66,B_1_C22_75,B_1_C26_112,B_2_C26_112,C_1_C5_112,C_1_C6_112,C_1_C7_112,D1_HOS_C5_44,D3_IPF_C2_52,D3_IPF_C2_70,D3_IPF_C3_52,D3_IPF_C3_70,D3_IRF_C2_59,D3_IRF_C2_63,D3_IRF_C2_76,D3_IRF_C3_59,D3_IRF_C3_63,D3_IRF_C3_76,D_3_HOS_C9_32,D_3_HOS_C9_34,D_4_HOS_C11_75,D_4_HOS_C12_68,D_4_HOS_C13_75,D_4_HOS_C3_75,D_4_IPF_C11_50,D_4_IPF_C11_91,D_4_IRF_C11_50,D_4_IRF_C11_55,D_5_HOS_C2_68,D_5_HOS_C5_68,A_C1_22,C_1_C6_97,D_4_HOS_C12_97,D_5_HOS_C2_97,D_5_HOS_C5_97,D_5_HOS_C4_59,D_5_HOS_C7_59,S3_1_C11_22,S3_1_C11_24,S3_1_C11_26,B_1_C21_93,D_4_HOS_C12_93,D_4_HOS_C4_54,D_4_HOS_C4_57,D_4_HOS_C4_58,D_4_IPF_C11_54,D_4_IPF_C11_57,D_4_IPF_C11_58,D_4_IRF_C11_54,D_4_IRF_C11_57,D_4_IRF_C11_58,D_5_HOS_C2_93,D_5_HOS_C4_71,D_5_HOS_C5_93,D_5_HOS_C7_71,S3_1_C3_24,A_C2_20,B_1_C0_20,B_1_C26_89,B_2_C26_89,C_1_C5_89,C_1_C6_101,D3_SNF_C2_72,D3_SNF_C3_72,D_4_HOS_C2_50,D_4_HOS_C2_52,D_4_HOS_C2_91,D_4_IRF_C11_91,D_4_SNF_C11_54,D3_IPF_C2_62,D3_IPF_C3_62,C_1_C6_93,D3_HOS_C2_93,D3_HOS_C3_93,D_4_HOS_C10_93,B_1_C0_117,C_1_C6_117,A_C1_117,A_C6_117,A_C6_193,D3_SNF_C2_63,D3_SNF_C2_70,D3_SNF_C2_76,D3_SNF_C3_63,D3_SNF_C3_70,D3_SNF_C3_76,D_4_HOS_C1_50,A_C6_96,D3_SNF_C2_50,D3_SNF_C3_50,A_C1_12,C_1_C5_96,C_1_C7_117,C_1_C2_66,D3_SNF_C2_53,D3_SNF_C3_53,D3_IPF_C2_93,D3_IPF_C3_93,D_5_HOS_C4_50,D_5_HOS_C7_50,D3_IRF_C2_31,D3_SNF_C2_55,D3_SNF_C2_57,D3_SNF_C2_58,D3_SNF_C3_55,D3_SNF_C3_57,D3_SNF_C3_58,D_5_HOS_C4_65,D_5_HOS_C7_65,A_C6_20,B_1_C21_64,B_1_C21_71,B_1_C21_73,B_1_C22_68,B_1_C22_73,D1_HOS_C5_45,D1_HOS_C5_46,D3_IPF_C2_75,D3_IPF_C3_75,D_3_HOS_C9_33,D_4_HOS_C11_56,D_4_HOS_C11_63,D_4_HOS_C11_65,D_4_HOS_C11_66,D_4_HOS_C11_69,D_4_HOS_C11_71,D_4_HOS_C13_56,D_4_HOS_C13_63,D_4_HOS_C13_65,D_4_HOS_C13_66,D_4_HOS_C13_69,D_4_HOS_C13_70,D_4_HOS_C13_71,D_4_HOS_C2_51,D_4_HOS_C2_53,D_4_HOS_C2_54,D_4_HOS_C2_55,D_4_HOS_C2_58,D_4_HOS_C2_65,D_4_HOS_C2_66,D_4_HOS_C2_69,D_4_HOS_C2_70,D_4_HOS_C2_75,D_4_HOS_C2_90,D_4_HOS_C3_56,D_4_HOS_C3_63,D_4_HOS_C3_65,D_4_HOS_C3_66,D_4_HOS_C3_69,D_4_HOS_C3_71,D_4_IPF_C11_75,D_4_IRF_C11_51,D_4_IRF_C11_70,D_4_IRF_C13_56,S3_1_C7_10,A_C1_20,D3_IPF_C2_31,D3_SNF_C2_52,D3_SNF_C2_59,D3_SNF_C3_52,D3_SNF_C3_59,B_1_C21_190,B_1_C21_192,B_1_C21_76,B_1_C22_190,B_1_C22_192,B_1_C22_76,B_1_C22_93,A_C6_33,D3_HOS_C2_35,D_1_HOS_C6_35,D_1_HOS_C7_35,D_3_HOS_C9_35,D_4_HOS_C13_93,D_4_HOS_C3_76,D_4_HOS_C3_93,S3_1_C6_12,D3_IRF_C2_62,D3_IRF_C3_62,A_C6_34,B_1_C21_33,B_1_C22_33,D3_IRF_C2_64,D3_IRF_C3_64,D_4_IRF_C11_65,D_4_IRF_C11_90,D_5_HOS_C3_9201,D_5_HOS_C6_9201,B_1_C21_67,B_1_C22_67,D3_SNF_C2_56,D3_SNF_C3_56,D3_HOS_C2_98,D3_HOS_C3_98,D_4_HOS_C10_98,D_5_HOS_C4_76,D_5_HOS_C7_76,S3_1_C4_9,D_4_SNF_C11_60,D_4_SNF_C11_73,A_C6_9201,D_5_HOS_C4_56,D_5_HOS_C7_56,A_C6_72,D3_IRF_C2_52,D3_IRF_C3_52,D_4_IRF_C13_90,A_C1_115,A_C2_115,A_C6_115,D3_SNF_C2_51,D3_SNF_C2_75,D3_SNF_C3_51,D3_SNF_C3_75,D_4_HOS_C2_63,D_4_IPF_C11_53,D_4_IPF_C11_60,D_4_IPF_C11_63,D_4_IRF_C11_53,D_4_IRF_C11_60,D_4_IRF_C11_63,D_4_IRF_C11_75,D_4_SNF_C11_50,D_4_SNF_C11_53,D_4_SNF_C11_63,D_4_SNF_C11_91,B_1_C26_115,B_2_C26_115,C_1_C5_115,C_1_C6_115,C_1_C7_115,C_1_C6_96,D_4_HOS_C11_68,D_4_HOS_C3_68,D3_SNF_C2_64,D3_SNF_C3_64,B_1_C21_62,B_1_C22_62,D_4_HOS_C13_68,D_4_HOS_C3_62,D_4_IPF_C13_54,A_C6_89,B_1_C0_89,C_1_C6_89,D_4_HOS_C11_76,D_4_HOS_C13_76,D_4_HOS_C11_67,D_4_HOS_C3_67,D_4_IPF_C11_67,A_C2_89,S3_1_C5_8,D_4_IRF_C11_73,D_4_IRF_C13_73,A_C6_97,D3_SNF_C2_93,D3_SNF_C3_93,D_5_HOS_C4_51,D_5_HOS_C4_63,D_5_HOS_C4_66,D_5_HOS_C4_67,D_5_HOS_C4_68,D_5_HOS_C7_51,D_5_HOS_C7_63,D_5_HOS_C7_66,D_5_HOS_C7_67,D_5_HOS_C7_68,D_5_HOS_C4_52,D_5_HOS_C7_52,D_4_HOS_C2_60,D3_SNF_C2_31,D_4_HOS_C11_93,D_4_SNF_C11_65,D_4_SNF_C11_66,D_4_SNF_C11_67,D_4_SNF_C11_68,D3_HOS_C2_97,D3_HOS_C3_97,D_4_HOS_C10_97,C_1_C6_6250,D3_HOS_C2_6250,D_4_HOS_C10_6250,A_C1_9910,A_C2_9910,A_C6_9910,B_1_C0_9910,B_1_C26_9910,B_2_C26_9910,C_1_C5_9910,C_1_C7_9910,D_5_HOS_C4_93,D_5_HOS_C7_93,S3_1_C10_25,D_4_HOS_C2_76,D_4_IPF_C11_76,D_4_IRF_C11_76,D3_IRF_C2_93,D3_IRF_C3_93,D_4_HOS_C2_57,D_4_SNF_C11_57,B_1_C21_88,B_1_C22_88,S3_1_C9_26,C_1_C6_9910,D_4_IRF_C13_54,D_4_IRF_C13_65,D_4_IRF_C13_91,D_4_HOS_C11_62,D_4_HOS_C11_72,D_4_HOS_C13_62,D_4_HOS_C13_72,D_4_HOS_C3_72,D_4_IPF_C11_65,D_4_IPF_C11_69,D_4_IPF_C11_70,D_4_IPF_C11_72,D_4_IPF_C11_73,D_4_IPF_C13_50,D_4_IPF_C13_52,D_4_IPF_C13_57,D_4_IPF_C13_60,D_4_IPF_C13_70,D_4_IPF_C13_71,D_4_IPF_C13_72,D_4_IPF_C13_73,D_4_IPF_C11_56,D_4_IRF_C11_56,D_4_HOS_C2_93,D3_IRF_C2_98,D3_IRF_C3_98,D3_SNF_C2_98,D3_SNF_C3_98,D_4_HOS_C2_59,D_4_IPF_C11_59,D_4_IRF_C11_59,D_4_SNF_C11_55,D_4_SNF_C11_59,D3_IPF_C2_9201,D3_IPF_C3_9201,D3_IRF_C2_9201,D3_IRF_C3_9201,D_4_IPF_C11_66,D_4_IRF_C11_66,D_4_IPF_C11_51,B_1_C21_98,B_1_C22_98,S3_1_C5_9,D3_HOS_C2_96,D3_HOS_C3_96,D3_IPF_C2_96,D3_IPF_C3_96,D3_IRF_C2_96,D3_IRF_C3_96,D_4_HOS_C10_96,D_5_HOS_C4_70,D_5_HOS_C7_70,B_1_C22_9201,D_4_HOS_C11_9201,D_4_HOS_C13_9201,D_4_HOS_C2_9201,D_4_IPF_C11_9201,D_4_IPF_C13_91,D_4_IRF_C11_9201,D_4_HOS_C13_67,D_4_IRF_C11_67,D_4_IRF_C11_68,D_4_IRF_C11_69,D_4_IRF_C11_71,D_4_IRF_C11_72,D_5_HOS_C3_96,D_5_HOS_C6_96,D_4_SNF_C11_71,A_C1_72,B_1_C21_9201,B_1_C0_115,D_4_IRF_C13_50,D_4_HOS_C2_88,S3_1_C5_12,S3_1_C5_10,D3_IRF_C2_32,D3_IPF_C2_35,D_4_IPF_C11_90,A_C1_89,A_C1_99,A_C2_99,A_C6_99,B_1_C0_99,B_1_C26_99,B_2_C26_99,C_1_C5_99,C_1_C6_99,C_1_C7_99,D_4_IPF_C11_93,D_4_SNF_C11_93,D3_IPF_C2_98,D3_IPF_C3_98,D_4_HOS_C2_64,B_1_C21_68,D_4_HOS_C4_50,D_4_HOS_C4_51,D_4_HOS_C4_65,D_4_HOS_C4_75,D_4_HOS_C4_90,D_4_HOS_C4_91,D_4_IPF_C13_90,D_4_HOS_C13_97,D_4_HOS_C2_73,D_4_HOS_C2_97,D_4_HOS_C3_9201,D_4_HOS_C3_97,D_5_HOS_C3_97,D_5_HOS_C6_97,D_5_HOS_C4_62,D_5_HOS_C7_62,D_5_HOS_C4_9201,D_5_HOS_C7_9201,B_1_C22_71,D_4_IPF_C13_69,D_4_HOS_C12_96,D_5_HOS_C2_96,D_5_HOS_C5_96,D_4_SNF_C11_51,D_4_SNF_C11_70,D_4_SNF_C11_76,B_1_C21_112,B_1_C22_64,D_4_IPF_C11_52,B_1_C22_112,B_1_C22_72,D_4_SNF_C11_90,B_1_C21_193,B_1_C22_193,D3_IPF_C2_32,D3_IPF_C2_33,D3_IPF_C2_34,D3_IRF_C2_33,D3_IRF_C2_34,D3_IRF_C2_35,D_4_IPF_C11_64,D_4_IRF_C11_52,D_4_IRF_C11_64,D_4_SNF_C11_56,D_4_IPF_C11_55,A_C1_9920,A_C1_9930,A_C1_9940,A_C2_9920,A_C2_9930,A_C2_9940,A_C6_9920,A_C6_9930,A_C6_9940,B_1_C0_9920,B_1_C0_9930,B_1_C0_9940,B_1_C26_9920,B_1_C26_9930,B_1_C26_9940,B_2_C26_9920,B_2_C26_9930,B_2_C26_9940,C_1_C5_9920,C_1_C5_9930,C_1_C5_9940,C_1_C7_9920,C_1_C7_9930,C_1_C7_9940,D_4_IRF_C13_60,D_4_IPF_C13_53,D_4_IRF_C11_93,D3_SNF_C2_9201,D3_SNF_C3_9201,B_1_C21_72,S3_1_C4_12,S3_1_C5_11,D_4_IPF_C11_62,D_4_IPF_C11_68,D_4_IRF_C11_62,D_4_IRF_C13_69,S3_1_C9_24,D_5_HOS_C4_75,D_5_HOS_C7_75,D_4_HOS_C11_98,D_4_HOS_C13_98,D_4_HOS_C2_98,D_4_IRF_C11_98,FFY,S2_1_C2_2,S2_1_C1_35,S2_1_C1_40,S2_1_C2_40,E_A_HOS_C1_72,E_A_HOS_C1_7093,E_A_HOS_C1_7094,E_A_HOS_C1_59,E_A_HOS_C1_7099,Line 19 Subtotal,Reconstructed IPPS payment (pre HAC penalty),Reconstructed HAC penalty,Reconstructed IPPS payment (post HAC penalty),HAC penalty imputed from E_A_HOS_C1_59,Name and Num
,Curated Name and Num,"Hospital type, text","Control type, text",Lon,Lat,Report Record Number,Hospital Provider Number,Fiscal Intermediary Number,Report Status Code,Fiscal Intermediary/MAC Create Date,Fiscal Year Begin Date,Fiscal Year End Date,Utilization Code (L/N/F),NOT IN THIS FILE,SSA State Code,SSA State County Code,Census Division Code,CMS Region Code,Geographic MSA,Utilization Review SNF,Utilization Review SNF,PBP Clinical Lab Services Program Only,Int & Res (non approved teaching program,Home Program Dialysis,Int & Res (non approved teaching program,Subprovider I,Home Program Dialysis,Cross Foot Adjustments,Int & Res (non approved teaching program,Int & Res (non approved teaching program,Islet Acquisition,Subprovider I,Nursery,PBP Clinical Lab Services Program Only,PBP Clinical Lab Services Program Only,Subprovider I,Home Program Dialysis,Home Program Dialysis,PBP Clinical Lab Services Program Only,Home Program Dialysis,PBP Clinical Lab Services Program Only,Home Program Dialysis,Subprovider-IPF,Subprovider-IRF,Subprovider II,Home Program Dialysis,Renal Dialysis,Total,Home Program Dialysis,PBP Clinical Lab Services Program Only,Home Program Dialysis,PBP Clinical Lab Services Program Only,Home Program Dialysis,OPPS payments,Outlier payments,Line 2 times line 5,"Sum of lines 3,4 divided by line 6",Transitional corridor payment,Partial or full credits from manufacturers,Sequestration adjustment,Total Subprovider II Interns & Residents,Subprovider 2,Labor and Delivery,Subprovider 2,Labor and Delivery,SNF,NF,Subprovider 2,Subprovider 2,Total Subprovider I Interns & Residents,Home Office Salaries,Related  Salaries,Interns & Residents,Interns & Residents,Interns & Residents,Interns & Residents,Home Office Salaries,Related Salaries,Wage Related Costs RHC/FQHC,Interns & Residents,Interns & Residents,Interns & Residents,Interns & Residents,Home Office Salaries,Related Salaries,Teaching Physician Salaries,Teaching Physician Salaries,Interns & Residents,Interns & Residents,Interns & Residents,Interns & Residents,Home Office Salaries,Related Salaries,Without Outliers:  Other Charges,With Outliers:  Other Charges,With Outliers:  Non Routine Med Sup Chgs,LUPA Episodes:  Other Charges,PEP Episodes:  Other Charges,PEP:  Total Number of Outlier Episodes,Total Other Charges,Without Outliers:  Total Visits,Without Outliers:  Other Charges,Without Outliers:  Total Charges,W/Out Outliers:  Number of Episodes,Without Outliers:  Non Routine Med Sup Chgs,With Outliers:  Total Visits,With Outliers:  Other Charges,With Outliers:  Total Charges,With Outliers:  Number of Episodes,With Outliers:  Non Routine Med Sup Chgs,LUPA Episodes:  Total Visits,LUPA Episodes:  Other Charges,Total Charges:  LUPA Episodes,LUPA Episodes:  Total Number of Episodes,LUPA:  Total Non Routine Med Sup Chgs,PEP Episodes:  Total Visits,PEP Episodes:  Other Charges,PEP Episodes:  Total Charges:,PEP Episodes:  Total Number of Episodes,PEP:  Total Number of Outlier Episodes,PEP:  Total Non Routine Med Supply Chgs,Total Visits,Total Other Charges,Total Charges,Total Number of Episodes,Total Number of Outlier Episodes,Total Non Routine Medical  Supply Charges,Total,Building Improvements,Fixed Equipment,Movable Equipment,Subtotal,Total,Fixed Equipment,Movable Equipment,Subtotal,Total,Fixed Equipment,Movable Equipment,Subtotal,Total,Total,Total,Cafeteria employees and guests,Sale of medical records and abstracts,"Trade, Quantity, and Time Discounts",Refunds and Rebates of Expenses,Total,Total Salaries,Adults and Pediatrics,Total Salaries,Adults and Pediatrics,Renal Dialysis,Total Salaries,Adults and Pediatrics,Total,Adults and Pediatrics,Renal Dialysis,Total,Adults and Pediatrics,Renal Dialysis,Total,Adults & Pediatrics,Renal Dialysis,Total Costs,Subtotal,Total,Adults & Pediatrics,Renal Dialysis,Total,Adults & Pediatrics,Renal Dialysis,Total Charges,net of Swing Bed Cost,net of Swing Bed and Private Room Diff,Total Program General Inpatient Routine,Program Inpatient Ancillary Service Cost,Total Program Inpatient Costs,Pass through Cost for Program Inpatient Routine,Pass Through Cost for  Program Ancillary,Total Program Excludable Costs,"Anesthetist, and Medical Education Costs",Adults and Pediatrics,Renal Dialysis,TOTAL,Renal Dialysis,Total,Adults & Pediatrics,Total,Adults & Pediatrics,Total,Adults & Pediatrics,Total Patient Days,Total Inpatient Program Days,Cost To Charge Ratio,Total Bad Debt expense,Medicare reimbursable bad debts for the entire hospital complex,Cost of Uncompensated Care,Total unreimbursed and uncompensated care,Charity care charges and uninsured discounts for the entire facility,Cost of patients approved for charity care and uninsured discounts,Cost of charity care (patients covered by public program + patients w/ coverage accepted by provider),Charity care charges and uninsured discounts for the entire facility,Cost of patients approved for charity care and uninsured discounts,Cost of charity care,Urban/Rural Indicator at beginning,Urban (1) or Rural (2),Hospital Type,Total Hospital Interns & Residents,Total Facility FTEs,Title XVIII discharges,Title XVIII discharges,Total discharges,Total discharges,Hospital Adults & Pediatrics,Total Hospital,Total Facility,Total,Hospital Adults & Pediatrics,Total Hospital,Total Hospital,Hospital Adults & Pediatrics,Total Hospital,Total Adults & Peds,Hospital Adults & Pediatrics,Total Hospital,Total Adults & Pediatrics,Land,Buildings and Fixtures,Buildings and Fixtures,Total,Total,Investment Income-New Bldgs & Fixtures,Provider-based physician adjustment,Related Organization Transactions,Investment Income-Other,Subprovider-IPF,Interest Expense,Other Capital,Subprovider-IPF,Subprovider-IPF,Subprovider-IPF,Subprovider-IPF,Subprovider-IPF,Subprovider-IPF,Total,net of Swing Bed Cost,net of Swing Bed and Private Room Diff,Total Program General Inpatient Routine,Total Program Inpatient Costs,Pass through Cost for Program Inpatient,Total Program Excludable Costs,"Anesthetist, and Medical Education Costs",Subprovider-IPF,Subprovider-IPF,Subprovider-IPF,Subprovider-IPF,Ratio of line 15 to line 16,Title XIX discharges,Title XIX discharges,Title XIX discharges,Total discharges,IPF,IPF,IPF,Hospital Adults & Pediatrics,Total Hospital,IPF,Total Adults & Peds,IPF,Total Salaries,Excluded Area Salaries,Administrative and General,Operation of Plant,Housekeeping,Dietary,Nursing Administration,Medical Records & Med Records Library,Other General Service,Net Salaries,Excluded Area Salaries,Subtotal Salaries,Total,Net Salaries,Excluded Area Salaries,Subtotal Salaries,Total,Total Overhead Costs,Negative Cost Centers,Total,Total,Total,Medical and Other Services reimbursed by OPPS,Total prospective payment,Deductibles and coinsurance related to line 24,Subtotal,OPPS payments,Subtotal,Subtotal,Allowable bad debts,Adjusted reimburseable bad debts,Allowable bad debts for dual eligibles beneficiaries,Subtotal,Subtotal,Interim payments,Balance due provider/program,Land Improvements,Total,Movable Equipment,Subtotal,Land Improvements,Buildings and Fixtures,Building Improvements,Depreciation-New Bldgs & Fixtures,Depreciation-New Movable Equipment,Total Directly Assigned New Cap Rel Csts,Total Hospital Interns & Residents,Total Facility FTEs,Employee Benefits,Maintenance and Repairs,Laundry and Linen Service,Pharmacy,Social Service,Total Salaries,Excluded Area Salaries,Employee Benefits,Administrative and General,Admin & Gen Under Contract,Operation of Plant,Laundry and Linen Service,Housekeeping,Dietary,Nursing Administration,Pharmacy,Medical Records & Med Records Library,Social Service,Total Salaries,Total Salaries,Net Salaries,Subtotal Salaries,Net Salaries,Subtotal Salaries,Total,Adults and Pediatrics,Adults and Pediatrics,Cross Foot Adjustments,interns and residents,Tentative settlement,Total Hospital Interns & Residents,Total Facility FTEs,Building Improvements,Building Improvements,Nursery,Nursery,Nursery,Less Observation Beds,Nursery,Nursery,Nursery,Total unreimbursed cost for Medicaid and CHIP and state and local indigent care programs,Net Revenue from Medicaid,Charity care charges and uninsured discounts for the entire facility,Cost of patients approved for charity care and uninsured discounts,Cost of charity care (uninsured patients + patients w/ coverage not accepted by provider),Medicaid charges,Nursery,Nursery,Medicaid Observation Days,Wage Related Costs Core,Wage Related Costs Other,Non-Physician Anesthetist Part B,Wage Related Costs Core,Wage Related Costs Other,Non-Physician Anesthetist Part B,Administrative and General,Administrative and General,Subtotal Wage Related Csts,Subtotal Wage Related Csts,Total Overhead Costs,Subtotal Wage Related Csts,Total Overhead Costs,Parking Lot,Total,Rental of quarters to employee and oths,NF,NF,NF,NF,NF,NF,NF,Total,Vending Machines,Telephone Services,Television and Radio Service,Renal Dialysis,Total,Renal Dialysis,Total,Renal Dialysis,Medical and Other Services,Total cost,Ancillary service charges,Total reasonable charges,Total customary charges,Excess of customary charges,Lesser of cost or charges,Deductibles and coinsurance,HMO,Contract Labor,Contract Labor: Pysician Part A,Home Office Salaries & Wage Related Csts,Excluded Areas,Central Services and Supply,Contract Labor,Contract Labor:  Physician Part A,Home Office Salaries & Wage Related Csts,Excluded Areas,Central Services and Supply,Excluded Area Salaries,Contract Labor,Contract Labor:  Physician Part A,Home Office Salaries & Wage Related Csts,Employee Benefits,Operation of Plant,Housekeeping,Dietary,Nursing Administration,Central Services and Supply,Medical Records & Med Records Library,Social Service,Excluded Area Salaries,Contract Labor,Contract Labor:  Physician Part A,Home Office Salaries & Wage Related Csts,Employee Benefits,Operation of Plant,Housekeeping,Dietary,Nursing Administration,Central Services and Supply,Medical Records & Med Records Library,Social Service,Subtotal Other Wages and Related Csts,Subtotal Other Wages and Related Csts,Excluded Area Salaries,Subtotal Other Wages and Related Csts,Excluded Area Salaries,Subtotal Other Wages and Related Csts,Land,"Sale of scrap, waste, etc.",Nursery,Nursery,Total,Renal Dialysis,Total,Total Allied Health,Total Outpatient Program Pass Thru Cost,Renal Dialysis,Total,Renal Dialysis,Total,Excess of reasonable cost over reasonable charges,Primary payer payments,Ancillary service other pass through costs,Stand-alone CHIP Charges (Gross Revenue),Stand-alone CHIP cost,Net Revenue from stand-alone SCHIP,In State Medicaid eligible days,Out of State Medicaid eligible days,HMO,Physician Part A,Physician Part B,Physician-Part A,Physician-Part B,Physician Part A,Physician Part B,Non-Physician Anesthetist Part B,Physician-Part A,Physician-Part B,Non-Physician Anesthetist Part B,Physician-Part A,Pharmacy,Physician-Part B,Non-Physician Anesthetist Part B,Physician-Part A,Pharmacy,Physician-Part B,Total,Land Improvements,Interest Expense,MSP-LCC reconciliation amount,Total,Buildings and Fixtures,Building Improvements,Movable Equipment,Subtotal,Sale of medical and surgical supplies to,Payments received from patients for amounts previously written off as charity care,Payments received from patients for amounts previously written off as charity care,Payments received from patients for amounts previously written off as charity care,In State Medicaid paid days,Number of periods hospital was in MDH status,Out of State Medicaid paid days,Non-Physician Anesthetist Part A,Non-Physician Anesthetist Part A,Non-Physician Anesthetist Part A,Non-Physician Anesthetist Part A,Non-Physician Anesthetist Part A,Non-Physician Anesthetist Part A,Buildings and Fixtures,Subprovider-IRF,SNF,Subprovider-IRF,SNF,Subprovider-IPF,Subprovider-IRF,Subprovider-IRF,Subprovider-IRF,Subprovider-IRF,Subprovider-IRF,Subprovider-IRF,Program Inpatient Ancillary Service Cost,Pass Through Cost for  Program Ancillary,net of Swing Bed Cost,net of Swing Bed and Private Room Diff,Total Program General Inpatient Routine,Program Inpatient Ancillary Service Cost,Total Program Inpatient Costs,Pass through Cost for Program Inpatient,Pass Through Cost for  Program Ancillary,Total Program Excludable Costs,"Anesthetist, and Medical Education Costs",TOTAL,Renal Dialysis,TOTAL,Renal Dialysis,TOTAL,Subprovider-IRF,Renal Dialysis,TOTAL,Renal Dialysis,Subprovider-IRF,Subprovider-IRF,Subprovider-IRF,Title XVIII discharges,Title XVIII discharges,Title XIX discharges,Total discharges,IRF,IRF,IRF,IRF,IRF,SNF,Cafeteria,Cafeteria,Cafeteria,Sale of drugs to other than patients,Ambulance Services,Ambulance Services,SNF,Ambulance Services,SNF,Ambulance Services,SNF,Ambulance Services,SNF,Ambulance Services,SNF,Ambulance Services,net of Swing Bed and Private Room Diff,Total Program General Inp. Rtn Service,Program Ancillary Services,TOTAL,TOTAL,Payment to cost ratio,Line 2 times line 5,Medicaid HMO Days,SNF,SNF,SNF,SNF,SNF,SNF,SNF,Laundry and Linen Service,SNF,Laundry and Linen Service,SNF,Without Outliers:  Total Visits,Without Outliers:  Total Charges,W/Out Outliers:  Number of Episodes,Without Outliers:  Non Routine Med Sup Chgs,With Outliers:  Total Visits,With Outliers:  Total Charges,With Outliers:  Number of Episodes,With Outliers:  Non Routine Med Sup Chgs,LUPA Episodes:  Total Visits,Total Charges:  LUPA Episodes,LUPA Episodes:  Total Number of Episodes,LUPA:  Total Non Routine Med Sup Chgs,PEP Episodes:  Total Visits,PEP Episodes:  Total Charges:,PEP Episodes:  Total Number of Episodes,Total Visits,Total Charges,Total Number of Episodes,Total Number of Outlier Episodes,Total Non Routine Medical  Supply Charges,Kidney Acquisition,Renal Dialysis,Kidney Acquisition,Pancreas Acquisition,Kidney Acquisition,Kidney Acquisition,Pancreas Acquisition,Subprovider-IPF,Kidney Acquisition,Pancreas Acquisition,Kidney Acquisition,Pancreas Acquisition,Kidney Acquisition,Pancreas Acquisition,Kidney Acquisition,Organ Procurement,Organ Procurement,Total Allied Health Cost,Total Costs,Total,Adults & Pediatrics,Outlier payments,Title XVIII discharges,Labor and Delivery Days -  Title XIX,Labor and Delivery Days -  Title XIX,Management and Administrative Services,Management and Administrative Services,Management and Administrative Services,Management and Administrative Services,Negative Cost Centers,Total Swing Bed Cost,"Sum of lines 3,4 divided by line 6",Transitional corridor payment,Hospital Adults & Ped Swing Bed SNF,Hospital Adlts & Ped Swing Bed SNF,Hospital Adlts & Ped Swing Bed NF,Admin & Gen Under Contract,Admin & Gen Under Contract,PEP:  Total Non Routine Med Supply Chgs,Investment Income-New Movable Equip,Net revenue from state/local govt indigent care (not Medicaid or CHIP),Total charges to state or local government programs for indigent care (not Medicaid or CHIP),Total costs for patients covered by a state or local government program,State or local govt (not Medicaid or CHIP) -- Costs minus net revenue (0 min),"Income from imposition of interest, finance",Rental of Provider space by suppliers,Nursery,Administrative & General under contract,Administrative & General under contract,Administrative and General under Contract,Administrative and General under Contract,Laundry and Linen Service,NF,NF,NF,NF,Hospital Adults & Pediatrics,Total Hospital,Total Hospital,NF,NF,Fixed Equipment,Non-physician Anesthetist,SNF,Stand-alone CHIP -- Costs minus net revenue (0 min),Non-Physician Anesthetist Part B,Total,Hospital Adlts & Ped Swing Bed SNF,Wage Related Costs RHC/FQHC,Non-Physician Part B,Wage Related Costs RHC/FQHC,Non-Physician Part B,Non-Physician Part B,Non-Physician Part B,Interest expense on Medicare Overpaymts,Ambulance Trips,Hospital Adlts & Ped Swing Bed NF,Ambulance Services,RPCH/CAH Visits,RPCH/CAH Visits,CAH Visits,Government grants or appropriations or transfers for support of hospital operations,Ambulance Services,Without Outliers:  Other Charges,With Outliers:  Other Charges,LUPA Episodes:  Other Charges,PEP Episodes:  Other Charges,Total Other Charges,Dietary under contract,Dietary under contract,Land Improvements,Ambulance Services,Ambulance Services,Begin Balance,Purchase,Total,Disp. And Retirement,Ending Balance,Land,Assets,Heart Acquisition,Liver Acquisition,Heart Acquisition,Liver Acquisition,Heart Acquisition,Liver Acquisition,Renal Dialysis,Heart Acquisition,Liver Acquisition,Int & Res (non approved teaching program,Heart Acquisition,Liver Acquisition,Int & Res (non approved teaching program,Heart Acquisition,Liver Acquisition,Int & Res (non approved teaching program,Heart Acquisition,Liver Acquisition,Heart Acquisition,Liver Acquisition,Pancreas Acquisition,Kidney Acquisition,Heart Acquisition,Liver Acquisition,Pancreas Acquisition,Organ Procurement,Organ Procurement,Teaching Physician Salaries,Interns & Residents,Interns & Residents,Teaching Physician Salaries,Interns & Residents,Other General Service,Interns & Residents,Teaching Physician Salaries,Other General Service,Interns & Residents,Teaching Physician Salaries,Other General Service,Interns & Residents,"Number of patients on transplant 
list","Net costs of Epoietin furnished to
all maintenance dialysis patients
by the provider",Number of EPO units furnished for Line 13,Number of Times per week Patient receives Dialysis,"Average patient dialysis time 
including setup","Number of days in year dialysis 
furnished",Number of stations,"Treatment capacity per day per
station",Utilization,"Number of patients in program at 
end of cost reporting period",Home Program Dialysis,"Number of patients transplanted 
during fiscal year","Average patient dialysis time 
including setup",Number of stations,PEP:  Total Number of Outlier Episodes,OLTC,OLTC,OLTC,OLTC,OLTC,OLTC,OLTC,OLTC,OLTC,Total discharges,OLTC,OLTC,OLTC,SNF,SNF,Int & Res (non approved teaching program,Int & Res (non approved teaching program,Subprovider I,Subprovider I,Subprovider I,Subprovider I,Subprovider I,Subprovider I,Subprovider I,Subprovider I,Subprovider I,Total discharges,Subprovider 1,Subprovider 1,Subprovider 1,Cost of physicians svcs in a teaching hospita,Adj for Physical therapy costs in excess,Title V discharges,Title V discharges,Hospital Adults & Pediatrics,Total Hospital,Total Hospital,Physicians' Assistant,Home Program Dialysis,Home Program Dialysis,Home Program Dialysis,Home Program Dialysis,Home Program Dialysis,Home Program Dialysis,Home Program Dialysis,Renal Dialysis,Renal Dialysis,Component rate ESRD,Protested amounts,Private grants or donations or endowment income restricted to funding charity care,"Number of Times per week
 Patient receives Dialysis","Number of days in year dialysis 
furnished",Number of stations,"Treatment capacity per day per
station","Number of Times per week
 Patient receives Dialysis","Average patient dialysis time 
including setup","Number of patients in program at 
end of cost reporting period","Number of Times per week
 Patient receives Dialysis",CAPD exchanges per day,Dietary under Contract,Dietary under Contract,Int & Res (non approved teaching program,Pancreas Acquisition,Subprovider-IPF,Subprovider-IRF,Nursery,Subprovider-IRF,Nursery,Subprovider-IPF,Subprovider-IRF,Total,Total Allied Health,Total Outpatient Program Pass Thru Cost,Total,Total Allied Health,Total Outpatient Program Pass Thru Cost,Cafeteria,Other Capital,Program Discharges,Target Amount per Discharge,Target Amount,Operating Cost and Target Amount,Bonus Payment,Allowable Inpatient Cost Plus Incentive Pt,Home Office Personnel,Home Office Personnel,Home Office Personnel,Home Office Personnel,SNF,Adults and Pediatrics,Total Other Medical Education,Total Other Medical Education,Total Other Medical Education,"Number of patients in program at 
end of cost reporting period","Percentage of patients re-using
dialyzers",Average times dialyzers re-used,"Number of patients in program at 
end of cost reporting period",SNF,Renal Dialysis,Renal Dialysis,Total Nursing School,Renal Dialysis,Total Nursing School,Total,Adj for Occupational therapy in excess of li,Other Medicaid Days,Total Nonphysician Anesthetist Cost,Nursing School,Land,Adj for Speech therapy in excess of lim,Fixed Equipment,Subprovider II,Subprovider II,Subprovider II,Subprovider II,Subprovider II,Subprovider II,Subprovider II,Subprovider II,Adj for Respiratory therapy costs in excess,Maintenance of Personnel,Subprovider-IPF,Lung  Acquisition,Lung  Acquisition,Lung  Acquisition,Pancreas Acquisition,Lung  Acquisition,Renal Dialysis,Lung  Acquisition,Lung  Acquisition,Lung  Acquisition,Lung  Acquisition,Home Program Dialysis,Home Program Dialysis,Organ Procurement,Home Program Dialysis,Renal Dialysis,Home Program Dialysis,Total Nursing School,Total,Utilization,Renal Dialysis,Housekeeping under contract,Housekeeping under contract,Housekeeping under Contract,Housekeeping under Contract,Lung  Acquisition,Physician Part A,Physician Part A Teaching,Nursery,Home Program Dialysis,"Epoietin amount form worksheet A
for home dialysis program",PBP Clinical Lab Services Program Only,PBP Clinical Lab Services Program Only,PBP Clinical Lab Services Program Only,PBP Clinical Lab Services Program Only,PBP Clinical Lab Services Program Only,Renal Dialysis,Renal Dialysis,CAPD exchanges per day,Home Program Dialysis,Home Office:  Physician Part A,Home Office:  Physician Part A,Home Office:  Physician Part A,Home Office:  Physician Part A,Interns and residents,"Number of patients in program at 
end of cost reporting period","Number of days in year dialysis 
furnished",SNF,Renal Dialysis,Relief Payment,Total,Land,Subprovider-IRF,Total Subprovider I Interns & Residents,Title XIX discharges,Subprovider 1,Intestinal Acquisition,Intestinal Acquisition,Intestinal Acquisition,Intestinal Acquisition,Intestinal Acquisition,Intestinal Acquisition,Kidney Acquisition,Liver Acquisition,Kidney Acquisition,Liver Acquisition,Maintenance of Personnel,Maintenance of Personnel,Maintenance of Personnel,Int & Res (non approved teaching program,Intestinal Acquisition,Heart Acquisition,Lung  Acquisition,Pancreas Acquisition,Intestinal Acquisition,Intestinal Acquisition,Title V discharges,IPF,Physician Part A,Physician Part B,Interns & Residents,Home Program Dialysis,Home Program Dialysis,Home Program Dialysis,OLTC,Payment to cost ratio,Home Office Salaries & Wage Related Csts,Without Outliers:  Total Visits,Without Outliers:  Total Charges,W/Out Outliers:  Number of Episodes,Without Outliers:  Non Routine Med Sup Chgs,LUPA Episodes:  Total Visits,Total Charges:  LUPA Episodes,LUPA Episodes:  Total Number of Episodes,Total Visits,Total Charges,Total Number of Episodes,Total Non Routine Medical  Supply Charges,Land Improvements,NF,NF,NF,ESRD DME costs,Subprovider-IRF,Utilization Review-physicians compens,Utilization Review SNF,Utilization Review - Physician Compen,ICF,ICF,ICF,ICF,ICF,ICF,ICF,ICF,ICF,ICF,ICF,Ambulance Services,Ambulance Services,OLTC,OLTC,OLTC,Renal Dialysis,Premiums,Paid Losses,Self Insurance,"Percentage of patients re-using
dialyzers",Average times dialyzers re-used,"Number of patients in program at 
end of cost reporting period","Number of Times per week 
Patient receives Dialysis","Average patient dialysis time 
including setup",Number of stations,Donations,Intestinal Acquisition,ICF,IRF,LUPA:  Total Non Routine Med Sup Chgs,PEP Episodes:  Total Visits,PEP Episodes:  Total Charges:,PEP Episodes:  Total Number of Episodes,Title XVIII discharges,ICF,Total Other Medical Education Cost,Heart Acquisition,Lung  Acquisition,Pancreas Acquisition,Renal Dialysis,PBP Clinical Lab Services Program Only,Islet Acquisition,Islet Acquisition,Islet Acquisition,Islet Acquisition,Islet Acquisition,Islet Acquisition,Islet Acquisition,Home Program Dialysis,Subprovider-IRF,Islet Acquisition,Islet Acquisition,Organ Procurement,Organ Procurement,Renal Dialysis,Subprovider I,PEP:  Total Non Routine Med Supply Chgs,With Outliers:  Total Visits,With Outliers:  Total Charges,With Outliers:  Number of Episodes,Total Number of Outlier Episodes,Title V discharges,Labor and Delivery Days Title 18,Organ acquisition,Organ acquisition charges,Medicare allowable bad debts for the entire hospital complex,Physician Part A Teaching,Aggregate amount collected from patients,Amounts expected under 42 CFR,Medical and Other Services reimbursed by OPPS,Renal Dialysis,HHA 3 Provider Number,ASC 1 Provider Number,RHC 11 Provider Number,RHC 12 Provider Number,RHC 13 Provider Number,RHC 14 Provider Number,RHC 15 Provider Number,RHC 16 Provider Number,RHC 17 Provider Number,RHC 18 Provider Number,RHC 19 Provider Number,RHC 20 Provider Number,RHC 21 Provider Number,RHC 22 Provider Number,RHC 23 Provider Number,RHC 24 Provider Number,RHC 25 Provider Number,FQHC 2 Provider Number,FQHC 3 Provider Number,FQHC 4 Provider Number,FQHC 5 Provider Number,FQHC 6 Provider Number,FQHC 7 Provider Number,FQHC 8 Provider Number,FQHC 9 Provider Number,Beginning Date of SCH status,Ending Date of SCH status,MDH status beginning date  (MM/DD/YY),MDH status ending date (MM/DD/YY),Medicare Certified Pancreas TC term date,Medicare Certified Islet TC term date,Hospital Street Address,Hospital City,Hospital Zip Code,Hospital County,Hospital Name,Provider's actual MSA or CBSA,Hospital Title 18 Payment System (P/T/O),Type of Control of Hospital (See Table I),"Does the facility qualify and is it receiving payments for 
disproportionate share? (Y/N)","Is this a New Hospital under
42 CFR 412.300 PPS capital
(Y/N)",Does the hospital elect a fully prospective payment method for capital costs? (Y/N),"Is this a teaching hospital or
affiliated with a teaching hospital? (Y/N)",or allied health costs?,Is this a New Hospital under 42 CFR 413.40(f)(1)(I) (TEFRA)? (Y/N),Have you established a new subprovider excluded unit under 42 CFR 413.40(f)(1)(I)?(Y/N),Does the facility operate an ICF/MR facility for purposes of Title XIX? (Y/N),Does the hospital qualify as RPCH/CAH? (Y/N),"If this facility qualifies as a RPCH/CAH, has it elected the all inclusive payment for outpatient service? (Y/N)",Is this a rural hospital qualifying for an exception to the certified registered nurse anesthetist the CRNA fee schedule? (Y/N),Is this hospital an All-Inclusive rate provider? (Y/N),Is this hospital classified as a referral center? (Y/N),"Does this facility operate 
transplant center? (Y/N)","Are there any related organization or how office costs as defined in HCFA Pub. 15-I, chapter 10? (Y/N)",Are provider based physicians' costs included in Worksheet A? (Y/N),"If this Hospital is claiming cost for renal services on Worksheet A, are they inpatient services only? (Y/N)",IPF Provider Number,IPF Provider Number,FI/Contractor's Name,Home Office Name,Home Office Street,City,State,Zip Code,"If Line 32, Col 1 is yes, enter the method used: (A, B, or E only)",Received DSH or supplemental payments from Medicaid? (Y/N),Hospital PO Box,NF Provider Number,Swing Bed SNF Provider Number,MDH status beginning date (MM/DD/YY),MDH status ending date (MM/DD/YY),IRF Provider Number,IRF Provider Number,SNF Provider Number,HHA 1 Provider Number,Hospice 1 Provider Number,Beginning Date of SCH status,Ending Date of SCH status,"Medicare certified kidney 
transplant center cert date",Swing Bed NF Provider Number,RHC 1 Provider Number,RHC 2 Provider Number,Home Office PO Box,Renal 1 Provider Number,RHC 3 Provider Number,RHC 4 Provider Number,RHC 5 Provider Number,MCP Physician Payment Method (Y/N),"Medicare certified heart
transplant center cert date","Medical certified liver 
transplant center cert date",Renal 2 Provider Number,Hospice 2 Provider Number,Initial Physician Payment Method (Y/N),"Medical certified lung
transplant center cert date","If an Organ Procurement Organization, enter the OPO number",CMHC 1 Provider Number,certification date,RHC 6 Provider Number,RHC 7 Provider Number,RHC 8 Provider Number,RHC 9 Provider Number,RHC 10 Provider Number,Renal 3 Provider Number,Renal 4 Provider Number,Renal 5 Provider Number,HHA 2 Provider Number,Medicare Certified Kidney TC term date,Medicare Certified Heart TC term date,Medicare Certified Liver TC term date,Renal 6 Provider Number,FQHC 1 Provider Number,ICF Provider Number,Renal 7 Provider Number,Renal 8 Provider Number,Renal 9 Provider Number,Renal 10 Provider Number,certification date,Medicare Certified Lung TC term date,Blood Clotting Factors for Hemoph.,Blood Clotting Factors for Hemoph.,Blood Clotting Factors for Hemoph.,Blood Clotting Factors for Hemoph.,HHA,ASC (Distinct Part),Hospice,Other Special Purpose,FQHC,CMHC,HHA,ASC (Distinct Part),Hospice,Other Special Purpose,FQHC,CMHC,Blood Clotting Factors for Hemoph.,Blood Clotting Factors for Hemoph.,Respiratory Therapy,Occupational Therapy,Speech Pathology,Blood Clotting Factors for Hemoph.,OPT,OOT,OSP,Blood Clotting Factors for Hemoph.,FQHC,Blood Clotting Factors for Hemoph.,Coronary Care Unit,Surgical Intensive Care Unit,Other Special Care Unit,Durable Medical Equipment Rented,Durable Medical Equipment Rented,Blood Clotting Factors for Hemoph.,Drugs Charged to Patients,Other Ancillary,Emergency,Radioisotope,Whole Blood & Packed Red Blood Cells,Occupational Therapy,Speech Pathology,Medical Supplies Charged to Patients,Impl. Dev. Charged to Patients,Blood Clotting Factors for Hemoph.,RHC,FQHC,Other Reimbursable,Delivery Room and Labor Room,Anesthesiology,Radiology-Therapeutic,Radioisotope,Cardiac Catheterization,Laboratory,Intravenous Therapy,Physical Therapy,Occupational Therapy,Speech Pathology,Electrocardiology,Electroencephalography,Medical Supplies Charged to Patients,Impl. Dev. Charged to Patients,Drugs Charged to Patients,Other Ancillary,RHC,FQHC,Other Outpatient Services,Medical Supplies Charged to Patients,Recovery Room,Radiology-Therapeutic,Radioisotope,MRI,Cardiac Catheterization,Whole Blood & Packed Red Blood Cells,"Blood Storing, Processing, Trans",Intravenous Therapy,Respiratory Therapy,Physical Therapy,Occupational Therapy,Speech Pathology,ASC (Non Distinct Part),Other Ancillary,Observation Beds (Distinct Unit),Other Outpatient Services,Recovery Room,Anesthesiology,Radiology-Therapeutic,CT Scan,MRI,Cardiac Catheterization,Whole Blood & Packed Red Blood Cells,"Blood Storing, Processing, Trans",Physical Therapy,Speech Pathology,Electroencephalography,Medical Supplies Charged to Patients,Impl. Dev. Charged to Patients,ASC (Non Distinct Part),Other Ancillary,Other Outpatient Services,Delivery Room and Labor Room,MRI,Whole Blood & Packed Red Blood Cells,Intravenous Therapy,Electrocardiology,Impl. Dev. Charged to Patients,ASC (Non Distinct Part),Observation Beds (Distinct Unit),Drugs Charged to Patients,Blood Clotting Factors for Hemoph.,Blood Clotting Factors for Hemoph.,Durable Medical Equipment Rented,Other Reimbursable,Blood Clotting Factors for Hemoph.,Blood Clotting Factors for Hemoph.,Durable Medical Equipment Rented,Other Reimbursable,Outpatient Rehab Provider,Burn Intensive Care Unit,Surgical Intensive Care Unit,CMHC,Outpatient Rehab Provider,Outpatient Rehab Provider,HHA,New Cap Related Csts Bldg & Fixtures,New Cap Related Csts Movable Equipment,New Cap Related Csts Bldg & Fixtures,New Cap Related Csts Movable Equipment,New Cap Related Csts Bldg & Fixtures,New Cap Related Csts Movable Equipment,Other Adjustments (Summed),Pharmacy,Medical Records and Medical Rec. Library,Social Service,Administrative and General,Respiratory Therapy,Physical Therapy,Occupational Therapy,Electrocardiology,Housekeeping,New Capital Buildings and Fixtures,Dietary,Pharmacy,Medical Records and Medical Rec. Library,Social Service,New Capital Equipment,Employee Benefits,Administrative and General,Operating Room,Recovery Room,Anesthesiology,Radiology-Diagnostic,Radiology-Therapeutic,Laboratory,"Blood Storing, Processing, Trans",Respiratory Therapy,Physical Therapy,Occupational Therapy,Speech Pathology,Electrocardiology,Operation of Plant,Electroencephalography,Medical Supplies Charged to Patients,Drugs Charged to Patients,Housekeeping,Pharmacy,Medical Records and Medical Rec. Library,Social Service,Administrative and General,New Capital Buildings and Fixtures,Dietary,Pharmacy,Medical Records and Medical Rec. Library,Social Service,New Capital Equipment,Employee Benefits,Administrative and General,Operating Room,Recovery Room,Anesthesiology,Radiology-Diagnostic,Radiology-Therapeutic,CT Scan,MRI,Laboratory,"Blood Storing, Processing, Trans",Intravenous Therapy,Respiratory Therapy,Physical Therapy,Occupational Therapy,Speech Pathology,Electrocardiology,Operation of Plant,Electroencephalography,Medical Supplies Charged to Patients,Impl. Dev. Charged to Patients,Drugs Charged to Patients,Housekeeping,Clinic,Emergency,Operating Room,Recovery Room,Anesthesiology,Radiology-Diagnostic,Radiology-Therapeutic,CT Scan,MRI,Laboratory,"Blood Storing, Processing, Trans",Intravenous Therapy,Respiratory Therapy,Physical Therapy,Occupational Therapy,Speech Pathology,Electrocardiology,Electroencephalography,Medical Supplies Charged to Patients,Impl. Dev. Charged to Patients,Drugs Charged to Patients,Clinic,Emergency,Operating Room,Recovery Room,Anesthesiology,Radiology-Diagnostic,Radiology-Therapeutic,CT Scan,MRI,Laboratory,"Blood Storing, Processing, Trans",Intravenous Therapy,Respiratory Therapy,Physical Therapy,Occupational Therapy,Speech Pathology,Electrocardiology,Electroencephalography,Medical Supplies Charged to Patients,Impl. Dev. Charged to Patients,Drugs Charged to Patients,Clinic,Emergency,Operating Room,Recovery Room,Anesthesiology,Radiology-Diagnostic,Radiology-Therapeutic,CT Scan,MRI,Laboratory,"Blood Storing, Processing, Trans",Intravenous Therapy,Respiratory Therapy,Physical Therapy,Occupational Therapy,Speech Pathology,Electrocardiology,Electroencephalography,Medical Supplies Charged to Patients,Impl. Dev. Charged to Patients,Drugs Charged to Patients,Clinic,Emergency,Operating Room,Recovery Room,Anesthesiology,Radiology-Diagnostic,Radiology-Therapeutic,CT Scan,MRI,Laboratory,"Blood Storing, Processing, Trans",Intravenous Therapy,Respiratory Therapy,Physical Therapy,Occupational Therapy,Speech Pathology,Electrocardiology,Electroencephalography,Medical Supplies Charged to Patients,Impl. Dev. Charged to Patients,Drugs Charged to Patients,Clinic,Emergency,Operating Room,Recovery Room,Anesthesiology,Radiology-Diagnostic,Radiology-Therapeutic,CT Scan,MRI,Laboratory,"Blood Storing, Processing, Trans",Intravenous Therapy,Respiratory Therapy,Physical Therapy,Occupational Therapy,Speech Pathology,Electrocardiology,Electroencephalography,Medical Supplies Charged to Patients,Impl. Dev. Charged to Patients,Drugs Charged to Patients,Clinic,Emergency,Operating Room,Recovery Room,Anesthesiology,Radiology-Diagnostic,Radiology-Therapeutic,CT Scan,MRI,Laboratory,"Blood Storing, Processing, Trans",Intravenous Therapy,Respiratory Therapy,Physical Therapy,Occupational Therapy,Speech Pathology,Electrocardiology,Electroencephalography,Medical Supplies Charged to Patients,Impl. Dev. Charged to Patients,Drugs Charged to Patients,Clinic,Emergency,Operating Room,Recovery Room,Anesthesiology,Radiology-Diagnostic,Radiology-Therapeutic,CT Scan,MRI,Laboratory,"Blood Storing, Processing, Trans",Intravenous Therapy,Respiratory Therapy,Physical Therapy,Occupational Therapy,Speech Pathology,Electrocardiology,Electroencephalography,Medical Supplies Charged to Patients,Impl. Dev. Charged to Patients,Drugs Charged to Patients,Clinic,Emergency,New Cap Related Csts Bldg & Fixtures,New Cap Related Csts Bldg & Fixtures,New Cap Related Csts Movable Equipment,Dietary,Nursing Administration,Other General Service,Other Nonreimbursable,Operation of Plant,Clinic,Nursing Administration,Other General Service,Other Nonreimbursable,Laundry and Linen Service,Clinic,New Capital Buildings and Fixtures,Cafeteria,Other Nonreimbursable,Clinic,Cafeteria,Nursing Administration,Other General Service,Other Nonreimbursable,Laundry and Linen Service,"Gift, Flower, Coffee Shop, Canteen",Other Nonreimbursable,"Gift, Flower, Coffee Shop, Canteen",Other Nonreimbursable,Clinic,Other Reimbursable,Central Services and Supply,Maintenance and Repairs,Other Reimbursable,New Capital Equipment,Employee Benefits,Other Reimbursable,Central Services and Supply,Maintenance and Repairs,Other Reimbursable,Other Reimbursable,Other Reimbursable,Other Reimbursable,Other Reimbursable,Drugs Charged to Patients,Other Reimbursable,Drugs Charged to Patients,Other Reimbursable,Drugs Charged to Patients,Other Reimbursable,Employee Benefits,Radiology-Diagnostic,Maintenance and Repairs,Laboratory,Laundry and Linen Service,Operation of Plant,Nonpaid Workers,Nonpaid Workers,Dietary,Research,Research,Clinic,Clinic,Clinic,Research,Maintenance and Repairs,Research,Interns & Res Salary and Fringe Benefits,Interns & Res Salary and Fringe Benefits,Clinic,Clinic,Operating Room,Delivery Room and Labor Room,Delivery Room and Labor Room,Nursing Administration,Central Services and Supply,Delivery Room and Labor Room,Laundry and Linen Service,Housekeeping,Delivery Room and Labor Room,Delivery Room and Labor Room,Delivery Room and Labor Room,Delivery Room and Labor Room,Delivery Room and Labor Room,Operating Room,Delivery Room and Labor Room,Radiology-Diagnostic,Laboratory,Medical Supplies Charged to Patients,Drugs Charged to Patients,Operating Room,Operating Room,Operating Room,Speech Pathology,Drugs Charged to Patients,CT Scan,MRI,Physical Therapy,Occupational Therapy,Speech Pathology,Electrocardiology,Drugs Charged to Patients,Respiratory Therapy,Electrocardiology,Radiology-Diagnostic,Laboratory,Respiratory Therapy,Electrocardiology,Radiology-Diagnostic,Laboratory,Respiratory Therapy,Electrocardiology,Radiology-Diagnostic,Laboratory,Respiratory Therapy,Electrocardiology,New Cap Related Csts Bldg & Fixtures,New Cap Related Csts Movable Equipment,Other Ancillary,Other Ancillary,Radiology-Diagnostic,Other Ancillary,Other Ancillary,Other Ancillary,Other Ancillary,New Cap Related Csts Bldg & Fixtures,New Cap Related Csts Movable Equipment,Central Services and Supply,Intensive Care Unit,Intensive Care Unit,Operating Room,Laboratory,Respiratory Therapy,Intensive Care Unit,Intensive Care Unit,Intensive Care Unit,Intensive Care Unit,Intensive Care Unit,Physical Therapy,Intensive Care Unit Program Cost,Intensive Care Unit,Intensive Care Unit,Intensive Care Unit,Intensive Care Unit,Radiology-Diagnostic,Respiratory Therapy,Radiology-Diagnostic,Respiratory Therapy,Intensive Care Unit,Intensive Care Unit,Intensive Care Unit,Intensive Care Unit,"Gift, Flower, Coffee Shop, Canteen",Coronary Care Unit,Surgical Intensive Care Unit,Recovery Room,Anesthesiology,Radioisotope,CT Scan,MRI,Cardiac Catheterization,Intravenous Therapy,Electroencephalography,Emergency,"Gift, Flower, Coffee Shop, Canteen",Coronary Care Unit,Surgical Intensive Care Unit,Radioisotope,Cardiac Catheterization,Intravenous Therapy,Emergency,Nonphysician Anesthetists,CT Scan,Cardiac Catheterization,Electroencephalography,Emergency,"Gift, Flower, Coffee Shop, Canteen",Paramedical Education,Coronary Care Unit,Surgical Intensive Care Unit,Radioisotope,Cardiac Catheterization,Physicians' Private Office,Coronary Care Unit,Surgical Intensive Care Unit,Radioisotope,Cardiac Catheterization,Physicians' Private Office,Coronary Care Unit,Surgical Intensive Care Unit,Radioisotope,Cardiac Catheterization,Coronary Care Unit,Surgical Intensive Care Unit,Radioisotope,Cardiac Catheterization,Coronary Care Unit,Surgical Intensive Care Unit,Radioisotope,Cardiac Catheterization,Recovery Room,Anesthesiology,Radioisotope,CT Scan,MRI,Cardiac Catheterization,Intravenous Therapy,Electroencephalography,Impl. Dev. Charged to Patients,Emergency,Coronary Care Unit,Surgical Intensive Care Unit,Delivery Room and Labor Room,Radioisotope,Cardiac Catheterization,Delivery Room and Labor Room,Radioisotope,Cardiac Catheterization,Coronary Intensive Care Unit,Surgical Intensive Care Unit,Coronary Intensive Care Unit,Surgical Intensive Care Unit,Coronary Intensive Care Unit,Surgical Intensive Care Unit,Delivery Room and Labor Room,Radioisotope,Cardiac Catheterization,Operating Room,Recovery Room,Delivery Room and Labor Room,Anesthesiology,Radioisotope,CT Scan,MRI,Cardiac Catheterization,Intravenous Therapy,Physical Therapy,Electroencephalography,Medical Supplies Charged to Patients,Impl. Dev. Charged to Patients,Emergency,Operating Room,Operating Room,Recovery Room,Delivery Room and Labor Room,Anesthesiology,Radioisotope,CT Scan,MRI,Cardiac Catheterization,Intravenous Therapy,Physical Therapy,Electroencephalography,Medical Supplies Charged to Patients,Impl. Dev. Charged to Patients,Emergency,Drugs Charged to Patients,Laboratory,Impl. Dev. Charged to Patients,Drugs Charged to Patients,Recovery Room,Delivery Room and Labor Room,Anesthesiology,Radioisotope,CT Scan,MRI,Cardiac Catheterization,Intravenous Therapy,Physical Therapy,Electroencephalography,Medical Supplies Charged to Patients,Impl. Dev. Charged to Patients,Emergency,Drugs Charged to Patients,Laboratory,Impl. Dev. Charged to Patients,Drugs Charged to Patients,Surgical Intensive Care Unit,Coronary Care Unit,Surgical Intensive Care Unit,Coronary Care Unit,Surgical Intensive Care Unit,Coronary Care Unit,Surgical Intensive Care Unit,Intensive Care Unit,Coronary Care Unit,Surgical Intensive Care Unit,Coronary Care Unit,Medical Supplies Charged to Patients,Medical Supplies Charged to Patients,Physicians' Private Office,Other Ancillary,Occupational Therapy,Speech Pathology,Other Ancillary,Other Ancillary,Other Ancillary,Other Ancillary,Other Ancillary,Other Ancillary,Other Ancillary,Whole Blood & Packed Red Blood Cells,Anesthesiology,Whole Blood & Packed Red Blood Cells,Whole Blood & Packed Red Blood Cells,Whole Blood & Packed Red Blood Cells,Whole Blood & Packed Red Blood Cells,Whole Blood & Packed Red Blood Cells,Whole Blood & Packed Red Blood Cells,Whole Blood & Packed Red Blood Cells,Whole Blood & Packed Red Blood Cells,Whole Blood & Packed Red Blood Cells,Whole Blood & Packed Red Blood Cells,Whole Blood & Packed Red Blood Cells,Whole Blood & Packed Red Blood Cells,Radiology-Diagnostic,Whole Blood & Packed Red Blood Cells,Radiology-Diagnostic,HHA,Physicians' Private Office,Physicians' Private Office,Interns & Res Other Program Costs,Intensive Care Unit,Interns & Res Other Program Costs,Operating Room,Recovery Room,Anesthesiology,Radiology-Diagnostic,Radioisotope,Laboratory,Respiratory Therapy,Physical Therapy,Occupational Therapy,Speech Pathology,Electrocardiology,Medical Supplies Charged to Patients,Impl. Dev. Charged to Patients,Drugs Charged to Patients,Emergency,Operating Room,Recovery Room,Anesthesiology,Radiology-Diagnostic,Radioisotope,Laboratory,Respiratory Therapy,Physical Therapy,Occupational Therapy,Speech Pathology,Electrocardiology,Medical Supplies Charged to Patients,Impl. Dev. Charged to Patients,Drugs Charged to Patients,Emergency,Operating Room,Recovery Room,Anesthesiology,Radiology-Diagnostic,Radioisotope,Laboratory,Respiratory Therapy,Physical Therapy,Occupational Therapy,Speech Pathology,Electrocardiology,Medical Supplies Charged to Patients,Impl. Dev. Charged to Patients,Drugs Charged to Patients,Clinic,Operating Room,Recovery Room,Anesthesiology,Radiology-Diagnostic,Radioisotope,Laboratory,Respiratory Therapy,Physical Therapy,Occupational Therapy,Speech Pathology,Electrocardiology,Medical Supplies Charged to Patients,Impl. Dev. Charged to Patients,Drugs Charged to Patients,Clinic,Occupational Therapy,Occupational Therapy,Occupational Therapy,Hospice,HHA,Hospice,HHA,Hospice,HHA,Hospice,HHA,Hospice,HHA,Hospice,Radiology-Diagnostic,Laboratory,Physical Therapy,Occupational Therapy,Speech Pathology,Medical Supplies Charged to Patients,Drugs Charged to Patients,Radiology-Diagnostic,Laboratory,Physical Therapy,Occupational Therapy,Speech Pathology,Medical Supplies Charged to Patients,Drugs Charged to Patients,HHA,Hospice,HHA,New Cap Related Csts Movable Equipment,Paramedical Education,Other Special Care Unit,Radiology-Therapeutic,ASC (Non Distinct Part),Paramedical Education,Other Special Care Unit,ASC (Non Distinct Part),Interns & Res Other Program Costs,Paramedical Education,Other Special Care Unit,Radiology-Therapeutic,Radioisotope,ASC (Non Distinct Part),Other Special Care Unit,ASC (Non Distinct Part),Intensive Care Unit,Operating Room,Laboratory,Other Special Care Unit,ASC (Non Distinct Part),Other Special Care Unit,ASC (Non Distinct Part),Other Special Care Unit,ASC (Non Distinct Part),Other Special Care Unit,ASC (Non Distinct Part),Radiology-Therapeutic,ASC (Non Distinct Part),ASC (Non Distinct Part),ASC (Non Distinct Part),CT Scan,MRI,Clinic,CT Scan,MRI,Clinic,Radiology-Therapeutic,CT Scan,MRI,Electroencephalography,ASC (Non Distinct Part),Emergency,Radiology-Therapeutic,CT Scan,MRI,Electroencephalography,ASC (Non Distinct Part),Emergency,Other Special Care Unit,Intensive Care Unit,ASC (Non Distinct Part),Radiology-Therapeutic,ASC (Non Distinct Part),Radiology-Therapeutic,ASC (Non Distinct Part),Impl. Dev. Charged to Patients,Emergency,Radiology-Therapeutic,ASC (Non Distinct Part),Impl. Dev. Charged to Patients,Emergency,Other Special Care,Other Special Care,Other Special Care,Other Special Care,Laboratory,Laboratory,Physicians' Private Office,HHA,Whole Blood & Packed Red Blood Cells,Durable Medical Equipment Sold,Durable Medical Equipment Sold,Durable Medical Equipment Sold,Durable Medical Equipment Sold,Durable Medical Equipment Sold,Durable Medical Equipment Sold,Durable Medical Equipment Sold,Whole Blood & Packed Red Blood Cells,Electrocardiology,Whole Blood & Packed Red Blood Cells,Electrocardiology,RHC,Other Outpatient Services,RHC,Other Outpatient Services,RHC,Other Outpatient Services,RHC,Other Outpatient Services,RHC,Other Outpatient Services,RHC,Other Outpatient Services,RHC,Other Outpatient Services,Operating Room,Physical Therapy,Speech Pathology,Electrocardiology,Medical Supplies Charged to Patients,Other Outpatient Services,Operating Room,Physical Therapy,Speech Pathology,Electrocardiology,Medical Supplies Charged to Patients,Other Outpatient Services,RHC/FQHC Combined,RHC/FQHC Combined,RHC/FQHC Combined,RHC/FQHC Combined,Nonphysician Anesthetists,Nonphysician Anesthetists,Impl. Dev. Charged to Patients,Nonphysician Anesthetists,RHC,RHC,Respiratory Therapy,Clinic,Emergency,Respiratory Therapy,Clinic,Emergency,Anesthesiology,Anesthesiology,Anesthesiology,Clinic,Anesthesiology,Clinic,Observation Beds (Distinct Unit),Observation Beds (Distinct Unit),Observation Beds (Distinct Unit),Observation Beds (Distinct Unit),Observation Beds (Distinct Unit),Observation Beds (Distinct Unit),Observation Beds (Distinct Unit),Observation Beds (Distinct Unit),Observation Beds (Distinct Unit),Observation Beds (Distinct Unit),Observation Beds (Distinct Unit),Observation Beds (Distinct Unit),Observation Beds (Distinct Unit),HHA,HHA,Other Ancillary,HHA,"Blood Storing, Processing, Trans","Blood Storing, Processing, Trans","Blood Storing, Processing, Trans","Blood Storing, Processing, Trans",Nonpaid Workers,Nonpaid Workers,Other adjustments,"Gift, Flower, Coffee Shop, Canteen",MRI,Other Outpatient Services,Other General Service,Occupational Therapy,Occupational Therapy,Research,Hospice,Hospice,Recovery Room,"Blood Storing, Processing, Trans",Recovery Room,"Blood Storing, Processing, Trans",Intensive Care Unit,Interns & Res Salary and Fringe Benefits,"Blood Storing, Processing, Trans",Interns & Res Salary and Fringe Benefits,Interns & Res Salary and Fringe Benefits,Recovery Room,"Blood Storing, Processing, Trans",Intravenous Therapy,Other Nonreimbursable,Intensive Care Unit,Operating Room,Recovery Room,Delivery Room and Labor Room,Anesthesiology,Radiology-Diagnostic,Radiology-Therapeutic,Radioisotope,CT Scan,MRI,Cardiac Catheterization,Laboratory,"Blood Storing, Processing, Trans",Respiratory Therapy,Electrocardiology,Electroencephalography,Emergency,Other Nonreimbursable,Recovery Room,Delivery Room and Labor Room,Anesthesiology,Radiology-Diagnostic,Radiology-Therapeutic,Radioisotope,CT Scan,MRI,Cardiac Catheterization,"Blood Storing, Processing, Trans",Respiratory Therapy,Electrocardiology,Electroencephalography,Emergency,Recovery Room,Delivery Room and Labor Room,Radiology-Diagnostic,Radiology-Therapeutic,CT Scan,MRI,Cardiac Catheterization,Laboratory,Intravenous Therapy,Electroencephalography,Drugs Charged to Patients,Clinic,Emergency,Recovery Room,Delivery Room and Labor Room,Anesthesiology,Radiology-Diagnostic,Radiology-Therapeutic,CT Scan,MRI,Cardiac Catheterization,Laboratory,Intravenous Therapy,Drugs Charged to Patients,Clinic,Emergency,Recovery Room,Delivery Room and Labor Room,Anesthesiology,Radiology-Diagnostic,Radiology-Therapeutic,CT Scan,MRI,Cardiac Catheterization,Laboratory,Intravenous Therapy,Electroencephalography,Drugs Charged to Patients,Clinic,Emergency,Delivery Room and Labor Room,Radiology-Therapeutic,Radioisotope,CT Scan,MRI,Cardiac Catheterization,Intravenous Therapy,Electroencephalography,Delivery Room and Labor Room,Radiology-Therapeutic,Radioisotope,CT Scan,MRI,Cardiac Catheterization,Intravenous Therapy,Electroencephalography,Hospice,Hospice,Hospice,Other Special Purpose,Other Special Purpose,Other Special Purpose,Whole Blood & Packed Red Blood Cells,Whole Blood & Packed Red Blood Cells,Other Ancillary,Emergency,Other Ancillary,Emergency,Maintenance of Personnel,Maintenance of Personnel,Maintenance of Personnel,Nonpaid Workers,Burn Intensive Care Unit,Burn Intensive Care Unit,Burn Intensive Care Unit,Burn Intensive Care Unit,Burn Intensive Care Unit,Burn Intensive Care Unit,Burn Intensive Care Unit,Burn Intensive Care Unit,Burn Intensive Care Unit,Burn Intensive Care Unit,Burn Intensive Care Unit,Burn Intensive Care Unit,Burn Intensive Care Unit,Burn Intensive Care Unit,Burn Intensive Care Unit,Hospice,Hospice,ASC (Non Distinct Part),ASC (Non Distinct Part),Radiology-Therapeutic,Cardiac Catheterization,"Blood Storing, Processing, Trans",Intravenous Therapy,Other Ancillary,Radiology-Therapeutic,Cardiac Catheterization,"Blood Storing, Processing, Trans",Intravenous Therapy,Other Ancillary,Radiology-Therapeutic,CT Scan,MRI,Intravenous Therapy,Electrocardiology,Clinic,Radiology-Therapeutic,CT Scan,MRI,Intravenous Therapy,Electrocardiology,Clinic,Anesthesiology,Anesthesiology,Durable Medical Equipment Rented,Durable Medical Equipment Rented,Durable Medical Equipment Rented,Durable Medical Equipment Rented,Durable Medical Equipment Rented,Other Reimbursable,Durable Medical Equipment Rented,Other Reimbursable,Other Reimbursable,Other Special Purpose,Cafeteria,Other Organ Acquisition,Cafeteria,Other Organ Acquisition,Other Organ Acquisition,Research,Coronary Care Unit,Other Organ Acquisition,Research,Coronary Care Unit,Surgical Intensive Care Unit,Other Special Care Unit,Physical Therapy,ASC (Non Distinct Part),Research,Coronary Care Unit,Surgical Intensive Care Unit,Other Special Care Unit,Physical Therapy,ASC (Non Distinct Part),Other Organ Acquisition,Other Organ Acquisition,Other Organ Acquisition,Other Organ Acquisition,Other Organ Acquisition,Coronary Care Unit Program Cost,Delivery Room and Labor Room,Electroencephalography,Delivery Room and Labor Room,Electroencephalography,Cardiac Catheterization,"Blood Storing, Processing, Trans",Other Ancillary,Cardiac Catheterization,"Blood Storing, Processing, Trans",Other Ancillary,Coronary Care Unit,Surgical Intensive Care Unit,ASC (Non Distinct Part),Speech Pathology,ASC (Non Distinct Part),ASC (Non Distinct Part),Operating Room,Emergency,Operating Room,Radiology-Therapeutic,Speech Pathology,Speech Pathology,Interns & Res Other Program Costs,Durable Medical Equipment Sold,Durable Medical Equipment Sold,Durable Medical Equipment Sold,Durable Medical Equipment Sold,Cardiac Catheterization,Cardiac Catheterization,HHA,Hospice,RHC/FQHC Combined,Other Outpatient Services,Other Outpatient Services,Radiology-Diagnostic,CT Scan,MRI,Radiology-Diagnostic,CT Scan,MRI,Radiology-Diagnostic,CT Scan,MRI,Other Outpatient Services,Medical Supplies Charged to Patients,Other Outpatient Services,Medical Supplies Charged to Patients,Hospice,Nursing School,Nursing School,FQHC,FQHC,FQHC,HHA,Impl. Dev. Charged to Patients,Impl. Dev. Charged to Patients,Operating Room,Delivery Room and Labor Room,Emergency,Emergency,Radiology-Diagnostic,Whole Blood & Packed Red Blood Cells,Whole Blood & Packed Red Blood Cells,Other Outpatient Services,Other Outpatient Services,Other Outpatient Services,Other Outpatient Services,Other Special Purpose,Other Special Purpose,Other Special Purpose,Other Special Purpose,Nonpaid Workers,"Blood Storing, Processing, Trans",Electroencephalography,Other Ancillary,"Blood Storing, Processing, Trans",Electroencephalography,Other Ancillary,Operating Room,Durable Medical Equipment Rented,Operating Room,Operating Room,Maintenance of Personnel,Durable Medical Equipment Rented,Other Special Purpose,Physical Therapy,Anesthesiology,Anesthesiology,Other Outpatient Services,Other Outpatient Services,Operating Room,Operating Room,Intensive Care Unit,Radiology-Therapeutic,CT Scan,MRI,Radiology-Therapeutic,CT Scan,MRI,Respiratory Therapy,Respiratory Therapy,Nursing School,Intravenous Therapy,Medical Supplies Charged to Patients,Drugs Charged to Patients,Speech Pathology,Drugs Charged to Patients,Burn Intensive Care Unit Program Cost,Surgical Intensive Care Unit Program Cost,ASC (Non Distinct Part),ASC (Non Distinct Part),Burn Intensive Care Unit,Radioisotope,"Blood Storing, Processing, Trans",Respiratory Therapy,Physical Therapy,Electrocardiology,Medical Supplies Charged to Patients,Radioisotope,"Blood Storing, Processing, Trans",Respiratory Therapy,Physical Therapy,Electrocardiology,Electroencephalography,Medical Supplies Charged to Patients,Recovery Room,Anesthesiology,Radiology-Diagnostic,Radiology-Therapeutic,MRI,Respiratory Therapy,Physical Therapy,Electrocardiology,Electroencephalography,ASC (Non Distinct Part),Clinic,Radioisotope,"Blood Storing, Processing, Trans",Respiratory Therapy,Physical Therapy,Electrocardiology,Medical Supplies Charged to Patients,ASC (Non Distinct Part),Recovery Room,Electroencephalography,Radioisotope,Burn Intensive Care Unit,Nursing School,Intensive Care Unit,Delivery Room and Labor Room,Cardiac Catheterization,Delivery Room and Labor Room,Cardiac Catheterization,"Gift, Flower, Coffee Shop, Canteen",Physicians' Private Office,Other Ancillary,"Gift, Flower, Coffee Shop, Canteen",Physicians' Private Office,Other Ancillary,Other Outpatient Services,Burn Intensive Care Unit,Other Special Care Unit,Other Special Care Unit,Other Special Care Unit,Other Special Care Unit,Other Outpatient Services,Other Ancillary,Other Outpatient Services,Other Special Care,Whole Blood & Packed Red Blood Cells,Whole Blood & Packed Red Blood Cells,Surgical Intensive Care Unit,Burn Intensive Care Unit,Burn Intensive Care Unit,Intravenous Therapy,Intravenous Therapy,Respiratory Therapy,Clinic,Observation Beds (Distinct Unit),Observation Beds (Distinct Unit),Occupational Therapy,Occupational Therapy,Radioisotope,Radioisotope,Other Reimbursable,Other Reimbursable,Other Reimbursable,Other Ancillary,Other Ancillary,Coronary Care Unit,Laboratory,Drugs Charged to Patients,Observation Beds (Distinct Unit),Radioisotope,Radioisotope,Impl. Dev. Charged to Patients,Delivery Room and Labor Room,Delivery Room and Labor Room,Clinic,ASC (Distinct Part),ASC (Distinct Part),ASC (Distinct Part),Recovery Room,ASC (Non Distinct Part),Recovery Room,ASC (Non Distinct Part),"Blood Storing, Processing, Trans",Anesthesiology,Laboratory,"Blood Storing, Processing, Trans",Anesthesiology,Laboratory,"Blood Storing, Processing, Trans",ASC (Non Distinct Part),Operating Room,Anesthesiology,"Blood Storing, Processing, Trans",Emergency,ASC (Distinct Part),ASC (Distinct Part),ASC (Distinct Part),ASC (Distinct Part),ASC (Distinct Part),Durable Medical Equipment Rented,Speech Pathology,Speech Pathology,Intravenous Therapy,Intravenous Therapy,Whole Blood & Packed Red Blood Cells,Whole Blood & Packed Red Blood Cells,Speech Pathology,Whole Blood & Packed Red Blood Cells,Radiology-Diagnostic,FQHC,FQHC,FQHC,Other Ancillary,Other Ancillary,Occupational Therapy,Occupational Therapy,Occupational Therapy,FQHC,Intensive Care Unit,Drugs Charged to Patients,Drugs Charged to Patients,Durable Medical Equipment Sold,Other Outpatient Services,Other Outpatient Services,Recovery Room,"Blood Storing, Processing, Trans",Physical Therapy,Occupational Therapy,Speech Pathology,Recovery Room,"Blood Storing, Processing, Trans",Physical Therapy,Occupational Therapy,Speech Pathology,Delivery Room and Labor Room,Delivery Room and Labor Room,Laboratory,Intensive Care Unit,Other Outpatient Services,Respiratory Therapy,Physical Therapy,Occupational Therapy,Speech Pathology,Durable Medical Equipment Sold,Durable Medical Equipment Sold,Durable Medical Equipment Sold,Blood Clotting Factors for Hemoph.,Blood Clotting Factors for Hemoph.,Blood Clotting Factors for Hemoph.,CORF,CORF,CORF,CORF,CORF,CORF,CORF,CORF,Other Outpatient Services,Other Outpatient Services,Outpatient Rehab Provider,Other Ancillary,Other Ancillary,Other Ancillary,Other Outpatient Services,Other Outpatient Services,CT Scan,CT Scan,RHC,RHC,RHC/FQHC Combined,CORF,Radiology-Diagnostic,Respiratory Therapy,Emergency,Whole Blood & Packed Red Blood Cells,Impl. Dev. Charged to Patients,Whole Blood & Packed Red Blood Cells,Impl. Dev. Charged to Patients,Impl. Dev. Charged to Patients,Respiratory Therapy,Electrocardiology,Electroencephalography,Impl. Dev. Charged to Patients,Drugs Charged to Patients,Operating Room,Delivery Room and Labor Room,CT Scan,Laboratory,Electroencephalography,Medical Supplies Charged to Patients,Impl. Dev. Charged to Patients,Drugs Charged to Patients,Radioisotope,Radioisotope,Other Outpatient Services,Other Reimbursable,Other Reimbursable,Other Reimbursable,Other Reimbursable,Cardiac Catheterization,Cardiac Catheterization,Cardiac Catheterization,Radiology-Therapeutic,Cardiac Catheterization,Observation Beds (Distinct Unit),Observation Beds (Distinct Unit),Observation Beds (Distinct Unit),Observation Beds (Distinct Unit),Physical Therapy,Physical Therapy,Recovery Room,Other Reimbursable,Other Reimbursable,Coronary Care Unit,Durable Medical Equipment Rented,Durable Medical Equipment Rented,Durable Medical Equipment Rented,Durable Medical Equipment Rented,Durable Medical Equipment Rented,Durable Medical Equipment Rented,Durable Medical Equipment Rented,Electroencephalography,Electroencephalography,Observation Beds (Distinct Unit),Observation Beds (Distinct Unit),Observation Beds (Distinct Unit),Observation Beds (Distinct Unit),Observation Beds (Distinct Unit),Emergency,Observation Beds (Distinct Unit),Occupational Therapy,Occupational Therapy,Speech Pathology,Electrocardiology,Medical Supplies Charged to Patients,Impl. Dev. Charged to Patients,Durable Medical Equipment Rented,Durable Medical Equipment Rented,Medical Supplies Charged to Patients,Impl. Dev. Charged to Patients,Observation Beds (Distinct Unit),ASC (Distinct Part),Operating Room,RHC,Other Special Care,Burn Intensive Care Unit,Coronary Care Unit,Other Special Care Unit,Clinic,FQHC,CMHC,CMHC,CMHC,CMHC,CMHC,CMHC,CMHC,CMHC,CMHC,Other Outpatient Services,Other Outpatient Services,Other Reimbursable,Other Reimbursable,Intravenous Therapy,Speech Pathology,Operating Room,Recovery Room,Respiratory Therapy,ASC (Non Distinct Part),Clinic,Emergency,Clinic,Durable Medical Equipment Sold,Drugs Charged to Patients,Durable Medical Equipment Sold,Observation Beds (Distinct Unit),Durable Medical Equipment Sold,Durable Medical Equipment Sold,Durable Medical Equipment Sold,Whole Blood & Packed Red Blood Cells,Whole Blood & Packed Red Blood Cells,Observation Beds (Distinct Unit),Observation Beds (Distinct Unit),Medical Supplies Charged to Patients,Electrocardiology,Durable Medical Equipment Rented,Durable Medical Equipment Rented,Durable Medical Equipment Rented,Recovery Room,Electroencephalography,Other Ancillary,Other Organ Acquisition,Intravenous Therapy,Delivery Room and Labor Room,Other Organ Acquisition,Impl. Dev. Charged to Patients,Clinic,Nonpaid Workers,Nonpaid Workers,Coronary Care Unit,Burn Intensive Care Unit,Surgical Intensive Care Unit,Burn Intensive Care Unit,Surgical Intensive Care Unit,Other Special Care Unit,Intravenous Therapy,Delivery Room and Labor Room,Intravenous Therapy,Radioisotope,Radiology-Therapeutic,OPT,OOT,OSP,OPT,OOT,OSP,OPT,OOT,OSP,OPT,OOT,OSP,OPT,OOT,OSP,OPT,OOT,OSP,OPT,OOT,OSP,OPT,OOT,OSP,Laboratory,Anesthesiology,Other Outpatient Services,Observation Beds (Distinct Unit),Observation Beds (Distinct Unit),Impl. Dev. Charged to Patients,Other Special Care,Surgical Intensive Care Unit,Whole Blood & Packed Red Blood Cells,Speech Pathology,Whole Blood & Packed Red Blood Cells,Electrocardiology,Hospice,ASC (Non Distinct Part),ASC (Non Distinct Part),Other Reimbursable,Other Reimbursable,Other Reimbursable,Other Reimbursable,FFY,Hospital State,"If (SCH), enter the # of periods.",Is this hospital is subject to the HAC reduction adjustment for discharges occurring prior to October 1? (Y/N),Is this hospital is subject to the HAC reduction adjustment for discharges occurring on or after October 1? (Y/N),IPPS Interim payment,HVBP payment adjustment amount,HRR adjustment amount ,IPPS Payment amount (unadjusted),HAC reduction adjustment amount,Line 19 Subtotal,Reconstructed IPPS payment (pre HAC penalty),Reconstructed HAC penalty,Reconstructed IPPS payment (post HAC penalty),HAC penalty imputed from E_A_HOS_C1_59,Name and Num
,Curated Name and Num,"Hospital type, text","Control type, text",Lon,Lat,HOSPITAL IDENTIFICATION INFORMATION,HOSPITAL IDENTIFICATION INFORMATION,HOSPITAL IDENTIFICATION INFORMATION,HOSPITAL IDENTIFICATION INFORMATION,HOSPITAL IDENTIFICATION INFORMATION,HOSPITAL IDENTIFICATION INFORMATION,HOSPITAL IDENTIFICATION INFORMATION,HOSPITAL IDENTIFICATION INFORMATION,HOSPITAL IDENTIFICATION INFORMATION,HOSPITAL IDENTIFICATION INFORMATION,HOSPITAL IDENTIFICATION INFORMATION,HOSPITAL IDENTIFICATION INFORMATION,HOSPITAL IDENTIFICATION INFORMATION,HOSPITAL IDENTIFICATION INFORMATION,TRIAL BALANCE OF EXPENSE ACCOUNTS,TRIAL BALANCE OF EXPENSE ACCOUNTS,TRIAL BALANCE OF EXPENSE ACCOUNTS,COST ALLOCATION,COST ALLOCATION,COST ALLOCATION,COST ALLOCATION,COST ALLOCATION,COST ALLOCATION,COMPUTATION OF RATIO OF COST TO CHARGES,COMPUTATION OF RATIO OF COST TO CHARGES,COMPUTATION OF RATIO OF COST TO CHARGES,INPATIENT ANCILLARY SERVICE COST APPORTIONMENT,INPATIENT ANCILLARY SERVICE COST APPORTIONMENT,INPATIENT ANCILLARY SERVICE COST APPORTIONMENT,INPATIENT ANCILLARY SERVICE COST APPORTIONMENT,INPATIENT ANCILLARY SERVICE COST APPORTIONMENT,INPATIENT ANCILLARY SERVICE COST APPORTIONMENT,INPATIENT ANCILLARY SERVICE COST APPORTIONMENT,INPATIENT ANCILLARY SERVICE COST APPORTIONMENT,INPATIENT ANCILLARY SERVICE COST APPORTIONMENT,INPATIENT ANCILLARY SERVICE COST APPORTIONMENT,INPATIENT ANCILLARY SERVICE COST APPORTIONMENT,INPATIENT ANCILLARY SERVICE COST APPORTIONMENT,INPATIENT ANCILLARY SERVICE COST APPORTIONMENT,APPORTIONMENT OF INPATIENT ROUTINE SERVICE CAPITAL COSTS,APPORTIONMENT OF INPATIENT/OUTPATIENT ANCILLARY SERVICE OTHER PASS THROUGH COSTS,APPORTIONMENT OF INPATIENT/OUTPATIENT ANCILLARY SERVICE OTHER PASS THROUGH COSTS,APPORTIONMENT OF INPATIENT/OUTPATIENT ANCILLARY SERVICE OTHER PASS THROUGH COSTS,APPORTIONMENT OF MEDICAL AND OTHER HEALTH SERVICES,APPORTIONMENT OF MEDICAL AND OTHER HEALTH SERVICES,APPORTIONMENT OF MEDICAL AND OTHER HEALTH SERVICES,APPORTIONMENT OF MEDICAL AND OTHER HEALTH SERVICES,APPORTIONMENT OF MEDICAL AND OTHER HEALTH SERVICES,CALCULATION OF REIMBURSEMENT SETTLEMENT,CALCULATION OF REIMBURSEMENT SETTLEMENT,CALCULATION OF REIMBURSEMENT SETTLEMENT,CALCULATION OF REIMBURSEMENT SETTLEMENT,CALCULATION OF REIMBURSEMENT SETTLEMENT,CALCULATION OF REIMBURSEMENT SETTLEMENT,CALCULATION OF REIMBURSEMENT SETTLEMENT,Total Inpatient Days/Outpatient Visits,NUMBER OF BEDS,NUMBER OF BEDS,BED DAYS AVAILABLE,BED DAYS AVAILABLE,BED DAYS AVAILABLE,BED DAYS AVAILABLE,Medicaid Inpatient Days/Outpatient Visits,Total Inpatient Days/Outpatient Visits,Total Inpatient Days/Outpatient Visits,HOSPITAL WAGE INDEX DATA,HOSPITAL WAGE INDEX DATA,HOSPITAL WAGE INDEX DATA,HOSPITAL WAGE INDEX DATA,HOSPITAL WAGE INDEX DATA,HOSPITAL WAGE INDEX DATA,HOSPITAL WAGE INDEX DATA,HOSPITAL WAGE INDEX DATA,HOSPITAL WAGE INDEX DATA,HOSPITAL WAGE INDEX DATA,HOSPITAL WAGE INDEX DATA,HOSPITAL WAGE INDEX DATA,HOSPITAL WAGE INDEX DATA,HOSPITAL WAGE INDEX DATA,HOSPITAL WAGE INDEX DATA,HOSPITAL WAGE INDEX DATA,HOSPITAL WAGE INDEX DATA,HOSPITAL WAGE INDEX DATA,HOSPITAL WAGE INDEX DATA,HOSPITAL WAGE INDEX DATA,HOSPITAL WAGE INDEX DATA,HOSPITAL WAGE INDEX DATA,HOSPITAL WAGE INDEX DATA,HHA STATISTICAL DATA,HHA STATISTICAL DATA,HHA STATISTICAL DATA,HHA STATISTICAL DATA,HHA STATISTICAL DATA,HHA STATISTICAL DATA,HHA STATISTICAL DATA,HHA STATISTICAL DATA,HHA STATISTICAL DATA,HHA STATISTICAL DATA,HHA STATISTICAL DATA,HHA STATISTICAL DATA,HHA STATISTICAL DATA,HHA STATISTICAL DATA,HHA STATISTICAL DATA,HHA STATISTICAL DATA,HHA STATISTICAL DATA,HHA STATISTICAL DATA,HHA STATISTICAL DATA,HHA STATISTICAL DATA,HHA STATISTICAL DATA,HHA STATISTICAL DATA,HHA STATISTICAL DATA,HHA STATISTICAL DATA,HHA STATISTICAL DATA,HHA STATISTICAL DATA,HHA STATISTICAL DATA,HHA STATISTICAL DATA,HHA STATISTICAL DATA,HHA STATISTICAL DATA,HHA STATISTICAL DATA,HHA STATISTICAL DATA,HHA STATISTICAL DATA,HHA STATISTICAL DATA,ANALYSIS OF CHANGES IN NEW CAPITAL BALANCES,ANALYSIS OF CHANGES IN NEW CAPITAL BALANCES,ANALYSIS OF CHANGES IN NEW CAPITAL BALANCES,ANALYSIS OF CHANGES IN NEW CAPITAL BALANCES,ANALYSIS OF CHANGES IN NEW CAPITAL BALANCES,ANALYSIS OF CHANGES IN NEW CAPITAL BALANCES,ANALYSIS OF CHANGES IN NEW CAPITAL BALANCES,ANALYSIS OF CHANGES IN NEW CAPITAL BALANCES,ANALYSIS OF CHANGES IN NEW CAPITAL BALANCES,ANALYSIS OF CHANGES IN NEW CAPITAL BALANCES,ANALYSIS OF CHANGES IN NEW CAPITAL BALANCES,ANALYSIS OF CHANGES IN NEW CAPITAL BALANCES,ANALYSIS OF CHANGES IN NEW CAPITAL BALANCES,RECONCILIATION OF CAPITAL COST CENTERS,RECONCILIATION OF CAPITAL COST CENTERS,RECONCILIATION OF CAPITAL COST CENTERS,ADJUSTMENTS,ADJUSTMENTS,ADJUSTMENTS,ADJUSTMENTS,ADJUSTMENTS,TRIAL BALANCE OF EXPENSE ACCOUNTS,TRIAL BALANCE OF EXPENSE ACCOUNTS,TRIAL BALANCE OF EXPENSE ACCOUNTS,TRIAL BALANCE OF EXPENSE ACCOUNTS,TRIAL BALANCE OF EXPENSE ACCOUNTS,TRIAL BALANCE OF EXPENSE ACCOUNTS,TRIAL BALANCE OF EXPENSE ACCOUNTS,COST ALLOCATION,COST ALLOCATION,COST ALLOCATION,COST ALLOCATION,COST ALLOCATION,COST ALLOCATION,ALLOCATION OF NEW CAPITAL COSTS,ALLOCATION OF NEW CAPITAL COSTS,ALLOCATION OF NEW CAPITAL COSTS,COMPUTATION OF RATIO OF COST TO CHARGES,COMPUTATION OF RATIO OF COST TO CHARGES,COMPUTATION OF RATIO OF COST TO CHARGES,COMPUTATION OF RATIO OF COST TO CHARGES,COMPUTATION OF RATIO OF COST TO CHARGES,COMPUTATION OF RATIO OF COST TO CHARGES,COMPUTATION OF RATIO OF COST TO CHARGES,COMPUTATION OF RATIO OF COST TO CHARGES,COMPUTATION OF RATIO OF COST TO CHARGES,COMPUTATION OF INPATIENT OPERATING COSTS,COMPUTATION OF INPATIENT OPERATING COSTS,COMPUTATION OF INPATIENT OPERATING COSTS,COMPUTATION OF INPATIENT OPERATING COSTS,COMPUTATION OF INPATIENT OPERATING COSTS,COMPUTATION OF INPATIENT OPERATING COSTS,COMPUTATION OF INPATIENT OPERATING COSTS,COMPUTATION OF INPATIENT OPERATING COSTS,COMPUTATION OF INPATIENT OPERATING COSTS,INPATIENT ANCILLARY SERVICE COST APPORTIONMENT,INPATIENT ANCILLARY SERVICE COST APPORTIONMENT,INPATIENT ANCILLARY SERVICE COST APPORTIONMENT,INPATIENT ANCILLARY SERVICE COST APPORTIONMENT,APPORTIONMENT OF INPATIENT ROUTINE SERVICE CAPITAL COSTS,APPORTIONMENT OF INPATIENT ROUTINE SERVICE CAPITAL COSTS,APPORTIONMENT OF INPATIENT ROUTINE SERVICE CAPITAL COSTS,APPORTIONMENT OF INPATIENT ROUTINE SERVICE CAPITAL COSTS,APPORTIONMENT OF INPATIENT ROUTINE SERVICE CAPITAL COSTS,APPORTIONMENT OF INPATIENT ROUTINE SERVICE CAPITAL COSTS,APPORTIONMENT OF INPATIENT ROUTINE SERVICE OTHER PASS THROUGH COSTS,APPORTIONMENT OF INPATIENT ROUTINE SERVICE OTHER PASS THROUGH COSTS,S-10 DATA,S-10 DATA,S-10 DATA,S-10 DATA,S-10 DATA,S-10 DATA,S-10 DATA,S-10 DATA,S-10 DATA,S-10 DATA,S-10 DATA,,,,Total Inpatient Days/Outpatient Visits,Total Inpatient Days/Outpatient Visits,Total Inpatient Days/Outpatient Visits,Total Inpatient Days/Outpatient Visits,Total Inpatient Days/Outpatient Visits,Total Inpatient Days/Outpatient Visits,NUMBER OF BEDS,NUMBER OF BEDS,NUMBER OF BEDS,NUMBER OF BEDS,BED DAYS AVAILABLE,BED DAYS AVAILABLE,BED DAYS AVAILABLE,Medicare Inpatient Days/Outpatient Visits,Medicare Inpatient Days/Outpatient Visits,Medicare Inpatient Days/Outpatient Visits,Total Inpatient Days/Outpatient Visits,Total Inpatient Days/Outpatient Visits,Total Inpatient Days/Outpatient Visits,ANALYSIS OF CHANGES IN NEW CAPITAL BALANCES,ANALYSIS OF CHANGES IN NEW CAPITAL BALANCES,ANALYSIS OF CHANGES IN NEW CAPITAL BALANCES,RECONCILIATION OF CAPITAL COST CENTERS,RECONCILIATION OF CAPITAL COST CENTERS,ADJUSTMENTS,ADJUSTMENTS,ADJUSTMENTS,ADJUSTMENTS,TRIAL BALANCE OF EXPENSE ACCOUNTS,TRIAL BALANCE OF EXPENSE ACCOUNTS,TRIAL BALANCE OF EXPENSE ACCOUNTS,TRIAL BALANCE OF EXPENSE ACCOUNTS,COST ALLOCATION,COST ALLOCATION,ALLOCATION OF NEW CAPITAL COSTS,COMPUTATION OF RATIO OF COST TO CHARGES,COMPUTATION OF RATIO OF COST TO CHARGES,COMPUTATION OF RATIO OF COST TO CHARGES,COMPUTATION OF INPATIENT OPERATING COSTS,COMPUTATION OF INPATIENT OPERATING COSTS,COMPUTATION OF INPATIENT OPERATING COSTS,COMPUTATION OF INPATIENT OPERATING COSTS,COMPUTATION OF INPATIENT OPERATING COSTS,COMPUTATION OF INPATIENT OPERATING COSTS,COMPUTATION OF INPATIENT OPERATING COSTS,INPATIENT ANCILLARY SERVICE COST APPORTIONMENT,APPORTIONMENT OF INPATIENT ROUTINE SERVICE CAPITAL COSTS,APPORTIONMENT OF INPATIENT ROUTINE SERVICE CAPITAL COSTS,APPORTIONMENT OF INPATIENT ROUTINE SERVICE CAPITAL COSTS,CALCULATION OF REIMBURSEMENT SETTLEMENT,Total Inpatient Days/Outpatient Visits,Total Inpatient Days/Outpatient Visits,Total Inpatient Days/Outpatient Visits,Total Inpatient Days/Outpatient Visits,NUMBER OF BEDS,BED DAYS AVAILABLE,Medicare Inpatient Days/Outpatient Visits,Medicaid Inpatient Days/Outpatient Visits,Medicaid Inpatient Days/Outpatient Visits,Medicaid Inpatient Days/Outpatient Visits,Medicaid Inpatient Days/Outpatient Visits,Total Inpatient Days/Outpatient Visits,HOSPITAL WAGE INDEX DATA,HOSPITAL WAGE INDEX DATA,HOSPITAL WAGE INDEX DATA,HOSPITAL WAGE INDEX DATA,HOSPITAL WAGE INDEX DATA,HOSPITAL WAGE INDEX DATA,HOSPITAL WAGE INDEX DATA,HOSPITAL WAGE INDEX DATA,HOSPITAL WAGE INDEX DATA,HOSPITAL WAGE INDEX DATA,HOSPITAL WAGE INDEX DATA,HOSPITAL WAGE INDEX DATA,HOSPITAL WAGE INDEX DATA,HOSPITAL WAGE INDEX DATA,HOSPITAL WAGE INDEX DATA,HOSPITAL WAGE INDEX DATA,HOSPITAL WAGE INDEX DATA,HOSPITAL WAGE INDEX DATA,COST ALLOCATION,APPORTIONMENT OF INPATIENT/OUTPATIENT ANCILLARY SERVICE OTHER PASS THROUGH COSTS,APPORTIONMENT OF MEDICAL AND OTHER HEALTH SERVICES,APPORTIONMENT OF MEDICAL AND OTHER HEALTH SERVICES,CALCULATION OF REIMBURSEMENT SETTLEMENT,CALCULATION OF REIMBURSEMENT SETTLEMENT,CALCULATION OF REIMBURSEMENT SETTLEMENT,CALCULATION OF REIMBURSEMENT SETTLEMENT,CALCULATION OF REIMBURSEMENT SETTLEMENT,CALCULATION OF REIMBURSEMENT SETTLEMENT,CALCULATION OF REIMBURSEMENT SETTLEMENT,CALCULATION OF REIMBURSEMENT SETTLEMENT,CALCULATION OF REIMBURSEMENT SETTLEMENT,CALCULATION OF REIMBURSEMENT SETTLEMENT,CALCULATION OF REIMBURSEMENT SETTLEMENT,CALCULATION OF REIMBURSEMENT SETTLEMENT,CALCULATION OF REIMBURSEMENT SETTLEMENT,CALCULATION OF REIMBURSEMENT SETTLEMENT,ANALYSIS OF CHANGES IN NEW CAPITAL BALANCES,ANALYSIS OF CHANGES IN NEW CAPITAL BALANCES,ANALYSIS OF CHANGES IN NEW CAPITAL BALANCES,ANALYSIS OF CHANGES IN NEW CAPITAL BALANCES,ANALYSIS OF CHANGES IN NEW CAPITAL BALANCES,ANALYSIS OF CHANGES IN NEW CAPITAL BALANCES,ANALYSIS OF CHANGES IN NEW CAPITAL BALANCES,ADJUSTMENTS,ADJUSTMENTS,ALLOCATION OF NEW CAPITAL COSTS,Total Inpatient Days/Outpatient Visits,Total Inpatient Days/Outpatient Visits,HOSPITAL WAGE INDEX DATA,HOSPITAL WAGE INDEX DATA,HOSPITAL WAGE INDEX DATA,HOSPITAL WAGE INDEX DATA,HOSPITAL WAGE INDEX DATA,HOSPITAL WAGE INDEX DATA,HOSPITAL WAGE INDEX DATA,HOSPITAL WAGE INDEX DATA,HOSPITAL WAGE INDEX DATA,HOSPITAL WAGE INDEX DATA,HOSPITAL WAGE INDEX DATA,HOSPITAL WAGE INDEX DATA,HOSPITAL WAGE INDEX DATA,HOSPITAL WAGE INDEX DATA,HOSPITAL WAGE INDEX DATA,HOSPITAL WAGE INDEX DATA,HOSPITAL WAGE INDEX DATA,HOSPITAL WAGE INDEX DATA,HOSPITAL WAGE INDEX DATA,HOSPITAL WAGE INDEX DATA,HOSPITAL WAGE INDEX DATA,HOSPITAL WAGE INDEX DATA,HOSPITAL WAGE INDEX DATA,HOSPITAL WAGE INDEX DATA,HOSPITAL WAGE INDEX DATA,COST ALLOCATION,COST ALLOCATION,ALLOCATION OF NEW CAPITAL COSTS,CALCULATION OF REIMBURSEMENT SETTLEMENT,CALCULATION OF REIMBURSEMENT SETTLEMENT,Total Inpatient Days/Outpatient Visits,Total Inpatient Days/Outpatient Visits,ANALYSIS OF CHANGES IN NEW CAPITAL BALANCES,ANALYSIS OF CHANGES IN NEW CAPITAL BALANCES,COST ALLOCATION,COST ALLOCATION,ALLOCATION OF NEW CAPITAL COSTS,COMPUTATION OF RATIO OF COST TO CHARGES,COMPUTATION OF RATIO OF COST TO CHARGES,COMPUTATION OF RATIO OF COST TO CHARGES,APPORTIONMENT OF INPATIENT ROUTINE SERVICE CAPITAL COSTS,S-10 DATA,S-10 DATA,S-10 DATA,S-10 DATA,S-10 DATA,S-10 DATA,Medicaid Inpatient Days/Outpatient Visits,Total Inpatient Days/Outpatient Visits,Total Inpatient Days/Outpatient Visits,HOSPITAL WAGE INDEX DATA,HOSPITAL WAGE INDEX DATA,HOSPITAL WAGE INDEX DATA,HOSPITAL WAGE INDEX DATA,HOSPITAL WAGE INDEX DATA,HOSPITAL WAGE INDEX DATA,HOSPITAL WAGE INDEX DATA,HOSPITAL WAGE INDEX DATA,HOSPITAL WAGE INDEX DATA,HOSPITAL WAGE INDEX DATA,HOSPITAL WAGE INDEX DATA,HOSPITAL WAGE INDEX DATA,HOSPITAL WAGE INDEX DATA,ADJUSTMENTS,RECONCILIATION OF CAPITAL COST CENTERS,ADJUSTMENTS,TRIAL BALANCE OF EXPENSE ACCOUNTS,TRIAL BALANCE OF EXPENSE ACCOUNTS,COST ALLOCATION,COST ALLOCATION,ALLOCATION OF NEW CAPITAL COSTS,COMPUTATION OF RATIO OF COST TO CHARGES,COMPUTATION OF RATIO OF COST TO CHARGES,RECONCILIATION OF CAPITAL COST CENTERS,ADJUSTMENTS,ADJUSTMENTS,ADJUSTMENTS,COMPUTATION OF RATIO OF COST TO CHARGES,APPORTIONMENT OF MEDICAL AND OTHER HEALTH SERVICES,APPORTIONMENT OF MEDICAL AND OTHER HEALTH SERVICES,APPORTIONMENT OF MEDICAL AND OTHER HEALTH SERVICES,APPORTIONMENT OF MEDICAL AND OTHER HEALTH SERVICES,CALCULATION OF REIMBURSEMENT SETTLEMENT,CALCULATION OF REIMBURSEMENT SETTLEMENT,CALCULATION OF REIMBURSEMENT SETTLEMENT,CALCULATION OF REIMBURSEMENT SETTLEMENT,CALCULATION OF REIMBURSEMENT SETTLEMENT,CALCULATION OF REIMBURSEMENT SETTLEMENT,CALCULATION OF REIMBURSEMENT SETTLEMENT,CALCULATION OF REIMBURSEMENT SETTLEMENT,Medicaid Inpatient Days/Outpatient Visits,HOSPITAL WAGE INDEX DATA,HOSPITAL WAGE INDEX DATA,HOSPITAL WAGE INDEX DATA,HOSPITAL WAGE INDEX DATA,HOSPITAL WAGE INDEX DATA,HOSPITAL WAGE INDEX DATA,HOSPITAL WAGE INDEX DATA,HOSPITAL WAGE INDEX DATA,HOSPITAL WAGE INDEX DATA,HOSPITAL WAGE INDEX DATA,HOSPITAL WAGE INDEX DATA,HOSPITAL WAGE INDEX DATA,HOSPITAL WAGE INDEX DATA,HOSPITAL WAGE INDEX DATA,HOSPITAL WAGE INDEX DATA,HOSPITAL WAGE INDEX DATA,HOSPITAL WAGE INDEX DATA,HOSPITAL WAGE INDEX DATA,HOSPITAL WAGE INDEX DATA,HOSPITAL WAGE INDEX DATA,HOSPITAL WAGE INDEX DATA,HOSPITAL WAGE INDEX DATA,HOSPITAL WAGE INDEX DATA,HOSPITAL WAGE INDEX DATA,HOSPITAL WAGE INDEX DATA,HOSPITAL WAGE INDEX DATA,HOSPITAL WAGE INDEX DATA,HOSPITAL WAGE INDEX DATA,HOSPITAL WAGE INDEX DATA,HOSPITAL WAGE INDEX DATA,HOSPITAL WAGE INDEX DATA,HOSPITAL WAGE INDEX DATA,HOSPITAL WAGE INDEX DATA,HOSPITAL WAGE INDEX DATA,HOSPITAL WAGE INDEX DATA,HOSPITAL WAGE INDEX DATA,HOSPITAL WAGE INDEX DATA,HOSPITAL WAGE INDEX DATA,HOSPITAL WAGE INDEX DATA,HOSPITAL WAGE INDEX DATA,ANALYSIS OF CHANGES IN NEW CAPITAL BALANCES,ADJUSTMENTS,TRIAL BALANCE OF EXPENSE ACCOUNTS,TRIAL BALANCE OF EXPENSE ACCOUNTS,APPORTIONMENT OF INPATIENT/OUTPATIENT ANCILLARY SERVICE OTHER PASS THROUGH COSTS,APPORTIONMENT OF INPATIENT/OUTPATIENT ANCILLARY SERVICE OTHER PASS THROUGH COSTS,APPORTIONMENT OF INPATIENT/OUTPATIENT ANCILLARY SERVICE OTHER PASS THROUGH COSTS,APPORTIONMENT OF INPATIENT/OUTPATIENT ANCILLARY SERVICE OTHER PASS THROUGH COSTS,APPORTIONMENT OF INPATIENT/OUTPATIENT ANCILLARY SERVICE OTHER PASS THROUGH COSTS,APPORTIONMENT OF MEDICAL AND OTHER HEALTH SERVICES,APPORTIONMENT OF MEDICAL AND OTHER HEALTH SERVICES,APPORTIONMENT OF MEDICAL AND OTHER HEALTH SERVICES,APPORTIONMENT OF MEDICAL AND OTHER HEALTH SERVICES,CALCULATION OF REIMBURSEMENT SETTLEMENT,CALCULATION OF REIMBURSEMENT SETTLEMENT,CALCULATION OF REIMBURSEMENT SETTLEMENT,S-10 DATA,S-10 DATA,S-10 DATA,,,Medicare Inpatient Days/Outpatient Visits,HOSPITAL WAGE INDEX DATA,HOSPITAL WAGE INDEX DATA,HOSPITAL WAGE INDEX DATA,HOSPITAL WAGE INDEX DATA,HOSPITAL WAGE INDEX DATA,HOSPITAL WAGE INDEX DATA,HOSPITAL WAGE INDEX DATA,HOSPITAL WAGE INDEX DATA,HOSPITAL WAGE INDEX DATA,HOSPITAL WAGE INDEX DATA,HOSPITAL WAGE INDEX DATA,HOSPITAL WAGE INDEX DATA,HOSPITAL WAGE INDEX DATA,HOSPITAL WAGE INDEX DATA,HOSPITAL WAGE INDEX DATA,HOSPITAL WAGE INDEX DATA,HOSPITAL WAGE INDEX DATA,HOSPITAL WAGE INDEX DATA,ANALYSIS OF CHANGES IN NEW CAPITAL BALANCES,TRIAL BALANCE OF EXPENSE ACCOUNTS,CALCULATION OF REIMBURSEMENT SETTLEMENT,ANALYSIS OF CHANGES IN NEW CAPITAL BALANCES,ANALYSIS OF CHANGES IN NEW CAPITAL BALANCES,ANALYSIS OF CHANGES IN NEW CAPITAL BALANCES,ANALYSIS OF CHANGES IN NEW CAPITAL BALANCES,ANALYSIS OF CHANGES IN NEW CAPITAL BALANCES,ADJUSTMENTS,S-10 DATA,S-10 DATA,S-10 DATA,,,,HOSPITAL WAGE INDEX DATA,HOSPITAL WAGE INDEX DATA,HOSPITAL WAGE INDEX DATA,HOSPITAL WAGE INDEX DATA,HOSPITAL WAGE INDEX DATA,HOSPITAL WAGE INDEX DATA,ANALYSIS OF CHANGES IN NEW CAPITAL BALANCES,TRIAL BALANCE OF EXPENSE ACCOUNTS,TRIAL BALANCE OF EXPENSE ACCOUNTS,TRIAL BALANCE OF EXPENSE ACCOUNTS,TRIAL BALANCE OF EXPENSE ACCOUNTS,TRIAL BALANCE OF EXPENSE ACCOUNTS,TRIAL BALANCE OF EXPENSE ACCOUNTS,COST ALLOCATION,COST ALLOCATION,ALLOCATION OF NEW CAPITAL COSTS,COMPUTATION OF RATIO OF COST TO CHARGES,COMPUTATION OF RATIO OF COST TO CHARGES,COMPUTATION OF INPATIENT OPERATING COSTS,COMPUTATION OF INPATIENT OPERATING COSTS,COMPUTATION OF INPATIENT OPERATING COSTS,COMPUTATION OF INPATIENT OPERATING COSTS,COMPUTATION OF INPATIENT OPERATING COSTS,COMPUTATION OF INPATIENT OPERATING COSTS,COMPUTATION OF INPATIENT OPERATING COSTS,COMPUTATION OF INPATIENT OPERATING COSTS,COMPUTATION OF INPATIENT OPERATING COSTS,COMPUTATION OF INPATIENT OPERATING COSTS,COMPUTATION OF INPATIENT OPERATING COSTS,INPATIENT ANCILLARY SERVICE COST APPORTIONMENT,INPATIENT ANCILLARY SERVICE COST APPORTIONMENT,INPATIENT ANCILLARY SERVICE COST APPORTIONMENT,INPATIENT ANCILLARY SERVICE COST APPORTIONMENT,INPATIENT ANCILLARY SERVICE COST APPORTIONMENT,INPATIENT ANCILLARY SERVICE COST APPORTIONMENT,INPATIENT ANCILLARY SERVICE COST APPORTIONMENT,INPATIENT ANCILLARY SERVICE COST APPORTIONMENT,INPATIENT ANCILLARY SERVICE COST APPORTIONMENT,APPORTIONMENT OF INPATIENT ROUTINE SERVICE CAPITAL COSTS,APPORTIONMENT OF INPATIENT ROUTINE SERVICE CAPITAL COSTS,APPORTIONMENT OF INPATIENT ROUTINE SERVICE CAPITAL COSTS,Total Inpatient Days/Outpatient Visits,Total Inpatient Days/Outpatient Visits,Total Inpatient Days/Outpatient Visits,Total Inpatient Days/Outpatient Visits,NUMBER OF BEDS,BED DAYS AVAILABLE,Medicare Inpatient Days/Outpatient Visits,Medicaid Inpatient Days/Outpatient Visits,Total Inpatient Days/Outpatient Visits,HOSPITAL WAGE INDEX DATA,HOSPITAL WAGE INDEX DATA,HOSPITAL WAGE INDEX DATA,HOSPITAL WAGE INDEX DATA,ADJUSTMENTS,TRIAL BALANCE OF EXPENSE ACCOUNTS,TRIAL BALANCE OF EXPENSE ACCOUNTS,COST ALLOCATION,COST ALLOCATION,COST ALLOCATION,COST ALLOCATION,ALLOCATION OF NEW CAPITAL COSTS,ALLOCATION OF NEW CAPITAL COSTS,COMPUTATION OF RATIO OF COST TO CHARGES,COMPUTATION OF RATIO OF COST TO CHARGES,COMPUTATION OF RATIO OF COST TO CHARGES,COMPUTATION OF RATIO OF COST TO CHARGES,COMPUTATION OF INPATIENT OPERATING COSTS,COMPUTATION OF INPATIENT OPERATING COSTS,COMPUTATION OF INPATIENT OPERATING COSTS,INPATIENT ANCILLARY SERVICE COST APPORTIONMENT,INPATIENT ANCILLARY SERVICE COST APPORTIONMENT,CALCULATION OF REIMBURSEMENT SETTLEMENT,CALCULATION OF REIMBURSEMENT SETTLEMENT,,Total Inpatient Days/Outpatient Visits,NUMBER OF BEDS,BED DAYS AVAILABLE,Medicare Inpatient Days/Outpatient Visits,Medicaid Inpatient Days/Outpatient Visits,Total Inpatient Days/Outpatient Visits,HOSPITAL WAGE INDEX DATA,HOSPITAL WAGE INDEX DATA,HOSPITAL WAGE INDEX DATA,HOSPITAL WAGE INDEX DATA,HOSPITAL WAGE INDEX DATA,HHA STATISTICAL DATA,HHA STATISTICAL DATA,HHA STATISTICAL DATA,HHA STATISTICAL DATA,HHA STATISTICAL DATA,HHA STATISTICAL DATA,HHA STATISTICAL DATA,HHA STATISTICAL DATA,HHA STATISTICAL DATA,HHA STATISTICAL DATA,HHA STATISTICAL DATA,HHA STATISTICAL DATA,HHA STATISTICAL DATA,HHA STATISTICAL DATA,HHA STATISTICAL DATA,HHA STATISTICAL DATA,HHA STATISTICAL DATA,HHA STATISTICAL DATA,HHA STATISTICAL DATA,HHA STATISTICAL DATA,TRIAL BALANCE OF EXPENSE ACCOUNTS,TRIAL BALANCE OF EXPENSE ACCOUNTS,TRIAL BALANCE OF EXPENSE ACCOUNTS,TRIAL BALANCE OF EXPENSE ACCOUNTS,TRIAL BALANCE OF EXPENSE ACCOUNTS,COST ALLOCATION,COST ALLOCATION,COST ALLOCATION,COST ALLOCATION,COST ALLOCATION,ALLOCATION OF NEW CAPITAL COSTS,ALLOCATION OF NEW CAPITAL COSTS,COMPUTATION OF RATIO OF COST TO CHARGES,COMPUTATION OF RATIO OF COST TO CHARGES,COMPUTATION OF RATIO OF COST TO CHARGES,,,APPORTIONMENT OF INPATIENT ROUTINE SERVICE OTHER PASS THROUGH COSTS,APPORTIONMENT OF INPATIENT ROUTINE SERVICE OTHER PASS THROUGH COSTS,APPORTIONMENT OF INPATIENT ROUTINE SERVICE OTHER PASS THROUGH COSTS,APPORTIONMENT OF INPATIENT ROUTINE SERVICE OTHER PASS THROUGH COSTS,CALCULATION OF REIMBURSEMENT SETTLEMENT,Total Inpatient Days/Outpatient Visits,Medicaid Inpatient Days/Outpatient Visits,Total Inpatient Days/Outpatient Visits,HOSPITAL WAGE INDEX DATA,HOSPITAL WAGE INDEX DATA,HOSPITAL WAGE INDEX DATA,HOSPITAL WAGE INDEX DATA,ALLOCATION OF NEW CAPITAL COSTS,COMPUTATION OF INPATIENT OPERATING COSTS,CALCULATION OF REIMBURSEMENT SETTLEMENT,CALCULATION OF REIMBURSEMENT SETTLEMENT,Medicare Inpatient Days/Outpatient Visits,Total Inpatient Days/Outpatient Visits,Total Inpatient Days/Outpatient Visits,HOSPITAL WAGE INDEX DATA,HOSPITAL WAGE INDEX DATA,HHA STATISTICAL DATA,ADJUSTMENTS,S-10 DATA,S-10 DATA,S-10 DATA,S-10 DATA,ADJUSTMENTS,ADJUSTMENTS,TRIAL BALANCE OF EXPENSE ACCOUNTS,HOSPITAL WAGE INDEX DATA,HOSPITAL WAGE INDEX DATA,HOSPITAL WAGE INDEX DATA,HOSPITAL WAGE INDEX DATA,ADJUSTMENTS,TRIAL BALANCE OF EXPENSE ACCOUNTS,Total Inpatient Days/Outpatient Visits,NUMBER OF BEDS,BED DAYS AVAILABLE,BED DAYS AVAILABLE,BED DAYS AVAILABLE,BED DAYS AVAILABLE,Medicaid Inpatient Days/Outpatient Visits,Total Inpatient Days/Outpatient Visits,ANALYSIS OF CHANGES IN NEW CAPITAL BALANCES,ADJUSTMENTS,TRIAL BALANCE OF EXPENSE ACCOUNTS,S-10 DATA,HOSPITAL WAGE INDEX DATA,APPORTIONMENT OF INPATIENT/OUTPATIENT ANCILLARY SERVICE OTHER PASS THROUGH COSTS,Medicaid Inpatient Days/Outpatient Visits,HOSPITAL WAGE INDEX DATA,HOSPITAL WAGE INDEX DATA,HOSPITAL WAGE INDEX DATA,HOSPITAL WAGE INDEX DATA,HOSPITAL WAGE INDEX DATA,HOSPITAL WAGE INDEX DATA,ADJUSTMENTS,Medicare Inpatient Days/Outpatient Visits,Medicaid Inpatient Days/Outpatient Visits,TRIAL BALANCE OF EXPENSE ACCOUNTS,Medicare Inpatient Days/Outpatient Visits,Medicaid Inpatient Days/Outpatient Visits,Total Inpatient Days/Outpatient Visits,S-10 DATA,COMPUTATION OF RATIO OF COST TO CHARGES,HHA STATISTICAL DATA,HHA STATISTICAL DATA,HHA STATISTICAL DATA,HHA STATISTICAL DATA,HHA STATISTICAL DATA,HOSPITAL WAGE INDEX DATA,HOSPITAL WAGE INDEX DATA,ANALYSIS OF CHANGES IN NEW CAPITAL BALANCES,APPORTIONMENT OF MEDICAL AND OTHER HEALTH SERVICES,APPORTIONMENT OF MEDICAL AND OTHER HEALTH SERVICES,ANALYSIS OF CHANGES IN NEW CAPITAL BALANCES,ANALYSIS OF CHANGES IN NEW CAPITAL BALANCES,ANALYSIS OF CHANGES IN NEW CAPITAL BALANCES,ANALYSIS OF CHANGES IN NEW CAPITAL BALANCES,ANALYSIS OF CHANGES IN NEW CAPITAL BALANCES,ANALYSIS OF CHANGES IN NEW CAPITAL BALANCES,ANALYSIS OF CHANGES IN NEW CAPITAL BALANCES,TRIAL BALANCE OF EXPENSE ACCOUNTS,TRIAL BALANCE OF EXPENSE ACCOUNTS,TRIAL BALANCE OF EXPENSE ACCOUNTS,TRIAL BALANCE OF EXPENSE ACCOUNTS,TRIAL BALANCE OF EXPENSE ACCOUNTS,TRIAL BALANCE OF EXPENSE ACCOUNTS,TRIAL BALANCE OF EXPENSE ACCOUNTS,COST ALLOCATION,COST ALLOCATION,COST ALLOCATION,COST ALLOCATION,COST ALLOCATION,ALLOCATION OF NEW CAPITAL COSTS,ALLOCATION OF NEW CAPITAL COSTS,ALLOCATION OF NEW CAPITAL COSTS,COMPUTATION OF RATIO OF COST TO CHARGES,COMPUTATION OF RATIO OF COST TO CHARGES,COMPUTATION OF RATIO OF COST TO CHARGES,COMPUTATION OF RATIO OF COST TO CHARGES,COMPUTATION OF RATIO OF COST TO CHARGES,COMPUTATION OF RATIO OF COST TO CHARGES,COMPUTATION OF RATIO OF COST TO CHARGES,COMPUTATION OF RATIO OF COST TO CHARGES,COMPUTATION OF RATIO OF COST TO CHARGES,COMPUTATION OF RATIO OF COST TO CHARGES,,,HOSPITAL WAGE INDEX DATA,HOSPITAL WAGE INDEX DATA,HOSPITAL WAGE INDEX DATA,HOSPITAL WAGE INDEX DATA,HOSPITAL WAGE INDEX DATA,HOSPITAL WAGE INDEX DATA,HOSPITAL WAGE INDEX DATA,HOSPITAL WAGE INDEX DATA,HOSPITAL WAGE INDEX DATA,HOSPITAL WAGE INDEX DATA,HOSPITAL WAGE INDEX DATA,HOSPITAL WAGE INDEX DATA,HOSPITAL WAGE INDEX DATA,RENAL STATISTICAL DATA,RENAL STATISTICAL DATA,RENAL STATISTICAL DATA,RENAL STATISTICAL DATA,RENAL STATISTICAL DATA,RENAL STATISTICAL DATA,RENAL STATISTICAL DATA,RENAL STATISTICAL DATA,RENAL STATISTICAL DATA,RENAL STATISTICAL DATA,TRIAL BALANCE OF EXPENSE ACCOUNTS,RENAL STATISTICAL DATA,RENAL STATISTICAL DATA,RENAL STATISTICAL DATA,HHA STATISTICAL DATA,TRIAL BALANCE OF EXPENSE ACCOUNTS,TRIAL BALANCE OF EXPENSE ACCOUNTS,TRIAL BALANCE OF EXPENSE ACCOUNTS,COST ALLOCATION,COST ALLOCATION,ALLOCATION OF NEW CAPITAL COSTS,COMPUTATION OF RATIO OF COST TO CHARGES,COMPUTATION OF RATIO OF COST TO CHARGES,Total Inpatient Days/Outpatient Visits,Total Inpatient Days/Outpatient Visits,NUMBER OF BEDS,BED DAYS AVAILABLE,Total Inpatient Days/Outpatient Visits,COST ALLOCATION,Total Inpatient Days/Outpatient Visits,TRIAL BALANCE OF EXPENSE ACCOUNTS,COST ALLOCATION,TRIAL BALANCE OF EXPENSE ACCOUNTS,TRIAL BALANCE OF EXPENSE ACCOUNTS,TRIAL BALANCE OF EXPENSE ACCOUNTS,COST ALLOCATION,COST ALLOCATION,ALLOCATION OF NEW CAPITAL COSTS,COMPUTATION OF RATIO OF COST TO CHARGES,COMPUTATION OF RATIO OF COST TO CHARGES,APPORTIONMENT OF INPATIENT ROUTINE SERVICE CAPITAL COSTS,Total Inpatient Days/Outpatient Visits,NUMBER OF BEDS,BED DAYS AVAILABLE,Total Inpatient Days/Outpatient Visits,CALCULATION OF REIMBURSEMENT SETTLEMENT,ADJUSTMENTS,Total Inpatient Days/Outpatient Visits,Total Inpatient Days/Outpatient Visits,BED DAYS AVAILABLE,BED DAYS AVAILABLE,BED DAYS AVAILABLE,ADJUSTMENTS,TRIAL BALANCE OF EXPENSE ACCOUNTS,COST ALLOCATION,COST ALLOCATION,ALLOCATION OF NEW CAPITAL COSTS,COMPUTATION OF RATIO OF COST TO CHARGES,COMPUTATION OF RATIO OF COST TO CHARGES,COMPUTATION OF RATIO OF COST TO CHARGES,APPORTIONMENT OF MEDICAL AND OTHER HEALTH SERVICES,APPORTIONMENT OF MEDICAL AND OTHER HEALTH SERVICES,CALCULATION OF REIMBURSEMENT SETTLEMENT,CALCULATION OF REIMBURSEMENT SETTLEMENT,S-10 DATA,RENAL STATISTICAL DATA,RENAL STATISTICAL DATA,RENAL STATISTICAL DATA,RENAL STATISTICAL DATA,RENAL STATISTICAL DATA,RENAL STATISTICAL DATA,RENAL STATISTICAL DATA,RENAL STATISTICAL DATA,RENAL STATISTICAL DATA,HOSPITAL WAGE INDEX DATA,HOSPITAL WAGE INDEX DATA,TRIAL BALANCE OF EXPENSE ACCOUNTS,TRIAL BALANCE OF EXPENSE ACCOUNTS,COST ALLOCATION,COST ALLOCATION,COST ALLOCATION,COST ALLOCATION,COST ALLOCATION,APPORTIONMENT OF INPATIENT ROUTINE SERVICE OTHER PASS THROUGH COSTS,APPORTIONMENT OF INPATIENT ROUTINE SERVICE OTHER PASS THROUGH COSTS,APPORTIONMENT OF INPATIENT/OUTPATIENT ANCILLARY SERVICE OTHER PASS THROUGH COSTS,APPORTIONMENT OF INPATIENT/OUTPATIENT ANCILLARY SERVICE OTHER PASS THROUGH COSTS,APPORTIONMENT OF INPATIENT/OUTPATIENT ANCILLARY SERVICE OTHER PASS THROUGH COSTS,APPORTIONMENT OF INPATIENT/OUTPATIENT ANCILLARY SERVICE OTHER PASS THROUGH COSTS,APPORTIONMENT OF INPATIENT/OUTPATIENT ANCILLARY SERVICE OTHER PASS THROUGH COSTS,APPORTIONMENT OF INPATIENT/OUTPATIENT ANCILLARY SERVICE OTHER PASS THROUGH COSTS,HOSPITAL WAGE INDEX DATA,TRIAL BALANCE OF EXPENSE ACCOUNTS,COMPUTATION OF INPATIENT OPERATING COSTS,COMPUTATION OF INPATIENT OPERATING COSTS,COMPUTATION OF INPATIENT OPERATING COSTS,COMPUTATION OF INPATIENT OPERATING COSTS,COMPUTATION OF INPATIENT OPERATING COSTS,COMPUTATION OF INPATIENT OPERATING COSTS,HOSPITAL WAGE INDEX DATA,HOSPITAL WAGE INDEX DATA,HOSPITAL WAGE INDEX DATA,HOSPITAL WAGE INDEX DATA,Total Inpatient Days/Outpatient Visits,INPATIENT ANCILLARY SERVICE COST APPORTIONMENT,APPORTIONMENT OF INPATIENT/OUTPATIENT ANCILLARY SERVICE OTHER PASS THROUGH COSTS,APPORTIONMENT OF INPATIENT/OUTPATIENT ANCILLARY SERVICE OTHER PASS THROUGH COSTS,APPORTIONMENT OF INPATIENT/OUTPATIENT ANCILLARY SERVICE OTHER PASS THROUGH COSTS,RENAL STATISTICAL DATA,RENAL STATISTICAL DATA,RENAL STATISTICAL DATA,RENAL STATISTICAL DATA,APPORTIONMENT OF INPATIENT ROUTINE SERVICE OTHER PASS THROUGH COSTS,APPORTIONMENT OF INPATIENT/OUTPATIENT ANCILLARY SERVICE OTHER PASS THROUGH COSTS,APPORTIONMENT OF INPATIENT/OUTPATIENT ANCILLARY SERVICE OTHER PASS THROUGH COSTS,APPORTIONMENT OF INPATIENT/OUTPATIENT ANCILLARY SERVICE OTHER PASS THROUGH COSTS,APPORTIONMENT OF INPATIENT/OUTPATIENT ANCILLARY SERVICE OTHER PASS THROUGH COSTS,APPORTIONMENT OF INPATIENT/OUTPATIENT ANCILLARY SERVICE OTHER PASS THROUGH COSTS,APPORTIONMENT OF INPATIENT/OUTPATIENT ANCILLARY SERVICE OTHER PASS THROUGH COSTS,ADJUSTMENTS,,APPORTIONMENT OF INPATIENT/OUTPATIENT ANCILLARY SERVICE OTHER PASS THROUGH COSTS,ADJUSTMENTS,ANALYSIS OF CHANGES IN NEW CAPITAL BALANCES,ADJUSTMENTS,ANALYSIS OF CHANGES IN NEW CAPITAL BALANCES,TRIAL BALANCE OF EXPENSE ACCOUNTS,TRIAL BALANCE OF EXPENSE ACCOUNTS,TRIAL BALANCE OF EXPENSE ACCOUNTS,COST ALLOCATION,COST ALLOCATION,ALLOCATION OF NEW CAPITAL COSTS,COMPUTATION OF RATIO OF COST TO CHARGES,COMPUTATION OF RATIO OF COST TO CHARGES,ADJUSTMENTS,HOSPITAL WAGE INDEX DATA,INPATIENT ANCILLARY SERVICE COST APPORTIONMENT,TRIAL BALANCE OF EXPENSE ACCOUNTS,TRIAL BALANCE OF EXPENSE ACCOUNTS,TRIAL BALANCE OF EXPENSE ACCOUNTS,TRIAL BALANCE OF EXPENSE ACCOUNTS,COST ALLOCATION,COST ALLOCATION,COST ALLOCATION,ALLOCATION OF NEW CAPITAL COSTS,COMPUTATION OF RATIO OF COST TO CHARGES,COMPUTATION OF RATIO OF COST TO CHARGES,INPATIENT ANCILLARY SERVICE COST APPORTIONMENT,INPATIENT ANCILLARY SERVICE COST APPORTIONMENT,,APPORTIONMENT OF INPATIENT/OUTPATIENT ANCILLARY SERVICE OTHER PASS THROUGH COSTS,APPORTIONMENT OF INPATIENT/OUTPATIENT ANCILLARY SERVICE OTHER PASS THROUGH COSTS,APPORTIONMENT OF INPATIENT/OUTPATIENT ANCILLARY SERVICE OTHER PASS THROUGH COSTS,APPORTIONMENT OF INPATIENT/OUTPATIENT ANCILLARY SERVICE OTHER PASS THROUGH COSTS,APPORTIONMENT OF INPATIENT/OUTPATIENT ANCILLARY SERVICE OTHER PASS THROUGH COSTS,RENAL STATISTICAL DATA,COST ALLOCATION,HOSPITAL WAGE INDEX DATA,HOSPITAL WAGE INDEX DATA,HOSPITAL WAGE INDEX DATA,HOSPITAL WAGE INDEX DATA,COMPUTATION OF RATIO OF COST TO CHARGES,HOSPITAL WAGE INDEX DATA,HOSPITAL WAGE INDEX DATA,BED DAYS AVAILABLE,TRIAL BALANCE OF EXPENSE ACCOUNTS,RENAL STATISTICAL DATA,COST ALLOCATION,COST ALLOCATION,COMPUTATION OF RATIO OF COST TO CHARGES,COMPUTATION OF RATIO OF COST TO CHARGES,COMPUTATION OF RATIO OF COST TO CHARGES,INPATIENT ANCILLARY SERVICE COST APPORTIONMENT,INPATIENT ANCILLARY SERVICE COST APPORTIONMENT,RENAL STATISTICAL DATA,APPORTIONMENT OF MEDICAL AND OTHER HEALTH SERVICES,HOSPITAL WAGE INDEX DATA,HOSPITAL WAGE INDEX DATA,HOSPITAL WAGE INDEX DATA,HOSPITAL WAGE INDEX DATA,CALCULATION OF REIMBURSEMENT SETTLEMENT,RENAL STATISTICAL DATA,RENAL STATISTICAL DATA,COST ALLOCATION,APPORTIONMENT OF INPATIENT/OUTPATIENT ANCILLARY SERVICE OTHER PASS THROUGH COSTS,COMPUTATION OF INPATIENT OPERATING COSTS,APPORTIONMENT OF INPATIENT/OUTPATIENT ANCILLARY SERVICE OTHER PASS THROUGH COSTS,ANALYSIS OF CHANGES IN NEW CAPITAL BALANCES,INPATIENT ANCILLARY SERVICE COST APPORTIONMENT,Total Inpatient Days/Outpatient Visits,Total Inpatient Days/Outpatient Visits,Medicaid Inpatient Days/Outpatient Visits,TRIAL BALANCE OF EXPENSE ACCOUNTS,TRIAL BALANCE OF EXPENSE ACCOUNTS,COST ALLOCATION,COST ALLOCATION,ALLOCATION OF NEW CAPITAL COSTS,COMPUTATION OF RATIO OF COST TO CHARGES,COST ALLOCATION,COST ALLOCATION,COST ALLOCATION,COST ALLOCATION,HOSPITAL WAGE INDEX DATA,HOSPITAL WAGE INDEX DATA,HOSPITAL WAGE INDEX DATA,TRIAL BALANCE OF EXPENSE ACCOUNTS,TRIAL BALANCE OF EXPENSE ACCOUNTS,COST ALLOCATION,COST ALLOCATION,COST ALLOCATION,COST ALLOCATION,COMPUTATION OF RATIO OF COST TO CHARGES,Total Inpatient Days/Outpatient Visits,BED DAYS AVAILABLE,HOSPITAL WAGE INDEX DATA,HOSPITAL WAGE INDEX DATA,HOSPITAL WAGE INDEX DATA,INPATIENT ANCILLARY SERVICE COST APPORTIONMENT,INPATIENT ANCILLARY SERVICE COST APPORTIONMENT,APPORTIONMENT OF INPATIENT/OUTPATIENT ANCILLARY SERVICE OTHER PASS THROUGH COSTS,Total Inpatient Days/Outpatient Visits,CALCULATION OF REIMBURSEMENT SETTLEMENT,HOSPITAL WAGE INDEX DATA,HHA STATISTICAL DATA,HHA STATISTICAL DATA,HHA STATISTICAL DATA,HHA STATISTICAL DATA,HHA STATISTICAL DATA,HHA STATISTICAL DATA,HHA STATISTICAL DATA,HHA STATISTICAL DATA,HHA STATISTICAL DATA,HHA STATISTICAL DATA,HHA STATISTICAL DATA,ANALYSIS OF CHANGES IN NEW CAPITAL BALANCES,COST ALLOCATION,COST ALLOCATION,Total Inpatient Days/Outpatient Visits,CALCULATION OF REIMBURSEMENT SETTLEMENT,INPATIENT ANCILLARY SERVICE COST APPORTIONMENT,ADJUSTMENTS,TRIAL BALANCE OF EXPENSE ACCOUNTS,COMPUTATION OF INPATIENT OPERATING COSTS,TRIAL BALANCE OF EXPENSE ACCOUNTS,TRIAL BALANCE OF EXPENSE ACCOUNTS,COST ALLOCATION,COST ALLOCATION,ALLOCATION OF NEW CAPITAL COSTS,COMPUTATION OF RATIO OF COST TO CHARGES,COMPUTATION OF RATIO OF COST TO CHARGES,Total Inpatient Days/Outpatient Visits,NUMBER OF BEDS,BED DAYS AVAILABLE,Total Inpatient Days/Outpatient Visits,COST ALLOCATION,COST ALLOCATION,COST ALLOCATION,COST ALLOCATION,Total Inpatient Days/Outpatient Visits,APPORTIONMENT OF INPATIENT/OUTPATIENT ANCILLARY SERVICE OTHER PASS THROUGH COSTS,,,,RENAL STATISTICAL DATA,RENAL STATISTICAL DATA,RENAL STATISTICAL DATA,RENAL STATISTICAL DATA,RENAL STATISTICAL DATA,RENAL STATISTICAL DATA,ANALYSIS OF CHANGES IN NEW CAPITAL BALANCES,COMPUTATION OF RATIO OF COST TO CHARGES,Medicaid Inpatient Days/Outpatient Visits,BED DAYS AVAILABLE,HHA STATISTICAL DATA,HHA STATISTICAL DATA,HHA STATISTICAL DATA,HHA STATISTICAL DATA,Total Inpatient Days/Outpatient Visits,TRIAL BALANCE OF EXPENSE ACCOUNTS,APPORTIONMENT OF INPATIENT ROUTINE SERVICE OTHER PASS THROUGH COSTS,COST ALLOCATION,COST ALLOCATION,COST ALLOCATION,APPORTIONMENT OF INPATIENT/OUTPATIENT ANCILLARY SERVICE OTHER PASS THROUGH COSTS,TRIAL BALANCE OF EXPENSE ACCOUNTS,TRIAL BALANCE OF EXPENSE ACCOUNTS,TRIAL BALANCE OF EXPENSE ACCOUNTS,COST ALLOCATION,COST ALLOCATION,ALLOCATION OF NEW CAPITAL COSTS,COMPUTATION OF RATIO OF COST TO CHARGES,COMPUTATION OF RATIO OF COST TO CHARGES,APPORTIONMENT OF MEDICAL AND OTHER HEALTH SERVICES,INPATIENT ANCILLARY SERVICE COST APPORTIONMENT,TRIAL BALANCE OF EXPENSE ACCOUNTS,COST ALLOCATION,,,APPORTIONMENT OF INPATIENT/OUTPATIENT ANCILLARY SERVICE OTHER PASS THROUGH COSTS,COST ALLOCATION,HHA STATISTICAL DATA,HHA STATISTICAL DATA,HHA STATISTICAL DATA,HHA STATISTICAL DATA,HHA STATISTICAL DATA,Total Inpatient Days/Outpatient Visits,Medicare Inpatient Days/Outpatient Visits,CALCULATION OF REIMBURSEMENT SETTLEMENT,CALCULATION OF REIMBURSEMENT SETTLEMENT,S-10 DATA,HOSPITAL WAGE INDEX DATA,CALCULATION OF REIMBURSEMENT SETTLEMENT,CALCULATION OF REIMBURSEMENT SETTLEMENT,CALCULATION OF REIMBURSEMENT SETTLEMENT,APPORTIONMENT OF INPATIENT/OUTPATIENT ANCILLARY SERVICE OTHER PASS THROUGH COSTS,,,,,,,,,,,,,,,,,,,,,,,,,,,,,,,,,,,,,,,,,,,,,,,,,,,,,,,,,,,,,,,,,,S-10 DATA,,,,,,,,,,,,,,,,,,,,,,RENAL STATISTICAL DATA,,,,,RENAL STATISTICAL DATA,,,,,,,,,,,,,,,,,,,,,,,,,,TRIAL BALANCE OF EXPENSE ACCOUNTS,TRIAL BALANCE OF EXPENSE ACCOUNTS,TRIAL BALANCE OF EXPENSE ACCOUNTS,COST ALLOCATION,COST ALLOCATION,COST ALLOCATION,COST ALLOCATION,COST ALLOCATION,COST ALLOCATION,COST ALLOCATION,COST ALLOCATION,COST ALLOCATION,COST ALLOCATION,COST ALLOCATION,COST ALLOCATION,COST ALLOCATION,COST ALLOCATION,ALLOCATION OF NEW CAPITAL COSTS,COMPUTATION OF RATIO OF COST TO CHARGES,COMPUTATION OF RATIO OF COST TO CHARGES,COMPUTATION OF RATIO OF COST TO CHARGES,COMPUTATION OF RATIO OF COST TO CHARGES,COMPUTATION OF RATIO OF COST TO CHARGES,COMPUTATION OF RATIO OF COST TO CHARGES,COMPUTATION OF RATIO OF COST TO CHARGES,COMPUTATION OF RATIO OF COST TO CHARGES,COMPUTATION OF RATIO OF COST TO CHARGES,INPATIENT ANCILLARY SERVICE COST APPORTIONMENT,INPATIENT ANCILLARY SERVICE COST APPORTIONMENT,INPATIENT ANCILLARY SERVICE COST APPORTIONMENT,INPATIENT ANCILLARY SERVICE COST APPORTIONMENT,INPATIENT ANCILLARY SERVICE COST APPORTIONMENT,INPATIENT ANCILLARY SERVICE COST APPORTIONMENT,APPORTIONMENT OF INPATIENT/OUTPATIENT ANCILLARY SERVICE OTHER PASS THROUGH COSTS,APPORTIONMENT OF INPATIENT/OUTPATIENT ANCILLARY SERVICE OTHER PASS THROUGH COSTS,APPORTIONMENT OF INPATIENT/OUTPATIENT ANCILLARY SERVICE OTHER PASS THROUGH COSTS,APPORTIONMENT OF INPATIENT/OUTPATIENT ANCILLARY SERVICE OTHER PASS THROUGH COSTS,APPORTIONMENT OF INPATIENT/OUTPATIENT ANCILLARY SERVICE OTHER PASS THROUGH COSTS,APPORTIONMENT OF INPATIENT/OUTPATIENT ANCILLARY SERVICE OTHER PASS THROUGH COSTS,APPORTIONMENT OF INPATIENT/OUTPATIENT ANCILLARY SERVICE OTHER PASS THROUGH COSTS,APPORTIONMENT OF INPATIENT/OUTPATIENT ANCILLARY SERVICE OTHER PASS THROUGH COSTS,APPORTIONMENT OF INPATIENT/OUTPATIENT ANCILLARY SERVICE OTHER PASS THROUGH COSTS,APPORTIONMENT OF INPATIENT/OUTPATIENT ANCILLARY SERVICE OTHER PASS THROUGH COSTS,APPORTIONMENT OF INPATIENT/OUTPATIENT ANCILLARY SERVICE OTHER PASS THROUGH COSTS,APPORTIONMENT OF INPATIENT/OUTPATIENT ANCILLARY SERVICE OTHER PASS THROUGH COSTS,APPORTIONMENT OF INPATIENT/OUTPATIENT ANCILLARY SERVICE OTHER PASS THROUGH COSTS,APPORTIONMENT OF INPATIENT/OUTPATIENT ANCILLARY SERVICE OTHER PASS THROUGH COSTS,APPORTIONMENT OF INPATIENT/OUTPATIENT ANCILLARY SERVICE OTHER PASS THROUGH COSTS,APPORTIONMENT OF INPATIENT/OUTPATIENT ANCILLARY SERVICE OTHER PASS THROUGH COSTS,APPORTIONMENT OF INPATIENT/OUTPATIENT ANCILLARY SERVICE OTHER PASS THROUGH COSTS,APPORTIONMENT OF INPATIENT/OUTPATIENT ANCILLARY SERVICE OTHER PASS THROUGH COSTS,APPORTIONMENT OF INPATIENT/OUTPATIENT ANCILLARY SERVICE OTHER PASS THROUGH COSTS,APPORTIONMENT OF INPATIENT/OUTPATIENT ANCILLARY SERVICE OTHER PASS THROUGH COSTS,APPORTIONMENT OF INPATIENT/OUTPATIENT ANCILLARY SERVICE OTHER PASS THROUGH COSTS,APPORTIONMENT OF INPATIENT/OUTPATIENT ANCILLARY SERVICE OTHER PASS THROUGH COSTS,APPORTIONMENT OF INPATIENT/OUTPATIENT ANCILLARY SERVICE OTHER PASS THROUGH COSTS,APPORTIONMENT OF INPATIENT/OUTPATIENT ANCILLARY SERVICE OTHER PASS THROUGH COSTS,APPORTIONMENT OF INPATIENT/OUTPATIENT ANCILLARY SERVICE OTHER PASS THROUGH COSTS,APPORTIONMENT OF INPATIENT/OUTPATIENT ANCILLARY SERVICE OTHER PASS THROUGH COSTS,APPORTIONMENT OF INPATIENT/OUTPATIENT ANCILLARY SERVICE OTHER PASS THROUGH COSTS,APPORTIONMENT OF INPATIENT/OUTPATIENT ANCILLARY SERVICE OTHER PASS THROUGH COSTS,APPORTIONMENT OF INPATIENT/OUTPATIENT ANCILLARY SERVICE OTHER PASS THROUGH COSTS,APPORTIONMENT OF INPATIENT/OUTPATIENT ANCILLARY SERVICE OTHER PASS THROUGH COSTS,APPORTIONMENT OF INPATIENT/OUTPATIENT ANCILLARY SERVICE OTHER PASS THROUGH COSTS,APPORTIONMENT OF INPATIENT/OUTPATIENT ANCILLARY SERVICE OTHER PASS THROUGH COSTS,APPORTIONMENT OF INPATIENT/OUTPATIENT ANCILLARY SERVICE OTHER PASS THROUGH COSTS,APPORTIONMENT OF INPATIENT/OUTPATIENT ANCILLARY SERVICE OTHER PASS THROUGH COSTS,APPORTIONMENT OF INPATIENT/OUTPATIENT ANCILLARY SERVICE OTHER PASS THROUGH COSTS,APPORTIONMENT OF INPATIENT/OUTPATIENT ANCILLARY SERVICE OTHER PASS THROUGH COSTS,APPORTIONMENT OF INPATIENT/OUTPATIENT ANCILLARY SERVICE OTHER PASS THROUGH COSTS,APPORTIONMENT OF INPATIENT/OUTPATIENT ANCILLARY SERVICE OTHER PASS THROUGH COSTS,APPORTIONMENT OF INPATIENT/OUTPATIENT ANCILLARY SERVICE OTHER PASS THROUGH COSTS,APPORTIONMENT OF INPATIENT/OUTPATIENT ANCILLARY SERVICE OTHER PASS THROUGH COSTS,APPORTIONMENT OF INPATIENT/OUTPATIENT ANCILLARY SERVICE OTHER PASS THROUGH COSTS,APPORTIONMENT OF INPATIENT/OUTPATIENT ANCILLARY SERVICE OTHER PASS THROUGH COSTS,APPORTIONMENT OF INPATIENT/OUTPATIENT ANCILLARY SERVICE OTHER PASS THROUGH COSTS,APPORTIONMENT OF INPATIENT/OUTPATIENT ANCILLARY SERVICE OTHER PASS THROUGH COSTS,APPORTIONMENT OF INPATIENT/OUTPATIENT ANCILLARY SERVICE OTHER PASS THROUGH COSTS,APPORTIONMENT OF INPATIENT/OUTPATIENT ANCILLARY SERVICE OTHER PASS THROUGH COSTS,APPORTIONMENT OF INPATIENT/OUTPATIENT ANCILLARY SERVICE OTHER PASS THROUGH COSTS,APPORTIONMENT OF INPATIENT/OUTPATIENT ANCILLARY SERVICE OTHER PASS THROUGH COSTS,APPORTIONMENT OF INPATIENT/OUTPATIENT ANCILLARY SERVICE OTHER PASS THROUGH COSTS,APPORTIONMENT OF INPATIENT/OUTPATIENT ANCILLARY SERVICE OTHER PASS THROUGH COSTS,APPORTIONMENT OF INPATIENT/OUTPATIENT ANCILLARY SERVICE OTHER PASS THROUGH COSTS,APPORTIONMENT OF INPATIENT/OUTPATIENT ANCILLARY SERVICE OTHER PASS THROUGH COSTS,APPORTIONMENT OF INPATIENT/OUTPATIENT ANCILLARY SERVICE OTHER PASS THROUGH COSTS,APPORTIONMENT OF INPATIENT/OUTPATIENT ANCILLARY SERVICE OTHER PASS THROUGH COSTS,APPORTIONMENT OF INPATIENT/OUTPATIENT ANCILLARY SERVICE OTHER PASS THROUGH COSTS,APPORTIONMENT OF INPATIENT/OUTPATIENT ANCILLARY SERVICE OTHER PASS THROUGH COSTS,APPORTIONMENT OF INPATIENT/OUTPATIENT ANCILLARY SERVICE OTHER PASS THROUGH COSTS,APPORTIONMENT OF INPATIENT/OUTPATIENT ANCILLARY SERVICE OTHER PASS THROUGH COSTS,APPORTIONMENT OF INPATIENT/OUTPATIENT ANCILLARY SERVICE OTHER PASS THROUGH COSTS,APPORTIONMENT OF INPATIENT/OUTPATIENT ANCILLARY SERVICE OTHER PASS THROUGH COSTS,APPORTIONMENT OF INPATIENT/OUTPATIENT ANCILLARY SERVICE OTHER PASS THROUGH COSTS,APPORTIONMENT OF INPATIENT/OUTPATIENT ANCILLARY SERVICE OTHER PASS THROUGH COSTS,APPORTIONMENT OF INPATIENT/OUTPATIENT ANCILLARY SERVICE OTHER PASS THROUGH COSTS,APPORTIONMENT OF INPATIENT/OUTPATIENT ANCILLARY SERVICE OTHER PASS THROUGH COSTS,APPORTIONMENT OF INPATIENT/OUTPATIENT ANCILLARY SERVICE OTHER PASS THROUGH COSTS,APPORTIONMENT OF INPATIENT/OUTPATIENT ANCILLARY SERVICE OTHER PASS THROUGH COSTS,APPORTIONMENT OF INPATIENT/OUTPATIENT ANCILLARY SERVICE OTHER PASS THROUGH COSTS,APPORTIONMENT OF INPATIENT/OUTPATIENT ANCILLARY SERVICE OTHER PASS THROUGH COSTS,APPORTIONMENT OF INPATIENT/OUTPATIENT ANCILLARY SERVICE OTHER PASS THROUGH COSTS,APPORTIONMENT OF INPATIENT/OUTPATIENT ANCILLARY SERVICE OTHER PASS THROUGH COSTS,APPORTIONMENT OF INPATIENT/OUTPATIENT ANCILLARY SERVICE OTHER PASS THROUGH COSTS,APPORTIONMENT OF INPATIENT/OUTPATIENT ANCILLARY SERVICE OTHER PASS THROUGH COSTS,APPORTIONMENT OF INPATIENT/OUTPATIENT ANCILLARY SERVICE OTHER PASS THROUGH COSTS,APPORTIONMENT OF INPATIENT/OUTPATIENT ANCILLARY SERVICE OTHER PASS THROUGH COSTS,APPORTIONMENT OF INPATIENT/OUTPATIENT ANCILLARY SERVICE OTHER PASS THROUGH COSTS,APPORTIONMENT OF MEDICAL AND OTHER HEALTH SERVICES,APPORTIONMENT OF MEDICAL AND OTHER HEALTH SERVICES,APPORTIONMENT OF MEDICAL AND OTHER HEALTH SERVICES,APPORTIONMENT OF MEDICAL AND OTHER HEALTH SERVICES,APPORTIONMENT OF MEDICAL AND OTHER HEALTH SERVICES,APPORTIONMENT OF MEDICAL AND OTHER HEALTH SERVICES,APPORTIONMENT OF MEDICAL AND OTHER HEALTH SERVICES,APPORTIONMENT OF MEDICAL AND OTHER HEALTH SERVICES,Total Inpatient Days/Outpatient Visits,BED DAYS AVAILABLE,BED DAYS AVAILABLE,Medicare Inpatient Days/Outpatient Visits,Medicaid Inpatient Days/Outpatient Visits,Total Inpatient Days/Outpatient Visits,Total Inpatient Days/Outpatient Visits,RECONCILIATION OF CAPITAL COST CENTERS,RECONCILIATION OF CAPITAL COST CENTERS,RECONCILIATION OF CAPITAL COST CENTERS,RECONCILIATION OF CAPITAL COST CENTERS,RECONCILIATION OF CAPITAL COST CENTERS,RECONCILIATION OF CAPITAL COST CENTERS,ADJUSTMENTS,TRIAL BALANCE OF EXPENSE ACCOUNTS,TRIAL BALANCE OF EXPENSE ACCOUNTS,TRIAL BALANCE OF EXPENSE ACCOUNTS,TRIAL BALANCE OF EXPENSE ACCOUNTS,TRIAL BALANCE OF EXPENSE ACCOUNTS,TRIAL BALANCE OF EXPENSE ACCOUNTS,TRIAL BALANCE OF EXPENSE ACCOUNTS,TRIAL BALANCE OF EXPENSE ACCOUNTS,TRIAL BALANCE OF EXPENSE ACCOUNTS,TRIAL BALANCE OF EXPENSE ACCOUNTS,TRIAL BALANCE OF EXPENSE ACCOUNTS,TRIAL BALANCE OF EXPENSE ACCOUNTS,TRIAL BALANCE OF EXPENSE ACCOUNTS,TRIAL BALANCE OF EXPENSE ACCOUNTS,TRIAL BALANCE OF EXPENSE ACCOUNTS,TRIAL BALANCE OF EXPENSE ACCOUNTS,TRIAL BALANCE OF EXPENSE ACCOUNTS,TRIAL BALANCE OF EXPENSE ACCOUNTS,TRIAL BALANCE OF EXPENSE ACCOUNTS,TRIAL BALANCE OF EXPENSE ACCOUNTS,TRIAL BALANCE OF EXPENSE ACCOUNTS,TRIAL BALANCE OF EXPENSE ACCOUNTS,TRIAL BALANCE OF EXPENSE ACCOUNTS,TRIAL BALANCE OF EXPENSE ACCOUNTS,TRIAL BALANCE OF EXPENSE ACCOUNTS,TRIAL BALANCE OF EXPENSE ACCOUNTS,TRIAL BALANCE OF EXPENSE ACCOUNTS,TRIAL BALANCE OF EXPENSE ACCOUNTS,TRIAL BALANCE OF EXPENSE ACCOUNTS,TRIAL BALANCE OF EXPENSE ACCOUNTS,TRIAL BALANCE OF EXPENSE ACCOUNTS,TRIAL BALANCE OF EXPENSE ACCOUNTS,TRIAL BALANCE OF EXPENSE ACCOUNTS,TRIAL BALANCE OF EXPENSE ACCOUNTS,TRIAL BALANCE OF EXPENSE ACCOUNTS,TRIAL BALANCE OF EXPENSE ACCOUNTS,TRIAL BALANCE OF EXPENSE ACCOUNTS,TRIAL BALANCE OF EXPENSE ACCOUNTS,COST ALLOCATION,COST ALLOCATION,COST ALLOCATION,COST ALLOCATION,COST ALLOCATION,COST ALLOCATION,COST ALLOCATION,COST ALLOCATION,COST ALLOCATION,COST ALLOCATION,COST ALLOCATION,COST ALLOCATION,COST ALLOCATION,COST ALLOCATION,COST ALLOCATION,COST ALLOCATION,COST ALLOCATION,COST ALLOCATION,COST ALLOCATION,COST ALLOCATION,COST ALLOCATION,COST ALLOCATION,COST ALLOCATION,COST ALLOCATION,COST ALLOCATION,COST ALLOCATION,COST ALLOCATION,COST ALLOCATION,COST ALLOCATION,COST ALLOCATION,COST ALLOCATION,COST ALLOCATION,COST ALLOCATION,COST ALLOCATION,COST ALLOCATION,COST ALLOCATION,COST ALLOCATION,COST ALLOCATION,COST ALLOCATION,COST ALLOCATION,COST ALLOCATION,COST ALLOCATION,COST ALLOCATION,COST ALLOCATION,COST ALLOCATION,COST ALLOCATION,COST ALLOCATION,COST ALLOCATION,COST ALLOCATION,COST ALLOCATION,COST ALLOCATION,COST ALLOCATION,ALLOCATION OF NEW CAPITAL COSTS,ALLOCATION OF NEW CAPITAL COSTS,ALLOCATION OF NEW CAPITAL COSTS,ALLOCATION OF NEW CAPITAL COSTS,ALLOCATION OF NEW CAPITAL COSTS,ALLOCATION OF NEW CAPITAL COSTS,ALLOCATION OF NEW CAPITAL COSTS,ALLOCATION OF NEW CAPITAL COSTS,ALLOCATION OF NEW CAPITAL COSTS,ALLOCATION OF NEW CAPITAL COSTS,ALLOCATION OF NEW CAPITAL COSTS,ALLOCATION OF NEW CAPITAL COSTS,ALLOCATION OF NEW CAPITAL COSTS,ALLOCATION OF NEW CAPITAL COSTS,ALLOCATION OF NEW CAPITAL COSTS,ALLOCATION OF NEW CAPITAL COSTS,ALLOCATION OF NEW CAPITAL COSTS,ALLOCATION OF NEW CAPITAL COSTS,ALLOCATION OF NEW CAPITAL COSTS,ALLOCATION OF NEW CAPITAL COSTS,ALLOCATION OF NEW CAPITAL COSTS,COMPUTATION OF RATIO OF COST TO CHARGES,COMPUTATION OF RATIO OF COST TO CHARGES,COMPUTATION OF RATIO OF COST TO CHARGES,COMPUTATION OF RATIO OF COST TO CHARGES,COMPUTATION OF RATIO OF COST TO CHARGES,COMPUTATION OF RATIO OF COST TO CHARGES,COMPUTATION OF RATIO OF COST TO CHARGES,COMPUTATION OF RATIO OF COST TO CHARGES,COMPUTATION OF RATIO OF COST TO CHARGES,COMPUTATION OF RATIO OF COST TO CHARGES,COMPUTATION OF RATIO OF COST TO CHARGES,COMPUTATION OF RATIO OF COST TO CHARGES,COMPUTATION OF RATIO OF COST TO CHARGES,COMPUTATION OF RATIO OF COST TO CHARGES,COMPUTATION OF RATIO OF COST TO CHARGES,COMPUTATION OF RATIO OF COST TO CHARGES,COMPUTATION OF RATIO OF COST TO CHARGES,COMPUTATION OF RATIO OF COST TO CHARGES,COMPUTATION OF RATIO OF COST TO CHARGES,COMPUTATION OF RATIO OF COST TO CHARGES,COMPUTATION OF RATIO OF COST TO CHARGES,COMPUTATION OF RATIO OF COST TO CHARGES,COMPUTATION OF RATIO OF COST TO CHARGES,COMPUTATION OF RATIO OF COST TO CHARGES,COMPUTATION OF RATIO OF COST TO CHARGES,COMPUTATION OF RATIO OF COST TO CHARGES,COMPUTATION OF RATIO OF COST TO CHARGES,COMPUTATION OF RATIO OF COST TO CHARGES,COMPUTATION OF RATIO OF COST TO CHARGES,COMPUTATION OF RATIO OF COST TO CHARGES,COMPUTATION OF RATIO OF COST TO CHARGES,COMPUTATION OF RATIO OF COST TO CHARGES,COMPUTATION OF RATIO OF COST TO CHARGES,COMPUTATION OF RATIO OF COST TO CHARGES,COMPUTATION OF RATIO OF COST TO CHARGES,COMPUTATION OF RATIO OF COST TO CHARGES,COMPUTATION OF RATIO OF COST TO CHARGES,COMPUTATION OF RATIO OF COST TO CHARGES,COMPUTATION OF RATIO OF COST TO CHARGES,COMPUTATION OF RATIO OF COST TO CHARGES,COMPUTATION OF RATIO OF COST TO CHARGES,COMPUTATION OF RATIO OF COST TO CHARGES,INPATIENT ANCILLARY SERVICE COST APPORTIONMENT,INPATIENT ANCILLARY SERVICE COST APPORTIONMENT,INPATIENT ANCILLARY SERVICE COST APPORTIONMENT,INPATIENT ANCILLARY SERVICE COST APPORTIONMENT,INPATIENT ANCILLARY SERVICE COST APPORTIONMENT,INPATIENT ANCILLARY SERVICE COST APPORTIONMENT,INPATIENT ANCILLARY SERVICE COST APPORTIONMENT,INPATIENT ANCILLARY SERVICE COST APPORTIONMENT,INPATIENT ANCILLARY SERVICE COST APPORTIONMENT,INPATIENT ANCILLARY SERVICE COST APPORTIONMENT,INPATIENT ANCILLARY SERVICE COST APPORTIONMENT,INPATIENT ANCILLARY SERVICE COST APPORTIONMENT,INPATIENT ANCILLARY SERVICE COST APPORTIONMENT,INPATIENT ANCILLARY SERVICE COST APPORTIONMENT,INPATIENT ANCILLARY SERVICE COST APPORTIONMENT,INPATIENT ANCILLARY SERVICE COST APPORTIONMENT,INPATIENT ANCILLARY SERVICE COST APPORTIONMENT,INPATIENT ANCILLARY SERVICE COST APPORTIONMENT,INPATIENT ANCILLARY SERVICE COST APPORTIONMENT,INPATIENT ANCILLARY SERVICE COST APPORTIONMENT,INPATIENT ANCILLARY SERVICE COST APPORTIONMENT,INPATIENT ANCILLARY SERVICE COST APPORTIONMENT,INPATIENT ANCILLARY SERVICE COST APPORTIONMENT,INPATIENT ANCILLARY SERVICE COST APPORTIONMENT,INPATIENT ANCILLARY SERVICE COST APPORTIONMENT,INPATIENT ANCILLARY SERVICE COST APPORTIONMENT,INPATIENT ANCILLARY SERVICE COST APPORTIONMENT,INPATIENT ANCILLARY SERVICE COST APPORTIONMENT,INPATIENT ANCILLARY SERVICE COST APPORTIONMENT,INPATIENT ANCILLARY SERVICE COST APPORTIONMENT,INPATIENT ANCILLARY SERVICE COST APPORTIONMENT,INPATIENT ANCILLARY SERVICE COST APPORTIONMENT,INPATIENT ANCILLARY SERVICE COST APPORTIONMENT,INPATIENT ANCILLARY SERVICE COST APPORTIONMENT,INPATIENT ANCILLARY SERVICE COST APPORTIONMENT,INPATIENT ANCILLARY SERVICE COST APPORTIONMENT,INPATIENT ANCILLARY SERVICE COST APPORTIONMENT,INPATIENT ANCILLARY SERVICE COST APPORTIONMENT,INPATIENT ANCILLARY SERVICE COST APPORTIONMENT,INPATIENT ANCILLARY SERVICE COST APPORTIONMENT,INPATIENT ANCILLARY SERVICE COST APPORTIONMENT,INPATIENT ANCILLARY SERVICE COST APPORTIONMENT,APPORTIONMENT OF INPATIENT/OUTPATIENT ANCILLARY SERVICE OTHER PASS THROUGH COSTS,APPORTIONMENT OF INPATIENT/OUTPATIENT ANCILLARY SERVICE OTHER PASS THROUGH COSTS,APPORTIONMENT OF INPATIENT/OUTPATIENT ANCILLARY SERVICE OTHER PASS THROUGH COSTS,APPORTIONMENT OF INPATIENT/OUTPATIENT ANCILLARY SERVICE OTHER PASS THROUGH COSTS,APPORTIONMENT OF INPATIENT/OUTPATIENT ANCILLARY SERVICE OTHER PASS THROUGH COSTS,APPORTIONMENT OF INPATIENT/OUTPATIENT ANCILLARY SERVICE OTHER PASS THROUGH COSTS,APPORTIONMENT OF INPATIENT/OUTPATIENT ANCILLARY SERVICE OTHER PASS THROUGH COSTS,APPORTIONMENT OF INPATIENT/OUTPATIENT ANCILLARY SERVICE OTHER PASS THROUGH COSTS,APPORTIONMENT OF INPATIENT/OUTPATIENT ANCILLARY SERVICE OTHER PASS THROUGH COSTS,APPORTIONMENT OF INPATIENT/OUTPATIENT ANCILLARY SERVICE OTHER PASS THROUGH COSTS,APPORTIONMENT OF INPATIENT/OUTPATIENT ANCILLARY SERVICE OTHER PASS THROUGH COSTS,APPORTIONMENT OF INPATIENT/OUTPATIENT ANCILLARY SERVICE OTHER PASS THROUGH COSTS,APPORTIONMENT OF INPATIENT/OUTPATIENT ANCILLARY SERVICE OTHER PASS THROUGH COSTS,APPORTIONMENT OF INPATIENT/OUTPATIENT ANCILLARY SERVICE OTHER PASS THROUGH COSTS,APPORTIONMENT OF INPATIENT/OUTPATIENT ANCILLARY SERVICE OTHER PASS THROUGH COSTS,APPORTIONMENT OF INPATIENT/OUTPATIENT ANCILLARY SERVICE OTHER PASS THROUGH COSTS,APPORTIONMENT OF INPATIENT/OUTPATIENT ANCILLARY SERVICE OTHER PASS THROUGH COSTS,APPORTIONMENT OF INPATIENT/OUTPATIENT ANCILLARY SERVICE OTHER PASS THROUGH COSTS,APPORTIONMENT OF INPATIENT/OUTPATIENT ANCILLARY SERVICE OTHER PASS THROUGH COSTS,APPORTIONMENT OF INPATIENT/OUTPATIENT ANCILLARY SERVICE OTHER PASS THROUGH COSTS,APPORTIONMENT OF INPATIENT/OUTPATIENT ANCILLARY SERVICE OTHER PASS THROUGH COSTS,RECONCILIATION OF CAPITAL COST CENTERS,RECONCILIATION OF CAPITAL COST CENTERS,RECONCILIATION OF CAPITAL COST CENTERS,TRIAL BALANCE OF EXPENSE ACCOUNTS,TRIAL BALANCE OF EXPENSE ACCOUNTS,TRIAL BALANCE OF EXPENSE ACCOUNTS,TRIAL BALANCE OF EXPENSE ACCOUNTS,TRIAL BALANCE OF EXPENSE ACCOUNTS,TRIAL BALANCE OF EXPENSE ACCOUNTS,TRIAL BALANCE OF EXPENSE ACCOUNTS,TRIAL BALANCE OF EXPENSE ACCOUNTS,TRIAL BALANCE OF EXPENSE ACCOUNTS,TRIAL BALANCE OF EXPENSE ACCOUNTS,TRIAL BALANCE OF EXPENSE ACCOUNTS,TRIAL BALANCE OF EXPENSE ACCOUNTS,TRIAL BALANCE OF EXPENSE ACCOUNTS,TRIAL BALANCE OF EXPENSE ACCOUNTS,TRIAL BALANCE OF EXPENSE ACCOUNTS,COST ALLOCATION,COST ALLOCATION,COST ALLOCATION,COST ALLOCATION,COST ALLOCATION,COST ALLOCATION,COST ALLOCATION,ALLOCATION OF NEW CAPITAL COSTS,ALLOCATION OF NEW CAPITAL COSTS,COMPUTATION OF RATIO OF COST TO CHARGES,TRIAL BALANCE OF EXPENSE ACCOUNTS,TRIAL BALANCE OF EXPENSE ACCOUNTS,TRIAL BALANCE OF EXPENSE ACCOUNTS,TRIAL BALANCE OF EXPENSE ACCOUNTS,TRIAL BALANCE OF EXPENSE ACCOUNTS,TRIAL BALANCE OF EXPENSE ACCOUNTS,TRIAL BALANCE OF EXPENSE ACCOUNTS,COST ALLOCATION,COST ALLOCATION,COST ALLOCATION,COST ALLOCATION,ALLOCATION OF NEW CAPITAL COSTS,COMPUTATION OF RATIO OF COST TO CHARGES,COMPUTATION OF RATIO OF COST TO CHARGES,APPORTIONMENT OF INPATIENT/OUTPATIENT ANCILLARY SERVICE OTHER PASS THROUGH COSTS,APPORTIONMENT OF INPATIENT/OUTPATIENT ANCILLARY SERVICE OTHER PASS THROUGH COSTS,APPORTIONMENT OF MEDICAL AND OTHER HEALTH SERVICES,APPORTIONMENT OF MEDICAL AND OTHER HEALTH SERVICES,APPORTIONMENT OF MEDICAL AND OTHER HEALTH SERVICES,APPORTIONMENT OF MEDICAL AND OTHER HEALTH SERVICES,TRIAL BALANCE OF EXPENSE ACCOUNTS,TRIAL BALANCE OF EXPENSE ACCOUNTS,TRIAL BALANCE OF EXPENSE ACCOUNTS,TRIAL BALANCE OF EXPENSE ACCOUNTS,TRIAL BALANCE OF EXPENSE ACCOUNTS,TRIAL BALANCE OF EXPENSE ACCOUNTS,COST ALLOCATION,ALLOCATION OF NEW CAPITAL COSTS,TRIAL BALANCE OF EXPENSE ACCOUNTS,COST ALLOCATION,ALLOCATION OF NEW CAPITAL COSTS,APPORTIONMENT OF INPATIENT/OUTPATIENT ANCILLARY SERVICE OTHER PASS THROUGH COSTS,APPORTIONMENT OF MEDICAL AND OTHER HEALTH SERVICES,APPORTIONMENT OF MEDICAL AND OTHER HEALTH SERVICES,TRIAL BALANCE OF EXPENSE ACCOUNTS,TRIAL BALANCE OF EXPENSE ACCOUNTS,COST ALLOCATION,COST ALLOCATION,COST ALLOCATION,COST ALLOCATION,COST ALLOCATION,TRIAL BALANCE OF EXPENSE ACCOUNTS,TRIAL BALANCE OF EXPENSE ACCOUNTS,TRIAL BALANCE OF EXPENSE ACCOUNTS,TRIAL BALANCE OF EXPENSE ACCOUNTS,TRIAL BALANCE OF EXPENSE ACCOUNTS,TRIAL BALANCE OF EXPENSE ACCOUNTS,TRIAL BALANCE OF EXPENSE ACCOUNTS,TRIAL BALANCE OF EXPENSE ACCOUNTS,COST ALLOCATION,COST ALLOCATION,ALLOCATION OF NEW CAPITAL COSTS,COMPUTATION OF RATIO OF COST TO CHARGES,COMPUTATION OF RATIO OF COST TO CHARGES,COMPUTATION OF RATIO OF COST TO CHARGES,COMPUTATION OF RATIO OF COST TO CHARGES,COMPUTATION OF RATIO OF COST TO CHARGES,COMPUTATION OF RATIO OF COST TO CHARGES,COMPUTATION OF RATIO OF COST TO CHARGES,COMPUTATION OF RATIO OF COST TO CHARGES,APPORTIONMENT OF INPATIENT/OUTPATIENT ANCILLARY SERVICE OTHER PASS THROUGH COSTS,APPORTIONMENT OF MEDICAL AND OTHER HEALTH SERVICES,APPORTIONMENT OF MEDICAL AND OTHER HEALTH SERVICES,TRIAL BALANCE OF EXPENSE ACCOUNTS,TRIAL BALANCE OF EXPENSE ACCOUNTS,TRIAL BALANCE OF EXPENSE ACCOUNTS,TRIAL BALANCE OF EXPENSE ACCOUNTS,TRIAL BALANCE OF EXPENSE ACCOUNTS,TRIAL BALANCE OF EXPENSE ACCOUNTS,TRIAL BALANCE OF EXPENSE ACCOUNTS,TRIAL BALANCE OF EXPENSE ACCOUNTS,TRIAL BALANCE OF EXPENSE ACCOUNTS,COMPUTATION OF RATIO OF COST TO CHARGES,COMPUTATION OF RATIO OF COST TO CHARGES,APPORTIONMENT OF INPATIENT/OUTPATIENT ANCILLARY SERVICE OTHER PASS THROUGH COSTS,APPORTIONMENT OF INPATIENT/OUTPATIENT ANCILLARY SERVICE OTHER PASS THROUGH COSTS,APPORTIONMENT OF INPATIENT/OUTPATIENT ANCILLARY SERVICE OTHER PASS THROUGH COSTS,APPORTIONMENT OF INPATIENT/OUTPATIENT ANCILLARY SERVICE OTHER PASS THROUGH COSTS,APPORTIONMENT OF MEDICAL AND OTHER HEALTH SERVICES,APPORTIONMENT OF MEDICAL AND OTHER HEALTH SERVICES,APPORTIONMENT OF MEDICAL AND OTHER HEALTH SERVICES,APPORTIONMENT OF MEDICAL AND OTHER HEALTH SERVICES,APPORTIONMENT OF MEDICAL AND OTHER HEALTH SERVICES,APPORTIONMENT OF MEDICAL AND OTHER HEALTH SERVICES,APPORTIONMENT OF MEDICAL AND OTHER HEALTH SERVICES,APPORTIONMENT OF MEDICAL AND OTHER HEALTH SERVICES,RECONCILIATION OF CAPITAL COST CENTERS,RECONCILIATION OF CAPITAL COST CENTERS,TRIAL BALANCE OF EXPENSE ACCOUNTS,TRIAL BALANCE OF EXPENSE ACCOUNTS,TRIAL BALANCE OF EXPENSE ACCOUNTS,COST ALLOCATION,COST ALLOCATION,ALLOCATION OF NEW CAPITAL COSTS,COMPUTATION OF RATIO OF COST TO CHARGES,RECONCILIATION OF CAPITAL COST CENTERS,RECONCILIATION OF CAPITAL COST CENTERS,TRIAL BALANCE OF EXPENSE ACCOUNTS,TRIAL BALANCE OF EXPENSE ACCOUNTS,TRIAL BALANCE OF EXPENSE ACCOUNTS,TRIAL BALANCE OF EXPENSE ACCOUNTS,TRIAL BALANCE OF EXPENSE ACCOUNTS,TRIAL BALANCE OF EXPENSE ACCOUNTS,COST ALLOCATION,COST ALLOCATION,ALLOCATION OF NEW CAPITAL COSTS,COMPUTATION OF RATIO OF COST TO CHARGES,COMPUTATION OF RATIO OF COST TO CHARGES,COMPUTATION OF RATIO OF COST TO CHARGES,COMPUTATION OF INPATIENT OPERATING COSTS,INPATIENT ANCILLARY SERVICE COST APPORTIONMENT,APPORTIONMENT OF INPATIENT ROUTINE SERVICE CAPITAL COSTS,APPORTIONMENT OF INPATIENT ROUTINE SERVICE CAPITAL COSTS,APPORTIONMENT OF INPATIENT ROUTINE SERVICE CAPITAL COSTS,APPORTIONMENT OF MEDICAL AND OTHER HEALTH SERVICES,APPORTIONMENT OF MEDICAL AND OTHER HEALTH SERVICES,APPORTIONMENT OF MEDICAL AND OTHER HEALTH SERVICES,APPORTIONMENT OF MEDICAL AND OTHER HEALTH SERVICES,NUMBER OF BEDS,BED DAYS AVAILABLE,Medicare Inpatient Days/Outpatient Visits,Total Inpatient Days/Outpatient Visits,TRIAL BALANCE OF EXPENSE ACCOUNTS,TRIAL BALANCE OF EXPENSE ACCOUNTS,TRIAL BALANCE OF EXPENSE ACCOUNTS,TRIAL BALANCE OF EXPENSE ACCOUNTS,TRIAL BALANCE OF EXPENSE ACCOUNTS,TRIAL BALANCE OF EXPENSE ACCOUNTS,TRIAL BALANCE OF EXPENSE ACCOUNTS,TRIAL BALANCE OF EXPENSE ACCOUNTS,TRIAL BALANCE OF EXPENSE ACCOUNTS,TRIAL BALANCE OF EXPENSE ACCOUNTS,TRIAL BALANCE OF EXPENSE ACCOUNTS,TRIAL BALANCE OF EXPENSE ACCOUNTS,TRIAL BALANCE OF EXPENSE ACCOUNTS,TRIAL BALANCE OF EXPENSE ACCOUNTS,TRIAL BALANCE OF EXPENSE ACCOUNTS,TRIAL BALANCE OF EXPENSE ACCOUNTS,TRIAL BALANCE OF EXPENSE ACCOUNTS,TRIAL BALANCE OF EXPENSE ACCOUNTS,TRIAL BALANCE OF EXPENSE ACCOUNTS,TRIAL BALANCE OF EXPENSE ACCOUNTS,TRIAL BALANCE OF EXPENSE ACCOUNTS,TRIAL BALANCE OF EXPENSE ACCOUNTS,TRIAL BALANCE OF EXPENSE ACCOUNTS,TRIAL BALANCE OF EXPENSE ACCOUNTS,COST ALLOCATION,COST ALLOCATION,COST ALLOCATION,COST ALLOCATION,COST ALLOCATION,COST ALLOCATION,COST ALLOCATION,COST ALLOCATION,COST ALLOCATION,COST ALLOCATION,COST ALLOCATION,ALLOCATION OF NEW CAPITAL COSTS,ALLOCATION OF NEW CAPITAL COSTS,ALLOCATION OF NEW CAPITAL COSTS,ALLOCATION OF NEW CAPITAL COSTS,ALLOCATION OF NEW CAPITAL COSTS,COMPUTATION OF RATIO OF COST TO CHARGES,COMPUTATION OF RATIO OF COST TO CHARGES,COMPUTATION OF RATIO OF COST TO CHARGES,COMPUTATION OF RATIO OF COST TO CHARGES,COMPUTATION OF RATIO OF COST TO CHARGES,COMPUTATION OF RATIO OF COST TO CHARGES,COMPUTATION OF RATIO OF COST TO CHARGES,COMPUTATION OF RATIO OF COST TO CHARGES,COMPUTATION OF RATIO OF COST TO CHARGES,COMPUTATION OF RATIO OF COST TO CHARGES,COMPUTATION OF RATIO OF COST TO CHARGES,COMPUTATION OF RATIO OF COST TO CHARGES,COMPUTATION OF RATIO OF COST TO CHARGES,COMPUTATION OF RATIO OF COST TO CHARGES,COMPUTATION OF RATIO OF COST TO CHARGES,COMPUTATION OF RATIO OF COST TO CHARGES,COMPUTATION OF RATIO OF COST TO CHARGES,COMPUTATION OF RATIO OF COST TO CHARGES,INPATIENT ANCILLARY SERVICE COST APPORTIONMENT,INPATIENT ANCILLARY SERVICE COST APPORTIONMENT,INPATIENT ANCILLARY SERVICE COST APPORTIONMENT,INPATIENT ANCILLARY SERVICE COST APPORTIONMENT,INPATIENT ANCILLARY SERVICE COST APPORTIONMENT,INPATIENT ANCILLARY SERVICE COST APPORTIONMENT,INPATIENT ANCILLARY SERVICE COST APPORTIONMENT,INPATIENT ANCILLARY SERVICE COST APPORTIONMENT,APPORTIONMENT OF INPATIENT ROUTINE SERVICE CAPITAL COSTS,APPORTIONMENT OF INPATIENT ROUTINE SERVICE CAPITAL COSTS,APPORTIONMENT OF INPATIENT ROUTINE SERVICE CAPITAL COSTS,APPORTIONMENT OF INPATIENT ROUTINE SERVICE CAPITAL COSTS,APPORTIONMENT OF INPATIENT ROUTINE SERVICE CAPITAL COSTS,APPORTIONMENT OF INPATIENT ROUTINE SERVICE CAPITAL COSTS,APPORTIONMENT OF INPATIENT/OUTPATIENT ANCILLARY SERVICE OTHER PASS THROUGH COSTS,APPORTIONMENT OF INPATIENT/OUTPATIENT ANCILLARY SERVICE OTHER PASS THROUGH COSTS,APPORTIONMENT OF INPATIENT/OUTPATIENT ANCILLARY SERVICE OTHER PASS THROUGH COSTS,APPORTIONMENT OF INPATIENT/OUTPATIENT ANCILLARY SERVICE OTHER PASS THROUGH COSTS,APPORTIONMENT OF INPATIENT/OUTPATIENT ANCILLARY SERVICE OTHER PASS THROUGH COSTS,APPORTIONMENT OF INPATIENT/OUTPATIENT ANCILLARY SERVICE OTHER PASS THROUGH COSTS,APPORTIONMENT OF INPATIENT/OUTPATIENT ANCILLARY SERVICE OTHER PASS THROUGH COSTS,APPORTIONMENT OF INPATIENT/OUTPATIENT ANCILLARY SERVICE OTHER PASS THROUGH COSTS,APPORTIONMENT OF INPATIENT/OUTPATIENT ANCILLARY SERVICE OTHER PASS THROUGH COSTS,APPORTIONMENT OF INPATIENT/OUTPATIENT ANCILLARY SERVICE OTHER PASS THROUGH COSTS,APPORTIONMENT OF INPATIENT/OUTPATIENT ANCILLARY SERVICE OTHER PASS THROUGH COSTS,APPORTIONMENT OF INPATIENT/OUTPATIENT ANCILLARY SERVICE OTHER PASS THROUGH COSTS,APPORTIONMENT OF INPATIENT/OUTPATIENT ANCILLARY SERVICE OTHER PASS THROUGH COSTS,APPORTIONMENT OF INPATIENT/OUTPATIENT ANCILLARY SERVICE OTHER PASS THROUGH COSTS,APPORTIONMENT OF INPATIENT/OUTPATIENT ANCILLARY SERVICE OTHER PASS THROUGH COSTS,APPORTIONMENT OF INPATIENT/OUTPATIENT ANCILLARY SERVICE OTHER PASS THROUGH COSTS,APPORTIONMENT OF INPATIENT/OUTPATIENT ANCILLARY SERVICE OTHER PASS THROUGH COSTS,APPORTIONMENT OF INPATIENT/OUTPATIENT ANCILLARY SERVICE OTHER PASS THROUGH COSTS,APPORTIONMENT OF INPATIENT/OUTPATIENT ANCILLARY SERVICE OTHER PASS THROUGH COSTS,APPORTIONMENT OF MEDICAL AND OTHER HEALTH SERVICES,APPORTIONMENT OF MEDICAL AND OTHER HEALTH SERVICES,APPORTIONMENT OF MEDICAL AND OTHER HEALTH SERVICES,APPORTIONMENT OF MEDICAL AND OTHER HEALTH SERVICES,APPORTIONMENT OF MEDICAL AND OTHER HEALTH SERVICES,APPORTIONMENT OF MEDICAL AND OTHER HEALTH SERVICES,APPORTIONMENT OF MEDICAL AND OTHER HEALTH SERVICES,APPORTIONMENT OF MEDICAL AND OTHER HEALTH SERVICES,APPORTIONMENT OF MEDICAL AND OTHER HEALTH SERVICES,APPORTIONMENT OF MEDICAL AND OTHER HEALTH SERVICES,APPORTIONMENT OF MEDICAL AND OTHER HEALTH SERVICES,APPORTIONMENT OF MEDICAL AND OTHER HEALTH SERVICES,APPORTIONMENT OF MEDICAL AND OTHER HEALTH SERVICES,APPORTIONMENT OF MEDICAL AND OTHER HEALTH SERVICES,APPORTIONMENT OF MEDICAL AND OTHER HEALTH SERVICES,APPORTIONMENT OF MEDICAL AND OTHER HEALTH SERVICES,APPORTIONMENT OF MEDICAL AND OTHER HEALTH SERVICES,APPORTIONMENT OF MEDICAL AND OTHER HEALTH SERVICES,APPORTIONMENT OF MEDICAL AND OTHER HEALTH SERVICES,APPORTIONMENT OF MEDICAL AND OTHER HEALTH SERVICES,APPORTIONMENT OF MEDICAL AND OTHER HEALTH SERVICES,APPORTIONMENT OF MEDICAL AND OTHER HEALTH SERVICES,APPORTIONMENT OF MEDICAL AND OTHER HEALTH SERVICES,APPORTIONMENT OF MEDICAL AND OTHER HEALTH SERVICES,APPORTIONMENT OF MEDICAL AND OTHER HEALTH SERVICES,APPORTIONMENT OF MEDICAL AND OTHER HEALTH SERVICES,APPORTIONMENT OF MEDICAL AND OTHER HEALTH SERVICES,APPORTIONMENT OF MEDICAL AND OTHER HEALTH SERVICES,APPORTIONMENT OF MEDICAL AND OTHER HEALTH SERVICES,APPORTIONMENT OF MEDICAL AND OTHER HEALTH SERVICES,APPORTIONMENT OF MEDICAL AND OTHER HEALTH SERVICES,APPORTIONMENT OF MEDICAL AND OTHER HEALTH SERVICES,APPORTIONMENT OF MEDICAL AND OTHER HEALTH SERVICES,APPORTIONMENT OF MEDICAL AND OTHER HEALTH SERVICES,NUMBER OF BEDS,NUMBER OF BEDS,BED DAYS AVAILABLE,BED DAYS AVAILABLE,Medicare Inpatient Days/Outpatient Visits,Medicare Inpatient Days/Outpatient Visits,Medicaid Inpatient Days/Outpatient Visits,Medicaid Inpatient Days/Outpatient Visits,Medicaid Inpatient Days/Outpatient Visits,Total Inpatient Days/Outpatient Visits,Total Inpatient Days/Outpatient Visits,TRIAL BALANCE OF EXPENSE ACCOUNTS,TRIAL BALANCE OF EXPENSE ACCOUNTS,COST ALLOCATION,COMPUTATION OF RATIO OF COST TO CHARGES,COMPUTATION OF RATIO OF COST TO CHARGES,COMPUTATION OF RATIO OF COST TO CHARGES,COMPUTATION OF RATIO OF COST TO CHARGES,INPATIENT ANCILLARY SERVICE COST APPORTIONMENT,INPATIENT ANCILLARY SERVICE COST APPORTIONMENT,APPORTIONMENT OF INPATIENT/OUTPATIENT ANCILLARY SERVICE OTHER PASS THROUGH COSTS,APPORTIONMENT OF INPATIENT/OUTPATIENT ANCILLARY SERVICE OTHER PASS THROUGH COSTS,APPORTIONMENT OF MEDICAL AND OTHER HEALTH SERVICES,APPORTIONMENT OF MEDICAL AND OTHER HEALTH SERVICES,TRIAL BALANCE OF EXPENSE ACCOUNTS,TRIAL BALANCE OF EXPENSE ACCOUNTS,TRIAL BALANCE OF EXPENSE ACCOUNTS,COST ALLOCATION,COST ALLOCATION,ALLOCATION OF NEW CAPITAL COSTS,COMPUTATION OF RATIO OF COST TO CHARGES,COMPUTATION OF RATIO OF COST TO CHARGES,COMPUTATION OF RATIO OF COST TO CHARGES,INPATIENT ANCILLARY SERVICE COST APPORTIONMENT,INPATIENT ANCILLARY SERVICE COST APPORTIONMENT,APPORTIONMENT OF INPATIENT/OUTPATIENT ANCILLARY SERVICE OTHER PASS THROUGH COSTS,APPORTIONMENT OF INPATIENT/OUTPATIENT ANCILLARY SERVICE OTHER PASS THROUGH COSTS,APPORTIONMENT OF MEDICAL AND OTHER HEALTH SERVICES,APPORTIONMENT OF MEDICAL AND OTHER HEALTH SERVICES,APPORTIONMENT OF MEDICAL AND OTHER HEALTH SERVICES,APPORTIONMENT OF MEDICAL AND OTHER HEALTH SERVICES,TRIAL BALANCE OF EXPENSE ACCOUNTS,TRIAL BALANCE OF EXPENSE ACCOUNTS,TRIAL BALANCE OF EXPENSE ACCOUNTS,TRIAL BALANCE OF EXPENSE ACCOUNTS,TRIAL BALANCE OF EXPENSE ACCOUNTS,COST ALLOCATION,INPATIENT ANCILLARY SERVICE COST APPORTIONMENT,INPATIENT ANCILLARY SERVICE COST APPORTIONMENT,INPATIENT ANCILLARY SERVICE COST APPORTIONMENT,INPATIENT ANCILLARY SERVICE COST APPORTIONMENT,INPATIENT ANCILLARY SERVICE COST APPORTIONMENT,INPATIENT ANCILLARY SERVICE COST APPORTIONMENT,INPATIENT ANCILLARY SERVICE COST APPORTIONMENT,INPATIENT ANCILLARY SERVICE COST APPORTIONMENT,INPATIENT ANCILLARY SERVICE COST APPORTIONMENT,INPATIENT ANCILLARY SERVICE COST APPORTIONMENT,INPATIENT ANCILLARY SERVICE COST APPORTIONMENT,INPATIENT ANCILLARY SERVICE COST APPORTIONMENT,INPATIENT ANCILLARY SERVICE COST APPORTIONMENT,INPATIENT ANCILLARY SERVICE COST APPORTIONMENT,INPATIENT ANCILLARY SERVICE COST APPORTIONMENT,INPATIENT ANCILLARY SERVICE COST APPORTIONMENT,INPATIENT ANCILLARY SERVICE COST APPORTIONMENT,INPATIENT ANCILLARY SERVICE COST APPORTIONMENT,INPATIENT ANCILLARY SERVICE COST APPORTIONMENT,INPATIENT ANCILLARY SERVICE COST APPORTIONMENT,INPATIENT ANCILLARY SERVICE COST APPORTIONMENT,INPATIENT ANCILLARY SERVICE COST APPORTIONMENT,INPATIENT ANCILLARY SERVICE COST APPORTIONMENT,INPATIENT ANCILLARY SERVICE COST APPORTIONMENT,INPATIENT ANCILLARY SERVICE COST APPORTIONMENT,INPATIENT ANCILLARY SERVICE COST APPORTIONMENT,INPATIENT ANCILLARY SERVICE COST APPORTIONMENT,INPATIENT ANCILLARY SERVICE COST APPORTIONMENT,INPATIENT ANCILLARY SERVICE COST APPORTIONMENT,INPATIENT ANCILLARY SERVICE COST APPORTIONMENT,INPATIENT ANCILLARY SERVICE COST APPORTIONMENT,INPATIENT ANCILLARY SERVICE COST APPORTIONMENT,INPATIENT ANCILLARY SERVICE COST APPORTIONMENT,INPATIENT ANCILLARY SERVICE COST APPORTIONMENT,INPATIENT ANCILLARY SERVICE COST APPORTIONMENT,INPATIENT ANCILLARY SERVICE COST APPORTIONMENT,INPATIENT ANCILLARY SERVICE COST APPORTIONMENT,INPATIENT ANCILLARY SERVICE COST APPORTIONMENT,INPATIENT ANCILLARY SERVICE COST APPORTIONMENT,INPATIENT ANCILLARY SERVICE COST APPORTIONMENT,INPATIENT ANCILLARY SERVICE COST APPORTIONMENT,INPATIENT ANCILLARY SERVICE COST APPORTIONMENT,INPATIENT ANCILLARY SERVICE COST APPORTIONMENT,INPATIENT ANCILLARY SERVICE COST APPORTIONMENT,INPATIENT ANCILLARY SERVICE COST APPORTIONMENT,INPATIENT ANCILLARY SERVICE COST APPORTIONMENT,INPATIENT ANCILLARY SERVICE COST APPORTIONMENT,INPATIENT ANCILLARY SERVICE COST APPORTIONMENT,INPATIENT ANCILLARY SERVICE COST APPORTIONMENT,INPATIENT ANCILLARY SERVICE COST APPORTIONMENT,INPATIENT ANCILLARY SERVICE COST APPORTIONMENT,INPATIENT ANCILLARY SERVICE COST APPORTIONMENT,INPATIENT ANCILLARY SERVICE COST APPORTIONMENT,INPATIENT ANCILLARY SERVICE COST APPORTIONMENT,INPATIENT ANCILLARY SERVICE COST APPORTIONMENT,INPATIENT ANCILLARY SERVICE COST APPORTIONMENT,INPATIENT ANCILLARY SERVICE COST APPORTIONMENT,INPATIENT ANCILLARY SERVICE COST APPORTIONMENT,INPATIENT ANCILLARY SERVICE COST APPORTIONMENT,INPATIENT ANCILLARY SERVICE COST APPORTIONMENT,APPORTIONMENT OF INPATIENT/OUTPATIENT ANCILLARY SERVICE OTHER PASS THROUGH COSTS,APPORTIONMENT OF MEDICAL AND OTHER HEALTH SERVICES,APPORTIONMENT OF MEDICAL AND OTHER HEALTH SERVICES,TRIAL BALANCE OF EXPENSE ACCOUNTS,TRIAL BALANCE OF EXPENSE ACCOUNTS,TRIAL BALANCE OF EXPENSE ACCOUNTS,COST ALLOCATION,COST ALLOCATION,COST ALLOCATION,COST ALLOCATION,ALLOCATION OF NEW CAPITAL COSTS,ALLOCATION OF NEW CAPITAL COSTS,COMPUTATION OF RATIO OF COST TO CHARGES,COMPUTATION OF RATIO OF COST TO CHARGES,INPATIENT ANCILLARY SERVICE COST APPORTIONMENT,INPATIENT ANCILLARY SERVICE COST APPORTIONMENT,INPATIENT ANCILLARY SERVICE COST APPORTIONMENT,INPATIENT ANCILLARY SERVICE COST APPORTIONMENT,INPATIENT ANCILLARY SERVICE COST APPORTIONMENT,INPATIENT ANCILLARY SERVICE COST APPORTIONMENT,INPATIENT ANCILLARY SERVICE COST APPORTIONMENT,INPATIENT ANCILLARY SERVICE COST APPORTIONMENT,INPATIENT ANCILLARY SERVICE COST APPORTIONMENT,INPATIENT ANCILLARY SERVICE COST APPORTIONMENT,INPATIENT ANCILLARY SERVICE COST APPORTIONMENT,INPATIENT ANCILLARY SERVICE COST APPORTIONMENT,INPATIENT ANCILLARY SERVICE COST APPORTIONMENT,INPATIENT ANCILLARY SERVICE COST APPORTIONMENT,Total Inpatient Days/Outpatient Visits,Total Inpatient Days/Outpatient Visits,Total Inpatient Days/Outpatient Visits,RECONCILIATION OF CAPITAL COST CENTERS,TRIAL BALANCE OF EXPENSE ACCOUNTS,TRIAL BALANCE OF EXPENSE ACCOUNTS,TRIAL BALANCE OF EXPENSE ACCOUNTS,TRIAL BALANCE OF EXPENSE ACCOUNTS,TRIAL BALANCE OF EXPENSE ACCOUNTS,TRIAL BALANCE OF EXPENSE ACCOUNTS,TRIAL BALANCE OF EXPENSE ACCOUNTS,TRIAL BALANCE OF EXPENSE ACCOUNTS,TRIAL BALANCE OF EXPENSE ACCOUNTS,TRIAL BALANCE OF EXPENSE ACCOUNTS,TRIAL BALANCE OF EXPENSE ACCOUNTS,TRIAL BALANCE OF EXPENSE ACCOUNTS,TRIAL BALANCE OF EXPENSE ACCOUNTS,COST ALLOCATION,COST ALLOCATION,COST ALLOCATION,COST ALLOCATION,COST ALLOCATION,COST ALLOCATION,COST ALLOCATION,ALLOCATION OF NEW CAPITAL COSTS,ALLOCATION OF NEW CAPITAL COSTS,COMPUTATION OF RATIO OF COST TO CHARGES,COMPUTATION OF RATIO OF COST TO CHARGES,COMPUTATION OF RATIO OF COST TO CHARGES,COMPUTATION OF RATIO OF COST TO CHARGES,COMPUTATION OF RATIO OF COST TO CHARGES,COMPUTATION OF RATIO OF COST TO CHARGES,INPATIENT ANCILLARY SERVICE COST APPORTIONMENT,INPATIENT ANCILLARY SERVICE COST APPORTIONMENT,INPATIENT ANCILLARY SERVICE COST APPORTIONMENT,INPATIENT ANCILLARY SERVICE COST APPORTIONMENT,INPATIENT ANCILLARY SERVICE COST APPORTIONMENT,INPATIENT ANCILLARY SERVICE COST APPORTIONMENT,INPATIENT ANCILLARY SERVICE COST APPORTIONMENT,INPATIENT ANCILLARY SERVICE COST APPORTIONMENT,INPATIENT ANCILLARY SERVICE COST APPORTIONMENT,INPATIENT ANCILLARY SERVICE COST APPORTIONMENT,INPATIENT ANCILLARY SERVICE COST APPORTIONMENT,INPATIENT ANCILLARY SERVICE COST APPORTIONMENT,INPATIENT ANCILLARY SERVICE COST APPORTIONMENT,INPATIENT ANCILLARY SERVICE COST APPORTIONMENT,INPATIENT ANCILLARY SERVICE COST APPORTIONMENT,INPATIENT ANCILLARY SERVICE COST APPORTIONMENT,INPATIENT ANCILLARY SERVICE COST APPORTIONMENT,INPATIENT ANCILLARY SERVICE COST APPORTIONMENT,INPATIENT ANCILLARY SERVICE COST APPORTIONMENT,INPATIENT ANCILLARY SERVICE COST APPORTIONMENT,APPORTIONMENT OF INPATIENT ROUTINE SERVICE CAPITAL COSTS,APPORTIONMENT OF INPATIENT ROUTINE SERVICE OTHER PASS THROUGH COSTS,APPORTIONMENT OF INPATIENT/OUTPATIENT ANCILLARY SERVICE OTHER PASS THROUGH COSTS,APPORTIONMENT OF INPATIENT/OUTPATIENT ANCILLARY SERVICE OTHER PASS THROUGH COSTS,APPORTIONMENT OF INPATIENT/OUTPATIENT ANCILLARY SERVICE OTHER PASS THROUGH COSTS,APPORTIONMENT OF MEDICAL AND OTHER HEALTH SERVICES,APPORTIONMENT OF MEDICAL AND OTHER HEALTH SERVICES,APPORTIONMENT OF MEDICAL AND OTHER HEALTH SERVICES,APPORTIONMENT OF MEDICAL AND OTHER HEALTH SERVICES,APPORTIONMENT OF MEDICAL AND OTHER HEALTH SERVICES,APPORTIONMENT OF MEDICAL AND OTHER HEALTH SERVICES,APPORTIONMENT OF MEDICAL AND OTHER HEALTH SERVICES,APPORTIONMENT OF MEDICAL AND OTHER HEALTH SERVICES,NUMBER OF BEDS,BED DAYS AVAILABLE,Medicaid Inpatient Days/Outpatient Visits,Total Inpatient Days/Outpatient Visits,APPORTIONMENT OF MEDICAL AND OTHER HEALTH SERVICES,APPORTIONMENT OF MEDICAL AND OTHER HEALTH SERVICES,TRIAL BALANCE OF EXPENSE ACCOUNTS,Medicare Inpatient Days/Outpatient Visits,TRIAL BALANCE OF EXPENSE ACCOUNTS,TRIAL BALANCE OF EXPENSE ACCOUNTS,TRIAL BALANCE OF EXPENSE ACCOUNTS,COST ALLOCATION,COST ALLOCATION,ALLOCATION OF NEW CAPITAL COSTS,COMPUTATION OF RATIO OF COST TO CHARGES,COMPUTATION OF RATIO OF COST TO CHARGES,INPATIENT ANCILLARY SERVICE COST APPORTIONMENT,INPATIENT ANCILLARY SERVICE COST APPORTIONMENT,INPATIENT ANCILLARY SERVICE COST APPORTIONMENT,INPATIENT ANCILLARY SERVICE COST APPORTIONMENT,TRIAL BALANCE OF EXPENSE ACCOUNTS,TRIAL BALANCE OF EXPENSE ACCOUNTS,TRIAL BALANCE OF EXPENSE ACCOUNTS,TRIAL BALANCE OF EXPENSE ACCOUNTS,TRIAL BALANCE OF EXPENSE ACCOUNTS,TRIAL BALANCE OF EXPENSE ACCOUNTS,COST ALLOCATION,COST ALLOCATION,COST ALLOCATION,COST ALLOCATION,ALLOCATION OF NEW CAPITAL COSTS,ALLOCATION OF NEW CAPITAL COSTS,COMPUTATION OF RATIO OF COST TO CHARGES,COMPUTATION OF RATIO OF COST TO CHARGES,APPORTIONMENT OF MEDICAL AND OTHER HEALTH SERVICES,APPORTIONMENT OF MEDICAL AND OTHER HEALTH SERVICES,APPORTIONMENT OF MEDICAL AND OTHER HEALTH SERVICES,APPORTIONMENT OF MEDICAL AND OTHER HEALTH SERVICES,APPORTIONMENT OF MEDICAL AND OTHER HEALTH SERVICES,APPORTIONMENT OF MEDICAL AND OTHER HEALTH SERVICES,APPORTIONMENT OF MEDICAL AND OTHER HEALTH SERVICES,APPORTIONMENT OF MEDICAL AND OTHER HEALTH SERVICES,APPORTIONMENT OF MEDICAL AND OTHER HEALTH SERVICES,APPORTIONMENT OF MEDICAL AND OTHER HEALTH SERVICES,APPORTIONMENT OF MEDICAL AND OTHER HEALTH SERVICES,APPORTIONMENT OF MEDICAL AND OTHER HEALTH SERVICES,Total Inpatient Days/Outpatient Visits,Medicare Inpatient Days/Outpatient Visits,Medicaid Inpatient Days/Outpatient Visits,Total Inpatient Days/Outpatient Visits,TRIAL BALANCE OF EXPENSE ACCOUNTS,TRIAL BALANCE OF EXPENSE ACCOUNTS,TRIAL BALANCE OF EXPENSE ACCOUNTS,COST ALLOCATION,COMPUTATION OF RATIO OF COST TO CHARGES,COMPUTATION OF RATIO OF COST TO CHARGES,INPATIENT ANCILLARY SERVICE COST APPORTIONMENT,INPATIENT ANCILLARY SERVICE COST APPORTIONMENT,INPATIENT ANCILLARY SERVICE COST APPORTIONMENT,INPATIENT ANCILLARY SERVICE COST APPORTIONMENT,INPATIENT ANCILLARY SERVICE COST APPORTIONMENT,INPATIENT ANCILLARY SERVICE COST APPORTIONMENT,APPORTIONMENT OF INPATIENT/OUTPATIENT ANCILLARY SERVICE OTHER PASS THROUGH COSTS,APPORTIONMENT OF INPATIENT/OUTPATIENT ANCILLARY SERVICE OTHER PASS THROUGH COSTS,APPORTIONMENT OF MEDICAL AND OTHER HEALTH SERVICES,APPORTIONMENT OF MEDICAL AND OTHER HEALTH SERVICES,APPORTIONMENT OF MEDICAL AND OTHER HEALTH SERVICES,APPORTIONMENT OF MEDICAL AND OTHER HEALTH SERVICES,TRIAL BALANCE OF EXPENSE ACCOUNTS,COST ALLOCATION,COST ALLOCATION,ALLOCATION OF NEW CAPITAL COSTS,COMPUTATION OF RATIO OF COST TO CHARGES,COMPUTATION OF RATIO OF COST TO CHARGES,COMPUTATION OF RATIO OF COST TO CHARGES,INPATIENT ANCILLARY SERVICE COST APPORTIONMENT,INPATIENT ANCILLARY SERVICE COST APPORTIONMENT,APPORTIONMENT OF INPATIENT/OUTPATIENT ANCILLARY SERVICE OTHER PASS THROUGH COSTS,APPORTIONMENT OF INPATIENT/OUTPATIENT ANCILLARY SERVICE OTHER PASS THROUGH COSTS,APPORTIONMENT OF MEDICAL AND OTHER HEALTH SERVICES,APPORTIONMENT OF MEDICAL AND OTHER HEALTH SERVICES,TRIAL BALANCE OF EXPENSE ACCOUNTS,COMPUTATION OF RATIO OF COST TO CHARGES,TRIAL BALANCE OF EXPENSE ACCOUNTS,Medicaid Inpatient Days/Outpatient Visits,COMPUTATION OF RATIO OF COST TO CHARGES,APPORTIONMENT OF INPATIENT/OUTPATIENT ANCILLARY SERVICE OTHER PASS THROUGH COSTS,APPORTIONMENT OF MEDICAL AND OTHER HEALTH SERVICES,APPORTIONMENT OF MEDICAL AND OTHER HEALTH SERVICES,TRIAL BALANCE OF EXPENSE ACCOUNTS,COST ALLOCATION,CALCULATION OF REIMBURSEMENT SETTLEMENT,TRIAL BALANCE OF EXPENSE ACCOUNTS,TRIAL BALANCE OF EXPENSE ACCOUNTS,COMPUTATION OF RATIO OF COST TO CHARGES,TRIAL BALANCE OF EXPENSE ACCOUNTS,APPORTIONMENT OF MEDICAL AND OTHER HEALTH SERVICES,APPORTIONMENT OF MEDICAL AND OTHER HEALTH SERVICES,TRIAL BALANCE OF EXPENSE ACCOUNTS,COMPUTATION OF RATIO OF COST TO CHARGES,COMPUTATION OF RATIO OF COST TO CHARGES,APPORTIONMENT OF MEDICAL AND OTHER HEALTH SERVICES,APPORTIONMENT OF MEDICAL AND OTHER HEALTH SERVICES,APPORTIONMENT OF MEDICAL AND OTHER HEALTH SERVICES,APPORTIONMENT OF MEDICAL AND OTHER HEALTH SERVICES,BED DAYS AVAILABLE,TRIAL BALANCE OF EXPENSE ACCOUNTS,TRIAL BALANCE OF EXPENSE ACCOUNTS,TRIAL BALANCE OF EXPENSE ACCOUNTS,TRIAL BALANCE OF EXPENSE ACCOUNTS,TRIAL BALANCE OF EXPENSE ACCOUNTS,TRIAL BALANCE OF EXPENSE ACCOUNTS,TRIAL BALANCE OF EXPENSE ACCOUNTS,COST ALLOCATION,COST ALLOCATION,COST ALLOCATION,COST ALLOCATION,COST ALLOCATION,COST ALLOCATION,COST ALLOCATION,COST ALLOCATION,COST ALLOCATION,COST ALLOCATION,COST ALLOCATION,COST ALLOCATION,COST ALLOCATION,COST ALLOCATION,COST ALLOCATION,COST ALLOCATION,COST ALLOCATION,COST ALLOCATION,COST ALLOCATION,COST ALLOCATION,COST ALLOCATION,COST ALLOCATION,COST ALLOCATION,COST ALLOCATION,COST ALLOCATION,COST ALLOCATION,COST ALLOCATION,COST ALLOCATION,COST ALLOCATION,COST ALLOCATION,COST ALLOCATION,COST ALLOCATION,COST ALLOCATION,APPORTIONMENT OF INPATIENT/OUTPATIENT ANCILLARY SERVICE OTHER PASS THROUGH COSTS,APPORTIONMENT OF INPATIENT/OUTPATIENT ANCILLARY SERVICE OTHER PASS THROUGH COSTS,APPORTIONMENT OF INPATIENT/OUTPATIENT ANCILLARY SERVICE OTHER PASS THROUGH COSTS,APPORTIONMENT OF INPATIENT/OUTPATIENT ANCILLARY SERVICE OTHER PASS THROUGH COSTS,APPORTIONMENT OF INPATIENT/OUTPATIENT ANCILLARY SERVICE OTHER PASS THROUGH COSTS,APPORTIONMENT OF INPATIENT/OUTPATIENT ANCILLARY SERVICE OTHER PASS THROUGH COSTS,APPORTIONMENT OF INPATIENT/OUTPATIENT ANCILLARY SERVICE OTHER PASS THROUGH COSTS,APPORTIONMENT OF INPATIENT/OUTPATIENT ANCILLARY SERVICE OTHER PASS THROUGH COSTS,APPORTIONMENT OF INPATIENT/OUTPATIENT ANCILLARY SERVICE OTHER PASS THROUGH COSTS,APPORTIONMENT OF INPATIENT/OUTPATIENT ANCILLARY SERVICE OTHER PASS THROUGH COSTS,APPORTIONMENT OF INPATIENT/OUTPATIENT ANCILLARY SERVICE OTHER PASS THROUGH COSTS,APPORTIONMENT OF INPATIENT/OUTPATIENT ANCILLARY SERVICE OTHER PASS THROUGH COSTS,APPORTIONMENT OF INPATIENT/OUTPATIENT ANCILLARY SERVICE OTHER PASS THROUGH COSTS,APPORTIONMENT OF INPATIENT/OUTPATIENT ANCILLARY SERVICE OTHER PASS THROUGH COSTS,APPORTIONMENT OF INPATIENT/OUTPATIENT ANCILLARY SERVICE OTHER PASS THROUGH COSTS,APPORTIONMENT OF INPATIENT/OUTPATIENT ANCILLARY SERVICE OTHER PASS THROUGH COSTS,APPORTIONMENT OF INPATIENT/OUTPATIENT ANCILLARY SERVICE OTHER PASS THROUGH COSTS,APPORTIONMENT OF INPATIENT/OUTPATIENT ANCILLARY SERVICE OTHER PASS THROUGH COSTS,APPORTIONMENT OF INPATIENT/OUTPATIENT ANCILLARY SERVICE OTHER PASS THROUGH COSTS,APPORTIONMENT OF INPATIENT/OUTPATIENT ANCILLARY SERVICE OTHER PASS THROUGH COSTS,APPORTIONMENT OF INPATIENT/OUTPATIENT ANCILLARY SERVICE OTHER PASS THROUGH COSTS,APPORTIONMENT OF INPATIENT/OUTPATIENT ANCILLARY SERVICE OTHER PASS THROUGH COSTS,APPORTIONMENT OF INPATIENT/OUTPATIENT ANCILLARY SERVICE OTHER PASS THROUGH COSTS,APPORTIONMENT OF INPATIENT/OUTPATIENT ANCILLARY SERVICE OTHER PASS THROUGH COSTS,APPORTIONMENT OF INPATIENT/OUTPATIENT ANCILLARY SERVICE OTHER PASS THROUGH COSTS,APPORTIONMENT OF INPATIENT/OUTPATIENT ANCILLARY SERVICE OTHER PASS THROUGH COSTS,APPORTIONMENT OF INPATIENT/OUTPATIENT ANCILLARY SERVICE OTHER PASS THROUGH COSTS,APPORTIONMENT OF INPATIENT/OUTPATIENT ANCILLARY SERVICE OTHER PASS THROUGH COSTS,APPORTIONMENT OF INPATIENT/OUTPATIENT ANCILLARY SERVICE OTHER PASS THROUGH COSTS,APPORTIONMENT OF INPATIENT/OUTPATIENT ANCILLARY SERVICE OTHER PASS THROUGH COSTS,APPORTIONMENT OF INPATIENT/OUTPATIENT ANCILLARY SERVICE OTHER PASS THROUGH COSTS,APPORTIONMENT OF INPATIENT/OUTPATIENT ANCILLARY SERVICE OTHER PASS THROUGH COSTS,APPORTIONMENT OF INPATIENT/OUTPATIENT ANCILLARY SERVICE OTHER PASS THROUGH COSTS,APPORTIONMENT OF INPATIENT/OUTPATIENT ANCILLARY SERVICE OTHER PASS THROUGH COSTS,APPORTIONMENT OF INPATIENT/OUTPATIENT ANCILLARY SERVICE OTHER PASS THROUGH COSTS,APPORTIONMENT OF INPATIENT/OUTPATIENT ANCILLARY SERVICE OTHER PASS THROUGH COSTS,APPORTIONMENT OF INPATIENT/OUTPATIENT ANCILLARY SERVICE OTHER PASS THROUGH COSTS,APPORTIONMENT OF INPATIENT/OUTPATIENT ANCILLARY SERVICE OTHER PASS THROUGH COSTS,APPORTIONMENT OF INPATIENT/OUTPATIENT ANCILLARY SERVICE OTHER PASS THROUGH COSTS,APPORTIONMENT OF INPATIENT/OUTPATIENT ANCILLARY SERVICE OTHER PASS THROUGH COSTS,APPORTIONMENT OF MEDICAL AND OTHER HEALTH SERVICES,APPORTIONMENT OF MEDICAL AND OTHER HEALTH SERVICES,APPORTIONMENT OF MEDICAL AND OTHER HEALTH SERVICES,APPORTIONMENT OF MEDICAL AND OTHER HEALTH SERVICES,APPORTIONMENT OF MEDICAL AND OTHER HEALTH SERVICES,APPORTIONMENT OF MEDICAL AND OTHER HEALTH SERVICES,APPORTIONMENT OF MEDICAL AND OTHER HEALTH SERVICES,APPORTIONMENT OF MEDICAL AND OTHER HEALTH SERVICES,APPORTIONMENT OF MEDICAL AND OTHER HEALTH SERVICES,APPORTIONMENT OF MEDICAL AND OTHER HEALTH SERVICES,APPORTIONMENT OF MEDICAL AND OTHER HEALTH SERVICES,APPORTIONMENT OF MEDICAL AND OTHER HEALTH SERVICES,APPORTIONMENT OF MEDICAL AND OTHER HEALTH SERVICES,APPORTIONMENT OF MEDICAL AND OTHER HEALTH SERVICES,APPORTIONMENT OF MEDICAL AND OTHER HEALTH SERVICES,APPORTIONMENT OF MEDICAL AND OTHER HEALTH SERVICES,Medicare Inpatient Days/Outpatient Visits,Medicaid Inpatient Days/Outpatient Visits,Total Inpatient Days/Outpatient Visits,COST ALLOCATION,ALLOCATION OF NEW CAPITAL COSTS,COMPUTATION OF RATIO OF COST TO CHARGES,APPORTIONMENT OF MEDICAL AND OTHER HEALTH SERVICES,APPORTIONMENT OF MEDICAL AND OTHER HEALTH SERVICES,APPORTIONMENT OF MEDICAL AND OTHER HEALTH SERVICES,APPORTIONMENT OF MEDICAL AND OTHER HEALTH SERVICES,APPORTIONMENT OF MEDICAL AND OTHER HEALTH SERVICES,APPORTIONMENT OF MEDICAL AND OTHER HEALTH SERVICES,TRIAL BALANCE OF EXPENSE ACCOUNTS,TRIAL BALANCE OF EXPENSE ACCOUNTS,COST ALLOCATION,TRIAL BALANCE OF EXPENSE ACCOUNTS,TRIAL BALANCE OF EXPENSE ACCOUNTS,TRIAL BALANCE OF EXPENSE ACCOUNTS,COST ALLOCATION,COST ALLOCATION,ALLOCATION OF NEW CAPITAL COSTS,COMPUTATION OF RATIO OF COST TO CHARGES,COMPUTATION OF RATIO OF COST TO CHARGES,INPATIENT ANCILLARY SERVICE COST APPORTIONMENT,APPORTIONMENT OF INPATIENT ROUTINE SERVICE CAPITAL COSTS,APPORTIONMENT OF INPATIENT ROUTINE SERVICE CAPITAL COSTS,APPORTIONMENT OF INPATIENT ROUTINE SERVICE CAPITAL COSTS,NUMBER OF BEDS,BED DAYS AVAILABLE,Medicare Inpatient Days/Outpatient Visits,Total Inpatient Days/Outpatient Visits,TRIAL BALANCE OF EXPENSE ACCOUNTS,NUMBER OF BEDS,APPORTIONMENT OF MEDICAL AND OTHER HEALTH SERVICES,APPORTIONMENT OF MEDICAL AND OTHER HEALTH SERVICES,INPATIENT ANCILLARY SERVICE COST APPORTIONMENT,INPATIENT ANCILLARY SERVICE COST APPORTIONMENT,INPATIENT ANCILLARY SERVICE COST APPORTIONMENT,INPATIENT ANCILLARY SERVICE COST APPORTIONMENT,INPATIENT ANCILLARY SERVICE COST APPORTIONMENT,INPATIENT ANCILLARY SERVICE COST APPORTIONMENT,INPATIENT ANCILLARY SERVICE COST APPORTIONMENT,INPATIENT ANCILLARY SERVICE COST APPORTIONMENT,INPATIENT ANCILLARY SERVICE COST APPORTIONMENT,INPATIENT ANCILLARY SERVICE COST APPORTIONMENT,APPORTIONMENT OF MEDICAL AND OTHER HEALTH SERVICES,APPORTIONMENT OF MEDICAL AND OTHER HEALTH SERVICES,APPORTIONMENT OF MEDICAL AND OTHER HEALTH SERVICES,APPORTIONMENT OF MEDICAL AND OTHER HEALTH SERVICES,APPORTIONMENT OF MEDICAL AND OTHER HEALTH SERVICES,APPORTIONMENT OF MEDICAL AND OTHER HEALTH SERVICES,APPORTIONMENT OF MEDICAL AND OTHER HEALTH SERVICES,APPORTIONMENT OF MEDICAL AND OTHER HEALTH SERVICES,APPORTIONMENT OF MEDICAL AND OTHER HEALTH SERVICES,APPORTIONMENT OF MEDICAL AND OTHER HEALTH SERVICES,APPORTIONMENT OF MEDICAL AND OTHER HEALTH SERVICES,APPORTIONMENT OF MEDICAL AND OTHER HEALTH SERVICES,APPORTIONMENT OF MEDICAL AND OTHER HEALTH SERVICES,APPORTIONMENT OF MEDICAL AND OTHER HEALTH SERVICES,TRIAL BALANCE OF EXPENSE ACCOUNTS,TRIAL BALANCE OF EXPENSE ACCOUNTS,COST ALLOCATION,COST ALLOCATION,ALLOCATION OF NEW CAPITAL COSTS,COMPUTATION OF RATIO OF COST TO CHARGES,COMPUTATION OF RATIO OF COST TO CHARGES,APPORTIONMENT OF MEDICAL AND OTHER HEALTH SERVICES,APPORTIONMENT OF MEDICAL AND OTHER HEALTH SERVICES,TRIAL BALANCE OF EXPENSE ACCOUNTS,TRIAL BALANCE OF EXPENSE ACCOUNTS,TRIAL BALANCE OF EXPENSE ACCOUNTS,TRIAL BALANCE OF EXPENSE ACCOUNTS,TRIAL BALANCE OF EXPENSE ACCOUNTS,TRIAL BALANCE OF EXPENSE ACCOUNTS,TRIAL BALANCE OF EXPENSE ACCOUNTS,TRIAL BALANCE OF EXPENSE ACCOUNTS,COST ALLOCATION,COST ALLOCATION,COST ALLOCATION,COST ALLOCATION,COST ALLOCATION,COST ALLOCATION,COST ALLOCATION,COST ALLOCATION,COST ALLOCATION,COST ALLOCATION,COST ALLOCATION,COST ALLOCATION,COST ALLOCATION,COST ALLOCATION,ALLOCATION OF NEW CAPITAL COSTS,COMPUTATION OF RATIO OF COST TO CHARGES,COMPUTATION OF RATIO OF COST TO CHARGES,COMPUTATION OF RATIO OF COST TO CHARGES,COMPUTATION OF INPATIENT OPERATING COSTS,INPATIENT ANCILLARY SERVICE COST APPORTIONMENT,INPATIENT ANCILLARY SERVICE COST APPORTIONMENT,INPATIENT ANCILLARY SERVICE COST APPORTIONMENT,INPATIENT ANCILLARY SERVICE COST APPORTIONMENT,INPATIENT ANCILLARY SERVICE COST APPORTIONMENT,INPATIENT ANCILLARY SERVICE COST APPORTIONMENT,INPATIENT ANCILLARY SERVICE COST APPORTIONMENT,INPATIENT ANCILLARY SERVICE COST APPORTIONMENT,INPATIENT ANCILLARY SERVICE COST APPORTIONMENT,INPATIENT ANCILLARY SERVICE COST APPORTIONMENT,APPORTIONMENT OF INPATIENT ROUTINE SERVICE OTHER PASS THROUGH COSTS,APPORTIONMENT OF INPATIENT ROUTINE SERVICE OTHER PASS THROUGH COSTS,APPORTIONMENT OF INPATIENT/OUTPATIENT ANCILLARY SERVICE OTHER PASS THROUGH COSTS,APPORTIONMENT OF INPATIENT/OUTPATIENT ANCILLARY SERVICE OTHER PASS THROUGH COSTS,APPORTIONMENT OF INPATIENT/OUTPATIENT ANCILLARY SERVICE OTHER PASS THROUGH COSTS,APPORTIONMENT OF INPATIENT/OUTPATIENT ANCILLARY SERVICE OTHER PASS THROUGH COSTS,APPORTIONMENT OF INPATIENT/OUTPATIENT ANCILLARY SERVICE OTHER PASS THROUGH COSTS,APPORTIONMENT OF INPATIENT/OUTPATIENT ANCILLARY SERVICE OTHER PASS THROUGH COSTS,APPORTIONMENT OF INPATIENT/OUTPATIENT ANCILLARY SERVICE OTHER PASS THROUGH COSTS,APPORTIONMENT OF INPATIENT/OUTPATIENT ANCILLARY SERVICE OTHER PASS THROUGH COSTS,APPORTIONMENT OF MEDICAL AND OTHER HEALTH SERVICES,APPORTIONMENT OF MEDICAL AND OTHER HEALTH SERVICES,TRIAL BALANCE OF EXPENSE ACCOUNTS,COMPUTATION OF RATIO OF COST TO CHARGES,APPORTIONMENT OF INPATIENT/OUTPATIENT ANCILLARY SERVICE OTHER PASS THROUGH COSTS,APPORTIONMENT OF MEDICAL AND OTHER HEALTH SERVICES,APPORTIONMENT OF MEDICAL AND OTHER HEALTH SERVICES,APPORTIONMENT OF MEDICAL AND OTHER HEALTH SERVICES,APPORTIONMENT OF MEDICAL AND OTHER HEALTH SERVICES,Total Inpatient Days/Outpatient Visits,Total Inpatient Days/Outpatient Visits,Total Inpatient Days/Outpatient Visits,COST ALLOCATION,APPORTIONMENT OF INPATIENT/OUTPATIENT ANCILLARY SERVICE OTHER PASS THROUGH COSTS,APPORTIONMENT OF INPATIENT/OUTPATIENT ANCILLARY SERVICE OTHER PASS THROUGH COSTS,APPORTIONMENT OF INPATIENT/OUTPATIENT ANCILLARY SERVICE OTHER PASS THROUGH COSTS,APPORTIONMENT OF INPATIENT/OUTPATIENT ANCILLARY SERVICE OTHER PASS THROUGH COSTS,APPORTIONMENT OF INPATIENT/OUTPATIENT ANCILLARY SERVICE OTHER PASS THROUGH COSTS,APPORTIONMENT OF INPATIENT/OUTPATIENT ANCILLARY SERVICE OTHER PASS THROUGH COSTS,APPORTIONMENT OF INPATIENT/OUTPATIENT ANCILLARY SERVICE OTHER PASS THROUGH COSTS,APPORTIONMENT OF INPATIENT/OUTPATIENT ANCILLARY SERVICE OTHER PASS THROUGH COSTS,APPORTIONMENT OF INPATIENT/OUTPATIENT ANCILLARY SERVICE OTHER PASS THROUGH COSTS,APPORTIONMENT OF INPATIENT/OUTPATIENT ANCILLARY SERVICE OTHER PASS THROUGH COSTS,APPORTIONMENT OF MEDICAL AND OTHER HEALTH SERVICES,APPORTIONMENT OF MEDICAL AND OTHER HEALTH SERVICES,APPORTIONMENT OF MEDICAL AND OTHER HEALTH SERVICES,APPORTIONMENT OF MEDICAL AND OTHER HEALTH SERVICES,BED DAYS AVAILABLE,TRIAL BALANCE OF EXPENSE ACCOUNTS,COST ALLOCATION,COST ALLOCATION,ALLOCATION OF NEW CAPITAL COSTS,COMPUTATION OF RATIO OF COST TO CHARGES,COMPUTATION OF RATIO OF COST TO CHARGES,INPATIENT ANCILLARY SERVICE COST APPORTIONMENT,INPATIENT ANCILLARY SERVICE COST APPORTIONMENT,APPORTIONMENT OF INPATIENT/OUTPATIENT ANCILLARY SERVICE OTHER PASS THROUGH COSTS,APPORTIONMENT OF INPATIENT/OUTPATIENT ANCILLARY SERVICE OTHER PASS THROUGH COSTS,APPORTIONMENT OF INPATIENT/OUTPATIENT ANCILLARY SERVICE OTHER PASS THROUGH COSTS,APPORTIONMENT OF INPATIENT/OUTPATIENT ANCILLARY SERVICE OTHER PASS THROUGH COSTS,APPORTIONMENT OF INPATIENT/OUTPATIENT ANCILLARY SERVICE OTHER PASS THROUGH COSTS,INPATIENT ANCILLARY SERVICE COST APPORTIONMENT,INPATIENT ANCILLARY SERVICE COST APPORTIONMENT,COMPUTATION OF RATIO OF COST TO CHARGES,INPATIENT ANCILLARY SERVICE COST APPORTIONMENT,INPATIENT ANCILLARY SERVICE COST APPORTIONMENT,APPORTIONMENT OF INPATIENT/OUTPATIENT ANCILLARY SERVICE OTHER PASS THROUGH COSTS,COST ALLOCATION,COMPUTATION OF RATIO OF COST TO CHARGES,TRIAL BALANCE OF EXPENSE ACCOUNTS,TRIAL BALANCE OF EXPENSE ACCOUNTS,TRIAL BALANCE OF EXPENSE ACCOUNTS,INPATIENT ANCILLARY SERVICE COST APPORTIONMENT,INPATIENT ANCILLARY SERVICE COST APPORTIONMENT,INPATIENT ANCILLARY SERVICE COST APPORTIONMENT,INPATIENT ANCILLARY SERVICE COST APPORTIONMENT,INPATIENT ANCILLARY SERVICE COST APPORTIONMENT,INPATIENT ANCILLARY SERVICE COST APPORTIONMENT,APPORTIONMENT OF INPATIENT/OUTPATIENT ANCILLARY SERVICE OTHER PASS THROUGH COSTS,TRIAL BALANCE OF EXPENSE ACCOUNTS,INPATIENT ANCILLARY SERVICE COST APPORTIONMENT,INPATIENT ANCILLARY SERVICE COST APPORTIONMENT,TRIAL BALANCE OF EXPENSE ACCOUNTS,COMPUTATION OF RATIO OF COST TO CHARGES,COMPUTATION OF RATIO OF COST TO CHARGES,COMPUTATION OF RATIO OF COST TO CHARGES,INPATIENT ANCILLARY SERVICE COST APPORTIONMENT,INPATIENT ANCILLARY SERVICE COST APPORTIONMENT,INPATIENT ANCILLARY SERVICE COST APPORTIONMENT,INPATIENT ANCILLARY SERVICE COST APPORTIONMENT,APPORTIONMENT OF MEDICAL AND OTHER HEALTH SERVICES,APPORTIONMENT OF MEDICAL AND OTHER HEALTH SERVICES,INPATIENT ANCILLARY SERVICE COST APPORTIONMENT,INPATIENT ANCILLARY SERVICE COST APPORTIONMENT,INPATIENT ANCILLARY SERVICE COST APPORTIONMENT,INPATIENT ANCILLARY SERVICE COST APPORTIONMENT,INPATIENT ANCILLARY SERVICE COST APPORTIONMENT,INPATIENT ANCILLARY SERVICE COST APPORTIONMENT,INPATIENT ANCILLARY SERVICE COST APPORTIONMENT,APPORTIONMENT OF MEDICAL AND OTHER HEALTH SERVICES,APPORTIONMENT OF MEDICAL AND OTHER HEALTH SERVICES,TRIAL BALANCE OF EXPENSE ACCOUNTS,COST ALLOCATION,COST ALLOCATION,COST ALLOCATION,COST ALLOCATION,COST ALLOCATION,COMPUTATION OF INPATIENT OPERATING COSTS,COMPUTATION OF INPATIENT OPERATING COSTS,INPATIENT ANCILLARY SERVICE COST APPORTIONMENT,INPATIENT ANCILLARY SERVICE COST APPORTIONMENT,APPORTIONMENT OF INPATIENT ROUTINE SERVICE OTHER PASS THROUGH COSTS,APPORTIONMENT OF INPATIENT/OUTPATIENT ANCILLARY SERVICE OTHER PASS THROUGH COSTS,APPORTIONMENT OF INPATIENT/OUTPATIENT ANCILLARY SERVICE OTHER PASS THROUGH COSTS,APPORTIONMENT OF INPATIENT/OUTPATIENT ANCILLARY SERVICE OTHER PASS THROUGH COSTS,APPORTIONMENT OF INPATIENT/OUTPATIENT ANCILLARY SERVICE OTHER PASS THROUGH COSTS,APPORTIONMENT OF INPATIENT/OUTPATIENT ANCILLARY SERVICE OTHER PASS THROUGH COSTS,APPORTIONMENT OF INPATIENT/OUTPATIENT ANCILLARY SERVICE OTHER PASS THROUGH COSTS,APPORTIONMENT OF INPATIENT/OUTPATIENT ANCILLARY SERVICE OTHER PASS THROUGH COSTS,APPORTIONMENT OF INPATIENT/OUTPATIENT ANCILLARY SERVICE OTHER PASS THROUGH COSTS,APPORTIONMENT OF INPATIENT/OUTPATIENT ANCILLARY SERVICE OTHER PASS THROUGH COSTS,APPORTIONMENT OF INPATIENT/OUTPATIENT ANCILLARY SERVICE OTHER PASS THROUGH COSTS,APPORTIONMENT OF INPATIENT/OUTPATIENT ANCILLARY SERVICE OTHER PASS THROUGH COSTS,APPORTIONMENT OF INPATIENT/OUTPATIENT ANCILLARY SERVICE OTHER PASS THROUGH COSTS,APPORTIONMENT OF INPATIENT/OUTPATIENT ANCILLARY SERVICE OTHER PASS THROUGH COSTS,APPORTIONMENT OF INPATIENT/OUTPATIENT ANCILLARY SERVICE OTHER PASS THROUGH COSTS,APPORTIONMENT OF INPATIENT/OUTPATIENT ANCILLARY SERVICE OTHER PASS THROUGH COSTS,APPORTIONMENT OF INPATIENT/OUTPATIENT ANCILLARY SERVICE OTHER PASS THROUGH COSTS,APPORTIONMENT OF INPATIENT/OUTPATIENT ANCILLARY SERVICE OTHER PASS THROUGH COSTS,APPORTIONMENT OF INPATIENT/OUTPATIENT ANCILLARY SERVICE OTHER PASS THROUGH COSTS,APPORTIONMENT OF INPATIENT/OUTPATIENT ANCILLARY SERVICE OTHER PASS THROUGH COSTS,APPORTIONMENT OF INPATIENT/OUTPATIENT ANCILLARY SERVICE OTHER PASS THROUGH COSTS,APPORTIONMENT OF INPATIENT/OUTPATIENT ANCILLARY SERVICE OTHER PASS THROUGH COSTS,APPORTIONMENT OF INPATIENT/OUTPATIENT ANCILLARY SERVICE OTHER PASS THROUGH COSTS,APPORTIONMENT OF INPATIENT/OUTPATIENT ANCILLARY SERVICE OTHER PASS THROUGH COSTS,APPORTIONMENT OF INPATIENT/OUTPATIENT ANCILLARY SERVICE OTHER PASS THROUGH COSTS,APPORTIONMENT OF INPATIENT/OUTPATIENT ANCILLARY SERVICE OTHER PASS THROUGH COSTS,APPORTIONMENT OF INPATIENT/OUTPATIENT ANCILLARY SERVICE OTHER PASS THROUGH COSTS,APPORTIONMENT OF INPATIENT/OUTPATIENT ANCILLARY SERVICE OTHER PASS THROUGH COSTS,APPORTIONMENT OF INPATIENT/OUTPATIENT ANCILLARY SERVICE OTHER PASS THROUGH COSTS,APPORTIONMENT OF INPATIENT/OUTPATIENT ANCILLARY SERVICE OTHER PASS THROUGH COSTS,APPORTIONMENT OF INPATIENT/OUTPATIENT ANCILLARY SERVICE OTHER PASS THROUGH COSTS,APPORTIONMENT OF INPATIENT/OUTPATIENT ANCILLARY SERVICE OTHER PASS THROUGH COSTS,APPORTIONMENT OF INPATIENT/OUTPATIENT ANCILLARY SERVICE OTHER PASS THROUGH COSTS,APPORTIONMENT OF INPATIENT/OUTPATIENT ANCILLARY SERVICE OTHER PASS THROUGH COSTS,APPORTIONMENT OF INPATIENT/OUTPATIENT ANCILLARY SERVICE OTHER PASS THROUGH COSTS,Medicaid Inpatient Days/Outpatient Visits,TRIAL BALANCE OF EXPENSE ACCOUNTS,INPATIENT ANCILLARY SERVICE COST APPORTIONMENT,INPATIENT ANCILLARY SERVICE COST APPORTIONMENT,INPATIENT ANCILLARY SERVICE COST APPORTIONMENT,INPATIENT ANCILLARY SERVICE COST APPORTIONMENT,INPATIENT ANCILLARY SERVICE COST APPORTIONMENT,COST ALLOCATION,COST ALLOCATION,COST ALLOCATION,COST ALLOCATION,COST ALLOCATION,COST ALLOCATION,COST ALLOCATION,TRIAL BALANCE OF EXPENSE ACCOUNTS,INPATIENT ANCILLARY SERVICE COST APPORTIONMENT,APPORTIONMENT OF INPATIENT ROUTINE SERVICE CAPITAL COSTS,APPORTIONMENT OF INPATIENT ROUTINE SERVICE CAPITAL COSTS,APPORTIONMENT OF INPATIENT ROUTINE SERVICE OTHER PASS THROUGH COSTS,APPORTIONMENT OF INPATIENT/OUTPATIENT ANCILLARY SERVICE OTHER PASS THROUGH COSTS,APPORTIONMENT OF INPATIENT/OUTPATIENT ANCILLARY SERVICE OTHER PASS THROUGH COSTS,APPORTIONMENT OF INPATIENT/OUTPATIENT ANCILLARY SERVICE OTHER PASS THROUGH COSTS,Medicare Inpatient Days/Outpatient Visits,INPATIENT ANCILLARY SERVICE COST APPORTIONMENT,INPATIENT ANCILLARY SERVICE COST APPORTIONMENT,TRIAL BALANCE OF EXPENSE ACCOUNTS,COST ALLOCATION,COST ALLOCATION,INPATIENT ANCILLARY SERVICE COST APPORTIONMENT,INPATIENT ANCILLARY SERVICE COST APPORTIONMENT,APPORTIONMENT OF INPATIENT/OUTPATIENT ANCILLARY SERVICE OTHER PASS THROUGH COSTS,APPORTIONMENT OF INPATIENT/OUTPATIENT ANCILLARY SERVICE OTHER PASS THROUGH COSTS,APPORTIONMENT OF MEDICAL AND OTHER HEALTH SERVICES,APPORTIONMENT OF MEDICAL AND OTHER HEALTH SERVICES,COST ALLOCATION,COST ALLOCATION,INPATIENT ANCILLARY SERVICE COST APPORTIONMENT,INPATIENT ANCILLARY SERVICE COST APPORTIONMENT,INPATIENT ANCILLARY SERVICE COST APPORTIONMENT,INPATIENT ANCILLARY SERVICE COST APPORTIONMENT,APPORTIONMENT OF INPATIENT/OUTPATIENT ANCILLARY SERVICE OTHER PASS THROUGH COSTS,APPORTIONMENT OF MEDICAL AND OTHER HEALTH SERVICES,APPORTIONMENT OF MEDICAL AND OTHER HEALTH SERVICES,BED DAYS AVAILABLE,APPORTIONMENT OF INPATIENT/OUTPATIENT ANCILLARY SERVICE OTHER PASS THROUGH COSTS,APPORTIONMENT OF INPATIENT/OUTPATIENT ANCILLARY SERVICE OTHER PASS THROUGH COSTS,TRIAL BALANCE OF EXPENSE ACCOUNTS,APPORTIONMENT OF MEDICAL AND OTHER HEALTH SERVICES,APPORTIONMENT OF MEDICAL AND OTHER HEALTH SERVICES,TRIAL BALANCE OF EXPENSE ACCOUNTS,INPATIENT ANCILLARY SERVICE COST APPORTIONMENT,INPATIENT ANCILLARY SERVICE COST APPORTIONMENT,APPORTIONMENT OF INPATIENT/OUTPATIENT ANCILLARY SERVICE OTHER PASS THROUGH COSTS,TRIAL BALANCE OF EXPENSE ACCOUNTS,TRIAL BALANCE OF EXPENSE ACCOUNTS,TRIAL BALANCE OF EXPENSE ACCOUNTS,INPATIENT ANCILLARY SERVICE COST APPORTIONMENT,INPATIENT ANCILLARY SERVICE COST APPORTIONMENT,INPATIENT ANCILLARY SERVICE COST APPORTIONMENT,INPATIENT ANCILLARY SERVICE COST APPORTIONMENT,APPORTIONMENT OF INPATIENT/OUTPATIENT ANCILLARY SERVICE OTHER PASS THROUGH COSTS,APPORTIONMENT OF INPATIENT/OUTPATIENT ANCILLARY SERVICE OTHER PASS THROUGH COSTS,APPORTIONMENT OF INPATIENT/OUTPATIENT ANCILLARY SERVICE OTHER PASS THROUGH COSTS,APPORTIONMENT OF INPATIENT/OUTPATIENT ANCILLARY SERVICE OTHER PASS THROUGH COSTS,APPORTIONMENT OF INPATIENT/OUTPATIENT ANCILLARY SERVICE OTHER PASS THROUGH COSTS,APPORTIONMENT OF INPATIENT/OUTPATIENT ANCILLARY SERVICE OTHER PASS THROUGH COSTS,APPORTIONMENT OF INPATIENT/OUTPATIENT ANCILLARY SERVICE OTHER PASS THROUGH COSTS,APPORTIONMENT OF INPATIENT/OUTPATIENT ANCILLARY SERVICE OTHER PASS THROUGH COSTS,APPORTIONMENT OF INPATIENT/OUTPATIENT ANCILLARY SERVICE OTHER PASS THROUGH COSTS,APPORTIONMENT OF INPATIENT/OUTPATIENT ANCILLARY SERVICE OTHER PASS THROUGH COSTS,APPORTIONMENT OF INPATIENT/OUTPATIENT ANCILLARY SERVICE OTHER PASS THROUGH COSTS,APPORTIONMENT OF INPATIENT/OUTPATIENT ANCILLARY SERVICE OTHER PASS THROUGH COSTS,COST ALLOCATION,ALLOCATION OF NEW CAPITAL COSTS,COMPUTATION OF RATIO OF COST TO CHARGES,COMPUTATION OF RATIO OF COST TO CHARGES,COMPUTATION OF RATIO OF COST TO CHARGES,COMPUTATION OF RATIO OF COST TO CHARGES,APPORTIONMENT OF INPATIENT/OUTPATIENT ANCILLARY SERVICE OTHER PASS THROUGH COSTS,APPORTIONMENT OF INPATIENT/OUTPATIENT ANCILLARY SERVICE OTHER PASS THROUGH COSTS,INPATIENT ANCILLARY SERVICE COST APPORTIONMENT,INPATIENT ANCILLARY SERVICE COST APPORTIONMENT,COST ALLOCATION,COST ALLOCATION,APPORTIONMENT OF INPATIENT/OUTPATIENT ANCILLARY SERVICE OTHER PASS THROUGH COSTS,APPORTIONMENT OF INPATIENT/OUTPATIENT ANCILLARY SERVICE OTHER PASS THROUGH COSTS,APPORTIONMENT OF INPATIENT/OUTPATIENT ANCILLARY SERVICE OTHER PASS THROUGH COSTS,TRIAL BALANCE OF EXPENSE ACCOUNTS,COST ALLOCATION,COMPUTATION OF RATIO OF COST TO CHARGES,APPORTIONMENT OF INPATIENT/OUTPATIENT ANCILLARY SERVICE OTHER PASS THROUGH COSTS,APPORTIONMENT OF INPATIENT/OUTPATIENT ANCILLARY SERVICE OTHER PASS THROUGH COSTS,APPORTIONMENT OF INPATIENT/OUTPATIENT ANCILLARY SERVICE OTHER PASS THROUGH COSTS,APPORTIONMENT OF INPATIENT/OUTPATIENT ANCILLARY SERVICE OTHER PASS THROUGH COSTS,APPORTIONMENT OF INPATIENT/OUTPATIENT ANCILLARY SERVICE OTHER PASS THROUGH COSTS,TRIAL BALANCE OF EXPENSE ACCOUNTS,BED DAYS AVAILABLE,APPORTIONMENT OF INPATIENT/OUTPATIENT ANCILLARY SERVICE OTHER PASS THROUGH COSTS,APPORTIONMENT OF INPATIENT/OUTPATIENT ANCILLARY SERVICE OTHER PASS THROUGH COSTS,TRIAL BALANCE OF EXPENSE ACCOUNTS,INPATIENT ANCILLARY SERVICE COST APPORTIONMENT,INPATIENT ANCILLARY SERVICE COST APPORTIONMENT,APPORTIONMENT OF MEDICAL AND OTHER HEALTH SERVICES,APPORTIONMENT OF MEDICAL AND OTHER HEALTH SERVICES,APPORTIONMENT OF MEDICAL AND OTHER HEALTH SERVICES,APPORTIONMENT OF MEDICAL AND OTHER HEALTH SERVICES,APPORTIONMENT OF MEDICAL AND OTHER HEALTH SERVICES,APPORTIONMENT OF MEDICAL AND OTHER HEALTH SERVICES,APPORTIONMENT OF MEDICAL AND OTHER HEALTH SERVICES,APPORTIONMENT OF MEDICAL AND OTHER HEALTH SERVICES,APPORTIONMENT OF MEDICAL AND OTHER HEALTH SERVICES,APPORTIONMENT OF MEDICAL AND OTHER HEALTH SERVICES,APPORTIONMENT OF MEDICAL AND OTHER HEALTH SERVICES,APPORTIONMENT OF MEDICAL AND OTHER HEALTH SERVICES,APPORTIONMENT OF INPATIENT/OUTPATIENT ANCILLARY SERVICE OTHER PASS THROUGH COSTS,INPATIENT ANCILLARY SERVICE COST APPORTIONMENT,APPORTIONMENT OF INPATIENT/OUTPATIENT ANCILLARY SERVICE OTHER PASS THROUGH COSTS,APPORTIONMENT OF INPATIENT/OUTPATIENT ANCILLARY SERVICE OTHER PASS THROUGH COSTS,APPORTIONMENT OF INPATIENT/OUTPATIENT ANCILLARY SERVICE OTHER PASS THROUGH COSTS,APPORTIONMENT OF INPATIENT/OUTPATIENT ANCILLARY SERVICE OTHER PASS THROUGH COSTS,APPORTIONMENT OF INPATIENT/OUTPATIENT ANCILLARY SERVICE OTHER PASS THROUGH COSTS,INPATIENT ANCILLARY SERVICE COST APPORTIONMENT,INPATIENT ANCILLARY SERVICE COST APPORTIONMENT,APPORTIONMENT OF INPATIENT/OUTPATIENT ANCILLARY SERVICE OTHER PASS THROUGH COSTS,COMPUTATION OF RATIO OF COST TO CHARGES,INPATIENT ANCILLARY SERVICE COST APPORTIONMENT,APPORTIONMENT OF INPATIENT/OUTPATIENT ANCILLARY SERVICE OTHER PASS THROUGH COSTS,TRIAL BALANCE OF EXPENSE ACCOUNTS,TRIAL BALANCE OF EXPENSE ACCOUNTS,TRIAL BALANCE OF EXPENSE ACCOUNTS,COST ALLOCATION,COST ALLOCATION,ALLOCATION OF NEW CAPITAL COSTS,COMPUTATION OF RATIO OF COST TO CHARGES,COMPUTATION OF RATIO OF COST TO CHARGES,APPORTIONMENT OF MEDICAL AND OTHER HEALTH SERVICES,APPORTIONMENT OF MEDICAL AND OTHER HEALTH SERVICES,Total Inpatient Days/Outpatient Visits,APPORTIONMENT OF INPATIENT/OUTPATIENT ANCILLARY SERVICE OTHER PASS THROUGH COSTS,APPORTIONMENT OF INPATIENT/OUTPATIENT ANCILLARY SERVICE OTHER PASS THROUGH COSTS,APPORTIONMENT OF INPATIENT/OUTPATIENT ANCILLARY SERVICE OTHER PASS THROUGH COSTS,INPATIENT ANCILLARY SERVICE COST APPORTIONMENT,INPATIENT ANCILLARY SERVICE COST APPORTIONMENT,APPORTIONMENT OF INPATIENT/OUTPATIENT ANCILLARY SERVICE OTHER PASS THROUGH COSTS,APPORTIONMENT OF INPATIENT/OUTPATIENT ANCILLARY SERVICE OTHER PASS THROUGH COSTS,COST ALLOCATION,COST ALLOCATION,Total Inpatient Days/Outpatient Visits,COMPUTATION OF RATIO OF COST TO CHARGES,APPORTIONMENT OF INPATIENT/OUTPATIENT ANCILLARY SERVICE OTHER PASS THROUGH COSTS,APPORTIONMENT OF INPATIENT/OUTPATIENT ANCILLARY SERVICE OTHER PASS THROUGH COSTS,APPORTIONMENT OF INPATIENT/OUTPATIENT ANCILLARY SERVICE OTHER PASS THROUGH COSTS,APPORTIONMENT OF INPATIENT/OUTPATIENT ANCILLARY SERVICE OTHER PASS THROUGH COSTS,APPORTIONMENT OF INPATIENT/OUTPATIENT ANCILLARY SERVICE OTHER PASS THROUGH COSTS,APPORTIONMENT OF INPATIENT/OUTPATIENT ANCILLARY SERVICE OTHER PASS THROUGH COSTS,APPORTIONMENT OF INPATIENT/OUTPATIENT ANCILLARY SERVICE OTHER PASS THROUGH COSTS,APPORTIONMENT OF INPATIENT/OUTPATIENT ANCILLARY SERVICE OTHER PASS THROUGH COSTS,APPORTIONMENT OF INPATIENT/OUTPATIENT ANCILLARY SERVICE OTHER PASS THROUGH COSTS,APPORTIONMENT OF INPATIENT/OUTPATIENT ANCILLARY SERVICE OTHER PASS THROUGH COSTS,APPORTIONMENT OF INPATIENT/OUTPATIENT ANCILLARY SERVICE OTHER PASS THROUGH COSTS,APPORTIONMENT OF INPATIENT/OUTPATIENT ANCILLARY SERVICE OTHER PASS THROUGH COSTS,APPORTIONMENT OF INPATIENT/OUTPATIENT ANCILLARY SERVICE OTHER PASS THROUGH COSTS,APPORTIONMENT OF INPATIENT/OUTPATIENT ANCILLARY SERVICE OTHER PASS THROUGH COSTS,APPORTIONMENT OF INPATIENT/OUTPATIENT ANCILLARY SERVICE OTHER PASS THROUGH COSTS,APPORTIONMENT OF INPATIENT/OUTPATIENT ANCILLARY SERVICE OTHER PASS THROUGH COSTS,APPORTIONMENT OF INPATIENT/OUTPATIENT ANCILLARY SERVICE OTHER PASS THROUGH COSTS,APPORTIONMENT OF INPATIENT/OUTPATIENT ANCILLARY SERVICE OTHER PASS THROUGH COSTS,APPORTIONMENT OF INPATIENT/OUTPATIENT ANCILLARY SERVICE OTHER PASS THROUGH COSTS,APPORTIONMENT OF INPATIENT/OUTPATIENT ANCILLARY SERVICE OTHER PASS THROUGH COSTS,APPORTIONMENT OF INPATIENT/OUTPATIENT ANCILLARY SERVICE OTHER PASS THROUGH COSTS,APPORTIONMENT OF INPATIENT/OUTPATIENT ANCILLARY SERVICE OTHER PASS THROUGH COSTS,APPORTIONMENT OF INPATIENT/OUTPATIENT ANCILLARY SERVICE OTHER PASS THROUGH COSTS,APPORTIONMENT OF INPATIENT/OUTPATIENT ANCILLARY SERVICE OTHER PASS THROUGH COSTS,INPATIENT ANCILLARY SERVICE COST APPORTIONMENT,INPATIENT ANCILLARY SERVICE COST APPORTIONMENT,INPATIENT ANCILLARY SERVICE COST APPORTIONMENT,INPATIENT ANCILLARY SERVICE COST APPORTIONMENT,APPORTIONMENT OF INPATIENT/OUTPATIENT ANCILLARY SERVICE OTHER PASS THROUGH COSTS,APPORTIONMENT OF INPATIENT/OUTPATIENT ANCILLARY SERVICE OTHER PASS THROUGH COSTS,APPORTIONMENT OF INPATIENT/OUTPATIENT ANCILLARY SERVICE OTHER PASS THROUGH COSTS,APPORTIONMENT OF INPATIENT/OUTPATIENT ANCILLARY SERVICE OTHER PASS THROUGH COSTS,APPORTIONMENT OF INPATIENT/OUTPATIENT ANCILLARY SERVICE OTHER PASS THROUGH COSTS,INPATIENT ANCILLARY SERVICE COST APPORTIONMENT,INPATIENT ANCILLARY SERVICE COST APPORTIONMENT,INPATIENT ANCILLARY SERVICE COST APPORTIONMENT,INPATIENT ANCILLARY SERVICE COST APPORTIONMENT,APPORTIONMENT OF INPATIENT/OUTPATIENT ANCILLARY SERVICE OTHER PASS THROUGH COSTS,APPORTIONMENT OF INPATIENT/OUTPATIENT ANCILLARY SERVICE OTHER PASS THROUGH COSTS,APPORTIONMENT OF INPATIENT/OUTPATIENT ANCILLARY SERVICE OTHER PASS THROUGH COSTS,COST ALLOCATION,COST ALLOCATION,BED DAYS AVAILABLE,INPATIENT ANCILLARY SERVICE COST APPORTIONMENT,INPATIENT ANCILLARY SERVICE COST APPORTIONMENT,INPATIENT ANCILLARY SERVICE COST APPORTIONMENT,INPATIENT ANCILLARY SERVICE COST APPORTIONMENT,INPATIENT ANCILLARY SERVICE COST APPORTIONMENT,INPATIENT ANCILLARY SERVICE COST APPORTIONMENT,APPORTIONMENT OF INPATIENT/OUTPATIENT ANCILLARY SERVICE OTHER PASS THROUGH COSTS,APPORTIONMENT OF MEDICAL AND OTHER HEALTH SERVICES,APPORTIONMENT OF MEDICAL AND OTHER HEALTH SERVICES,COST ALLOCATION,APPORTIONMENT OF INPATIENT/OUTPATIENT ANCILLARY SERVICE OTHER PASS THROUGH COSTS,APPORTIONMENT OF INPATIENT/OUTPATIENT ANCILLARY SERVICE OTHER PASS THROUGH COSTS,APPORTIONMENT OF INPATIENT/OUTPATIENT ANCILLARY SERVICE OTHER PASS THROUGH COSTS,APPORTIONMENT OF INPATIENT/OUTPATIENT ANCILLARY SERVICE OTHER PASS THROUGH COSTS,APPORTIONMENT OF INPATIENT/OUTPATIENT ANCILLARY SERVICE OTHER PASS THROUGH COSTS,APPORTIONMENT OF INPATIENT/OUTPATIENT ANCILLARY SERVICE OTHER PASS THROUGH COSTS,APPORTIONMENT OF INPATIENT/OUTPATIENT ANCILLARY SERVICE OTHER PASS THROUGH COSTS,APPORTIONMENT OF INPATIENT/OUTPATIENT ANCILLARY SERVICE OTHER PASS THROUGH COSTS,APPORTIONMENT OF INPATIENT/OUTPATIENT ANCILLARY SERVICE OTHER PASS THROUGH COSTS,APPORTIONMENT OF INPATIENT/OUTPATIENT ANCILLARY SERVICE OTHER PASS THROUGH COSTS,APPORTIONMENT OF INPATIENT/OUTPATIENT ANCILLARY SERVICE OTHER PASS THROUGH COSTS,APPORTIONMENT OF INPATIENT/OUTPATIENT ANCILLARY SERVICE OTHER PASS THROUGH COSTS,APPORTIONMENT OF MEDICAL AND OTHER HEALTH SERVICES,APPORTIONMENT OF MEDICAL AND OTHER HEALTH SERVICES,APPORTIONMENT OF INPATIENT/OUTPATIENT ANCILLARY SERVICE OTHER PASS THROUGH COSTS,TRIAL BALANCE OF EXPENSE ACCOUNTS,COST ALLOCATION,COST ALLOCATION,APPORTIONMENT OF INPATIENT/OUTPATIENT ANCILLARY SERVICE OTHER PASS THROUGH COSTS,APPORTIONMENT OF INPATIENT/OUTPATIENT ANCILLARY SERVICE OTHER PASS THROUGH COSTS,BED DAYS AVAILABLE,BED DAYS AVAILABLE,INPATIENT ANCILLARY SERVICE COST APPORTIONMENT,INPATIENT ANCILLARY SERVICE COST APPORTIONMENT,APPORTIONMENT OF INPATIENT/OUTPATIENT ANCILLARY SERVICE OTHER PASS THROUGH COSTS,TRIAL BALANCE OF EXPENSE ACCOUNTS,TRIAL BALANCE OF EXPENSE ACCOUNTS,TRIAL BALANCE OF EXPENSE ACCOUNTS,TRIAL BALANCE OF EXPENSE ACCOUNTS,COST ALLOCATION,COST ALLOCATION,ALLOCATION OF NEW CAPITAL COSTS,COMPUTATION OF RATIO OF COST TO CHARGES,COMPUTATION OF RATIO OF COST TO CHARGES,COMPUTATION OF RATIO OF COST TO CHARGES,APPORTIONMENT OF INPATIENT/OUTPATIENT ANCILLARY SERVICE OTHER PASS THROUGH COSTS,APPORTIONMENT OF INPATIENT/OUTPATIENT ANCILLARY SERVICE OTHER PASS THROUGH COSTS,INPATIENT ANCILLARY SERVICE COST APPORTIONMENT,INPATIENT ANCILLARY SERVICE COST APPORTIONMENT,APPORTIONMENT OF INPATIENT/OUTPATIENT ANCILLARY SERVICE OTHER PASS THROUGH COSTS,COST ALLOCATION,APPORTIONMENT OF INPATIENT/OUTPATIENT ANCILLARY SERVICE OTHER PASS THROUGH COSTS,APPORTIONMENT OF INPATIENT/OUTPATIENT ANCILLARY SERVICE OTHER PASS THROUGH COSTS,APPORTIONMENT OF INPATIENT/OUTPATIENT ANCILLARY SERVICE OTHER PASS THROUGH COSTS,APPORTIONMENT OF INPATIENT/OUTPATIENT ANCILLARY SERVICE OTHER PASS THROUGH COSTS,APPORTIONMENT OF INPATIENT/OUTPATIENT ANCILLARY SERVICE OTHER PASS THROUGH COSTS,APPORTIONMENT OF INPATIENT/OUTPATIENT ANCILLARY SERVICE OTHER PASS THROUGH COSTS,APPORTIONMENT OF INPATIENT/OUTPATIENT ANCILLARY SERVICE OTHER PASS THROUGH COSTS,APPORTIONMENT OF INPATIENT/OUTPATIENT ANCILLARY SERVICE OTHER PASS THROUGH COSTS,APPORTIONMENT OF INPATIENT/OUTPATIENT ANCILLARY SERVICE OTHER PASS THROUGH COSTS,APPORTIONMENT OF INPATIENT/OUTPATIENT ANCILLARY SERVICE OTHER PASS THROUGH COSTS,APPORTIONMENT OF INPATIENT/OUTPATIENT ANCILLARY SERVICE OTHER PASS THROUGH COSTS,APPORTIONMENT OF INPATIENT/OUTPATIENT ANCILLARY SERVICE OTHER PASS THROUGH COSTS,APPORTIONMENT OF MEDICAL AND OTHER HEALTH SERVICES,APPORTIONMENT OF MEDICAL AND OTHER HEALTH SERVICES,APPORTIONMENT OF MEDICAL AND OTHER HEALTH SERVICES,APPORTIONMENT OF MEDICAL AND OTHER HEALTH SERVICES,APPORTIONMENT OF MEDICAL AND OTHER HEALTH SERVICES,APPORTIONMENT OF MEDICAL AND OTHER HEALTH SERVICES,COST ALLOCATION,APPORTIONMENT OF INPATIENT/OUTPATIENT ANCILLARY SERVICE OTHER PASS THROUGH COSTS,APPORTIONMENT OF INPATIENT/OUTPATIENT ANCILLARY SERVICE OTHER PASS THROUGH COSTS,APPORTIONMENT OF MEDICAL AND OTHER HEALTH SERVICES,APPORTIONMENT OF MEDICAL AND OTHER HEALTH SERVICES,APPORTIONMENT OF INPATIENT/OUTPATIENT ANCILLARY SERVICE OTHER PASS THROUGH COSTS,APPORTIONMENT OF INPATIENT/OUTPATIENT ANCILLARY SERVICE OTHER PASS THROUGH COSTS,APPORTIONMENT OF INPATIENT/OUTPATIENT ANCILLARY SERVICE OTHER PASS THROUGH COSTS,COST ALLOCATION,COST ALLOCATION,APPORTIONMENT OF INPATIENT/OUTPATIENT ANCILLARY SERVICE OTHER PASS THROUGH COSTS,COST ALLOCATION,COST ALLOCATION,APPORTIONMENT OF INPATIENT/OUTPATIENT ANCILLARY SERVICE OTHER PASS THROUGH COSTS,COST ALLOCATION,COST ALLOCATION,INPATIENT ANCILLARY SERVICE COST APPORTIONMENT,INPATIENT ANCILLARY SERVICE COST APPORTIONMENT,INPATIENT ANCILLARY SERVICE COST APPORTIONMENT,INPATIENT ANCILLARY SERVICE COST APPORTIONMENT,INPATIENT ANCILLARY SERVICE COST APPORTIONMENT,INPATIENT ANCILLARY SERVICE COST APPORTIONMENT,APPORTIONMENT OF INPATIENT/OUTPATIENT ANCILLARY SERVICE OTHER PASS THROUGH COSTS,APPORTIONMENT OF INPATIENT/OUTPATIENT ANCILLARY SERVICE OTHER PASS THROUGH COSTS,APPORTIONMENT OF INPATIENT/OUTPATIENT ANCILLARY SERVICE OTHER PASS THROUGH COSTS,APPORTIONMENT OF INPATIENT/OUTPATIENT ANCILLARY SERVICE OTHER PASS THROUGH COSTS,APPORTIONMENT OF INPATIENT/OUTPATIENT ANCILLARY SERVICE OTHER PASS THROUGH COSTS,TRIAL BALANCE OF EXPENSE ACCOUNTS,TRIAL BALANCE OF EXPENSE ACCOUNTS,TRIAL BALANCE OF EXPENSE ACCOUNTS,TRIAL BALANCE OF EXPENSE ACCOUNTS,TRIAL BALANCE OF EXPENSE ACCOUNTS,TRIAL BALANCE OF EXPENSE ACCOUNTS,TRIAL BALANCE OF EXPENSE ACCOUNTS,TRIAL BALANCE OF EXPENSE ACCOUNTS,TRIAL BALANCE OF EXPENSE ACCOUNTS,COST ALLOCATION,COST ALLOCATION,COST ALLOCATION,COST ALLOCATION,COST ALLOCATION,COST ALLOCATION,ALLOCATION OF NEW CAPITAL COSTS,ALLOCATION OF NEW CAPITAL COSTS,ALLOCATION OF NEW CAPITAL COSTS,COMPUTATION OF RATIO OF COST TO CHARGES,COMPUTATION OF RATIO OF COST TO CHARGES,COMPUTATION OF RATIO OF COST TO CHARGES,COMPUTATION OF RATIO OF COST TO CHARGES,COMPUTATION OF RATIO OF COST TO CHARGES,COMPUTATION OF RATIO OF COST TO CHARGES,APPORTIONMENT OF INPATIENT/OUTPATIENT ANCILLARY SERVICE OTHER PASS THROUGH COSTS,APPORTIONMENT OF INPATIENT/OUTPATIENT ANCILLARY SERVICE OTHER PASS THROUGH COSTS,APPORTIONMENT OF INPATIENT/OUTPATIENT ANCILLARY SERVICE OTHER PASS THROUGH COSTS,INPATIENT ANCILLARY SERVICE COST APPORTIONMENT,INPATIENT ANCILLARY SERVICE COST APPORTIONMENT,COST ALLOCATION,BED DAYS AVAILABLE,BED DAYS AVAILABLE,APPORTIONMENT OF INPATIENT/OUTPATIENT ANCILLARY SERVICE OTHER PASS THROUGH COSTS,APPORTIONMENT OF INPATIENT/OUTPATIENT ANCILLARY SERVICE OTHER PASS THROUGH COSTS,APPORTIONMENT OF INPATIENT/OUTPATIENT ANCILLARY SERVICE OTHER PASS THROUGH COSTS,APPORTIONMENT OF INPATIENT/OUTPATIENT ANCILLARY SERVICE OTHER PASS THROUGH COSTS,Total Inpatient Days/Outpatient Visits,APPORTIONMENT OF MEDICAL AND OTHER HEALTH SERVICES,APPORTIONMENT OF MEDICAL AND OTHER HEALTH SERVICES,APPORTIONMENT OF INPATIENT/OUTPATIENT ANCILLARY SERVICE OTHER PASS THROUGH COSTS,APPORTIONMENT OF INPATIENT/OUTPATIENT ANCILLARY SERVICE OTHER PASS THROUGH COSTS,APPORTIONMENT OF INPATIENT/OUTPATIENT ANCILLARY SERVICE OTHER PASS THROUGH COSTS,APPORTIONMENT OF INPATIENT/OUTPATIENT ANCILLARY SERVICE OTHER PASS THROUGH COSTS,FFY,,,,,CALCULATION OF REIMBURSEMENT SETTLEMENT (PPS),CALCULATION OF REIMBURSEMENT SETTLEMENT (PPS),CALCULATION OF REIMBURSEMENT SETTLEMENT (PPS),CALCULATION OF REIMBURSEMENT SETTLEMENT (PPS),CALCULATION OF REIMBURSEMENT SETTLEMENT (PPS),CALCULATION OF REIMBURSEMENT SETTLEMENT (PPS),CALCULATION OF REIMBURSEMENT SETTLEMENT (PPS),CALCULATION OF REIMBURSEMENT SETTLEMENT (PPS),CALCULATION OF REIMBURSEMENT SETTLEMENT (PPS),CALCULATION OF REIMBURSEMENT SETTLEMENT (PPS),Name and Num
,Curated Name and Num,"Hospital type, text","Control type, text",Lon,Lat,Report Record Number (RPT_REC_NUM),Hospital Provider Number (PRVDR_NUM),Fiscal Intermediary Number (FI_NUM),Report Status Code (RPT_STUS_CD),Fiscal Intermediary/MAC Create Date (FI_CREAT_DT),Fiscal Year Begin Date (FY_BGN_DT),Fiscal Year End Date (FY_END_DT),Utilization Code (L/N/F) (UTIL_CODE),NOT IN THIS FILE (TRNSMTL_NUM),SSA State Code (STATE),SSA State County Code (ST_CTY_CD),Census Division Code (CENSUS),CMS Region Code (REGION),Geographic MSA (MSA),Utilization Review SNF (A_C1_114),Utilization Review SNF (A_C2_114),PBP Clinical Lab Services Program Only (A_C2_61),Int & Res (non approved teaching program (B_1_C21_100),Home Program Dialysis (B_1_C21_94),Int & Res (non approved teaching program (B_1_C22_100),"Allocation of Interns & Residents Program Costs, Subprovider I (B_1_C22_42)",Home Program Dialysis (B_1_C22_94),Cross Foot Adjustments (B_1_C26_200),Int & Res (non approved teaching program (C_1_C6_100),Int & Res (non approved teaching program (C_1_C7_100),Islet Acquisition (C_1_C7_111),Subprovider I (D3_HOS_C2_42),Nursery (D3_HOS_C2_43),PBP Clinical Lab Services Program Only (D3_HOS_C2_61),PBP Clinical Lab Services Program Only (D3_HOS_C3_61),Subprovider I (D3_IPF_C2_42),Home Program Dialysis (D3_IPF_C2_94),Home Program Dialysis (D3_IPF_C3_94),PBP Clinical Lab Services Program Only (D3_IRF_C2_61),Home Program Dialysis (D3_IRF_C2_94),PBP Clinical Lab Services Program Only (D3_IRF_C3_61),Home Program Dialysis (D3_IRF_C3_94),Subprovider-IPF (D3_SNF_C2_40),Subprovider-IRF (D3_SNF_C2_41),Subprovider II (D_1_HOS_C4_4201),Home Program Dialysis (D_4_HOS_C12_94),Renal Dialysis (D_4_HOS_C4_74),Total (D_4_SNF_C13_200),"PPS REIMBURSED SERVICES -  CHARGES, Home Program Dialysis (D_5_HOS_C2_94)","COST REIMBURSED SERVICES SUBJECT TO DEDUCTIBLES  AND COINSURANCE - CHARGES, PBP Clinical Lab Services Program Only (D_5_HOS_C3_61)","COST REIMBURSED SERVICES NOT SUBJECT TO DEDUCTIBLES AND COINSURANCE - CHARGES, Home Program Dialysis (D_5_HOS_C4_94)","COST SERVICES SUBJECT TO DEDUCTIBLES AND COINSURANCE - COST, PBP Clinical Lab Services Program Only (D_5_HOS_C6_61)","COST SERVICES NOT SUBJECT TO DEDUCTIBLES AND COINSURANCE - COST, Home Program Dialysis (D_5_HOS_C7_94)",OPPS payments (E_B_HOS_C101_3),Outlier payments (E_B_HOS_C101_4),Line 2 times line 5 (E_B_HOS_C101_6),"Sum of lines 3,4 divided by line 6 (E_B_HOS_C101_7)",Transitional corridor payment (E_B_HOS_C101_8),Partial or full credits from manufacturers (E_B_HOS_C1_3998),Sequestration adjustment (E_B_HOS_C1_4001),Total Subprovider II Interns & Residents (S3_1_C10_1801),Subprovider 2 (S3_1_C2_1801),Labor and Delivery (S3_1_C2_32),Subprovider 2 (S3_1_C3_1801),Labor and Delivery (S3_1_C3_32),SNF (S3_1_C5_19),NF (S3_1_C5_20),Subprovider 2 (S3_1_C7_1801),Subprovider 2 (S3_1_C8_1801),Total Subprovider I Interns & Residents (S3_1_C9_18),"AMOUNT REPORTED, Home Office Salaries (S3_2_C2_1401)","AMOUNT REPORTED, Related  Salaries (S3_2_C2_1402)","AMOUNT REPORTED, Interns & Residents (S3_2_C2_2550)","AMOUNT REPORTED, Interns & Residents (S3_2_C2_2551)","AMOUNT REPORTED, Interns & Residents (S3_2_C2_2552)","AMOUNT REPORTED, Interns & Residents (S3_2_C2_2553)","AMOUNT REPORTED, Home Office Salaries (S3_2_C3_1401)","AMOUNT REPORTED, Related Salaries (S3_2_C3_1402)","AMOUNT REPORTED, Wage Related Costs RHC/FQHC (S3_2_C3_24)","AMOUNT REPORTED, Interns & Residents (S3_2_C3_2550)","AMOUNT REPORTED, Interns & Residents (S3_2_C3_2551)","AMOUNT REPORTED, Interns & Residents (S3_2_C3_2552)","AMOUNT REPORTED, Interns & Residents (S3_2_C3_2553)","ADJUSTED SALARIES, Home Office Salaries (S3_2_C4_1401)","ADJUSTED SALARIES, Related Salaries (S3_2_C4_1402)","ADJUSTED SALARIES, Teaching Physician Salaries (S3_2_C4_1601)","ADJUSTED SALARIES, Teaching Physician Salaries (S3_2_C4_1602)","ADJUSTED SALARIES, Interns & Residents (S3_2_C4_2550)","ADJUSTED SALARIES, Interns & Residents (S3_2_C4_2551)","ADJUSTED SALARIES, Interns & Residents (S3_2_C4_2552)","ADJUSTED SALARIES, Interns & Residents (S3_2_C4_2553)","AVERAGE HOURLY WAGE, Home Office Salaries (S3_2_C6_1401)","AVERAGE HOURLY WAGE, Related Salaries (S3_2_C6_1402)","HHA II, Without Outliers:  Other Charges (S4_HHA2_C1_34)","HHA II, With Outliers:  Other Charges (S4_HHA2_C2_34)","HHA II, With Outliers:  Non Routine Med Sup Chgs (S4_HHA2_C2_38)","HHA II, LUPA Episodes:  Other Charges (S4_HHA2_C3_34)","HHA II, PEP Episodes:  Other Charges (S4_HHA2_C4_34)","HHA II, PEP:  Total Number of Outlier Episodes (S4_HHA2_C4_37)","HHA II, Total Other Charges (S4_HHA2_C5_34)","HHA III, Without Outliers:  Total Visits (S4_HHA3_C1_33)","HHA III, Without Outliers:  Other Charges (S4_HHA3_C1_34)","HHA III, Without Outliers:  Total Charges (S4_HHA3_C1_35)","HHA III, W/Out Outliers:  Number of Episodes (S4_HHA3_C1_36)","HHA III, Without Outliers:  Non Routine Med Sup Chgs (S4_HHA3_C1_38)","HHA III, With Outliers:  Total Visits (S4_HHA3_C2_33)","HHA III, With Outliers:  Other Charges (S4_HHA3_C2_34)","HHA III, With Outliers:  Total Charges (S4_HHA3_C2_35)","HHA III, With Outliers:  Number of Episodes (S4_HHA3_C2_37)","HHA III, With Outliers:  Non Routine Med Sup Chgs (S4_HHA3_C2_38)","HHA III, LUPA Episodes:  Total Visits (S4_HHA3_C3_33)","HHA III, LUPA Episodes:  Other Charges (S4_HHA3_C3_34)","HHA III, Total Charges:  LUPA Episodes (S4_HHA3_C3_35)","HHA III, LUPA Episodes:  Total Number of Episodes (S4_HHA3_C3_36)","HHA III, LUPA:  Total Non Routine Med Sup Chgs (S4_HHA3_C3_38)","HHA III, PEP Episodes:  Total Visits (S4_HHA3_C4_33)","HHA III, PEP Episodes:  Other Charges (S4_HHA3_C4_34)","HHA III, PEP Episodes:  Total Charges: (S4_HHA3_C4_35)","HHA III, PEP Episodes:  Total Number of Episodes (S4_HHA3_C4_36)","HHA III, PEP:  Total Number of Outlier Episodes (S4_HHA3_C4_37)","HHA III, PEP:  Total Non Routine Med Supply Chgs (S4_HHA3_C4_38)","HHA III, Total Visits (S4_HHA3_C5_33)","HHA III, Total Other Charges (S4_HHA3_C5_34)","HHA III, Total Charges (S4_HHA3_C5_35)","HHA III, Total Number of Episodes (S4_HHA3_C5_36)","HHA III, Total Number of Outlier Episodes (S4_HHA3_C5_37)","HHA III, Total Non Routine Medical  Supply Charges (S4_HHA3_C5_38)","Column 1 (Beginning Balances), Total (A7_1_C1_10)","Column 1 (Beginning Balances), Building Improvements (A7_1_C1_4)","Column 1 (Beginning Balances), Fixed Equipment (A7_1_C1_5)","Column 1 (Beginning Balances), Movable Equipment (A7_1_C1_6)","Column 1 (Beginning Balances), Subtotal (A7_1_C1_8)","Column 2 (Purchases), Total (A7_1_C2_10)","Column 2 (Purchases), Fixed Equipment (A7_1_C2_5)","Column 2 (Purchases), Movable Equipment (A7_1_C2_6)","Column 2 (Purchases), Subtotal (A7_1_C2_8)","Column 7 (Fully Depreciated Assets), Total (A7_1_C7_10)","Column 5 (Disposals and Retirements), Fixed Equipment (A7_1_C7_5)","Column 5 (Disposals and Retirements), Movable Equipment (A7_1_C7_6)","Column 7 (Fully Depreciated Assets), Subtotal (A7_1_C7_8)","Column 10 (Lease), Total (A7_3_C10_3)","Column 15 (Total), Total (A7_3_C15_3)","Column 9 (Depreciation), Total (A7_3_C9_3)",Cafeteria employees and guests (A8_C2_14),Sale of medical records and abstracts (A8_C2_18),"Trade, Quantity, and Time Discounts (A8_C2_4)",Refunds and Rebates of Expenses (A8_C2_5),Total (A8_C2_50),Total Salaries (A_C1_200),Adults and Pediatrics (A_C1_30),Total Salaries (A_C2_200),Adults and Pediatrics (A_C2_30),Renal Dialysis (A_C2_74),Total Salaries (A_C6_200),Adults and Pediatrics (A_C6_30),"Net Expense for Cost Allocation, Total (B_1_C0_200)","Net Expense for Cost Allocation, Adults and Pediatrics (B_1_C0_30)","Net Expense for Cost Allocation, Renal Dialysis (B_1_C0_74)",Total (B_1_C26_202),Adults and Pediatrics (B_1_C26_30),Renal Dialysis (B_1_C26_74),Total (B_2_C26_202),"TOTAL CAPITAL COSTS AFTER COST ALLOCATION, Adults & Pediatrics (B_2_C26_30)",Renal Dialysis (B_2_C26_74),Total Costs (C_1_C3_202),Subtotal (C_1_C5_200),Total (C_1_C5_202),Adults & Pediatrics (C_1_C5_30),Renal Dialysis (C_1_C5_74),Total (C_1_C6_202),"Total Inpatient Charges, Adults & Pediatrics (C_1_C6_30)",Renal Dialysis (C_1_C6_74),Total Charges (C_1_C8_202),"General Inpatient Routine Service Cost, net of Swing Bed Cost (D1_HOS_C1_27)","General Inpatient Routine Service Cost, net of Swing Bed and Private Room Diff (D1_HOS_C1_37)",Total Program General Inpatient Routine (D1_HOS_C1_41),Program Inpatient Ancillary Service Cost (D1_HOS_C1_48),Total Program Inpatient Costs (D1_HOS_C1_49),Pass through Cost for Program Inpatient Routine (D1_HOS_C1_50),Pass Through Cost for  Program Ancillary (D1_HOS_C1_51),Total Program Excludable Costs (D1_HOS_C1_52),"Total Program Inpatient Operating Cost excluding Capital Related, Nonphysician, Anesthetist, and Medical Education Costs (D1_HOS_C1_53)",Adults and Pediatrics (D3_HOS_C2_30),Renal Dialysis (D3_HOS_C2_74),TOTAL (D3_HOS_C3_200),Renal Dialysis (D3_HOS_C3_74),Total (D_1_HOS_C4_200),Adults & Pediatrics (D_1_HOS_C4_30),Total (D_1_HOS_C6_200),Adults & Pediatrics (D_1_HOS_C6_30),Total (D_1_HOS_C7_200),Adults & Pediatrics (D_1_HOS_C7_30),Total Patient Days (D_3_HOS_C6_200),Total Inpatient Program Days (D_3_HOS_C8_200),Cost To Charge Ratio (S10_C1_1),Total Bad Debt expense (S10_C1_26),Medicare reimbursable bad debts for the entire hospital complex (S10_C1_27),Cost of Uncompensated Care (S10_C1_30),Total unreimbursed and uncompensated care (S10_C1_31),Charity care charges and uninsured discounts for the entire facility (S10_C2_20),Cost of patients approved for charity care and uninsured discounts (S10_C2_21),Cost of charity care (patients covered by public program + patients w/ coverage accepted by provider) (S10_C2_23),Charity care charges and uninsured discounts for the entire facility (S10_C3_20),Cost of patients approved for charity care and uninsured discounts (S10_C3_21),Cost of charity care (S10_C3_23),Urban/Rural Indicator at beginning (S2_1_C1_26),Urban (1) or Rural (2) (S2_1_C1_27),Hospital Type (S2_1_C4_3),Total Hospital Interns & Residents (S3_1_C10_14),Total Facility FTEs (S3_1_C10_27),Title XVIII discharges (S3_1_C13_1),Title XVIII discharges (S3_1_C13_14),Total discharges (S3_1_C15_1),Total discharges (S3_1_C15_14),Hospital Adults & Pediatrics (S3_1_C2_1),Total Hospital (S3_1_C2_14),Total Facility (S3_1_C2_27),Total (S3_1_C2_7),Hospital Adults & Pediatrics (S3_1_C3_1),Total Hospital (S3_1_C3_14),Total Hospital (S3_1_C3_7),Hospital Adults & Pediatrics (S3_1_C6_1),Total Hospital (S3_1_C6_14),Total Adults & Peds (S3_1_C6_7),Hospital Adults & Pediatrics (S3_1_C8_1),Total Hospital (S3_1_C8_14),Total Adults & Pediatrics (S3_1_C8_7),"Column 1 (Beginning Balances), Land (A7_1_C1_1)","Column 1 (Beginning Balances), Buildings and Fixtures (A7_1_C1_3)","Column 2 (Purchases), Buildings and Fixtures (A7_1_C2_3)","Column 11 (Interest), Total (A7_3_C11_3)","Column 7 (Other Capital Related Costs), Total (A7_3_C7_3)",Investment Income-New Bldgs & Fixtures (A8_C2_1),Provider-based physician adjustment (A8_C2_10),Related Organization Transactions (A8_C2_12),Investment Income-Other (A8_C2_3),Subprovider-IPF (A_C1_40),Interest Expense (A_C2_113),Other Capital (A_C2_3),Subprovider-IPF (A_C2_40),"Net Expense for Cost Allocation, Subprovider-IPF (B_1_C0_40)",Subprovider-IPF (B_1_C26_40),"TOTAL CAPITAL COSTS AFTER COST ALLOCATION, Subprovider-IPF (B_2_C26_40)",Subprovider-IPF (C_1_C5_40),"Total Inpatient Charges, Subprovider-IPF (C_1_C6_40)",Total (C_1_C7_202),"General Inpatient Routine Service Cost, net of Swing Bed Cost (D1_IPF_C1_27)","General Inpatient Routine Service Cost, net of Swing Bed and Private Room Diff (D1_IPF_C1_37)",Total Program General Inpatient Routine (D1_IPF_C1_41),Total Program Inpatient Costs (D1_IPF_C1_49),Pass through Cost for Program Inpatient (D1_IPF_C1_50),Total Program Excludable Costs (D1_IPF_C1_52),"Total Program Inpatient Operating Cost excluding Capital Related, Nonphysician, Anesthetist, and Medical Education Costs (D1_IPF_C1_53)",Subprovider-IPF (D3_IPF_C2_40),Subprovider-IPF (D_1_HOS_C4_40),Subprovider-IPF (D_1_HOS_C6_40),Subprovider-IPF (D_1_HOS_C7_40),Ratio of line 15 to line 16 (E_B_HOS_C1_17),Title XIX discharges (S3_1_C14_1),Title XIX discharges (S3_1_C14_14),Title XIX discharges (S3_1_C14_16),Total discharges (S3_1_C15_16),IPF (S3_1_C2_16),IPF (S3_1_C3_16),IPF (S3_1_C6_16),Hospital Adults & Pediatrics (S3_1_C7_1),Total Hospital (S3_1_C7_14),IPF (S3_1_C7_16),Total Adults & Peds (S3_1_C7_7),IPF (S3_1_C8_16),"AMOUNT REPORTED, Total Salaries (S3_2_C2_1)","AMOUNT REPORTED, Excluded Area Salaries (S3_2_C2_10)","AMOUNT REPORTED, Administrative and General (S3_2_C2_27)","AMOUNT REPORTED, Operation of Plant (S3_2_C2_30)","AMOUNT REPORTED, Housekeeping (S3_2_C2_32)","AMOUNT REPORTED, Dietary (S3_2_C2_34)","AMOUNT REPORTED, Nursing Administration (S3_2_C2_38)","AMOUNT REPORTED, Medical Records & Med Records Library (S3_2_C2_41)","AMOUNT REPORTED, Other General Service (S3_2_C2_43)","AMOUNT REPORTED, Net Salaries (S3_3_C2_1)","AMOUNT REPORTED, Excluded Area Salaries (S3_3_C2_2)","AMOUNT REPORTED, Subtotal Salaries (S3_3_C2_3)","AMOUNT REPORTED, Total (S3_3_C2_6)","ADJUSTED SALARIES, Net Salaries (S3_3_C4_1)","ADJUSTED SALARIES, Excluded Area Salaries (S3_3_C4_2)","ADJUSTED SALARIES, Subtotal Salaries (S3_3_C4_3)","ADJUSTED SALARIES, Total (S3_3_C4_6)","ADJUSTED SALARIES, Total Overhead Costs (S3_3_C4_7)",Negative Cost Centers (B_1_C26_201),Total (D_4_HOS_C12_200),"PPS REIMBURSED SERVICES -  CHARGES, Total (D_5_HOS_C2_200)","PPS SERVICES COST, Total (D_5_HOS_C5_200)",Medical and Other Services reimbursed by OPPS (E_B_HOS_C1_2),Total prospective payment (E_B_HOS_C1_24),Deductibles and coinsurance related to line 24 (E_B_HOS_C1_26),Subtotal (E_B_HOS_C1_27),OPPS payments (E_B_HOS_C1_3),Subtotal (E_B_HOS_C1_30),Subtotal (E_B_HOS_C1_32),Allowable bad debts (E_B_HOS_C1_34),Adjusted reimburseable bad debts (E_B_HOS_C1_35),Allowable bad debts for dual eligibles beneficiaries (E_B_HOS_C1_36),Subtotal (E_B_HOS_C1_37),Subtotal (E_B_HOS_C1_40),Interim payments (E_B_HOS_C1_41),Balance due provider/program (E_B_HOS_C1_43),"Column 1 (Beginning Balances), Land Improvements (A7_1_C1_2)","Column 5 (Disposals and Retirements), Total (A7_1_C5_10)","Column 5 (Disposals and Retirements), Movable Equipment (A7_1_C5_6)","Column 5 (Disposals and Retirements), Subtotal (A7_1_C5_8)","Column 5 (Disposals and Retirements), Land Improvements (A7_1_C7_2)","Column 5 (Disposals and Retirements), Buildings and Fixtures (A7_1_C7_3)","Column 5 (Disposals and Retirements), Building Improvements (A7_1_C7_4)",Depreciation-New Bldgs & Fixtures (A8_C2_26),Depreciation-New Movable Equipment (A8_C2_27),"TOTAL CAPITAL COSTS AFTER COST ALLOCATION, Total Directly Assigned New Cap Rel Csts (B_2_C0_202)",Total Hospital Interns & Residents (S3_1_C11_14),Total Facility FTEs (S3_1_C11_27),"AMOUNT REPORTED, Employee Benefits (S3_2_C2_26)","AMOUNT REPORTED, Maintenance and Repairs (S3_2_C2_29)","AMOUNT REPORTED, Laundry and Linen Service (S3_2_C2_31)","AMOUNT REPORTED, Pharmacy (S3_2_C2_40)","AMOUNT REPORTED, Social Service (S3_2_C2_42)","ADJUSTED SALARIES, Total Salaries (S3_2_C4_1)","ADJUSTED SALARIES, Excluded Area Salaries (S3_2_C4_10)","ADJUSTED SALARIES, Employee Benefits (S3_2_C4_26)","ADJUSTED SALARIES, Administrative and General (S3_2_C4_27)","ADJUSTED SALARIES, Admin & Gen Under Contract (S3_2_C4_29)","ADJUSTED SALARIES, Operation of Plant (S3_2_C4_30)","ADJUSTED SALARIES, Laundry and Linen Service (S3_2_C4_31)","ADJUSTED SALARIES, Housekeeping (S3_2_C4_32)","ADJUSTED SALARIES, Dietary (S3_2_C4_34)","ADJUSTED SALARIES, Nursing Administration (S3_2_C4_38)","ADJUSTED SALARIES, Pharmacy (S3_2_C4_40)","ADJUSTED SALARIES, Medical Records & Med Records Library (S3_2_C4_41)","ADJUSTED SALARIES, Social Service (S3_2_C4_42)","PAID HOURS RELATED TO SALARIES, Total Salaries (S3_2_C5_1)","AVERAGE HOURLY WAGE, Total Salaries (S3_2_C6_1)","PAID HOURS RELATED TO SALARIES, Net Salaries (S3_3_C5_1)","PAID HOURS RELATED TO SALARIES, Subtotal Salaries (S3_3_C5_3)","AVERAGE HOURLY WAGE, Net Salaries (S3_3_C6_1)","AVERAGE HOURLY WAGE, Subtotal Salaries (S3_3_C6_3)","AVERAGE HOURLY WAGE, Total (S3_3_C6_6)","Allocation of Interns & Residents Salary and Fringes, Adults and Pediatrics (B_1_C21_30)","Allocation of Interns & Residents Program Costs, Adults and Pediatrics (B_1_C22_30)",Cross Foot Adjustments (B_2_C26_200),interns and residents (E_B_HOS_C1_28),Tentative settlement (E_B_HOS_C1_42),Total Hospital Interns & Residents (S3_1_C9_14),Total Facility FTEs (S3_1_C9_27),"Column 2 (Purchases), Building Improvements (A7_1_C2_4)","Column 5 (Disposals and Retirements), Building Improvements (A7_1_C5_4)","Net Expense for Cost Allocation, Nursery (B_1_C0_43)",Nursery (B_1_C26_43),"TOTAL CAPITAL COSTS AFTER COST ALLOCATION, Nursery (B_2_C26_43)",Less Observation Beds (C_1_C5_201),Nursery (C_1_C5_43),"Total Inpatient Charges, Nursery (C_1_C6_43)",Nursery (D_1_HOS_C4_43),Total unreimbursed cost for Medicaid and CHIP and state and local indigent care programs (S10_C1_19),Net Revenue from Medicaid (S10_C1_2),Charity care charges and uninsured discounts for the entire facility (S10_C1_20),Cost of patients approved for charity care and uninsured discounts (S10_C1_21),Cost of charity care (uninsured patients + patients w/ coverage not accepted by provider) (S10_C1_23),Medicaid charges (S10_C1_6),Nursery (S3_1_C7_13),Nursery (S3_1_C8_13),Medicaid Observation Days (S3_1_C8_28),"AMOUNT REPORTED, Wage Related Costs Core (S3_2_C2_17)","AMOUNT REPORTED, Wage Related Costs Other (S3_2_C2_18)","AMOUNT REPORTED, Non-Physician Anesthetist Part B (S3_2_C2_21)","ADJUSTED SALARIES, Wage Related Costs Core (S3_2_C4_17)","ADJUSTED SALARIES, Wage Related Costs Other (S3_2_C4_18)","ADJUSTED SALARIES, Non-Physician Anesthetist Part B (S3_2_C4_21)","PAID HOURS RELATED TO SALARIES, Administrative and General (S3_2_C5_27)","AVERAGE HOURLY WAGE, Administrative and General (S3_2_C6_27)","AMOUNT REPORTED, Subtotal Wage Related Csts (S3_3_C2_5)","ADJUSTED SALARIES, Subtotal Wage Related Csts (S3_3_C4_5)","PAID HOURS RELATED TO SALARIES, Total Overhead Costs (S3_3_C5_7)","AVERAGE HOURLY WAGE, Subtotal Wage Related Csts (S3_3_C6_5)","AVERAGE HOURLY WAGE, Total Overhead Costs (S3_3_C6_7)",Parking Lot (A8_C2_9),"Column 5 (Insurance), Total (A7_3_C5_3)",Rental of quarters to employee and oths (A8_C2_15),NF (A_C2_45),NF (A_C6_45),"Net Expense for Cost Allocation, NF (B_1_C0_45)",NF (B_1_C26_45),"TOTAL CAPITAL COSTS AFTER COST ALLOCATION, NF (B_2_C26_45)",NF (C_1_C5_45),"Total Inpatient Charges, NF (C_1_C6_45)","Column 6 (Taxes), Total (A7_3_C6_3)",Vending Machines (A8_C2_20),Telephone Services (A8_C2_7),Television and Radio Service (A8_C2_8),Renal Dialysis (C_1_C7_74),"COST REIMBURSED SERVICES SUBJECT TO DEDUCTIBLES  AND COINSURANCE - CHARGES, Total (D_5_HOS_C3_200)","COST REIMBURSED SERVICES SUBJECT TO DEDUCTIBLES  AND COINSURANCE - CHARGES, Renal Dialysis (D_5_HOS_C3_74)","COST SERVICES SUBJECT TO DEDUCTIBLES AND COINSURANCE - COST, Total (D_5_HOS_C6_200)","COST SERVICES SUBJECT TO DEDUCTIBLES AND COINSURANCE - COST, Renal Dialysis (D_5_HOS_C6_74)",Medical and Other Services (E_B_HOS_C1_1),Total cost (E_B_HOS_C1_11),Ancillary service charges (E_B_HOS_C1_12),Total reasonable charges (E_B_HOS_C1_14),Total customary charges (E_B_HOS_C1_18),Excess of customary charges (E_B_HOS_C1_19),Lesser of cost or charges (E_B_HOS_C1_21),Deductibles and coinsurance (E_B_HOS_C1_25),HMO (S3_1_C7_2),"AMOUNT REPORTED, Contract Labor (S3_2_C2_11)","AMOUNT REPORTED, Contract Labor: Pysician Part A (S3_2_C2_13)","AMOUNT REPORTED, Home Office Salaries & Wage Related Csts (S3_2_C2_14)","AMOUNT REPORTED, Excluded Areas (S3_2_C2_19)","AMOUNT REPORTED, Central Services and Supply (S3_2_C2_39)","ADJUSTED SALARIES, Contract Labor (S3_2_C4_11)","ADJUSTED SALARIES, Contract Labor:  Physician Part A (S3_2_C4_13)","ADJUSTED SALARIES, Home Office Salaries & Wage Related Csts (S3_2_C4_14)","ADJUSTED SALARIES, Excluded Areas (S3_2_C4_19)","ADJUSTED SALARIES, Central Services and Supply (S3_2_C4_39)","PAID HOURS RELATED TO SALARIES, Excluded Area Salaries (S3_2_C5_10)","PAID HOURS RELATED TO SALARIES, Contract Labor (S3_2_C5_11)","PAID HOURS RELATED TO SALARIES, Contract Labor:  Physician Part A (S3_2_C5_13)","PAID HOURS RELATED TO SALARIES, Home Office Salaries & Wage Related Csts (S3_2_C5_14)","PAID HOURS RELATED TO SALARIES, Employee Benefits (S3_2_C5_26)","PAID HOURS RELATED TO SALARIES, Operation of Plant (S3_2_C5_30)","PAID HOURS RELATED TO SALARIES, Housekeeping (S3_2_C5_32)","PAID HOURS RELATED TO SALARIES, Dietary (S3_2_C5_34)","PAID HOURS RELATED TO SALARIES, Nursing Administration (S3_2_C5_38)","PAID HOURS RELATED TO SALARIES, Central Services and Supply (S3_2_C5_39)","PAID HOURS RELATED TO SALARIES, Medical Records & Med Records Library (S3_2_C5_41)","PAID HOURS RELATED TO SALARIES, Social Service (S3_2_C5_42)","AVERAGE HOURLY WAGE, Excluded Area Salaries (S3_2_C6_10)","AVERAGE HOURLY WAGE, Contract Labor (S3_2_C6_11)","AVERAGE HOURLY WAGE, Contract Labor:  Physician Part A (S3_2_C6_13)","AVERAGE HOURLY WAGE, Home Office Salaries & Wage Related Csts (S3_2_C6_14)","AVERAGE HOURLY WAGE, Employee Benefits (S3_2_C6_26)","AVERAGE HOURLY WAGE, Operation of Plant (S3_2_C6_30)","AVERAGE HOURLY WAGE, Housekeeping (S3_2_C6_32)","AVERAGE HOURLY WAGE, Dietary (S3_2_C6_34)","AVERAGE HOURLY WAGE, Nursing Administration (S3_2_C6_38)","AVERAGE HOURLY WAGE, Central Services and Supply (S3_2_C6_39)","AVERAGE HOURLY WAGE, Medical Records & Med Records Library (S3_2_C6_41)","AVERAGE HOURLY WAGE, Social Service (S3_2_C6_42)","AMOUNT REPORTED, Subtotal Other Wages and Related Csts (S3_3_C2_4)","ADJUSTED SALARIES, Subtotal Other Wages and Related Csts (S3_3_C4_4)","PAID HOURS RELATED TO SALARIES, Excluded Area Salaries (S3_3_C5_2)","PAID HOURS RELATED TO SALARIES, Subtotal Other Wages and Related Csts (S3_3_C5_4)","AVERAGE HOURLY WAGE, Excluded Area Salaries (S3_3_C6_2)","AVERAGE HOURLY WAGE, Subtotal Other Wages and Related Csts (S3_3_C6_4)","Column 2 (Purchases), Land (A7_1_C2_1)","Sale of scrap, waste, etc. (A8_C2_11)",Nursery (A_C1_43),Nursery (A_C2_43),Total (D_4_HOS_C11_200),Renal Dialysis (D_4_HOS_C12_74),Total (D_4_HOS_C13_200),Total Allied Health (D_4_HOS_C3_200),Total Outpatient Program Pass Thru Cost (D_4_HOS_C6_200),"PPS REIMBURSED SERVICES -  CHARGES, Renal Dialysis (D_5_HOS_C2_74)","COST REIMBURSED SERVICES NOT SUBJECT TO DEDUCTIBLES AND COINSURANCE - CHARGES, Total (D_5_HOS_C4_200)","PPS SERVICES COST, Renal Dialysis (D_5_HOS_C5_74)","COST SERVICES NOT SUBJECT TO DEDUCTIBLES AND COINSURANCE - COST, Total (D_5_HOS_C7_200)",Excess of reasonable cost over reasonable charges (E_B_HOS_C1_20),Primary payer payments (E_B_HOS_C1_31),Ancillary service other pass through costs (E_B_HOS_C1_9),Stand-alone CHIP Charges (Gross Revenue) (S10_C1_10),Stand-alone CHIP cost (S10_C1_11),Net Revenue from stand-alone SCHIP (S10_C1_9),In State Medicaid eligible days (S2_1_C2_24),Out of State Medicaid eligible days (S2_1_C4_24),HMO (S3_1_C6_2),"AMOUNT REPORTED, Physician Part A (S3_2_C2_22)","AMOUNT REPORTED, Physician Part B (S3_2_C2_23)","AMOUNT REPORTED, Physician-Part A (S3_2_C2_4)","AMOUNT REPORTED, Physician-Part B (S3_2_C2_5)","ADJUSTED SALARIES, Physician Part A (S3_2_C4_22)","ADJUSTED SALARIES, Physician Part B (S3_2_C4_23)","ADJUSTED SALARIES, Non-Physician Anesthetist Part B (S3_2_C4_3)","ADJUSTED SALARIES, Physician-Part A (S3_2_C4_4)","ADJUSTED SALARIES, Physician-Part B (S3_2_C4_5)","PAID HOURS RELATED TO SALARIES, Non-Physician Anesthetist Part B (S3_2_C5_3)","PAID HOURS RELATED TO SALARIES, Physician-Part A (S3_2_C5_4)","PAID HOURS RELATED TO SALARIES, Pharmacy (S3_2_C5_40)","PAID HOURS RELATED TO SALARIES, Physician-Part B (S3_2_C5_5)","AVERAGE HOURLY WAGE, Non-Physician Anesthetist Part B (S3_2_C6_3)","AVERAGE HOURLY WAGE, Physician-Part A (S3_2_C6_4)","AVERAGE HOURLY WAGE, Pharmacy (S3_2_C6_40)","AVERAGE HOURLY WAGE, Physician-Part B (S3_2_C6_5)","PAID HOURS RELATED TO SALARIES, Total (S3_3_C5_6)","Column 2 (Purchases), Land Improvements (A7_1_C2_2)",Interest Expense (A_C6_113),MSP-LCC reconciliation amount (E_B_HOS_C1_38),"Column 3 (Donations), Total (A7_1_C3_10)","Column 3 (Donations), Buildings and Fixtures (A7_1_C3_3)","Column 3 (Donations), Building Improvements (A7_1_C3_4)","Column 3 (Donations), Movable Equipment (A7_1_C3_6)","Column 3 (Donations), Subtotal (A7_1_C3_8)",Sale of medical and surgical supplies to (A8_C2_16),Payments received from patients for amounts previously written off as charity care (S10_C1_22),Payments received from patients for amounts previously written off as charity care (S10_C2_22),Payments received from patients for amounts previously written off as charity care (S10_C3_22),In State Medicaid paid days (S2_1_C1_24),Number of periods hospital was in MDH status (S2_1_C1_37),Out of State Medicaid paid days (S2_1_C3_24),"AMOUNT REPORTED, Non-Physician Anesthetist Part A (S3_2_C2_2)","AMOUNT REPORTED, Non-Physician Anesthetist Part A (S3_2_C2_20)","ADJUSTED SALARIES, Non-Physician Anesthetist Part A (S3_2_C4_2)","ADJUSTED SALARIES, Non-Physician Anesthetist Part A (S3_2_C4_20)","PAID HOURS RELATED TO SALARIES, Non-Physician Anesthetist Part A (S3_2_C5_2)","AVERAGE HOURLY WAGE, Non-Physician Anesthetist Part A (S3_2_C6_2)","Column 5 (Disposals and Retirements), Buildings and Fixtures (A7_1_C5_3)",Subprovider-IRF (A_C1_41),SNF (A_C1_44),Subprovider-IRF (A_C2_41),SNF (A_C2_44),Subprovider-IPF (A_C6_40),Subprovider-IRF (A_C6_41),"Net Expense for Cost Allocation, Subprovider-IRF (B_1_C0_41)",Subprovider-IRF (B_1_C26_41),"TOTAL CAPITAL COSTS AFTER COST ALLOCATION, Subprovider-IRF (B_2_C26_41)",Subprovider-IRF (C_1_C5_41),"Total Inpatient Charges, Subprovider-IRF (C_1_C6_41)",Program Inpatient Ancillary Service Cost (D1_IPF_C1_48),Pass Through Cost for  Program Ancillary (D1_IPF_C1_51),"General Inpatient Routine Service Cost, net of Swing Bed Cost (D1_IRF_C1_27)","General Inpatient Routine Service Cost, net of Swing Bed and Private Room Diff (D1_IRF_C1_37)",Total Program General Inpatient Routine (D1_IRF_C1_41),Program Inpatient Ancillary Service Cost (D1_IRF_C1_48),Total Program Inpatient Costs (D1_IRF_C1_49),Pass through Cost for Program Inpatient (D1_IRF_C1_50),Pass Through Cost for  Program Ancillary (D1_IRF_C1_51),Total Program Excludable Costs (D1_IRF_C1_52),"Total Program Inpatient Operating Cost excluding Capital Related, Nonphysician, Anesthetist, and Medical Education Costs (D1_IRF_C1_53)",TOTAL (D3_IPF_C2_200),Renal Dialysis (D3_IPF_C2_74),TOTAL (D3_IPF_C3_200),Renal Dialysis (D3_IPF_C3_74),TOTAL (D3_IRF_C2_200),Subprovider-IRF (D3_IRF_C2_41),Renal Dialysis (D3_IRF_C2_74),TOTAL (D3_IRF_C3_200),Renal Dialysis (D3_IRF_C3_74),Subprovider-IRF (D_1_HOS_C4_41),Subprovider-IRF (D_1_HOS_C6_41),Subprovider-IRF (D_1_HOS_C7_41),Title XVIII discharges (S3_1_C13_16),Title XVIII discharges (S3_1_C13_17),Title XIX discharges (S3_1_C14_17),Total discharges (S3_1_C15_17),IRF (S3_1_C2_17),IRF (S3_1_C3_17),IRF (S3_1_C6_17),IRF (S3_1_C7_17),IRF (S3_1_C8_17),"AMOUNT REPORTED, SNF (S3_2_C2_9)","ADJUSTED SALARIES, Cafeteria (S3_2_C4_36)","PAID HOURS RELATED TO SALARIES, Cafeteria (S3_2_C5_36)","AVERAGE HOURLY WAGE, Cafeteria (S3_2_C6_36)",Sale of drugs to other than patients (A8_C2_17),Ambulance Services (A_C1_95),Ambulance Services (A_C2_95),"Net Expense for Cost Allocation, SNF (B_1_C0_44)","Net Expense for Cost Allocation, Ambulance Services (B_1_C0_95)",SNF (B_1_C26_44),Ambulance Services (B_1_C26_95),"TOTAL CAPITAL COSTS AFTER COST ALLOCATION, SNF (B_2_C26_44)",Ambulance Services (B_2_C26_95),SNF (C_1_C5_44),Ambulance Services (C_1_C5_95),"Total Inpatient Charges, SNF (C_1_C6_44)",Ambulance Services (C_1_C7_95),"General Inpatient Routine Service Cost, net of Swing Bed and Private Room Diff (D1_SNF_C1_37)",Total Program General Inp. Rtn Service (D1_SNF_C1_74),Program Ancillary Services (D1_SNF_C1_84),TOTAL (D3_SNF_C2_202),TOTAL (D3_SNF_C3_200),Payment to cost ratio (E_B_HOS_C1_5),Line 2 times line 5 (E_B_HOS_C1_6),Medicaid HMO Days (S2_1_C5_24),SNF (S3_1_C10_19),SNF (S3_1_C2_19),SNF (S3_1_C3_19),SNF (S3_1_C6_19),SNF (S3_1_C7_19),SNF (S3_1_C8_19),"ADJUSTED SALARIES, SNF (S3_2_C4_9)","PAID HOURS RELATED TO SALARIES, Laundry and Linen Service (S3_2_C5_31)","PAID HOURS RELATED TO SALARIES, SNF (S3_2_C5_9)","AVERAGE HOURLY WAGE, Laundry and Linen Service (S3_2_C6_31)","AVERAGE HOURLY WAGE, SNF (S3_2_C6_9)","HHA I, Without Outliers:  Total Visits (S4_HHA1_C1_33)","HHA I, Without Outliers:  Total Charges (S4_HHA1_C1_35)","HHA I, W/Out Outliers:  Number of Episodes (S4_HHA1_C1_36)","HHA I, Without Outliers:  Non Routine Med Sup Chgs (S4_HHA1_C1_38)","HHA I, With Outliers:  Total Visits (S4_HHA1_C2_33)","HHA I, With Outliers:  Total Charges (S4_HHA1_C2_35)","HHA I, With Outliers:  Number of Episodes (S4_HHA1_C2_37)","HHA I, With Outliers:  Non Routine Med Sup Chgs (S4_HHA1_C2_38)","HHA I, LUPA Episodes:  Total Visits (S4_HHA1_C3_33)","HHA I, Total Charges:  LUPA Episodes (S4_HHA1_C3_35)","HHA I, LUPA Episodes:  Total Number of Episodes (S4_HHA1_C3_36)","HHA I, LUPA:  Total Non Routine Med Sup Chgs (S4_HHA1_C3_38)","HHA I, PEP Episodes:  Total Visits (S4_HHA1_C4_33)","HHA I, PEP Episodes:  Total Charges: (S4_HHA1_C4_35)","HHA I, PEP Episodes:  Total Number of Episodes (S4_HHA1_C4_36)","HHA I, Total Visits (S4_HHA1_C5_33)","HHA I, Total Charges (S4_HHA1_C5_35)","HHA I, Total Number of Episodes (S4_HHA1_C5_36)","HHA I, Total Number of Outlier Episodes (S4_HHA1_C5_37)","HHA I, Total Non Routine Medical  Supply Charges (S4_HHA1_C5_38)",Kidney Acquisition (A_C1_105),Renal Dialysis (A_C1_74),Kidney Acquisition (A_C2_105),Pancreas Acquisition (A_C2_109),Kidney Acquisition (A_C6_105),"Net Expense for Cost Allocation, Kidney Acquisition (B_1_C0_105)","Net Expense for Cost Allocation, Pancreas Acquisition (B_1_C0_109)","Allocation of Interns & Residents Program Costs, Subprovider-IPF (B_1_C22_40)",Kidney Acquisition (B_1_C26_105),Pancreas Acquisition (B_1_C26_109),Kidney Acquisition (B_2_C26_105),Pancreas Acquisition (B_2_C26_109),Kidney Acquisition (C_1_C5_105),Pancreas Acquisition (C_1_C5_109),Kidney Acquisition (C_1_C6_105),Organ Procurement (D4_KIDNEY_C1_69),Organ Procurement (D4_PANCREAS_C1_69),Total Allied Health Cost (D_3_HOS_C2_200),Total Costs (D_3_HOS_C5_200),Total (D_3_HOS_C9_200),Adults & Pediatrics (D_3_HOS_C9_30),Outlier payments (E_B_HOS_C1_4),Title XVIII discharges (S3_1_C13_2),Labor and Delivery Days -  Title XIX (S3_1_C7_32),Labor and Delivery Days -  Title XIX (S3_1_C8_32),"AMOUNT REPORTED, Management and Administrative Services (S3_2_C2_12)","ADJUSTED SALARIES, Management and Administrative Services (S3_2_C4_12)","PAID HOURS RELATED TO SALARIES, Management and Administrative Services (S3_2_C5_12)","AVERAGE HOURLY WAGE, Management and Administrative Services (S3_2_C6_12)",Negative Cost Centers (B_2_C26_201),Total Swing Bed Cost (D1_HOS_C1_26),"Sum of lines 3,4 divided by line 6 (E_B_HOS_C1_7)",Transitional corridor payment (E_B_HOS_C1_8),Hospital Adults & Ped Swing Bed SNF (S3_1_C6_5),Hospital Adlts & Ped Swing Bed SNF (S3_1_C8_5),Hospital Adlts & Ped Swing Bed NF (S3_1_C8_6),"PAID HOURS RELATED TO SALARIES, Admin & Gen Under Contract (S3_2_C5_29)","AVERAGE HOURLY WAGE, Admin & Gen Under Contract (S3_2_C6_29)","HHA I, PEP:  Total Non Routine Med Supply Chgs (S4_HHA1_C4_38)",Investment Income-New Movable Equip (A8_C2_2),Net revenue from state/local govt indigent care (not Medicaid or CHIP) (S10_C1_13),Total charges to state or local government programs for indigent care (not Medicaid or CHIP) (S10_C1_14),Total costs for patients covered by a state or local government program (S10_C1_15),State or local govt (not Medicaid or CHIP) -- Costs minus net revenue (0 min) (S10_C1_16),"Income from imposition of interest, finance (A8_C2_21)",Rental of Provider space by suppliers (A8_C2_6),Nursery (A_C6_43),"AMOUNT REPORTED, Administrative & General under contract (S3_2_C2_28)","ADJUSTED SALARIES, Administrative & General under contract (S3_2_C4_28)","PAID HOURS RELATED TO SALARIES, Administrative and General under Contract (S3_2_C5_28)","AVERAGE HOURLY WAGE, Administrative and General under Contract (S3_2_C6_28)",Laundry and Linen Service (A8_C2_13),NF (A_C1_45),NF (S3_1_C10_20),NF (S3_1_C2_20),NF (S3_1_C3_20),Hospital Adults & Pediatrics (S3_1_C4_1),Total Hospital (S3_1_C4_14),Total Hospital (S3_1_C4_7),NF (S3_1_C7_20),NF (S3_1_C8_20),"Column 5 (Disposals and Retirements), Fixed Equipment (A7_1_C5_5)",Non-physician Anesthetist (A8_C2_28),SNF (A_C6_44),Stand-alone CHIP -- Costs minus net revenue (0 min) (S10_C1_12),"AMOUNT REPORTED, Non-Physician Anesthetist Part B (S3_2_C2_3)",Total (D_4_HOS_C1_200),Hospital Adlts & Ped Swing Bed SNF (S3_1_C7_5),"AMOUNT REPORTED, Wage Related Costs RHC/FQHC (S3_2_C2_24)","AMOUNT REPORTED, Non-Physician Part B (S3_2_C2_6)","ADJUSTED SALARIES, Wage Related Costs RHC/FQHC (S3_2_C4_24)","ADJUSTED SALARIES, Non-Physician Part B (S3_2_C4_6)","PAID HOURS RELATED TO SALARIES, Non-Physician Part B (S3_2_C5_6)","AVERAGE HOURLY WAGE, Non-Physician Part B (S3_2_C6_6)",Interest expense on Medicare Overpaymts (A8_C2_22),Ambulance Trips (S3_1_C6_29),Hospital Adlts & Ped Swing Bed NF (S3_1_C7_6),Ambulance Services (A_C6_95),RPCH/CAH Visits (S3_1_C6_15),RPCH/CAH Visits (S3_1_C7_15),CAH Visits (S3_1_C8_15),Government grants or appropriations or transfers for support of hospital operations (S10_C1_18),Ambulance Services (C_1_C6_95),"HHA I, Without Outliers:  Other Charges (S4_HHA1_C1_34)","HHA I, With Outliers:  Other Charges (S4_HHA1_C2_34)","HHA I, LUPA Episodes:  Other Charges (S4_HHA1_C3_34)","HHA I, PEP Episodes:  Other Charges (S4_HHA1_C4_34)","HHA I, Total Other Charges (S4_HHA1_C5_34)","AMOUNT REPORTED, Dietary under contract (S3_2_C2_35)","ADJUSTED SALARIES, Dietary under contract (S3_2_C4_35)","Column 5 (Disposals and Retirements), Land Improvements (A7_1_C5_2)","COST REIMBURSED SERVICES SUBJECT TO DEDUCTIBLES  AND COINSURANCE - CHARGES, Ambulance Services (D_5_HOS_C3_95)","COST SERVICES SUBJECT TO DEDUCTIBLES AND COINSURANCE - COST, Ambulance Services (D_5_HOS_C6_95)","Column 7 (Fully Depreciated Assets), Begin Balance (A7_1_C1_7)","Column 7 (Fully Depreciated Assets), Purchase (A7_1_C2_7)","Column 7 (Fully Depreciated Assets), Total (A7_1_C4_7)","Column 7 (Fully Depreciated Assets), Disp. And Retirement (A7_1_C5_7)","Column 7 (Fully Depreciated Assets), Ending Balance (A7_1_C6_7)","Column 5 (Disposals and Retirements), Land (A7_1_C7_1)","Column 7 (Fully Depreciated Assets), Assets (A7_1_C7_7)",Heart Acquisition (A_C1_106),Liver Acquisition (A_C1_107),Heart Acquisition (A_C2_106),Liver Acquisition (A_C2_107),Heart Acquisition (A_C6_106),Liver Acquisition (A_C6_107),Renal Dialysis (A_C6_74),"Net Expense for Cost Allocation, Heart Acquisition (B_1_C0_106)","Net Expense for Cost Allocation, Liver Acquisition (B_1_C0_107)",Int & Res (non approved teaching program (B_1_C26_100),Heart Acquisition (B_1_C26_106),Liver Acquisition (B_1_C26_107),Int & Res (non approved teaching program (B_2_C26_100),Heart Acquisition (B_2_C26_106),Liver Acquisition (B_2_C26_107),Int & Res (non approved teaching program (C_1_C5_100),Heart Acquisition (C_1_C5_106),Liver Acquisition (C_1_C5_107),Heart Acquisition (C_1_C6_106),Liver Acquisition (C_1_C6_107),Pancreas Acquisition (C_1_C6_109),Kidney Acquisition (C_1_C7_105),Heart Acquisition (C_1_C7_106),Liver Acquisition (C_1_C7_107),Pancreas Acquisition (C_1_C7_109),Organ Procurement (D4_HEART_C1_69),Organ Procurement (D4_LIVER_C1_69),"AMOUNT REPORTED, Teaching Physician Salaries (S3_2_C2_16)","AMOUNT REPORTED, Interns & Residents (S3_2_C2_25)","AMOUNT REPORTED, Interns & Residents (S3_2_C2_7)","ADJUSTED SALARIES, Teaching Physician Salaries (S3_2_C4_16)","ADJUSTED SALARIES, Interns & Residents (S3_2_C4_25)","ADJUSTED SALARIES, Other General Service (S3_2_C4_43)","ADJUSTED SALARIES, Interns & Residents (S3_2_C4_7)","PAID HOURS RELATED TO SALARIES, Teaching Physician Salaries (S3_2_C5_16)","PAID HOURS RELATED TO SALARIES, Other General Service (S3_2_C5_43)","PAID HOURS RELATED TO SALARIES, Interns & Residents (S3_2_C5_7)","AVERAGE HOURLY WAGE, Teaching Physician Salaries (S3_2_C6_16)","AVERAGE HOURLY WAGE, Other General Service (S3_2_C6_43)","AVERAGE HOURLY WAGE, Interns & Residents (S3_2_C6_7)","Number of patients on transplant 
list (S5_C1_11)","Net costs of Epoietin furnished to
all maintenance dialysis patients
by the provider (S5_C1_13)",Number of EPO units furnished for Line 13 (S5_C1_15),Number of Times per week Patient receives Dialysis (S5_C1_2),"Average patient dialysis time 
including setup (S5_C1_3)","Number of days in year dialysis 
furnished (S5_C1_5)",Number of stations (S5_C1_6),"Treatment capacity per day per
station (S5_C1_7)",Utilization (S5_C1_8),"Number of patients in program at 
end of cost reporting period (S5_C2_1)",Home Program Dialysis (A_C2_94),"Number of patients transplanted 
during fiscal year (S5_C1_12)","Average patient dialysis time 
including setup (S5_C2_3)",Number of stations (S5_C4_6),"HHA I, PEP:  Total Number of Outlier Episodes (S4_HHA1_C4_37)",OLTC (A_C1_46),OLTC (A_C2_46),OLTC (A_C6_46),"Net Expense for Cost Allocation, OLTC (B_1_C0_46)",OLTC (B_1_C26_46),"TOTAL CAPITAL COSTS AFTER COST ALLOCATION, OLTC (B_2_C26_46)",OLTC (C_1_C5_46),"Total Inpatient Charges, OLTC (C_1_C6_46)",OLTC (S3_1_C10_21),Total discharges (S3_1_C15_21),OLTC (S3_1_C2_21),OLTC (S3_1_C3_21),OLTC (S3_1_C8_21),"Allocation of Interns & Residents Program Costs, SNF (B_1_C22_44)",SNF (S3_1_C9_19),Int & Res (non approved teaching program (A_C2_100),"Net Expense for Cost Allocation, Int & Res (non approved teaching program (B_1_C0_100)",Subprovider I (A_C1_42),Subprovider I (A_C2_42),Subprovider I (A_C6_42),"Net Expense for Cost Allocation, Subprovider I (B_1_C0_42)",Subprovider I (B_1_C26_42),"TOTAL CAPITAL COSTS AFTER COST ALLOCATION, Subprovider I (B_2_C26_42)",Subprovider I (C_1_C5_42),"Total Inpatient Charges, Subprovider I (C_1_C6_42)",Subprovider I (D_1_HOS_C4_42),Total discharges (S3_1_C15_18),Subprovider 1 (S3_1_C2_18),Subprovider 1 (S3_1_C3_18),Subprovider 1 (S3_1_C8_18),Cost of physicians svcs in a teaching hospita (E_B_HOS_C1_23),Adj for Physical therapy costs in excess (A8_C2_24),Title V discharges (S3_1_C12_1),Title V discharges (S3_1_C12_14),Hospital Adults & Pediatrics (S3_1_C5_1),Total Hospital (S3_1_C5_14),Total Hospital (S3_1_C5_7),Physicians' Assistant (A8_C2_29),Home Program Dialysis (A_C1_94),"Net Expense for Cost Allocation, Home Program Dialysis (B_1_C0_94)",Home Program Dialysis (B_1_C26_94),Home Program Dialysis (B_2_C26_94),Home Program Dialysis (C_1_C5_94),Home Program Dialysis (C_1_C6_94),Home Program Dialysis (C_1_C7_94),"COST REIMBURSED SERVICES NOT SUBJECT TO DEDUCTIBLES AND COINSURANCE - CHARGES, Renal Dialysis (D_5_HOS_C4_74)","COST SERVICES NOT SUBJECT TO DEDUCTIBLES AND COINSURANCE - COST, Renal Dialysis (D_5_HOS_C7_74)",Component rate ESRD (E_B_HOS_C1_33),Protested amounts (E_B_HOS_C1_44),Private grants or donations or endowment income restricted to funding charity care (S10_C1_17),"Number of Times per week
 Patient receives Dialysis (S5_C2_2)","Number of days in year dialysis 
furnished (S5_C2_5)",Number of stations (S5_C2_6),"Treatment capacity per day per
station (S5_C2_7)","Number of Times per week
 Patient receives Dialysis (S5_C4_2)","Average patient dialysis time 
including setup (S5_C4_3)","Number of patients in program at 
end of cost reporting period (S5_C6_1)","Number of Times per week
 Patient receives Dialysis (S5_C6_2)",CAPD exchanges per day (S5_C6_4),"PAID HOURS RELATED TO SALARIES, Dietary under Contract (S3_2_C5_35)","AVERAGE HOURLY WAGE, Dietary under Contract (S3_2_C6_35)",Int & Res (non approved teaching program (A_C6_100),Pancreas Acquisition (A_C1_109),"Allocation of Interns & Residents Salary and Fringes, Subprovider-IPF (B_1_C21_40)","Allocation of Interns & Residents Salary and Fringes, Subprovider-IRF (B_1_C21_41)","Allocation of Interns & Residents Salary and Fringes, Nursery (B_1_C21_43)","Allocation of Interns & Residents Program Costs, Subprovider-IRF (B_1_C22_41)","Allocation of Interns & Residents Program Costs, Nursery (B_1_C22_43)",Subprovider-IPF (D_3_HOS_C9_40),Subprovider-IRF (D_3_HOS_C9_41),Total (D_4_IPF_C11_200),Total Allied Health (D_4_IPF_C3_200),Total Outpatient Program Pass Thru Cost (D_4_IPF_C6_200),Total (D_4_IRF_C11_200),Total Allied Health (D_4_IRF_C3_200),Total Outpatient Program Pass Thru Cost (D_4_IRF_C6_200),"AMOUNT REPORTED, Cafeteria (S3_2_C2_36)",Other Capital (A_C6_3),Program Discharges (D1_HOS_C1_54),Target Amount per Discharge (D1_HOS_C1_55),Target Amount (D1_HOS_C1_56),"Difference between Adjusted Inpatient, Operating Cost and Target Amount (D1_HOS_C1_57)",Bonus Payment (D1_HOS_C1_58),Allowable Inpatient Cost Plus Incentive Pt (D1_HOS_C1_63),"AMOUNT REPORTED, Home Office Personnel (S3_2_C2_8)","ADJUSTED SALARIES, Home Office Personnel (S3_2_C4_8)","PAID HOURS RELATED TO SALARIES, Home Office Personnel (S3_2_C5_8)","AVERAGE HOURLY WAGE, Home Office Personnel (S3_2_C6_8)",SNF (S3_1_C11_19),Adults and Pediatrics (D3_SNF_C2_30),Total Other Medical Education (D_4_HOS_C4_200),Total Other Medical Education (D_4_IPF_C4_200),Total Other Medical Education (D_4_IRF_C4_200),"Number of patients in program at 
end of cost reporting period (S5_C1_1)","Percentage of patients re-using
dialyzers (S5_C1_10)",Average times dialyzers re-used (S5_C1_9),"Number of patients in program at 
end of cost reporting period (S5_C4_1)",SNF (D_3_HOS_C9_44),Renal Dialysis (D_4_HOS_C11_74),Renal Dialysis (D_4_HOS_C13_74),Total Nursing School (D_4_HOS_C2_200),Renal Dialysis (D_4_HOS_C3_74),Total Nursing School (D_4_IRF_C2_200),Total (D_4_SNF_C11_200),Adj for Occupational therapy in excess of li (A8_C2_30),Other Medicaid Days (S2_1_C6_24),Total Nonphysician Anesthetist Cost (D_4_IPF_C1_200),Nursing School (A8_C2_19),"Column 5 (Disposals and Retirements), Land (A7_1_C5_1)",Adj for Speech therapy in excess of lim (A8_C2_31),"Column 3 (Donations), Fixed Equipment (A7_1_C3_5)",Subprovider II (A_C1_4201),Subprovider II (A_C2_4201),Subprovider II (A_C6_4201),"Net Expense for Cost Allocation, Subprovider II (B_1_C0_4201)",Subprovider II (B_1_C26_4201),"TOTAL CAPITAL COSTS AFTER COST ALLOCATION, Subprovider II (B_2_C26_4201)",Subprovider II (C_1_C5_4201),"Total Inpatient Charges, Subprovider II (C_1_C6_4201)",Adj for Respiratory therapy costs in excess (A8_C2_23),"PAID HOURS RELATED TO SALARIES, Maintenance of Personnel (S3_2_C5_37)",Subprovider-IPF (D3_HOS_C2_40),Lung  Acquisition (A_C1_108),Lung  Acquisition (A_C2_108),Lung  Acquisition (A_C6_108),Pancreas Acquisition (A_C6_109),"Net Expense for Cost Allocation, Lung  Acquisition (B_1_C0_108)",Renal Dialysis (B_1_C21_74),Lung  Acquisition (B_1_C26_108),Lung  Acquisition (B_2_C26_108),Lung  Acquisition (C_1_C5_108),Lung  Acquisition (C_1_C6_108),Home Program Dialysis (D3_HOS_C2_94),Home Program Dialysis (D3_HOS_C3_94),Organ Procurement (D4_LUNG_C1_69),Home Program Dialysis (D_4_HOS_C11_94),Renal Dialysis (D_4_HOS_C2_74),Home Program Dialysis (D_4_HOS_C2_94),Total Nursing School (D_4_IPF_C2_200),Total (D_4_IRF_C13_200),Utilization (S5_C2_8),Renal Dialysis (B_1_C22_74),"AMOUNT REPORTED, Housekeeping under contract (S3_2_C2_33)","ADJUSTED SALARIES, Housekeeping under contract (S3_2_C4_33)","PAID HOURS RELATED TO SALARIES, Housekeeping under Contract (S3_2_C5_33)","AVERAGE HOURLY WAGE, Housekeeping under Contract (S3_2_C6_33)",Lung  Acquisition (C_1_C7_108),"AMOUNT REPORTED, Physician Part A (S3_2_C2_2201)","ADJUSTED SALARIES, Physician Part A Teaching (S3_2_C4_2201)",Nursery (S3_1_C5_13),Home Program Dialysis (A_C6_94),"Epoietin amount form worksheet A
for home dialysis program (S5_C1_14)","Net Expense for Cost Allocation, PBP Clinical Lab Services Program Only (B_1_C0_61)",PBP Clinical Lab Services Program Only (B_1_C26_61),PBP Clinical Lab Services Program Only (C_1_C5_61),"Total Inpatient Charges, PBP Clinical Lab Services Program Only (C_1_C6_61)","Total Outpatient Charges, PBP Clinical Lab Services Program Only (C_1_C7_61)",Renal Dialysis (D3_SNF_C2_74),Renal Dialysis (D3_SNF_C3_74),CAPD exchanges per day (S5_C4_4),"COST REIMBURSED SERVICES SUBJECT TO DEDUCTIBLES  AND COINSURANCE - CHARGES, Home Program Dialysis (D_5_HOS_C3_94)","AMOUNT REPORTED, Home Office:  Physician Part A (S3_2_C2_15)","ADJUSTED SALARIES, Home Office:  Physician Part A (S3_2_C4_15)","PAID HOURS RELATED TO SALARIES, Home Office:  Physician Part A (S3_2_C5_15)","AVERAGE HOURLY WAGE, Home Office:  Physician Part A (S3_2_C6_15)",Interns and residents (E_B_HOS_C1_22),"Number of patients in program at 
end of cost reporting period (S5_C5_1)","Number of days in year dialysis 
furnished (S5_C5_2)","Allocation of Interns & Residents Salary and Fringes, SNF (B_1_C21_44)",Renal Dialysis (D_4_IRF_C11_74),Relief Payment (D1_HOS_C1_62),Total (D_4_IPF_C13_200),"Column 3 (Donations), Land (A7_1_C3_1)",Subprovider-IRF (D3_HOS_C2_41),Total Subprovider I Interns & Residents (S3_1_C10_18),Title XIX discharges (S3_1_C14_18),Subprovider 1 (S3_1_C7_18),Intestinal Acquisition (A_C1_110),Intestinal Acquisition (A_C2_110),"Net Expense for Cost Allocation, Intestinal Acquisition (B_1_C0_110)",Intestinal Acquisition (B_1_C26_110),Intestinal Acquisition (B_2_C26_110),Intestinal Acquisition (C_1_C6_110),Kidney Acquisition (B_1_C21_105),Liver Acquisition (B_1_C21_107),Kidney Acquisition (B_1_C22_105),Liver Acquisition (B_1_C22_107),"AMOUNT REPORTED, Maintenance of Personnel (S3_2_C2_37)","ADJUSTED SALARIES, Maintenance of Personnel (S3_2_C4_37)","AVERAGE HOURLY WAGE, Maintenance of Personnel (S3_2_C6_37)",Int & Res (non approved teaching program (A_C1_100),Intestinal Acquisition (A_C6_110),Heart Acquisition (B_1_C22_106),Lung  Acquisition (B_1_C22_108),Pancreas Acquisition (B_1_C22_109),Intestinal Acquisition (B_1_C22_110),Intestinal Acquisition (C_1_C7_110),Title V discharges (S3_1_C12_16),IPF (S3_1_C5_16),"AMOUNT REPORTED, Physician Part A (S3_2_C3_22)","AMOUNT REPORTED, Physician Part B (S3_2_C3_23)","AMOUNT REPORTED, Interns & Residents (S3_2_C3_25)",Home Program Dialysis (D3_SNF_C2_94),Home Program Dialysis (D3_SNF_C3_94),Home Program Dialysis (D_4_HOS_C3_94),OLTC (S3_1_C11_21),Payment to cost ratio (E_B_HOS_C101_5),"AMOUNT REPORTED, Home Office Salaries & Wage Related Csts (S3_2_C3_14)","HHA II, Without Outliers:  Total Visits (S4_HHA2_C1_33)","HHA II, Without Outliers:  Total Charges (S4_HHA2_C1_35)","HHA II, W/Out Outliers:  Number of Episodes (S4_HHA2_C1_36)","HHA II, Without Outliers:  Non Routine Med Sup Chgs (S4_HHA2_C1_38)","HHA II, LUPA Episodes:  Total Visits (S4_HHA2_C3_33)","HHA II, Total Charges:  LUPA Episodes (S4_HHA2_C3_35)","HHA II, LUPA Episodes:  Total Number of Episodes (S4_HHA2_C3_36)","HHA II, Total Visits (S4_HHA2_C5_33)","HHA II, Total Charges (S4_HHA2_C5_35)","HHA II, Total Number of Episodes (S4_HHA2_C5_36)","HHA II, Total Non Routine Medical  Supply Charges (S4_HHA2_C5_38)","Column 3 (Donations), Land Improvements (A7_1_C3_2)","Allocation of Interns & Residents Salary and Fringes, NF (B_1_C21_45)","Allocation of Interns & Residents Program Costs, NF (B_1_C22_45)",NF (S3_1_C9_20),ESRD DME costs (E_B_HOS_C1_29),Subprovider-IRF (D3_IRF_C2_40),Utilization Review-physicians compens (A8_C2_25),Utilization Review SNF (A_C6_114),Utilization Review - Physician Compen (D1_SNF_C1_85),ICF (A_C1_4501),ICF (A_C2_4501),"Net Expense for Cost Allocation, ICF (B_1_C0_4501)",ICF (B_1_C26_4501),"TOTAL CAPITAL COSTS AFTER COST ALLOCATION, ICF (B_2_C26_4501)",ICF (C_1_C5_4501),"Total Inpatient Charges, ICF (C_1_C6_4501)",ICF (S3_1_C10_2001),ICF (S3_1_C2_2001),ICF (S3_1_C3_2001),ICF (S3_1_C8_2001),Ambulance Services (B_1_C21_95),Ambulance Services (B_1_C22_95),"Allocation of Interns & Residents Salary and Fringes, OLTC (B_1_C21_46)","Allocation of Interns & Residents Program Costs, OLTC (B_1_C22_46)",OLTC (S3_1_C9_21),Renal Dialysis (D_4_IPF_C11_74),Premiums (S2_1_C1_11801),Paid Losses (S2_1_C2_11801),Self Insurance (S2_1_C3_11801),"Percentage of patients re-using
dialyzers (S5_C2_10)",Average times dialyzers re-used (S5_C2_9),"Number of patients in program at 
end of cost reporting period (S5_C3_1)","Number of Times per week 
Patient receives Dialysis (S5_C3_2)","Average patient dialysis time 
including setup (S5_C3_3)",Number of stations (S5_C3_6),"Column 7 (Fully Depreciated Assets), Donations (A7_1_C3_7)",Intestinal Acquisition (C_1_C5_110),ICF (S3_1_C7_2001),IRF (S3_1_C5_17),"HHA II, LUPA:  Total Non Routine Med Sup Chgs (S4_HHA2_C3_38)","HHA II, PEP Episodes:  Total Visits (S4_HHA2_C4_33)","HHA II, PEP Episodes:  Total Charges: (S4_HHA2_C4_35)","HHA II, PEP Episodes:  Total Number of Episodes (S4_HHA2_C4_36)",Title XVIII discharges (S3_1_C13_18),ICF (A_C6_4501),Total Other Medical Education Cost (D_3_HOS_C3_200),Heart Acquisition (B_1_C21_106),Lung  Acquisition (B_1_C21_108),Pancreas Acquisition (B_1_C21_109),Renal Dialysis (D_4_IRF_C13_74),PBP Clinical Lab Services Program Only (A_C6_61),Islet Acquisition (A_C1_111),Islet Acquisition (A_C2_111),"Net Expense for Cost Allocation, Islet Acquisition (B_1_C0_111)",Islet Acquisition (B_1_C26_111),Islet Acquisition (B_2_C26_111),Islet Acquisition (C_1_C5_111),Islet Acquisition (C_1_C6_111),"COST SERVICES SUBJECT TO DEDUCTIBLES AND COINSURANCE - COST, Home Program Dialysis (D_5_HOS_C6_94)",Subprovider-IRF (D3_IPF_C2_41),Islet Acquisition (A_C6_111),Islet Acquisition (B_1_C22_111),Organ Procurement (D4_ISLET_C1_69),Organ Procurement (D4_INTESTINE_C1_69),Renal Dialysis (D_4_SNF_C11_74),"Allocation of Interns & Residents Salary and Fringes, Subprovider I (B_1_C21_42)","HHA II, PEP:  Total Non Routine Med Supply Chgs (S4_HHA2_C4_38)","HHA II, With Outliers:  Total Visits (S4_HHA2_C2_33)","HHA II, With Outliers:  Total Charges (S4_HHA2_C2_35)","HHA II, With Outliers:  Number of Episodes (S4_HHA2_C2_37)","HHA II, Total Number of Outlier Episodes (S4_HHA2_C5_37)",Title V discharges (S3_1_C12_17),Labor and Delivery Days Title 18 (S3_1_C6_32),Organ acquisition (E_B_HOS_C1_10),Organ acquisition charges (E_B_HOS_C1_13),Medicare allowable bad debts for the entire hospital complex (S10_C1_2701),"AMOUNT REPORTED, Physician Part A Teaching (S3_2_C3_2201)",Aggregate amount collected from patients (E_B_HOS_C1_15),Amounts expected under 42 CFR (E_B_HOS_C1_16),Medical and Other Services reimbursed by OPPS (E_B_HOS_C101_2),Renal Dialysis (D_4_IPF_C13_74),HHA 3 Provider Number (S2_1_C2_1202),ASC 1 Provider Number (S2_1_C2_13),RHC 11 Provider Number (S2_1_C2_1510),RHC 12 Provider Number (S2_1_C2_1511),RHC 13 Provider Number (S2_1_C2_1512),RHC 14 Provider Number (S2_1_C2_1513),RHC 15 Provider Number (S2_1_C2_1514),RHC 16 Provider Number (S2_1_C2_1515),RHC 17 Provider Number (S2_1_C2_1516),RHC 18 Provider Number (S2_1_C2_1517),RHC 19 Provider Number (S2_1_C2_1518),RHC 20 Provider Number (S2_1_C2_1519),RHC 21 Provider Number (S2_1_C2_1520),RHC 22 Provider Number (S2_1_C2_1521),RHC 23 Provider Number (S2_1_C2_1522),RHC 24 Provider Number (S2_1_C2_1523),RHC 25 Provider Number (S2_1_C2_1524),FQHC 2 Provider Number (S2_1_C2_1601),FQHC 3 Provider Number (S2_1_C2_1602),FQHC 4 Provider Number (S2_1_C2_1603),FQHC 5 Provider Number (S2_1_C2_1604),FQHC 6 Provider Number (S2_1_C2_1605),FQHC 7 Provider Number (S2_1_C2_1606),FQHC 8 Provider Number (S2_1_C2_1607),FQHC 9 Provider Number (S2_1_C2_1608),Beginning Date of SCH status (S2_1_C1_3601),Ending Date of SCH status (S2_1_C2_3601),MDH status beginning date  (MM/DD/YY) (S2_1_C1_3801),MDH status ending date (MM/DD/YY) (S2_1_C2_3801),Medicare Certified Pancreas TC term date (S2_1_C2_130),Medicare Certified Islet TC term date (S2_1_C2_132),Hospital Street Address (S2_1_C1_1),Hospital City (S2_1_C1_2),Hospital Zip Code (S2_1_C3_2),Hospital County (S2_1_C4_2),Hospital Name (S2_1_C1_3),Provider's actual MSA or CBSA (S2_1_C3_3),Hospital Title 18 Payment System (P/T/O) (S2_1_C7_3),Type of Control of Hospital (See Table I) (S2_1_C1_21),"Does the facility qualify and is it receiving payments for 
disproportionate share? (Y/N) (S2_1_C1_22)","Is this a New Hospital under
42 CFR 412.300 PPS capital
(Y/N) (S2_1_C1_47)",Does the hospital elect a fully prospective payment method for capital costs? (Y/N) (S2_1_C1_48),"Is this a teaching hospital or
affiliated with a teaching hospital? (Y/N) (S2_1_C1_56)",or allied health costs? (S2_1_C1_60),Is this a New Hospital under 42 CFR 413.40(f)(1)(I) (TEFRA)? (Y/N) (S2_1_C1_85),Have you established a new subprovider excluded unit under 42 CFR 413.40(f)(1)(I)?(Y/N) (S2_1_C1_86),Does the facility operate an ICF/MR facility for purposes of Title XIX? (Y/N) (S2_1_C1_93),Does the hospital qualify as RPCH/CAH? (Y/N) (S2_1_C1_105),"If this facility qualifies as a RPCH/CAH, has it elected the all inclusive payment for outpatient service? (Y/N) (S2_1_C1_106)",Is this a rural hospital qualifying for an exception to the certified registered nurse anesthetist the CRNA fee schedule? (Y/N) (S2_1_C1_108),Is this hospital an All-Inclusive rate provider? (Y/N) (S2_1_C1_115),Is this hospital classified as a referral center? (Y/N) (S2_1_C1_116),"Does this facility operate 
transplant center? (Y/N) (S2_1_C1_125)","Are there any related organization or how office costs as defined in HCFA Pub. 15-I, chapter 10? (Y/N) (S2_1_C1_140)",Are provider based physicians' costs included in Worksheet A? (Y/N) (S2_1_C1_144),"If this Hospital is claiming cost for renal services on Worksheet A, are they inpatient services only? (Y/N) (S2_1_C1_145)",IPF Provider Number (S2_1_C1_4),IPF Provider Number (S2_1_C2_4),FI/Contractor's Name (S2_1_C2_140),Home Office Name (S2_1_C1_141),Home Office Street (S2_1_C1_142),City (S2_1_C1_143),State (S2_1_C2_143),Zip Code (S2_1_C3_143),"If Line 32, Col 1 is yes, enter the method used: (A, B, or E only) (S2_1_C2_115)",Received DSH or supplemental payments from Medicaid? (Y/N) (S10_C1_3),Hospital PO Box (S2_1_C2_1),NF Provider Number (S2_1_C2_10),Swing Bed SNF Provider Number (S2_1_C2_7),MDH status beginning date (MM/DD/YY) (S2_1_C1_38),MDH status ending date (MM/DD/YY) (S2_1_C2_38),IRF Provider Number (S2_1_C1_5),IRF Provider Number (S2_1_C2_5),SNF Provider Number (S2_1_C2_9),HHA 1 Provider Number (S2_1_C2_12),Hospice 1 Provider Number (S2_1_C2_14),Beginning Date of SCH status (S2_1_C1_36),Ending Date of SCH status (S2_1_C2_36),"Medicare certified kidney 
transplant center cert date (S2_1_C1_126)",Swing Bed NF Provider Number (S2_1_C2_8),RHC 1 Provider Number (S2_1_C2_15),RHC 2 Provider Number (S2_1_C2_1501),Home Office PO Box (S2_1_C2_142),Renal 1 Provider Number (S2_1_C2_18),RHC 3 Provider Number (S2_1_C2_1502),RHC 4 Provider Number (S2_1_C2_1503),RHC 5 Provider Number (S2_1_C2_1504),MCP Physician Payment Method (Y/N) (S5_C1_21),"Medicare certified heart
transplant center cert date (S2_1_C1_127)","Medical certified liver 
transplant center cert date (S2_1_C1_128)",Renal 2 Provider Number (S2_1_C2_1801),Hospice 2 Provider Number (S2_1_C2_1401),Initial Physician Payment Method (Y/N) (S5_C2_21),"Medical certified lung
transplant center cert date (S2_1_C1_129)","If an Organ Procurement Organization, enter the OPO number (S2_1_C1_134)",CMHC 1 Provider Number (S2_1_C2_17),certification date (S2_1_C1_131),RHC 6 Provider Number (S2_1_C2_1505),RHC 7 Provider Number (S2_1_C2_1506),RHC 8 Provider Number (S2_1_C2_1507),RHC 9 Provider Number (S2_1_C2_1508),RHC 10 Provider Number (S2_1_C2_1509),Renal 3 Provider Number (S2_1_C2_1802),Renal 4 Provider Number (S2_1_C2_1803),Renal 5 Provider Number (S2_1_C2_1804),HHA 2 Provider Number (S2_1_C2_1201),Medicare Certified Kidney TC term date (S2_1_C2_126),Medicare Certified Heart TC term date (S2_1_C2_127),Medicare Certified Liver TC term date (S2_1_C2_128),Renal 6 Provider Number (S2_1_C2_1805),FQHC 1 Provider Number (S2_1_C2_16),ICF Provider Number (S2_1_C2_1001),Renal 7 Provider Number (S2_1_C2_1806),Renal 8 Provider Number (S2_1_C2_1807),Renal 9 Provider Number (S2_1_C2_1808),Renal 10 Provider Number (S2_1_C2_1809),certification date (S2_1_C1_132),Medicare Certified Lung TC term date (S2_1_C2_129),Blood Clotting Factors for Hemoph. (A_C1_6250),Blood Clotting Factors for Hemoph. (A_C2_6250),Blood Clotting Factors for Hemoph. (A_C6_6250),"Net Expense for Cost Allocation, Blood Clotting Factors for Hemoph. (B_1_C0_6250)",HHA (B_1_C21_101),ASC (Distinct Part) (B_1_C21_115),Hospice (B_1_C21_116),Other Special Purpose (B_1_C21_117),FQHC (B_1_C21_89),CMHC (B_1_C21_99),HHA (B_1_C22_101),ASC (Distinct Part) (B_1_C22_115),Hospice (B_1_C22_116),Other Special Purpose (B_1_C22_117),FQHC (B_1_C22_89),CMHC (B_1_C22_99),Blood Clotting Factors for Hemoph. (B_1_C26_6250),"TOTAL CAPITAL COSTS AFTER COST ALLOCATION, Blood Clotting Factors for Hemoph. (B_2_C26_6250)",Respiratory Therapy (C_1_C2_65),Occupational Therapy (C_1_C2_67),Speech Pathology (C_1_C2_68),Blood Clotting Factors for Hemoph. (C_1_C5_6250),OPT (C_1_C6_9920),OOT (C_1_C6_9930),OSP (C_1_C6_9940),"Total Outpatient Charges, Blood Clotting Factors for Hemoph. (C_1_C7_6250)",FQHC (C_1_C7_89),Blood Clotting Factors for Hemoph. (D3_HOS_C3_6250),Coronary Care Unit (D3_SNF_C2_32),Surgical Intensive Care Unit (D3_SNF_C2_34),Other Special Care Unit (D3_SNF_C2_35),Durable Medical Equipment Rented (D3_SNF_C2_96),Durable Medical Equipment Rented (D3_SNF_C3_96),Blood Clotting Factors for Hemoph. (D_4_HOS_C12_6250),Drugs Charged to Patients (D_4_HOS_C1_73),Other Ancillary (D_4_HOS_C1_76),Emergency (D_4_HOS_C1_91),Radioisotope (D_4_HOS_C2_56),Whole Blood & Packed Red Blood Cells (D_4_HOS_C2_62),Occupational Therapy (D_4_HOS_C2_67),Speech Pathology (D_4_HOS_C2_68),Medical Supplies Charged to Patients (D_4_HOS_C2_71),Impl. Dev. Charged to Patients (D_4_HOS_C2_72),Blood Clotting Factors for Hemoph. (D_4_HOS_C3_6250),RHC (D_4_HOS_C3_88),FQHC (D_4_HOS_C3_89),Other Reimbursable (D_4_HOS_C3_98),Delivery Room and Labor Room (D_4_HOS_C4_52),Anesthesiology (D_4_HOS_C4_53),Radiology-Therapeutic (D_4_HOS_C4_55),Radioisotope (D_4_HOS_C4_56),Cardiac Catheterization (D_4_HOS_C4_59),Laboratory (D_4_HOS_C4_60),Intravenous Therapy (D_4_HOS_C4_64),Physical Therapy (D_4_HOS_C4_66),Occupational Therapy (D_4_HOS_C4_67),Speech Pathology (D_4_HOS_C4_68),Electrocardiology (D_4_HOS_C4_69),Electroencephalography (D_4_HOS_C4_70),Medical Supplies Charged to Patients (D_4_HOS_C4_71),Impl. Dev. Charged to Patients (D_4_HOS_C4_72),Drugs Charged to Patients (D_4_HOS_C4_73),Other Ancillary (D_4_HOS_C4_76),RHC (D_4_HOS_C4_88),FQHC (D_4_HOS_C4_89),Other Outpatient Services (D_4_HOS_C4_93),Medical Supplies Charged to Patients (D_4_IPF_C11_71),Recovery Room (D_4_IPF_C13_51),Radiology-Therapeutic (D_4_IPF_C13_55),Radioisotope (D_4_IPF_C13_56),MRI (D_4_IPF_C13_58),Cardiac Catheterization (D_4_IPF_C13_59),Whole Blood & Packed Red Blood Cells (D_4_IPF_C13_62),"Blood Storing, Processing, Trans (D_4_IPF_C13_63)",Intravenous Therapy (D_4_IPF_C13_64),Respiratory Therapy (D_4_IPF_C13_65),Physical Therapy (D_4_IPF_C13_66),Occupational Therapy (D_4_IPF_C13_67),Speech Pathology (D_4_IPF_C13_68),ASC (Non Distinct Part) (D_4_IPF_C13_75),Other Ancillary (D_4_IPF_C13_76),Observation Beds (Distinct Unit) (D_4_IPF_C13_9201),Other Outpatient Services (D_4_IPF_C13_93),Recovery Room (D_4_IRF_C13_51),Anesthesiology (D_4_IRF_C13_53),Radiology-Therapeutic (D_4_IRF_C13_55),CT Scan (D_4_IRF_C13_57),MRI (D_4_IRF_C13_58),Cardiac Catheterization (D_4_IRF_C13_59),Whole Blood & Packed Red Blood Cells (D_4_IRF_C13_62),"Blood Storing, Processing, Trans (D_4_IRF_C13_63)",Physical Therapy (D_4_IRF_C13_66),Speech Pathology (D_4_IRF_C13_68),Electroencephalography (D_4_IRF_C13_70),Medical Supplies Charged to Patients (D_4_IRF_C13_71),Impl. Dev. Charged to Patients (D_4_IRF_C13_72),ASC (Non Distinct Part) (D_4_IRF_C13_75),Other Ancillary (D_4_IRF_C13_76),Other Outpatient Services (D_4_IRF_C13_93),Delivery Room and Labor Room (D_4_SNF_C11_52),MRI (D_4_SNF_C11_58),Whole Blood & Packed Red Blood Cells (D_4_SNF_C11_62),Intravenous Therapy (D_4_SNF_C11_64),Electrocardiology (D_4_SNF_C11_69),Impl. Dev. Charged to Patients (D_4_SNF_C11_72),ASC (Non Distinct Part) (D_4_SNF_C11_75),Observation Beds (Distinct Unit) (D_4_SNF_C11_9201),Drugs Charged to Patients (D_4_SNF_C13_73),"PPS REIMBURSED SERVICES -  CHARGES, Blood Clotting Factors for Hemoph. (D_5_HOS_C2_6250)","COST REIMBURSED SERVICES SUBJECT TO DEDUCTIBLES  AND COINSURANCE - CHARGES, Blood Clotting Factors for Hemoph. (D_5_HOS_C3_6250)","COST REIMBURSED SERVICES NOT SUBJECT TO DEDUCTIBLES AND COINSURANCE - CHARGES, Durable Medical Equipment Rented (D_5_HOS_C4_96)","COST REIMBURSED SERVICES NOT SUBJECT TO DEDUCTIBLES AND COINSURANCE - CHARGES, Other Reimbursable (D_5_HOS_C4_98)","PPS SERVICES COST, Blood Clotting Factors for Hemoph. (D_5_HOS_C5_6250)","COST SERVICES SUBJECT TO DEDUCTIBLES AND COINSURANCE - COST, Blood Clotting Factors for Hemoph. (D_5_HOS_C6_6250)","COST SERVICES NOT SUBJECT TO DEDUCTIBLES AND COINSURANCE - COST, Durable Medical Equipment Rented (D_5_HOS_C7_96)","COST SERVICES NOT SUBJECT TO DEDUCTIBLES AND COINSURANCE - COST, Other Reimbursable (D_5_HOS_C7_98)",Outpatient Rehab Provider (S3_1_C11_25),Burn Intensive Care Unit (S3_1_C4_10),Surgical Intensive Care Unit (S3_1_C4_11),CMHC (S3_1_C6_25),Outpatient Rehab Provider (S3_1_C7_25),Outpatient Rehab Provider (S3_1_C8_25),HHA (S3_1_C9_22),"Column 10 (Lease), New Cap Related Csts Bldg & Fixtures (A7_3_C10_1)","Column 10 (Lease), New Cap Related Csts Movable Equipment (A7_3_C10_2)","Column 15 (Total), New Cap Related Csts Bldg & Fixtures (A7_3_C15_1)","Column 15 (Total), New Cap Related Csts Movable Equipment (A7_3_C15_2)","Column 9 (Depreciation), New Cap Related Csts Bldg & Fixtures (A7_3_C9_1)","Column 9 (Depreciation), New Cap Related Csts Movable Equipment (A7_3_C9_2)",Other Adjustments (Summed) (A8_C2_33),Pharmacy (A_C1_15),Medical Records and Medical Rec. Library (A_C1_16),Social Service (A_C1_17),Administrative and General (A_C1_5),Respiratory Therapy (A_C1_65),Physical Therapy (A_C1_66),Occupational Therapy (A_C1_67),Electrocardiology (A_C1_69),Housekeeping (A_C1_9),New Capital Buildings and Fixtures (A_C2_1),Dietary (A_C2_10),Pharmacy (A_C2_15),Medical Records and Medical Rec. Library (A_C2_16),Social Service (A_C2_17),New Capital Equipment (A_C2_2),Employee Benefits (A_C2_4),Administrative and General (A_C2_5),Operating Room (A_C2_50),Recovery Room (A_C2_51),Anesthesiology (A_C2_53),Radiology-Diagnostic (A_C2_54),Radiology-Therapeutic (A_C2_55),Laboratory (A_C2_60),"Blood Storing, Processing, Trans (A_C2_63)",Respiratory Therapy (A_C2_65),Physical Therapy (A_C2_66),Occupational Therapy (A_C2_67),Speech Pathology (A_C2_68),Electrocardiology (A_C2_69),Operation of Plant (A_C2_7),Electroencephalography (A_C2_70),Medical Supplies Charged to Patients (A_C2_71),Drugs Charged to Patients (A_C2_73),Housekeeping (A_C2_9),Pharmacy (A_C6_15),Medical Records and Medical Rec. Library (A_C6_16),Social Service (A_C6_17),Administrative and General (A_C6_5),"Net Expense for Cost Allocation, New Capital Buildings and Fixtures (B_1_C0_1)","Net Expense for Cost Allocation, Dietary (B_1_C0_10)","Net Expense for Cost Allocation, Pharmacy (B_1_C0_15)","Net Expense for Cost Allocation, Medical Records and Medical Rec. Library (B_1_C0_16)","Net Expense for Cost Allocation, Social Service (B_1_C0_17)","Net Expense for Cost Allocation, New Capital Equipment (B_1_C0_2)","Net Expense for Cost Allocation, Employee Benefits (B_1_C0_4)","Net Expense for Cost Allocation, Administrative and General (B_1_C0_5)","Net Expense for Cost Allocation, Operating Room (B_1_C0_50)","Net Expense for Cost Allocation, Recovery Room (B_1_C0_51)","Net Expense for Cost Allocation, Anesthesiology (B_1_C0_53)","Net Expense for Cost Allocation, Radiology-Diagnostic (B_1_C0_54)","Net Expense for Cost Allocation, Radiology-Therapeutic (B_1_C0_55)","Net Expense for Cost Allocation, CT Scan (B_1_C0_57)","Net Expense for Cost Allocation, MRI (B_1_C0_58)","Net Expense for Cost Allocation, Laboratory (B_1_C0_60)","Net Expense for Cost Allocation, Blood Storing, Processing, Trans (B_1_C0_63)","Net Expense for Cost Allocation, Intravenous Therapy (B_1_C0_64)","Net Expense for Cost Allocation, Respiratory Therapy (B_1_C0_65)","Net Expense for Cost Allocation, Physical Therapy (B_1_C0_66)","Net Expense for Cost Allocation, Occupational Therapy (B_1_C0_67)","Net Expense for Cost Allocation, Speech Pathology (B_1_C0_68)","Net Expense for Cost Allocation, Electrocardiology (B_1_C0_69)","Net Expense for Cost Allocation, Operation of Plant (B_1_C0_7)","Net Expense for Cost Allocation, Electroencephalography (B_1_C0_70)","Net Expense for Cost Allocation, Medical Supplies Charged to Patients (B_1_C0_71)","Net Expense for Cost Allocation, Impl. Dev. Charged to Patients (B_1_C0_72)","Net Expense for Cost Allocation, Drugs Charged to Patients (B_1_C0_73)","Net Expense for Cost Allocation, Housekeeping (B_1_C0_9)","Net Expense for Cost Allocation, Clinic (B_1_C0_90)","Net Expense for Cost Allocation, Emergency (B_1_C0_91)",Operating Room (B_1_C26_50),Recovery Room (B_1_C26_51),Anesthesiology (B_1_C26_53),Radiology-Diagnostic (B_1_C26_54),Radiology-Therapeutic (B_1_C26_55),CT Scan (B_1_C26_57),MRI (B_1_C26_58),Laboratory (B_1_C26_60),"Blood Storing, Processing, Trans (B_1_C26_63)",Intravenous Therapy (B_1_C26_64),Respiratory Therapy (B_1_C26_65),Physical Therapy (B_1_C26_66),Occupational Therapy (B_1_C26_67),Speech Pathology (B_1_C26_68),Electrocardiology (B_1_C26_69),Electroencephalography (B_1_C26_70),Medical Supplies Charged to Patients (B_1_C26_71),Impl. Dev. Charged to Patients (B_1_C26_72),Drugs Charged to Patients (B_1_C26_73),Clinic (B_1_C26_90),Emergency (B_1_C26_91),"TOTAL CAPITAL COSTS AFTER COST ALLOCATION, Operating Room (B_2_C26_50)","TOTAL CAPITAL COSTS AFTER COST ALLOCATION, Recovery Room (B_2_C26_51)","TOTAL CAPITAL COSTS AFTER COST ALLOCATION, Anesthesiology (B_2_C26_53)","TOTAL CAPITAL COSTS AFTER COST ALLOCATION, Radiology-Diagnostic (B_2_C26_54)","TOTAL CAPITAL COSTS AFTER COST ALLOCATION, Radiology-Therapeutic (B_2_C26_55)","TOTAL CAPITAL COSTS AFTER COST ALLOCATION, CT Scan (B_2_C26_57)","TOTAL CAPITAL COSTS AFTER COST ALLOCATION, MRI (B_2_C26_58)","TOTAL CAPITAL COSTS AFTER COST ALLOCATION, Laboratory (B_2_C26_60)","Blood Storing, Processing, Trans (B_2_C26_63)",Intravenous Therapy (B_2_C26_64),Respiratory Therapy (B_2_C26_65),Physical Therapy (B_2_C26_66),Occupational Therapy (B_2_C26_67),Speech Pathology (B_2_C26_68),Electrocardiology (B_2_C26_69),Electroencephalography (B_2_C26_70),Medical Supplies Charged to Patients (B_2_C26_71),Impl. Dev. Charged to Patients (B_2_C26_72),Drugs Charged to Patients (B_2_C26_73),Clinic (B_2_C26_90),Emergency (B_2_C26_91),Operating Room (C_1_C5_50),Recovery Room (C_1_C5_51),Anesthesiology (C_1_C5_53),Radiology-Diagnostic (C_1_C5_54),Radiology-Therapeutic (C_1_C5_55),CT Scan (C_1_C5_57),MRI (C_1_C5_58),Laboratory (C_1_C5_60),"Blood Storing, Processing, Trans (C_1_C5_63)",Intravenous Therapy (C_1_C5_64),Respiratory Therapy (C_1_C5_65),Physical Therapy (C_1_C5_66),Occupational Therapy (C_1_C5_67),Speech Pathology (C_1_C5_68),Electrocardiology (C_1_C5_69),Electroencephalography (C_1_C5_70),Medical Supplies Charged to Patients (C_1_C5_71),Impl. Dev. Charged to Patients (C_1_C5_72),Drugs Charged to Patients (C_1_C5_73),Clinic (C_1_C5_90),Emergency (C_1_C5_91),"Total Inpatient Charges, Operating Room (C_1_C6_50)","Total Inpatient Charges, Recovery Room (C_1_C6_51)","Total Inpatient Charges, Anesthesiology (C_1_C6_53)","Total Inpatient Charges, Radiology-Diagnostic (C_1_C6_54)","Total Inpatient Charges, Radiology-Therapeutic (C_1_C6_55)","Total Inpatient Charges, CT Scan (C_1_C6_57)","Total Inpatient Charges, MRI (C_1_C6_58)","Total Inpatient Charges, Laboratory (C_1_C6_60)","Blood Storing, Processing, Trans (C_1_C6_63)",Intravenous Therapy (C_1_C6_64),Respiratory Therapy (C_1_C6_65),Physical Therapy (C_1_C6_66),Occupational Therapy (C_1_C6_67),Speech Pathology (C_1_C6_68),Electrocardiology (C_1_C6_69),Electroencephalography (C_1_C6_70),Medical Supplies Charged to Patients (C_1_C6_71),Impl. Dev. Charged to Patients (C_1_C6_72),Drugs Charged to Patients (C_1_C6_73),Clinic (C_1_C6_90),Emergency (C_1_C6_91),Operating Room (D3_HOS_C2_50),Recovery Room (D3_HOS_C2_51),Anesthesiology (D3_HOS_C2_53),Radiology-Diagnostic (D3_HOS_C2_54),Radiology-Therapeutic (D3_HOS_C2_55),CT Scan (D3_HOS_C2_57),MRI (D3_HOS_C2_58),Laboratory (D3_HOS_C2_60),"Blood Storing, Processing, Trans (D3_HOS_C2_63)",Intravenous Therapy (D3_HOS_C2_64),Respiratory Therapy (D3_HOS_C2_65),Physical Therapy (D3_HOS_C2_66),Occupational Therapy (D3_HOS_C2_67),Speech Pathology (D3_HOS_C2_68),Electrocardiology (D3_HOS_C2_69),Electroencephalography (D3_HOS_C2_70),Medical Supplies Charged to Patients (D3_HOS_C2_71),Impl. Dev. Charged to Patients (D3_HOS_C2_72),Drugs Charged to Patients (D3_HOS_C2_73),Clinic (D3_HOS_C2_90),Emergency (D3_HOS_C2_91),Operating Room (D3_HOS_C3_50),Recovery Room (D3_HOS_C3_51),Anesthesiology (D3_HOS_C3_53),Radiology-Diagnostic (D3_HOS_C3_54),Radiology-Therapeutic (D3_HOS_C3_55),CT Scan (D3_HOS_C3_57),MRI (D3_HOS_C3_58),Laboratory (D3_HOS_C3_60),"Blood Storing, Processing, Trans (D3_HOS_C3_63)",Intravenous Therapy (D3_HOS_C3_64),Respiratory Therapy (D3_HOS_C3_65),Physical Therapy (D3_HOS_C3_66),Occupational Therapy (D3_HOS_C3_67),Speech Pathology (D3_HOS_C3_68),Electrocardiology (D3_HOS_C3_69),Electroencephalography (D3_HOS_C3_70),Medical Supplies Charged to Patients (D3_HOS_C3_71),Impl. Dev. Charged to Patients (D3_HOS_C3_72),Drugs Charged to Patients (D3_HOS_C3_73),Clinic (D3_HOS_C3_90),Emergency (D3_HOS_C3_91),Operating Room (D_4_HOS_C10_50),Recovery Room (D_4_HOS_C10_51),Anesthesiology (D_4_HOS_C10_53),Radiology-Diagnostic (D_4_HOS_C10_54),Radiology-Therapeutic (D_4_HOS_C10_55),CT Scan (D_4_HOS_C10_57),MRI (D_4_HOS_C10_58),Laboratory (D_4_HOS_C10_60),"Blood Storing, Processing, Trans (D_4_HOS_C10_63)",Intravenous Therapy (D_4_HOS_C10_64),Respiratory Therapy (D_4_HOS_C10_65),Physical Therapy (D_4_HOS_C10_66),Occupational Therapy (D_4_HOS_C10_67),Speech Pathology (D_4_HOS_C10_68),Electrocardiology (D_4_HOS_C10_69),Electroencephalography (D_4_HOS_C10_70),Medical Supplies Charged to Patients (D_4_HOS_C10_71),Impl. Dev. Charged to Patients (D_4_HOS_C10_72),Drugs Charged to Patients (D_4_HOS_C10_73),Clinic (D_4_HOS_C10_90),Emergency (D_4_HOS_C10_91),"Column 11 (Interest), New Cap Related Csts Bldg & Fixtures (A7_3_C11_1)","Column 7 (Other Capital Related Costs), New Cap Related Csts Bldg & Fixtures (A7_3_C7_1)","Column 7 (Other Capital Related Costs), New Cap Related Csts Movable Equipment (A7_3_C7_2)",Dietary (A_C1_10),Nursing Administration (A_C1_13),Other General Service (A_C1_18),Other Nonreimbursable (A_C1_194),Operation of Plant (A_C1_7),Clinic (A_C1_90),Nursing Administration (A_C2_13),Other General Service (A_C2_18),Other Nonreimbursable (A_C2_194),Laundry and Linen Service (A_C2_8),Clinic (A_C2_90),New Capital Buildings and Fixtures (A_C6_1),Cafeteria (A_C6_11),Other Nonreimbursable (A_C6_194),Clinic (A_C6_90),"Net Expense for Cost Allocation, Cafeteria (B_1_C0_11)","Net Expense for Cost Allocation, Nursing Administration (B_1_C0_13)","Net Expense for Cost Allocation, Other General Service (B_1_C0_18)","Net Expense for Cost Allocation, Other Nonreimbursable (B_1_C0_194)","Net Expense for Cost Allocation, Laundry and Linen Service (B_1_C0_8)","Gift, Flower, Coffee Shop, Canteen (B_1_C26_190)",Other Nonreimbursable (B_1_C26_194),"Gift, Flower, Coffee Shop, Canteen (B_2_C26_190)",Other Nonreimbursable (B_2_C26_194),Clinic (C_1_C7_90),Other Reimbursable (A_C1_98),Central Services and Supply (A_C2_14),Maintenance and Repairs (A_C2_6),Other Reimbursable (A_C2_98),New Capital Equipment (A_C6_2),Employee Benefits (A_C6_4),Other Reimbursable (A_C6_98),"Net Expense for Cost Allocation, Central Services and Supply (B_1_C0_14)","Net Expense for Cost Allocation, Maintenance and Repairs (B_1_C0_6)","Net Expense for Cost Allocation, Other Reimbursable (B_1_C0_98)",Other Reimbursable (B_1_C26_98),Other Reimbursable (B_2_C26_98),Other Reimbursable (C_1_C5_98),Other Reimbursable (C_1_C7_98),Drugs Charged to Patients (D_4_HOS_C12_73),Other Reimbursable (D_4_HOS_C12_98),"PPS REIMBURSED SERVICES -  CHARGES, Drugs Charged to Patients (D_5_HOS_C2_73)","PPS REIMBURSED SERVICES -  CHARGES, Other Reimbursable (D_5_HOS_C2_98)","PPS SERVICES COST, Drugs Charged to Patients (D_5_HOS_C5_73)","PPS SERVICES COST, Other Reimbursable (D_5_HOS_C5_98)",Employee Benefits (A_C1_4),Radiology-Diagnostic (A_C1_54),Maintenance and Repairs (A_C1_6),Laboratory (A_C1_60),Laundry and Linen Service (A_C1_8),Operation of Plant (A_C6_7),Nonpaid Workers (B_1_C26_193),Nonpaid Workers (B_2_C26_193),Dietary (A_C6_10),Research (B_1_C26_191),Research (B_2_C26_191),Clinic (D_4_HOS_C12_90),"PPS REIMBURSED SERVICES -  CHARGES, Clinic (D_5_HOS_C2_90)","PPS SERVICES COST, Clinic (D_5_HOS_C5_90)",Research (A_C2_191),Maintenance and Repairs (A_C6_6),"Net Expense for Cost Allocation, Research (B_1_C0_191)","Net Expense for Cost Allocation, Interns & Res Salary and Fringe Benefits (B_1_C0_21)","Allocation of Interns & Residents Salary and Fringes, Interns & Res Salary and Fringe Benefits (B_1_C21_21)",Clinic (B_1_C21_90),Clinic (B_1_C22_90),Operating Room (A_C1_50),Delivery Room and Labor Room (A_C1_52),Delivery Room and Labor Room (A_C2_52),Nursing Administration (A_C6_13),Central Services and Supply (A_C6_14),Delivery Room and Labor Room (A_C6_52),Laundry and Linen Service (A_C6_8),Housekeeping (A_C6_9),"Net Expense for Cost Allocation, Delivery Room and Labor Room (B_1_C0_52)",Delivery Room and Labor Room (B_1_C26_52),"TOTAL CAPITAL COSTS AFTER COST ALLOCATION, Delivery Room and Labor Room (B_2_C26_52)",Delivery Room and Labor Room (C_1_C5_52),"Total Inpatient Charges, Delivery Room and Labor Room (C_1_C6_52)","Total Outpatient Charges, Operating Room (C_1_C7_50)","Total Outpatient Charges, Delivery Room and Labor Room (C_1_C7_52)","Total Outpatient Charges, Radiology-Diagnostic (C_1_C7_54)","Total Outpatient Charges, Laboratory (C_1_C7_60)",Medical Supplies Charged to Patients (C_1_C7_71),Drugs Charged to Patients (C_1_C7_73),Operating Room (D_4_HOS_C12_50),"PPS REIMBURSED SERVICES -  CHARGES, Operating Room (D_5_HOS_C2_50)","PPS SERVICES COST, Operating Room (D_5_HOS_C5_50)",Speech Pathology (A_C1_68),Drugs Charged to Patients (A_C1_73),CT Scan (A_C2_57),MRI (A_C2_58),Physical Therapy (A_C6_66),Occupational Therapy (A_C6_67),Speech Pathology (A_C6_68),Electrocardiology (A_C6_69),Drugs Charged to Patients (A_C6_73),Respiratory Therapy (C_1_C7_65),Electrocardiology (C_1_C7_69),Radiology-Diagnostic (D_4_HOS_C12_54),Laboratory (D_4_HOS_C12_60),Respiratory Therapy (D_4_HOS_C12_65),Electrocardiology (D_4_HOS_C12_69),"PPS REIMBURSED SERVICES -  CHARGES, Radiology-Diagnostic (D_5_HOS_C2_54)","PPS REIMBURSED SERVICES -  CHARGES, Laboratory (D_5_HOS_C2_60)","PPS REIMBURSED SERVICES -  CHARGES, Respiratory Therapy (D_5_HOS_C2_65)","PPS REIMBURSED SERVICES -  CHARGES, Electrocardiology (D_5_HOS_C2_69)","PPS SERVICES COST, Radiology-Diagnostic (D_5_HOS_C5_54)","PPS SERVICES COST, Laboratory (D_5_HOS_C5_60)","PPS SERVICES COST, Respiratory Therapy (D_5_HOS_C5_65)","PPS SERVICES COST, Electrocardiology (D_5_HOS_C5_69)","Column 5 (Insurance), New Cap Related Csts Bldg & Fixtures (A7_3_C5_1)","Column 5 (Insurance), New Cap Related Csts Movable Equipment (A7_3_C5_2)",Other Ancillary (A_C1_76),Other Ancillary (A_C2_76),Radiology-Diagnostic (A_C6_54),"Net Expense for Cost Allocation, Other Ancillary (B_1_C0_76)",Other Ancillary (B_1_C26_76),Other Ancillary (B_2_C26_76),Other Ancillary (C_1_C5_76),"Column 6 (Taxes), New Cap Related Csts Bldg & Fixtures (A7_3_C6_1)","Column 6 (Taxes), New Cap Related Csts Movable Equipment (A7_3_C6_2)",Central Services and Supply (A_C1_14),Intensive Care Unit (A_C1_31),Intensive Care Unit (A_C2_31),Operating Room (A_C6_50),Laboratory (A_C6_60),Respiratory Therapy (A_C6_65),"Net Expense for Cost Allocation, Intensive Care Unit (B_1_C0_31)",Intensive Care Unit (B_1_C26_31),"TOTAL CAPITAL COSTS AFTER COST ALLOCATION, Intensive Care Unit (B_2_C26_31)",Intensive Care Unit (C_1_C5_31),"Total Inpatient Charges, Intensive Care Unit (C_1_C6_31)",Physical Therapy (C_1_C7_66),Intensive Care Unit Program Cost (D1_HOS_C5_43),Intensive Care Unit (D3_HOS_C2_31),Intensive Care Unit (D_1_HOS_C4_31),Intensive Care Unit (D_1_HOS_C6_31),Intensive Care Unit (D_1_HOS_C7_31),"COST REIMBURSED SERVICES SUBJECT TO DEDUCTIBLES  AND COINSURANCE - CHARGES, Radiology-Diagnostic (D_5_HOS_C3_54)","COST REIMBURSED SERVICES SUBJECT TO DEDUCTIBLES  AND COINSURANCE - CHARGES, Respiratory Therapy (D_5_HOS_C3_65)","COST SERVICES SUBJECT TO DEDUCTIBLES AND COINSURANCE - COST, Radiology-Diagnostic (D_5_HOS_C6_54)","COST SERVICES SUBJECT TO DEDUCTIBLES AND COINSURANCE - COST, Respiratory Therapy (D_5_HOS_C6_65)",Intensive Care Unit (S3_1_C2_8),Intensive Care Unit (S3_1_C3_8),Intensive Care Unit (S3_1_C6_8),Intensive Care Unit (S3_1_C8_8),"Gift, Flower, Coffee Shop, Canteen (A_C1_190)",Coronary Care Unit (A_C1_32),Surgical Intensive Care Unit (A_C1_34),Recovery Room (A_C1_51),Anesthesiology (A_C1_53),Radioisotope (A_C1_56),CT Scan (A_C1_57),MRI (A_C1_58),Cardiac Catheterization (A_C1_59),Intravenous Therapy (A_C1_64),Electroencephalography (A_C1_70),Emergency (A_C1_91),"Gift, Flower, Coffee Shop, Canteen (A_C2_190)",Coronary Care Unit (A_C2_32),Surgical Intensive Care Unit (A_C2_34),Radioisotope (A_C2_56),Cardiac Catheterization (A_C2_59),Intravenous Therapy (A_C2_64),Emergency (A_C2_91),Nonphysician Anesthetists (A_C6_19),CT Scan (A_C6_57),Cardiac Catheterization (A_C6_59),Electroencephalography (A_C6_70),Emergency (A_C6_91),"Net Expense for Cost Allocation, Gift, Flower, Coffee Shop, Canteen (B_1_C0_190)","Net Expense for Cost Allocation, Paramedical Education (B_1_C0_23)","Net Expense for Cost Allocation, Coronary Care Unit (B_1_C0_32)","Net Expense for Cost Allocation, Surgical Intensive Care Unit (B_1_C0_34)","Net Expense for Cost Allocation, Radioisotope (B_1_C0_56)","Net Expense for Cost Allocation, Cardiac Catheterization (B_1_C0_59)",Physicians' Private Office (B_1_C26_192),Coronary Care Unit (B_1_C26_32),Surgical Intensive Care Unit (B_1_C26_34),Radioisotope (B_1_C26_56),Cardiac Catheterization (B_1_C26_59),Physicians' Private Office (B_2_C26_192),"TOTAL CAPITAL COSTS AFTER COST ALLOCATION, Coronary Care Unit (B_2_C26_32)","TOTAL CAPITAL COSTS AFTER COST ALLOCATION, Surgical Intensive Care Unit (B_2_C26_34)","TOTAL CAPITAL COSTS AFTER COST ALLOCATION, Radioisotope (B_2_C26_56)","TOTAL CAPITAL COSTS AFTER COST ALLOCATION, Cardiac Catheterization (B_2_C26_59)",Coronary Care Unit (C_1_C5_32),Surgical Intensive Care Unit (C_1_C5_34),Radioisotope (C_1_C5_56),Cardiac Catheterization (C_1_C5_59),"Total Inpatient Charges, Coronary Care Unit (C_1_C6_32)","Total Inpatient Charges, Surgical Intensive Care Unit (C_1_C6_34)","Total Inpatient Charges, Radioisotope (C_1_C6_56)","Total Inpatient Charges, Cardiac Catheterization (C_1_C6_59)","Total Outpatient Charges, Recovery Room (C_1_C7_51)","Total Outpatient Charges, Anesthesiology (C_1_C7_53)","Total Outpatient Charges, Radioisotope (C_1_C7_56)","Total Outpatient Charges, CT Scan (C_1_C7_57)","Total Outpatient Charges, MRI (C_1_C7_58)","Total Outpatient Charges, Cardiac Catheterization (C_1_C7_59)",Intravenous Therapy (C_1_C7_64),Electroencephalography (C_1_C7_70),Impl. Dev. Charged to Patients (C_1_C7_72),Emergency (C_1_C7_91),Coronary Care Unit (D3_HOS_C2_32),Surgical Intensive Care Unit (D3_HOS_C2_34),Delivery Room and Labor Room (D3_HOS_C2_52),Radioisotope (D3_HOS_C2_56),Cardiac Catheterization (D3_HOS_C2_59),Delivery Room and Labor Room (D3_HOS_C3_52),Radioisotope (D3_HOS_C3_56),Cardiac Catheterization (D3_HOS_C3_59),Coronary Intensive Care Unit (D_1_HOS_C4_32),Surgical Intensive Care Unit (D_1_HOS_C4_34),Coronary Intensive Care Unit (D_1_HOS_C6_32),Surgical Intensive Care Unit (D_1_HOS_C6_34),Coronary Intensive Care Unit (D_1_HOS_C7_32),Surgical Intensive Care Unit (D_1_HOS_C7_34),Delivery Room and Labor Room (D_4_HOS_C10_52),Radioisotope (D_4_HOS_C10_56),Cardiac Catheterization (D_4_HOS_C10_59),Operating Room (D_4_HOS_C11_50),Recovery Room (D_4_HOS_C12_51),Delivery Room and Labor Room (D_4_HOS_C12_52),Anesthesiology (D_4_HOS_C12_53),Radioisotope (D_4_HOS_C12_56),CT Scan (D_4_HOS_C12_57),MRI (D_4_HOS_C12_58),Cardiac Catheterization (D_4_HOS_C12_59),Intravenous Therapy (D_4_HOS_C12_64),Physical Therapy (D_4_HOS_C12_66),Electroencephalography (D_4_HOS_C12_70),Medical Supplies Charged to Patients (D_4_HOS_C12_71),Impl. Dev. Charged to Patients (D_4_HOS_C12_72),Emergency (D_4_HOS_C12_91),Operating Room (D_4_HOS_C13_50),Operating Room (D_4_HOS_C3_50),"PPS REIMBURSED SERVICES -  CHARGES, Recovery Room (D_5_HOS_C2_51)","PPS REIMBURSED SERVICES -  CHARGES, Delivery Room and Labor Room (D_5_HOS_C2_52)","PPS REIMBURSED SERVICES -  CHARGES, Anesthesiology (D_5_HOS_C2_53)","PPS REIMBURSED SERVICES -  CHARGES, Radioisotope (D_5_HOS_C2_56)","PPS REIMBURSED SERVICES -  CHARGES, CT Scan (D_5_HOS_C2_57)","PPS REIMBURSED SERVICES -  CHARGES, MRI (D_5_HOS_C2_58)","PPS REIMBURSED SERVICES -  CHARGES, Cardiac Catheterization (D_5_HOS_C2_59)","PPS REIMBURSED SERVICES -  CHARGES, Intravenous Therapy (D_5_HOS_C2_64)","PPS REIMBURSED SERVICES -  CHARGES, Physical Therapy (D_5_HOS_C2_66)","PPS REIMBURSED SERVICES -  CHARGES, Electroencephalography (D_5_HOS_C2_70)","PPS REIMBURSED SERVICES -  CHARGES, Medical Supplies Charged to Patients (D_5_HOS_C2_71)","PPS REIMBURSED SERVICES -  CHARGES, Impl. Dev. Charged to Patients (D_5_HOS_C2_72)","PPS REIMBURSED SERVICES -  CHARGES, Emergency (D_5_HOS_C2_91)","COST REIMBURSED SERVICES SUBJECT TO DEDUCTIBLES  AND COINSURANCE - CHARGES, Drugs Charged to Patients (D_5_HOS_C3_73)","COST REIMBURSED SERVICES NOT SUBJECT TO DEDUCTIBLES AND COINSURANCE - CHARGES, Laboratory (D_5_HOS_C4_60)","COST REIMBURSED SERVICES NOT SUBJECT TO DEDUCTIBLES AND COINSURANCE - CHARGES, Impl. Dev. Charged to Patients (D_5_HOS_C4_72)","COST REIMBURSED SERVICES NOT SUBJECT TO DEDUCTIBLES AND COINSURANCE - CHARGES, Drugs Charged to Patients (D_5_HOS_C4_73)","PPS SERVICES COST, Recovery Room (D_5_HOS_C5_51)","PPS SERVICES COST, Delivery Room and Labor Room (D_5_HOS_C5_52)","PPS SERVICES COST, Anesthesiology (D_5_HOS_C5_53)","PPS SERVICES COST, Radioisotope (D_5_HOS_C5_56)","PPS SERVICES COST, CT Scan (D_5_HOS_C5_57)","PPS SERVICES COST, MRI (D_5_HOS_C5_58)","PPS SERVICES COST, Cardiac Catheterization (D_5_HOS_C5_59)","PPS SERVICES COST, Intravenous Therapy (D_5_HOS_C5_64)","PPS SERVICES COST, Physical Therapy (D_5_HOS_C5_66)","PPS SERVICES COST, Electroencephalography (D_5_HOS_C5_70)","PPS SERVICES COST, Medical Supplies Charged to Patients (D_5_HOS_C5_71)","PPS SERVICES COST, Impl. Dev. Charged to Patients (D_5_HOS_C5_72)","PPS SERVICES COST, Emergency (D_5_HOS_C5_91)","COST SERVICES SUBJECT TO DEDUCTIBLES AND COINSURANCE - COST, Drugs Charged to Patients (D_5_HOS_C6_73)","COST SERVICES NOT SUBJECT TO DEDUCTIBLES AND COINSURANCE - COST, Laboratory (D_5_HOS_C7_60)","COST SERVICES NOT SUBJECT TO DEDUCTIBLES AND COINSURANCE - COST, Impl. Dev. Charged to Patients (D_5_HOS_C7_72)","COST SERVICES NOT SUBJECT TO DEDUCTIBLES AND COINSURANCE - COST, Drugs Charged to Patients (D_5_HOS_C7_73)",Surgical Intensive Care Unit (S3_1_C2_11),Coronary Care Unit (S3_1_C2_9),Surgical Intensive Care Unit (S3_1_C3_11),Coronary Care Unit (S3_1_C3_9),Surgical Intensive Care Unit (S3_1_C6_11),Coronary Care Unit (S3_1_C6_9),Surgical Intensive Care Unit (S3_1_C7_11),Intensive Care Unit (S3_1_C7_8),Coronary Care Unit (S3_1_C7_9),Surgical Intensive Care Unit (S3_1_C8_11),Coronary Care Unit (S3_1_C8_9),Medical Supplies Charged to Patients (A_C1_71),Medical Supplies Charged to Patients (A_C6_71),"Net Expense for Cost Allocation, Physicians' Private Office (B_1_C0_192)",Other Ancillary (C_1_C6_76),Occupational Therapy (C_1_C7_67),Speech Pathology (C_1_C7_68),Other Ancillary (C_1_C7_76),Other Ancillary (D3_HOS_C2_76),Other Ancillary (D3_HOS_C3_76),Other Ancillary (D_4_HOS_C10_76),Other Ancillary (D_4_HOS_C12_76),"PPS REIMBURSED SERVICES -  CHARGES, Other Ancillary (D_5_HOS_C2_76)","PPS SERVICES COST, Other Ancillary (D_5_HOS_C5_76)",Whole Blood & Packed Red Blood Cells (A_C2_62),Anesthesiology (A_C6_53),Whole Blood & Packed Red Blood Cells (A_C6_62),"Net Expense for Cost Allocation, Whole Blood & Packed Red Blood Cells (B_1_C0_62)",Whole Blood & Packed Red Blood Cells (B_1_C26_62),"TOTAL CAPITAL COSTS AFTER COST ALLOCATION, Whole Blood & Packed Red Blood Cells (B_2_C26_62)",Whole Blood & Packed Red Blood Cells (C_1_C5_62),"Total Inpatient Charges, Whole Blood & Packed Red Blood Cells (C_1_C6_62)","Total Outpatient Charges, Whole Blood & Packed Red Blood Cells (C_1_C7_62)",Whole Blood & Packed Red Blood Cells (D3_HOS_C2_62),Whole Blood & Packed Red Blood Cells (D3_HOS_C3_62),Whole Blood & Packed Red Blood Cells (D_4_HOS_C10_62),Whole Blood & Packed Red Blood Cells (D_4_HOS_C12_62),"PPS REIMBURSED SERVICES -  CHARGES, Whole Blood & Packed Red Blood Cells (D_5_HOS_C2_62)","COST REIMBURSED SERVICES NOT SUBJECT TO DEDUCTIBLES AND COINSURANCE - CHARGES, Radiology-Diagnostic (D_5_HOS_C4_54)","PPS SERVICES COST, Whole Blood & Packed Red Blood Cells (D_5_HOS_C5_62)","COST SERVICES NOT SUBJECT TO DEDUCTIBLES AND COINSURANCE - COST, Radiology-Diagnostic (D_5_HOS_C7_54)",HHA (A_C1_101),Physicians' Private Office (A_C1_192),Physicians' Private Office (A_C2_192),Interns & Res Other Program Costs (A_C2_22),Intensive Care Unit (A_C6_31),"Net Expense for Cost Allocation, Interns & Res Other Program Costs (B_1_C0_22)",Operating Room (D3_IPF_C2_50),Recovery Room (D3_IPF_C2_51),Anesthesiology (D3_IPF_C2_53),Radiology-Diagnostic (D3_IPF_C2_54),Radioisotope (D3_IPF_C2_56),Laboratory (D3_IPF_C2_60),Respiratory Therapy (D3_IPF_C2_65),Physical Therapy (D3_IPF_C2_66),Occupational Therapy (D3_IPF_C2_67),Speech Pathology (D3_IPF_C2_68),Electrocardiology (D3_IPF_C2_69),Medical Supplies Charged to Patients (D3_IPF_C2_71),Impl. Dev. Charged to Patients (D3_IPF_C2_72),Drugs Charged to Patients (D3_IPF_C2_73),Emergency (D3_IPF_C2_91),Operating Room (D3_IPF_C3_50),Recovery Room (D3_IPF_C3_51),Anesthesiology (D3_IPF_C3_53),Radiology-Diagnostic (D3_IPF_C3_54),Radioisotope (D3_IPF_C3_56),Laboratory (D3_IPF_C3_60),Respiratory Therapy (D3_IPF_C3_65),Physical Therapy (D3_IPF_C3_66),Occupational Therapy (D3_IPF_C3_67),Speech Pathology (D3_IPF_C3_68),Electrocardiology (D3_IPF_C3_69),Medical Supplies Charged to Patients (D3_IPF_C3_71),Impl. Dev. Charged to Patients (D3_IPF_C3_72),Drugs Charged to Patients (D3_IPF_C3_73),Emergency (D3_IPF_C3_91),Operating Room (D3_IRF_C2_50),Recovery Room (D3_IRF_C2_51),Anesthesiology (D3_IRF_C2_53),Radiology-Diagnostic (D3_IRF_C2_54),Radioisotope (D3_IRF_C2_56),Laboratory (D3_IRF_C2_60),Respiratory Therapy (D3_IRF_C2_65),Physical Therapy (D3_IRF_C2_66),Occupational Therapy (D3_IRF_C2_67),Speech Pathology (D3_IRF_C2_68),Electrocardiology (D3_IRF_C2_69),Medical Supplies Charged to Patients (D3_IRF_C2_71),Impl. Dev. Charged to Patients (D3_IRF_C2_72),Drugs Charged to Patients (D3_IRF_C2_73),Clinic (D3_IRF_C2_90),Operating Room (D3_IRF_C3_50),Recovery Room (D3_IRF_C3_51),Anesthesiology (D3_IRF_C3_53),Radiology-Diagnostic (D3_IRF_C3_54),Radioisotope (D3_IRF_C3_56),Laboratory (D3_IRF_C3_60),Respiratory Therapy (D3_IRF_C3_65),Physical Therapy (D3_IRF_C3_66),Occupational Therapy (D3_IRF_C3_67),Speech Pathology (D3_IRF_C3_68),Electrocardiology (D3_IRF_C3_69),Medical Supplies Charged to Patients (D3_IRF_C3_71),Impl. Dev. Charged to Patients (D3_IRF_C3_72),Drugs Charged to Patients (D3_IRF_C3_73),Clinic (D3_IRF_C3_90),Occupational Therapy (D_4_HOS_C12_67),"PPS REIMBURSED SERVICES -  CHARGES, Occupational Therapy (D_5_HOS_C2_67)","PPS SERVICES COST, Occupational Therapy (D_5_HOS_C5_67)",Hospice (A_C1_116),HHA (A_C2_101),Hospice (A_C2_116),"Net Expense for Cost Allocation, HHA (B_1_C0_101)","Net Expense for Cost Allocation, Hospice (B_1_C0_116)",HHA (B_1_C26_101),Hospice (B_1_C26_116),HHA (B_2_C26_101),Hospice (B_2_C26_116),HHA (C_1_C5_101),Hospice (C_1_C5_116),Radiology-Diagnostic (D3_SNF_C2_54),Laboratory (D3_SNF_C2_60),Physical Therapy (D3_SNF_C2_66),Occupational Therapy (D3_SNF_C2_67),Speech Pathology (D3_SNF_C2_68),Medical Supplies Charged to Patients (D3_SNF_C2_71),Drugs Charged to Patients (D3_SNF_C2_73),Radiology-Diagnostic (D3_SNF_C3_54),Laboratory (D3_SNF_C3_60),Physical Therapy (D3_SNF_C3_66),Occupational Therapy (D3_SNF_C3_67),Speech Pathology (D3_SNF_C3_68),Medical Supplies Charged to Patients (D3_SNF_C3_71),Drugs Charged to Patients (D3_SNF_C3_73),HHA (S3_1_C10_22),Hospice (S3_1_C10_24),HHA (S3_1_C8_22),"Column 11 (Interest), New Cap Related Csts Movable Equipment (A7_3_C11_2)",Paramedical Education (A_C1_23),Other Special Care Unit (A_C1_35),Radiology-Therapeutic (A_C1_55),ASC (Non Distinct Part) (A_C1_75),Paramedical Education (A_C2_23),Other Special Care Unit (A_C2_35),ASC (Non Distinct Part) (A_C2_75),Interns & Res Other Program Costs (A_C6_22),Paramedical Education (A_C6_23),Other Special Care Unit (A_C6_35),Radiology-Therapeutic (A_C6_55),Radioisotope (A_C6_56),ASC (Non Distinct Part) (A_C6_75),"Net Expense for Cost Allocation, Other Special Care Unit (B_1_C0_35)","Net Expense for Cost Allocation, ASC (Non Distinct Part) (B_1_C0_75)","Allocation of Interns & Residents Program Costs, Intensive Care Unit (B_1_C22_31)","Allocation of Interns & Residents Program Costs, Operating Room (B_1_C22_50)","Allocation of Interns & Residents Program Costs, Laboratory (B_1_C22_60)",Other Special Care Unit (B_1_C26_35),ASC (Non Distinct Part) (B_1_C26_75),"TOTAL CAPITAL COSTS AFTER COST ALLOCATION, Other Special Care Unit (B_2_C26_35)",ASC (Non Distinct Part) (B_2_C26_75),Other Special Care Unit (C_1_C5_35),ASC (Non Distinct Part) (C_1_C5_75),"Total Inpatient Charges, Other Special Care Unit (C_1_C6_35)",ASC (Non Distinct Part) (C_1_C6_75),"Total Outpatient Charges, Radiology-Therapeutic (C_1_C7_55)",ASC (Non Distinct Part) (C_1_C7_75),ASC (Non Distinct Part) (D3_HOS_C2_75),ASC (Non Distinct Part) (D3_HOS_C3_75),CT Scan (D3_IPF_C2_57),MRI (D3_IPF_C2_58),Clinic (D3_IPF_C2_90),CT Scan (D3_IPF_C3_57),MRI (D3_IPF_C3_58),Clinic (D3_IPF_C3_90),Radiology-Therapeutic (D3_IRF_C2_55),CT Scan (D3_IRF_C2_57),MRI (D3_IRF_C2_58),Electroencephalography (D3_IRF_C2_70),ASC (Non Distinct Part) (D3_IRF_C2_75),Emergency (D3_IRF_C2_91),Radiology-Therapeutic (D3_IRF_C3_55),CT Scan (D3_IRF_C3_57),MRI (D3_IRF_C3_58),Electroencephalography (D3_IRF_C3_70),ASC (Non Distinct Part) (D3_IRF_C3_75),Emergency (D3_IRF_C3_91),Other Special Care Unit (D_1_HOS_C4_35),Intensive Care Unit (D_3_HOS_C9_31),ASC (Non Distinct Part) (D_4_HOS_C10_75),Radiology-Therapeutic (D_4_HOS_C12_55),ASC (Non Distinct Part) (D_4_HOS_C12_75),"PPS REIMBURSED SERVICES -  CHARGES, Radiology-Therapeutic (D_5_HOS_C2_55)","PPS REIMBURSED SERVICES -  CHARGES, ASC (Non Distinct Part) (D_5_HOS_C2_75)","COST REIMBURSED SERVICES SUBJECT TO DEDUCTIBLES  AND COINSURANCE - CHARGES, Impl. Dev. Charged to Patients (D_5_HOS_C3_72)","COST REIMBURSED SERVICES SUBJECT TO DEDUCTIBLES  AND COINSURANCE - CHARGES, Emergency (D_5_HOS_C3_91)","PPS SERVICES COST, Radiology-Therapeutic (D_5_HOS_C5_55)","PPS SERVICES COST, ASC (Non Distinct Part) (D_5_HOS_C5_75)","COST SERVICES SUBJECT TO DEDUCTIBLES AND COINSURANCE - COST, Impl. Dev. Charged to Patients (D_5_HOS_C6_72)","COST SERVICES SUBJECT TO DEDUCTIBLES AND COINSURANCE - COST, Emergency (D_5_HOS_C6_91)",Other Special Care (S3_1_C2_12),Other Special Care (S3_1_C3_12),Other Special Care (S3_1_C7_12),Other Special Care (S3_1_C8_12),"COST REIMBURSED SERVICES SUBJECT TO DEDUCTIBLES  AND COINSURANCE - CHARGES, Laboratory (D_5_HOS_C3_60)","COST SERVICES SUBJECT TO DEDUCTIBLES AND COINSURANCE - COST, Laboratory (D_5_HOS_C6_60)",Physicians' Private Office (A_C6_192),HHA (S3_1_C6_22),Whole Blood & Packed Red Blood Cells (A_C1_62),Durable Medical Equipment Sold (A_C1_97),Durable Medical Equipment Sold (A_C2_97),"Net Expense for Cost Allocation, Durable Medical Equipment Sold (B_1_C0_97)",Durable Medical Equipment Sold (B_1_C26_97),Durable Medical Equipment Sold (B_2_C26_97),Durable Medical Equipment Sold (C_1_C5_97),Durable Medical Equipment Sold (C_1_C7_97),Whole Blood & Packed Red Blood Cells (D3_SNF_C2_62),Electrocardiology (D3_SNF_C2_69),Whole Blood & Packed Red Blood Cells (D3_SNF_C3_62),Electrocardiology (D3_SNF_C3_69),RHC (A_C1_88),Other Outpatient Services (A_C1_93),RHC (A_C2_88),Other Outpatient Services (A_C2_93),RHC (A_C6_88),Other Outpatient Services (A_C6_93),"Net Expense for Cost Allocation, RHC (B_1_C0_88)","Net Expense for Cost Allocation, Other Outpatient Services (B_1_C0_93)",RHC (B_1_C26_88),Other Outpatient Services (B_1_C26_93),RHC (B_2_C26_88),Other Outpatient Services (B_2_C26_93),RHC (C_1_C7_88),Other Outpatient Services (C_1_C7_93),"COST REIMBURSED SERVICES SUBJECT TO DEDUCTIBLES  AND COINSURANCE - CHARGES, Operating Room (D_5_HOS_C3_50)","COST REIMBURSED SERVICES SUBJECT TO DEDUCTIBLES  AND COINSURANCE - CHARGES, Physical Therapy (D_5_HOS_C3_66)","COST REIMBURSED SERVICES SUBJECT TO DEDUCTIBLES  AND COINSURANCE - CHARGES, Speech Pathology (D_5_HOS_C3_68)","COST REIMBURSED SERVICES SUBJECT TO DEDUCTIBLES  AND COINSURANCE - CHARGES, Electrocardiology (D_5_HOS_C3_69)","COST REIMBURSED SERVICES SUBJECT TO DEDUCTIBLES  AND COINSURANCE - CHARGES, Medical Supplies Charged to Patients (D_5_HOS_C3_71)","COST REIMBURSED SERVICES SUBJECT TO DEDUCTIBLES  AND COINSURANCE - CHARGES, Other Outpatient Services (D_5_HOS_C3_93)","COST SERVICES SUBJECT TO DEDUCTIBLES AND COINSURANCE - COST, Operating Room (D_5_HOS_C6_50)","COST SERVICES SUBJECT TO DEDUCTIBLES AND COINSURANCE - COST, Physical Therapy (D_5_HOS_C6_66)","COST SERVICES SUBJECT TO DEDUCTIBLES AND COINSURANCE - COST, Speech Pathology (D_5_HOS_C6_68)","COST SERVICES SUBJECT TO DEDUCTIBLES AND COINSURANCE - COST, Electrocardiology (D_5_HOS_C6_69)","COST SERVICES SUBJECT TO DEDUCTIBLES AND COINSURANCE - COST, Medical Supplies Charged to Patients (D_5_HOS_C6_71)","COST SERVICES SUBJECT TO DEDUCTIBLES AND COINSURANCE - COST, Other Outpatient Services (D_5_HOS_C6_93)",RHC/FQHC Combined (S3_1_C10_26),RHC/FQHC Combined (S3_1_C6_26),RHC/FQHC Combined (S3_1_C7_26),RHC/FQHC Combined (S3_1_C8_26),Nonphysician Anesthetists (A_C1_19),Nonphysician Anesthetists (A_C2_19),Impl. Dev. Charged to Patients (A_C2_72),"Net Expense for Cost Allocation, Nonphysician Anesthetists (B_1_C0_19)",RHC (C_1_C5_88),RHC (C_1_C6_88),Respiratory Therapy (D3_SNF_C2_65),Clinic (D3_SNF_C2_90),Emergency (D3_SNF_C2_91),Respiratory Therapy (D3_SNF_C3_65),Clinic (D3_SNF_C3_90),Emergency (D3_SNF_C3_91),Anesthesiology (D_4_HOS_C11_53),Anesthesiology (D_4_HOS_C1_53),"COST REIMBURSED SERVICES SUBJECT TO DEDUCTIBLES  AND COINSURANCE - CHARGES, Anesthesiology (D_5_HOS_C3_53)","COST REIMBURSED SERVICES SUBJECT TO DEDUCTIBLES  AND COINSURANCE - CHARGES, Clinic (D_5_HOS_C3_90)","COST SERVICES SUBJECT TO DEDUCTIBLES AND COINSURANCE - COST, Anesthesiology (D_5_HOS_C6_53)","COST SERVICES SUBJECT TO DEDUCTIBLES AND COINSURANCE - COST, Clinic (D_5_HOS_C6_90)",Observation Beds (Distinct Unit) (A_C1_9201),"Net Expense for Cost Allocation, Observation Beds (Distinct Unit) (B_1_C0_9201)",Observation Beds (Distinct Unit) (B_1_C26_9201),Observation Beds (Distinct Unit) (B_2_C26_9201),Observation Beds (Distinct Unit) (C_1_C5_9201),Observation Beds (Distinct Unit) (C_1_C6_9201),Observation Beds (Distinct Unit) (C_1_C7_9201),Observation Beds (Distinct Unit) (D3_HOS_C2_9201),Observation Beds (Distinct Unit) (D3_HOS_C3_9201),Observation Beds (Distinct Unit) (D_4_HOS_C10_9201),Observation Beds (Distinct Unit) (D_4_HOS_C12_9201),"PPS REIMBURSED SERVICES -  CHARGES, Observation Beds (Distinct Unit) (D_5_HOS_C2_9201)","PPS SERVICES COST, Observation Beds (Distinct Unit) (D_5_HOS_C5_9201)",HHA (A_C6_101),HHA (C_1_C7_101),Other Ancillary (A_C6_76),HHA (S3_1_C7_22),"Blood Storing, Processing, Trans (C_1_C7_63)","Blood Storing, Processing, Trans (D_4_HOS_C12_63)","PPS REIMBURSED SERVICES -  CHARGES, Blood Storing, Processing, Trans (D_5_HOS_C2_63)","PPS SERVICES COST, Blood Storing, Processing, Trans (D_5_HOS_C5_63)",Nonpaid Workers (A_C2_193),"Net Expense for Cost Allocation, Nonpaid Workers (B_1_C0_193)",Other adjustments (E_B_HOS_C1_39),"Gift, Flower, Coffee Shop, Canteen (A_C6_190)",MRI (A_C6_58),Other Outpatient Services (C_1_C5_93),Other General Service (A_C6_18),"COST REIMBURSED SERVICES SUBJECT TO DEDUCTIBLES  AND COINSURANCE - CHARGES, Occupational Therapy (D_5_HOS_C3_67)","COST SERVICES SUBJECT TO DEDUCTIBLES AND COINSURANCE - COST, Occupational Therapy (D_5_HOS_C6_67)",Research (A_C1_191),Hospice (C_1_C6_116),Hospice (C_1_C7_116),"COST REIMBURSED SERVICES SUBJECT TO DEDUCTIBLES  AND COINSURANCE - CHARGES, Recovery Room (D_5_HOS_C3_51)","COST REIMBURSED SERVICES SUBJECT TO DEDUCTIBLES  AND COINSURANCE - CHARGES, Blood Storing, Processing, Trans (D_5_HOS_C3_63)","COST SERVICES SUBJECT TO DEDUCTIBLES AND COINSURANCE - COST, Recovery Room (D_5_HOS_C6_51)","COST SERVICES SUBJECT TO DEDUCTIBLES AND COINSURANCE - COST, Blood Storing, Processing, Trans (D_5_HOS_C6_63)",Intensive Care Unit (S3_1_C4_8),Interns & Res Salary and Fringe Benefits (A_C1_21),"Blood Storing, Processing, Trans (A_C1_63)",Interns & Res Salary and Fringe Benefits (A_C2_21),Interns & Res Salary and Fringe Benefits (A_C6_21),Recovery Room (A_C6_51),"Blood Storing, Processing, Trans (A_C6_63)",Intravenous Therapy (A_C6_64),Other Nonreimbursable (B_1_C21_194),"Allocation of Interns & Residents Salary and Fringes, Intensive Care Unit (B_1_C21_31)","Allocation of Interns & Residents Salary and Fringes, Operating Room (B_1_C21_50)","Allocation of Interns & Residents Salary and Fringes, Recovery Room (B_1_C21_51)","Allocation of Interns & Residents Salary and Fringes, Delivery Room and Labor Room (B_1_C21_52)","Allocation of Interns & Residents Salary and Fringes, Anesthesiology (B_1_C21_53)","Allocation of Interns & Residents Salary and Fringes, Radiology-Diagnostic (B_1_C21_54)","Allocation of Interns & Residents Salary and Fringes, Radiology-Therapeutic (B_1_C21_55)","Allocation of Interns & Residents Salary and Fringes, Radioisotope (B_1_C21_56)","Allocation of Interns & Residents Salary and Fringes, CT Scan (B_1_C21_57)","Allocation of Interns & Residents Salary and Fringes, MRI (B_1_C21_58)","Allocation of Interns & Residents Salary and Fringes, Cardiac Catheterization (B_1_C21_59)","Allocation of Interns & Residents Salary and Fringes, Laboratory (B_1_C21_60)","Allocation of Interns & Residents Salary and Fringes, Blood Storing, Processing, Trans (B_1_C21_63)","Allocation of Interns & Residents Salary and Fringes, Respiratory Therapy (B_1_C21_65)","Allocation of Interns & Residents Salary and Fringes, Electrocardiology (B_1_C21_69)","Allocation of Interns & Residents Salary and Fringes, Electroencephalography (B_1_C21_70)",Emergency (B_1_C21_91),Other Nonreimbursable (B_1_C22_194),"Allocation of Interns & Residents Program Costs, Recovery Room (B_1_C22_51)","Allocation of Interns & Residents Program Costs, Delivery Room and Labor Room (B_1_C22_52)","Allocation of Interns & Residents Program Costs, Anesthesiology (B_1_C22_53)","Allocation of Interns & Residents Program Costs, Radiology-Diagnostic (B_1_C22_54)","Allocation of Interns & Residents Program Costs, Radiology-Therapeutic (B_1_C22_55)","Allocation of Interns & Residents Program Costs, Radioisotope (B_1_C22_56)","Allocation of Interns & Residents Program Costs, CT Scan (B_1_C22_57)","Allocation of Interns & Residents Program Costs, MRI (B_1_C22_58)","Allocation of Interns & Residents Program Costs, Cardiac Catheterization (B_1_C22_59)","Allocation of Interns & Residents Program Costs, Blood Storing, Processing, Trans (B_1_C22_63)","Allocation of Interns & Residents Program Costs, Respiratory Therapy (B_1_C22_65)","Allocation of Interns & Residents Program Costs, Electrocardiology (B_1_C22_69)","Allocation of Interns & Residents Program Costs, Electroencephalography (B_1_C22_70)",Emergency (B_1_C22_91),Recovery Room (D_4_HOS_C11_51),Delivery Room and Labor Room (D_4_HOS_C11_52),Radiology-Diagnostic (D_4_HOS_C11_54),Radiology-Therapeutic (D_4_HOS_C11_55),CT Scan (D_4_HOS_C11_57),MRI (D_4_HOS_C11_58),Cardiac Catheterization (D_4_HOS_C11_59),Laboratory (D_4_HOS_C11_60),Intravenous Therapy (D_4_HOS_C11_64),Electroencephalography (D_4_HOS_C11_70),Drugs Charged to Patients (D_4_HOS_C11_73),Clinic (D_4_HOS_C11_90),Emergency (D_4_HOS_C11_91),Recovery Room (D_4_HOS_C13_51),Delivery Room and Labor Room (D_4_HOS_C13_52),Anesthesiology (D_4_HOS_C13_53),Radiology-Diagnostic (D_4_HOS_C13_54),Radiology-Therapeutic (D_4_HOS_C13_55),CT Scan (D_4_HOS_C13_57),MRI (D_4_HOS_C13_58),Cardiac Catheterization (D_4_HOS_C13_59),Laboratory (D_4_HOS_C13_60),Intravenous Therapy (D_4_HOS_C13_64),Drugs Charged to Patients (D_4_HOS_C13_73),Clinic (D_4_HOS_C13_90),Emergency (D_4_HOS_C13_91),Recovery Room (D_4_HOS_C3_51),Delivery Room and Labor Room (D_4_HOS_C3_52),Anesthesiology (D_4_HOS_C3_53),Radiology-Diagnostic (D_4_HOS_C3_54),Radiology-Therapeutic (D_4_HOS_C3_55),CT Scan (D_4_HOS_C3_57),MRI (D_4_HOS_C3_58),Cardiac Catheterization (D_4_HOS_C3_59),Laboratory (D_4_HOS_C3_60),Intravenous Therapy (D_4_HOS_C3_64),Electroencephalography (D_4_HOS_C3_70),Drugs Charged to Patients (D_4_HOS_C3_73),Clinic (D_4_HOS_C3_90),Emergency (D_4_HOS_C3_91),"COST REIMBURSED SERVICES SUBJECT TO DEDUCTIBLES  AND COINSURANCE - CHARGES, Delivery Room and Labor Room (D_5_HOS_C3_52)","COST REIMBURSED SERVICES SUBJECT TO DEDUCTIBLES  AND COINSURANCE - CHARGES, Radiology-Therapeutic (D_5_HOS_C3_55)","COST REIMBURSED SERVICES SUBJECT TO DEDUCTIBLES  AND COINSURANCE - CHARGES, Radioisotope (D_5_HOS_C3_56)","COST REIMBURSED SERVICES SUBJECT TO DEDUCTIBLES  AND COINSURANCE - CHARGES, CT Scan (D_5_HOS_C3_57)","COST REIMBURSED SERVICES SUBJECT TO DEDUCTIBLES  AND COINSURANCE - CHARGES, MRI (D_5_HOS_C3_58)","COST REIMBURSED SERVICES SUBJECT TO DEDUCTIBLES  AND COINSURANCE - CHARGES, Cardiac Catheterization (D_5_HOS_C3_59)","COST REIMBURSED SERVICES SUBJECT TO DEDUCTIBLES  AND COINSURANCE - CHARGES, Intravenous Therapy (D_5_HOS_C3_64)","COST REIMBURSED SERVICES SUBJECT TO DEDUCTIBLES  AND COINSURANCE - CHARGES, Electroencephalography (D_5_HOS_C3_70)","COST SERVICES SUBJECT TO DEDUCTIBLES AND COINSURANCE - COST, Delivery Room and Labor Room (D_5_HOS_C6_52)","COST SERVICES SUBJECT TO DEDUCTIBLES AND COINSURANCE - COST, Radiology-Therapeutic (D_5_HOS_C6_55)","COST SERVICES SUBJECT TO DEDUCTIBLES AND COINSURANCE - COST, Radioisotope (D_5_HOS_C6_56)","COST SERVICES SUBJECT TO DEDUCTIBLES AND COINSURANCE - COST, CT Scan (D_5_HOS_C6_57)","COST SERVICES SUBJECT TO DEDUCTIBLES AND COINSURANCE - COST, MRI (D_5_HOS_C6_58)","COST SERVICES SUBJECT TO DEDUCTIBLES AND COINSURANCE - COST, Cardiac Catheterization (D_5_HOS_C6_59)","COST SERVICES SUBJECT TO DEDUCTIBLES AND COINSURANCE - COST, Intravenous Therapy (D_5_HOS_C6_64)","COST SERVICES SUBJECT TO DEDUCTIBLES AND COINSURANCE - COST, Electroencephalography (D_5_HOS_C6_70)",Hospice (S3_1_C6_24),Hospice (S3_1_C7_24),Hospice (S3_1_C8_24),Other Special Purpose (B_1_C26_117),Other Special Purpose (B_2_C26_117),Other Special Purpose (C_1_C5_117),"COST REIMBURSED SERVICES SUBJECT TO DEDUCTIBLES  AND COINSURANCE - CHARGES, Whole Blood & Packed Red Blood Cells (D_5_HOS_C3_62)","COST SERVICES SUBJECT TO DEDUCTIBLES AND COINSURANCE - COST, Whole Blood & Packed Red Blood Cells (D_5_HOS_C6_62)","COST REIMBURSED SERVICES SUBJECT TO DEDUCTIBLES  AND COINSURANCE - CHARGES, Other Ancillary (D_5_HOS_C3_76)","COST REIMBURSED SERVICES NOT SUBJECT TO DEDUCTIBLES AND COINSURANCE - CHARGES, Emergency (D_5_HOS_C4_91)","COST SERVICES SUBJECT TO DEDUCTIBLES AND COINSURANCE - COST, Other Ancillary (D_5_HOS_C6_76)","COST SERVICES NOT SUBJECT TO DEDUCTIBLES AND COINSURANCE - COST, Emergency (D_5_HOS_C7_91)",Maintenance of Personnel (A_C2_12),Maintenance of Personnel (A_C6_12),"Net Expense for Cost Allocation, Maintenance of Personnel (B_1_C0_12)",Nonpaid Workers (A_C1_193),Burn Intensive Care Unit (A_C1_33),Burn Intensive Care Unit (A_C2_33),"Net Expense for Cost Allocation, Burn Intensive Care Unit (B_1_C0_33)",Burn Intensive Care Unit (B_1_C26_33),"TOTAL CAPITAL COSTS AFTER COST ALLOCATION, Burn Intensive Care Unit (B_2_C26_33)",Burn Intensive Care Unit (C_1_C5_33),"Total Inpatient Charges, Burn Intensive Care Unit (C_1_C6_33)",Burn Intensive Care Unit (D3_HOS_C2_33),Burn Intensive Care Unit (D_1_HOS_C4_33),Burn Intensive Care Unit (D_1_HOS_C6_33),Burn Intensive Care Unit (D_1_HOS_C7_33),Burn Intensive Care Unit (S3_1_C2_10),Burn Intensive Care Unit (S3_1_C3_10),Burn Intensive Care Unit (S3_1_C6_10),Burn Intensive Care Unit (S3_1_C8_10),Hospice (A_C6_116),Hospice (S3_1_C2_24),"COST REIMBURSED SERVICES SUBJECT TO DEDUCTIBLES  AND COINSURANCE - CHARGES, ASC (Non Distinct Part) (D_5_HOS_C3_75)","COST SERVICES SUBJECT TO DEDUCTIBLES AND COINSURANCE - COST, ASC (Non Distinct Part) (D_5_HOS_C6_75)",Radiology-Therapeutic (D3_IPF_C2_55),Cardiac Catheterization (D3_IPF_C2_59),"Blood Storing, Processing, Trans (D3_IPF_C2_63)",Intravenous Therapy (D3_IPF_C2_64),Other Ancillary (D3_IPF_C2_76),Radiology-Therapeutic (D3_IPF_C3_55),Cardiac Catheterization (D3_IPF_C3_59),"Blood Storing, Processing, Trans (D3_IPF_C3_63)",Intravenous Therapy (D3_IPF_C3_64),Other Ancillary (D3_IPF_C3_76),"COST REIMBURSED SERVICES NOT SUBJECT TO DEDUCTIBLES AND COINSURANCE - CHARGES, Radiology-Therapeutic (D_5_HOS_C4_55)","COST REIMBURSED SERVICES NOT SUBJECT TO DEDUCTIBLES AND COINSURANCE - CHARGES, CT Scan (D_5_HOS_C4_57)","COST REIMBURSED SERVICES NOT SUBJECT TO DEDUCTIBLES AND COINSURANCE - CHARGES, MRI (D_5_HOS_C4_58)","COST REIMBURSED SERVICES NOT SUBJECT TO DEDUCTIBLES AND COINSURANCE - CHARGES, Intravenous Therapy (D_5_HOS_C4_64)","COST REIMBURSED SERVICES NOT SUBJECT TO DEDUCTIBLES AND COINSURANCE - CHARGES, Electrocardiology (D_5_HOS_C4_69)","COST REIMBURSED SERVICES NOT SUBJECT TO DEDUCTIBLES AND COINSURANCE - CHARGES, Clinic (D_5_HOS_C4_90)","COST SERVICES NOT SUBJECT TO DEDUCTIBLES AND COINSURANCE - COST, Radiology-Therapeutic (D_5_HOS_C7_55)","COST SERVICES NOT SUBJECT TO DEDUCTIBLES AND COINSURANCE - COST, CT Scan (D_5_HOS_C7_57)","COST SERVICES NOT SUBJECT TO DEDUCTIBLES AND COINSURANCE - COST, MRI (D_5_HOS_C7_58)","COST SERVICES NOT SUBJECT TO DEDUCTIBLES AND COINSURANCE - COST, Intravenous Therapy (D_5_HOS_C7_64)","COST SERVICES NOT SUBJECT TO DEDUCTIBLES AND COINSURANCE - COST, Electrocardiology (D_5_HOS_C7_69)","COST SERVICES NOT SUBJECT TO DEDUCTIBLES AND COINSURANCE - COST, Clinic (D_5_HOS_C7_90)","COST REIMBURSED SERVICES NOT SUBJECT TO DEDUCTIBLES AND COINSURANCE - CHARGES, Anesthesiology (D_5_HOS_C4_53)","COST SERVICES NOT SUBJECT TO DEDUCTIBLES AND COINSURANCE - COST, Anesthesiology (D_5_HOS_C7_53)",Durable Medical Equipment Rented (A_C1_96),Durable Medical Equipment Rented (A_C2_96),"Net Expense for Cost Allocation, Durable Medical Equipment Rented (B_1_C0_96)",Durable Medical Equipment Rented (B_1_C26_96),Durable Medical Equipment Rented (B_2_C26_96),Other Reimbursable (C_1_C6_98),Durable Medical Equipment Rented (C_1_C7_96),"COST REIMBURSED SERVICES SUBJECT TO DEDUCTIBLES  AND COINSURANCE - CHARGES, Other Reimbursable (D_5_HOS_C3_98)","COST SERVICES SUBJECT TO DEDUCTIBLES AND COINSURANCE - COST, Other Reimbursable (D_5_HOS_C6_98)",Other Special Purpose (A_C2_117),Cafeteria (A_C1_11),Other Organ Acquisition (A_C1_112),Cafeteria (A_C2_11),Other Organ Acquisition (A_C2_112),Other Organ Acquisition (A_C6_112),Research (A_C6_191),Coronary Care Unit (A_C6_32),"Net Expense for Cost Allocation, Other Organ Acquisition (B_1_C0_112)",Research (B_1_C21_191),"Allocation of Interns & Residents Salary and Fringes, Coronary Care Unit (B_1_C21_32)","Allocation of Interns & Residents Salary and Fringes, Surgical Intensive Care Unit (B_1_C21_34)","Allocation of Interns & Residents Salary and Fringes, Other Special Care Unit (B_1_C21_35)","Allocation of Interns & Residents Salary and Fringes, Physical Therapy (B_1_C21_66)",ASC (Non Distinct Part) (B_1_C21_75),Research (B_1_C22_191),"Allocation of Interns & Residents Program Costs, Coronary Care Unit (B_1_C22_32)","Allocation of Interns & Residents Program Costs, Surgical Intensive Care Unit (B_1_C22_34)","Allocation of Interns & Residents Program Costs, Other Special Care Unit (B_1_C22_35)","Allocation of Interns & Residents Program Costs, Physical Therapy (B_1_C22_66)",ASC (Non Distinct Part) (B_1_C22_75),Other Organ Acquisition (B_1_C26_112),Other Organ Acquisition (B_2_C26_112),Other Organ Acquisition (C_1_C5_112),Other Organ Acquisition (C_1_C6_112),Other Organ Acquisition (C_1_C7_112),Coronary Care Unit Program Cost (D1_HOS_C5_44),Delivery Room and Labor Room (D3_IPF_C2_52),Electroencephalography (D3_IPF_C2_70),Delivery Room and Labor Room (D3_IPF_C3_52),Electroencephalography (D3_IPF_C3_70),Cardiac Catheterization (D3_IRF_C2_59),"Blood Storing, Processing, Trans (D3_IRF_C2_63)",Other Ancillary (D3_IRF_C2_76),Cardiac Catheterization (D3_IRF_C3_59),"Blood Storing, Processing, Trans (D3_IRF_C3_63)",Other Ancillary (D3_IRF_C3_76),Coronary Care Unit (D_3_HOS_C9_32),Surgical Intensive Care Unit (D_3_HOS_C9_34),ASC (Non Distinct Part) (D_4_HOS_C11_75),Speech Pathology (D_4_HOS_C12_68),ASC (Non Distinct Part) (D_4_HOS_C13_75),ASC (Non Distinct Part) (D_4_HOS_C3_75),Operating Room (D_4_IPF_C11_50),Emergency (D_4_IPF_C11_91),Operating Room (D_4_IRF_C11_50),Radiology-Therapeutic (D_4_IRF_C11_55),"PPS REIMBURSED SERVICES -  CHARGES, Speech Pathology (D_5_HOS_C2_68)","PPS SERVICES COST, Speech Pathology (D_5_HOS_C5_68)",Interns & Res Other Program Costs (A_C1_22),Durable Medical Equipment Sold (C_1_C6_97),Durable Medical Equipment Sold (D_4_HOS_C12_97),"PPS REIMBURSED SERVICES -  CHARGES, Durable Medical Equipment Sold (D_5_HOS_C2_97)","PPS SERVICES COST, Durable Medical Equipment Sold (D_5_HOS_C5_97)","COST REIMBURSED SERVICES NOT SUBJECT TO DEDUCTIBLES AND COINSURANCE - CHARGES, Cardiac Catheterization (D_5_HOS_C4_59)","COST SERVICES NOT SUBJECT TO DEDUCTIBLES AND COINSURANCE - COST, Cardiac Catheterization (D_5_HOS_C7_59)",HHA (S3_1_C11_22),Hospice (S3_1_C11_24),RHC/FQHC Combined (S3_1_C11_26),Other Outpatient Services (B_1_C21_93),Other Outpatient Services (D_4_HOS_C12_93),Radiology-Diagnostic (D_4_HOS_C4_54),CT Scan (D_4_HOS_C4_57),MRI (D_4_HOS_C4_58),Radiology-Diagnostic (D_4_IPF_C11_54),CT Scan (D_4_IPF_C11_57),MRI (D_4_IPF_C11_58),Radiology-Diagnostic (D_4_IRF_C11_54),CT Scan (D_4_IRF_C11_57),MRI (D_4_IRF_C11_58),"PPS REIMBURSED SERVICES -  CHARGES, Other Outpatient Services (D_5_HOS_C2_93)","COST REIMBURSED SERVICES NOT SUBJECT TO DEDUCTIBLES AND COINSURANCE - CHARGES, Medical Supplies Charged to Patients (D_5_HOS_C4_71)","PPS SERVICES COST, Other Outpatient Services (D_5_HOS_C5_93)","COST SERVICES NOT SUBJECT TO DEDUCTIBLES AND COINSURANCE - COST, Medical Supplies Charged to Patients (D_5_HOS_C7_71)",Hospice (S3_1_C3_24),Nursing School (A_C2_20),"Net Expense for Cost Allocation, Nursing School (B_1_C0_20)",FQHC (B_1_C26_89),FQHC (B_2_C26_89),FQHC (C_1_C5_89),HHA (C_1_C6_101),Impl. Dev. Charged to Patients (D3_SNF_C2_72),Impl. Dev. Charged to Patients (D3_SNF_C3_72),Operating Room (D_4_HOS_C2_50),Delivery Room and Labor Room (D_4_HOS_C2_52),Emergency (D_4_HOS_C2_91),Emergency (D_4_IRF_C11_91),Radiology-Diagnostic (D_4_SNF_C11_54),Whole Blood & Packed Red Blood Cells (D3_IPF_C2_62),Whole Blood & Packed Red Blood Cells (D3_IPF_C3_62),Other Outpatient Services (C_1_C6_93),Other Outpatient Services (D3_HOS_C2_93),Other Outpatient Services (D3_HOS_C3_93),Other Outpatient Services (D_4_HOS_C10_93),"Net Expense for Cost Allocation, Other Special Purpose (B_1_C0_117)",Other Special Purpose (C_1_C6_117),Other Special Purpose (A_C1_117),Other Special Purpose (A_C6_117),Nonpaid Workers (A_C6_193),"Blood Storing, Processing, Trans (D3_SNF_C2_63)",Electroencephalography (D3_SNF_C2_70),Other Ancillary (D3_SNF_C2_76),"Blood Storing, Processing, Trans (D3_SNF_C3_63)",Electroencephalography (D3_SNF_C3_70),Other Ancillary (D3_SNF_C3_76),Operating Room (D_4_HOS_C1_50),Durable Medical Equipment Rented (A_C6_96),Operating Room (D3_SNF_C2_50),Operating Room (D3_SNF_C3_50),Maintenance of Personnel (A_C1_12),Durable Medical Equipment Rented (C_1_C5_96),Other Special Purpose (C_1_C7_117),Physical Therapy (C_1_C2_66),Anesthesiology (D3_SNF_C2_53),Anesthesiology (D3_SNF_C3_53),Other Outpatient Services (D3_IPF_C2_93),Other Outpatient Services (D3_IPF_C3_93),"COST REIMBURSED SERVICES NOT SUBJECT TO DEDUCTIBLES AND COINSURANCE - CHARGES, Operating Room (D_5_HOS_C4_50)","COST SERVICES NOT SUBJECT TO DEDUCTIBLES AND COINSURANCE - COST, Operating Room (D_5_HOS_C7_50)",Intensive Care Unit (D3_IRF_C2_31),Radiology-Therapeutic (D3_SNF_C2_55),CT Scan (D3_SNF_C2_57),MRI (D3_SNF_C2_58),Radiology-Therapeutic (D3_SNF_C3_55),CT Scan (D3_SNF_C3_57),MRI (D3_SNF_C3_58),"COST REIMBURSED SERVICES NOT SUBJECT TO DEDUCTIBLES AND COINSURANCE - CHARGES, Respiratory Therapy (D_5_HOS_C4_65)","COST SERVICES NOT SUBJECT TO DEDUCTIBLES AND COINSURANCE - COST, Respiratory Therapy (D_5_HOS_C7_65)",Nursing School (A_C6_20),"Allocation of Interns & Residents Salary and Fringes, Intravenous Therapy (B_1_C21_64)","Allocation of Interns & Residents Salary and Fringes, Medical Supplies Charged to Patients (B_1_C21_71)",Drugs Charged to Patients (B_1_C21_73),"Allocation of Interns & Residents Program Costs, Speech Pathology (B_1_C22_68)",Drugs Charged to Patients (B_1_C22_73),Burn Intensive Care Unit Program Cost (D1_HOS_C5_45),Surgical Intensive Care Unit Program Cost (D1_HOS_C5_46),ASC (Non Distinct Part) (D3_IPF_C2_75),ASC (Non Distinct Part) (D3_IPF_C3_75),Burn Intensive Care Unit (D_3_HOS_C9_33),Radioisotope (D_4_HOS_C11_56),"Blood Storing, Processing, Trans (D_4_HOS_C11_63)",Respiratory Therapy (D_4_HOS_C11_65),Physical Therapy (D_4_HOS_C11_66),Electrocardiology (D_4_HOS_C11_69),Medical Supplies Charged to Patients (D_4_HOS_C11_71),Radioisotope (D_4_HOS_C13_56),"Blood Storing, Processing, Trans (D_4_HOS_C13_63)",Respiratory Therapy (D_4_HOS_C13_65),Physical Therapy (D_4_HOS_C13_66),Electrocardiology (D_4_HOS_C13_69),Electroencephalography (D_4_HOS_C13_70),Medical Supplies Charged to Patients (D_4_HOS_C13_71),Recovery Room (D_4_HOS_C2_51),Anesthesiology (D_4_HOS_C2_53),Radiology-Diagnostic (D_4_HOS_C2_54),Radiology-Therapeutic (D_4_HOS_C2_55),MRI (D_4_HOS_C2_58),Respiratory Therapy (D_4_HOS_C2_65),Physical Therapy (D_4_HOS_C2_66),Electrocardiology (D_4_HOS_C2_69),Electroencephalography (D_4_HOS_C2_70),ASC (Non Distinct Part) (D_4_HOS_C2_75),Clinic (D_4_HOS_C2_90),Radioisotope (D_4_HOS_C3_56),"Blood Storing, Processing, Trans (D_4_HOS_C3_63)",Respiratory Therapy (D_4_HOS_C3_65),Physical Therapy (D_4_HOS_C3_66),Electrocardiology (D_4_HOS_C3_69),Medical Supplies Charged to Patients (D_4_HOS_C3_71),ASC (Non Distinct Part) (D_4_IPF_C11_75),Recovery Room (D_4_IRF_C11_51),Electroencephalography (D_4_IRF_C11_70),Radioisotope (D_4_IRF_C13_56),Burn Intensive Care Unit (S3_1_C7_10),Nursing School (A_C1_20),Intensive Care Unit (D3_IPF_C2_31),Delivery Room and Labor Room (D3_SNF_C2_52),Cardiac Catheterization (D3_SNF_C2_59),Delivery Room and Labor Room (D3_SNF_C3_52),Cardiac Catheterization (D3_SNF_C3_59),"Gift, Flower, Coffee Shop, Canteen (B_1_C21_190)",Physicians' Private Office (B_1_C21_192),Other Ancillary (B_1_C21_76),"Gift, Flower, Coffee Shop, Canteen (B_1_C22_190)",Physicians' Private Office (B_1_C22_192),Other Ancillary (B_1_C22_76),Other Outpatient Services (B_1_C22_93),Burn Intensive Care Unit (A_C6_33),Other Special Care Unit (D3_HOS_C2_35),Other Special Care Unit (D_1_HOS_C6_35),Other Special Care Unit (D_1_HOS_C7_35),Other Special Care Unit (D_3_HOS_C9_35),Other Outpatient Services (D_4_HOS_C13_93),Other Ancillary (D_4_HOS_C3_76),Other Outpatient Services (D_4_HOS_C3_93),Other Special Care (S3_1_C6_12),Whole Blood & Packed Red Blood Cells (D3_IRF_C2_62),Whole Blood & Packed Red Blood Cells (D3_IRF_C3_62),Surgical Intensive Care Unit (A_C6_34),"Allocation of Interns & Residents Salary and Fringes, Burn Intensive Care Unit (B_1_C21_33)","Allocation of Interns & Residents Program Costs, Burn Intensive Care Unit (B_1_C22_33)",Intravenous Therapy (D3_IRF_C2_64),Intravenous Therapy (D3_IRF_C3_64),Respiratory Therapy (D_4_IRF_C11_65),Clinic (D_4_IRF_C11_90),"COST REIMBURSED SERVICES SUBJECT TO DEDUCTIBLES  AND COINSURANCE - CHARGES, Observation Beds (Distinct Unit) (D_5_HOS_C3_9201)","COST SERVICES SUBJECT TO DEDUCTIBLES AND COINSURANCE - COST, Observation Beds (Distinct Unit) (D_5_HOS_C6_9201)","Allocation of Interns & Residents Salary and Fringes, Occupational Therapy (B_1_C21_67)","Allocation of Interns & Residents Program Costs, Occupational Therapy (B_1_C22_67)",Radioisotope (D3_SNF_C2_56),Radioisotope (D3_SNF_C3_56),Other Reimbursable (D3_HOS_C2_98),Other Reimbursable (D3_HOS_C3_98),Other Reimbursable (D_4_HOS_C10_98),"COST REIMBURSED SERVICES NOT SUBJECT TO DEDUCTIBLES AND COINSURANCE - CHARGES, Other Ancillary (D_5_HOS_C4_76)","COST SERVICES NOT SUBJECT TO DEDUCTIBLES AND COINSURANCE - COST, Other Ancillary (D_5_HOS_C7_76)",Coronary Care Unit (S3_1_C4_9),Laboratory (D_4_SNF_C11_60),Drugs Charged to Patients (D_4_SNF_C11_73),Observation Beds (Distinct Unit) (A_C6_9201),"COST REIMBURSED SERVICES NOT SUBJECT TO DEDUCTIBLES AND COINSURANCE - CHARGES, Radioisotope (D_5_HOS_C4_56)","COST SERVICES NOT SUBJECT TO DEDUCTIBLES AND COINSURANCE - COST, Radioisotope (D_5_HOS_C7_56)",Impl. Dev. Charged to Patients (A_C6_72),Delivery Room and Labor Room (D3_IRF_C2_52),Delivery Room and Labor Room (D3_IRF_C3_52),Clinic (D_4_IRF_C13_90),ASC (Distinct Part) (A_C1_115),ASC (Distinct Part) (A_C2_115),ASC (Distinct Part) (A_C6_115),Recovery Room (D3_SNF_C2_51),ASC (Non Distinct Part) (D3_SNF_C2_75),Recovery Room (D3_SNF_C3_51),ASC (Non Distinct Part) (D3_SNF_C3_75),"Blood Storing, Processing, Trans (D_4_HOS_C2_63)",Anesthesiology (D_4_IPF_C11_53),Laboratory (D_4_IPF_C11_60),"Blood Storing, Processing, Trans (D_4_IPF_C11_63)",Anesthesiology (D_4_IRF_C11_53),Laboratory (D_4_IRF_C11_60),"Blood Storing, Processing, Trans (D_4_IRF_C11_63)",ASC (Non Distinct Part) (D_4_IRF_C11_75),Operating Room (D_4_SNF_C11_50),Anesthesiology (D_4_SNF_C11_53),"Blood Storing, Processing, Trans (D_4_SNF_C11_63)",Emergency (D_4_SNF_C11_91),ASC (Distinct Part) (B_1_C26_115),ASC (Distinct Part) (B_2_C26_115),ASC (Distinct Part) (C_1_C5_115),ASC (Distinct Part) (C_1_C6_115),ASC (Distinct Part) (C_1_C7_115),Durable Medical Equipment Rented (C_1_C6_96),Speech Pathology (D_4_HOS_C11_68),Speech Pathology (D_4_HOS_C3_68),Intravenous Therapy (D3_SNF_C2_64),Intravenous Therapy (D3_SNF_C3_64),"Allocation of Interns & Residents Salary and Fringes, Whole Blood & Packed Red Blood Cells (B_1_C21_62)","Allocation of Interns & Residents Program Costs, Whole Blood & Packed Red Blood Cells (B_1_C22_62)",Speech Pathology (D_4_HOS_C13_68),Whole Blood & Packed Red Blood Cells (D_4_HOS_C3_62),Radiology-Diagnostic (D_4_IPF_C13_54),FQHC (A_C6_89),"Net Expense for Cost Allocation, FQHC (B_1_C0_89)",FQHC (C_1_C6_89),Other Ancillary (D_4_HOS_C11_76),Other Ancillary (D_4_HOS_C13_76),Occupational Therapy (D_4_HOS_C11_67),Occupational Therapy (D_4_HOS_C3_67),Occupational Therapy (D_4_IPF_C11_67),FQHC (A_C2_89),Intensive Care Unit (S3_1_C5_8),Drugs Charged to Patients (D_4_IRF_C11_73),Drugs Charged to Patients (D_4_IRF_C13_73),Durable Medical Equipment Sold (A_C6_97),Other Outpatient Services (D3_SNF_C2_93),Other Outpatient Services (D3_SNF_C3_93),"COST REIMBURSED SERVICES NOT SUBJECT TO DEDUCTIBLES AND COINSURANCE - CHARGES, Recovery Room (D_5_HOS_C4_51)","COST REIMBURSED SERVICES NOT SUBJECT TO DEDUCTIBLES AND COINSURANCE - CHARGES, Blood Storing, Processing, Trans (D_5_HOS_C4_63)","COST REIMBURSED SERVICES NOT SUBJECT TO DEDUCTIBLES AND COINSURANCE - CHARGES, Physical Therapy (D_5_HOS_C4_66)","COST REIMBURSED SERVICES NOT SUBJECT TO DEDUCTIBLES AND COINSURANCE - CHARGES, Occupational Therapy (D_5_HOS_C4_67)","COST REIMBURSED SERVICES NOT SUBJECT TO DEDUCTIBLES AND COINSURANCE - CHARGES, Speech Pathology (D_5_HOS_C4_68)","COST SERVICES NOT SUBJECT TO DEDUCTIBLES AND COINSURANCE - COST, Recovery Room (D_5_HOS_C7_51)","COST SERVICES NOT SUBJECT TO DEDUCTIBLES AND COINSURANCE - COST, Blood Storing, Processing, Trans (D_5_HOS_C7_63)","COST SERVICES NOT SUBJECT TO DEDUCTIBLES AND COINSURANCE - COST, Physical Therapy (D_5_HOS_C7_66)","COST SERVICES NOT SUBJECT TO DEDUCTIBLES AND COINSURANCE - COST, Occupational Therapy (D_5_HOS_C7_67)","COST SERVICES NOT SUBJECT TO DEDUCTIBLES AND COINSURANCE - COST, Speech Pathology (D_5_HOS_C7_68)","COST REIMBURSED SERVICES NOT SUBJECT TO DEDUCTIBLES AND COINSURANCE - CHARGES, Delivery Room and Labor Room (D_5_HOS_C4_52)","COST SERVICES NOT SUBJECT TO DEDUCTIBLES AND COINSURANCE - COST, Delivery Room and Labor Room (D_5_HOS_C7_52)",Laboratory (D_4_HOS_C2_60),Intensive Care Unit (D3_SNF_C2_31),Other Outpatient Services (D_4_HOS_C11_93),Respiratory Therapy (D_4_SNF_C11_65),Physical Therapy (D_4_SNF_C11_66),Occupational Therapy (D_4_SNF_C11_67),Speech Pathology (D_4_SNF_C11_68),Durable Medical Equipment Sold (D3_HOS_C2_97),Durable Medical Equipment Sold (D3_HOS_C3_97),Durable Medical Equipment Sold (D_4_HOS_C10_97),"Total Inpatient Charges, Blood Clotting Factors for Hemoph. (C_1_C6_6250)",Blood Clotting Factors for Hemoph. (D3_HOS_C2_6250),Blood Clotting Factors for Hemoph. (D_4_HOS_C10_6250),CORF (A_C1_9910),CORF (A_C2_9910),CORF (A_C6_9910),"Net Expense for Cost Allocation, CORF (B_1_C0_9910)",CORF (B_1_C26_9910),CORF (B_2_C26_9910),CORF (C_1_C5_9910),CORF (C_1_C7_9910),"COST REIMBURSED SERVICES NOT SUBJECT TO DEDUCTIBLES AND COINSURANCE - CHARGES, Other Outpatient Services (D_5_HOS_C4_93)","COST SERVICES NOT SUBJECT TO DEDUCTIBLES AND COINSURANCE - COST, Other Outpatient Services (D_5_HOS_C7_93)",Outpatient Rehab Provider (S3_1_C10_25),Other Ancillary (D_4_HOS_C2_76),Other Ancillary (D_4_IPF_C11_76),Other Ancillary (D_4_IRF_C11_76),Other Outpatient Services (D3_IRF_C2_93),Other Outpatient Services (D3_IRF_C3_93),CT Scan (D_4_HOS_C2_57),CT Scan (D_4_SNF_C11_57),RHC (B_1_C21_88),RHC (B_1_C22_88),RHC/FQHC Combined (S3_1_C9_26),CORF (C_1_C6_9910),Radiology-Diagnostic (D_4_IRF_C13_54),Respiratory Therapy (D_4_IRF_C13_65),Emergency (D_4_IRF_C13_91),Whole Blood & Packed Red Blood Cells (D_4_HOS_C11_62),Impl. Dev. Charged to Patients (D_4_HOS_C11_72),Whole Blood & Packed Red Blood Cells (D_4_HOS_C13_62),Impl. Dev. Charged to Patients (D_4_HOS_C13_72),Impl. Dev. Charged to Patients (D_4_HOS_C3_72),Respiratory Therapy (D_4_IPF_C11_65),Electrocardiology (D_4_IPF_C11_69),Electroencephalography (D_4_IPF_C11_70),Impl. Dev. Charged to Patients (D_4_IPF_C11_72),Drugs Charged to Patients (D_4_IPF_C11_73),Operating Room (D_4_IPF_C13_50),Delivery Room and Labor Room (D_4_IPF_C13_52),CT Scan (D_4_IPF_C13_57),Laboratory (D_4_IPF_C13_60),Electroencephalography (D_4_IPF_C13_70),Medical Supplies Charged to Patients (D_4_IPF_C13_71),Impl. Dev. Charged to Patients (D_4_IPF_C13_72),Drugs Charged to Patients (D_4_IPF_C13_73),Radioisotope (D_4_IPF_C11_56),Radioisotope (D_4_IRF_C11_56),Other Outpatient Services (D_4_HOS_C2_93),Other Reimbursable (D3_IRF_C2_98),Other Reimbursable (D3_IRF_C3_98),Other Reimbursable (D3_SNF_C2_98),Other Reimbursable (D3_SNF_C3_98),Cardiac Catheterization (D_4_HOS_C2_59),Cardiac Catheterization (D_4_IPF_C11_59),Cardiac Catheterization (D_4_IRF_C11_59),Radiology-Therapeutic (D_4_SNF_C11_55),Cardiac Catheterization (D_4_SNF_C11_59),Observation Beds (Distinct Unit) (D3_IPF_C2_9201),Observation Beds (Distinct Unit) (D3_IPF_C3_9201),Observation Beds (Distinct Unit) (D3_IRF_C2_9201),Observation Beds (Distinct Unit) (D3_IRF_C3_9201),Physical Therapy (D_4_IPF_C11_66),Physical Therapy (D_4_IRF_C11_66),Recovery Room (D_4_IPF_C11_51),Other Reimbursable (B_1_C21_98),Other Reimbursable (B_1_C22_98),Coronary Care Unit (S3_1_C5_9),Durable Medical Equipment Rented (D3_HOS_C2_96),Durable Medical Equipment Rented (D3_HOS_C3_96),Durable Medical Equipment Rented (D3_IPF_C2_96),Durable Medical Equipment Rented (D3_IPF_C3_96),Durable Medical Equipment Rented (D3_IRF_C2_96),Durable Medical Equipment Rented (D3_IRF_C3_96),Durable Medical Equipment Rented (D_4_HOS_C10_96),"COST REIMBURSED SERVICES NOT SUBJECT TO DEDUCTIBLES AND COINSURANCE - CHARGES, Electroencephalography (D_5_HOS_C4_70)","COST SERVICES NOT SUBJECT TO DEDUCTIBLES AND COINSURANCE - COST, Electroencephalography (D_5_HOS_C7_70)",Observation Beds (Distinct Unit) (B_1_C22_9201),Observation Beds (Distinct Unit) (D_4_HOS_C11_9201),Observation Beds (Distinct Unit) (D_4_HOS_C13_9201),Observation Beds (Distinct Unit) (D_4_HOS_C2_9201),Observation Beds (Distinct Unit) (D_4_IPF_C11_9201),Emergency (D_4_IPF_C13_91),Observation Beds (Distinct Unit) (D_4_IRF_C11_9201),Occupational Therapy (D_4_HOS_C13_67),Occupational Therapy (D_4_IRF_C11_67),Speech Pathology (D_4_IRF_C11_68),Electrocardiology (D_4_IRF_C11_69),Medical Supplies Charged to Patients (D_4_IRF_C11_71),Impl. Dev. Charged to Patients (D_4_IRF_C11_72),"COST REIMBURSED SERVICES SUBJECT TO DEDUCTIBLES  AND COINSURANCE - CHARGES, Durable Medical Equipment Rented (D_5_HOS_C3_96)","COST SERVICES SUBJECT TO DEDUCTIBLES AND COINSURANCE - COST, Durable Medical Equipment Rented (D_5_HOS_C6_96)",Medical Supplies Charged to Patients (D_4_SNF_C11_71),Impl. Dev. Charged to Patients (A_C1_72),Observation Beds (Distinct Unit) (B_1_C21_9201),"Net Expense for Cost Allocation, ASC (Distinct Part) (B_1_C0_115)",Operating Room (D_4_IRF_C13_50),RHC (D_4_HOS_C2_88),Other Special Care (S3_1_C5_12),Burn Intensive Care Unit (S3_1_C5_10),Coronary Care Unit (D3_IRF_C2_32),Other Special Care Unit (D3_IPF_C2_35),Clinic (D_4_IPF_C11_90),FQHC (A_C1_89),CMHC (A_C1_99),CMHC (A_C2_99),CMHC (A_C6_99),"Net Expense for Cost Allocation, CMHC (B_1_C0_99)",CMHC (B_1_C26_99),CMHC (B_2_C26_99),CMHC (C_1_C5_99),CMHC (C_1_C6_99),CMHC (C_1_C7_99),Other Outpatient Services (D_4_IPF_C11_93),Other Outpatient Services (D_4_SNF_C11_93),Other Reimbursable (D3_IPF_C2_98),Other Reimbursable (D3_IPF_C3_98),Intravenous Therapy (D_4_HOS_C2_64),"Allocation of Interns & Residents Salary and Fringes, Speech Pathology (B_1_C21_68)",Operating Room (D_4_HOS_C4_50),Recovery Room (D_4_HOS_C4_51),Respiratory Therapy (D_4_HOS_C4_65),ASC (Non Distinct Part) (D_4_HOS_C4_75),Clinic (D_4_HOS_C4_90),Emergency (D_4_HOS_C4_91),Clinic (D_4_IPF_C13_90),Durable Medical Equipment Sold (D_4_HOS_C13_97),Drugs Charged to Patients (D_4_HOS_C2_73),Durable Medical Equipment Sold (D_4_HOS_C2_97),Observation Beds (Distinct Unit) (D_4_HOS_C3_9201),Durable Medical Equipment Sold (D_4_HOS_C3_97),"COST REIMBURSED SERVICES SUBJECT TO DEDUCTIBLES  AND COINSURANCE - CHARGES, Durable Medical Equipment Sold (D_5_HOS_C3_97)","COST SERVICES SUBJECT TO DEDUCTIBLES AND COINSURANCE - COST, Durable Medical Equipment Sold (D_5_HOS_C6_97)","COST REIMBURSED SERVICES NOT SUBJECT TO DEDUCTIBLES AND COINSURANCE - CHARGES, Whole Blood & Packed Red Blood Cells (D_5_HOS_C4_62)","COST SERVICES NOT SUBJECT TO DEDUCTIBLES AND COINSURANCE - COST, Whole Blood & Packed Red Blood Cells (D_5_HOS_C7_62)","COST REIMBURSED SERVICES NOT SUBJECT TO DEDUCTIBLES AND COINSURANCE - CHARGES, Observation Beds (Distinct Unit) (D_5_HOS_C4_9201)","COST SERVICES NOT SUBJECT TO DEDUCTIBLES AND COINSURANCE - COST, Observation Beds (Distinct Unit) (D_5_HOS_C7_9201)","Allocation of Interns & Residents Program Costs, Medical Supplies Charged to Patients (B_1_C22_71)",Electrocardiology (D_4_IPF_C13_69),Durable Medical Equipment Rented (D_4_HOS_C12_96),"PPS REIMBURSED SERVICES -  CHARGES, Durable Medical Equipment Rented (D_5_HOS_C2_96)","PPS SERVICES COST, Durable Medical Equipment Rented (D_5_HOS_C5_96)",Recovery Room (D_4_SNF_C11_51),Electroencephalography (D_4_SNF_C11_70),Other Ancillary (D_4_SNF_C11_76),Other Organ Acquisition (B_1_C21_112),"Allocation of Interns & Residents Program Costs, Intravenous Therapy (B_1_C22_64)",Delivery Room and Labor Room (D_4_IPF_C11_52),Other Organ Acquisition (B_1_C22_112),"Allocation of Interns & Residents Program Costs, Impl. Dev. Charged to Patients (B_1_C22_72)",Clinic (D_4_SNF_C11_90),Nonpaid Workers (B_1_C21_193),Nonpaid Workers (B_1_C22_193),Coronary Care Unit (D3_IPF_C2_32),Burn Intensive Care Unit (D3_IPF_C2_33),Surgical Intensive Care Unit (D3_IPF_C2_34),Burn Intensive Care Unit (D3_IRF_C2_33),Surgical Intensive Care Unit (D3_IRF_C2_34),Other Special Care Unit (D3_IRF_C2_35),Intravenous Therapy (D_4_IPF_C11_64),Delivery Room and Labor Room (D_4_IRF_C11_52),Intravenous Therapy (D_4_IRF_C11_64),Radioisotope (D_4_SNF_C11_56),Radiology-Therapeutic (D_4_IPF_C11_55),OPT (A_C1_9920),OOT (A_C1_9930),OSP (A_C1_9940),OPT (A_C2_9920),OOT (A_C2_9930),OSP (A_C2_9940),OPT (A_C6_9920),OOT (A_C6_9930),OSP (A_C6_9940),"Net Expense for Cost Allocation, OPT (B_1_C0_9920)","Net Expense for Cost Allocation, OOT (B_1_C0_9930)","Net Expense for Cost Allocation, OSP (B_1_C0_9940)",OPT (B_1_C26_9920),OOT (B_1_C26_9930),OSP (B_1_C26_9940),OPT (B_2_C26_9920),OOT (B_2_C26_9930),OSP (B_2_C26_9940),OPT (C_1_C5_9920),OOT (C_1_C5_9930),OSP (C_1_C5_9940),OPT (C_1_C7_9920),OOT (C_1_C7_9930),OSP (C_1_C7_9940),Laboratory (D_4_IRF_C13_60),Anesthesiology (D_4_IPF_C13_53),Other Outpatient Services (D_4_IRF_C11_93),Observation Beds (Distinct Unit) (D3_SNF_C2_9201),Observation Beds (Distinct Unit) (D3_SNF_C3_9201),"Allocation of Interns & Residents Salary and Fringes, Impl. Dev. Charged to Patients (B_1_C21_72)",Other Special Care (S3_1_C4_12),Surgical Intensive Care Unit (S3_1_C5_11),Whole Blood & Packed Red Blood Cells (D_4_IPF_C11_62),Speech Pathology (D_4_IPF_C11_68),Whole Blood & Packed Red Blood Cells (D_4_IRF_C11_62),Electrocardiology (D_4_IRF_C13_69),Hospice (S3_1_C9_24),"COST REIMBURSED SERVICES NOT SUBJECT TO DEDUCTIBLES AND COINSURANCE - CHARGES, ASC (Non Distinct Part) (D_5_HOS_C4_75)","COST SERVICES NOT SUBJECT TO DEDUCTIBLES AND COINSURANCE - COST, ASC (Non Distinct Part) (D_5_HOS_C7_75)",Other Reimbursable (D_4_HOS_C11_98),Other Reimbursable (D_4_HOS_C13_98),Other Reimbursable (D_4_HOS_C2_98),Other Reimbursable (D_4_IRF_C11_98),FFY,Hospital State (S2_1_C2_2),"If (SCH), enter the # of periods. (S2_1_C1_35)",Is this hospital is subject to the HAC reduction adjustment for discharges occurring prior to October 1? (Y/N) (S2_1_C1_40),Is this hospital is subject to the HAC reduction adjustment for discharges occurring on or after October 1? (Y/N) (S2_1_C2_40),IPPS Interim payment (E_A_HOS_C1_72),HVBP payment adjustment amount (E_A_HOS_C1_7093),HRR adjustment amount  (E_A_HOS_C1_7094),IPPS Payment amount (unadjusted) (E_A_HOS_C1_59),HAC reduction adjustment amount (E_A_HOS_C1_7099),Line 19 Subtotal (IMPUTED OR HYPOTHETICAL),Reconstructed IPPS payment (pre HAC penalty) (IMPUTED OR HYPOTHETICAL),Reconstructed HAC penalty (IMPUTED OR HYPOTHETICAL),Reconstructed IPPS payment (post HAC penalty) (IMPUTED OR HYPOTHETICAL),HAC penalty imputed from E_A_HOS_C1_59 (IMPUTED OR HYPOTHETICAL),Name and Num
2011,UPMC NORTHWEST HOSPITAL (390091),Acute Care Hospitals,Voluntary non-profit - Other,-79.707926,41.360026,600753,390091,12001,4,2017-07-20 00:00:00,2010-07-01 00:00:00,2011-06-30,F,A,39,39730,2.0,3.0,,,,,,,,,,,,,,,,,,,,,,,,,,,,,,,,,,,,,,,,,,,,,,,,,,,,,,,,,,,,,,,,,,,,,,,,,,,,,,,,,,,,,,,,,,,,,,,,,,,,,,,,,,,,,,109981109.0,,23823472.0,34269650.0,114735935.0,1932837.0,,1932837.0,2115462.0,,,,,,4886599.0,4886599.0,-315617.0,-45920.0,,,-10025619.0,29487884.0,5868716.0,59295561.0,3072846.0,,-10025619.0,-1928959.0,78757826.0,7129479.0,,78757826.0,16869021.0,,4888323.0,1140532.0,,78757826.0,81124764.0,79429903.0,16902569.0,,93031382.0,19520579.0,,212741495.0,16902569.0,16902569.0,8034023.0,8931784.0,18183837.0,616277.0,388959.0,1005236.0,17178601.0,9806390.0,,8931784.0,,40869.0,25760.0,19708.0,12244.0,1055316.0,542164.0,40869.0,19708.0,0.370204,4180251.0,193023.0,3207197.0,6650530.0,2463355.0,911944.0,908830.0,4741884.0,1755465.0,1731109.0,2.0,2.0,1.0,661.3,712.97,2766.0,2766.0,5871.0,5871.0,119.0,127.0,180.0,119.0,43435.0,46355.0,43435.0,12244.0,13185.0,12244.0,23177.0,25849.0,23177.0,2082668.0,40265633.0,182625.0,,,,-4042821.0,6467928.0,,1028258.0,,,489389.0,1251833.0,3059635.0,260006.0,3106988.0,4476777.0,119710113.0,3106988.0,3106988.0,920263.0,1089678.0,77009.0,83438.0,1006240.0,1323067.0,5277.0,1563.0,77009.0,,681.0,681.0,141.0,718.0,28.0,10220.0,1563.0,2392.0,3131.0,1171.0,2392.0,5277.0,29487884.0,1590134.0,3741007.0,493208.0,681520.0,869140.0,649460.0,841183.0,,29564827.0,2213358.0,27351469.0,42071103.0,29564827.0,2213358.0,27351469.0,42071103.0,9222049.0,,24782222.0,24782222.0,7149306.0,7130854.0,7770443.0,1914062.0,5858202.0,7738528.0,5858202.0,5854658.0,71047.0,49733.0,17929.0,5904391.0,5903956.0,5842999.0,,3073558.0,6528259.0,6361164.0,6536370.0,,,,,,1724.0,,,256938.0,,51507.0,957939.0,159790.0,29487884.0,1590134.0,256938.0,3741007.0,,493208.0,51507.0,681520.0,608675.0,649460.0,957939.0,841183.0,159790.0,1509514.0,19.53,1533864.0,1422251.2,19.27,19.23,26.71,,,14505.0,,60957.0,,,,,452561.0,861579.0,40319.0,1694861.0,861579.0,899204.0,1046.0,3443333.0,5422913.0,2278529.0,843521.0,822279.0,23798078.0,566.0,1046.0,2583.0,7581127.0,,,7581127.0,,,147223.0,25.41,7602868.0,7602868.0,496243.0,27.8,18.58,,,,,,,,,,,,,,,,,,,,1876.0,1876.0,,4861.0,4861.0,2985.0,1876.0,55.0,346.0,363740.0,1140664.0,5612362.0,617087.0,169714.0,363740.0,1140664.0,5612362.0,617087.0,169714.0,79289.6,6266.0,7268.0,139407.0,11274.0,23317.0,69222.0,50386.0,22381.0,13416.0,64397.0,8590.0,20.05,58.05,156.94,40.26,22.79,21.15,9.85,12.08,29.02,12.65,13.06,18.6,7116766.0,7116766.0,111612.8,152941.0,19.83,46.53,,,380771.0,71924.0,11164.0,,18452.0,91131.0,91131.0,,4861.0,,1876.0,,3544.0,18452.0,203010.0,75155.0,59813.0,291.0,,4443.0,21741.0,31764.0,187334.0,273700.0,21741.0,31764.0,,187334.0,273700.0,,984.0,33800.0,1438.0,,190.38,28.34,190.33,1575192.2,,,435.0,,,,,,,21242.0,3114.0,24356.0,3146.0,,,,,,,,,,471207.0,623224.0,58043.0,127882.0,-265814.0,,533250.0,1616697.0,210991.0,1616697.0,2089997.0,169415.0,6429.0,1616697.0,1616697.0,1125053.0,453223.0,1578276.0,146821.0,9522.0,156343.0,1421933.0,524559.0,,169415.0,,1699116.0,1453698.0,,453223.0,,2509.0,1746.0,146821.0,173.0,150.0,10.0,223.0,9.0,3285.0,1746.0,121.0,2509.0,623224.0,260465.0,21395.0,12.17,-18436.0,,,747900.0,,2252466.0,,311441.0,,2254431.0,,3688555.0,,2254431.0,1557890.0,767628.0,2130192.0,767628.0,0.843,6011310.0,43.0,15.54,16.0,5840.0,3214.0,,4651.0,623224.0,5054.0,32323.2,10.19,19.28,,,,,,,,,,,,,,,,,,,,,,,,,,,,,,,,,,,,,,,,,,13463.0,930.0,49.0,243.0,,,,,,,,,,,,,,,,419359.0,2481506.0,918663.0,499304.0,,-10065.0,,350643.0,350643.0,25788.0,13.6,,,,,,,,,,,,,-1965.0,15342.0,,,,,,,,,,,,,,,,,24789.0,,,,,,,,,,,,11220954.0,,,,11220954.0,,,,,,,,,,,,,,,,,,,,,,,,,,,,,,,,,,,,,,,,,,,,,,,,,,,,,,,,,,,,,,,,,,,,,,,,,,,,,,,,,,,,,,,,,,,,,,,,,,,,,,,,,,,,,,,,,,,,,,,,,,,,,,,,94.0,91131.0,91131.0,187.0,91131.0,91131.0,,,,,,,,,,,,,,,,,,,,,,,,,,,,156.0,,46.0,,,175206.0,,,,,,,,,,,,,,,,,,,,,,,,,,,,,,,,,,,,,,,,,,,,,,,,,,,,,,,,,,,,,,,,,,,,,,,,,,,,,,,,,,,,,,,,,,,,,,,,,,,,,,,,,,,,,,,,,,,,,,,,,,,,,,,,,,,,,,,,,,,,,,,,,,,,,,,,,,,,,,,,,,,,,,,,,,,,,,,,,,,,,,,,,,,,,,,,,,,,,,,,,,,,,,,,,,,,,,,,,,,,,,,100 FAIRFIELD DRIVE,SENECA,16346,VENANGO,UPMC NORTHWEST HOSPITAL,99939,P,2,Y,N,N,N,Y,N,,N,N,,N,N,Y,N,Y,Y,N,UPMC NORTHWEST-PSYCHIATRIC,39S091,H00164,UPMC,200 LOTHROP STREET,PITTSBURGH,PA,15213-2582,,Y,,,,,,UPMC NORTHWEST-REHAB UNIT,39T091,395966,,,,,,,,,,,,,,,,,,,,,,,,,,,,,,,,,,,,,,,,,,,,,,,,,,,,,,,,,,,,,,,,,,,,,,,,,,,,,,,,,,,,,,,,,,,,,,,,,,,,,,,,,,,,,,,,,,,,,,,,,,,,,,,,,,,,,,,,,,,,,,,,,,,,,,,,,,,,,,,,,,,,,,,,,,3007361.0,1879238.0,3007361.0,1879238.0,-12060688.0,957939.0,841183.0,159790.0,3741007.0,669464.0,337739.0,58514.0,276085.0,681520.0,,786618.0,3069015.0,451380.0,14177.0,,168746.0,29569728.0,4246711.0,62170.0,1253542.0,1783424.0,216142.0,6431794.0,,182021.0,686707.0,97113.0,50942.0,48018.0,1885506.0,180295.0,,,390523.0,,-45920.0,,-4093080.0,3007361.0,838254.0,1126523.0,1246643.0,173967.0,1879238.0,6026937.0,18828342.0,3090408.0,346177.0,144548.0,3107927.0,680476.0,337558.0,590015.0,7357472.0,,12692.0,776697.0,894112.0,282273.0,116133.0,339901.0,2454801.0,225500.0,23646.0,2104944.0,2881995.0,1072043.0,228380.0,2459957.0,6238983.0,647626.0,291296.0,5955423.0,1439373.0,600369.0,1001611.0,11313657.0,,35751.0,1304813.0,1410564.0,409661.0,168005.0,733770.0,340141.0,36865.0,3281680.0,5873276.0,378980.0,5346177.0,600030.0,35160.0,26344.0,531130.0,185209.0,12467.0,38511.0,253744.0,,3255.0,40215.0,33884.0,4066.0,1318.0,92839.0,15625.0,561.0,49953.0,203259.0,3882.0,308483.0,6238983.0,647626.0,291296.0,6380051.0,1439373.0,600369.0,1166194.0,11313657.0,,35751.0,1304813.0,1410564.0,409661.0,168005.0,733770.0,340141.0,36865.0,3281680.0,5873276.0,378980.0,5346177.0,3488078.0,613229.0,1047030.0,3834849.0,180576.0,4245275.0,1348917.0,10488612.0,,132054.0,2913273.0,2072613.0,1107361.0,436463.0,2467909.0,176224.0,113783.0,5155736.0,12243146.0,18583.0,4225882.0,1946738.0,236011.0,324749.0,1570685.0,94765.0,2178365.0,640495.0,5589874.0,,68663.0,1486538.0,727938.0,242569.0,285422.0,1595506.0,102662.0,60263.0,2453751.0,5483374.0,4587.0,2350652.0,843195.0,104373.0,34252.0,511626.0,26757.0,98957.0,33625.0,1309596.0,,16331.0,554599.0,292055.0,78595.0,97941.0,198138.0,32102.0,6843.0,1292285.0,2116171.0,3182.0,751583.0,1946738.0,236011.0,324749.0,1570685.0,94765.0,2178365.0,640495.0,5589874.0,,68663.0,1486538.0,727938.0,242569.0,285422.0,1595506.0,102662.0,60263.0,2453751.0,5483374.0,4587.0,2350652.0,,,,869140.0,649460.0,,,493208.0,177645.0,101849.0,,,422064.0,50735.0,,,,,496199.0,751309.0,,,473571.0,,,,,527704.0,,443054.0,,,,251772.0,,500131.0,,,,,,,2664849.0,,2664849.0,,1028432.0,,256938.0,2022768.0,,2115313.0,51507.0,,,,-321305.0,,,179426.0,179426.0,124475.0,,,,,,,,1133046.0,248025.0,104685.0,,,,,,347427.0,647077.0,38080.0,647077.0,570906.0,10916264.0,8082.0,16004236.0,31467574.0,210889.0,2975569.0,3354219.0,3354219.0,1452820.0,34825.0,,212914.0,416537.0,11631.0,4450.0,1861.0,,-18436.0,584128.0,3440766.0,3903359.0,392900.0,159385.0,1017293.0,3903359.0,392900.0,159385.0,1017293.0,1063507.0,109873.0,59464.0,126333.0,,,284887.0,600205.0,-424628.0,668018.0,1230424.0,134320.0,1230424.0,,,169714.0,764726.0,219038.0,-646135.0,-251070.0,-46352.0,960968.0,2104689.0,128057.0,2104689.0,2447095.0,1443172.0,1218030.0,1425195.0,1626.0,941.0,74113.0,,,,,8.0,2920.0,941.0,1626.0,,,,284268.0,,,168550.0,299083.0,,132827.0,38886.0,2124336.0,,,,,,22419.0,1132030.0,,,,,-778304.0,,18756.0,,,,,,,,,,,,,,,,,,,,,,,851205.0,1714806.0,,8970891.0,14940502.0,,18259.0,911534.0,1075422.0,12494808.0,,,3674.0,,,4106.0,,,,,,,,,3674.0,,,,179547.0,,355165.0,,3519453.0,2477838.0,,,,188553.0,,270877.0,2175323.0,,,179547.0,,355165.0,,3519453.0,2477838.0,,,,188553.0,,270877.0,2175323.0,,,,4861.0,79402.0,,37460.0,,159878.0,130084.0,,,,58960.0,,142659.0,695525.0,,,,1876.0,,,,,,,,173.0,,,,,,,1861839.0,156991.0,53140.0,620528.0,241346.0,176744.0,241346.0,321661.0,321661.0,309546.0,,-1108048.0,,938471.0,1266508.0,11057.0,1266508.0,1164516.0,1073244.0,609046.0,344702.0,609046.0,478025.0,478025.0,,270548.0,,,,,,-25000.0,,1077.0,1258.0,214.0,10375.0,,121678.0,7852.0,13019.0,2241.0,1991.0,6275.0,,,257517.0,69408.0,466.0,556.0,23.0,3573.0,,28507.0,2929.0,5223.0,726.0,683.0,779.0,,,99382.0,22192.0,4439.0,451.0,335.0,29381.0,,104476.0,23010.0,,,,8652.0,1118.0,,240047.0,160.0,1923.0,199.0,35.0,9167.0,,24477.0,8585.0,,,,1074.0,127.0,,92640.0,111.0,,,,,,,,,,,,,,,50811.0,201166.0,449904.0,389566.0,78443.0,2466.0,670478.0,15922.0,47129.0,180506.0,126223.0,26917.0,280.0,258754.0,,,,,90669.0,,315634.0,667012.0,9037.0,,166338.0,,-80950.0,,127477.0,,,,833033.0,,,,,2041709.0,,159080.0,,2041709.0,,2321.0,4917163.0,449032.0,890.0,4026.0,19273.0,5692.0,,876.0,299.0,,,34851.0,5715.0,810.0,,9826.0,,1583.0,300.0,253.0,,3142.0,,,890.0,3047084.0,97265.0,3047084.0,97265.0,,,860359.0,439981.0,,,,,,,,,,,,,,,,,,,44568.0,15205.0,25224.0,1888.0,,,,,,,,,,,,,,,,,,,,,,,,,,,,,,,,,,,,,205053.0,5993.0,,76501.0,4158.0,,,,,,,,,,,,,,,,,,,,,,,-222261.0,,,,,,,,,,-164583.0,,,,,,,,,,,,,,,,,,,,,,,,,,,,,,,,,,,,,,,,,,,,,,,,,,,,,,,3809.0,11.0,7302.0,42.0,,,,,,,,,,,6125.0,369.0,11797.0,161.0,,,,,,,,,,45577.0,616.0,44299.0,639.0,,,,,,,,,,,,,,,,,,,,,,,,,,,,,,,,,,,,,,,,,,,,,,,,,,,,,,,,,,,,,,,2775.0,,,,,1977.0,,,,,,,,,,,,,,,,,,,,,,,,,,,,,,,,,,,,,,,,,,,,,,,,,,,,3914.0,,1224.0,,,1232523.0,,,308817.0,,,,,,,,,,,,,,,,,,,,,,,,,,,,29.0,65.0,,70.0,117.0,,,,,,,,,,,,,,,,,,,139.0,,,,,,,,,,,,,2806.0,100.0,,877.0,96.0,,,4623.0,2002.0,,,,,,,,,,,,,5156.0,,,234.0,,,,,,,,,,,,,,,,,,,,,,,,,,,,,,,,,,,,,,,,,,,,,,,,,,,,,,,,,,,,,,,,,,,,,,,,,,,,,3322.0,790.0,,,,,,,,,,,,,,,,,,,,,,,,,,,,,,,,,,,,,,,,,,,,,,,,,,,3854.0,917.0,,,,,,,,,,,,,,,,,,,,,,,,,,,,,,,,,,,,,,,,,,,,,,,,,,,,,,,,,,,,,,,17.0,,,,,,,,,,,,,,,,,,,,,,,,,,,,,,,,,,,,,,,,,,,,,,,,,,,,,,,,,,,,,,,,,,,,,,,,,,,,,,,,,,,,,,,,,,,,,,,,,,,,,,,,,,,,,,,,,,,,,,,,,,,,,,,,,,,,,,,,,,,,,,,,,,,,,,,,,,,,,,,,,,,,,,,,,,,,,,,,,,,,,,,,,,,2010,PA,,,,,,,,,,,,,,UPMC NORTHWEST HOSPITAL (390091)
6856,UPMC NORTHWEST HOSPITAL (390091),Acute Care Hospitals,Voluntary non-profit - Other,-79.707926,41.360026,573297,390091,12001,4,2016-03-30 00:00:00,2011-07-01 00:00:00,2012-06-30,F,B,39,39730,2.0,3.0,,,,,,,,,,,,,,,,,,,,,,,,,,,,,,,,,,,,,,,,,,,,,,,,,,,,,,,,,,,,,,,,,,,,,,,,,,,,,,,,,,,,,,,,,,,,,,,,,,,,,,,,,,,,,,105385687.0,,23823472.0,29852562.0,110326266.0,2078733.0,769074.0,1320978.0,2090052.0,,,,,,4794182.0,4746260.0,-305490.0,-51252.0,,,-8035205.0,29289026.0,6070791.0,59266654.0,3372446.0,,-8035205.0,-2110594.0,80520475.0,7214170.0,,80520475.0,16652866.0,,4794182.0,1135380.0,,80494517.0,83485379.0,81324549.0,16686221.0,,104857458.0,20081055.0,,260295898.0,16686221.0,16686221.0,7239379.0,8164459.0,16550151.0,567085.0,349510.0,916595.0,15633556.0,9492972.0,,8164459.0,,40260.0,25066.0,18090.0,10875.0,959867.0,492638.0,40260.0,18090.0,0.309242,3546439.0,364481.0,2969313.0,6430576.0,4110292.0,1271075.0,1267427.0,6480539.0,2004055.0,1985318.0,2.0,2.0,1.0,618.6,672.8,2651.0,2651.0,5930.0,5930.0,119.0,127.0,180.0,119.0,43554.0,46482.0,43554.0,10875.0,11702.0,10875.0,21820.0,24336.0,21820.0,1907462.0,40448258.0,,,,,-6678306.0,7321166.0,,1141865.0,,,676887.0,1365149.0,3239655.0,267499.0,3362019.0,5212800.0,155438440.0,3362019.0,3362019.0,960908.0,1087745.0,76460.0,80821.0,1006924.0,1492572.0,5808.0,1660.0,76460.0,,586.0,586.0,36.0,742.0,28.0,10248.0,1660.0,1958.0,2633.0,252.0,1958.0,5808.0,29289026.0,1725891.0,3441891.0,490270.0,690763.0,873757.0,657184.0,852406.0,,29220696.0,2381239.0,26839457.0,42889630.0,29220696.0,2381239.0,26839457.0,42889630.0,9052166.0,,33809577.0,33809577.0,8417094.0,8399904.0,8846847.0,2100720.0,6753971.0,8804758.0,6753971.0,6750389.0,308965.0,216276.0,279096.0,6966665.0,6966415.0,6803775.0,,3073558.0,2087865.0,5798895.0,6969086.0,,,,,,,,,257007.0,,43867.0,1057935.0,153487.0,29289026.0,1725891.0,257007.0,3441891.0,,490270.0,43867.0,690763.0,598380.0,657184.0,1057935.0,852406.0,153487.0,1401731.99,20.89,1424492.19,1307146.59,20.51,20.53,28.98,,,14809.0,,162640.0,,,,,439611.0,799585.0,38391.0,2160830.0,799585.0,810826.0,1111.0,3461263.0,6128517.0,2370247.0,732980.0,717891.0,29329337.0,562.0,1111.0,3246.0,7760069.0,,,7760069.0,,,130291.2,26.42,7792206.0,7792206.0,463703.77,29.03,19.52,,,,,,,,,,,,,,,,15528.0,,4620.0,,10950.0,10950.0,,40404.0,40404.0,29454.0,10950.0,3106.0,476.0,566995.0,1122312.0,6568660.0,706361.0,181854.0,566995.0,1122312.0,6568660.0,706361.0,181854.0,83937.6,11910.45,4660.0,156094.98,11901.6,23385.6,70992.0,49047.5,22341.6,14616.0,45309.6,8352.0,20.56,47.6,240.84,42.08,21.59,20.96,9.73,12.2,29.42,12.44,18.81,18.38,8257967.0,8257967.0,117345.6,172665.43,20.29,47.83,,,365502.0,74144.0,15007.0,,17190.0,100984.0,100984.0,,24876.0,,6330.0,,3582.0,17190.0,561538.0,173651.0,290375.0,370.0,,4604.0,32137.0,48740.0,276975.0,420075.0,32137.0,48740.0,,276975.0,420075.0,,1349.0,35496.0,2045.97,,205.32,29.8,205.32,1479812.02,,,250.0,,,,,,,15089.0,3648.0,18737.0,2695.0,,,,,,,,,134506.0,490315.0,655348.0,65017.0,121772.0,-453345.0,,555332.0,1619828.0,211708.0,1619828.0,2161170.0,126837.0,4361.0,1619828.0,1619828.0,1136066.0,626113.0,1762179.0,148482.0,12918.0,161400.0,1600779.0,515975.0,,126837.0,,1861302.0,1513820.0,,626113.0,,2441.0,1712.0,148482.0,173.0,144.0,6.0,208.0,9.0,3294.0,1712.0,68.0,2441.0,655348.0,275377.0,22570.9,12.2,-919.0,,,773987.0,,2175367.0,,246480.0,,2176988.0,,3681079.0,,2176988.0,1482454.0,738973.0,2509305.0,738973.0,0.843,7081119.0,109.0,16.0,16.0,5856.0,3016.0,,4429.0,655348.0,4593.6,33408.0,9.55,19.62,,,,,,,,,,,,,,,,,,,,,,,,,,,,,,,,,,,,,,,,,,24899.0,,70.0,177.0,,,,,,,,,,,,,,,,564593.0,3739907.0,1156536.0,591943.0,,-24785.0,,351745.0,351745.0,24806.17,14.18,,,,,,,,,,,,,-1697.0,,,,,,,,,,,,,,,,,,37771.0,,,,,,,,,,,,11220954.0,,,1035685.0,10185269.0,,,,,,,,,,,,,,,,,,,,,,,,,,,,,,,,,,,,,,,,,,,,,,,,,,,,,,,,,,,,,,,,,,,,,,,,,,,,,,,,,,,,,,,,,,,,,,,,,,,,,,,,,,,220940.0,,,,,,,,,,,,,,,,,,,,,75.0,100984.0,100984.0,171.0,100984.0,100984.0,,,,,,,,,,,,,,,,,,,,,,,,,,,,393.0,,5.0,,,,,,,,,,,,,,,,,,,,,,,,,,,,,,,,,,,,,,,,,,,,,,,,,,,,,,,,,,,,,,,,,,,,,,,,,,,,,,,,,,,,,,,,,,,,,,,,,,,,,,,,,,,,,,,,,,,,,,,,,,,,,,,,,,,,,,,,,,,,1054942.0,183633.0,,,,,,,,,,,,,,,,,,,,,,,,,,,,,,,,,,,,,,,,,,,,,,,,,,,,,,,,,,,,,,,,,,,,,,,,,,,,,,,,,,,,,100 FAIRFIELD DRIVE,SENECA,16346,VENANGO,UPMC NORTHWEST HOSPITAL,99939,P,2,Y,N,N,N,Y,N,,N,N,,N,N,Y,N,Y,Y,N,UPMC NORTHWEST-PSYCHIATRIC,39S091,H00164,UPMC,200 LOTHROP STREET,PITTSBURGH,PA,15213-2582,,Y,,,,,,UPMC NORTHWEST-REHAB UNIT,39T091,395966,,,,,,,,,,,,,,,,,,,,,,,,,,,,,,,,,,,,,,,,,,,,,,,,,,,,,,,,,,,,,,,,,,,,,,,,,,,,,,,,,,,,,,,,,,,,,,,,,,,,,,,,,,,,,,,,,,,,,,,,,,,,,,,,,,,,,,,,,,,,,,,,,2.0,,,,,,,,,,,,,,,,,,,,,,,,,3073441.0,1720741.0,3025519.0,1720741.0,-8295619.0,1057935.0,852406.0,153487.0,3441891.0,658340.0,81.0,,283752.0,690763.0,,813189.0,3226501.0,244017.0,12017.0,,317432.0,25967345.0,4329445.0,61282.0,822999.0,1669625.0,600524.0,7939712.0,,168665.0,1258701.0,192081.0,98072.0,44431.0,2377029.0,210700.0,,,406065.0,,-51252.0,,-707290.0,3073441.0,849790.0,1309371.0,1045171.0,165504.0,1720741.0,5979935.0,18388422.0,3286406.0,353957.0,139769.0,3102310.0,748254.0,331221.0,618254.0,8475196.0,,2427.0,793289.0,1404491.0,373480.0,152475.0,328183.0,2926991.0,237010.0,,1899079.0,2974146.0,1096828.0,312995.0,2441524.0,6181170.0,666747.0,324587.0,6180287.0,1638060.0,676333.0,1124544.0,12845448.0,,6478.0,1321691.0,1981693.0,506817.0,204717.0,736914.0,369646.0,,2878458.0,6272137.0,534609.0,5099128.0,523464.0,35500.0,25073.0,663977.0,192559.0,15437.0,39845.0,275596.0,,715.0,37192.0,36891.0,4701.0,1331.0,94401.0,21667.0,,48411.0,160847.0,4831.0,305087.0,6181170.0,666747.0,324587.0,6524964.0,1638060.0,676333.0,1272703.0,12952523.0,,6478.0,1321691.0,1981693.0,506817.0,204717.0,736914.0,369646.0,,2878458.0,6272137.0,534609.0,5155502.0,5923422.0,626557.0,1253185.0,4121200.0,287550.0,4775828.0,1380891.0,10539253.0,,149128.0,2771638.0,3088087.0,1450794.0,304043.0,2615373.0,156598.0,,5812612.0,17737603.0,5552.0,3865124.0,2150834.0,235008.0,426910.0,2275683.0,115908.0,2746338.0,705025.0,5313007.0,,74079.0,1350658.0,701512.0,241394.0,126445.0,1614723.0,80465.0,,2518674.0,7944934.0,4470.0,1952866.0,639935.0,102105.0,41288.0,707919.0,26955.0,117247.0,37941.0,1179108.0,,2624.0,505789.0,284188.0,72110.0,61244.0,129904.0,26222.0,,1033777.0,2021612.0,4230.0,579683.0,2150834.0,235008.0,426910.0,2275683.0,115908.0,2746338.0,705025.0,5313007.0,,74079.0,1350658.0,701512.0,241394.0,126445.0,1614723.0,80465.0,,2518674.0,7944934.0,4470.0,1952866.0,,,,873757.0,657184.0,,,490270.0,195571.0,96325.0,,,367772.0,100566.0,,,,,531666.0,753509.0,,,411639.0,25958.0,,9749.0,,559410.0,,260069.0,,,,14225.0,,400014.0,,,,,,,1705319.0,,1705319.0,,433924.0,,257007.0,2008413.0,,2295429.0,43867.0,,,,-305490.0,,,243153.0,243153.0,230089.0,,,,,,,,1120606.0,1552.0,56300.0,,,,,,302364.0,553169.0,32822.0,553169.0,1038810.0,14851597.0,323108.0,17549497.0,43984786.0,,6911910.0,2973226.0,2973226.0,884621.0,328.0,,196234.0,407653.0,27810.0,16221.0,4403.0,,-919.0,757806.0,6544548.0,4698286.0,7701863.0,171574.0,1749282.0,4698286.0,7701863.0,171574.0,1749282.0,1316707.0,2060061.0,64250.0,140730.0,,,204082.0,934279.0,-344677.0,361556.0,692726.0,59762.0,692726.0,,,181854.0,763054.0,191347.0,-631107.0,-699839.0,,942189.0,1931084.0,126477.0,1947491.0,2149186.0,1803682.0,1146313.0,1122149.0,1405.0,827.0,74447.0,,,,,8.0,2928.0,827.0,1405.0,,,,292748.0,,,173255.0,319935.0,,153263.0,45452.0,2229532.0,,,,,,13658.0,1391999.0,,,,-36000.0,-1165730.0,,23289.0,,,,,,,,,,,,,,,,,,,,,,,908048.0,2103010.0,,11066252.0,16992201.0,,33730.0,977684.0,1200412.0,13503028.0,,,,,,,,,,,,,,,,,,,168252.0,,406166.0,,2560636.0,4313630.0,,5189.0,18248.0,278977.0,,407478.0,2240328.0,,,168252.0,,406166.0,,2560636.0,4313630.0,,5189.0,18248.0,278977.0,,407478.0,2240328.0,,,,24876.0,73101.0,,39282.0,,109319.0,277514.0,,184.0,7392.0,90914.0,,167247.0,657740.0,,,,6330.0,,,,,,,,113.0,,,,,,,300809.0,245820.0,118618.0,426895.0,228302.0,164558.0,228302.0,212310.0,212310.0,237111.0,,-681876.0,,1059259.0,1405856.0,10430.0,1405856.0,2457481.0,1275206.0,1123214.0,423041.0,1123214.0,649279.0,649279.0,,244541.0,,,,,,-16407.0,,6563.0,459.0,454.0,6836.0,,132125.0,6264.0,18575.0,3122.0,671.0,11362.0,,,240212.0,61943.0,1953.0,199.0,44.0,2245.0,,29120.0,2346.0,7525.0,933.0,325.0,914.0,,,61123.0,18387.0,4262.0,949.0,596.0,41786.0,,148549.0,39553.0,838612.0,351749.0,49864.0,6347.0,,2364.0,313871.0,,1268.0,412.0,58.0,12677.0,,33498.0,14812.0,339728.0,105076.0,24152.0,511.0,,970.0,79865.0,,,,,,,,,,,,,,,,95897.0,284223.0,440408.0,350424.0,24767.0,,928191.0,28552.0,61886.0,178413.0,104680.0,11996.0,,236181.0,,,,,93711.0,,339610.0,686070.0,10156.0,,170198.0,,-80578.0,,-210404.0,,,,856081.0,,,,,1874917.0,,153150.0,,1874917.0,,,6756175.0,620860.0,,,16661.0,8994.0,,711.0,471.0,,6608.0,18334.0,7761.0,856.0,,1731.0,1537.0,783.0,406.0,279.0,,514.0,,,,2429311.0,188808.0,2429311.0,188808.0,,,564951.0,570176.0,,,,,,,,,,,,,,,,,,,54182.0,12195.0,20407.0,981.0,,,,,,,,,,,,,,,15528.0,,,,,,4620.0,,,,,,,,,,,,,,,,218234.0,,1405.0,81723.0,,412.0,,,,,,,,,,,,,,,,,,,,,,-452500.0,,,,,,,,,,-148159.0,,,,,,,,,,,,,,,,,,,,,,,,,,,,,,,,,,,,,,,,,,,,,,,,,,,,,,,6454.0,12.0,8494.0,47.0,,,,,,,,,,,8879.0,258.0,7920.0,133.0,,,,,,,,,,50492.0,748.0,48996.0,748.0,,,,,,,,,,,,,,,,,,,,,,,,,,,,,,,,,,,,,,,,,,,,,,,,,,,,,,,,,,,,,,83.0,,,,,3.0,,,,,,,,,,,,,,,,,,,,,,,,,,,,,,,,,,,,,,,,,,,,,,,,,,,,,1651.0,,538.0,,,,,,,,,,2830.0,,,,,,1.0,2830.0,1371.0,,,,,,,,,,,,,,,,22.0,52.0,1.0,112.0,57.0,1.0,,,,,,,,,,,,3648.0,1497.0,,,,,285.0,,,,,,,,,,,,,2559.0,1481.0,,834.0,1126.0,,,17415.0,5181.0,,,,,2058.0,199.0,,,,,,4868.0,33901.0,25670.0,1132.0,1447.0,1409.0,,,,,,,,,,,,,,,,,,,,,,,,,,,,,,,,,,,,,,,,,,,,,,,,,,,,,,,,,,,,,,,,,,,,,,,25184.0,9485.0,,,,2326.0,82.0,,,,,,,,,,,,,,,,,,,,,,,,,,,1606.0,,698.0,,,,,,,,,,,,,,,,,,,,,,6173.0,219.0,,,,,,,,,,,,,,,,,,,,,,,,,,,,,,,,,,,,,,,,,,,,,,,,,,,,,,,,,,,,,,,105.0,,,,,,,,,,,,,,,,,,,,,,,,,,,,,,,,,,,,1.0,,,,,,,,,,,,,,,,,,,,,,,,,,,,,,,,,,,,,,,,,,,,,,,,,,,,,,,,,,,,,,,,,,,,,,,,,,,,,,,,,,,,,,,,,,,,,,,,,,,,,,,,,,,,,,,,,,,,,,,,,,,,,,,,,,,,,,,,,,,,,,,,,,,,,,,2011,PA,,,,,,,,,,,,,,UPMC NORTHWEST HOSPITAL (390091)
14094,UPMC NORTHWEST HOSPITAL (390091),Acute Care Hospitals,Voluntary non-profit - Other,-79.707926,41.360026,642431,390091,12001,4,2019-02-07 00:00:00,2012-07-01 00:00:00,2013-06-30,F,C,39,39730,2.0,3.0,,,,,,,,,,,,,,,,,,,,,,,,,,,,,,,,,,,,,,,,,,37553.0,,,,,,,,,,,,,,,,,,,,,,,,,,,,,,,,,,,,,,,,,,,,,,,,,,,,,,,,,,,,,,,,,,,,105376556.0,,24592546.0,25374646.0,105447233.0,270127.0,80777.0,,270127.0,,,,,,4562499.0,4515920.0,-312609.0,-49870.0,,,-6633035.0,29382655.0,6304409.0,60683103.0,3148175.0,,-6633035.0,-1884282.0,83432723.0,7382139.0,,83432723.0,17186136.0,,4831607.0,1086407.0,,83408764.0,86552498.0,84042028.0,17189286.0,,113334622.0,20518434.0,,285079402.0,17189286.0,17189286.0,7408964.0,7782926.0,16441703.0,565211.0,361817.0,927028.0,15514675.0,10048849.0,,7782926.0,,40658.0,24848.0,18038.0,10710.0,930344.0,468241.0,40658.0,18038.0,0.292581,3104826.0,506882.0,5466441.0,7926247.0,3661712.0,3661712.0,3650257.0,7374836.0,4748102.0,4706332.0,2.0,2.0,1.0,622.97,675.36,2577.0,2577.0,5743.0,5743.0,119.0,127.0,180.0,119.0,43435.0,46355.0,43435.0,10710.0,11646.0,10710.0,21219.0,24593.0,21219.0,1907462.0,40313752.0,,,,,-4900068.0,6773106.0,,1109483.0,,46579.0,530950.0,1305396.0,3196249.0,252604.0,3281943.0,5210480.0,171744780.0,3281943.0,3281943.0,1114635.0,1255749.0,85794.0,90078.0,1165671.0,1764170.0,5456.0,1853.0,85794.0,,237.0,237.0,39.0,732.0,28.0,10220.0,1853.0,854.0,1129.0,342.0,854.0,5456.0,29382655.0,1695685.0,3367095.0,485943.0,740999.0,929273.0,681276.0,886646.0,,29403461.0,2383402.0,27020059.0,44154826.0,29403461.0,2383402.0,27020059.0,44154826.0,8744648.0,,37489199.0,37489199.0,8664256.0,8646115.0,9394383.0,2195356.0,7217533.0,9337912.0,7217533.0,7214564.0,423507.0,296455.0,374129.0,7511019.0,7510588.0,7383788.0,,3073558.0,354845.0,210028.0,404349.0,,,,,,269108.0,,,146840.0,,49857.0,1073479.0,160835.0,29382655.0,1695685.0,146840.0,3367095.0,,485943.0,49857.0,740999.0,702363.0,681276.0,1073479.0,886646.0,160835.0,1404758.0,20.92,1404843.0,1291722.0,20.93,20.92,29.87,,,14099.0,,89247.0,,,,,433501.0,785741.0,36789.0,2510470.0,785741.0,1069100.0,1636.0,2459806.0,7405567.0,3713124.0,1086390.0,1056075.0,32407478.0,260.0,1636.0,3629.0,7630365.0,,,7630365.0,,,132820.0,25.35,7654758.0,7654758.0,442259.0,28.33,19.77,,26639.0,,,,,,,,,19940.0,,,,,69757.0,,16992.0,,25037.0,25037.0,111457.0,111457.0,111457.0,86420.0,25037.0,6531.0,2433.0,1222958.0,1062416.0,7171343.0,674514.0,178057.0,1222958.0,1062416.0,7171343.0,674514.0,178057.0,80249.0,22430.0,5103.0,158539.0,6487.0,21690.0,69202.0,54025.0,22840.0,13663.0,54744.0,8538.0,21.13,54.52,208.19,45.23,22.64,22.4,10.71,13.0,29.83,13.03,16.2,18.84,9480009.0,9480009.0,113121.0,186734.0,21.07,50.77,,,348072.0,84727.0,15362.0,,18141.0,107969.0,107969.0,,41700.0,,8045.0,,2969.0,18141.0,792613.0,231904.0,304638.0,530.0,,4813.0,24393.0,2475.0,231967.0,23542.0,24393.0,2475.0,,231967.0,23542.0,,1104.0,36085.0,112.0,,210.12,29.75,210.2,1478456.0,50624.0,,431.0,,,,,,,30315.0,11455.0,41770.0,1129.0,,,,,,,,,116321.0,490774.0,687717.0,43918.0,125973.0,-335037.0,,534692.0,1604732.0,201114.0,1604732.0,2312359.0,141114.0,4284.0,1604732.0,1604732.0,1096605.0,695723.0,1792328.0,137426.0,11906.0,149332.0,1642996.0,703105.0,,141114.0,,2067576.0,1576940.0,,695723.0,,2457.0,1679.0,137426.0,169.0,128.0,10.0,196.0,9.0,3285.0,1679.0,101.0,2457.0,687717.0,226910.0,17454.0,13.0,-5941.0,,,812200.0,,2274542.0,,224429.0,,2274542.0,,3988450.0,,2274542.0,1438237.0,649268.0,2425755.0,649268.0,0.843,7288675.0,1903.0,15.8,16.0,5840.0,2860.0,,4523.0,687717.0,4514.0,32872.0,11.04,20.92,,,,,,,,,,,,,,,,,,,,,,,,,,,,,,,,,,,,,,,,,,38330.0,,79.0,210.0,23292.0,23292.0,662.0,35.18,,,,,,,,,,,,586742.0,3413601.0,998755.0,412013.0,,-32679.0,,44348.0,44348.0,197.0,225.12,,,,,,,,,,,,,,,,,,,,,,,,,,,,,,,34945.0,,,,,,,,,,,,10185269.0,138726.0,138726.0,,10323995.0,,,,,,,,,,,,,,,,,,,,,,,,,,,,,,,,,,,,,,,,,,,,,,,,,,,,,,,,,,,,,,,,,,,,,,,,,,,,,,,,,,,,,,,,,,,,,,,,,,,,,,,,,,,176559.0,,,,,,,,,,,,,,,,,,,,,176.0,107969.0,107969.0,144.0,107969.0,107969.0,,,,,,,,,,,,,,,,,,,,,,,,,,,,333.0,,79.0,,,78000.0,,,,,,,,,,,,,,,,,,,,,,,,,,,,,,,,,,,,,,,,,,,,,,,,,,,,,,,,,,,,,,,,,,,,,,,,,,,,,,,,,,,,,,,,,,,,,,,,,,,,,,,,,,,,,,,,,,,,,,,,,,,,,,,,,,,,,,,,,994947.0,126000.0,,,,,,,,,,,,,,,,,,,,,,,,,,,,,,,,,,,,,,,,,,,,,,,,724117.0,,,,,,,,,,,,,,,,,,,,,,,,,,,,,,,,,,,,,100 FAIRFIELD DRIVE,SENECA,16346,VENANGO,UPMC NORTHWEST HOSPITAL,99939,P,2,Y,N,N,N,Y,N,,N,N,,N,N,Y,N,Y,Y,,UPMC NORTHWEST - PSYCHIATRIC,39S091,HO0164,UPMC,200 LOTHROP STREET,PITTSBURGH,PA,15213-2582,,Y,,,,,,UPMC NORTHWEST - REHAB UNIT,39T091,395966,,,,,,,,,,,,,,,,,,,,,,,,,,,,,,,,,,,,,,,,,,,,,,,,,,,,,,,,,,,,,,,,,,,,,,,,,,,,,,,,,,,,,,,,,,,,,,,,,,,,,,,,,,,,,,,,,,,,,,,,,,,,,,,,,,,,,,,,,,,,,,,,,1.0,,,,,,,,,,,,,,,,,,,,,,,,,2970963.0,1591536.0,2940080.0,1575840.0,-8104974.0,1073479.0,886646.0,160835.0,3367095.0,662934.0,588.0,,292574.0,740999.0,,827430.0,2973528.0,80574.0,13676.0,,330682.0,27306664.0,4387143.0,69740.0,132044.0,1638407.0,723411.0,9404194.0,,228299.0,1183645.0,252785.0,106668.0,51558.0,2050788.0,255799.0,,,345314.0,,-49870.0,,-2610866.0,2970963.0,1327546.0,1354581.0,917350.0,174511.0,1591536.0,7371684.0,18080958.0,3297436.0,359927.0,131820.0,3233348.0,813052.0,332390.0,609916.0,10274078.0,,,856303.0,1297831.0,516032.0,197545.0,344132.0,2604203.0,283760.0,,1925201.0,2686485.0,1086313.0,566773.0,2418366.0,6095766.0,670160.0,311290.0,6460798.0,1690553.0,664894.0,1078014.0,15084788.0,,,1421344.0,1798016.0,682340.0,259552.0,752478.0,420735.0,,2883248.0,5780870.0,904683.0,4902750.0,497315.0,33508.0,21550.0,796334.0,183050.0,13244.0,27918.0,317376.0,,,63649.0,29199.0,4061.0,1013.0,92889.0,16224.0,,93573.0,79560.0,41197.0,286803.0,6095941.0,670160.0,311290.0,6741879.0,1690553.0,664894.0,1218536.0,15084788.0,,,1421344.0,1798016.0,682340.0,259552.0,752478.0,420735.0,,2883248.0,5780870.0,904683.0,4980406.0,6038493.0,629230.0,1294021.0,4449659.0,345865.0,5375527.0,1380231.0,12020832.0,,,3600602.0,3131887.0,1576972.0,395242.0,2870346.0,176885.0,,5331030.0,20455458.0,7793.0,4105630.0,2183106.0,229641.0,410949.0,2430311.0,120374.0,2669774.0,603586.0,5509191.0,,,1693430.0,684313.0,277817.0,139054.0,1593944.0,77881.0,,2320655.0,8919862.0,6868.0,2067363.0,675392.0,83576.0,36249.0,743130.0,22852.0,105101.0,30021.0,1098460.0,,,551344.0,273577.0,106374.0,72708.0,118438.0,24814.0,,1017380.0,1720971.0,4544.0,575907.0,2183106.0,229641.0,410949.0,2430311.0,120374.0,2669774.0,603586.0,5509191.0,,,1693430.0,684313.0,277817.0,139054.0,1593944.0,77881.0,,2320655.0,8919862.0,6868.0,2067363.0,,,,929273.0,681276.0,,,485943.0,278174.0,92777.0,,,380883.0,272899.0,,-312609.0,,-75.0,116343.0,774053.0,,,430740.0,23959.0,,9360.0,,1359626.0,,299418.0,,,,1554847.0,,463990.0,,,,,,,2022789.0,,2022789.0,,390271.0,,146840.0,2051876.0,,2292912.0,49857.0,,,,-205.0,,,401401.0,401401.0,265567.0,,,,,,,,1134351.0,65.0,3218.0,,-800.0,,,,290361.0,536529.0,29918.0,536529.0,1225772.0,13665747.0,5741.0,18594752.0,54325071.0,,9506982.0,3242449.0,3242449.0,1003094.0,,,177560.0,396745.0,85014.0,41327.0,11628.0,,-5941.0,765005.0,7256475.0,4782742.0,10419174.0,204030.0,1853806.0,4782742.0,10419174.0,204030.0,1853806.0,1301669.0,2703063.0,66428.0,137747.0,17662.0,8977.0,213407.0,983044.0,-283313.0,481211.0,829582.0,47004.0,854767.0,13221.0,6719.0,178057.0,867545.0,306542.0,-581848.0,-678283.0,,1152883.0,2300891.0,180062.0,2320692.0,2990982.0,1365577.0,1249813.0,1444160.0,1738.0,936.0,96970.0,,,,,8.0,2920.0,936.0,1738.0,,,,290523.0,108.0,,184116.0,318357.0,,142985.0,46496.0,1812890.0,,,,,,10648.0,1245188.0,,,,-36000.0,-626743.0,,28632.0,,,,,,,,,,,,,,,,,,,,,,,1212159.0,2235063.0,,11514292.0,17053830.0,,,1143644.0,1245697.0,13772755.0,,,,,,,,,,,,,,,,,,,246876.0,,440736.0,,2832080.0,4024495.0,,,,267218.0,,354735.0,2247866.0,,,246876.0,,440736.0,,2832080.0,4024495.0,,,,267218.0,,354735.0,2247866.0,,,,41700.0,89849.0,,38876.0,,111490.0,246974.0,,,,85139.0,,155517.0,616428.0,,,,8045.0,,,,,,,,15.0,,,,,,,483067.0,205089.0,101148.0,442352.0,320888.0,191099.0,320888.0,197225.0,197225.0,244884.0,,,,743522.0,971969.0,5377.0,971969.0,2070299.0,1044244.0,1023922.0,319539.0,1023922.0,3473.0,3473.0,,1084.0,,,,,,-19801.0,,,,,10402.0,,177633.0,16004.0,31687.0,6156.0,4882.0,8919.0,,,292126.0,61847.0,,,,3132.0,,35180.0,5211.0,12668.0,2357.0,2553.0,663.0,,,56362.0,17229.0,12269.0,753.0,747.0,32744.0,,167050.0,65248.0,861234.0,377789.0,75558.0,5670.0,,1394.0,369417.0,,3796.0,274.0,66.0,8617.0,,33084.0,21243.0,344308.0,144653.0,39508.0,421.0,,611.0,71274.0,,,,,,,,,,,,,,,,89692.0,318964.0,375814.0,324084.0,22072.0,,931481.0,24512.0,63177.0,150244.0,124090.0,11541.0,,179717.0,,,,,95428.0,,359293.0,697278.0,9674.0,,161836.0,,-76470.0,,-282778.0,,,,859020.0,,,,,1860114.0,,145981.0,,1860114.0,,237759.0,8559137.0,2631252.0,2656.0,1722.0,46250.0,40931.0,,1821.0,1941.0,,9868.0,23917.0,5105.0,1801.0,,164.0,1873.0,942.0,242.0,574.0,,46.0,,,2656.0,2981064.0,114545.0,2981064.0,114545.0,,,565934.0,74265.0,,,,,,,41217.0,8163.0,,,,,,,,,,,14110.0,17084.0,4403.0,1269.0,,,,,,,,,,,,,,,28540.0,,,,,,8829.0,,,,,,,,,,,,,,,,225254.0,,2293.0,73338.0,,629.0,,,,,,,,,,,,,,,,,,,,,,-400408.0,,,,,,,,,,-140522.0,,,,,,,,,,,,,,,,,,,,,,,,,,,,,,,,,,,,,,,,,,,,,,,,,,,,,,,7033.0,11.0,8274.0,44.0,,,,,,,,,,,8939.0,277.0,8777.0,148.0,,,,,,,,,,53958.0,831.0,52349.0,831.0,,,,,,,,,,,,,,,,,,,,,,,,,,91.0,,,,,,,,,,,,,,,,,,,,,,,,,,,,,,,,,,,,,,,,,,,,,,,,,,,,,,,,,,,,,,,,,,,,,,,,,,,,,,,,,,,,,,,,,,,,,,6268.0,,1997.0,,,22404.0,,,13442.0,,,,,,,,,,1.0,,,,,,,,,,,,,,,,,,30.0,143.0,3.0,69.0,74.0,,,,,,,,,,,,,,,,,,,231.0,,,,,,,,,,,,,2025.0,225.0,,645.0,288.0,,,22594.0,6990.0,,,,,1893.0,167.0,,,,,,28409.0,31619.0,15757.0,5393.0,1245.0,752.0,,,,,,,,,,,,,,,,,,,,,,,,,,,,,,,,,,,,,,,,,,,,,,,,,,,,,,,,,,,,,,,,,,,,,,,34444.0,10749.0,,,,,,,,,,,,,,,,,,,,,,,,,,,,,,,,2385.0,,868.0,,,,,,,,,,,,,,,,,,,,,,,,,,,,,,,,,,,,,,,,,,,,,,,,,,,,,,,,,,,,,,,,,,,,,,,,,,,,,,,,,,,,,,98.0,,,,,,,,,,,,,,,,,,,,,,,,,,,,,,,,,,,,3.0,,,,,,,,,,,,,,,,,,,,,,,,,,,,,,,,,,,,,,,,,,,,,,,,,,,,,,,,,,,,,,,,,,,,,,,,,,,,,,,,,,,,,,,,,,,,,,,,,,,,,,,,,,,,,,,,,,,,,,,,,,,,,,,,,,,,,,,,,,,,,,,,,,,,,,,2012,PA,,,,,,,,,,,,,,UPMC NORTHWEST HOSPITAL (390091)
17809,UPMC NORTHWEST HOSPITAL (390091),Acute Care Hospitals,Voluntary non-profit - Other,-79.707926,41.360026,574797,390091,12001,2,2016-04-25 00:00:00,2013-07-01 00:00:00,2014-06-30,F,E,39,39730,2.0,3.0,,,,,,,,,,,,,,,,,,,,,,,,,,,,,,,,,,,,,,,,,,157680.0,,,3.0,,1095.0,,,,,,,,,,,,,,,,,,,,,,,,,,,,,,,,,,,,,,,,,,,,,,,,,,,,,,,,,,,,,,,105291838.0,,24673323.0,25164618.0,105313011.0,714185.0,85700.0,203174.0,733069.0,,,,,,4559038.0,4513247.0,,,,,-14923993.0,28551520.0,6230257.0,69401308.0,3226573.0,,-14923993.0,-2008505.0,83028835.0,7258366.0,,83028835.0,16400179.0,,4783578.0,1046768.0,,83005328.0,86393046.0,83679402.0,16412556.0,,113159695.0,18751071.0,,299741148.0,16412556.0,16412556.0,6879987.0,6995835.0,15022612.0,519709.0,312318.0,832027.0,14190585.0,9231760.0,,6995835.0,,38450.0,22596.0,16291.0,9472.0,847505.0,438838.0,38450.0,16291.0,0.276923,3131160.0,451221.0,3518538.0,5753148.0,331609.0,91830.0,91738.0,10119834.0,2802415.0,2776401.0,2.0,2.0,1.0,588.12,641.88,2424.0,2424.0,5327.0,5327.0,119.0,127.0,180.0,119.0,43435.0,46355.0,43435.0,9472.0,10309.0,9472.0,18860.0,22017.0,18860.0,1829462.0,40197431.0,18884.0,,,,-5483004.0,-1121220.0,,1166127.0,,45791.0,576881.0,1348777.0,3185641.0,235905.0,3316448.0,5727710.0,186581453.0,3316448.0,3316448.0,962597.0,1103128.0,68474.0,73486.0,1029642.0,1657565.0,5671.0,1646.0,68474.0,,67.0,67.0,40.0,800.0,28.0,10220.0,1646.0,341.0,410.0,229.0,341.0,5671.0,28551520.0,1807183.0,2969724.0,484886.0,775076.0,884880.0,553041.0,682712.0,,28502897.0,2530756.0,25972141.0,43702827.0,28502897.0,2530756.0,25972141.0,43702827.0,7853703.0,,40077486.0,40077486.0,9126270.0,9109361.0,9865234.0,2237429.0,7636109.0,9842749.0,7636109.0,7626849.0,395345.0,256974.0,344567.0,7883823.0,7883995.0,7745126.0,-14596.0,3124182.0,497747.0,,497747.0,,,,,,224540.0,,,,,48305.0,1097269.0,162476.0,28551520.0,1807183.0,,2969724.0,,484886.0,48305.0,775076.0,654891.0,553041.0,1097269.0,682712.0,162476.0,1336631.0,21.36,1336434.0,1220572.0,21.33,21.28,30.88,,,13534.0,,-4215.0,,,,,425153.0,763607.0,35777.0,2713644.0,763607.0,1056280.0,1522.0,2234610.0,7721681.0,9788225.0,2710585.0,2684663.0,35334034.0,64.0,1522.0,3736.0,7666778.0,,,7666778.0,,,120833.0,24.58,7690364.0,7690364.0,397580.0,29.61,19.75,,28586.0,,,,,,,,,17205.0,,,,,42320.0,,11892.0,,16559.0,16559.0,,83010.0,83010.0,66451.0,16559.0,8255.0,2614.0,1635748.0,759771.0,7607028.0,741167.0,179614.0,1635748.0,759771.0,7607028.0,741167.0,179614.0,82657.0,28984.0,4504.13,159863.0,,20785.0,69801.0,48331.0,17892.0,13555.0,41157.0,8381.0,21.86,56.44,168.68,47.58,,23.33,11.1,13.55,30.91,13.25,16.59,19.39,10040322.0,10040322.0,115862.0,194469.13,21.84,51.63,,,350690.0,73663.0,11976.0,,16909.0,96749.0,96749.0,,40690.0,,4667.0,,9260.0,16909.0,438985.0,121565.0,105416.0,319.0,,4218.0,23586.0,7067.0,214742.0,64343.0,23586.0,7067.0,,214742.0,64343.0,,1028.0,35516.0,307.0,,208.89,30.9,209.59,1415041.13,,,-172.0,,,,,,,25922.0,92.0,26014.0,314.0,,,,,,,,,366274.0,545869.0,723573.0,54177.0,124056.0,-394231.0,-17243.0,582803.0,1665371.0,196580.0,1680686.0,2493945.0,140531.0,5012.0,1680686.0,1680686.0,1098983.0,610942.0,1709925.0,128550.0,10657.0,139207.0,1570718.0,855078.0,,140531.0,,1823445.0,1627005.0,,610942.0,,2505.0,1638.0,128550.0,183.0,122.0,4.0,195.0,9.0,3285.0,1638.0,34.0,2505.0,723573.0,229989.0,16973.0,13.55,,,,839420.0,,2290111.0,,219155.0,,2295381.0,,4209480.0,,2295381.0,1369829.0,533923.0,2145148.0,533923.0,,,2295.0,15.96,16.0,5840.0,2698.0,,4521.0,723573.0,4246.0,33205.0,11.38,21.79,,,,,,,,,,,,,,,,,,,,,,,,,,,,,,,,,,,,,,,,,,5576.0,910.0,84.0,212.0,37775.0,37775.0,1118.0,33.79,,,,,,,,,,,,715146.0,3823228.0,1058740.0,343594.0,,,,15720.0,15720.0,110.0,142.91,,,,,,,,,,,,,-7694.0,16149.0,,,,,,,,,,,,,,,,,32985.0,,,,,,,,,63645.0,,,10323995.0,425311.0,425311.0,,10749306.0,,,,,,,,,,,,,,,,,,,,,,,,,,,,,,,,,,,,,,,,,,,,,,,,,,,,,,,,,,,,,,,,,,,,,,,,,,,,,,,,,,,,,,,,,,,,,,,,,,,,,,,,,,,194397.0,,,,,,,,,,,,,,,,,,,,,193.0,96749.0,96749.0,71.0,96749.0,96749.0,,,,,,,,,,,,,,,,,,,,,,,,,,,,319.0,,180.0,,,67828.0,,,,,,,,,,,,,,,,,,,,,,,,,,,,,,,,,,,,,,,,,,,,,,,,,,,,,,,,,,,,,,,,,,,,,,,,,,,,,,,,,,,,,,,,,,,,,,,,,,,,,,,,,,,,,,,,,,,,,,,,,,,,,,,,,,,,,,,,,781660.0,,,,,,,,,,,,,,,,,,,,,,,,,,,,,,,,,,,,,,,,,,,,,,,,,,,,,,,,,,,,,,,,,,,,,,,,,,,,,,,,,,,,,,100 FAIRFIELD DRIVE,SENECA,16346,VENANGO,UPMC NORTHWEST HOSPITAL,99939,P,2,Y,N,N,N,Y,N,,N,N,,N,N,Y,N,Y,Y,N,UPMC NORTHWEST - PSYCHIATRIC,39S091,HO0164,UPMC,600 GRANT STREET,PITTSBURGH,PA,15219,,Y,,,,,,UPMC NORTHWEST - REHAB UNIT,39T091,395966,,,,,,,,,,,,,,,,,,,,,,,,,,,,,,,,,,,,,,,,,,,,,,,,,,,,,,,,,,,,,,,,,,,,,,,,,,,,,,,,,,,,,,,,,,,,,,,,,,,,,,,,,,,,,,,,,,,,,,,,,,,,,,,,,,,,,,,,,,,,,,,,,,,,,,,,,,,,,,,,,,,,,,,,,,2873195.0,1685843.0,2843073.0,1670174.0,-8319769.0,1097269.0,682712.0,162476.0,2969724.0,670391.0,,,287235.0,775076.0,,770491.0,2693997.0,210790.0,14765.0,,329976.0,34425948.0,4625105.0,78430.0,159759.0,1573475.0,706867.0,10271393.0,,255681.0,1265419.0,202102.0,137254.0,40199.0,2144779.0,274765.0,,,361649.0,,-38062.0,-786.0,-10408487.0,2873195.0,1224090.0,1353407.0,855440.0,176455.0,1685843.0,7300598.0,16908930.0,2540588.0,371223.0,145062.0,3016749.0,841619.0,315655.0,581731.0,11377054.0,,,902002.0,1296117.0,521657.0,238567.0,327434.0,2695301.0,297414.0,826392.0,2409021.0,2426657.0,1136725.0,688873.0,2408996.0,5525513.0,684083.0,1623138.0,6244187.0,1652527.0,690731.0,1034134.0,16181548.0,,,1444305.0,1970068.0,676781.0,307947.0,717220.0,425847.0,1073101.0,3118490.0,3232407.0,1116081.0,4788956.0,548346.0,34470.0,85616.0,910425.0,176564.0,15744.0,26746.0,293286.0,,,64282.0,39473.0,4067.0,1213.0,92993.0,13095.0,4427.0,12563.0,15855.0,46341.0,268219.0,5525513.0,684083.0,1623138.0,6539226.0,1652527.0,690731.0,1174656.0,16186073.0,,,1444305.0,1970068.0,676781.0,307947.0,717220.0,425847.0,1073101.0,3118490.0,3232407.0,1116081.0,4847873.0,5667121.0,726317.0,1338336.0,4040224.0,249267.0,5020741.0,1588308.0,12074491.0,,,3520978.0,3211101.0,1673267.0,591867.0,2768043.0,166673.0,1447556.0,7583615.0,18271451.0,21544.0,4101610.0,1803017.0,245780.0,430493.0,2130447.0,95793.0,2471740.0,628905.0,5254437.0,,,1664401.0,756871.0,311164.0,218023.0,1500432.0,73051.0,469026.0,3478884.0,7845602.0,18274.0,1990078.0,542941.0,79353.0,188049.0,633003.0,19960.0,95110.0,29718.0,960004.0,,,558355.0,323255.0,108201.0,92114.0,98641.0,18840.0,130705.0,1178468.0,898965.0,6803.0,531703.0,1803017.0,245780.0,430493.0,2130447.0,95793.0,2471740.0,628905.0,5254437.0,,,1664401.0,756871.0,311164.0,218023.0,1500432.0,73051.0,469026.0,3478884.0,7845602.0,18274.0,1990078.0,,,,884880.0,553041.0,,,484886.0,303248.0,118373.0,,,370635.0,411339.0,,-282770.0,,-200.0,147477.0,626084.0,,,418940.0,23507.0,,9038.0,,2976366.0,,330462.0,,,,1532314.0,,440498.0,,,,,,,2015473.0,,2015473.0,,230937.0,,,2057206.0,,2290198.0,48305.0,-1836.0,,,-1034.0,,,1520783.0,1520783.0,566166.0,,,,,,,,1133026.0,,-3214.0,-45330.0,,,,,289722.0,632456.0,29955.0,632456.0,1593680.0,12682231.0,12322.0,18880518.0,60969281.0,2403203.0,9938984.0,2713263.0,2713263.0,817042.0,,,148748.0,386572.0,87136.0,34748.0,11461.0,,-1682.0,784357.0,8141588.0,4686962.0,10630238.0,199218.0,2222170.0,4686962.0,10630238.0,199218.0,2222170.0,1244367.0,2699756.0,66831.0,146090.0,18804.0,9782.0,228763.0,1317669.0,-330605.0,427857.0,821156.0,40336.0,832458.0,11318.0,5887.0,179614.0,841502.0,258145.0,-486297.0,-625432.0,,1076550.0,2240152.0,157975.0,2240152.0,3000744.0,1401628.0,1146790.0,1519930.0,1635.0,837.0,80871.0,,,,,8.0,2920.0,837.0,1635.0,,,,300010.0,,,181794.0,299038.0,,149348.0,46614.0,1777529.0,,,,,,11929.0,1244057.0,,,,-36000.0,-602040.0,,23691.0,,,,,,,,,,,,,,,,,,,,,,,1392496.0,2377444.0,,12930179.0,17329135.0,,,1484532.0,1622291.0,14043182.0,,,27523.0,,,10839.0,,,,,,,,,27523.0,,,,275459.0,,470590.0,,3133574.0,4228380.0,,,23756.0,334590.0,510813.0,569132.0,2328140.0,,,275459.0,,470590.0,,3133574.0,4228380.0,,,23756.0,334590.0,510813.0,569132.0,2328140.0,108.0,,,40670.0,88935.0,,205565.0,,120577.0,241578.0,,,10146.0,86291.0,142350.0,192793.0,614466.0,12.0,,,4660.0,,,,,,,,5.0,,,,,,,395886.0,273023.0,137004.0,518983.0,269666.0,141472.0,269666.0,232245.0,232245.0,277418.0,,,,558539.0,729763.0,4880.0,729763.0,1594318.0,915715.0,911059.0,264879.0,911059.0,301244.0,301244.0,,87583.0,,,,,,-24999.0,,4193.0,549.0,411.0,17952.0,,228428.0,23296.0,29272.0,4517.0,1678.0,14768.0,,,312695.0,86610.0,1263.0,177.0,180.0,5022.0,,41629.0,7815.0,12502.0,1571.0,709.0,971.0,,,35829.0,23140.0,3290.0,,,18897.0,,142988.0,56567.0,786520.0,364276.0,125122.0,2740.0,,,286675.0,,991.0,,,5350.0,,27469.0,18976.0,335918.0,126669.0,52864.0,180.0,,,32848.0,,24324.0,24324.0,8458.0,,,,,,,,,,,,91120.0,248824.0,374180.0,317806.0,25176.0,12878.0,744074.0,25621.0,45319.0,159810.0,110510.0,10637.0,3589.0,85257.0,,,,,95187.0,,366325.0,669607.0,9924.0,,152684.0,,-81420.0,,-244699.0,,-45.0,,822163.0,,,,,1769828.0,,139950.0,,1769828.0,,222272.0,7681445.0,2822455.0,134901.0,78415.0,56406.0,52404.0,,2170.0,2377.0,,,11064.0,3656.0,2698.0,,2013.0,,426.0,166.0,696.0,,538.0,,,134901.0,2190625.0,483548.0,2190625.0,483548.0,,,456463.0,281075.0,,,,,,,936.0,170.0,,,,,,,,,,,30192.0,13479.0,8778.0,886.0,,,,,,,,,,,,,,,9270.0,,,,32006.0,,2791.0,,,,8919.0,,,,,,,,,,,,204490.0,,2372.0,68600.0,,626.0,,,,,,,,,,,,,,,,,,,,,,-809733.0,,,,,,,,,,-140522.0,,,,,,,,,,,,,,,,,,,,,,,,,,,,,,,,,,,,,,,,,,,,,,,,,,,,,,,5468.0,9.0,6461.0,38.0,,,,,,,,,,,8380.0,202.0,8191.0,136.0,,,,,,,,,,48374.0,729.0,46917.0,729.0,,,,,,,,,,,,,,,,,,,,,,,,,,10.0,,,,,,,,,,,,,,,,,,,,,,,,,,,,,,,,,9531.0,,,,,1986.0,,,,,,,,,,20.0,,,,,,7.0,,,,,,,,,,,,,,,,,,,,,,,,,,,,,,,,,,,,,,,,12368.0,,3190.0,,,13194.0,,,6762.0,,,,10305.0,,,,,,,10305.0,4354.0,,,,,,,,,,,,,,,,42.0,147.0,3.0,42.0,29.0,,,,,,10.0,,,,,,,,,,,,,234.0,,,,,,,,,,,,,913.0,793.0,,235.0,967.0,,,19360.0,5830.0,,,,,3926.0,1715.0,,,,,,16179.0,32211.0,4986.0,3371.0,1239.0,226.0,,,,,,,,,,,,,,,,,,,,,,,,,,,,,,,,,,,,,,,,,,,,,,,,,,,,,,,,,,,,,,,,,,,,,,,3745.0,1089.0,,,,,,,,,,,,,,,,,,,,,,,,,,,,,,,,2189.0,,707.0,,,,,,,,,,,,,,,,,,,,,,,,,,,,,,,,,,,,,,,,,,,,,,,,,,,,,,,,,,,,,,,,,,,,,,,,,,,,,,,,,,,,,,84.0,,,,,,,,,,,,,,,,,,,,,,,,,,,,,,,,,,,,1.0,,,,,,,,,,,,,,,,,,,,,,,,,,,,,,,,,,,,,,,,,,,,,,,,,,,,,,,,,,,,,,,,,,,,,,,,,,,,,,,,,,,,,,,,,,,,,,,,,,,,,,,,,,,1.0,,,,,,,,,,,,,,,,,,,,,,,,,,,,,,,,,,,,,,,,,,,,2013,PA,,,,,,,,,,,,,,UPMC NORTHWEST HOSPITAL (390091)
26813,UPMC NORTHWEST HOSPITAL (390091),Acute Care Hospitals,Voluntary non-profit - Other,-79.707926,41.360026,712879,390091,12001,4,2022-02-25 00:00:00,2014-07-01 00:00:00,2015-06-30,F,J,39,39730,2.0,3.0,,,,,,,,,,,,,,,,,,,,,,,,,,,,,,,,,,,,,,,,,,174673.0,,,3.0,,1095.0,,,,,,,,,,,,,,,,,,,,,,,,,,,,,,,,,,,,,,,,,,,,,,,,,,,,,,,,,,,,,,,105508276.0,,24759023.0,25367792.0,105548333.0,964599.0,58333.0,,964599.0,,,,,,4448525.0,4300567.0,,,,,-18310447.0,27919103.0,6026593.0,75237217.0,3897180.0,,-18310447.0,-2674598.0,84845873.0,6947179.0,,84845873.0,15880222.0,,4666819.0,995942.0,,84822937.0,88134307.0,84989133.0,15897602.0,,114923002.0,17911266.0,,318845166.0,15897602.0,15897602.0,6504928.0,6661412.0,14415490.0,474559.0,307384.0,781943.0,13633547.0,8930340.0,,6661412.0,,37801.0,21189.0,15917.0,8670.0,797320.0,407490.0,37801.0,15917.0,0.266032,4208316.0,652568.0,3354023.0,5357031.0,189490.0,189490.0,189487.0,7679115.0,2181970.0,2150177.0,2.0,2.0,1.0,554.04,610.28,2333.0,2333.0,5069.0,5069.0,119.0,127.0,180.0,119.0,43435.0,46355.0,43435.0,8670.0,9588.0,8670.0,16997.0,20386.0,16997.0,1761634.0,39850041.0,98379.0,,,,-6868337.0,-1568185.0,,1278888.0,,147958.0,593092.0,1468384.0,3566758.0,229594.0,3584086.0,6302300.0,203922164.0,3584086.0,3584086.0,1079243.0,1197306.0,69129.0,72904.0,1124402.0,1894830.0,5888.0,1773.0,69129.0,,58.0,58.0,47.0,788.0,28.0,10220.0,1773.0,198.0,1173.0,283.0,198.0,5888.0,27919103.0,1941904.0,2785580.0,496712.0,776864.0,895282.0,568862.0,328092.0,,27862876.0,2713183.0,25149693.0,41748663.0,27862876.0,2708335.0,25154541.0,41753511.0,7376493.0,,46078485.0,46078485.0,10176980.0,10158356.0,10667619.0,2332854.0,8345461.0,10645934.0,8345461.0,8341896.0,602640.0,391716.0,458663.0,8733612.0,8733648.0,8433387.0,,3060537.0,789017.0,1018803.0,1053547.0,,,,,,218294.0,,,,,49714.0,1068919.0,165782.0,27919103.0,1938512.0,,2810406.0,,494193.0,49473.0,780519.0,716616.0,581724.0,1050906.0,328092.0,167665.0,1268078.0,22.02,1267823.0,1146799.0,21.98,21.93,31.01,,,14152.0,,125588.0,,,,,433367.0,782300.0,32269.0,3145174.0,782300.0,1261130.0,1722.0,2003008.0,7969054.0,7489625.0,1992480.0,1960690.0,37772018.0,974.0,1722.0,4192.0,7285343.0,,,7285343.0,,,110139.0,25.52,7310466.0,7310466.0,360185.0,29.06,20.48,,32328.0,,,,,,,,,115630.0,,,,,38854.0,,9921.0,,16236.0,16236.0,93415.0,93415.0,93415.0,77179.0,16236.0,5540.0,1878.0,,691427.0,8577990.0,781026.0,182453.0,,691427.0,8577990.0,781026.0,182281.0,86849.0,,5962.62,192990.87,,20609.0,67325.0,51477.0,18560.0,13480.0,18440.0,8457.0,22.32,,115.96,44.45,,23.98,11.59,13.92,31.34,13.52,17.79,19.83,9288504.0,9288504.0,121024.0,199480.49,22.38,46.56,,,353166.0,80652.0,12302.0,,18624.0,105708.0,105708.0,,54561.0,,6315.0,,3565.0,18624.0,367749.0,97833.0,62654.0,408.0,,3968.0,25123.0,9023.0,218503.0,82817.0,25123.0,9023.0,,218503.0,82817.0,,1277.0,33580.0,414.0,,171.11,31.3,200.04,1346279.49,,,-36.0,,,,,,,31790.0,3.0,31793.0,276.0,,3.0,,,,,,,34744.0,565174.0,771279.0,48169.0,142248.0,-400009.0,-2781.0,612653.0,1769920.0,188757.0,1772701.0,2812630.0,118063.0,3775.0,1772701.0,1772701.0,1278660.0,676301.0,1954961.0,136148.0,11737.0,147885.0,1807076.0,755413.0,,118063.0,,2451834.0,2025165.0,,676301.0,,2666.0,1923.0,136148.0,174.0,136.0,1.0,195.0,9.0,3285.0,1923.0,10.0,2666.0,771279.0,188028.0,13685.0,13.74,,,,909594.0,,2422167.0,,208333.0,,2423983.0,,4605275.0,,2423983.0,1366975.0,564433.0,2680875.0,564433.0,,,2364.0,16.43,16.0,5840.0,2633.0,,4669.0,769823.0,4274.0,34175.0,11.58,22.53,,,,,,,,,,,,,,,,,,,,,,,,,,,,,,,,,,,,,,,,,,3061.0,874.0,93.0,249.0,19087.0,19087.0,527.0,36.22,,,,,,,,,,,,220024.0,1636152.0,435269.0,215245.0,,,,26590.0,26590.0,159.0,167.23,,,,,,,,,,,,,-1816.0,35179.0,,,,,,,,,,,,,,,,,21070.0,,,,,,,,,,,,10749306.0,807887.0,807887.0,,11557193.0,,,,,,,,,,,,,,,,,,,,,,,,,,,,,,,,,,,,,,,,,,,,,,,,,,,,,,,,,,,,,,,,,,,,,,,,,,,,,,,,,,,,,,,,,,,,,,,,,,,,,,,,,,,,,,,,,,,,,,,,,,,,,,,,155.0,105708.0,105708.0,157.0,105708.0,105708.0,,,,,,,,,,,,,,,,,,,,,,,,,,,,346.0,,93.0,,,,,,,,,,,,,,,,,,,,,,,,,,,,,,,,,,,,,,,,,,,,,,,,,,,,,,,,,,,,,,,,,,,,,,,,,,,,,,,,,,,,,,,,,,,,,,,,,,,,,,,,,,,,,,,,,,,,,,,,,,,,,,,,,,,,,,,,,,,,752250.0,150000.0,,,,,,,,,,,,,,,,,,,,,,,,,,,,,,,,,,,,,,,,,,,,,16.0,,,1003950.0,,,,,,,,,,,,,,,,,,,,,,,,,,,,,,,,,,,,,100 FAIRFIELD DRIVE,SENECA,16346,VENANGO,UPMC NORTHWEST HOSPITAL,99939,P,2,Y,N,N,N,Y,N,,N,N,,N,N,Y,N,Y,Y,,UPMC NORTHWEST-PSYCHIATRIC,39S091,HO0164,UPMC,600 GRANT STREET,PITTSBURGH,PA,15219,,Y,,,,,,UPMC NORTHWEST-REHAB UNIT,39T091,395966,,,,,,,,,,,,,,,,,,,,,,,,,,,,,,,,,,,,,,,,,,,,,,,,,,,,,,,,,,,,,,,,,,,,,,,,,,,,,,,,,,,,,,,,,,,,,,,,,,,,,,,,,,,,,,,,,,,,,,,,,,,,,,,,,,,,,,,,,,,,,,,,,2.0,,,,,,,,,,,,,,,,,,,,,,,,,2731514.0,1717011.0,2633932.0,1666635.0,-9873925.0,1068919.0,328092.0,165782.0,2785580.0,616416.0,,98.0,296748.0,776864.0,,836436.0,2912192.0,134693.0,12097.0,,391547.0,38069910.0,4430268.0,72673.0,154442.0,2587376.0,641175.0,4390141.0,,279330.0,1172347.0,178695.0,93083.0,51642.0,2033914.0,259810.0,,,376053.0,,-6897.0,,-12600415.0,2731514.0,1374181.0,1338660.0,455888.0,179762.0,1717011.0,6572360.0,18984366.0,2513955.0,372367.0,186919.0,3330709.0,860508.0,338889.0,495523.0,5215270.0,,,873853.0,1158697.0,495764.0,188607.0,343997.0,2577820.0,332638.0,798626.0,2019704.0,2608290.0,1156572.0,592725.0,2231039.0,5612964.0,683948.0,1654180.0,6873181.0,1674599.0,660394.0,877154.0,7853273.0,,,1401130.0,1605267.0,655451.0,248915.0,713928.0,487647.0,1053368.0,2661378.0,3486367.0,1077189.0,4502535.0,559469.0,32483.0,73716.0,988329.0,169449.0,13630.0,22457.0,201869.0,,,83670.0,27199.0,4397.0,1138.0,84316.0,9473.0,4251.0,10621.0,16222.0,46198.0,253812.0,5668931.0,683948.0,1654180.0,6886704.0,1674599.0,660394.0,877154.0,7854396.0,,,1401130.0,1605267.0,655451.0,248915.0,713928.0,492477.0,1053368.0,2661378.0,3486367.0,1077189.0,4553983.0,5398770.0,740014.0,1305374.0,4043372.0,360277.0,4944781.0,1568907.0,12376071.0,,,3706575.0,3242626.0,1653264.0,603294.0,2920447.0,172356.0,1319530.0,6570965.0,18975091.0,38403.0,4091345.0,1755324.0,256239.0,432796.0,2007767.0,165942.0,2623067.0,722622.0,5542871.0,,,1783456.0,684383.0,230652.0,213033.0,1753819.0,87875.0,527294.0,2667792.0,8133291.0,30862.0,2096002.0,534447.0,80307.0,191594.0,613803.0,34093.0,87983.0,31699.0,938142.0,,,548955.0,237679.0,78587.0,62664.0,102548.0,26367.0,152876.0,868604.0,941347.0,9135.0,491447.0,1755324.0,256239.0,432796.0,2007767.0,165942.0,2623067.0,722622.0,5542871.0,,,1783456.0,684383.0,230652.0,213033.0,1753819.0,87875.0,527294.0,2667792.0,8133291.0,30862.0,2096002.0,,,,895282.0,568862.0,,,496712.0,281803.0,159943.0,,,367739.0,331522.0,,-306258.0,,,57439.0,691323.0,,,417212.0,22936.0,,8604.0,,3600851.0,,233462.0,,,,1265730.0,,404979.0,,,,,,,2178346.0,,2178346.0,,252122.0,,,2148976.0,,1753482.0,49714.0,-3063.0,,,-3202.0,,,1651570.0,1651570.0,488852.0,,,,,,,,1125261.0,1062.0,76.0,-50344.0,,,,,337872.0,710459.0,28944.0,710459.0,1832599.0,13220127.0,12373.0,18953182.0,34030490.0,2313715.0,11147402.0,2647774.0,2647774.0,798214.0,,,189954.0,208613.0,41194.0,17714.0,7356.0,,-795.0,845445.0,9289604.0,4568640.0,3831708.0,214028.0,2558178.0,4568640.0,3831708.0,214028.0,2558178.0,1309479.0,648432.0,65879.0,149579.0,21321.0,11007.0,706148.0,8058501.0,-1180824.0,7924097.0,10972522.0,94498.0,10972522.0,76261.0,39369.0,182453.0,859570.0,234004.0,-659074.0,-239000.0,350.0,1068608.0,2268335.0,121791.0,2268335.0,3304410.0,1379649.0,1249150.0,1794480.0,1667.0,918.0,67069.0,,,,,8.0,2920.0,918.0,1667.0,,,,310959.0,41580.0,,191626.0,258501.0,,111427.0,93261.0,1673027.0,,,,,,10199.0,1284279.0,,,,-33412.0,-692815.0,,27078.0,,,,,,,,,,,,,,,,,,,,,,,1442285.0,2431300.0,,14743554.0,18049484.0,,,1468959.0,1603079.0,15331199.0,,,17625.0,,,6787.0,,,,,,,,,17625.0,,,,277123.0,,455095.0,,3655172.0,4516035.0,,,24252.0,331293.0,496845.0,416077.0,2583841.0,,,277123.0,,455095.0,,3655172.0,4516035.0,,,24252.0,331293.0,496845.0,416077.0,2583841.0,108.0,,,54561.0,86852.0,,201465.0,,122602.0,203146.0,,,8422.0,98430.0,144048.0,135470.0,598986.0,12.0,,,6315.0,,,,,,,,1.0,,,,,,,707517.0,270468.0,242925.0,36617650.0,446515.0,208408.0,446515.0,11379282.0,11379282.0,3349553.0,,,,675396.0,894908.0,5371.0,894908.0,1830868.0,950303.0,969341.0,311909.0,969341.0,357507.0,357507.0,,115036.0,,,,,,-25077.0,,,,,9554.0,,183815.0,33967.0,24356.0,4658.0,2975.0,9870.0,,,322929.0,84679.0,,,,3363.0,,31111.0,10455.0,8459.0,1587.0,875.0,577.0,,,37376.0,19855.0,9568.0,1714.0,1850.0,26426.0,,189988.0,84444.0,902027.0,452298.0,140685.0,7715.0,1363.0,9473.0,500527.0,,2913.0,537.0,819.0,7807.0,,32156.0,25992.0,313264.0,154106.0,41382.0,451.0,395.0,3084.0,57931.0,,10657.0,10657.0,3631.0,,,,,,,,,,,,65515.0,294862.0,388861.0,323686.0,35546.0,6494.0,1102646.0,20198.0,49899.0,135047.0,110286.0,10456.0,1883.0,127620.0,,,,,97842.0,,378298.0,659658.0,12558.0,,159244.0,,-81426.0,,-163240.0,,,,824478.0,,,,,1772478.0,,135865.0,,1772478.0,,291383.0,7790561.0,2756743.0,165851.0,96442.0,46243.0,26762.0,,1551.0,1172.0,,,34102.0,15090.0,2566.0,1445.0,3936.0,,1144.0,661.0,770.0,840.0,923.0,,,165851.0,2327572.0,487476.0,2327572.0,487476.0,,,478202.0,283466.0,,,,,,,10978.0,1858.0,,,,,,,,,,,25950.0,21050.0,8350.0,1231.0,,,,,,,,,,,,,,,,,,,27768.0,,,,,,8051.0,,,,,,,,,,,,242505.0,,3114.0,74644.0,,722.0,,,,,,,,,,,,,,,,,,,,,,-517745.0,,,,,,,,,,,,,,,,,,,,,,,,,,,,,,,,,,,,,,,,,,,,,,,,,,,,,,,,,,,,,,,,,5411.0,16.0,6830.0,45.0,,,,,,,,,,,8725.0,228.0,9518.0,153.0,,,,,,,,,,52854.0,796.0,51262.0,796.0,,,,,,,,,,,,,,,,,,,,,,,,,,6.0,,,,,,,,,,,,,,,,,,,,,,,,,,,,,,,,,,,,,,,,,,,,,,,,,,,,,,,,,,,,,,,,,,,,,,,,,,,,,,,,,,,,,,,,,,,,,,5605.0,,1682.0,,,35608.0,,,21148.0,,,,14023.0,,,,,,,14023.0,4125.0,,,,,,,,,,,,,,,,33.0,120.0,2.0,67.0,89.0,1.0,,,,,6.0,,,,,,,,,,,,,183.0,,,,,,,,,,,,,3311.0,16843.0,,984.0,4991.0,,,13072.0,3941.0,,,,,1600.0,708.0,,,,,,40419.0,60155.0,31395.0,8304.0,2018.0,1386.0,,,,,,,,,,,,,,,,,,,,,,,,,,,,,,,,,,,,,,,,,,,,,,,,,,,,,,,,,,,,,,,,,,,,,,,31009.0,9978.0,,,,,,,,,,,,,,,,,,,,,,,,,,,,,,,,1770.0,2081.0,555.0,1210.0,,,,,,,,,,,,,,,,,,,,,,,,,,,,,,,,,,,,,,,,,,,,,,,,,,,,,,,,,,,,,,,,,,,,,,,,,,,,,,,,,,,,,157.0,,,,,,,,,,,,,,,,,,,,,,,,,,,,,,,,,,,,4.0,,,,,,,,,,,,,,,,,,,,,,,,,,,,,,,,,,,,,,,,,,,,,,,,,,,,,,,,,,,,,,,,,,,,,,,,,,,,,,,,,,,,,,,,,,,,,,,,,,,,,,,,,,,,,,,,,,,,,,,,,,,,,,,,,,,,,,,,,,,,,,,,,,,,,,,2014,PA,,,,,,,,,,,,,,UPMC NORTHWEST HOSPITAL (390091)
32898,UPMC NORTHWEST HOSPITAL (390091),Acute Care Hospitals,Voluntary non-profit - Other,-79.707926,41.360026,713188,390091,12001,4,2022-03-03 00:00:00,2015-07-01 00:00:00,2016-06-30,F,J,39,39730,2.0,3.0,,,,,,,,,,,,,,,,,,,,,,,,,,,,,,,,,,,,,,,,,,168765.0,,,3.0,,1098.0,,,,,,,,,,,,,,,,,,,,,,,,,,,,,,,,,,,,,,,,,,,,,,,,,,,,,,,,,,,,,,,105683858.0,,24817356.0,24348989.0,105459385.0,817893.0,3151.0,406778.0,1090028.0,,,,,,4022081.0,3981302.0,,,,,-19145366.0,29404410.0,7550605.0,70638107.0,2310445.0,,-19145366.0,-1152578.0,80897151.0,8547885.0,,80897151.0,16443689.0,,4207822.0,850198.0,,80876891.0,83800452.0,81042832.0,16465373.0,,116533692.0,19074488.0,,331462597.0,16465373.0,16465373.0,6886588.0,6153446.0,14137761.0,418021.0,277992.0,696013.0,13441748.0,9376248.0,,6153446.0,,35232.0,19859.0,14467.0,8306.0,679322.0,355580.0,35232.0,14467.0,0.244,4026542.0,635354.0,3015738.0,4708173.0,146406.0,146406.0,146171.0,7601686.0,1965494.0,1929652.0,2.0,2.0,1.0,569.43,623.77,2278.0,2278.0,5007.0,5007.0,110.0,118.0,171.0,110.0,40027.0,42955.0,40027.0,8306.0,9142.0,8306.0,16533.0,20023.0,16533.0,1761634.0,39913676.0,18205.0,,,,-5844758.0,-2033496.0,,1307796.0,,40779.0,631162.0,1495910.0,3123606.0,202327.0,3123606.0,5487920.0,214928905.0,3123606.0,3123606.0,698531.0,771944.0,45245.0,47557.0,724387.0,1221095.0,4816.0,1077.0,45245.0,,72.0,72.0,42.0,681.0,28.0,10248.0,1077.0,190.0,1381.0,247.0,190.0,4816.0,29404410.0,1963089.0,2529453.0,495030.0,747631.0,888419.0,533496.0,335124.0,,29377835.0,2732197.0,26645638.0,41697308.0,29378179.0,2750864.0,26627315.0,41678985.0,6816855.0,,47379426.0,47379426.0,9723409.0,9703116.0,10277130.0,2189123.0,8099248.0,10255136.0,8099248.0,8097880.0,523610.0,340347.0,387043.0,8438227.0,8438261.0,7915856.0,,3060537.0,2715252.0,2715252.0,2715252.0,,,,,,185741.0,,,,,-344.0,1061830.0,157062.0,29404754.0,1970934.0,,2356021.0,,499966.0,,755795.0,457842.0,541884.0,1064611.0,335124.0,157965.0,1304339.0,22.54,1304221.0,1186482.0,22.53,22.44,30.65,,,13155.0,,353640.0,,,,,224838.0,418991.0,22256.0,2757620.0,418991.0,1560589.0,1981.0,1692435.0,9285678.0,7455280.0,1819088.0,1783481.0,46069905.0,1160.0,1981.0,3326.0,7221524.0,,,7221524.0,,,94030.0,25.06,7252335.0,7252335.0,334705.0,27.24,20.37,,29922.0,,,,,,,,,10857.0,,,,,43569.0,,10226.0,,19623.0,19623.0,120979.0,120979.0,120979.0,101356.0,19623.0,8382.0,2065.0,11363.0,751743.0,6947829.0,735267.0,191728.0,11363.0,751743.0,6947829.0,735267.0,189160.0,84397.0,450.0,4551.0,165715.0,,20686.0,64267.0,32273.0,17221.0,13877.0,19901.0,8160.0,23.35,25.25,165.18,41.93,,24.17,11.76,14.19,31.47,13.63,16.84,19.36,7799335.0,7799335.0,117739.0,173156.0,23.36,45.04,,,173830.0,76101.0,15150.0,,20293.0,123782.0,123782.0,,77410.0,,9397.0,,1368.0,20293.0,456655.0,111424.0,72408.0,582.0,,3761.0,30811.0,4391.0,266770.0,44080.0,30811.0,4391.0,,266770.0,44080.0,,2018.0,32356.0,235.0,,132.2,32.9,187.57,1359638.0,31138.0,,-34.0,,,,,,,35607.0,235.0,35842.0,286.0,,,,,,,,,,553838.0,769108.0,49026.0,150925.0,-445601.0,-7000.0,599521.0,1521671.0,165710.0,1521671.0,2830992.0,73413.0,2312.0,1521671.0,1521671.0,1083433.0,570914.0,1654347.0,117978.0,10181.0,128159.0,1526188.0,491043.0,,73413.0,,2441164.0,1989635.0,,570914.0,,2500.0,1780.0,117978.0,133.0,134.0,3.0,199.0,9.0,3294.0,1780.0,23.0,2500.0,769108.0,440982.0,31817.0,13.86,,,,630161.0,,1765828.0,,181477.0,,1765828.0,,4848549.0,,1765828.0,954252.0,469774.0,2396620.0,469774.0,0.843,8179727.0,2578.0,15.94,16.0,5856.0,2468.0,,4567.0,779930.0,,33342.0,,23.39,,,,,,,,,,,,,,,,,,,,,,,,,,,,,,,,,,,,,,,,,,1701.0,842.0,134.0,291.0,88400.0,88400.0,2440.0,36.23,,,,,,,,,,,,3638.0,34119.0,8325.0,4687.0,,,,17505.0,17505.0,117.0,149.62,,,,,,,,,,,,,-300000.0,39016.0,,,,,,,,,,,,,,,,,14952.0,,,,,,,,,,,,11557193.0,630756.0,630756.0,,12187949.0,,,,,,,,,,,,,,,,,,,,,,,,,,,,,,,,,,,,,,,,,,,,,,,,,,,,,,,,,,,,,,,,,,,,,,,,,,,,,,,,,,,,,,,,,,,,,,,,,,,,,,,,,,,,,,,,,,,,,,,,,,,,,,,,98.0,123782.0,123782.0,267.0,123782.0,123782.0,,,,,,,,,,,,,,,,,,,,,,,,,,,,400.0,,134.0,,,,,,,,,,,,,,,,,,,,,,,,,,,,,,,,,,,,,,,,,,,,,,,,,,,,,,,,,,,,,,,,,,,,,,,,,,,,,,,,,,,,,,,,,,,,,,,,,,,,,,,,,,,,,,,,,,,,,,,,,,,,,,,,,,,,,,,,,,,,704804.0,28770.0,,,,,,,,,,,,,,,,,,,,,,,,,,,,,,,,,,,,,,,,,,,,,6.0,,,977465.0,,,,,,,,,,,,,,,,,,,,,,,,,,,,,,,,,,,,,100 FAIRFIELD DRIVE,SENECA,16346,VENANGO,UPMC NORTHWEST HOSPITAL,99939,P,2,Y,N,N,N,Y,N,,N,N,,N,N,Y,N,Y,Y,,UPMC NORTHWEST-PSYCHIATRIC,39S091,HO0164,UPMC,200 LOTHROP STREET,PITTSBURGH,PA,15213,,Y,,,,,,UPMC NORTHWEST-REHAB UNIT,39T091,395966,,,,,,,,,,,,,,,,,,,,,,,,,,,,,,,,,,,,,,,,,,,,,,,,,,,,,,,,,,,,,,,,,,,,,,,,,,,,,,,,,,,,,,,,,,,,,,,,,,,,,,,,,,,,,,,,,,,,,,,,,,,,,,,,,,,,,,,,,,,,,,,,,1.0,,,,,,,,,,,,,,,,,,,,,,,,,2446822.0,1575259.0,2419486.0,1561816.0,-11247502.0,1061830.0,335124.0,157062.0,2529453.0,618877.0,,,291731.0,747631.0,,779714.0,3275311.0,132364.0,14784.0,,295469.0,34905397.0,4034682.0,77539.0,149735.0,2403524.0,578411.0,4586886.0,,260557.0,1071160.0,230559.0,95143.0,57515.0,2117003.0,248562.0,,,376529.0,,-5146.0,,-14657892.0,2446822.0,848476.0,1318233.0,462342.0,172749.0,1575259.0,6322661.0,13224341.0,2715009.0,397315.0,211354.0,3258342.0,876909.0,345909.0,506255.0,5654792.0,,,851280.0,1042373.0,505541.0,190392.0,347939.0,2640088.0,302582.0,603063.0,2130218.0,3009897.0,1132228.0,1082617.0,2467409.0,5719056.0,692385.0,1404614.0,6180149.0,1572318.0,629406.0,804643.0,7805390.0,,,1275329.0,1344491.0,617405.0,232803.0,654276.0,421679.0,737150.0,2594767.0,3709619.0,1723696.0,4464556.0,587007.0,28883.0,79792.0,842655.0,141311.0,12010.0,21013.0,202139.0,,,59644.0,23384.0,3672.0,1214.0,50103.0,13661.0,3329.0,11350.0,17990.0,73315.0,223460.0,5719056.0,692385.0,1404614.0,6264851.0,1572318.0,629406.0,804643.0,7864945.0,,,1275329.0,1344491.0,617405.0,232803.0,654276.0,421679.0,737150.0,2594767.0,3709619.0,1723696.0,4464556.0,5130758.0,765238.0,1237062.0,3892248.0,321384.0,5498904.0,1812927.0,13027391.0,,,3748836.0,3275140.0,1711526.0,734551.0,3132045.0,164158.0,1076596.0,6029497.0,19473737.0,25368.0,4078582.0,1593444.0,253544.0,382789.0,2094453.0,87385.0,2840926.0,947039.0,5847506.0,,,1793236.0,714323.0,261691.0,268885.0,1785470.0,93097.0,377805.0,2395186.0,8634495.0,13300.0,2093694.0,471855.0,76666.0,137146.0,609277.0,15584.0,82168.0,36848.0,925304.0,,,495401.0,208673.0,78207.0,62051.0,93700.0,23864.0,82558.0,794768.0,1047476.0,5765.0,461881.0,1593444.0,253544.0,382789.0,2094453.0,87385.0,2840926.0,947039.0,5847506.0,,,1793236.0,714323.0,261691.0,268885.0,1785470.0,93097.0,377805.0,2395186.0,8634495.0,13300.0,2093694.0,,,,888419.0,533496.0,,,495030.0,404348.0,205756.0,,,363991.0,685412.0,,-300098.0,,,527908.0,675174.0,,,363647.0,20260.0,,7692.0,,3951507.0,,237399.0,,,,707276.0,,416961.0,,,,,,,1937618.0,,1937618.0,,235058.0,,,2198414.0,,1691999.0,-344.0,-27739.0,,,-2056.0,,,1381402.0,1381402.0,598741.0,,,,,,,,1182541.0,,,-72466.0,,,,-96.0,275583.0,500789.0,25527.0,500789.0,2013912.0,14182345.0,8192.0,19426055.0,36675454.0,2296793.0,11105074.0,2802106.0,2802106.0,829768.0,,,248356.0,205621.0,24661.0,12025.0,4140.0,,,867556.0,9335450.0,4570572.0,3756712.0,210487.0,2488069.0,4570572.0,3756712.0,210487.0,2488069.0,1155081.0,589958.0,58149.0,130571.0,20058.0,9864.0,696876.0,8204058.0,-1163123.0,8123760.0,10339137.0,105576.0,10339137.0,7278.0,3579.0,191728.0,839868.0,206019.0,-239405.0,-154312.0,,1033279.0,1981425.0,112700.0,1981425.0,3014638.0,1327284.0,1097727.0,1657236.0,1509.0,836.0,62441.0,,,,,8.0,2928.0,836.0,1509.0,,,,322465.0,61391.0,,189824.0,274607.0,,115607.0,77912.0,1957345.0,,,,,,9211.0,1171297.0,,,,-36000.0,-646723.0,,35417.0,,,,,,,,,,,,,,,,,,,,,,,1524552.0,2683377.0,,16262817.0,18735661.0,,,1480887.0,1790323.0,16159143.0,,,18591.0,,,4604.0,,,,,,,,,18591.0,,,,274868.0,,468665.0,,3727691.0,4307248.0,,,5167.0,286791.0,536811.0,412850.0,2645667.0,,,274868.0,,468665.0,,3727691.0,4307248.0,,,5167.0,286791.0,536811.0,412850.0,2645667.0,,,,77390.0,83114.0,,167913.0,,107816.0,169023.0,,,1509.0,73514.0,117303.0,136991.0,583650.0,,,,9388.0,,,,,,,,31.0,,,,,,,534965.0,354396.0,274246.0,39076675.0,385389.0,154064.0,385389.0,13626225.0,13626225.0,3553372.0,,,,481681.0,595959.0,4300.0,595959.0,1606561.0,1057118.0,842838.0,188572.0,842838.0,340152.0,340152.0,,76104.0,,,,,,-10417.0,,2259.0,615.0,308.0,9624.0,,119102.0,13343.0,8493.0,2813.0,1686.0,9534.0,,,204546.0,70372.0,669.0,186.0,110.0,2590.0,,18847.0,3686.0,2481.0,841.0,389.0,500.0,,,24814.0,15524.0,8858.0,1936.0,3294.0,27684.0,,181444.0,77201.0,910096.0,446408.0,152525.0,22333.0,4299.0,,465210.0,,2623.0,585.0,1180.0,7942.0,,28712.0,21328.0,265864.0,133410.0,35199.0,1172.0,939.0,,56436.0,,14533.0,14533.0,4343.0,,,,,,,,,,,,83714.0,301437.0,366769.0,308617.0,33622.0,5720.0,939315.0,23375.0,47338.0,107143.0,92231.0,7759.0,1250.0,113951.0,,,,,101455.0,,397910.0,686634.0,13112.0,,138593.0,,-80785.0,,-97838.0,,-80.0,,823031.0,,,,,1602064.0,,120972.0,,1602064.0,,379144.0,8495289.0,3253121.0,205509.0,90643.0,23586.0,20438.0,192.0,682.0,795.0,83.0,2152.0,62635.0,39172.0,2231.0,8326.0,10407.0,384.0,1812.0,1523.0,572.0,3672.0,2296.0,,,205509.0,2428431.0,398206.0,2428431.0,398206.0,,,433074.0,175635.0,,,,,,,1657.0,260.0,,,,,,,,,,,16923.0,18684.0,3786.0,981.0,,,,,,,,,,,,,,,10416.0,,,,31496.0,,3084.0,,,,6882.0,,,,,,,,,,,,239496.0,,4445.0,66163.0,,981.0,,,,,,,,,,,,,,,,,,,,,,-494113.0,,,,,,,,,,,,,,,,,,,,,,,,,,,,,,,,,,,,,,,,,,,,,,,,,,,,,,,,,,,,,,,,,7253.0,10.0,7818.0,69.0,,,,,,,,,,,9582.0,277.0,10259.0,175.0,,,,,,,,,,61890.0,1003.0,59886.0,1003.0,,,,,,,,,,,,,,,,,,,,,,,,,,41.0,,,,,,,,,,,,,,,,,,,,,,,,,,,,,,,,,,,,,262.0,,,,,224.0,,,,,,20.0,,,,,,9.0,,,,,,,,,,,,,,,,,,,,,,,,,,,,,,,,,,,,,,,,3870.0,,992.0,,,6782.0,,,3437.0,,,,20251.0,,,,,,,20251.0,4673.0,,,,,,,,,,,,,,,,31.0,65.0,2.0,92.0,172.0,3.0,,,,,,,,,,,,31.0,10.0,,,,,248.0,,,,,,,,,,,,,2185.0,,,560.0,,,,3596.0,1065.0,,,,,,,,,,,,6606.0,54453.0,11007.0,1178.0,1575.0,428.0,,,,,,,,,,,,,,,,,,,,,,,,,,,,,,,,,,,,,,,,,,,,,,,,,,,,,,,,,,,,,,,,,,,,,,,8171.0,1828.0,,,,,,,,,,,,,,,,,,,,,,,,,,,,,,,,,,,,,,,,,,,,,,,,,,,,,,,,,,,,,,,,,,,,,,,,,,,,,,,,,,,,,,,,,,,,,,,,,,,,,,,,,,,,,,,,,,,,,,,,150.0,,,,,,,,,,,,,,,,,,,,,,,,,,,,,,,,,,,,1.0,,,,,,,,,,,,,,,,,,,,,,,,,,,,,,,,,,,,,,,,,,,,,,,,,,,,,,,,,,,,,,,,,,,,,,,,,,,,,,,,,,,,,,,,,,,,,,,,,,,,,,,,,,,,,,,,,,,,,,,,,,,,,,,,,,,,,,,,,,,,,,,,,,,,,,,2015,PA,,N,N,14065875.0,21572.0,-57995.0,16099526.0,,16071995.0,16035572.0,160356.0,15875216.0,160995.26,UPMC NORTHWEST HOSPITAL (390091)
39003,UPMC NORTHWEST HOSPITAL (390091),Acute Care Hospitals,Voluntary non-profit - Other,-79.707926,41.360026,713189,390091,12001,4,2022-03-03 00:00:00,2016-07-01 00:00:00,2017-06-30,F,L,39,39730,2.0,3.0,,,,,,,,,,,,,,,,,,,,,,,,,,,,,,,,,,,,,,,,,,172303.0,,,3.0,,1095.0,,,,,,5913532.0,1171539.0,1775696.0,296277.0,,,,,,,,,,5913532.0,1171539.0,,,1775696.0,296277.0,,,31.2,42.24,,,,,,,,,,,,,,,,,,,,,,,,,,,,,,,,,,,103786497.0,,24820507.0,22040515.0,103834160.0,8072860.0,71140.0,7851706.0,8657844.0,,,,,,4009338.0,3969131.0,,,,,-19066979.0,28397211.0,6832321.0,77406335.0,5059658.0,,-19066979.0,-3549600.0,86736567.0,7348322.0,,86736567.0,15111333.0,,4176326.0,839841.0,,86710417.0,89081401.0,86902902.0,15118381.0,,127837969.0,20062987.0,,355411074.0,15118381.0,15118381.0,6066925.0,6189396.0,13388253.0,403165.0,273528.0,676693.0,12711560.0,9063037.0,,6189396.0,,35248.0,19133.0,13916.0,7678.0,624220.0,336987.0,35248.0,13916.0,0.243972,4757413.0,530833.0,3502207.0,6248444.0,126173.0,126173.0,126030.0,8957058.0,2280662.0,2254942.0,2.0,2.0,1.0,518.24,584.06,2199.0,2199.0,4976.0,4976.0,110.0,118.0,171.0,110.0,35952.0,38872.0,35952.0,7678.0,8492.0,7678.0,16376.0,19623.0,16376.0,1761634.0,39931880.0,734998.0,,,,-8564126.0,-1117427.0,,1701904.0,,40207.0,671137.0,2332293.0,4562521.0,219942.0,4592851.0,9768392.0,227573105.0,4592851.0,4592851.0,1075053.0,1164136.0,51481.0,53455.0,1110681.0,2259695.0,5823.0,1363.0,51481.0,,56.0,56.0,24.0,355.0,28.0,10220.0,1363.0,181.0,1237.0,148.0,181.0,5823.0,28397211.0,2353965.0,1832771.0,450709.0,829840.0,907605.0,496067.0,343493.0,,28308551.0,3174708.0,25133843.0,42587707.0,28139943.0,3201196.0,24938747.0,42392611.0,6156792.0,,49577746.0,49577746.0,10197870.0,10172650.0,10446374.0,2126014.0,8330194.0,10409010.0,8330194.0,8328693.0,440722.0,286469.0,351072.0,8615162.0,8615154.0,8133482.0,,3091675.0,472080.0,165912.0,472080.0,,,,,,166988.0,,,,,,1011922.0,157714.0,28228603.0,2372425.0,,1719432.0,,453653.0,,833295.0,485585.0,511913.0,1019709.0,343493.0,158388.0,1219489.0,23.15,1218976.0,1077529.0,23.08,23.14,32.56,,,13353.0,,309369.0,,,,,445782.0,771092.0,25013.0,2178499.0,771092.0,1463530.0,1754.0,2746237.0,10229250.0,8830885.0,2154489.0,2128912.0,55248875.0,1046.0,1754.0,2757.0,7338178.0,,,7338178.0,,,42556.0,40.4,9441942.0,9441942.0,282234.0,37.86,21.81,,27298.0,,,,,,,,,12909.0,,,,,38577.0,,10354.0,,17515.0,17515.0,97293.0,97293.0,97293.0,79778.0,17515.0,7681.0,2046.0,168608.0,758243.0,,958141.0,193014.0,168608.0,758243.0,,958141.0,192798.0,106767.0,2649.0,4572.0,,,19113.0,69147.0,33030.0,15807.0,13534.0,19973.0,7852.0,22.22,63.65,165.84,,,23.74,12.05,14.7,32.39,14.25,17.2,20.17,8011922.0,8011922.0,141447.0,224517.0,22.63,35.69,,,,,19004.0,,25220.0,153369.0,153369.0,,58716.0,,7161.0,,1501.0,25220.0,514012.0,125405.0,91310.0,468.0,,4330.0,31791.0,12167.0,247833.0,99400.0,31791.0,12167.0,,247833.0,99400.0,,1613.0,31395.0,571.0,,153.65,32.48,174.08,1302046.0,,,8.0,,,,,,,25577.0,143.0,25720.0,252.0,,1.0,,,,,,,,545691.0,820743.0,48664.0,148173.0,-54092.0,,599738.0,1517540.0,132576.0,1517540.0,2908583.0,89083.0,1974.0,1517540.0,1517540.0,1010453.0,630784.0,1641237.0,88275.0,24885.0,113160.0,1528077.0,653106.0,,89083.0,,2324161.0,1930475.0,,630784.0,,2451.0,1632.0,88275.0,78.0,128.0,2.0,201.0,9.0,3285.0,1632.0,43.0,2451.0,820743.0,427786.0,29769.0,14.37,,,,975773.0,,2263347.0,,153781.0,,2263347.0,,5189454.0,,2263347.0,1196695.0,541467.0,2551529.0,541467.0,0.843,8575544.0,2562.0,16.63,16.0,5840.0,2429.0,,4594.0,828771.0,,34680.0,,23.9,,,,,,,,,,,,,,,,,,,,,,,,,,,,,,,,,,,,,,,,,,12144.0,,112.0,220.0,,,,,,,,,,,,,,,,706.0,6368.0,1554.0,848.0,,,,10740.0,10740.0,58.0,185.17,,,,,,,,,,,,,,34095.0,,,,,,,,,,,,,,,,,2178.0,,,,,,,,,,,,12187949.0,,,306168.0,11881781.0,,,,,,,,,,,,,,,,,,,,,,,,,,,,,,,,,,,,,,,,,,,,,,,,,,,,,,,,,,,,,,,,,,,,,,,,,,,,,,,,,,,,,,,,,,,,,,,,,,,,,,,,,,,13005.0,,,,,,,,,,,,,,,,,,,,,111.0,153369.0,153369.0,233.0,153369.0,153369.0,,,,,,,,,,,,,,,,,,,,,,,,,,,,397.0,,112.0,,,,,,,,,,,,,,,,,,,,,,,,,,,,,,,,,,,,,,,,,,,,,,,,,,,,,,,,,,,,,,,,,,,,,,,,,,,,,,,,,,,,,,,,,,,,,,,,,,,,,,,,,,,,,,,,,,,,,,,,,,,,,,,,,,,,,,,,,,,,719698.0,400000.0,,,,,,,,,,,,,,,,,,,,,,,,,,,,,,,,,,,,,,,,,,,,,1.0,,,816666.0,,,,,,,,,,,,,,,,,,,,,,,,,,,,,,,,,,,,,100 FAIRFIELD DRIVE,SENECA,16346,VENANGO,UPMC NORTHWEST HOSPITAL,99939,P,2,Y,N,N,N,Y,N,,N,N,,N,N,Y,N,Y,Y,,UPMC NORTHWEST-PSYCHIATRIC,39S091,HO0164,UPMC,200 LOTHROP STREET,PITTSBURGH,PA,15213,,Y,,,,,,UPMC NORTHWEST-REHAB UNIT,39T091,395966,,,,,,,,,,,,,,,,,,,,,,,,,,,,,,,,,,,,,,,,,,,,,,,,,,,,,,,,,,,,,,,,,,,,,,,,,,,,,,,,,,,,,,,,,,,,,,,,,,,,,,,,,,,,,,,,,,,,,,,,,,,,,,,,,,,,,,,,,,,,,,,,,1.0,,,,,,,,,,,,,,,,,,,,,,,,,2430815.0,1578523.0,2405542.0,1563589.0,-9364308.0,1011922.0,343493.0,157714.0,1832771.0,623536.0,,,326834.0,829840.0,,783910.0,3400781.0,127098.0,12614.0,,354827.0,36790208.0,3891711.0,79909.0,164567.0,2301862.0,358437.0,5331001.0,,186573.0,856507.0,255901.0,110478.0,140047.0,2097174.0,258364.0,,,405892.0,-43.0,-3317.0,,-14823427.0,2430815.0,899423.0,1293145.0,467274.0,171002.0,1578523.0,8436148.0,14338062.0,2630834.0,383462.0,228010.0,3404945.0,813801.0,397852.0,489635.0,6761227.0,,,785777.0,968931.0,451056.0,179770.0,466793.0,2575155.0,317193.0,850502.0,2029496.0,3116108.0,1239129.0,560983.0,2191460.0,5876747.0,680434.0,1861112.0,6401759.0,1614192.0,750995.0,806055.0,9497467.0,,,1266087.0,1442348.0,551955.0,220209.0,858438.0,447913.0,1039955.0,2478503.0,3849610.0,1011010.0,4210321.0,645726.0,24746.0,131693.0,588038.0,143018.0,13468.0,21468.0,254828.0,,,52284.0,80500.0,2903.0,985.0,73373.0,7629.0,4582.0,10808.0,18413.0,73953.0,233682.0,5876747.0,680434.0,1861112.0,6497311.0,1614192.0,750995.0,806055.0,9557022.0,,,1266087.0,1442348.0,551955.0,220209.0,858438.0,447913.0,1039955.0,2478503.0,3849610.0,1011010.0,4210321.0,5275181.0,757071.0,1247092.0,4289245.0,202404.0,5905675.0,1918023.0,15277671.0,,,4008591.0,3443275.0,1863958.0,869338.0,3408276.0,198454.0,1175699.0,6075502.0,20544628.0,26163.0,4269266.0,1579311.0,246371.0,399497.0,2202047.0,31216.0,3038660.0,858823.0,6711043.0,,,1825105.0,712982.0,302914.0,339116.0,1793787.0,85180.0,436331.0,2322809.0,8321983.0,10440.0,2133432.0,479836.0,79189.0,183398.0,609969.0,7397.0,102296.0,31740.0,1134019.0,,,479820.0,282034.0,84795.0,75588.0,112926.0,21652.0,117968.0,736591.0,1015007.0,2954.0,406954.0,1579311.0,246371.0,399497.0,2202047.0,31216.0,3038660.0,858823.0,6711043.0,,,1825105.0,712982.0,302914.0,339116.0,1793787.0,85180.0,436331.0,2322809.0,8321983.0,10440.0,2133432.0,,,,907605.0,496067.0,,,450709.0,348324.0,193389.0,,,353877.0,214464.0,,-314852.0,,,482418.0,709052.0,,,353877.0,26150.0,,7698.0,,3547150.0,,302016.0,,,,2774628.0,,471941.0,,,,,,,1687468.0,,1687468.0,,205815.0,,,2284087.0,,1833717.0,,-21588.0,,,-588.0,,,991271.0,991271.0,280464.0,,,,,,,,1265222.0,,,3750.0,,,,-58.0,593670.0,1045350.0,44358.0,1045350.0,2145028.0,14067275.0,16022.0,21014783.0,41280224.0,2670809.0,11017991.0,2928241.0,2928241.0,889676.0,,,195371.0,186980.0,21207.0,10691.0,3522.0,,,807255.0,10227713.0,4560160.0,4434719.0,171591.0,2630608.0,4560160.0,4434719.0,171591.0,2630608.0,1120121.0,744700.0,45111.0,165607.0,17159.0,10139.0,779899.0,10062888.0,-938476.0,9864658.0,12540089.0,116308.0,12540089.0,8114.0,4795.0,193014.0,879916.0,188109.0,-53752.0,-254676.0,,1059805.0,2076138.0,121374.0,2076138.0,3168076.0,202973.0,1131932.0,1712959.0,1493.0,814.0,66178.0,,,,,8.0,2920.0,814.0,1493.0,,,,306525.0,64179.0,,203526.0,282788.0,,91895.0,82334.0,1667686.0,,,,,,13968.0,1671656.0,,,,-36000.0,-1146369.0,,42954.0,,,,,,,,,,,,,,,,,,,,,,,1359871.0,2806977.0,,16402252.0,19359942.0,,,1563675.0,1740354.0,17803081.0,,,6551.0,,,3169.0,,,,,,,,,6551.0,,,,247072.0,,494395.0,,3832735.0,4501480.0,,,8962.0,297575.0,619401.0,383295.0,2877295.0,,,247072.0,,494395.0,,3832735.0,4501480.0,,,8962.0,297575.0,619401.0,383295.0,2877295.0,510.0,,,58716.0,79415.0,,226963.0,,129029.0,171441.0,,,3545.0,75640.0,167463.0,121547.0,548847.0,62.0,,,7161.0,,,,,,,,10.0,,,,,,,598376.0,107790.0,118602.0,46232831.0,421644.0,79051.0,421644.0,15726855.0,15726855.0,4251613.0,,,,154961.0,198238.0,2592.0,198238.0,1331780.0,808200.0,641484.0,59424.0,641484.0,262656.0,262656.0,,24331.0,,,,,,,,1829.0,,,11108.0,,113629.0,6244.0,11938.0,703.0,2643.0,8736.0,,,413084.0,32771.0,556.0,,,2658.0,,19201.0,1642.0,4722.0,197.0,589.0,550.0,,,50383.0,6251.0,2606.0,193.0,471.0,28407.0,,203563.0,69294.0,891784.0,415200.0,135795.0,18010.0,1432.0,,427886.0,,792.0,62.0,216.0,8302.0,,34398.0,18217.0,352763.0,116228.0,30268.0,1134.0,387.0,,52188.0,,16003.0,16003.0,4480.0,,,,,,,,,,,,60441.0,339376.0,390501.0,335231.0,27951.0,11349.0,953411.0,16349.0,56990.0,154470.0,93842.0,6230.0,3068.0,116285.0,,,,,106370.0,,412651.0,713928.0,11101.0,,136816.0,,-74250.0,,43364.0,,,,844812.0,,,,,1759659.0,,117393.0,,1759659.0,,431527.0,6609801.0,4097897.0,213762.0,83045.0,21988.0,25921.0,,740.0,955.0,,37836.0,28114.0,16946.0,1130.0,,4990.0,8965.0,946.0,624.0,287.0,,952.0,,,213762.0,1877738.0,504743.0,1877738.0,504743.0,,,444941.0,196090.0,,,,,,,,,,,,,,,,,,,32769.0,16782.0,3036.0,1056.0,,,,,,,,,,,,,,,,,,,38067.0,,,,,,10292.0,,,,,,,,,,,,235846.0,,3747.0,62004.0,,715.0,,,,,,,,,,,,,,,,,,,,,,-653053.0,,,,,,,,,,,,,,,,,,,,,,,,,,,,,,,,,,,,,,,,,,,,,,,,,,,,,,,,,,,,,,,,,8817.0,6.0,10107.0,74.0,,,,,,,,,,,11897.0,342.0,12748.0,233.0,,,,,,,,,,76685.0,1242.0,74200.0,1242.0,,,,,,,,,,,,,,,,,,,,,,,,,,48.0,,,,,,,,,,,,,,,,,,,,,,,,,,,,,,,,,,,,,,,,,,,,,,,,,,,,,,,,,,,,,,,,,,,,,,,,,,,,,,,,,,,,,,,,,,,,,,2512.0,,639.0,,,23700.0,,,2498.0,,,,14282.0,,,,,,7.0,14282.0,3183.0,,,,,,,,,,,,,,,,36.0,73.0,2.0,130.0,94.0,2.0,,,,,,,,,,,,869.0,276.0,,,,,251.0,,,,,,,,,,,,,4054.0,734.0,,1030.0,644.0,,,33713.0,10243.0,,,,,5079.0,2332.0,,,,,,38650.0,41612.0,14059.0,9158.0,1401.0,518.0,,,,,,,,,,,,,,,,,,,,,,,,,,,,,,,,,,,,,,,,,,,,,,,,,,,,,,,,,,,,,,,,,,,,,,,16804.0,1557.0,,,,,,,,,,,,,,,,,,,,,,,,,,,,,,,,3883.0,1472.0,1248.0,572.0,,,,,,,,,,,,,,,,,,,,,,,,,,,,,,,,,,,,,,,,,,,,,,,,,,,,,,,,,,,,,,,,,,,,,,,,,,,,,,,,,,,,,138.0,,,,,,,,,,,,,,,,,,,,,,,,,,,,,,,,,,,,7.0,,,,,,,,,,,,,,,,,,,,,,,,,,,,,,,,,,,,,,,,,,,,,,,,,,,,,,,,,,,,,,,,,,,,,,,,,,,,,,,,,,,,,,,,,,,,,,,,,,,,,,,,,,,,,,,,,,,,,,,,,,,,,,,,,,,,,,,,,,,,,,,,,,,,,,,2016,PA,,N,N,13547038.0,34495.0,-109582.0,15433062.0,,15403072.0,15327985.0,153280.0,15174705.0,154330.62,UPMC NORTHWEST HOSPITAL (390091)
45156,UPMC NORTHWEST HOSPITAL (390091),Acute Care Hospitals,Voluntary non-profit - Other,-79.707926,41.360026,717091,390091,12001,4,2022-05-03 00:00:00,2017-07-01 00:00:00,2018-06-30,F,M,39,39730,2.0,3.0,,,,,,,,,,,,,,,,,,,,,,,,,,,,,,,,,,,,,,,,,,202574.0,,,3.0,,1095.0,,,,,,5412949.0,1480957.0,1603035.0,318163.0,,,,,,,,,,5412949.0,1480957.0,,,1603035.0,318163.0,,,32.0,42.04,,,,,,,,,,,,,,,,,,,,,,,,,,,,,,,,,,,111387277.0,,24891647.0,29726309.0,112019924.0,6327558.0,26385.0,4149971.0,9127359.0,113480055.0,24918032.0,33870221.0,116912503.0,,4539528.0,4498060.0,,,,,-24864463.0,29301377.0,6797349.0,85829424.0,5498811.0,,-24864463.0,-4025786.0,90266338.0,7514423.0,,89709888.0,14435992.0,,4734045.0,920153.0,,89684374.0,92020424.0,89903042.0,14440344.0,,136945265.0,20911344.0,,389722244.0,14440344.0,14440344.0,5538121.0,5885764.0,12494015.0,430612.0,280049.0,710661.0,11783354.0,9173467.0,,5885764.0,,37264.0,18857.0,14602.0,7232.0,665994.0,352922.0,37264.0,14602.0,0.230124,4298512.0,483841.0,2976919.0,4389639.0,85251.0,85251.0,85135.0,8108075.0,1931495.0,1898496.0,2.0,2.0,1.0,516.41,587.15,2093.0,2093.0,4882.0,4882.0,110.0,118.0,171.0,110.0,37002.0,39922.0,37002.0,7232.0,8051.0,7232.0,16092.0,19224.0,16092.0,1761634.0,40666878.0,4951003.0,,,,-12045864.0,-2127509.0,,1950881.0,,41468.0,942237.0,2678964.0,4881617.0,230464.0,4943467.0,13731501.0,252776979.0,4943467.0,4943467.0,1474612.0,1616816.0,68740.0,72855.0,1543961.0,4145605.0,8163.0,2435.0,68740.0,,54.0,54.0,13.0,419.0,28.0,10220.0,2435.0,196.0,1179.0,210.0,196.0,8163.0,29301377.0,2643395.0,1926097.0,471397.0,845464.0,929080.0,516062.0,230107.0,,28885078.0,3493592.0,25391486.0,42561973.0,28885078.0,3536842.0,25348236.0,42518723.0,6050112.0,,55657298.0,55657298.0,11352042.0,11327976.0,12249125.0,2361521.0,9897984.0,12214640.0,9899510.0,9894807.0,359636.0,233763.0,278945.0,10128570.0,10128700.0,9665643.0,8.0,3091675.0,4234780.0,6059.0,4234780.0,3091675.0,45617881.0,,,,194517.0,,,,,,1114644.0,164715.0,29301377.0,2679936.0,,1513333.0,,478903.0,,855625.0,517579.0,531623.0,1127469.0,230107.0,166608.0,1224624.0,23.93,1214938.0,1063263.0,23.77,23.84,33.19,14155.0,5534.0,16191.0,1526.0,260475.0,4.34,4.34,,,362751.0,593393.0,22510.0,2117382.0,593393.0,1363275.0,1553.0,1412720.0,10711986.0,8022824.0,1846244.0,1813361.0,56302455.0,955.0,1553.0,2765.0,7272331.0,,,7272331.0,,,41878.0,36.14,9218917.0,9218917.0,274377.0,36.37,22.05,,26601.0,,,,,,,,,14867.0,,,,,45737.0,,11894.0,,19527.0,19527.0,105243.0,105243.0,105243.0,85716.0,19527.0,9147.0,2011.0,304180.0,753484.0,,1020376.0,194906.0,304180.0,753484.0,,1020376.0,200406.0,116464.0,9031.0,4482.0,,,19755.0,67178.0,32971.0,15600.0,13353.0,12759.0,7739.0,23.01,33.68,168.11,,,24.24,12.74,15.7,34.08,15.01,18.03,21.53,7951570.0,7951570.0,151675.0,217923.0,23.32,36.49,,,,,16110.0,,24066.0,147319.0,147319.0,,59506.0,,7633.0,,4703.0,24066.0,435049.0,100115.0,72014.0,340.0,,4848.0,25388.0,7528.0,200265.0,68332.0,25388.0,7528.0,,200265.0,68332.0,,1424.0,34132.0,342.0,,140.64,33.03,199.8,1281186.0,,,-130.0,,,,,,,32883.0,116.0,32999.0,305.0,,4.0,,,,,,,,583640.0,850197.0,49548.0,153417.0,-237973.0,,646086.0,1496041.0,133038.0,1496041.0,3171113.0,142204.0,4115.0,1496041.0,1496041.0,919951.0,559208.0,1479159.0,81803.0,21707.0,103510.0,1375649.0,986187.0,,142204.0,,2157057.0,1942875.0,,559208.0,,2519.0,1549.0,81803.0,89.0,116.0,3.0,191.0,9.0,3285.0,1549.0,42.0,2519.0,850197.0,420831.0,28943.0,14.54,,,,1009300.0,,2168479.0,,151780.0,,2168479.0,,5460422.0,,2168479.0,1211958.0,571671.0,2637924.0,571671.0,0.843,9549484.0,2541.0,16.88,16.0,5840.0,2567.0,6.0,4593.0,856906.0,,35211.0,,24.34,,,,,,,,,,,,,,,,,,,,,,,,,,,,,,,,,,,,,,,,,,10419.0,1117.0,105.0,209.0,,,,,,,,,,,,,,,,140.0,1368.0,315.0,175.0,,,,7628.0,7628.0,69.0,110.55,,,,,,,,,,,,,,28101.0,,,,,,,,,,,,,,,,,,,,,,,,,,,,,11881781.0,,,4228721.0,7653060.0,1761634.0,7653060.0,,,,,,,,,,,,,,,,,,,,,,,,,,,,66508.0,,,66508.0,,,,260.0,,,255.8,,,,,,,,,,,,,,,,,,,,,,,,,,,,,,,,,,,,,,,,,,,,,,,,,,,,,,,,,,,,,,,,,,,,,,,,,,,,,,,,,,,,,,,,113.0,147319.0,147319.0,207.0,147319.0,147319.0,,,,,,,,,,,,,,,,,,,,,,,,,,,,344.0,,105.0,,,,,,,,,,,,,,,,,,,,,,,,,,,,,,,,,,,,,,,,,,6648.0,6648.0,,,,,,,,,,,,,,,,,,,,,,,4.0,,,,,,,,,,,,,,,,,,,,,,,,,,,,,,,,,,,,,,,,,,,,,,,,,,,,,,,,,,,,,,,,,,,,,,,,,,729451.0,,,,,,,,,,,,,,,,,,,,,,,,,,,,,,,,,,,,,,,,,,,,,,5.0,,,744371.0,,,,,,,,,,,,,,,,,,,,,,,,,,,,,,,,,,,,,100 FAIRFIELD DRIVE,SENECA,16346,VENANGO,UPMC NORTHWEST HOSPITAL,99939,P,2,Y,N,N,Y,Y,N,,N,N,,N,N,Y,N,Y,Y,,UPMC NORTHWEST-PSYCHIATRIC,39S091,HO0164,UPMC,200 LOTHROP STREET,PITTSBURGH,PA,15213,,Y,,,,,,UPMC NORTHWEST-REHAB UNIT,39T091,395966,,,,,,,,,,,,,,,,,,,,,,,,,,,,,,,,,,,,,,,,,,,,,,,,,,,,,,,,,,,,,,,,,,,,,,,,,,,,,,,,,,,,,,,,,,,,,,,,,,,,,,,,,,,,,,,,,,,,,,,,,,,,,,,,,,,,,,,,,,,,,,,,,1.0,,,,,,,,,,,,,,,,,,,,,,,,,2477189.0,2062339.0,2450449.0,2047611.0,-10687792.0,1114644.0,230107.0,164715.0,1926097.0,651292.0,,,334352.0,845464.0,,840149.0,3743382.0,115849.0,13501.0,,382027.0,38792458.0,3887461.0,81498.0,158816.0,2660762.0,269282.0,4856162.0,,376353.0,864607.0,270646.0,106383.0,155623.0,2141051.0,93707.0,,,410512.0,-244.0,-2513.0,,-16412908.0,2477189.0,974759.0,1435726.0,343443.0,180109.0,2062339.0,6470953.0,13951879.0,2795365.0,382588.0,213303.0,3570839.0,826058.0,383122.0,438309.0,6412862.0,,,1007720.0,988236.0,502581.0,171443.0,492547.0,2637186.0,116336.0,876726.0,1917161.0,3434014.0,1266125.0,620346.0,2326534.0,5822857.0,633788.0,2038142.0,6153989.0,1615635.0,712764.0,923662.0,8755110.0,,,1462757.0,1431363.0,603699.0,206163.0,825445.0,187461.0,1052747.0,2300754.0,4147824.0,1262553.0,4250310.0,815993.0,24995.0,168587.0,518653.0,163192.0,21246.0,216176.0,275939.0,,,62950.0,79399.0,2993.0,983.0,62061.0,6501.0,4940.0,10728.0,20716.0,86490.0,275474.0,5822857.0,633788.0,2038142.0,6242221.0,1615635.0,712764.0,923662.0,8814665.0,,,1462757.0,1431363.0,603699.0,206163.0,825445.0,187461.0,1052747.0,2300754.0,4147824.0,1267232.0,4250310.0,4950792.0,662009.0,1210378.0,4309223.0,162536.0,6310776.0,1809064.0,16412032.0,,,4032649.0,3755707.0,2203356.0,872927.0,3806188.0,212447.0,1458549.0,5711234.0,21686518.0,26550.0,5014831.0,1467587.0,216444.0,368205.0,2064342.0,32742.0,3013769.0,706293.0,6837957.0,,,1631272.0,708363.0,382363.0,341703.0,1920201.0,100626.0,531424.0,1988750.0,7891584.0,24068.0,2423791.0,431503.0,67703.0,183052.0,520143.0,6423.0,84063.0,36904.0,1015820.0,,,487284.0,257012.0,98764.0,70868.0,109703.0,10962.0,138202.0,574816.0,1012277.0,7582.0,446717.0,1467587.0,216444.0,368205.0,2064342.0,32742.0,3013769.0,706293.0,6837957.0,,,1631272.0,708363.0,382363.0,341703.0,1920201.0,100626.0,531424.0,1988750.0,7891584.0,24068.0,2423791.0,,,,929080.0,516062.0,,,471397.0,420665.0,209174.0,,,372198.0,204558.0,,-319228.0,,-5590.0,482152.0,650553.0,,,372198.0,25514.0,,7697.0,,3995983.0,,185939.0,,,,1061786.0,,376210.0,,,,,,,1696004.0,,1696004.0,,217552.0,,,2320860.0,,1873245.0,,-28626.0,,,-2420.0,,,1290515.0,1290515.0,405054.0,,,,304180.0,363175.0,,,1417237.0,,,-46717.0,-170.0,,,-12.0,483352.0,820319.0,47086.0,820319.0,2039821.0,14853336.0,5853.0,22656191.0,42923574.0,2589541.0,10649444.0,2766027.0,2766027.0,813273.0,,,121433.0,160359.0,9992.0,2140.0,-286.0,,,864207.0,10642056.0,5462820.0,4873067.0,197819.0,2628467.0,5462820.0,4873067.0,197819.0,2628467.0,1198494.0,719031.0,59091.0,150167.0,17153.0,9448.0,859709.0,15458979.0,-1199790.0,13909488.0,17093290.0,117686.0,17093290.0,9587.0,5280.0,194906.0,899371.0,198823.0,-90541.0,-253752.0,-310.0,1125805.0,2063175.0,149788.0,2063175.0,3602865.0,189344.0,1070130.0,1886203.0,1579.0,819.0,77690.0,,,,,8.0,2920.0,819.0,1579.0,,,,303136.0,55671.0,,237813.0,249321.0,,42184.0,82728.0,1749747.0,,,,,,5120.0,1856833.0,,,,-72498.0,-1302637.0,,49060.0,,,,,,,,,,,,,,,,,,,,,,,1364187.0,2889291.0,,19242943.0,16185548.0,,,1508334.0,2248904.0,18046478.0,,,20835.0,,,8355.0,,,,,,,,,20835.0,,,,265305.0,,478258.0,,4353475.0,3508956.0,,,27676.0,277572.0,518448.0,425606.0,2870192.0,,,265305.0,,478258.0,,4353475.0,3508956.0,,,27676.0,277572.0,518448.0,425606.0,2870192.0,,,,59506.0,82987.0,,237765.0,,121431.0,178672.0,,,10042.0,30238.0,134828.0,123015.0,528991.0,,,,7633.0,,,,,,,,28.0,,,,,,,622310.0,133855.0,121123.0,63968775.0,335682.0,224377.0,335682.0,20331901.0,20331901.0,5343550.0,,,,74847.0,97353.0,2163.0,97353.0,1036000.0,742257.0,521467.0,28548.0,521467.0,161482.0,161482.0,,8840.0,,,,,,,97994.0,8463.0,660.0,1324.0,17056.0,,247652.0,27846.0,19104.0,1454.0,2150.0,24439.0,81.0,,547952.0,45879.0,2488.0,206.0,658.0,3957.0,,36790.0,8318.0,6931.0,376.0,446.0,1396.0,21.0,,70287.0,8456.0,9327.0,1297.0,2113.0,24656.0,,180519.0,58074.0,860991.0,390158.0,127160.0,19722.0,1635.0,,411655.0,,2742.0,406.0,1050.0,6356.0,,26817.0,17348.0,312389.0,100777.0,26373.0,1127.0,425.0,,52804.0,,21587.0,21587.0,5576.0,,,,,,,,,,,,50854.0,352074.0,477327.0,416401.0,36064.0,6097.0,870911.0,13256.0,51949.0,173186.0,107556.0,7480.0,1586.0,111714.0,,,,,108874.0,,399894.0,720739.0,12314.0,,137984.0,32857.0,-72795.0,,152674.0,,-1266.0,,853177.0,,96480.0,,,1647692.0,,117473.0,,1647692.0,,356266.0,8072837.0,4576813.0,177499.0,59286.0,19653.0,19842.0,,548.0,1039.0,,8223.0,38139.0,6616.0,,2525.0,4127.0,1613.0,1064.0,346.0,,843.0,761.0,,,177499.0,2079287.0,733557.0,2079287.0,733557.0,,,407919.0,245015.0,,,,,,,,,,,,,,,,,,,6498.0,21403.0,356.0,1223.0,,,,,,,,,,,,,,,,,,,45737.0,,,,,,11894.0,,,,,,,,,,,,284645.0,,4207.0,85027.0,,775.0,,,,,,,,,,,,,,,,,,,,,,-2016192.0,,,,,,,,,,,,,,,,,,,,,,,,,,-31658.0,,,,,,246795.0,,25456.0,,,,,,,,,,,,,76769.0,,,9951.0,,,,,,,,,,,,30012.0,,,7645.0,5.0,8405.0,55.0,,,,,,,,,,,11408.0,301.0,12142.0,215.0,,,,,,,,,,73660.0,1193.0,71273.0,1193.0,,,,,,,,,,,,,,,,,,,,,,,,,,14.0,,,,,,,,,,,,,,,,,,,,,,,,,,,,,,,,,,,,,,,,,,,,,,,,,,,,,,,,,,,,,,,,,,,,,,,,,,,,,,,,,,,,,,,,,,,,,,2632.0,,287.0,,,7693.0,,,5834.0,,,,18244.0,,,,,,1.0,18244.0,3784.0,,,,,,,,,,,,,,,,56.0,55.0,2.0,99.0,106.0,1.0,,,,,,,,,,,,,,,,,,216.0,,,,,,,,,,,,,599.0,42345.0,,65.0,11785.0,,,8232.0,2420.0,,,,,196.0,97.0,,,,,,8051.0,45239.0,6781.0,1579.0,1262.0,355.0,,,,,,,,,,,,,,,,,,,,,,,,,,,,,,,,,,,,,,,,,,,,,,,,,,,,,,,,,,,,,,,,,,,,,,,2427.0,133.0,,,,,,,,,,,,,,,,,,,,,,,,,,,,,,,,,,,,,,,,,,,,,,,,,,,,,,,,,,,,,,4.0,,,,,,,,,,,,,,,,,,,,,,,,,,,,,,,,,,,,,,,,,,,,,,,,,,,,,,,,,,126.0,,,,,,,,,,,,,,,,,,,,,,,,,,,,,,,,,,,,1.0,,,,,,,,,,,,,,,,,,,,,,,,,,,,,,,,,,,,,,,,,,,,,,,,,,,,,,,,,,,,,,,,,,,,,,,,,,,,,,,,,,,,,,,,,,,,,,,,,,,,,,,,,,,,,,,,,,,,,,,,,,,,,,,,,,,,,,,,,,,,,,,,,,,,,,,2017,PA,,N,N,13373580.0,101014.0,-112554.0,15232123.0,,15199539.0,15187999.0,151880.0,15036119.0,152321.23,UPMC NORTHWEST HOSPITAL (390091)
47382,UPMC NORTHWEST HOSPITAL (390091),Acute Care Hospitals,Voluntary non-profit - Other,-79.707926,41.360026,682374,390091,12001,5,2020-12-16 00:00:00,2018-07-01 00:00:00,2019-06-30,F,N,39,39730,2.0,3.0,,,,,,,,,,,,,,,,,,,,,,,,,,,,,,,,,,,,,,,,,,222913.0,,,3.0,,1095.0,,,,,,6323747.0,1686805.0,1590466.0,377439.0,,,,,,,,,,6323747.0,1686805.0,,66508.0,1590466.0,377439.0,,,32.58,49.34,,,,,,,,,,,,,,,,,,,,,,,,,,,,,,,,,,,113537390.0,57335.0,24918032.0,33812886.0,116912503.0,8900240.0,1928220.0,3636400.0,8900240.0,,,,,,5283666.0,5244241.0,,,,,-24694526.0,30126177.0,7064791.0,89671827.0,6692619.0,,-24694526.0,-5301741.0,95103478.0,7421528.0,,94907773.0,14755287.0,,5430059.0,996203.0,,94879534.0,97637707.0,95239747.0,14759983.0,,145446096.0,22310903.0,,431110091.0,14759983.0,14759983.0,5609677.0,5842861.0,12358795.0,446220.0,287892.0,734112.0,11624683.0,10078647.0,,5842861.0,,37768.0,19426.0,13092.0,7383.0,655665.0,378600.0,37768.0,13092.0,0.220082,4809661.0,603019.0,3054285.0,4720597.0,209015.0,209015.0,208899.0,7929864.0,1908235.0,1875236.0,2.0,2.0,1.0,520.52,591.66,1997.0,1997.0,4734.0,4734.0,110.0,118.0,171.0,110.0,38220.0,41140.0,38220.0,7383.0,8042.0,7383.0,16270.0,19344.0,16270.0,1761634.0,45617881.0,3206400.0,,,,-11183927.0,-1765965.0,,1961940.0,,39425.0,1139674.0,2600921.0,4965099.0,252472.0,5151150.0,15211861.0,285663995.0,5151150.0,5151150.0,875571.0,967433.0,42914.0,46016.0,921417.0,2300040.0,8160.0,1387.0,42914.0,,77.0,77.0,28.0,548.0,28.0,10220.0,1387.0,261.0,1168.0,203.0,261.0,8160.0,30126177.0,2698813.0,1716112.0,511052.0,953598.0,998297.0,538431.0,236397.0,,30005797.0,3554678.0,26451119.0,43937842.0,29948993.0,3545436.0,26403557.0,43890280.0,6286546.0,,61507566.0,61507566.0,12079434.0,12055306.0,13273767.0,2497329.0,10783668.0,13241426.0,10794560.0,10788694.0,549164.0,356957.0,409110.0,11145651.0,11145674.0,10768268.0,154493.0,3091675.0,5828130.0,5021.0,8340066.0,,,,,,146393.0,,,,,,1122233.0,195994.0,30069373.0,2673729.0,,1493432.0,,517354.0,,963566.0,548321.0,547397.0,1109317.0,236397.0,199733.0,1230652.0,24.43,1228301.86,1076082.86,24.38,24.54,33.55,19275.0,22806.0,15701.0,10892.0,,1.23,1.23,,,431094.0,664953.0,20701.0,2397960.0,664953.0,1396840.0,1522.0,1666312.0,10955880.0,7720849.0,1699220.0,1666337.0,62511284.0,862.0,1522.0,3156.0,7222142.0,,,7222142.0,,,42401.0,35.22,9210851.0,9210851.0,283831.77,34.88,22.15,,26252.0,,,,,,,,,13173.0,,,,,32007.0,,8390.0,,13631.0,13631.0,70807.0,70807.0,70807.0,57176.0,13631.0,6401.0,1883.0,148981.0,116339.0,,1004214.0,199296.0,148981.0,116339.0,,1004214.0,196594.0,117436.0,3091.33,685.0,,,21389.0,71718.0,33781.0,16015.0,13600.0,12638.77,9128.0,22.77,48.19,169.84,,,24.19,13.44,16.23,34.18,14.46,18.7,21.88,8275872.0,8275872.0,152219.0,232091.33,23.29,35.66,,,,,14262.0,,24128.0,149578.0,149578.0,,38800.0,,5241.0,,5866.0,24128.0,494834.0,108904.0,71037.0,483.0,,5064.0,20804.0,3368.0,188524.0,28000.0,20804.0,3368.0,,188524.0,28000.0,,1124.0,34058.0,201.0,,167.73,32.57,139.3,1308174.19,129220.0,,-23.0,,,,,,,32883.0,116.0,32999.0,366.0,,,,,,,,,2970107.0,621572.0,855865.0,53254.0,166730.0,-500272.0,-4899.0,675312.0,1585238.0,147055.0,1590137.0,3263733.0,91862.0,3102.0,1590137.0,1590137.0,951482.0,636051.0,1587533.0,87994.0,24222.0,112216.0,1475317.0,663537.0,,91862.0,,2525463.0,1944689.0,,636051.0,,2440.0,1460.0,87994.0,98.0,100.0,4.0,174.0,9.0,3285.0,1460.0,90.0,2440.0,855865.0,461216.0,29009.0,15.9,,,,1037571.0,,2268002.0,,166402.0,,2268002.0,,5917987.0,,2268002.0,1070350.0,500766.0,2378872.0,500766.0,0.843,10162623.0,2203.0,16.72,16.0,5840.0,2203.0,,4668.0,871707.0,,34783.0,,25.06,,,,,,,,,,,,,,,,,,,,,,,,,,,,,,,,,,,,,,,,,,8213.0,1136.0,122.0,236.0,,,,,,,,,,,,,,,,119.0,1692.0,372.0,253.0,,,,13219.0,13219.0,94.0,140.63,,,,,,,,,,,,,,37867.0,,,,,,,,,,,,,,,,,,,,,,,,,,,,,7653060.0,,,5364938.0,2288122.0,,,,,,,,,,,,,,,,,,,,,,,,,,,,,,,,,,,,,,,,,,,,,,,,,,,,,,,,,,,,,,,,,,,,,,,,,,,,,,,,,,,,,,,,,,,,,,,,,,,,,,,,,,,,,,,,,,,,,,,,,,,,,,,,121.0,149578.0,149578.0,252.0,149578.0,149578.0,,,,,,,,,,,,,,,,,,,,,,,,,,,,317.0,,121.0,,,,,,,,,,,,,,,,,,,,,,,,,,,,,,,,,,,,,,,,,,3638.0,3638.0,,,,,,,,,,,,,,,,,,,,,,,,,,,,,,,,,,,,,,,,,,,,,,,,,,,,,,,,,,,,,,,,,,,,,,,,,,,,,,,,,,,,,,,,,,,,,,,,,731474.0,,,,,,,,,,,,,,,,,,,,,,,,,,,,,,,,,,,,,,,,,,,,,,3.0,,,927723.0,,,,,,,,,,,,,,,,,,,,,,,,,,,,,,,,,,,,,100 FAIRFIELD DRIVE,SENECA,16346,VENANGO,UPMC NORTHWEST HOSPITAL,99939,P,2,Y,N,N,Y,Y,N,,N,N,,N,N,Y,N,Y,Y,,UPMC NORTHWEST-PSYCHIATRIC,39S091,HO0164,UPMC,200 LOTHROP STREET,PITTSBURGH,PA,15213,,Y,,,,,,UPMC NORTHWEST-REHAB UNIT,39T091,395966,,,,,,,,,,,,,,,,,,,,,,,,,,,,,,,,,,,,,,,,,,,,,,,,,,,,,,,,,,,,,,,,,,,,,,,,,,,,,,,,,,,,,,,,,,,,,,,,,,,,,,,,,,,,,,,,,,,,,,,,,,,,,,,,,,,,,,,,,,,,,,,,,1.0,,,,,,,,,,,,,,,,,,,,,,,,,2766917.0,2516749.0,2740826.0,2503415.0,-11744634.0,1122233.0,236397.0,195994.0,1716112.0,644583.0,,,354914.0,953598.0,,863489.0,4147009.0,107753.0,16163.0,,336791.0,39310902.0,3980704.0,92182.0,121222.0,2413783.0,188248.0,4473112.0,,376276.0,981756.0,314547.0,115623.0,200789.0,2355188.0,89623.0,,,478267.0,-326.0,-1022.0,-5000.0,-15855260.0,2766917.0,1007985.0,1508217.0,343128.0,210896.0,2516749.0,6640559.0,14376588.0,2652519.0,400580.0,165361.0,3567005.0,843271.0,518532.0,375323.0,6197348.0,,,1028502.0,1081875.0,589281.0,185088.0,562550.0,2892209.0,91581.0,1048710.0,1912217.0,3747635.0,1441434.0,688017.0,2320080.0,5691725.0,661818.0,1975973.0,6172253.0,1938212.0,907268.0,1121579.0,8514374.0,,,1496024.0,1570405.0,704191.0,221559.0,910529.0,158087.0,1253239.0,2284499.0,4500474.0,1418740.0,4315451.0,847152.0,26506.0,163376.0,535747.0,387285.0,25154.0,447460.0,266399.0,,,67622.0,88847.0,3325.0,1023.0,65017.0,7089.0,5666.0,10290.0,21593.0,92294.0,294821.0,5691725.0,661818.0,1975973.0,6260485.0,1938212.0,907268.0,1121579.0,8573929.0,,,1496024.0,1570405.0,704191.0,221559.0,910529.0,158087.0,1253239.0,2284499.0,4500474.0,1435520.0,4315451.0,5471562.0,707460.0,1265722.0,4116389.0,204893.0,7239420.0,2332515.0,17450026.0,,,3743260.0,3956827.0,2374552.0,986202.0,3694791.0,225055.0,1608061.0,6223279.0,22329403.0,25954.0,5305986.0,1550796.0,219839.0,363945.0,1882481.0,24121.0,3318447.0,1055861.0,6954498.0,,,1532348.0,776704.0,459899.0,371139.0,1814848.0,106824.0,560939.0,2219635.0,8064106.0,17406.0,2436023.0,410801.0,83501.0,174248.0,427097.0,4692.0,99188.0,62692.0,945332.0,,,487546.0,290156.0,127503.0,73438.0,110524.0,9075.0,147045.0,615920.0,1089356.0,8346.0,430185.0,1550796.0,219839.0,363945.0,1882481.0,24121.0,3318447.0,1055861.0,6954498.0,,,1532348.0,776704.0,459899.0,371139.0,1814848.0,106824.0,560939.0,2219635.0,8064106.0,17406.0,2436023.0,,,,998297.0,538431.0,,,511052.0,504192.0,414902.0,,,390695.0,248513.0,,-330989.0,,-67455.0,529161.0,772159.0,,,390695.0,28239.0,,8621.0,,2968033.0,,210377.0,,,,1089286.0,,391986.0,,,,,,,1657482.0,,1657482.0,,223904.0,,,2270219.0,,2012300.0,,-24813.0,,,-4891.0,,,1012271.0,1012271.0,479678.0,,,,75400.0,89640.0,,,1378979.0,,,-172930.0,-176.0,,,-399.0,574791.0,919899.0,46599.0,919899.0,2200752.0,16014977.0,14752.0,23973399.0,45625798.0,3172733.0,10985962.0,3268757.0,3268757.0,865884.0,,,223634.0,119426.0,18024.0,12919.0,298.0,,,958717.0,11256352.0,5138002.0,4969112.0,173242.0,2659640.0,5138002.0,4969112.0,173242.0,2659640.0,1122364.0,670761.0,55120.0,161972.0,17373.0,8879.0,985091.0,16721520.0,-927332.0,16162606.0,19775091.0,130963.0,19775091.0,8718.0,4455.0,199296.0,933760.0,204873.0,-79883.0,-218864.0,-156.0,1151127.0,2134309.0,159244.0,2134309.0,3589442.0,246909.0,906257.0,1525328.0,1552.0,659.0,67620.0,,,,,8.0,2920.0,659.0,1552.0,,,,314501.0,56672.0,,302247.0,225691.0,,,74836.0,1768145.0,,,,,,,1866933.0,,,,-72878.0,-1311204.0,,46787.0,,,,,,,,,,,,,,,,,,,,,,,1034948.0,2861401.0,,23114180.0,15997873.0,,,1635824.0,2009539.0,19131268.0,,,22005.0,,,9137.0,,,,,,,,,22005.0,,,,180959.0,3440.0,504596.0,,5193849.0,3054671.0,,,24823.0,307047.0,681184.0,356008.0,2926227.0,,,180959.0,3440.0,504596.0,,5193849.0,3054671.0,,,24823.0,307047.0,681184.0,356008.0,2926227.0,,,,38800.0,68734.0,1428.0,241589.0,,155244.0,189247.0,,,9273.0,26085.0,178566.0,98788.0,516751.0,,,,5241.0,,,,,,,,45.0,,,,,,,882477.0,165432.0,133503.0,82958507.0,511920.0,154392.0,511920.0,25202605.0,25202605.0,5956354.0,,,,79356.0,102780.0,2368.0,102780.0,1017451.0,810040.0,474076.0,26663.0,474076.0,232648.0,232648.0,,13084.0,,,,,,,76717.0,,,,11140.0,,206788.0,6186.0,17053.0,1692.0,479.0,21626.0,19.0,,283478.0,60904.0,,,,2361.0,,28109.0,1968.0,6371.0,469.0,95.0,1317.0,5.0,,38294.0,10755.0,4512.0,1393.0,1395.0,30256.0,,205343.0,50815.0,904852.0,407900.0,133964.0,3655.0,1234.0,,623001.0,,1195.0,529.0,668.0,7128.0,,27912.0,16168.0,338029.0,113087.0,26508.0,223.0,323.0,,84159.0,,9718.0,9718.0,2694.0,,,,,,,,,,,,77836.0,313959.0,407658.0,348864.0,19414.0,8744.0,887152.0,16809.0,42677.0,152290.0,96720.0,3842.0,2292.0,119843.0,,,,,115301.0,,421291.0,787877.0,12294.0,,203531.0,28891.0,-81490.0,,225540.0,,,,1006110.0,,,,,1892476.0,,127064.0,,1892476.0,,348302.0,9759358.0,5648006.0,161128.0,50853.0,37722.0,15845.0,,1128.0,939.0,,,60006.0,26212.0,2512.0,2291.0,8731.0,,1794.0,1553.0,213.0,723.0,1542.0,,,161128.0,2371667.0,985637.0,2371667.0,985637.0,,,461330.0,311074.0,,,,,,,,,,,,,,,,,,,52364.0,14439.0,2945.0,879.0,,,,,,,,,,,,,,,,,,,32007.0,,,,,,8390.0,,,,,,,,,,,,159986.0,,1964.0,50903.0,,347.0,,,,,,,,,,,,,,,,,,,,,,-1139162.0,,,,,,,,,,,,,,,,,,,,,,,,,,31658.0,,,,,,,,25046.0,,,,,,,,,,,,,45319.0,,,29635.0,,,,,,,,,,,,53624.0,,,6277.0,3.0,7911.0,71.0,,,,,,,,,,,11256.0,289.0,12382.0,201.0,,,,,,,,,,74790.0,1211.0,72366.0,1211.0,,,,,,,,,,,,,,,,,,,,,,,,,,,,,,,,,,,,,,,,,,,,,,,,,,,,,,,,,,,,,,,,,,,,,,,,,,,,,,,,,,,,,,,,,,,,,,,,,,,,,,,,,,,,,,,,,,,,,,,,605.0,,51.0,,,42215.0,,,13443.0,,,,10576.0,,,,,,,10576.0,2093.0,,,,,,,,,,,,,,,,30.0,90.0,1.0,107.0,143.0,2.0,,,,,,,,,,,,,,,,,,246.0,,,,,,,,,,,,,3551.0,429.0,,302.0,347.0,,,16766.0,4441.0,,,,,2829.0,1354.0,,,,,,10401.0,29005.0,21976.0,2023.0,867.0,1302.0,,,,,,,,,,,,,,,,,,,,,,,,,,,,,,,,,,,,,,,,,,,,,,,,,,,,,,,,,,,,,,,,,,,,,,,15176.0,854.0,,,,,,,,,,,,,,,,,,,,,,,,,,,,,,,,1535.0,,583.0,,,,,,,,,,,,,,,,,,,,,,,,,,,,,,,,,,,,,,,,,,,,,,,,,,,,,,,,,,,,,,,,,,,,,,,,,,,,,,,,,,,,,,69.0,,,,,,,,,,,,,,,,,,,,,,,,,,,,,,,,,,,,1.0,,,,,,,,,,,,,,,,,,,,,,,,,,,,,,,,,,,,,,,,,,,,,,,,,,,,,,,,,,,,,,,,,,,,,,,,,,,,,,,,,,,,,,,,,,,,,,,,,,,,,,,,,,,,,,,,,,,,,,,,,,,,,,,,,,,,,,,,,,,,,,,,,,,,,,,2018,PA,,N,N,12630436.0,92488.0,-91340.0,14709402.0,,14656195.0,14657343.0,146573.0,14510770.0,147094.02,UPMC NORTHWEST HOSPITAL (390091)
56316,UPMC NORTHWEST HOSPITAL (390091),Acute Care Hospitals,Voluntary non-profit - Other,-79.707926,41.360026,713993,390091,12001,1,2022-03-14 00:00:00,2019-07-01 00:00:00,2020-06-30,F,N,39,39730,2.0,3.0,,,,,,,,,,,,,,,,,,,,,,,,,,,,,,,,,,,,,,,,,,167454.0,,,3.0,,1098.0,,,,,,6202946.0,1549442.0,1512655.0,410075.0,,,,,,,,,,6202946.0,1549442.0,,66508.0,1512655.0,410075.0,,,32.45,49.75,,,,,,,,,,,,,,,,,,,,,,,,,,,,,,,,,,,116609499.0,57335.0,26846252.0,37444264.0,117472676.0,1215145.0,,1119824.0,1718454.0,,,,,,5177622.0,5136495.0,,,,,-29130187.0,31915826.0,7226930.0,98081764.0,6443886.0,,-29130187.0,-5074177.0,100867403.0,6651459.0,,100791395.0,14334437.0,,5326038.0,857958.0,,100765695.0,104174740.0,100946710.0,14340304.0,,140952722.0,20676207.0,,464642589.0,14340304.0,14340304.0,4815728.0,5258575.0,10849847.0,342469.0,251684.0,594153.0,10255694.0,8915613.0,,5258575.0,,35079.0,18254.0,10792.0,6130.0,511040.0,288110.0,35079.0,10792.0,0.216867,4105378.0,383467.0,2730237.0,4080916.0,137995.0,137995.0,137995.0,7623594.0,1761374.0,1761374.0,2.0,2.0,1.0,526.09,595.22,1583.0,1583.0,4100.0,4100.0,110.0,118.0,171.0,110.0,38303.0,41231.0,38303.0,6130.0,6648.0,6130.0,14145.0,16838.0,14145.0,1761634.0,45854174.0,598630.0,,,,-12572130.0,-2811240.0,,2219442.0,,41127.0,1130025.0,2790266.0,5297330.0,225967.0,5297330.0,15350463.0,323689867.0,5297330.0,5297330.0,645044.0,713208.0,27516.0,29461.0,683747.0,1716780.0,7736.0,942.0,27516.0,,64.0,64.0,24.0,627.0,28.0,10248.0,942.0,221.0,990.0,231.0,221.0,7736.0,31915826.0,2951132.0,2266833.0,566925.0,994547.0,1011294.0,726980.0,243137.0,,31813360.0,3850211.0,27963149.0,46534146.0,31104544.0,3594400.0,27510144.0,46081141.0,7183675.0,-3158.0,67924395.0,67924395.0,12350038.0,12323811.0,12088445.0,2290516.0,9803010.0,12062218.0,9816996.0,9813382.0,328933.0,213806.0,210228.0,10027188.0,10027193.0,9611239.0,248500.0,3220895.0,1315281.0,,1315281.0,,,,,,148416.0,,,,,,1198183.0,182812.0,31207010.0,2694835.0,,1964607.0,,570351.0,,1008743.0,563177.0,765215.0,1198183.0,243137.0,182812.0,1241680.0,25.13,1239415.0,1090977.0,25.1,25.22,34.76,,,14325.0,13986.0,,0.95,0.95,,,979348.0,1449878.0,24957.0,3228030.0,1449878.0,1243025.0,1283.0,1350679.0,11580243.0,7485599.0,1623379.0,1623379.0,67259493.0,739.0,1283.0,4109.0,7576711.0,,,7576711.0,,,52301.0,37.56,9514235.0,9514235.0,295654.0,34.58,24.3,,28615.0,,,,,,,,,12512.0,,,,,,,,,5081.0,5081.0,39174.0,39174.0,39174.0,34093.0,5081.0,,1698.0,503623.0,800751.0,,1015209.0,199196.0,503623.0,800751.0,,1015209.0,199196.0,115154.0,7757.0,4645.0,,,23820.0,70430.0,32869.0,18981.0,13089.0,12256.0,8303.0,23.4,64.92,172.39,,,23.94,14.32,17.13,40.31,15.22,19.84,22.02,9056762.0,9056762.0,148438.0,234696.0,24.21,38.59,,,,,15545.0,,26227.0,188540.0,188540.0,,39174.0,,5081.0,,3614.0,26227.0,406265.0,88105.0,48995.0,363.0,,4110.0,14794.0,5723.0,72496.0,58750.0,14794.0,5723.0,,72496.0,58750.0,,1286.0,35855.0,307.0,,56.37,33.42,191.37,1325673.0,,,-5.0,,,,,,,,,,282.0,,4.0,,,,,,,,617238.0,899079.0,44276.0,163230.0,-559427.0,-3798.0,668547.0,1647021.0,131669.0,1650819.0,3253934.0,68164.0,1945.0,1650819.0,1650819.0,867255.0,566237.0,1433492.0,69175.0,21982.0,91157.0,1342335.0,487423.0,,68164.0,,2112624.0,1690176.0,,566237.0,,2288.0,1202.0,69175.0,69.0,81.0,4.0,171.0,9.0,3294.0,1202.0,37.0,2288.0,899079.0,461837.0,27628.0,16.72,,,,1062036.0,,2378950.0,,147659.0,,2378950.0,,5611803.0,,2378950.0,1158200.0,512920.0,2274003.0,512920.0,,,2039.0,15.97,16.0,5856.0,2000.0,7.0,4108.0,899565.0,,33284.0,,27.03,,,,,,,,,,,,,,,,,,,,,,,,,,,,,,,,,,,,,,,,,,,1017.0,107.0,215.0,,,,,139.0,,,,,,,,,,,269.0,2292.0,497.0,228.0,,,,26417.0,26417.0,122.0,216.53,,,,,,,,,,,191071.0,,,39110.0,,,,,,,,,,,,,,,,,,,,,,,,,,41370.0,,,2288122.0,,,1018950.0,1269172.0,,,,,,,,,,,,,,,,,,,,,,,,,,,,,,,,,,,,,,,,,,,,,,,,,,,,,,,,,,,,,,,,,,,,,,,,,,,,,,,,,,,,,,,,,,,,,,,,,,,,,,,,,,,,,,,,,,,,,,,,,,,,,,,,88.0,188540.0,188540.0,229.0,188540.0,188540.0,,,,,,,,,,,,,,,,,,,,,,,,,,,,327.0,,107.0,,,63890.0,,,,,,,,,,,,,,,,,,,,,,,,,,,,,,,,,,,,,,,1375.0,1375.0,,,,,,,,,,,,,,,,,,,,,,,16.0,,,,,,,,,,,,,,,,,,,,,,,,,,,,,,,,,,,,,,,,,,,,,,,,,,,,,,,,,,,,,,,,,,,,,,,,,,732190.0,,,,,,,,,,,,,,,,,,,,,,,,,,,,,,,,,,,,,,,,,,,,,,2.0,,,589950.0,,,,,,,,,,,,,,,,,,,,,,,,,,,,,,,,,,,,,100 FAIRFIELD DRIVE,SENECA,16346,VENANGO,UPMC NORTHWEST HOSPITAL,99939,P,2,Y,N,N,Y,Y,N,,N,N,,N,N,Y,N,Y,Y,,UPMC NORTHWEST-PSYCHIATRIC,39S091,HO0164,UPMC,200 LOTHROP STREET,PITTSBURGH,PA,15213,,Y,,,,,,UPMC NORTHWEST-REHAB UNIT,39T091,395966,,,,,,,,,,,,,,,,,,,,,,,,,,,,,,,,,,,,,,,,,,,,,,,,,,,,,,,,,,,,,,,,,,,,,,,,,,,,,,,,,,,,,,,,,,,,,,,,,,,,,,,,,,,,,,,,,,,,,,,,,,,,,,,,,,,,,,,,,,,,,,,,,3.0,,,,,,,,,,,,,,,,,,,,,,,,,2463138.0,2714484.0,2435909.0,2700586.0,-13746817.0,1198183.0,243137.0,182812.0,2266833.0,691011.0,,,337186.0,994547.0,,814914.0,3932070.0,107371.0,36623.0,,392766.0,45782871.0,4418883.0,91231.0,94663.0,3344685.0,524923.0,4842418.0,,381193.0,1025290.0,335424.0,128744.0,51582.0,2509740.0,188248.0,,,471328.0,-274.0,-824.0,,-19385774.0,2463138.0,1005445.0,1601435.0,349684.0,219435.0,2714484.0,7383816.0,17106566.0,2602306.0,405092.0,230635.0,3427037.0,1014239.0,466193.0,377340.0,6622777.0,,,1090259.0,1115307.0,559006.0,201778.0,394074.0,3085522.0,194396.0,1180307.0,2308844.0,3528236.0,1479933.0,788371.0,2498796.0,5803646.0,692585.0,2180325.0,6251312.0,2432260.0,873942.0,1160986.0,9228003.0,,,1745888.0,1639783.0,683637.0,246997.0,742494.0,288192.0,1444176.0,2819971.0,4335775.0,1858133.0,4662329.0,819339.0,23453.0,158842.0,572826.0,528805.0,21620.0,449027.0,225110.0,,,72171.0,79375.0,2884.0,999.0,62602.0,6747.0,5669.0,10828.0,17922.0,100457.0,275339.0,5803646.0,692585.0,2180325.0,6345818.0,2432260.0,873942.0,1160986.0,9287558.0,,,1745888.0,1639783.0,683637.0,246997.0,742494.0,288192.0,1444176.0,2819971.0,4335775.0,1875422.0,4662329.0,5458340.0,649238.0,1272596.0,3516399.0,371663.0,7508133.0,2565130.0,17192358.0,,,3301559.0,3750859.0,2307522.0,967396.0,4207878.0,205582.0,2792451.0,5754434.0,20123504.0,26331.0,5004772.0,1551811.0,183047.0,355510.0,1460640.0,30220.0,3210564.0,1064008.0,6218160.0,,,1217549.0,685784.0,397098.0,316681.0,1907578.0,93008.0,947183.0,1715868.0,6470375.0,13456.0,2074990.0,396194.0,65156.0,182424.0,355622.0,6115.0,87880.0,67485.0,882177.0,,,493078.0,273692.0,104839.0,67335.0,88138.0,14142.0,211953.0,547851.0,839298.0,6935.0,401878.0,1551811.0,183047.0,355510.0,1460640.0,30220.0,3210564.0,1064008.0,6218160.0,,,1217549.0,685784.0,397098.0,316681.0,1907578.0,93008.0,947183.0,1715868.0,6470375.0,13456.0,2074990.0,,,,1011294.0,726980.0,,,566925.0,574483.0,501581.0,,,386112.0,331099.0,,-316602.0,,-110951.0,517389.0,1098172.0,,,386112.0,28858.0,,7705.0,,3612670.0,,291457.0,,,,985997.0,,467122.0,,,,,,,1448947.0,,1448947.0,,187949.0,,,2237180.0,,2005515.0,,-28797.0,,,-492.0,,,870064.0,870064.0,444269.0,,,,62491.0,76008.0,,,1361315.0,,,-154917.0,,,,-138.0,979348.0,1556577.0,92188.0,1556577.0,2158689.0,17273357.0,2525.0,23842283.0,48272422.0,3661330.0,13302036.0,2771340.0,2771340.0,707554.0,,,201639.0,132422.0,9967.0,552.0,533.0,,,1009534.0,11862035.0,4315670.0,4888732.0,154375.0,2644986.0,4315670.0,4888732.0,154375.0,2644986.0,942945.0,689121.0,62518.0,122209.0,18945.0,9670.0,1036057.0,16372324.0,-1922150.0,16418211.0,20627825.0,120541.0,20627825.0,8284.0,4228.0,199196.0,888007.0,187159.0,-75356.0,-87384.0,,1074057.0,2111039.0,147966.0,2111039.0,3597337.0,357918.0,775544.0,1365537.0,1410.0,518.0,54359.0,,,,,8.0,2928.0,518.0,1410.0,,,,314749.0,125012.0,,273218.0,225966.0,,,75949.0,1943876.0,,,,,,9.0,2084148.0,,,,-69801.0,-1532014.0,,73010.0,,,,,,,,,,,,,,,,,,,,,,,1296478.0,2976459.0,,24419611.0,15445638.0,,,1689795.0,3077720.0,19067971.0,,,15671.0,,,11287.0,,,,,,,,,15671.0,,,,154705.0,,420658.0,,4825937.0,2686417.0,,,4762.0,235149.0,616036.0,400021.0,2607239.0,,,154705.0,,420658.0,,4825937.0,2686417.0,,,4762.0,235149.0,616036.0,400021.0,2607239.0,,,,39174.0,55068.0,,215853.0,,132096.0,174776.0,,,1900.0,35754.0,137852.0,127721.0,504962.0,,,,5081.0,,,,,,,,30.0,,,,,,,992479.0,281880.0,194251.0,105421050.0,487743.0,95615.0,487743.0,33338894.0,33338894.0,6455156.0,,,,144955.0,184593.0,2378.0,184593.0,700509.0,941897.0,230025.0,25853.0,230025.0,237207.0,237207.0,,26660.0,,,,,,,-10547.0,,,,2926.0,,174192.0,8822.0,4728.0,1675.0,,11736.0,38.0,,204433.0,42638.0,,,,795.0,,24713.0,3573.0,1887.0,442.0,,542.0,9.0,,26518.0,8258.0,13427.0,2308.0,2314.0,29159.0,,197413.0,54711.0,784280.0,355484.0,101757.0,8063.0,6867.0,41.0,423570.0,,3428.0,822.0,1187.0,6900.0,,28007.0,22157.0,313001.0,93852.0,21636.0,373.0,1537.0,13.0,54943.0,,245.0,245.0,65.0,,,,,,,,,,,,47957.0,329459.0,379215.0,340515.0,18025.0,85139.0,678847.0,11968.0,46741.0,151342.0,89900.0,3833.0,19052.0,88056.0,,,,,114452.0,,550922.0,808332.0,20461.0,,275842.0,-33970.0,-67952.0,,-64937.0,,,,1090976.0,,,,,2087611.0,,118571.0,,2087611.0,,327277.0,11649257.0,7004358.0,118101.0,33628.0,24863.0,11165.0,,681.0,707.0,,50550.0,35638.0,18323.0,1387.0,2530.0,4515.0,10228.0,975.0,1160.0,211.0,720.0,874.0,,,118101.0,3307200.0,1454902.0,3307200.0,1454902.0,,,669166.0,414269.0,,,,,,,,,,,,,,,,,,,19709.0,23298.0,2215.0,1076.0,,,,,,,,,,,,,,,,,,,,,,,,,,,,,,,,,,,,,180662.0,,739.0,73164.0,,143.0,,,,,,,,,,,,,,,,,,,,,,-637492.0,,,,,,,,,,,,,,,,,,,,,,,,,,,,,-9.0,,,,,20700.0,,,,,,,,,,,,,55308.0,,,,,,,,,,,,,,,,,,6277.0,4.0,9173.0,91.0,,,,,,,,,,,11792.0,420.0,13788.0,227.0,,,,,,,,,,94270.0,1527.0,91216.0,1527.0,,,,,,,,,,,,,,,,,,,,,,,,,,5.0,,,,,,,,,,,,,,,,,,,,,,,,,,,,,,,,,,,,,207.0,,,,,39.0,,,,,,,,,,,,,,,,,,,,,,,,,,,,,,,,,,,,,,,,,,,,,,,,,,,,,,,,,18367.0,,,3997.0,,,,16570.0,,,,,,6.0,16570.0,3523.0,,,,,,,,,,,,,,,,16.0,71.0,1.0,119.0,102.0,2.0,,,,,,,,,,,,,,,,,,222.0,,,,,,,,,,,,,,33029.0,,,6290.0,,,17585.0,4490.0,,,,,2252.0,1156.0,,,,,,45276.0,33738.0,34691.0,9161.0,923.0,2195.0,,,,,,,,,,,,,,,,,,,,,,,,,,,,,,,,,,,,,,,,,,,,,,,,,,,,,,,,,,,,,,,,,,,,,,,1920.0,216.0,,,,,,,,,,,,,,,,,,,,,,,,,,,,,,,,1595.0,2272.0,568.0,647.0,,,,,,,,,,,,,,,,,,,,,,,,,,,3.0,,,,,,,,,,,,,,,,,,,,,,,,,,,,,,,,,,,,,,,,,,,,,,,,,,,,,,,,,,96.0,,,,,,,,,,,,,,,,,,,,13.0,,,,,,,,,,,,,,,,6.0,,,,,,,,,,,,,,,,,,,,,,,,,,,,,,,,,,,,,,,,,,,,,,,,,,,,,,,,,,,,,,,,,,,,,,,,,,,,,,,,,,,,,,,,,,,,,,,,,,,,,,,,,,,,,,,,,,,,,,,,,,,,,,,,,,,,,,,,,,,,,,,,,,,,,,,2019,PA,,N,N,10814550.0,82648.0,-73880.0,12259761.0,,12220313.0,12229081.0,122291.0,12106790.0,122597.61,UPMC NORTHWEST HOSPITAL (390091)
62017,UPMC NORTHWEST HOSPITAL (390091),Acute Care Hospitals,Voluntary non-profit - Other,-79.707926,41.360026,731464,390091,12001,5,2022-12-06 00:00:00,2020-07-01 00:00:00,2021-06-30,F,O,39,39730,2.0,3.0,,,,,,,,,,,,,,,,,,,,,,,,,,,,,,,,,,,,,,,,,,,,,3.0,,1095.0,,,,,,6113942.0,1663230.0,1786836.0,487491.0,,,,,,,,,,6113942.0,1663230.0,,66508.0,1786836.0,487491.0,,,33.53,49.51,,,,,,,,,,,,,,,,,,,,,,,,,,,,,,,,,,,116509363.0,57335.0,26655181.0,38564088.0,117875848.0,2161699.0,744974.0,1384785.0,2161699.0,,,,,,4789763.0,4743540.0,,,,,-29459789.0,34065197.0,7823765.0,100822742.0,6312709.0,,-29459789.0,-4794221.0,105428150.0,6896455.0,,105380442.0,14420532.0,,5053225.0,797570.0,,105383454.0,108449461.0,105480957.0,14420532.0,,154017787.0,24262680.0,,537771451.0,14420532.0,14420532.0,4656012.0,4755583.0,9762113.0,277805.0,225036.0,502841.0,9259272.0,9209791.0,,4755583.0,,36115.0,19475.0,10226.0,6288.0,420405.0,257494.0,36115.0,10226.0,0.195963,4374214.0,227096.0,1939121.0,2226758.0,157967.0,157967.0,157967.0,4598365.0,1028121.0,1028121.0,2.0,2.0,1.0,620.27,710.3,1395.0,1395.0,4080.0,4080.0,103.0,111.0,164.0,103.0,37583.0,40503.0,37583.0,6288.0,6549.0,6288.0,15466.0,18605.0,15466.0,1697744.0,46452803.0,-26417.0,,,,-14825478.0,-3676699.0,,2253061.0,,46223.0,1193261.0,2602421.0,4926964.0,199387.0,4926964.0,14620012.0,383753664.0,4926964.0,4926964.0,494566.0,550672.0,20013.0,21796.0,528876.0,1435110.0,7113.0,714.0,20013.0,,60.0,60.0,24.0,696.0,28.0,10220.0,714.0,193.0,1016.0,117.0,193.0,7113.0,34065197.0,3042934.0,2674007.0,666548.0,1014354.0,1000879.0,834281.0,247500.0,,33941435.0,3986729.0,29954706.0,49021756.0,33699774.0,3834679.0,29865095.0,48932145.0,7897576.0,-29907.0,75322903.0,75322903.0,12110219.0,12088736.0,11839988.0,2244700.0,9599259.0,11788220.0,9613365.0,9612295.0,150904.0,98088.0,43252.0,9710383.0,9710383.0,9576432.0,133951.0,3179525.0,-204473.0,,624024.0,,,,,,263462.0,,,-4000.0,,,1246402.0,206055.0,33823536.0,2885458.0,,2398552.0,,667446.0,,1025394.0,596735.0,834221.0,1260892.0,247500.0,206441.0,1295593.0,26.11,1293148.0,1139006.0,26.06,26.22,35.86,,,16278.0,14106.0,,0.92,0.92,,,1208000.0,1702736.0,23291.0,2968504.0,1702736.0,1305620.0,1272.0,287637.0,12910620.0,4440398.0,870154.0,870154.0,79038309.0,728.0,1272.0,4009.0,8052269.0,,,8052269.0,,,57869.0,41.45,10340541.0,10340541.0,307773.0,34.62,25.66,,32191.0,,,,,,,,,14032.0,,,,,658.0,,91.0,,3971.0,3971.0,31612.0,31612.0,31612.0,27641.0,3971.0,,1914.0,290094.0,659243.0,,1093104.0,220676.0,290094.0,659243.0,,1093104.0,223147.0,120121.0,5329.0,4385.0,,,27923.0,68918.0,34616.0,21424.0,14190.0,12222.0,9405.0,24.02,54.44,150.34,,,23.9,14.88,17.24,38.94,15.73,20.25,21.95,8726509.0,8726509.0,154142.0,225667.0,24.88,38.67,,,,,12078.0,,21483.0,170215.0,170215.0,,30954.0,,3880.0,,1070.0,21483.0,470450.0,92191.0,67274.0,355.0,,5991.0,13945.0,10106.0,95688.0,105336.0,13945.0,10106.0,,95688.0,105336.0,,1650.76,36452.0,630.0,,57.97,34.59,167.2,1364673.0,54112.0,,,,,,,,,,,,317.0,,,,,,,,,,681994.0,943795.0,51280.0,217045.0,-869260.0,-1153.0,737763.0,1719550.0,123915.0,1720703.0,3889091.0,56106.0,1783.0,1720703.0,1720703.0,885906.0,613851.0,1499757.0,63800.0,21617.0,85417.0,1414340.0,391962.0,,56106.0,,2445832.0,1994081.0,,613851.0,,2593.0,1335.0,63800.0,62.0,90.0,,175.0,9.0,3285.0,1335.0,,2593.0,943795.0,416263.0,24648.0,16.89,,,,1165623.0,,2435047.0,,137031.0,,2435047.0,,5428131.0,,2435047.0,1044606.0,385740.0,1819813.0,385740.0,,,2258.0,21.14,16.0,5840.0,1628.0,38.0,3795.0,949221.0,,34021.0,,27.9,,,,,,,,,,,,,,,,,,,,,,,,,,,,,,,,,,,,,,,,,,30285.0,1171.0,110.0,231.0,,,,,76.0,,,,,,,,,,,325.0,3374.0,661.0,336.0,,,,20985.0,20985.0,106.0,197.97,,,,,,,,,,,,,,24917.0,,,,,,,,,,,,,,,,,,,,,,,,,,,,,1269172.0,4245.0,4245.0,624024.0,649393.0,,,,,,,,,,,,,,,,,,,,,,,,,,,,,,,,,,,,,,,,,,,,,,,,,,,,,,,,,,,,,,,,,,,,,,,,,,,,,,,,,,,,,,,,,,,,,,,,,,,,,,,,,,,-5000.0,,,,,,,,,,,,,,,,,,,,,35.0,170215.0,170215.0,215.0,170215.0,170215.0,,,,,,,,,,,,,,,,,,,,,,,,,,,,,,110.0,,,,,,,,,,,,,,,,,,,,,,,,,,,,,,,,,,,,,,,,,,,,,,,,,,,,,,,,,,,,,,,,,,1.0,,,,,,,,,,,,,,,,,,,,,,,,,,,,,,,,,,,,,,,,,,,,,,,,,,,,,,,,,,,,,,,,,,,,,,,,,,727680.0,4.0,4570000.0,,,,,,,,,,,,,,,,,,,,,,,,,,,,,,,,,,,,,,,,,,,,2.0,,,349377.0,,,,,,,,,,,,,,,,,,,,,,,,,,,,,,,,,,,,,100 FAIRFIELD DRIVE,SENECA,16346,VENANGO,UPMC NORTHWEST HOSPITAL,99939,P,2,Y,N,N,Y,Y,N,,N,N,,N,N,Y,N,Y,Y,,UPMC NORTHWEST-PSYCHIATRIC,39S091,HO0164,UPMC,200 LOTHROP STREET,PITTSBURGH,PA,15213,,Y,,,,,,UPMC NORTHWEST-REHAB UNIT,39T091,395966,,,,,,,,,,,,,,,,,,,,,,,,,,,,,,,,,,,,,,,,,,,,,,,,,,,,,,,,,,,,,,,,,,,,,,,,,,,,,,,,,,,,,,,,,,,,,,,,,,,,,,,,,,,,,,,,,,,,,,,,,,,,,,,,,,,,,,,,,,,,,,,,,,,,,,,,,,,,,,,,,,,,,,,,,,2265090.0,2524673.0,2234582.0,2508958.0,-10957612.0,1246402.0,247500.0,206055.0,2674007.0,698990.0,124.0,,371920.0,1014354.0,,797488.0,4736339.0,79700.0,16361.0,,319221.0,46011581.0,4833452.0,108144.0,115979.0,2425846.0,864557.0,5912713.0,,435033.0,1014831.0,343543.0,126599.0,62608.0,2085535.0,226042.0,,,461640.0,-311.0,,2609.0,-19966340.0,2265090.0,1061986.0,1756661.0,327200.0,225411.0,2524673.0,7182356.0,17061499.0,2661296.0,447483.0,271228.0,3710330.0,916331.0,483615.0,425354.0,7786857.0,,,1163497.0,1163675.0,595864.0,195330.0,430529.0,2763132.0,190809.0,1409682.0,2562201.0,4239544.0,1532161.0,922233.0,2607462.0,6279837.0,743869.0,2111847.0,6514391.0,2229882.0,870675.0,996190.0,10477025.0,,,1866846.0,1666812.0,721741.0,236803.0,760343.0,279546.0,1707227.0,3096288.0,5150758.0,2031206.0,4718284.0,810498.0,22676.0,115664.0,579071.0,518390.0,19826.0,268113.0,233411.0,,,206826.0,74921.0,3345.0,937.0,52869.0,6636.0,6032.0,10614.0,18989.0,97457.0,254905.0,6279837.0,743869.0,2111847.0,6533897.0,2229882.0,870675.0,996190.0,10536580.0,,,1866846.0,1666812.0,721741.0,236803.0,760343.0,279546.0,1707227.0,3096288.0,5150758.0,2048495.0,4718284.0,5560951.0,644553.0,1284342.0,3921231.0,267830.0,7964450.0,2216881.0,18140414.0,,,3771121.0,4118065.0,2474767.0,1053610.0,4595834.0,222741.0,3332149.0,5818712.0,24341563.0,10312.0,5373436.0,1241792.0,151439.0,283399.0,1538246.0,106407.0,3077784.0,839342.0,6016578.0,,,1168000.0,707407.0,414083.0,314343.0,1840511.0,81668.0,1035518.0,1277470.0,7110756.0,5356.0,2021363.0,307042.0,52144.0,123770.0,313117.0,20571.0,74461.0,41376.0,851063.0,,,462200.0,261549.0,108492.0,57030.0,73199.0,10511.0,207198.0,431578.0,891212.0,2895.0,381591.0,1241792.0,151439.0,283399.0,1538246.0,106407.0,3077784.0,839342.0,6016578.0,,,1168000.0,707407.0,414083.0,314343.0,1840511.0,81668.0,1035518.0,1277470.0,7110756.0,5356.0,2021363.0,,,,1000879.0,834281.0,,,666548.0,684581.0,590068.0,,,378696.0,285459.0,,-275581.0,,-40048.0,472355.0,1273538.0,,,378696.0,26895.0,,7158.0,,3778976.0,,639783.0,,,,323325.0,,855805.0,,,,,,,2045319.0,,2045319.0,,256346.0,,-4000.0,2342779.0,,2048051.0,,-24077.0,,,-564.0,,,873191.0,873191.0,468064.0,,,,39603.0,47708.0,,,1450105.0,,,-147804.0,,,,45127.0,1208000.0,1795502.0,78900.0,1795502.0,2333658.0,19837080.0,19973.0,29391629.0,56347696.0,5200090.0,16754890.0,3059148.0,3059148.0,756396.0,-2300.0,,198451.0,165789.0,-450.0,5706.0,-886.0,,,946483.0,14522080.0,4947331.0,5253674.0,147722.0,2853236.0,4947331.0,5253674.0,147722.0,2853236.0,929531.0,738950.0,58456.0,113476.0,21247.0,10944.0,1051027.0,17243647.0,-791731.0,16989338.0,21064376.0,110783.0,21064376.0,9261.0,4771.0,220676.0,1083391.0,257036.0,-71676.0,-85804.0,,1352575.0,2507343.0,145297.0,2507343.0,5019028.0,390140.0,350518.0,1661148.0,1867.0,261.0,20311.0,,,,,8.0,2920.0,261.0,1867.0,,,,335499.0,157215.0,,290518.0,244189.0,,,63607.0,1939040.0,,,,,,9.0,1959334.0,,,,-98760.0,-1330046.0,,68809.0,,,,,,,,,,,,,,,,,,,,,,,1515814.0,3551195.0,,28024858.0,17586719.0,,,1949309.0,3346307.0,19620272.0,,,12443.0,,,9492.0,,,,,,,,,12443.0,,,,190533.0,,524201.0,,4899426.0,2852747.0,,,9551.0,288512.0,889957.0,828680.0,2473993.0,,,190533.0,,524201.0,,4899426.0,2852747.0,,,9551.0,288512.0,889957.0,828680.0,2473993.0,108.0,,,30954.0,65605.0,,228937.0,,118532.0,144309.0,,,3531.0,37132.0,178072.0,279960.0,467038.0,14.0,,,3880.0,,,,,,,,95.0,,,,,,,854882.0,279913.0,251626.0,129359742.0,392275.0,26157.0,392275.0,36906544.0,36906544.0,5985344.0,,,,117978.0,149807.0,2079.0,149807.0,955859.0,959463.0,348276.0,27240.0,348276.0,264918.0,264918.0,,20721.0,,,,,,,-31458.0,,,,2372.0,,140502.0,11928.0,4837.0,1221.0,,12813.0,,,159000.0,38123.0,,,,555.0,,19874.0,4720.0,1788.0,320.0,,510.0,,,19928.0,7197.0,13057.0,3229.0,2826.0,29102.0,,206762.0,64630.0,924722.0,422963.0,141773.0,20634.0,8118.0,,489472.0,,3228.0,1112.0,1234.0,6226.0,,29247.0,25575.0,341897.0,110818.0,25721.0,821.0,1624.0,,61347.0,,8785.0,8785.0,2302.0,,,,,,,,,,,,40859.0,265242.0,279627.0,259003.0,15793.0,79166.0,516862.0,7782.0,37519.0,103386.0,67860.0,2865.0,15840.0,64780.0,,,,,107879.0,,457078.0,932187.0,17911.0,,288829.0,-33970.0,-55437.0,,-409250.0,,-74.0,,1209160.0,,,,,2202027.0,,110280.0,,2202027.0,,208617.0,11266403.0,11419904.0,96435.0,18261.0,10043.0,9947.0,,243.0,490.0,,,45889.0,15873.0,5667.0,4583.0,887.0,,1110.0,782.0,729.0,868.0,167.0,,,96435.0,3291348.0,2195280.0,3291348.0,2195280.0,,,636306.0,415707.0,,,,,,,550.0,77.0,,,,,,,,,,,8091.0,7386.0,633.0,294.0,,,,,,,,,,,,,,,,,,,,,,,,,,,,,,,,,,,,,149725.0,,1035.0,59249.0,,195.0,,,,,,,,,,,,,,,,,,,,,,-839113.0,,,,,,,,,,,,,,,,,,,,,,,,,,,,,,,,,,40728.0,,,,,,,,,,,,,6980.0,,,,,,,,,,,,,,,,,,4963.0,13.0,7042.0,60.0,,,,,,,,,,,9679.0,395.0,11210.0,199.0,,,,,,,,,,85107.0,1379.0,82350.0,1379.0,,,,,,,,,,,,,,,,,,,,,,,,,,6.0,,,,,,,,,,,,,,,,,,,,,,,,,,,,,,,,,,,,,,,,,,,,,,,,,,,,,,,,,,,,,,,,,,,,,,,,,,,,,,,,,,,,,,,,,,,,,520.0,656.0,397.0,84.0,,,41616.0,,,1030.0,,,,4301.0,,,,,,,4301.0,780.0,,,,,,,,,,,,,,,,11.0,23.0,1.0,109.0,105.0,1.0,,,,,,,,,,,,322.0,109.0,,,,,,,,,,,,,,,,,,,118242.0,,,18872.0,,,7974.0,1972.0,,,,,901.0,393.0,,,,,,9455.0,42966.0,16221.0,1828.0,1039.0,799.0,,,,,,,,,,,,,,,,,,,,,,,,,,,,,,,,,,,,,,,,,,,,,,,,,,,,,,,,,,,,,,,,,,,,,,,4029.0,315.0,,,,,,,,,,,,,,,,,,,,,,,,,,,,,,,,943.0,,325.0,,,,,,,,,,,,,,,,,,,,,,,,,,,,1.0,,,,,,,,,,,,,,,,,,,,,,,,,,,,,,,,,,,,,,,,,,,,,,,,,,,,,,,,,,,,,,,,,,,,,,,,,,,,,,,,,,,,,,,,,,,,,,,,,,,,,,,,,,,,,,,,,,,,,,,,,,,,,,,,,,,,,,,,,,,,,,,,,,,,,,,,,,,,,,,,,,,,,,,,,,,,,,,,,,,,,,,,,,,,,,,,,,,,,,,,,,,,,,,,,,,,,,,,,,,,,,,,,,,,,,,,,,,,,,,,,,,,,2020,PA,,N,N,10877852.0,-89704.0,129087.0,12188237.0,,12145592.0,12184975.0,121850.0,12063125.0,121882.37,UPMC NORTHWEST HOSPITAL (390091)
68800,UPMC NORTHWEST HOSPITAL (390091),Acute Care Hospitals,Voluntary non-profit - Other,-79.707926,41.360026,732082,390091,12001,1,2022-12-07 00:00:00,2021-07-01 00:00:00,2022-06-30,F,O,39,39730,2.0,3.0,,,,,,,,,,,,,,,,,,,,,,,,,,,,,,,,,,,,,,,,,,24985.0,,,3.0,,1095.0,,,,,,6278608.0,1744571.0,1563592.0,474059.0,,,,,,,,,,6278608.0,1744571.0,,66508.0,1563592.0,474059.0,,,35.03,51.63,,,,,,,,,,,,,,,,,,,,,,,,,,,,,,,,,,,118701596.0,57335.0,27400155.0,39948873.0,119413524.0,1770051.0,136066.0,1378533.0,1770051.0,,,,,,4781893.0,4731803.0,,,,,-34795428.0,40484805.0,10002113.0,112629528.0,8378997.0,,-34795428.0,-6897965.0,118318905.0,9259395.0,,118194306.0,18206463.0,,5071631.0,915449.0,,118312374.0,121939455.0,118372022.0,18206463.0,,171757157.0,32125934.0,,590490569.0,18206463.0,18206463.0,5145066.0,4405830.0,10105493.0,287121.0,196282.0,483403.0,9622090.0,10625881.0,,4405830.0,,38764.0,23323.0,10516.0,6591.0,417383.0,258697.0,38764.0,10516.0,0.200363,3917193.0,147452.0,1765754.0,5026896.0,195856.0,195856.0,195856.0,3944505.0,946947.0,946947.0,2.0,2.0,1.0,547.81,617.04,1225.0,1225.0,4089.0,4089.0,111.0,119.0,172.0,111.0,39475.0,42395.0,39475.0,6591.0,6994.0,6591.0,18753.0,22102.0,18753.0,1697744.0,46426386.0,39906.0,,,,-18117994.0,-3520581.0,,3004840.0,,50090.0,1374657.0,2869377.0,4902733.0,161029.0,4902733.0,10630047.0,418733412.0,4902733.0,4902733.0,563521.0,599604.0,18507.0,19577.0,580027.0,1398495.0,5281.0,607.0,18507.0,,34.0,34.0,18.0,514.0,28.0,8148.0,607.0,241.0,861.0,110.0,241.0,5281.0,40484805.0,3834806.0,2907223.0,935865.0,1220713.0,1083240.0,940056.0,266597.0,,40352062.0,4863682.0,35488380.0,56015867.0,37867614.0,3763900.0,34103714.0,54631201.0,8510902.0,,76580149.0,76580149.0,13071247.0,13052205.0,12172186.0,2253442.0,9920242.0,12136603.0,9928550.0,9926741.0,103285.0,67135.0,28571.0,9993876.0,9994125.0,9873051.0,96089.0,3233637.0,6846.0,,269246.0,,,,,,289738.0,,,-1250.0,,,1339850.0,229481.0,38000357.0,2699259.0,,2060983.0,,959596.0,,1263237.0,701703.0,974090.0,1381259.0,266597.0,234781.0,1283458.0,29.61,1281131.29,1132897.29,29.56,30.1,40.12,,,16931.0,8308.0,,,,,,2081656.0,3057882.0,33140.0,3567433.0,3057882.0,1206120.0,1113.0,3261142.0,12451027.0,3748649.0,751091.0,751091.0,85826849.0,592.0,1113.0,4570.0,8241675.0,,,8241675.0,,,54.96,37499.69,10295762.0,10295762.0,533.65,30.19,15948.47,,35744.0,,,,,,,,,14346.0,,,,,,,,,1498.0,1498.0,14876.0,14876.0,14876.0,13378.0,1498.0,,2887.0,1858795.0,349751.0,,1145562.0,204884.0,1858795.0,349751.0,,1145562.0,216174.0,114973.0,13688.0,2132.0,,,25.27,17.16,31.11,40.08,16.27,21.45,24.37,23.48,135.8,164.05,,,37973.72,73615.21,22555.54,24303.64,13286.66,12428.76,9634.02,10231725.0,10231725.0,148234.0,228833.0,25.39,44.71,,,,,10461.0,,19042.0,155448.0,155448.0,,14876.0,,1498.0,,1809.0,19042.0,529686.0,106129.0,60045.0,352.0,,7308.0,16436.0,13307.0,136202.0,105833.0,16436.0,13307.0,,136202.0,105833.0,,1261.0,35.33,1041.0,,108.01,39095.92,101.66,1361730.29,212125.0,,-249.0,,,,,,,,,,298.0,,5.0,,,,,,,,714229.0,1028876.0,55874.0,324283.0,-767303.0,-93.0,773064.0,1782714.0,127454.0,1782807.0,4054660.0,36083.0,1070.0,1782807.0,1782807.0,790955.0,520813.0,1311768.0,56545.0,16290.0,72835.0,1238933.0,266569.0,,36083.0,,2110771.0,1787812.0,,520813.0,,2547.0,1130.0,56545.0,80.0,73.0,,166.0,9.0,3285.0,1130.0,,2547.0,1028876.0,429872.0,18.36,23413.51,,,,1389777.0,,2542555.0,,131902.0,,2542555.0,,6508253.0,,2542555.0,1064360.0,421778.0,2037316.0,421778.0,,,3093.0,15.99,16.0,5840.0,1785.0,,4264.0,1064641.0,,33261.0,,32.01,,,,,,,,,,,,,,,,,,,,,,,,,,,,,,,,,,,,,,,,,,16541.0,1240.0,97.0,206.0,,,,,,,,,,,,,,,,307.0,4563.0,914.0,607.0,,,,22610.0,22610.0,249.29,90.7,,,,,,,,,,,,,,46084.0,,,,,,,,,,,,,,,,,,,,,,,,,,,,,649394.0,3421.0,3421.0,269246.0,383569.0,,,,,,,,,,,,,,,,,,,,,,,,,,,,,,,,,,,,,,,,,,,,,,,,,,,,,,,,,,,,,,,,,,,,,,,,,,,,,,,,,,,,,,,,,,,,,,,,,,,,,,,,,,2006000.0,,,,,,,,,,,,,,,,,,,,,,24.0,155448.0,155448.0,166.0,155448.0,155448.0,,,,,,,,,,,,,,,,,,,,,,,,,,,,,,97.0,,,,,,,,,,,,,,,,,,,,,,,,,,,,,,,,,,,,,,,,,,,,,,,,,,,,,,,,,,,,,,,,,,1.0,,,,,,,,,,,,,,,,,,,,,,,,,,,,,,,,,,,,,,,,,,,,,,,,,,,,,,,,,,,,,,,,,,,,,,,,,,722583.0,3050000.0,,,,,,,,,,,,,,,,,,,,,,,,,,,,,,,,,,,,,,,,,,,,,,,,226851.0,,,,,,,,,,,,,,,,,,,,,,,,,,,,,,,,,,,,,100 FAIRFIELD DRIVE,SENECA,16346,VENANGO,UPMC NORTHWEST HOSPITAL,99939,P,2,Y,N,N,Y,Y,N,,N,N,,N,N,Y,N,Y,Y,,UPMC NORTHWEST-PSYCHIATRIC,39S091,HO0164,UPMC,200 LOTHROP STREET,PITTSBURGH,PA,15213,,Y,,,,,,UPMC NORTHWEST-REHAB UNIT,39T091,395966,,,,,,,,,,,,,,,,,,,,,,,,,,,,,,,,,,,,,,,,,,,,,,,,,,,,,,,,,,,,,,,,,,,,,,,,,,,,,,,,,,,,,,,,,,,,,,,,,,,,,,,,,,,,,,,,,,,,,,,,,,,,,,,,,,,,,,,,,,,,,,,,,,,,,,,,,,,,,,,,,,,,,,,,,,2316757.0,2465136.0,2283946.0,2447857.0,-13156853.0,1339850.0,266597.0,229481.0,2907223.0,858892.0,,,398494.0,1220713.0,,879414.0,4500181.0,48803.0,17666.0,,248449.0,50122649.0,4562985.0,94166.0,102861.0,2866198.0,855954.0,5675969.0,,585972.0,1273237.0,474944.0,109283.0,54193.0,2125052.0,211350.0,,,482196.0,-179.0,-116.0,,-21917102.0,2316757.0,1233399.0,1789182.0,315284.0,252756.0,2465136.0,7372207.0,18591745.0,2876728.0,471377.0,254079.0,3589724.0,936896.0,632733.0,462196.0,7848071.0,,,1474102.0,1307990.0,672597.0,183122.0,458646.0,3092294.0,111754.0,1439829.0,2327060.0,4078059.0,1746898.0,931247.0,3579278.0,6132928.0,767459.0,2141526.0,6437617.0,2283613.0,1063070.0,899283.0,10501035.0,,,2206603.0,1849864.0,808114.0,220096.0,768682.0,175572.0,1729828.0,2789249.0,4920533.0,2061629.0,5782181.0,776476.0,22096.0,118538.0,683636.0,525569.0,20925.0,142233.0,218070.0,,,249957.0,76582.0,3781.0,722.0,28155.0,5950.0,5639.0,8759.0,17125.0,93425.0,250513.0,6132928.0,767459.0,2141526.0,6437617.0,2283613.0,1063070.0,899283.0,10560590.0,,,2206603.0,1849864.0,808114.0,220096.0,768682.0,175572.0,1729828.0,2789249.0,4920533.0,2061629.0,5782181.0,4736025.0,577751.0,1074072.0,4418800.0,463113.0,9137047.0,2377235.0,19796231.0,,,5264699.0,4397048.0,2597977.0,1090746.0,5323372.0,262849.0,3571704.0,3502118.0,30617993.0,22295.0,6046870.0,857909.0,115887.0,196073.0,1432194.0,151731.0,3297842.0,749044.0,5994337.0,,,1315764.0,657755.0,382426.0,278752.0,1938631.0,103708.0,955200.0,679852.0,8283950.0,11699.0,2059721.0,201865.0,42370.0,85457.0,277164.0,27248.0,88095.0,30180.0,786049.0,,,446702.0,247803.0,105641.0,47364.0,74715.0,13324.0,175233.0,225667.0,833954.0,5480.0,443501.0,857909.0,115887.0,196073.0,1432194.0,151731.0,3297842.0,749044.0,5994337.0,,,1315764.0,657755.0,382426.0,278752.0,1938631.0,103708.0,955200.0,679852.0,8283950.0,11699.0,2059721.0,,,,1083240.0,940056.0,,,935865.0,695080.0,465401.0,,,354947.0,283349.0,,-276811.0,,-40985.0,502047.0,1247958.0,,,354947.0,29316.0,,7353.0,,4379110.0,,286407.0,,,,323539.0,,469573.0,,,,,,,1833904.0,,1833904.0,,184621.0,,-1250.0,2459518.0,,2418294.0,,-27695.0,,,-587.0,,,1457277.0,1457277.0,682591.0,,,,50795.0,60709.0,,,1573469.0,,,-150555.0,,,,-452.0,1156814.0,1676332.0,32453.0,1676332.0,2039799.0,21328373.0,17053.0,30429602.0,60737949.0,5857615.0,18259519.0,3182683.0,3182683.0,748882.0,,,217896.0,169501.0,-1620.0,5655.0,1941.0,,,1234868.0,14621634.0,5198114.0,5578502.0,165508.0,2639741.0,5198114.0,5578502.0,165508.0,2639741.0,914175.0,727392.0,56190.0,101736.0,23414.0,12330.0,1029590.0,22646013.0,-1344822.0,22035493.0,26935967.0,126085.0,27083351.0,9397.0,4949.0,204884.0,1462633.0,317138.0,-73936.0,-172912.0,-26.0,1828654.0,3077122.0,157715.0,3077122.0,7068846.0,513131.0,554597.0,1872149.0,2236.0,403.0,28424.0,,,,,8.0,2920.0,403.0,2236.0,,,,373261.0,144684.0,,416232.0,270866.0,,,57338.0,2896626.0,,,,,,,2145606.0,,,,-156934.0,-1504954.0,,52215.0,,,,,,,,,,,,,,,,,,,,,,,1521354.0,3839442.0,,30658419.0,19414134.0,,,1103708.0,4900891.0,20806850.0,,,,,,,,,,,,,,,,,,,168910.0,,519768.0,,5293313.0,2794612.0,,,5510.0,119159.0,892356.0,974496.0,2513822.0,,,168910.0,,519768.0,,5293313.0,2794612.0,,,5510.0,119159.0,892356.0,974496.0,2513822.0,,,,14876.0,61756.0,,226538.0,,141400.0,116425.0,,,2076.0,15309.0,163704.0,323469.0,541279.0,,,,1498.0,,,,,,,,28.0,,,,,,,1546067.0,327434.0,204575.0,141785913.0,632691.0,206527.0,632691.0,37302673.0,37302673.0,6976716.0,,,,133195.0,168043.0,2173.0,168043.0,983315.0,1816141.0,333624.0,20026.0,333624.0,364603.0,364603.0,,21886.0,,,,,,,49197.0,,,,2554.0,,78944.0,10557.0,4032.0,2889.0,,5935.0,,,125536.0,21527.0,,,,525.0,,10352.0,3584.0,1519.0,798.0,,229.0,,,12638.0,4635.0,22337.0,780.0,1365.0,17823.0,,159549.0,38557.0,769895.0,371107.0,166512.0,22875.0,4924.0,,440279.0,,5256.0,285.0,595.0,3593.0,,20922.0,13090.0,290051.0,102514.0,28293.0,882.0,903.0,,44323.0,,,,,,,,,,,,,,,,46299.0,306530.0,324402.0,280156.0,22080.0,77098.0,537111.0,7780.0,40196.0,122216.0,77390.0,3752.0,14144.0,54072.0,,,,,115737.0,,458172.0,979202.0,29088.0,,238759.0,32538.0,-95108.0,,-383791.0,,,,1253602.0,,,,,2276297.0,,111796.0,,2276297.0,,266441.0,12253078.0,13205157.0,100404.0,16965.0,9217.0,2013.0,174.0,246.0,81.0,82.0,,56060.0,14130.0,1491.0,,3014.0,,1498.0,569.0,192.0,,649.0,,,100404.0,2686141.0,2421628.0,2686141.0,2421628.0,,,482385.0,409182.0,,,,,,,,,,,,,,,,,,,9170.0,13124.0,550.0,506.0,,,,,,,,,,,,,,,,,,,,,,,,,,,,,,,,,,,,,146418.0,,1601.0,49709.0,,345.0,,,,,,,,,,,,,,,,,,,,,,-1345155.0,,,,,,,,,,,,,,,,,,,,,,,,,,,,,,,,,,5581.0,,,,,,,,,,,,,55128.0,,,5873.0,,,,,,,,,,,,58017.0,,,4169.0,15.0,6233.0,44.0,,,,,,,,,,,8610.0,266.0,10004.0,162.0,,,,,,,,,,77724.0,1259.0,75206.0,1259.0,,,,,,,,,,,,,,,,,,,,,,,,,,,,,,,,,,,,,,,,,,,,,,,,,,,,,,,,,,,,,,,2234.0,,,,,980.0,,,,,,,,,,,,,,,,,,,,,,,,,,,,,,,,,,,,,,,,,,,,,,,,,,,423.0,534.0,345.0,69.0,,,15819.0,,,6943.0,,,,3745.0,,,,,,,3745.0,636.0,,,,,,,,,,,,,,,,7.0,17.0,,59.0,106.0,1.0,,,,,,,,,,,,23153.0,7685.0,,,,,,,,,,,,,,,,,,1881.0,130067.0,,242.0,24067.0,,,28097.0,6611.0,,,,,5695.0,2482.0,,,,,,38023.0,29211.0,11884.0,6828.0,780.0,479.0,,,,,,,,,,,,,,,,,,,,,,,,,,,,,,,,,,,,,,,,,,,,,,,,,,,,,,,,,,,,,,,,,,,,,,,4254.0,255.0,,,,,,,,,,,,,,,,,,,,,,,,,,,,,,,,5316.0,,1944.0,,,,,,,,,,,,,,,,,,,,,,,,,,,,1.0,,,,,,,,,,,,,,,,,,,,,,,,,,,,,,,,,,,,,,,,,,,,,,,,,,,,,,,,,,,,,,,,,,,,,,,,,,,,,,,,,,,,,,,,,,,,,,,,,,,,,,,,,,,,,,,,,,,,,,,,,,,,,,,,,,,,,,,,,,,,,,,,,,,,,,,,,,,,,,,,,,,,,,,,,,,,,,,,,,,,,,,,,,,,,,,,,,,,,,,,,,,,,,,,,,,,,,,,,,,,,,,,,,,,,,,,,,,,,,,,,,,,,2021,PA,,,,,,,,,,,,,,UPMC NORTHWEST HOSPITAL (390091)
