,Curated Name and Num,Hospital type (modified),S2_1_C1_21,Lon,Lat,D_4_HOS_C1_91,S3_1_C10_1801,B_1_C21_21,A_C6_44,D_4_IPF_C3_200,S3_2_C6_31,S3_1_C2_2001,D3_HOS_C3_73,D_4_HOS_C11_67,D3_IPF_C3_70,E_B_HOS_C1_29,B_1_C0_4201,D4_ISLET_C1_69,C_1_C7_50,D_5_HOS_C2_66,B_1_C0_88,A_C1_9201,S2_1_C2_1503,D_5_HOS_C2_200,A_C2_9,C_1_C5_4201,S3_2_C6_43,S2_1_C1_56,D3_IPF_C3_94,C_1_C5_202,S3_2_C4_36,C_1_C6_107,D_4_HOS_C13_65,D3_IRF_C3_200,D_5_HOS_C3_63,G_C1THRU4_25,C_1_C5_46,C_1_C5_4501,D1_IPF_C1_49,B_1_C0_6250,A_C2_94,D_5_HOS_C6_74,S10_C1_9,D_4_HOS_C2_51,D3_SNF_C3_62,D_4_HOS_C10_66,A_C2_117,C_1_C5_43,S2_1_C1_11801,S3_1_C2_21,S4_HHA1_C4_38,D_4_IRF_C13_50,B_1_C26_70,D_4_IRF_C13_65,A_C2_101,D3_IPF_C3_72,A_C1_46,S3_2_C4_18,A_C6_65,D_4_IRF_C13_54,B_1_C22_59,B_2_C26_4201,C_1_C7_65,D_5_HOS_C3_68,D_4_IRF_C11_57,S5_C1_9,D_5_HOS_C4_60,S3_1_C6_32,B_2_C26_202,D_1_HOS_C7_40,S3_2_C6_26,A8_C2_20,B_1_C0_50,D_4_IRF_C11_90,A_C6_21,A_C6_97,S3_2_C2_2550,C_1_C5_63,S3_1_C7_15,S3_1_C15_21,C_1_C6_98,D_4_IRF_C13_91,E_B_HOS_C1_23,C_1_C6_100,D_5_HOS_C6_66,D3_IPF_C3_57,D_5_HOS_C3_91,C_1_C6_45,S3_3_C5_7,A7_1_C2_10,D_5_HOS_C6_56,D3_IRF_C2_91,D_4_HOS_C11_94,S4_HHA3_C1_33,D_5_HOS_C3_90,A_C6_9940,S3_1_C4_9,A8_C2_16,S3_2_C5_38,B_1_C22_112,D_4_HOS_C3_91,S3_2_C5_3,B_1_C0_73,S2_1_C1_126,D3_HOS_C2_63,S3_2_C4_1401,A_C6_62,A_C2_41,D3_SNF_C2_31,S3_2_C2_42,S3_2_C2_12,A_C2_100,D_4_IRF_C11_59,D1_IPF_C1_48,A_C1_40,S3_2_C4_31,D3_SNF_C2_53,S2_1_C2_16,S3_2_C4_15,A_C6_17,D3_HOS_C2_67,S3_1_C9_21,A_C1_19,S2_1_C2_3801,S3_3_C2_6,D_5_HOS_C3_57,D3_IRF_C2_64,D_4_IPF_C13_75,A_C1_42,E_B_HOS_C1_37,B_1_C0_93,B_1_C21_57,B_2_C26_193,B_1_C0_108,D_4_IPF_C11_51,D_4_HOS_C11_200,B_1_C22_76,C_1_C6_73,D_4_HOS_C2_52,D_5_HOS_C4_69,D_4_IRF_C13_90,D_5_HOS_C7_94,D3_IRF_C3_67,B_1_C0_9930,S4_HHA3_C2_35,A_C6_106,A_C1_9920,S2_1_C1_128,D_5_HOS_C2_65,D_4_HOS_C12_90,S3_1_C6_22,S3_2_C2_10,B_1_C21_94,D_5_HOS_C7_96,B_1_C0_200,E_B_HOS_C1_10,S2_1_C2_14,D1_IRF_C1_52,A_C2_46,D_3_HOS_C9_44,B_1_C0_4,S3_1_C13_17,S3_2_C3_1401,D3_IPF_C3_64,S4_HHA1_C2_38,D_4_IPF_C13_74,D_5_HOS_C2_91,S3_1_C11_25,A_C1_56,A_C6_98,D_4_HOS_C13_72,A_C6_112,D_4_SNF_C11_72,A_C6_61,D_5_HOS_C4_96,D3_IPF_C3_60,A_C2_109,C_1_C5_111,B_1_C22_63,D_4_IRF_C11_56,D_4_HOS_C2_62,S3_1_C7_13,S3_2_C2_30,B_2_C26_117,S4_HHA1_C1_35,D3_HOS_C2_76,D3_IPF_C2_90,S3_2_C3_2550,D3_IPF_C2_60,S3_1_C10_20,B_1_C26_106,D_4_SNF_C13_73,D1_HOS_C1_37,A_C2_89,B_1_C22_111,C_1_C7_76,A_C2_59,B_1_C21_9201,S3_2_C2_17,D_4_HOS_C2_65,A_C1_17,D_4_HOS_C11_55,D_4_IPF_C13_55,D3_SNF_C3_51,B_1_C22_46,D3_IRF_C2_58,D_5_HOS_C2_96,C_1_C5_73,S3_2_C2_15,S2_1_C2_1801,S10_C1_16,A_C1_99,C_1_C5_40,D_4_HOS_C12_64,A_C1_68,D_4_IPF_C13_69,D3_IPF_C3_200,S3_2_C5_39,S2_1_C2_1808,S3_2_C5_2,C_1_C7_91,D_4_HOS_C10_98,A7_3_C9_3,S2_1_C1_2,D3_IRF_C2_61,C_1_C6_202,S2_1_C1_115,C_1_C6_4201,C_1_C6_69,S3_1_C2_12,B_1_C0_9940,A_C6_30,A_C6_107,D_4_HOS_C12_58,E_B_HOS_C1_36,S3_2_C5_1,B_1_C21_60,D_4_HOS_C2_90,D3_IRF_C2_54,A_C6_57,S4_HHA1_C4_33,A_C2_95,D_1_HOS_C7_33,D_4_HOS_C4_66,CENSUS,B_1_C0_15,B_2_C26_194,S3_1_C5_9,A7_1_C5_8,A_C1_73,S10_C1_1,D_4_HOS_C4_52,D_3_HOS_C9_40,D3_IRF_C3_51,D3_SNF_C2_69,B_1_C26_93,D3_IRF_C3_59,A_C2_90,D_5_HOS_C7_73,S2_1_C2_1601,S4_HHA2_C2_35,B_1_C22_30,FI_NUM,S3_1_C8_20,D_4_HOS_C4_89,D3_SNF_C2_54,S3_2_C2_9,S4_HHA1_C5_38,D_4_HOS_C10_96,D_1_HOS_C7_32,D_4_HOS_C12_73,B_1_C0_56,S3_1_C2_9,S3_2_C5_5,B_2_C26_89,D_4_IPF_C13_64,B_2_C26_9940,D3_IRF_C3_9201,D3_HOS_C3_57,B_1_C21_52,S3_2_C4_21,D_5_HOS_C2_54,D_4_HOS_C11_68,S2_1_C2_1523,G_C1THRU4_6,D_5_HOS_C3_54,S2_1_C2_1806,D3_IPF_C2_50,B_1_C0_89,E_B_HOS_C1_26,A7_1_C1_10,C_1_C6_9201,C_1_C5_200,C_1_C6_74,S5_C2_8,FY_BGN_DT,C_1_C6_101,D_4_IPF_C2_200,A_C2_73,S3_2_C3_14,S4_HHA2_C3_36,S2_1_C2_12,B_2_C26_58,D3_HOS_C2_70,S4_HHA2_C1_35,D_4_HOS_C13_63,D3_SNF_C2_90,A_C2_11,C_1_C6_9910,B_1_C22_66,D3_SNF_C2_56,C_1_C7_96,D3_IPF_C3_51,S5_C4_4,S3_1_C5_20,S3_2_C2_41,E_B_HOS_C101_6,G_C1THRU4_41,A_C6_191,C_1_C5_30,S3_1_C7_6,S2_1_C1_106,B_1_C26_76,D_4_HOS_C4_67,G_C1THRU4_30,E_B_HOS_C1_28,S3_1_C3_21,B_1_C21_74,S2_1_C2_1515,S2_1_C2_1509,C_1_C7_52,D_3_HOS_C3_200,A_C2_63,D_5_HOS_C3_69,RPT_STUS_CD,D_5_HOS_C3_74,A7_1_C1_8,C_1_C6_108,D3_IRF_C3_60,D3_IRF_C2_6250,S3_2_C4_7,S3_2_C5_15,D3_IRF_C2_53,D3_IRF_C3_50,B_1_C0_7,S2_1_C2_1401,D4_INTESTINE_C1_69,D_4_HOS_C2_9201,D_5_HOS_C3_62,A_C6_88,S3_1_C6_29,D_4_HOS_C3_56,D_5_HOS_C6_69,S2_1_C2_115,S4_HHA2_C3_34,S2_1_C1_86,A_C2_22,B_1_C22_106,B_1_C26_55,D3_HOS_C3_52,E_B_HOS_C1_43,G3_C1_2,A_C6_117,D_4_HOS_C3_58,D_4_IPF_C11_53,B_1_C26_105,B_1_C26_43,S2_1_C2_1519,B_2_C26_97,D1_IRF_C1_53,S2_1_C2_18,D_5_HOS_C3_73,S3_2_C2_43,D3_IRF_C2_51,B_1_C22_99,D3_SNF_C3_74,D_4_HOS_C4_75,D3_HOS_C3_59,D3_HOS_C2_41,E_B_HOS_C1_2,B_1_C0_101,S3_1_C8_6,A7_1_C7_2,D_5_HOS_C2_64,D_4_HOS_C11_57,D_5_HOS_C5_53,S4_HHA2_C3_33,S3_2_C5_14,D_4_HOS_C12_69,B_2_C26_69,D_1_HOS_C4_200,D_5_HOS_C2_90,D3_IPF_C2_72,S2_1_C1_5,E_B_HOS_C1_12,B_1_C26_88,S4_HHA2_C5_35,S10_C1_26,E_B_HOS_C1_15,A_C6_11,D_4_HOS_C4_74,S4_HHA2_C2_37,D_4_HOS_C4_69,D1_IRF_C1_37,D3_IPF_C3_54,A_C6_75,A_C1_16,E_B_HOS_C1_3,B_1_C26_68,D_4_HOS_C12_96,B_2_C26_115,D_4_HOS_C2_59,C_1_C2_67,D_4_IRF_C13_51,D3_HOS_C3_71,D3_IPF_C3_63,B_1_C21_73,A7_3_C6_3,D_5_HOS_C3_95,A_C6_56,S3_2_C4_2551,B_1_C0_14,D3_SNF_C3_66,S3_1_C7_16,D_4_IPF_C11_50,D3_HOS_C2_73,D_4_IRF_C11_71,A_C6_5,A_C2_72,D_4_HOS_C1_53,C_1_C6_9940,B_2_C26_54,S3_2_C3_23,C_1_C7_53,S3_2_C2_29,A_C1_194,B_2_C26_35,A_C1_62,D1_HOS_C5_43,D1_HOS_C1_63,G_C1THRU4_7,B_1_C21_58,D_4_HOS_C4_71,B_1_C21_105,S3_1_C8_1801,B_1_C22_90,A_C6_33,S4_HHA2_C1_33,D_4_HOS_C11_63,A7_3_C11_3,C_1_C7_90,S3_3_C4_5,B_2_C26_73,C_1_C5_60,S3_1_C11_21,D_4_IPF_C11_65,S3_2_C4_29,A_C6_32,S3_2_C4_34,S3_1_C7_25,D3_IPF_C3_71,B_1_C22_51,D_5_HOS_C5_75,C_1_C6_109,S3_2_C2_24,S2_1_C2_1513,C_1_C5_58,D_4_HOS_C3_64,S2_1_C2_1510,D_4_HOS_C3_96,D_4_HOS_C2_55,S3_2_C2_21,A7_1_C7_3,B_1_C21_34,D_4_IPF_C13_90,D_4_HOS_C12_9201,D_4_HOS_C10_72,S3_1_C13_16,S4_HHA3_C4_35,B_1_C21_90,D_4_HOS_C13_64,S2_1_C1_47,S3_1_C5_11,C_1_C7_108,S4_HHA3_C3_38,D3_IRF_C2_60,D3_SNF_C3_68,B_1_C21_108,S3_2_C4_20,A_C6_12,C_1_C6_56,D_4_HOS_C4_200,A_C2_7,D_4_IRF_C11_75,D_4_IPF_C11_63,S5_C2_3,B_1_C22_67,D3_HOS_C3_62,E_B_HOS_C1_25,S3_2_C6_39,A7_1_C2_4,S2_1_C2_11801,B_1_C0_40,A_C6_9930,D_4_SNF_C11_59,S4_HHA2_C3_38,D_4_HOS_C3_94,A7_1_C3_10,B_1_C0_97,FI_CREAT_DT,D3_SNF_C2_62,D_1_HOS_C4_4201,D_4_HOS_C11_56,D_4_SNF_C11_56,A_C1_88,D_4_SNF_C11_70,D_5_HOS_C6_54,G_C1THRU4_1,D_4_SNF_C11_60,S3_2_C4_39,S3_2_C5_34,A8_C2_25,D3_IRF_C2_93,C_1_C7_68,S4_HHA3_C1_38,S5_C6_4,A7_3_C15_1,D3_HOS_C2_94,D3_IPF_C2_62,D_4_IPF_C11_57,S2_1_C3_24,A_C6_63,S3_2_C4_6,S3_3_C2_3,A8_C2_10,D_5_HOS_C3_94,B_1_C22_192,D3_HOS_C3_93,S2_1_C2_4,S3_2_C5_33,D_4_HOS_C12_50,S2_1_C5_24,S2_1_C1_26,S3_1_C3_17,D3_IPF_C2_58,B_1_C26_194,S3_1_C3_18,A_C1_101,A_C2_111,D_4_IPF_C11_9201,S3_2_C3_24,S3_2_C5_16,G_C1THRU4_34,B_1_C21_50,A7_1_C1_6,B_1_C26_45,D_5_HOS_C5_65,S4_HHA3_C5_37,S2_1_C1_129,D_4_SNF_C11_71,D_5_HOS_C4_53,A8_C2_50,S3_2_C6_10,D3_IPF_C2_91,G_C1THRU4_12,S3_2_C2_32,D3_IPF_C3_68,C_1_C5_117,A7_3_C9_1,S5_C2_1,D3_SNF_C3_65,S3_2_C4_37,B_1_C0_12,S2_1_C2_1511,S2_1_C2_1802,G_C1THRU4_44,D_4_IRF_C13_72,A7_1_C7_6,S2_1_C2_5,B_1_C22_40,D_4_SNF_C11_53,D3_HOS_C3_98,A_C2_18,S3_1_C8_5,S4_HHA1_C2_37,S3_2_C2_4,D3_IPF_C2_74,A7_1_C7_5,S3_1_C3_32,D3_SNF_C2_202,S3_2_C6_41,A7_1_C2_8,B_1_C22_42,D_1_HOS_C7_34,S3_2_C2_2,S3_2_C6_27,C_1_C7_106,S3_2_C6_34,A8_C2_2,D_4_HOS_C12_91,D3_SNF_C3_55,D_4_HOS_C10_6250,D3_IRF_C3_63,D1_SNF_C1_85,S3_2_C4_27,D_4_IPF_C11_73,B_2_C26_43,S3_1_C7_20,C_1_C7_59,D3_IPF_C2_9201,B_1_C26_30,A_C1_8,D4_LIVER_C1_69,A8_C2_14,B_1_C26_34,C_1_C5_41,S4_HHA2_C3_35,A7_1_C2_3,S4_HHA3_C5_38,D_5_HOS_C5_64,D3_IPF_C3_65,C_1_C6_65,D_4_IRF_C11_53,S2_1_C1_127,D_5_HOS_C7_59,D3_IRF_C3_6250,D_4_IRF_C11_50,B_1_C0_16,D3_SNF_C3_56,A_C6_40,A7_1_C3_5,S2_1_C1_142,A_C2_12,A8_C2_11,D_4_HOS_C3_59,E_B_HOS_C1_4,B_2_C26_190,C_1_C5_71,D_4_HOS_C11_64,B_1_C26_42,B_1_C0_67,D_4_IPF_C6_200,C_1_C6_71,A_C2_20,D1_HOS_C1_57,A_C1_89,S3_2_C6_7,C_1_C5_32,S3_2_C4_32,D_3_HOS_C9_41,A_C2_76,D3_IPF_C2_69,A_C1_107,S3_1_C8_15,A_C2_21,D_4_HOS_C2_66,D_4_HOS_C3_69,D_4_SNF_C11_55,D_5_HOS_C7_52,D_4_HOS_C13_54,S3_1_C9_27,A_C1_100,S4_HHA1_C3_36,D_3_HOS_C9_30,S3_1_C3_24,D_5_HOS_C2_51,S3_2_C6_35,S4_HHA2_C1_34,B_1_C22_93,S4_HHA2_C5_34,A_C6_95,B_1_C0_98,B_1_C22_116,D_4_HOS_C12_67,C_1_C7_9930,D_4_IPF_C13_62,D1_HOS_C1_62,S2_1_C2_1504,D3_SNF_C3_59,D_1_HOS_C7_35,D_4_IPF_C11_64,E_B_HOS_C1_14,S3_1_C8_19,A7_1_C6_7,S3_2_C5_10,D_5_HOS_C3_61,D_4_SNF_C11_62,C_1_C6_50,D_4_IPF_C11_59,S4_HHA3_C4_38,S2_1_C2_1805,A_C1_52,D_4_IRF_C11_74,S3_1_C8_1,A_C1_23,A_C1_50,A_C1_110,D_4_HOS_C10_63,D_4_HOS_C13_200,A7_1_C3_6,S3_2_C5_6,D_5_HOS_C4_65,D_4_HOS_C10_57,S2_1_C1_3,B_1_C0_13,B_1_C0_9201,D3_SNF_C2_30,C_1_C6_9930,A7_1_C4_7,E_B_HOS_C1_16,C_1_C6_60,B_2_C26_40,D_4_HOS_C3_76,S2_1_C2_1803,S3_2_C4_2552,C_1_C7_66,D_5_HOS_C6_94,A7_1_C2_5,S3_1_C13_14,B_2_C26_105,A_C1_11,C_1_C5_76,D_4_HOS_C10_71,A_C6_52,D_4_IPF_C13_67,D_4_IPF_C13_70,D1_IRF_C1_49,D_4_HOS_C3_51,B_1_C0_2,D3_IRF_C2_32,S3_3_C4_2,S3_2_C6_29,E_B_HOS_C1_20,A_C2_8,D_4_IPF_C4_200,D_4_HOS_C11_58,A_C6_42,B_2_C26_31,D3_HOS_C2_91,D_4_IPF_C11_52,D_4_SNF_C11_69,S3_1_C4_12,D3_IPF_C2_93,S3_1_C8_12,A_C2_114,D_5_HOS_C4_62,D_5_HOS_C7_62,B_2_C26_93,B_1_C26_73,A_C1_75,S4_HHA2_C5_37,S3_2_C2_8,B_1_C21_99,D_5_HOS_C5_56,S3_1_C8_28,D3_HOS_C3_58,D_4_HOS_C13_56,D3_HOS_C2_65,S4_HHA1_C2_35,A_C2_50,S10_C3_22,D_4_IPF_C11_55,B_1_C21_35,A_C1_32,C_1_C7_94,D1_HOS_C1_27,B_1_C22_62,S4_HHA3_C3_35,D_5_HOS_C7_65,B_1_C22_57,S3_1_C6_19,B_2_C26_99,S3_1_C12_1,B_1_C0_116,C_1_C5_45,E_B_HOS_C101_4,S2_1_C1_37,S2_1_C2_1520,C_1_C5_50,D_5_HOS_C7_68,A7_3_C15_2,D_4_HOS_C13_97,S10_C1_13,D_4_HOS_C3_73,D_4_HOS_C10_54,D3_IRF_C3_76,D_4_HOS_C12_98,A_C2_31,C_1_C5_53,A7_1_C2_6,D3_IRF_C2_63,D_5_HOS_C3_76,B_2_C26_72,D_4_HOS_C3_62,D_5_HOS_C6_55,S3_1_C8_24,D3_IPF_C3_58,B_1_C0_53,D_5_HOS_C3_59,B_2_C26_63,D3_IRF_C2_66,S3_2_C2_38,D_4_IRF_C13_200,S3_2_C2_36,A_C6_193,B_1_C21_112,D3_SNF_C3_98,D3_SNF_C3_54,D_4_IRF_C11_51,A_C6_110,A7_1_C7_10,S3_1_C6_8,D_5_HOS_C4_93,A_C2_54,D_4_HOS_C10_91,C_1_C5_9201,C_1_C6_33,B_1_C26_62,C_1_C6_112,B_1_C26_50,D_4_IRF_C13_69,D3_IPF_C2_41,D3_IRF_C3_93,A_C1_69,D3_SNF_C2_64,B_1_C26_64,D_1_HOS_C6_41,D_4_HOS_C10_58,G_C1THRU4_50,G_C1THRU4_36,D3_SNF_C2_76,E_B_HOS_C1_40,S10_C1_21,S2_1_C4_24,B_2_C26_76,D_1_HOS_C4_42,D1_SNF_C1_84,S4_HHA3_C1_35,G_C1THRU4_17,S3_2_C6_11,S3_2_C6_15,S5_C2_21,B_1_C26_111,D3_SNF_C2_70,D_5_HOS_C3_200,D_4_HOS_C2_71,D3_IPF_C2_66,D3_IRF_C3_66,A_C6_55,C_1_C5_88,S4_HHA3_C1_36,D_4_IRF_C13_75,B_1_C21_43,B_2_C26_53,S3_3_C2_4,A_C1_7,A_C1_44,D_4_HOS_C3_71,S3_1_C8_11,A_C6_115,D1_HOS_C1_48,A_C2_1,A_C6_6250,B_1_C26_75,D_4_HOS_C3_6250,C_1_C7_105,C_1_C5_69,C_1_C5_51,S3_1_C5_13,A_C6_9,S3_3_C5_1,S3_3_C6_6,A_C6_50,S5_C2_7,C_1_C7_111,A_C6_46,S3_1_C2_27,C_1_C6_9920,C_1_C6_41,D3_SNF_C2_9201,S3_1_C2_19,D3_IRF_C2_62,C_1_C6_31,S3_2_C5_8,B_1_C0_8,A_C2_110,B_1_C26_101,D_4_HOS_C11_93,B_1_C0_17,D_4_IRF_C11_64,D_5_HOS_C2_67,PRVDR_NUM,B_1_C26_108,D_4_HOS_C12_76,D_5_HOS_C4_67,D_5_HOS_C6_59,D3_IPF_C3_69,B_1_C26_66,D_4_IRF_C13_70,B_2_C26_110,D_5_HOS_C5_6250,D_5_HOS_C7_9201,A_C1_18,S3_2_C6_32,B_2_C26_34,D_4_HOS_C4_55,D3_IPF_C3_52,D_4_IRF_C13_63,C_1_C7_6250,S10_C1_2701,B_2_C26_90,D3_IPF_C2_56,B_1_C0_6,B_1_C26_191,D4_PANCREAS_C1_69,S3_2_C4_5,D3_SNF_C3_67,A_C1_31,A_C1_21,B_1_C26_61,S3_2_C4_1,S3_2_C6_14,B_1_C21_65,D_4_HOS_C10_64,D3_IRF_C3_57,D3_IPF_C3_74,E_B_HOS_C1_3998,S3_2_C4_12,E_B_HOS_C101_8,D_5_HOS_C5_66,A_C1_108,S3_1_C6_11,B_1_C22_58,S3_1_C15_1,D3_SNF_C2_35,D3_IRF_C2_59,B_1_C22_109,C_1_C5_65,S2_1_C3_143,A7_3_C10_3,A_C6_6,C_1_C7_75,A7_1_C5_5,B_1_C26_58,B_1_C26_74,D3_SNF_C3_57,S3_1_C8_8,D_4_HOS_C11_50,S3_1_C9_19,D_5_HOS_C7_74,B_1_C22_72,A8_C2_8,A7_3_C6_2,D3_IRF_C3_94,S3_2_C2_1402,D_4_IRF_C11_9201,D_1_HOS_C4_41,D_4_HOS_C4_54,D_4_HOS_C3_93,D3_IRF_C3_71,A_C2_17,D_5_HOS_C6_97,B_1_C22_190,B_1_C26_117,D_4_HOS_C2_91,D3_IRF_C3_70,A_C2_53,A7_1_C3_3,D_4_HOS_C13_71,C_1_C5_96,D_4_HOS_C3_66,G3_C1_26,B_1_C0_191,A_C1_200,D_5_HOS_C6_93,B_1_C21_100,B_1_C0_54,B_1_C26_46,D3_IRF_C2_72,D3_HOS_C3_9201,A_C6_64,S3_2_C6_36,D_4_HOS_C13_73,B_2_C26_106,B_1_C21_107,S3_1_C6_14,S3_2_C5_30,D_5_HOS_C4_200,A_C6_66,STATE,A_C1_76,C_1_C7_72,S3_1_C9_14,D_4_IRF_C11_66,D3_SNF_C2_68,S3_3_C6_1,A_C1_90,D_4_HOS_C11_9201,S3_1_C6_5,D3_IPF_C3_59,S3_2_C4_11,S3_3_C5_3,A_C1_9930,A_C2_16,D3_HOS_C2_90,S3_1_C9_22,S3_1_C3_10,S5_C5_2,D3_HOS_C2_56,S5_C1_10,D_4_HOS_C12_60,S2_1_C1_85,D3_HOS_C2_62,D_4_HOS_C3_89,D_4_HOS_C3_54,C_1_C3_202,S3_1_C7_14,S3_1_C5_12,D3_IPF_C2_200,B_2_C26_116,A_C1_64,A_C1_112,D3_SNF_C2_52,S2_1_C1_93,D_5_HOS_C7_56,RPT_REC_NUM,S4_HHA1_C3_33,A_C2_55,D_5_HOS_C2_94,D_5_HOS_C3_70,D_5_HOS_C7_70,D_4_HOS_C2_75,A_C2_69,D_4_SNF_C11_68,S3_1_C3_9,D_4_SNF_C11_50,A7_1_C1_3,D_4_HOS_C13_75,D_5_HOS_C6_70,S10_C2_22,D_4_IPF_C13_58,A8_C2_27,D_5_HOS_C3_66,B_1_C22_60,D_5_HOS_C4_54,A_C1_111,A_C1_20,C_1_C7_9201,S3_1_C3_1,S3_1_C11_14,A_C6_90,B_2_C26_60,D3_IPF_C3_96,E_B_HOS_C101_3,D3_IPF_C2_55,A_C1_10,B_1_C26_53,S3_3_C5_6,E_B_HOS_C1_8,S3_1_C8_9,S3_2_C3_22,B_1_C0_63,D_4_HOS_C1_50,S10_C1_6,D_5_HOS_C4_64,D_4_IRF_C11_54,A7_1_C7_1,D3_IPF_C2_42,A7_1_C3_4,A_C1_96,D_5_HOS_C3_65,D_5_HOS_C6_67,S3_1_C9_26,D_1_HOS_C4_40,A_C2_190,S3_2_C6_5,B_1_C22_91,D_5_HOS_C6_50,E_A_HOS_C1_7093,G_C1THRU4_3,S3_2_C5_40,S3_1_C7_11,S4_HHA2_C4_38,D_4_HOS_C3_67,D_4_HOS_C13_57,D_4_IPF_C13_63,D_4_HOS_C4_58,A7_1_C5_3,D3_IRF_C3_64,D3_HOS_C2_9201,A_C2_2,B_2_C26_75,S3_1_C8_16,A_C1_95,D_5_HOS_C5_52,ST_CTY_CD,E_B_HOS_C1_13,S2_1_C2_1607,S10_C1_17,B_1_C0_10,C_1_C5_107,D_4_HOS_C10_68,S5_C6_1,D_5_HOS_C3_98,A_C2_9930,S4_HHA1_C2_33,D_5_HOS_C3_50,C_1_C5_110,C_1_C6_32,D_5_HOS_C4_58,A7_1_C1_4,B_1_C0_18,S3_1_C7_2001,D_4_HOS_C2_70,D3_IRF_C3_91,A_C2_193,S4_HHA2_C4_34,D3_HOS_C2_51,A_C6_109,S3_2_C4_16,A_C6_89,D3_SNF_C2_72,S3_1_C6_12,S3_1_C9_24,D_3_HOS_C9_34,D_4_IRF_C13_64,S2_1_C2_24,C_1_C5_44,C_1_C7_60,D1_HOS_C1_41,A_C1_4201,B_2_C26_30,D_4_HOS_C3_200,G_C1THRU4_47,S3_2_C4_22,C_1_C5_74,D_5_HOS_C2_68,D_4_HOS_C13_74,A_C6_74,E_A_HOS_C1_7099,D_1_HOS_C6_35,D_5_HOS_C4_73,D_4_IPF_C11_72,D3_HOS_C2_54,S3_3_C2_5,D3_IPF_C2_98,A_C1_193,B_1_C21_45,S3_3_C4_3,D3_HOS_C2_57,B_1_C22_32,D_5_HOS_C7_76,D3_HOS_C2_58,C_1_C7_101,D_4_HOS_C10_73,S2_1_C2_1505,D3_IRF_C2_67,S3_2_C4_28,D3_IRF_C2_31,S3_2_C6_16,C_1_C6_30,A_C2_14,D_4_IRF_C11_65,B_1_C26_107,A_C2_88,D_4_HOS_C11_74,D_4_IRF_C11_62,D3_HOS_C2_53,B_1_C0_9920,C_1_C7_55,C_1_C5_91,S2_1_C2_17,D_5_HOS_C7_6250,B_2_C26_191,D3_HOS_C2_98,S10_C1_20,D_4_IPF_C13_72,A_C6_54,S5_C4_3,B_1_C0_20,D3_IRF_C2_55,S2_1_C2_1804,B_1_C26_9930,B_1_C0_46,D3_IRF_C2_40,D_4_IRF_C13_55,C_1_C7_202,S10_C1_27,D1_IRF_C1_51,D3_HOS_C2_64,B_1_C21_95,D_4_HOS_C12_66,S3_2_C2_7,D_4_IPF_C11_90,S2_1_C2_7,D_4_IPF_C11_75,D_3_HOS_C6_200,S2_1_C3_3,D3_SNF_C3_63,S3_2_C2_5,D3_HOS_C2_75,D3_IRF_C3_61,D_4_HOS_C13_69,B_1_C22_108,B_1_C0_71,D_4_HOS_C10_75,C_1_C5_66,S3_1_C8_2001,S2_1_C2_143,S3_1_C10_19,S3_1_C6_17,B_1_C26_190,B_1_C0_74,S2_1_C2_1507,B_1_C0_105,D_5_HOS_C4_75,D_4_HOS_C2_98,D_4_SNF_C13_200,S3_1_C8_10,C_1_C2_65,C_1_C5_57,B_1_C0_21,D_5_HOS_C4_57,S10_C1_11,A_C6_69,C_1_C7_51,B_1_C21_69,S10_C1_15,S3_1_C6_1,A8_C2_18,D_4_SNF_C11_64,S3_1_C15_16,D_4_HOS_C12_72,C_1_C5_90,D_1_HOS_C6_30,S2_1_C2_1508,A_C1_43,D_4_IRF_C13_56,D_4_HOS_C3_53,D3_HOS_C2_35,D3_IPF_C2_70,D_5_HOS_C7_51,C_1_C6_35,D3_IPF_C2_34,D_5_HOS_C3_6250,S3_2_C4_33,A_C1_66,A8_C2_17,A7_1_C5_2,C_1_C7_99,A_C1_58,S2_1_C2_38,D_5_HOS_C7_71,A_C1_14,S3_1_C5_10,D_4_HOS_C13_51,D3_IRF_C2_35,B_1_C21_64,D_5_HOS_C5_59,C_1_C6_90,MSA,D_5_HOS_C2_98,S2_1_C2_1516,B_1_C0_95,A_C6_96,B_1_C0_44,C_1_C5_56,D_5_HOS_C6_96,D_4_HOS_C1_73,D_4_HOS_C4_50,A_C2_98,A_C2_106,D_4_HOS_C12_93,G_C1THRU4_52,D_4_HOS_C2_58,C_1_C5_100,D_5_HOS_C5_57,S3_1_C2_20,D3_IRF_C3_68,S4_HHA2_C1_38,A_C6_76,A8_C2_23,S10_C1_31,D_4_SNF_C11_93,A_C2_9920,D3_HOS_C2_66,A_C2_191,D_5_HOS_C7_53,D3_IPF_C3_9201,B_1_C0_76,D3_HOS_C2_71,S4_HHA1_C4_37,D_4_IPF_C1_200,B_2_C26_109,B_1_C26_40,D_4_HOS_C13_93,S3_2_C4_25,D1_IRF_C1_41,G_C1THRU4_19,D_5_HOS_C4_59,E_B_HOS_C1_9,D_4_SNF_C11_66,B_1_C26_69,B_1_C22_105,C_1_C7_109,S3_3_C5_2,S3_1_C7_5,A_C1_13,D3_SNF_C2_75,B_1_C26_99,B_1_C0_41,B_2_C26_192,D_5_HOS_C7_90,S4_HHA3_C5_35,S2_1_C2_1517,D_4_HOS_C12_51,A7_3_C7_2,B_1_C0_57,D3_IPF_C2_65,D_4_HOS_C4_57,D3_HOS_C3_51,S5_C1_3,B_1_C26_110,D3_HOS_C3_53,C_1_C7_58,S3_2_C2_2551,D_4_HOS_C3_70,D_4_HOS_C13_76,C_1_C6_61,S3_2_C5_11,S3_1_C7_26,B_1_C0_52,D_5_HOS_C5_50,D_4_HOS_C10_90,D_4_IPF_C13_65,D3_IRF_C2_94,C_1_C7_63,B_1_C21_59,C_1_C5_35,D_5_HOS_C5_54,D_5_HOS_C5_90,B_1_C22_9201,G3_C1_5,D_5_HOS_C6_52,D3_IPF_C3_93,D3_SNF_C2_58,A_C6_192,B_1_C0_4501,D_5_HOS_C7_93,B_1_C26_35,S3_2_C6_1,B_2_C26_70,S4_HHA2_C1_36,D3_IRF_C2_98,S3_3_C6_2,B_1_C21_190,S3_3_C6_7,S3_1_C2_32,A8_C2_1,B_1_C26_65,S3_2_C2_14,D_4_IPF_C11_56,D_4_IPF_C11_200,A_C6_14,S3_3_C6_3,A_C2_108,A_C6_105,B_1_C26_96,C_1_C5_42,D_4_HOS_C3_65,C_1_C5_34,B_1_C0_11,A_C1_98,S3_1_C4_10,D3_IPF_C2_52,S2_1_C2_1512,B_1_C26_51,B_2_C26_111,S3_2_C6_9,B_1_C22_71,B_1_C26_98,A_C6_4,D_4_HOS_C13_52,B_1_C21_75,A_C1_54,D3_IRF_C2_71,D_5_HOS_C5_67,A_C6_108,D_4_IRF_C13_57,B_1_C22_33,E_B_HOS_C1_11,B_1_C22_95,S3_1_C12_16,S3_2_C2_31,D_4_IRF_C13_60,D_5_HOS_C2_75,A_C6_100,B_1_C0_34,D3_IPF_C2_53,A_C1_106,D_4_IRF_C6_200,D_5_HOS_C4_98,S2_1_C2_1502,D3_IRF_C3_62,D1_HOS_C1_53,S5_C3_2,D_4_HOS_C11_60,B_1_C21_54,B_2_C26_100,C_1_C5_97,D_4_HOS_C4_93,D3_IPF_C2_35,B_1_C0_42,D_5_HOS_C7_50,D_4_IRF_C11_93,D_3_HOS_C9_33,A_C6_15,A_C2_60,A_C1_109,S2_1_C2_142,S4_HHA3_C5_36,S3_3_C4_6,A_C1_22,B_1_C22_53,D3_SNF_C3_9201,S3_2_C2_19,D_4_HOS_C11_70,C_1_C7_89,S2_1_C1_116,C_1_C6_51,D_4_HOS_C13_62,D_4_HOS_C3_75,A_C1_72,G3_C1_25,D3_HOS_C2_97,S2_1_C2_1604,S3_1_C4_11,S3_1_C5_1,A_C6_31,S3_1_C14_14,C_1_C7_110,D_4_HOS_C2_53,D_4_HOS_C10_93,D3_SNF_C2_66,A8_C2_19,B_1_C26_57,D3_HOS_C3_91,S3_2_C2_25,D3_IPF_C2_54,D_5_HOS_C5_98,B_1_C22_44,D_4_IPF_C13_9201,B_1_C26_94,D_4_HOS_C13_90,D3_HOS_C3_94,D3_IPF_C3_73,D_5_HOS_C4_74,D_5_HOS_C7_55,S3_1_C6_24,D_4_IPF_C11_68,D_5_HOS_C6_75,A8_C2_5,D_4_HOS_C10_62,D3_SNF_C3_90,E_B_HOS_C1_30,D_4_IRF_C13_58,S10_C1_23,D_4_HOS_C13_50,G_C1THRU4_35,D3_SNF_C2_74,D_4_IPF_C13_68,D_3_HOS_C8_200,E_B_HOS_C1_22,D_4_HOS_C11_54,B_2_C26_50,D_5_HOS_C4_91,D1_HOS_C5_44,C_1_C6_72,S3_1_C2_24,D_4_IPF_C13_73,D_5_HOS_C4_63,D3_IRF_C2_69,D_4_HOS_C4_65,D3_SNF_C3_93,D3_HOS_C2_60,S3_1_C7_18,D1_IRF_C1_27,D_4_HOS_C2_68,D_4_HOS_C3_57,D_4_HOS_C4_59,D_4_IPF_C11_93,D3_IRF_C2_65,D_4_HOS_C11_52,D_4_HOS_C2_94,D_4_IPF_C13_200,D3_SNF_C2_55,S2_1_C1_125,S3_2_C4_1601,S3_1_C3_2001,D3_IRF_C2_70,D3_IRF_C3_69,D1_HOS_C5_45,A_C1_93,E_B_HOS_C1_41,S3_1_C2_11,D_5_HOS_C4_50,D1_HOS_C1_50,D3_IPF_C2_59,D_5_HOS_C5_70,D_4_HOS_C11_66,D_4_HOS_C11_91,D1_IPF_C1_53,S2_1_C1_3801,D_3_HOS_C9_31,S3_2_C2_3,D_4_HOS_C13_70,S3_2_C4_41,A_C2_61,D_5_HOS_C2_58,A_C2_115,D3_IRF_C3_54,D_4_HOS_C12_94,C_1_C5_201,S3_1_C14_17,C_1_C6_117,D_4_IRF_C13_93,S2_1_C1_140,S2_1_C1_27,S3_1_C6_15,C_1_C7_9910,A_C1_12,D_4_HOS_C2_69,D3_HOS_C3_75,D3_HOS_C3_55,A_C2_40,C_1_C6_54,S3_1_C7_1801,S3_2_C4_2553,D_4_HOS_C2_56,E_B_HOS_C1_35,B_1_C0_111,A_C6_16,D3_IPF_C2_67,D_5_HOS_C5_68,B_1_C0_110,S3_1_C2_17,S3_1_C8_7,S3_1_C8_13,S3_2_C6_8,D_4_IRF_C13_76,C_1_C5_59,S2_1_C2_1608,D_4_HOS_C3_9201,S2_1_C1_48,D_1_HOS_C6_33,C_1_C6_40,D3_IRF_C2_33,D3_SNF_C3_50,D3_IPF_C3_90,D3_IRF_C3_98,B_1_C0_96,A_C1_6,A7_1_C5_4,B_1_C21_30,C_1_C5_9930,S3_1_C7_19,B_1_C21_76,S4_HHA3_C5_33,A8_C2_28,S3_3_C4_7,D3_HOS_C3_72,A_C1_115,D_5_HOS_C6_72,D3_IRF_C2_41,E_B_HOS_C1_38,A_C6_99,D_5_HOS_C2_6250,D_4_HOS_C12_75,S3_1_C2_7,S3_1_C2_8,B_2_C26_9201,D3_SNF_C2_57,B_1_C22_54,D_4_HOS_C6_200,B_1_C0_66,D1_IPF_C1_52,A_C6_73,S2_1_C7_3,A_C6_45,S3_1_C3_7,S3_1_C5_8,A_C6_7,A_C1_34,D4_LUNG_C1_69,D3_HOS_C2_43,D_5_HOS_C5_93,D_5_HOS_C3_96,S2_1_C2_8,B_1_C26_200,C_1_C5_55,A7_1_C1_5,D3_HOS_C3_60,B_1_C26_6250,S4_HHA2_C2_33,A_C6_70,S3_1_C4_14,C_1_C7_107,B_1_C0_107,B_2_C26_55,C_1_C5_52,A7_3_C6_1,S3_2_C6_38,D_5_HOS_C7_66,S4_HHA1_C5_33,A7_3_C7_3,D_4_IPF_C13_54,D1_HOS_C1_52,D_4_HOS_C10_59,B_1_C22_55,D4_KIDNEY_C1_69,A7_3_C5_2,A_C2_32,B_1_C0_31,B_1_C0_69,B_1_C0_112,S4_HHA1_C1_36,B_1_C0_9,C_1_C5_75,B_1_C0_70,D3_IRF_C3_65,D1_HOS_C1_51,S3_1_C13_1,C_1_C7_95,S3_1_C2_1801,S4_HHA1_C4_34,S2_1_C2_1606,G2_C2_28,S3_2_C2_37,D1_HOS_C1_54,A7_1_C3_1,D3_IPF_C2_31,B_1_C22_50,S5_C5_1,A_C2_57,D_4_IPF_C11_70,S10_C1_19,A_C2_62,B_1_C26_33,A_C2_51,D_5_HOS_C7_200,G3_C1_29,S3_1_C15_14,S2_1_C1_131,D_4_IPF_C13_66,A_C1_67,B_1_C0_90,A_C6_116,S3_1_C7_24,S3_1_C3_14,D3_IPF_C2_76,D3_IRF_C3_74,S3_1_C6_2,S4_HHA3_C2_37,D_5_HOS_C7_91,D_4_HOS_C4_56,C_1_C5_31,D3_IRF_C2_90,A7_3_C11_1,S3_2_C4_43,C_1_C6_88,B_1_C26_56,B_2_C26_41,C_1_C5_115,C_1_C7_74,B_1_C0_58,S3_1_C9_18,A_C1_97,S3_2_C5_43,D_5_HOS_C4_68,E_B_HOS_C101_7,D_4_HOS_C4_70,S3_1_C5_7,C_1_C6_67,UTIL_CODE,D_5_HOS_C4_72,D_4_HOS_C11_75,D_4_HOS_C10_51,G_C1THRU4_53,D_4_HOS_C11_98,D3_SNF_C2_41,D3_IPF_C2_51,S5_C1_11,S3_2_C3_2553,S4_HHA1_C2_34,E_B_HOS_C1_33,A_C1_63,D3_HOS_C2_68,C_1_C5_101,D_4_HOS_C10_50,D3_IRF_C3_75,D_5_HOS_C3_67,S3_3_C2_2,B_1_C0_100,D_4_IRF_C1_102,D3_IRF_C2_74,A_C6_67,D3_IPF_C2_33,S5_C2_5,D_5_HOS_C3_97,D_4_IRF_C13_74,S5_C4_6,C_1_C5_9940,S3_2_C5_12,C_1_C7_88,S2_1_C2_1524,C_1_C6_59,A_C2_66,D_4_HOS_C11_90,D_4_HOS_C2_67,D_5_HOS_C2_62,S3_2_C2_23,D_4_SNF_C11_90,S3_2_C2_6,S3_2_C4_1402,G_C1THRU4_54,S2_1_C2_1402,A_C6_113,D_5_HOS_C4_51,B_1_C21_51,S2_1_C1_36,D_5_HOS_C6_98,D_4_HOS_C12_57,S4_HHA2_C4_36,B_2_C26_9930,D_5_HOS_C2_71,D_4_HOS_C12_97,D_4_HOS_C12_55,D_4_HOS_C12_200,B_2_C26_64,D_5_HOS_C6_60,A_C2_65,B_1_C0_45,D_4_HOS_C11_51,S3_2_C5_4,D_5_HOS_C3_51,A_C6_60,D_5_HOS_C5_9201,S3_1_C9_20,S3_1_C7_8,D3_IRF_C2_68,S10_C2_21,A_C2_99,B_1_C26_192,S3_2_C6_40,A_C2_112,A_C2_194,B_1_C21_115,B_1_C21_66,D_4_IRF_C3_200,D_4_IPF_C13_56,D3_SNF_C2_40,G_C1THRU4_15,A_C1_51,D_4_HOS_C13_9201,B_1_C21_98,C_1_C5_72,S2_1_C1_145,S3_2_C4_3,A_C6_20,D_5_HOS_C4_94,S3_2_C5_7,D3_SNF_C2_67,S3_2_C5_41,S3_2_C6_1402,A_C6_19,D_5_HOS_C3_71,D_5_HOS_C2_53,B_2_C26_67,C_1_C8_202,D_4_IRF_C13_62,D_4_HOS_C12_52,S5_C1_2,S3_1_C14_16,S2_1_C2_15,A_C6_114,A7_1_C5_1,D_1_HOS_C6_32,D_4_HOS_C4_68,S3_2_C4_42,C_1_C7_116,A7_3_C11_2,A_C6_58,D_1_HOS_C6_40,D3_IRF_C2_9201,S4_HHA1_C4_36,B_1_C21_55,B_1_C22_35,D_4_HOS_C12_74,D_5_HOS_C5_96,S4_HHA2_C2_38,B_2_C26_66,S5_C1_13,C_1_C5_70,A_C1_60,D_5_HOS_C2_59,B_2_C26_71,B_1_C0_68,D_4_IPF_C13_60,S3_1_C5_16,S3_1_C6_10,D3_HOS_C2_74,A_C6_190,A_C6_2,D_1_HOS_C6_200,D3_IRF_C2_73,S3_2_C2_20,D_1_HOS_C4_32,D3_SNF_C2_60,A_C2_192,D_5_HOS_C6_95,D3_HOS_C2_31,D3_IPF_C3_62,G_C1THRU4_49,B_1_C26_32,A_C2_4501,D3_SNF_C3_96,S3_2_C3_1402,S3_1_C6_7,S4_HHA1_C1_33,D_4_HOS_C4_53,A_C6_94,A_C6_9920,D_4_HOS_C13_60,S2_1_C2_1506,B_2_C26_52,S4_HHA3_C5_34,A7_1_C7_7,S2_1_C2_1202,D3_IPF_C2_75,E_B_HOS_C1_32,D_3_HOS_C9_32,C_1_C7_98,A_C6_4201,B_1_C22_98,C_1_C6_43,D_4_IRF_C11_55,A_C2_5,D3_SNF_C3_52,S3_1_C3_11,B_1_C22_43,G_C1THRU4_13,A8_C2_31,D3_IRF_C3_90,D_5_HOS_C6_200,E_B_HOS_C101_5,S3_3_C5_4,S3_2_C4_17,S10_C3_21,B_2_C26_62,A7_3_C5_3,A_C1_116,S3_2_C5_26,D_4_HOS_C2_57,S2_1_C1_60,D3_HOS_C3_76,C_1_C6_97,D3_SNF_C3_75,B_1_C26_9910,S5_C4_1,D_5_HOS_C5_51,B_1_C26_202,C_1_C6_91,S4_HHA3_C4_33,D_5_HOS_C4_70,D3_HOS_C2_93,S3_2_C4_35,S4_HHA2_C5_38,S2_1_C2_1201,S3_1_C6_9,A8_C2_4,A7_1_C3_2,B_1_C22_64,D3_HOS_C3_74,D_4_HOS_C10_67,B_1_C0_117,S2_1_C1_141,S10_C1_3,D_5_HOS_C3_72,D3_HOS_C3_90,C_1_C6_116,D_4_HOS_C11_72,S4_HHA1_C5_37,D3_IPF_C3_76,D4_HEART_C1_69,A7_1_C3_7,A_C2_6,A_C6_3,B_1_C26_67,E_B_HOS_C1_4001,D_4_HOS_C3_72,D1_HOS_C1_56,D_4_IRF_C11_200,B_2_C26_56,A_C6_22,C_1_C2_68,B_1_C0_32,C_1_C6_63,D_1_HOS_C4_35,D3_IPF_C3_91,B_1_C22_94,D3_SNF_C3_94,B_1_C0_75,C_1_C5_106,D_5_HOS_C7_75,D3_HOS_C2_6250,S2_1_C2_1521,D3_SNF_C2_32,D_1_HOS_C4_31,A_C2_35,A_C1_4,A_C2_4201,D_4_HOS_C13_66,D_5_HOS_C6_76,A_C2_116,A_C6_93,A7_1_C5_7,S3_2_C4_1602,D3_HOS_C2_50,B_1_C0_194,B_2_C26_101,B_1_C26_90,A_C2_105,S2_1_C1_4,S2_1_C2_9,B_2_C26_65,S2_1_C2_1514,S3_1_C4_8,B_1_C21_88,D_5_HOS_C5_60,D_4_HOS_C3_63,S5_C1_21,S3_1_C2_18,S3_2_C6_3,S2_1_C1_105,A_C6_53,S2_1_C3_11801,D3_HOS_C2_61,S3_1_C10_21,B_1_C22_45,D_5_HOS_C5_55,E_B_HOS_C1_18,FY_END_DT,S2_1_C2_132,S2_1_C2_1603,D_4_IPF_C13_91,D1_IPF_C1_27,C_1_C7_56,S2_1_C2_140,D_4_IRF_C11_60,S3_2_C4_2550,B_1_C0_94,B_1_C0_99,S4_HHA3_C3_36,B_1_C26_95,S3_2_C2_2552,D_4_HOS_C10_97,D_4_HOS_C11_71,S5_C3_3,A7_1_C3_8,C_1_C7_57,D3_HOS_C2_55,E_B_HOS_C1_27,D3_HOS_C2_96,C_1_C5_89,D3_IRF_C2_75,S10_C3_20,S4_HHA2_C4_37,D_5_HOS_C5_63,B_1_C22_31,S3_2_C2_27,S3_2_C6_13,A_C1_117,B_1_C22_194,D_4_HOS_C12_6250,S3_2_C6_1401,B_1_C0_9910,C_1_C6_110,D_4_HOS_C10_52,S5_C3_6,D3_IRF_C2_76,C_1_C5_95,D1_IPF_C1_50,D_5_HOS_C6_90,D3_HOS_C3_97,D_5_HOS_C7_63,D3_IPF_C2_71,S3_2_C3_2551,B_1_C0_65,S3_1_C8_18,D3_SNF_C3_64,S2_1_C2_127,A8_C2_7,D1_IRF_C1_48,S4_HHA1_C4_35,B_1_C21_89,D_4_IPF_C13_52,S3_1_C11_22,S3_1_C7_22,D3_HOS_C2_72,A_C6_59,A_C1_4501,C_1_C5_112,D1_IPF_C1_37,S3_1_C11_19,S3_2_C4_10,D_4_HOS_C12_71,S3_2_C6_4,S4_HHA2_C4_33,D3_HOS_C2_33,D3_SNF_C2_98,D_4_SNF_C11_73,D_4_SNF_C11_54,A_C6_8,S3_1_C10_25,B_2_C26_9920,D1_IPF_C1_41,A_C2_200,S10_C2_20,G_C1THRU4_9,D_5_HOS_C5_97,S3_3_C4_4,S3_1_C14_1,B_2_C26_68,S3_2_C2_1401,S4_HHA2_C4_35,S3_1_C12_17,S10_C1_22,A7_3_C15_3,A_C6_101,D3_HOS_C3_61,TRNSMTL_NUM,A_C6_13,C_1_C6_57,C_1_C7_9920,D_4_SNF_C11_91,S10_C1_30,B_2_C26_91,S2_1_C2_126,S3_2_C4_2,D_4_HOS_C3_97,A_C1_74,S2_1_C2_1809,S3_2_C4_23,B_1_C22_70,A_C2_23,D_1_HOS_C6_31,G3_C1_1,D_5_HOS_C7_58,S2_1_C6_24,C_1_C7_97,B_1_C22_41,D_4_HOS_C13_91,D_4_HOS_C3_98,D_4_HOS_C10_55,S2_1_C2_2,D_4_IPF_C11_60,S3_2_C2_33,D3_HOS_C2_42,S3_2_C4_2201,S3_2_C4_13,A_C2_19,A_C1_5,S3_2_C5_29,S4_HHA1_C5_35,B_1_C26_41,S3_1_C7_17,D_4_IRF_C13_71,A_C2_93,S3_1_C11_24,D1_HOS_C5_46,B_1_C21_41,S4_HHA3_C4_37,D1_HOS_C1_26,B_1_C0_22,B_1_C21_42,D_5_HOS_C3_56,E_A_HOS_C1_7094,S3_1_C7_7,S2_1_C4_2,S2_1_C2_36,D_4_IRF_C11_63,D3_IRF_C2_34,D_4_HOS_C3_74,D_5_HOS_C7_72,B_1_C0_62,D_5_HOS_C6_91,A_C1_94,S3_2_C4_26,C_1_C5_68,A_C6_35,S10_C1_10,S3_2_C4_19,B_1_C0_1,B_1_C0_192,D3_HOS_C3_70,D_1_HOS_C6_34,A7_1_C7_4,D_5_HOS_C2_97,D_5_HOS_C6_64,S3_1_C8_17,C_1_C5_99,A7_3_C9_2,E_A_HOS_C1_59,A7_1_C2_1,B_1_C22_68,D_4_HOS_C10_53,S5_C1_6,A7_1_C7_8,S2_1_C1_24,B_1_C21_72,A8_C2_33,S5_C6_2,D_4_IPF_C13_59,A_C2_74,D3_SNF_C3_53,B_1_C21_31,D1_IPF_C1_51,D_4_IPF_C11_62,C_1_C7_62,D_4_IPF_C13_51,D_4_IRF_C11_69,A_C2_9910,D_4_HOS_C4_88,B_1_C26_60,S4_HHA3_C1_34,D3_IRF_C2_57,A7_1_C1_7,C_1_C6_6250,D3_IPF_C3_75,D_4_HOS_C1_76,S3_2_C6_12,D_5_HOS_C3_75,B_2_C26_46,S3_1_C6_26,A_C2_97,B_1_C0_61,D1_HOS_C1_55,D_4_HOS_C10_70,C_1_C6_44,D_5_HOS_C4_6250,C_1_C5_67,B_2_C26_108,A_C6_41,D_4_HOS_C11_59,S2_1_C3_2,D_5_HOS_C6_63,S4_HHA3_C4_36,C_1_C5_109,S2_1_C2_1602,B_2_C26_112,D3_IPF_C2_6250,S3_2_C4_24,S4_HHA1_C3_35,A_C2_64,A8_C2_9,D3_HOS_C2_69,B_1_C21_71,C_1_C5_94,D_4_HOS_C4_64,S3_1_C3_19,S3_2_C2_26,D_4_IPF_C13_57,D_5_HOS_C6_62,D3_HOS_C3_56,B_1_C21_68,S3_1_C12_14,A7_1_C5_6,C_1_C5_116,A_C6_10,D_1_HOS_C4_33,D_4_HOS_C12_68,S3_1_C10_18,A7_1_C1_2,D_4_HOS_C4_60,D_4_HOS_C12_63,B_1_C21_46,B_2_C26_32,G3_C1_4,S2_1_C2_1001,D_1_HOS_C7_30,B_1_C22_69,D_5_HOS_C3_64,S3_2_C6_2,C_1_C6_70,D_4_SNF_C11_67,G_C1THRU4_4,D_5_HOS_C6_53,S2_1_C2_1501,D_5_HOS_C7_54,S3_1_C3_16,S3_1_C2_1,A7_1_C2_2,D_4_IPF_C11_71,B_2_C0_202,S2_1_C1_108,A_C2_34,D_4_SNF_C11_200,D_4_HOS_C4_90,B_2_C26_42,C_1_C6_76,REGION,S3_2_C5_28,B_1_C26_116,G_C1THRU4_37,D_4_IPF_C13_53,S2_1_C1_132,S4_HHA1_C5_36,D1_HOS_C1_58,D_4_HOS_C4_73,C_1_C6_46,S4_HHA1_C3_38,D1_SNF_C1_74,A_C6_200,B_1_C22_88,G_C1THRU4_39,S3_2_C2_39,C_1_C7_64,S4_HHA3_C2_33,D_5_HOS_C2_9201,S3_2_C5_31,S2_1_C2_130,S3_2_C6_28,S3_2_C5_35,D_5_HOS_C4_90,D3_SNF_C2_96,S3_1_C8_32,D_1_HOS_C7_41,D_4_SNF_C11_74,D_5_HOS_C2_74,S3_2_C2_18,A_C2_52,S5_C1_12,S3_1_C2_14,S4_HHA1_C1_38,D_4_HOS_C11_76,D3_IPF_C2_73,B_1_C22_115,S10_C1_18,D3_SNF_C2_91,S10_C1_2,D_4_HOS_C2_93,A7_3_C7_1,D3_IPF_C3_98,D3_IPF_C2_68,B_1_C26_201,D_4_HOS_C2_200,D_5_HOS_C7_64,B_2_C26_45,D_5_HOS_C2_70,D_5_HOS_C5_62,D_4_SNF_C11_58,S3_2_C6_33,D_4_HOS_C10_60,S3_1_C8_25,D_5_HOS_C7_60,D3_HOS_C2_30,D_4_SNF_C11_63,S5_C2_10,D_5_HOS_C5_73,A_C2_107,B_2_C26_96,D_4_HOS_C2_63,D3_SNF_C2_50,S5_C1_8,D3_SNF_C3_73,C_1_C5_9920,G3_C1_28,A7_1_C2_7,D3_SNF_C3_91,B_2_C26_107,S3_1_C3_8,B_2_C26_95,S3_2_C2_11,D3_IPF_C3_55,D_5_HOS_C7_69,D_5_HOS_C2_60,G_C1THRU4_51,A8_C2_24,D_5_HOS_C5_200,D3_HOS_C3_69,C_1_C6_53,A_C2_75,D_4_HOS_C3_55,A_C1_30,C_1_C5_98,D3_SNF_C3_72,D3_IPF_C2_57,S4_HHA1_C3_34,D_5_HOS_C7_98,A_C2_4,B_1_C22_73,B_1_C21_194,D_5_HOS_C2_73,A_C2_33,A_C6_4501,D_4_HOS_C4_72,S3_2_C2_34,S3_2_C5_36,S3_1_C10_14,D_4_IPF_C13_76,D_4_IPF_C13_93,B_1_C21_63,B_1_C26_91,S3_1_C8_22,S2_1_C4_3,D3_SNF_C3_58,D3_SNF_C3_71,A_C1_41,B_1_C26_193,C_1_C7_9940,D_1_HOS_C7_31,A_C6_43,S5_C2_9,D_5_HOS_C2_50,A8_C2_26,C_1_C6_94,C_1_C6_64,S3_2_C2_16,S3_2_C4_9,S3_1_C3_12,B_1_C22_107,C_1_C6_105,E_B_HOS_C1_19,A_C6_1,C_1_C6_106,S5_C1_14,D_5_HOS_C2_69,S5_C2_2,B_1_C22_193,B_1_C21_56,A8_C2_13,B_1_C26_52,B_1_C0_60,D3_IRF_C2_50,C_1_C7_61,D_5_HOS_C4_9201,D_5_HOS_C3_93,S3_1_C8_14,B_1_C26_9940,B_1_C0_33,S3_3_C4_1,D_4_HOS_C11_69,A_C2_30,C_1_C6_75,D_5_HOS_C2_72,D_5_HOS_C6_71,D3_SNF_C2_65,D3_SNF_C2_59,E_B_HOS_C1_31,G_C1THRU4_23,C_1_C7_93,D_4_IRF_C4_200,C_1_C7_117,S2_1_C2_1518,C_1_C7_73,B_1_C21_93,B_1_C22_101,B_1_C22_65,D_3_HOS_C9_200,D3_IRF_C3_72,D_5_HOS_C2_56,B_1_C0_72,B_1_C0_19,D3_IRF_C2_52,D_5_HOS_C2_57,S3_1_C11_20,B_1_C26_44,D_4_HOS_C2_88,S3_2_C2_28,B_1_C22_56,A_C6_111,D_4_SNF_C11_75,D3_HOS_C3_6250,S2_1_C1_35,A_C1_9,D3_IRF_C3_52,S3_2_C5_42,A_C1_190,S2_1_C1_143,D_4_HOS_C10_76,D_4_HOS_C13_68,S3_2_C2_40,D_4_HOS_C2_97,D_4_HOS_C3_60,D_4_HOS_C2_73,B_2_C26_57,S5_C1_5,B_2_C26_4501,D3_IPF_C2_32,D_4_HOS_C13_98,S3_2_C4_30,S2_1_C2_1522,C_1_C5_33,S3_1_C11_27,C_1_C6_55,D_4_IRF_C2_200,D_5_HOS_C5_91,S3_2_C6_42,A_C6_71,C_1_C7_54,S3_1_C11_26,D_4_HOS_C1_200,B_2_C26_98,B_1_C21_192,C_1_C7_67,D_4_HOS_C10_69,B_1_C0_59,D_4_IRF_C11_68,S3_1_C10_27,C_1_C7_69,D_4_HOS_C11_62,D3_HOS_C3_64,E_B_HOS_C1_7,D_5_HOS_C7_57,A_C2_3,S4_HHA1_C5_34,G_C1THRU4_40,B_1_C21_116,D3_HOS_C2_59,S4_HHA2_C5_33,D_4_IRF_C11_72,C_1_C7_71,D_5_HOS_C6_51,D3_IRF_C3_73,S3_2_C4_40,A_C1_6250,A_C6_34,C_1_C5_105,G_C1THRU4_8,E_B_HOS_C1_1,E_A_HOS_C1_72,D_5_HOS_C2_93,S3_1_C14_18,S3_2_C3_2552,D_4_IRF_C11_76,S3_1_C4_7,D_4_HOS_C10_9201,D_5_HOS_C4_66,B_1_C0_55,C_1_C5_54,S3_1_C13_2,D_4_HOS_C10_56,D_4_IPF_C11_74,D_4_HOS_C13_55,S3_1_C2_10,A_C1_15,D_4_HOS_C12_65,D3_SNF_C3_70,G_C1THRU4_46,B_1_C0_23,D3_HOS_C3_54,A_C2_9940,B_1_C22_34,D_5_HOS_C6_57,D3_IRF_C2_56,D_5_HOS_C6_9201,B_1_C0_190,A7_1_C1_1,A_C2_56,A8_C2_30,B_1_C0_35,S3_2_C4_8,D_5_HOS_C4_56,G_C1THRU4_48,A_C6_194,E_B_HOS_C1_42,C_1_C6_96,E_B_HOS_C101_2,D_4_HOS_C2_64,B_1_C26_89,D_4_IRF_C13_66,C_1_C6_111,D_4_HOS_C11_73,G3_C1_3,A_C1_114,S2_1_C2_1807,C_1_C7_100,D_4_IRF_C13_59,D3_IPF_C3_53,A8_C2_15,D_5_HOS_C3_58,C_1_C5_108,D_5_HOS_C5_76,E_B_HOS_C1_44,S4_HHA2_C5_36,S3_1_C6_25,A_C1_91,S3_1_C7_12,B_1_C26_71,B_1_C26_4501,B_1_C22_89,S3_1_C4_1,S3_1_C15_17,D_4_IRF_C11_58,D3_IRF_C3_58,B_1_C21_101,A_C1_65,C_1_C7_112,D3_SNF_C2_63,D_5_HOS_C6_68,S3_2_C2_2553,D3_IRF_C3_55,A7_3_C5_1,B_2_C26_94,B_1_C21_91,G_C1THRU4_31,D_4_HOS_C13_59,D3_SNF_C3_200,D_4_SNF_C11_76,A_C6_68,D_4_SNF_C11_51,D_4_IPF_C13_50,B_1_C26_59,S3_2_C5_9,A_C1_9910,A_C1_191,D_4_HOS_C12_62,D_4_HOS_C3_52,A_C2_71,D_5_HOS_C3_55,D3_HOS_C3_63,S3_2_C3_2201,D3_IPF_C3_67,D3_SNF_C2_51,D3_SNF_C2_94,S3_1_C3_1801,D3_SNF_C3_76,S5_C1_15,A_C2_6250,S3_2_C4_38,D_4_HOS_C12_59,D_4_HOS_C12_53,B_1_C26_72,A_C2_113,G_C1THRU4_11,D_4_HOS_C3_88,A_C1_59,D3_SNF_C2_71,S3_2_C4_4,D_4_HOS_C3_68,D3_HOS_C3_66,C_1_C6_62,D_5_HOS_C6_73,D_4_HOS_C4_51,S3_1_C5_14,A_C2_15,S3_2_C2_22,S3_2_C6_6,D_5_HOS_C3_60,D_1_HOS_C4_43,D_5_HOS_C3_53,D_4_HOS_C2_54,D_4_HOS_C2_60,D_4_HOS_C13_53,D_5_HOS_C6_6250,D_5_HOS_C7_67,A_C1_45,C_1_C6_68,D3_SNF_C2_34,C_1_C6_89,S2_1_C2_1605,C_1_C2_66,D3_IPF_C3_66,S3_2_C5_37,S3_2_C6_30,B_1_C26_54,D_5_HOS_C5_74,D1_SNF_C1_37,D_4_IRF_C11_70,B_2_C26_88,A7_1_C5_10,D_1_HOS_C7_200,D_4_HOS_C2_74,D_4_IPF_C11_54,A_C2_96,S4_HHA1_C1_34,D3_HOS_C3_65,G_C1THRU4_27,D_4_HOS_C12_56,C_1_C7_70,B_2_C26_9910,S2_1_C2_128,S2_1_C2_10,D_4_HOS_C2_72,S3_1_C3_20,C_1_C5_64,S3_1_C7_10,C_1_C6_66,S3_2_C2_2201,S3_2_C3_25,S3_1_C2_16,D_3_HOS_C5_200,B_1_C22_75,B_1_C26_9920,D_5_HOS_C3_9201,E_B_HOS_C1_21,D3_IRF_C3_96,D_4_IRF_C11_91,A_C2_45,A_C1_35,A_C1_70,S3_2_C2_35,B_1_C21_53,S2_1_C1_22,D_4_SNF_C11_52,E_B_HOS_C1_24,B_1_C21_33,A_C1_55,A_C1_192,A8_C2_6,S2_1_C1_134,A_C2_13,B_1_C26_97,D_4_IPF_C13_71,C_1_C5_61,D_4_IRF_C13_52,S2_1_C2_129,A8_C2_22,D_5_HOS_C4_71,S3_1_C10_24,D_5_HOS_C2_52,B_2_C26_201,S3_3_C6_4,A_C6_51,B_1_C0_115,D_4_HOS_C13_58,A_C1_9940,S3_1_C10_2001,S5_C1_1,A_C2_44,E_B_HOS_C1_17,B_1_C0_91,B_1_C21_70,B_1_C0_193,B_1_C21_117,B_1_C0_51,A_C2_10,C_1_C6_34,S2_1_C1_144,D_4_IRF_C11_73,D_1_HOS_C4_34,D_4_HOS_C3_90,D_4_IRF_C13_73,D_4_HOS_C11_53,A_C2_70,D_4_HOS_C3_50,A_C1_57,B_1_C22_117,B_1_C22_191,D3_HOS_C3_50,A8_C2_12,S3_2_C5_13,D_5_HOS_C5_58,A_C6_23,A_C1_105,D3_IPF_C3_50,D_4_IPF_C11_58,C_1_C6_4501,G_C1THRU4_45,B_2_C26_6250,S3_1_C13_18,D3_SNF_C3_60,D_5_HOS_C6_65,S3_1_C10_22,S3_1_C7_2,B_1_C26_4201,C_1_C6_99,S3_1_C7_32,D_5_HOS_C4_55,B_2_C26_59,S5_C2_6,B_2_C26_51,S2_1_C2_13,B_1_C0_64,S10_C3_23,S3_1_C8_21,B_1_C22_110,C_1_C6_95,D3_IPF_C3_56,S3_2_C5_32,B_1_C26_9201,D_5_HOS_C4_52,B_1_C21_44,B_1_C26_31,S4_HHA3_C2_38,D1_HOS_C1_49,D3_IRF_C3_56,S3_2_C4_14,S3_2_C2_1,S2_1_C2_3601,D_4_HOS_C12_70,D_4_SNF_C11_9201,D_4_IPF_C11_67,D_4_IPF_C11_76,B_1_C0_106,S5_C1_7,B_1_C21_32,B_1_C21_62,D_5_HOS_C5_69,E_B_HOS_C1_6,D_4_SNF_C11_57,S2_1_C2_1,D_5_HOS_C6_61,C_1_C6_58,D_4_HOS_C4_76,S5_C4_2,D_4_HOS_C10_65,E_B_HOS_C1_39,A_C2_68,D3_IPF_C2_96,D3_IRF_C3_53,D3_SNF_C2_93,E_B_HOS_C1_34,D3_HOS_C2_52,D_5_HOS_C5_72,E_B_HOS_C1_5,D3_SNF_C2_73,A_C1_53,D_4_IRF_C13_68,A7_3_C10_2,D3_HOS_C2_34,C_1_C5_9910,A_C6_91,A7_3_C10_1,S3_1_C8_26,D_4_HOS_C12_54,S3_1_C5_17,A_C2_91,A_C6_9201,B_1_C0_109,D1_IRF_C1_50,D3_IPF_C2_64,A_C6_18,B_1_C21_193,B_1_C21_106,S3_1_C15_18,C_1_C5_93,B_1_C26_109,A8_C2_21,B_1_C22_100,D_5_HOS_C2_55,D_4_IRF_C11_52,D3_HOS_C3_96,A_C6_9910,C_1_C7_115,B_1_C26_115,B_1_C26_63,A_C2_67,D_4_IPF_C11_69,B_1_C22_74,B_1_C0_43,A_C1_33,D_3_HOS_C9_35,D_5_HOS_C2_63,B_1_C22_52,S5_C3_1,D3_IPF_C2_94,G2_C1_28,D3_HOS_C3_67,S3_2_C2_13,A_C2_42,S10_C1_12,D_5_HOS_C4_76,D_4_IPF_C11_66,S4_HHA3_C3_33,D_4_IPF_C11_91,D_4_IRF_C11_67,S2_1_C1_3601,S3_2_C6_37,A_C2_43,A_C1_71,B_1_C26_112,B_2_C26_74,D_4_SNF_C11_65,S2_1_C1_38,S3_3_C6_5,D_5_HOS_C3_52,D_4_HOS_C11_65,S10_C2_23,C_1_C6_93,D_3_HOS_C2_200,B_2_C26_200,D3_HOS_C3_68,S3_1_C10_26,D_5_HOS_C2_76,B_2_C26_33,D3_SNF_C3_69,A_C6_72,S3_1_C6_16,D_4_HOS_C2_50,D3_IPF_C2_40,B_1_C26_100,C_1_C5_6250,D_5_HOS_C6_58,D3_IPF_C2_63,D3_HOS_C2_32,S3_1_C7_9,C_1_C6_42,A8_C2_3,B_2_C26_44,S10_C1_14,A8_C2_29,B_1_C0_30,B_1_C21_40,C_1_C6_52,S3_1_C5_19,D_5_HOS_C5_71,B_1_C21_67,D_4_IRF_C11_98,C_1_C6_115,D3_HOS_C2_40,G_C1THRU4_2,S2_1_C1_1,D3_IRF_C2_200,C_1_C5_62,D_1_HOS_C4_30,S3_1_C7_1,B_1_C21_191,G_C1THRU4_38,D3_IRF_C2_96,A_C2_58,D3_HOS_C3_200,D_4_HOS_C4_91,S3_2_C5_27,D_4_IRF_C13_53,D_4_HOS_C13_67,S3_3_C2_1,D_4_HOS_C2_76,B_1_C21_109,B_1_C0_5,FFY,Hospital Type (From CMS Hospitals Data Archive),Name and Num
,Curated Name and Num,Hospital type (modified),Type of Control of Hospital (See Table I),Lon,Lat,Emergency,Total Subprovider II Interns & Residents,Interns & Res Salary and Fringe Benefits,SNF,Total Allied Health,Laundry and Linen Service,ICF,Drugs Charged to Patients,Occupational Therapy,Electroencephalography,ESRD DME costs,Subprovider II,Organ Procurement,Operating Room,Physical Therapy,RHC,Observation Beds (Distinct Unit),RHC 4 Provider Number,Total,Housekeeping,Subprovider II,Other General Service,"Is this a teaching hospital or
affiliated with a teaching hospital? (Y/N)",Home Program Dialysis,Total,Cafeteria,Liver Acquisition,Respiratory Therapy,TOTAL,"Blood Storing, Processing, Trans",Minor Equipment Depreciable,OLTC,ICF,Total Program Inpatient Costs,Blood Clotting Factors for Hemoph.,Home Program Dialysis,Renal Dialysis,Net Revenue from stand-alone SCHIP,Recovery Room,Whole Blood & Packed Red Blood Cells,Physical Therapy,Other Special Purpose,Nursery,Premiums,OLTC,PEP:  Total Non Routine Med Supply Chgs,Operating Room,Electroencephalography,Respiratory Therapy,HHA,Impl. Dev. Charged to Patients,OLTC,Wage Related Costs Other,Respiratory Therapy,Radiology-Diagnostic,Cardiac Catheterization,Subprovider II,Respiratory Therapy,Speech Pathology,CT Scan,Average times dialyzers re-used,Laboratory,Labor and Delivery Days Title 18,Total,Subprovider-IPF,Employee Benefits,Vending Machines,Operating Room,Clinic,Interns & Res Salary and Fringe Benefits,Durable Medical Equipment Sold,Interns & Residents,"Blood Storing, Processing, Trans",RPCH/CAH Visits,Total discharges,Other Reimbursable,Emergency,Cost of physicians svcs in a teaching hospita,Int & Res (non approved teaching program,Physical Therapy,CT Scan,Emergency,NF,Total Overhead Costs,Total,Radioisotope,Emergency,Home Program Dialysis,Without Outliers:  Total Visits,Clinic,OSP,Coronary Care Unit,Sale of medical and surgical supplies to,Nursing Administration,Other Organ Acquisition,Emergency,Non-Physician Anesthetist Part B,Drugs Charged to Patients,"Medicare certified kidney 
transplant center cert date","Blood Storing, Processing, Trans",Home Office Salaries,Whole Blood & Packed Red Blood Cells,Subprovider-IRF,Intensive Care Unit,Social Service,Management and Administrative Services,Int & Res (non approved teaching program,Cardiac Catheterization,Program Inpatient Ancillary Service Cost,Subprovider-IPF,Laundry and Linen Service,Anesthesiology,FQHC 1 Provider Number,Home Office:  Physician Part A,Social Service,Occupational Therapy,OLTC,Nonphysician Anesthetists,MDH status ending date (MM/DD/YY),Total,CT Scan,Intravenous Therapy,ASC (Non Distinct Part),Subprovider I,Subtotal,Other Outpatient Services,CT Scan,Nonpaid Workers,Lung  Acquisition,Recovery Room,Total,Other Ancillary,Drugs Charged to Patients,Delivery Room and Labor Room,Electrocardiology,Clinic,Home Program Dialysis,Occupational Therapy,OOT,With Outliers:  Total Charges,Heart Acquisition,OPT,"Medical certified liver 
transplant center cert date",Respiratory Therapy,Clinic,HHA,Excluded Area Salaries,Home Program Dialysis,Durable Medical Equipment Rented,Total,Organ acquisition,Hospice 1 Provider Number,Total Program Excludable Costs,OLTC,SNF,Employee Benefits,Title XVIII discharges,Home Office Salaries,Intravenous Therapy,With Outliers:  Non Routine Med Sup Chgs,Renal Dialysis,Emergency,Outpatient Rehab Provider,Radioisotope,Other Reimbursable,Impl. Dev. Charged to Patients,Other Organ Acquisition,Impl. Dev. Charged to Patients,PBP Clinical Lab Services Program Only,Durable Medical Equipment Rented,Laboratory,Pancreas Acquisition,Islet Acquisition,"Blood Storing, Processing, Trans",Radioisotope,Whole Blood & Packed Red Blood Cells,Nursery,Operation of Plant,Other Special Purpose,Without Outliers:  Total Charges,Other Ancillary,Clinic,Interns & Residents,Laboratory,NF,Heart Acquisition,Drugs Charged to Patients,net of Swing Bed and Private Room Diff,FQHC,Islet Acquisition,Other Ancillary,Cardiac Catheterization,Observation Beds (Distinct Unit),Wage Related Costs Core,Respiratory Therapy,Social Service,Radiology-Therapeutic,Radiology-Therapeutic,Recovery Room,OLTC,MRI,Durable Medical Equipment Rented,Drugs Charged to Patients,Home Office:  Physician Part A,Renal 2 Provider Number,State or local govt (not Medicaid or CHIP) -- Costs minus net revenue (0 min),CMHC,Subprovider-IPF,Intravenous Therapy,Speech Pathology,Electrocardiology,TOTAL,Central Services and Supply,Renal 9 Provider Number,Non-Physician Anesthetist Part A,Emergency,Other Reimbursable,Total,Hospital City,PBP Clinical Lab Services Program Only,Total,Is this hospital an All-Inclusive rate provider? (Y/N),Subprovider II,Electrocardiology,Other Special Care,OSP,Adults and Pediatrics,Liver Acquisition,MRI,Allowable bad debts for dual eligibles beneficiaries,Total Salaries,Laboratory,Clinic,Radiology-Diagnostic,CT Scan,PEP Episodes:  Total Visits,Ambulance Services,Burn Intensive Care Unit,Physical Therapy,Census Division Code,Pharmacy,Other Nonreimbursable,Coronary Care Unit,Subtotal,Drugs Charged to Patients,Cost To Charge Ratio,Delivery Room and Labor Room,Subprovider-IPF,Recovery Room,Electrocardiology,Other Outpatient Services,Cardiac Catheterization,Clinic,Drugs Charged to Patients,FQHC 2 Provider Number,With Outliers:  Total Charges,Adults and Pediatrics,Fiscal Intermediary Number,NF,FQHC,Radiology-Diagnostic,SNF,Total Non Routine Medical  Supply Charges,Durable Medical Equipment Rented,Coronary Intensive Care Unit,Drugs Charged to Patients,Radioisotope,Coronary Care Unit,Physician-Part B,FQHC,Intravenous Therapy,OSP,Observation Beds (Distinct Unit),CT Scan,Delivery Room and Labor Room,Non-Physician Anesthetist Part B,Radiology-Diagnostic,Speech Pathology,RHC 24 Provider Number,Less: Allowances for uncollectible notes and accounts receivable,Radiology-Diagnostic,Renal 7 Provider Number,Operating Room,FQHC,Deductibles and coinsurance related to line 24,Total,Observation Beds (Distinct Unit),Subtotal,Renal Dialysis,Utilization,Fiscal Year Begin Date,HHA,Total Nursing School,Drugs Charged to Patients,Home Office Salaries & Wage Related Csts,LUPA Episodes:  Total Number of Episodes,HHA 1 Provider Number,MRI,Electroencephalography,Without Outliers:  Total Charges,"Blood Storing, Processing, Trans",Clinic,Cafeteria,CORF,Physical Therapy,Radioisotope,Durable Medical Equipment Rented,Recovery Room,CAPD exchanges per day,NF,Medical Records & Med Records Library,Line 2 times line 5,Deferred Income,Research,Adults & Pediatrics,Hospital Adlts & Ped Swing Bed NF,"If this facility qualifies as a RPCH/CAH, has it elected the all inclusive payment for outpatient service? (Y/N)",Other Ancillary,Occupational Therapy,Total Fixed Assets,interns and residents,OLTC,Renal Dialysis,RHC 16 Provider Number,RHC 10 Provider Number,Delivery Room and Labor Room,Total Other Medical Education Cost,"Blood Storing, Processing, Trans",Electrocardiology,Report Status Code,Renal Dialysis,Subtotal,Lung  Acquisition,Laboratory,Blood Clotting Factors for Hemoph.,Interns & Residents,Home Office:  Physician Part A,Anesthesiology,Operating Room,Operation of Plant,Hospice 2 Provider Number,Organ Procurement,Observation Beds (Distinct Unit),Whole Blood & Packed Red Blood Cells,RHC,Ambulance Trips,Radioisotope,Electrocardiology,"If Line 32, Col 1 is yes, enter the method used: (A, B, or E only)",LUPA Episodes:  Other Charges,Have you established a new subprovider excluded unit under 42 CFR 413.40(f)(1)(I)?(Y/N),Interns & Res Other Program Costs,Heart Acquisition,Radiology-Therapeutic,Delivery Room and Labor Room,Balance due provider/program,Less Contractual Allowance and Discounts on Patients' Accounts,Other Special Purpose,MRI,Anesthesiology,Kidney Acquisition,Nursery,RHC 20 Provider Number,Durable Medical Equipment Sold,"Anesthetist, and Medical Education Costs",Renal 1 Provider Number,Drugs Charged to Patients,Other General Service,Recovery Room,CMHC,Renal Dialysis,ASC (Non Distinct Part),Cardiac Catheterization,Subprovider-IRF,Medical and Other Services reimbursed by OPPS,HHA,Hospital Adlts & Ped Swing Bed NF,Land Improvements,Intravenous Therapy,CT Scan,Anesthesiology,LUPA Episodes:  Total Visits,Home Office Salaries & Wage Related Csts,Electrocardiology,Electrocardiology,Total,Clinic,Impl. Dev. Charged to Patients,IRF Provider Number,Ancillary service charges,RHC,Total Charges,Total Bad Debt expense,Aggregate amount collected from patients,Cafeteria,Renal Dialysis,With Outliers:  Number of Episodes,Electrocardiology,net of Swing Bed and Private Room Diff,Radiology-Diagnostic,ASC (Non Distinct Part),Medical Records and Medical Rec. Library,OPPS payments,Speech Pathology,Durable Medical Equipment Rented,ASC (Distinct Part),Cardiac Catheterization,Occupational Therapy,Recovery Room,Medical Supplies Charged to Patients,"Blood Storing, Processing, Trans",Drugs Charged to Patients,Total,Ambulance Services,Radioisotope,Interns & Residents,Central Services and Supply,Physical Therapy,IPF,Operating Room,Drugs Charged to Patients,Medical Supplies Charged to Patients,Administrative and General,Impl. Dev. Charged to Patients,Anesthesiology,OSP,Radiology-Diagnostic,Physician Part B,Anesthesiology,Maintenance and Repairs,Other Nonreimbursable,Other Special Care Unit,Whole Blood & Packed Red Blood Cells,Intensive Care Unit Program Cost,Allowable Inpatient Cost Plus Incentive Pt,Inventory,MRI,Medical Supplies Charged to Patients,Kidney Acquisition,Subprovider 2,Clinic,Burn Intensive Care Unit,Without Outliers:  Total Visits,"Blood Storing, Processing, Trans",Total,Clinic,Subtotal Wage Related Csts,Drugs Charged to Patients,Laboratory,OLTC,Respiratory Therapy,Admin & Gen Under Contract,Coronary Care Unit,Dietary,Outpatient Rehab Provider,Medical Supplies Charged to Patients,Recovery Room,ASC (Non Distinct Part),Pancreas Acquisition,Wage Related Costs RHC/FQHC,RHC 14 Provider Number,MRI,Intravenous Therapy,RHC 11 Provider Number,Durable Medical Equipment Rented,Radiology-Therapeutic,Non-Physician Anesthetist Part B,Buildings and Fixtures,Surgical Intensive Care Unit,Clinic,Observation Beds (Distinct Unit),Impl. Dev. Charged to Patients,Title XVIII discharges,PEP Episodes:  Total Charges:,Clinic,Intravenous Therapy,"Is this a New Hospital under
42 CFR 412.300 PPS capital
(Y/N)",Surgical Intensive Care Unit,Lung  Acquisition,LUPA:  Total Non Routine Med Sup Chgs,Laboratory,Speech Pathology,Lung  Acquisition,Non-Physician Anesthetist Part A,Maintenance of Personnel,Radioisotope,Total Other Medical Education,Operation of Plant,ASC (Non Distinct Part),"Blood Storing, Processing, Trans","Average patient dialysis time 
including setup",Occupational Therapy,Whole Blood & Packed Red Blood Cells,Deductibles and coinsurance,Central Services and Supply,Building Improvements,Paid Losses,Subprovider-IPF,OOT,Cardiac Catheterization,LUPA:  Total Non Routine Med Sup Chgs,Home Program Dialysis,Total,Durable Medical Equipment Sold,Fiscal Intermediary/MAC Create Date,Whole Blood & Packed Red Blood Cells,Subprovider II,Radioisotope,Radioisotope,RHC,Electroencephalography,Radiology-Diagnostic,Cash on Hand and in Banks,Laboratory,Central Services and Supply,Dietary,Utilization Review-physicians compens,Other Outpatient Services,Speech Pathology,Without Outliers:  Non Routine Med Sup Chgs,CAPD exchanges per day,New Cap Related Csts Bldg & Fixtures,Home Program Dialysis,Whole Blood & Packed Red Blood Cells,CT Scan,Out of State Medicaid paid days,"Blood Storing, Processing, Trans",Non-Physician Part B,Subtotal Salaries,Provider-based physician adjustment,Home Program Dialysis,Physicians' Private Office,Other Outpatient Services,IPF Provider Number,Housekeeping under Contract,Operating Room,Medicaid HMO Days,Urban/Rural Indicator at beginning,IRF,MRI,Other Nonreimbursable,Subprovider 1,HHA,Islet Acquisition,Observation Beds (Distinct Unit),Wage Related Costs RHC/FQHC,Teaching Physician Salaries,Other Assets,Operating Room,Movable Equipment,NF,Respiratory Therapy,Total Number of Outlier Episodes,"Medical certified lung
transplant center cert date",Medical Supplies Charged to Patients,Anesthesiology,Total,Excluded Area Salaries,Emergency,Land,Housekeeping,Speech Pathology,Other Special Purpose,New Cap Related Csts Bldg & Fixtures,"Number of patients in program at 
end of cost reporting period",Respiratory Therapy,Maintenance of Personnel,Maintenance of Personnel,RHC 12 Provider Number,Renal 3 Provider Number,Other Current Liabilities,Impl. Dev. Charged to Patients,Movable Equipment,IRF Provider Number,Subprovider-IPF,Anesthesiology,Other Reimbursable,Other General Service,Hospital Adlts & Ped Swing Bed SNF,With Outliers:  Number of Episodes,Physician-Part A,Renal Dialysis,Fixed Equipment,Labor and Delivery,TOTAL,Medical Records & Med Records Library,Subtotal,Subprovider I,Surgical Intensive Care Unit,Non-Physician Anesthetist Part A,Administrative and General,Heart Acquisition,Dietary,Investment Income-New Movable Equip,Emergency,Radiology-Therapeutic,Blood Clotting Factors for Hemoph.,"Blood Storing, Processing, Trans",Utilization Review - Physician Compen,Administrative and General,Drugs Charged to Patients,Nursery,NF,Cardiac Catheterization,Observation Beds (Distinct Unit),Adults and Pediatrics,Laundry and Linen Service,Organ Procurement,Cafeteria employees and guests,Surgical Intensive Care Unit,Subprovider-IRF,Total Charges:  LUPA Episodes,Buildings and Fixtures,Total Non Routine Medical  Supply Charges,Intravenous Therapy,Respiratory Therapy,Respiratory Therapy,Anesthesiology,"Medicare certified heart
transplant center cert date",Cardiac Catheterization,Blood Clotting Factors for Hemoph.,Operating Room,Medical Records and Medical Rec. Library,Radioisotope,Subprovider-IPF,Fixed Equipment,Home Office Street,Maintenance of Personnel,"Sale of scrap, waste, etc.",Cardiac Catheterization,Outlier payments,"Gift, Flower, Coffee Shop, Canteen",Medical Supplies Charged to Patients,Intravenous Therapy,Subprovider I,Occupational Therapy,Total Outpatient Program Pass Thru Cost,Medical Supplies Charged to Patients,Nursing School,Operating Cost and Target Amount,FQHC,Interns & Residents,Coronary Care Unit,Housekeeping,Subprovider-IRF,Other Ancillary,Electrocardiology,Liver Acquisition,CAH Visits,Interns & Res Salary and Fringe Benefits,Physical Therapy,Electrocardiology,Radiology-Therapeutic,Delivery Room and Labor Room,Radiology-Diagnostic,Total Facility FTEs,Int & Res (non approved teaching program,LUPA Episodes:  Total Number of Episodes,Adults & Pediatrics,Hospice,Recovery Room,Dietary under Contract,Without Outliers:  Other Charges,Other Outpatient Services,Total Other Charges,Ambulance Services,Other Reimbursable,Hospice,Occupational Therapy,OOT,Whole Blood & Packed Red Blood Cells,Relief Payment,RHC 5 Provider Number,Cardiac Catheterization,Other Special Care Unit,Intravenous Therapy,Total reasonable charges,SNF,Ending Balance,Excluded Area Salaries,PBP Clinical Lab Services Program Only,Whole Blood & Packed Red Blood Cells,Operating Room,Cardiac Catheterization,PEP:  Total Non Routine Med Supply Chgs,Renal 6 Provider Number,Delivery Room and Labor Room,Renal Dialysis,Hospital Adults & Pediatrics,Paramedical Education,Operating Room,Intestinal Acquisition,"Blood Storing, Processing, Trans",Total,Movable Equipment,Non-Physician Part B,Respiratory Therapy,CT Scan,Hospital Name,Nursing Administration,Observation Beds (Distinct Unit),Adults and Pediatrics,OOT,Total,Amounts expected under 42 CFR,Laboratory,Subprovider-IPF,Other Ancillary,Renal 4 Provider Number,Interns & Residents,Physical Therapy,Home Program Dialysis,Fixed Equipment,Title XVIII discharges,Kidney Acquisition,Cafeteria,Other Ancillary,Medical Supplies Charged to Patients,Delivery Room and Labor Room,Occupational Therapy,Electroencephalography,Total Program Inpatient Costs,Recovery Room,New Capital Equipment,Coronary Care Unit,Excluded Area Salaries,Admin & Gen Under Contract,Excess of reasonable cost over reasonable charges,Laundry and Linen Service,Total Other Medical Education,MRI,Subprovider I,Intensive Care Unit,Emergency,Delivery Room and Labor Room,Electrocardiology,Other Special Care,Other Outpatient Services,Other Special Care,Utilization Review SNF,Whole Blood & Packed Red Blood Cells,Whole Blood & Packed Red Blood Cells,Other Outpatient Services,Drugs Charged to Patients,ASC (Non Distinct Part),Total Number of Outlier Episodes,Home Office Personnel,CMHC,Radioisotope,Medicaid Observation Days,MRI,Radioisotope,Respiratory Therapy,With Outliers:  Total Charges,Operating Room,Payments received from patients for amounts previously written off as charity care,Radiology-Therapeutic,Other Special Care Unit,Coronary Care Unit,Home Program Dialysis,net of Swing Bed Cost,Whole Blood & Packed Red Blood Cells,Total Charges:  LUPA Episodes,Respiratory Therapy,CT Scan,SNF,CMHC,Title V discharges,Hospice,NF,Outlier payments,Number of periods hospital was in MDH status,RHC 21 Provider Number,Operating Room,Speech Pathology,New Cap Related Csts Movable Equipment,Durable Medical Equipment Sold,Net revenue from state/local govt indigent care (not Medicaid or CHIP),Drugs Charged to Patients,Radiology-Diagnostic,Other Ancillary,Other Reimbursable,Intensive Care Unit,Anesthesiology,Movable Equipment,"Blood Storing, Processing, Trans",Other Ancillary,Impl. Dev. Charged to Patients,Whole Blood & Packed Red Blood Cells,Radiology-Therapeutic,Hospice,MRI,Anesthesiology,Cardiac Catheterization,"Blood Storing, Processing, Trans",Physical Therapy,Nursing Administration,Total,Cafeteria,Nonpaid Workers,Other Organ Acquisition,Other Reimbursable,Radiology-Diagnostic,Recovery Room,Intestinal Acquisition,Total,Intensive Care Unit,Other Outpatient Services,Radiology-Diagnostic,Emergency,Observation Beds (Distinct Unit),Burn Intensive Care Unit,Whole Blood & Packed Red Blood Cells,Other Organ Acquisition,Operating Room,Electrocardiology,Subprovider-IRF,Other Outpatient Services,Electrocardiology,Intravenous Therapy,Intravenous Therapy,Subprovider-IRF,MRI,Total Long-term Liabilities,Total Assets,Other Ancillary,Subtotal,Cost of patients approved for charity care and uninsured discounts,Out of State Medicaid eligible days,Other Ancillary,Subprovider I,Program Ancillary Services,Without Outliers:  Total Charges,Leasehold Improvements,Contract Labor,Home Office:  Physician Part A,Initial Physician Payment Method (Y/N),Islet Acquisition,Electroencephalography,Total,Medical Supplies Charged to Patients,Physical Therapy,Physical Therapy,Radiology-Therapeutic,RHC,W/Out Outliers:  Number of Episodes,ASC (Non Distinct Part),Nursery,Anesthesiology,Subtotal Other Wages and Related Csts,Operation of Plant,SNF,Medical Supplies Charged to Patients,Surgical Intensive Care Unit,ASC (Distinct Part),Program Inpatient Ancillary Service Cost,New Capital Buildings and Fixtures,Blood Clotting Factors for Hemoph.,ASC (Non Distinct Part),Blood Clotting Factors for Hemoph.,Kidney Acquisition,Electrocardiology,Recovery Room,Nursery,Housekeeping,Net Salaries,Total,Operating Room,"Treatment capacity per day per
station",Islet Acquisition,OLTC,Total Facility,OPT,Subprovider-IRF,Observation Beds (Distinct Unit),SNF,Whole Blood & Packed Red Blood Cells,Intensive Care Unit,Home Office Personnel,Laundry and Linen Service,Intestinal Acquisition,HHA,Other Outpatient Services,Social Service,Intravenous Therapy,Occupational Therapy,Hospital Provider Number,Lung  Acquisition,Other Ancillary,Occupational Therapy,Cardiac Catheterization,Electrocardiology,Physical Therapy,Electroencephalography,Intestinal Acquisition,Blood Clotting Factors for Hemoph.,Observation Beds (Distinct Unit),Other General Service,Housekeeping,Surgical Intensive Care Unit,Radiology-Therapeutic,Delivery Room and Labor Room,"Blood Storing, Processing, Trans",Blood Clotting Factors for Hemoph.,Medicare allowable bad debts for the entire hospital complex,Clinic,Radioisotope,Maintenance and Repairs,Research,Organ Procurement,Physician-Part B,Occupational Therapy,Intensive Care Unit,Interns & Res Salary and Fringe Benefits,PBP Clinical Lab Services Program Only,Total Salaries,Home Office Salaries & Wage Related Csts,Respiratory Therapy,Intravenous Therapy,CT Scan,Renal Dialysis,Partial or full credits from manufacturers,Management and Administrative Services,Transitional corridor payment,Physical Therapy,Lung  Acquisition,Surgical Intensive Care Unit,MRI,Total discharges,Other Special Care Unit,Cardiac Catheterization,Pancreas Acquisition,Respiratory Therapy,Zip Code,Total,Maintenance and Repairs,ASC (Non Distinct Part),Fixed Equipment,MRI,Renal Dialysis,CT Scan,Intensive Care Unit,Operating Room,SNF,Renal Dialysis,Impl. Dev. Charged to Patients,Television and Radio Service,New Cap Related Csts Movable Equipment,Home Program Dialysis,Related  Salaries,Observation Beds (Distinct Unit),Subprovider-IRF,Radiology-Diagnostic,Other Outpatient Services,Medical Supplies Charged to Patients,Social Service,Durable Medical Equipment Sold,"Gift, Flower, Coffee Shop, Canteen",Other Special Purpose,Emergency,Electroencephalography,Anesthesiology,Buildings and Fixtures,Medical Supplies Charged to Patients,Durable Medical Equipment Rented,Physical Therapy,Total Income,Research,Total Salaries,Other Outpatient Services,Int & Res (non approved teaching program,Radiology-Diagnostic,OLTC,Impl. Dev. Charged to Patients,Observation Beds (Distinct Unit),Intravenous Therapy,Cafeteria,Drugs Charged to Patients,Heart Acquisition,Liver Acquisition,Total Hospital,Operation of Plant,Total,Physical Therapy,SSA State Code,Other Ancillary,Impl. Dev. Charged to Patients,Total Hospital Interns & Residents,Physical Therapy,Speech Pathology,Net Salaries,Clinic,Observation Beds (Distinct Unit),Hospital Adults & Ped Swing Bed SNF,Cardiac Catheterization,Contract Labor,Subtotal Salaries,OOT,Medical Records and Medical Rec. Library,Clinic,HHA,Burn Intensive Care Unit,"Number of days in year dialysis 
furnished",Radioisotope,"Percentage of patients re-using
dialyzers",Laboratory,Is this a New Hospital under 42 CFR 413.40(f)(1)(I) (TEFRA)? (Y/N),Whole Blood & Packed Red Blood Cells,FQHC,Radiology-Diagnostic,Total Costs,Total Hospital,Other Special Care,TOTAL,Hospice,Intravenous Therapy,Other Organ Acquisition,Delivery Room and Labor Room,Does the facility operate an ICF/MR facility for purposes of Title XIX? (Y/N),Radioisotope,Report Record Number,LUPA Episodes:  Total Visits,Radiology-Therapeutic,Home Program Dialysis,Electroencephalography,Electroencephalography,ASC (Non Distinct Part),Electrocardiology,Speech Pathology,Coronary Care Unit,Operating Room,Buildings and Fixtures,ASC (Non Distinct Part),Electroencephalography,Payments received from patients for amounts previously written off as charity care,MRI,Depreciation-New Movable Equipment,Physical Therapy,Laboratory,Radiology-Diagnostic,Islet Acquisition,Nursing School,Observation Beds (Distinct Unit),Hospital Adults & Pediatrics,Total Hospital Interns & Residents,Clinic,Laboratory,Durable Medical Equipment Rented,OPPS payments,Radiology-Therapeutic,Dietary,Anesthesiology,Total,Transitional corridor payment,Coronary Care Unit,Physician Part A,"Blood Storing, Processing, Trans",Operating Room,Medicaid charges,Intravenous Therapy,Radiology-Diagnostic,Land,Subprovider I,Building Improvements,Durable Medical Equipment Rented,Respiratory Therapy,Occupational Therapy,RHC/FQHC Combined,Subprovider-IPF,"Gift, Flower, Coffee Shop, Canteen",Physician-Part B,Emergency,Operating Room,HVBP payment adjustment amount,Notes Receivable,Pharmacy,Surgical Intensive Care Unit,PEP:  Total Non Routine Med Supply Chgs,Occupational Therapy,CT Scan,"Blood Storing, Processing, Trans",MRI,Buildings and Fixtures,Intravenous Therapy,Observation Beds (Distinct Unit),New Capital Equipment,ASC (Non Distinct Part),IPF,Ambulance Services,Delivery Room and Labor Room,SSA State County Code,Organ acquisition charges,FQHC 8 Provider Number,Private grants or donations or endowment income restricted to funding charity care,Dietary,Liver Acquisition,Speech Pathology,"Number of patients in program at 
end of cost reporting period",Other Reimbursable,OOT,With Outliers:  Total Visits,Operating Room,Intestinal Acquisition,Coronary Care Unit,MRI,Building Improvements,Other General Service,ICF,Electroencephalography,Emergency,Nonpaid Workers,PEP Episodes:  Other Charges,Recovery Room,Pancreas Acquisition,Teaching Physician Salaries,FQHC,Impl. Dev. Charged to Patients,Other Special Care,Hospice,Surgical Intensive Care Unit,Intravenous Therapy,In State Medicaid eligible days,SNF,Laboratory,Total Program General Inpatient Routine,Subprovider II,Adults & Pediatrics,Total Allied Health,Notes Payable,Physician Part A,Renal Dialysis,Speech Pathology,Renal Dialysis,Renal Dialysis,HAC reduction adjustment amount,Other Special Care Unit,Drugs Charged to Patients,Impl. Dev. Charged to Patients,Radiology-Diagnostic,Subtotal Wage Related Csts,Other Reimbursable,Nonpaid Workers,NF,Subtotal Salaries,CT Scan,Coronary Care Unit,Other Ancillary,MRI,HHA,Drugs Charged to Patients,RHC 6 Provider Number,Occupational Therapy,Administrative & General under contract,Intensive Care Unit,Teaching Physician Salaries,Adults & Pediatrics,Central Services and Supply,Respiratory Therapy,Liver Acquisition,RHC,Renal Dialysis,Whole Blood & Packed Red Blood Cells,Anesthesiology,OPT,Radiology-Therapeutic,Emergency,CMHC 1 Provider Number,Blood Clotting Factors for Hemoph.,Research,Other Reimbursable,Charity care charges and uninsured discounts for the entire facility,Impl. Dev. Charged to Patients,Radiology-Diagnostic,"Average patient dialysis time 
including setup",Nursing School,Radiology-Therapeutic,Renal 5 Provider Number,OOT,OLTC,Subprovider-IRF,Radiology-Therapeutic,Total,Medicare reimbursable bad debts for the entire hospital complex,Pass Through Cost for  Program Ancillary,Intravenous Therapy,Ambulance Services,Physical Therapy,Interns & Residents,Clinic,Swing Bed SNF Provider Number,ASC (Non Distinct Part),Total Patient Days,Provider's actual MSA or CBSA,"Blood Storing, Processing, Trans",Physician-Part B,ASC (Non Distinct Part),PBP Clinical Lab Services Program Only,Electrocardiology,Lung  Acquisition,Medical Supplies Charged to Patients,ASC (Non Distinct Part),Physical Therapy,ICF,State,SNF,IRF,"Gift, Flower, Coffee Shop, Canteen",Renal Dialysis,RHC 8 Provider Number,Kidney Acquisition,ASC (Non Distinct Part),Other Reimbursable,Total,Burn Intensive Care Unit,Respiratory Therapy,CT Scan,Interns & Res Salary and Fringe Benefits,CT Scan,Stand-alone CHIP cost,Electrocardiology,Recovery Room,Electrocardiology,Total costs for patients covered by a state or local government program,Hospital Adults & Pediatrics,Sale of medical records and abstracts,Intravenous Therapy,Total discharges,Impl. Dev. Charged to Patients,Clinic,Adults & Pediatrics,RHC 9 Provider Number,Nursery,Radioisotope,Anesthesiology,Other Special Care Unit,Electroencephalography,Recovery Room,Other Special Care Unit,Surgical Intensive Care Unit,Blood Clotting Factors for Hemoph.,Housekeeping under contract,Physical Therapy,Sale of drugs to other than patients,Land Improvements,CMHC,MRI,MDH status ending date (MM/DD/YY),Medical Supplies Charged to Patients,Central Services and Supply,Burn Intensive Care Unit,Recovery Room,Other Special Care Unit,Intravenous Therapy,Cardiac Catheterization,Clinic,Geographic MSA,Other Reimbursable,RHC 17 Provider Number,Ambulance Services,Durable Medical Equipment Rented,SNF,Radioisotope,Durable Medical Equipment Rented,Drugs Charged to Patients,Operating Room,Other Reimbursable,Heart Acquisition,Other Outpatient Services,General Fund Balance,MRI,Int & Res (non approved teaching program,CT Scan,NF,Speech Pathology,Without Outliers:  Non Routine Med Sup Chgs,Other Ancillary,Adj for Respiratory therapy costs in excess,Total unreimbursed and uncompensated care,Other Outpatient Services,OPT,Physical Therapy,Research,Anesthesiology,Observation Beds (Distinct Unit),Other Ancillary,Medical Supplies Charged to Patients,PEP:  Total Number of Outlier Episodes,Total Nonphysician Anesthetist Cost,Pancreas Acquisition,Subprovider-IPF,Other Outpatient Services,Interns & Residents,Total Program General Inpatient Routine,Fixed Equipment,Cardiac Catheterization,Ancillary service other pass through costs,Physical Therapy,Electrocardiology,Kidney Acquisition,Pancreas Acquisition,Excluded Area Salaries,Hospital Adlts & Ped Swing Bed SNF,Nursing Administration,ASC (Non Distinct Part),CMHC,Subprovider-IRF,Physicians' Private Office,Clinic,Total Charges,RHC 18 Provider Number,Recovery Room,New Cap Related Csts Movable Equipment,CT Scan,Respiratory Therapy,CT Scan,Recovery Room,"Average patient dialysis time 
including setup",Intestinal Acquisition,Anesthesiology,MRI,Interns & Residents,Electroencephalography,Other Ancillary,PBP Clinical Lab Services Program Only,Contract Labor,RHC/FQHC Combined,Delivery Room and Labor Room,Operating Room,Clinic,Respiratory Therapy,Home Program Dialysis,"Blood Storing, Processing, Trans",Cardiac Catheterization,Other Special Care Unit,Radiology-Diagnostic,Clinic,Observation Beds (Distinct Unit),Net Income from Service to Patients,Delivery Room and Labor Room,Other Outpatient Services,MRI,Physicians' Private Office,ICF,Other Outpatient Services,Other Special Care Unit,Total Salaries,Electroencephalography,W/Out Outliers:  Number of Episodes,Other Reimbursable,Excluded Area Salaries,"Gift, Flower, Coffee Shop, Canteen",Total Overhead Costs,Labor and Delivery,Investment Income-New Bldgs & Fixtures,Respiratory Therapy,Home Office Salaries & Wage Related Csts,Radioisotope,Total,Central Services and Supply,Subtotal Salaries,Lung  Acquisition,Kidney Acquisition,Durable Medical Equipment Rented,Subprovider I,Respiratory Therapy,Surgical Intensive Care Unit,Cafeteria,Other Reimbursable,Burn Intensive Care Unit,Delivery Room and Labor Room,RHC 13 Provider Number,Recovery Room,Islet Acquisition,SNF,Medical Supplies Charged to Patients,Other Reimbursable,Employee Benefits,Delivery Room and Labor Room,ASC (Non Distinct Part),Radiology-Diagnostic,Medical Supplies Charged to Patients,Occupational Therapy,Lung  Acquisition,CT Scan,Burn Intensive Care Unit,Total cost,Ambulance Services,Title V discharges,Laundry and Linen Service,Laboratory,ASC (Non Distinct Part),Int & Res (non approved teaching program,Surgical Intensive Care Unit,Anesthesiology,Heart Acquisition,Total Outpatient Program Pass Thru Cost,Other Reimbursable,RHC 3 Provider Number,Whole Blood & Packed Red Blood Cells,"Anesthetist, and Medical Education Costs","Number of Times per week 
Patient receives Dialysis",Laboratory,Radiology-Diagnostic,Int & Res (non approved teaching program,Durable Medical Equipment Sold,Other Outpatient Services,Other Special Care Unit,Subprovider I,Operating Room,Other Outpatient Services,Burn Intensive Care Unit,Pharmacy,Laboratory,Pancreas Acquisition,Home Office PO Box,Total Number of Episodes,Total,Interns & Res Other Program Costs,Anesthesiology,Observation Beds (Distinct Unit),Excluded Areas,Electroencephalography,FQHC,Is this hospital classified as a referral center? (Y/N),Recovery Room,Whole Blood & Packed Red Blood Cells,ASC (Non Distinct Part),Impl. Dev. Charged to Patients,Total Other Income,Durable Medical Equipment Sold,FQHC 5 Provider Number,Surgical Intensive Care Unit,Hospital Adults & Pediatrics,Intensive Care Unit,Title XIX discharges,Intestinal Acquisition,Anesthesiology,Other Outpatient Services,Physical Therapy,Nursing School,CT Scan,Emergency,Interns & Residents,Radiology-Diagnostic,Other Reimbursable,SNF,Observation Beds (Distinct Unit),Home Program Dialysis,Clinic,Home Program Dialysis,Drugs Charged to Patients,Renal Dialysis,Radiology-Therapeutic,Hospice,Speech Pathology,ASC (Non Distinct Part),Refunds and Rebates of Expenses,Whole Blood & Packed Red Blood Cells,Clinic,Subtotal,MRI,Cost of charity care (uninsured patients + patients w/ coverage not accepted by provider),Operating Room,Total Other Assets,Renal Dialysis,Speech Pathology,Total Inpatient Program Days,Interns and residents,Radiology-Diagnostic,Operating Room,Emergency,Coronary Care Unit Program Cost,Impl. Dev. Charged to Patients,Hospice,Drugs Charged to Patients,"Blood Storing, Processing, Trans",Electrocardiology,Respiratory Therapy,Other Outpatient Services,Laboratory,Subprovider 1,net of Swing Bed Cost,Speech Pathology,CT Scan,Cardiac Catheterization,Other Outpatient Services,Respiratory Therapy,Delivery Room and Labor Room,Home Program Dialysis,Total,Radiology-Therapeutic,"Does this facility operate 
transplant center? (Y/N)",Teaching Physician Salaries,ICF,Electroencephalography,Electrocardiology,Burn Intensive Care Unit Program Cost,Other Outpatient Services,Interim payments,Surgical Intensive Care Unit,Operating Room,Pass through Cost for Program Inpatient Routine,Cardiac Catheterization,Electroencephalography,Physical Therapy,Emergency,"Anesthetist, and Medical Education Costs",MDH status beginning date  (MM/DD/YY),Intensive Care Unit,Non-Physician Anesthetist Part B,Electroencephalography,Medical Records & Med Records Library,PBP Clinical Lab Services Program Only,MRI,ASC (Distinct Part),Radiology-Diagnostic,Home Program Dialysis,Less Observation Beds,Title XIX discharges,Other Special Purpose,Other Outpatient Services,"Are there any related organization or how office costs as defined in HCFA Pub. 15-I, chapter 10? (Y/N)",Urban (1) or Rural (2),RPCH/CAH Visits,CORF,Maintenance of Personnel,Electrocardiology,ASC (Non Distinct Part),Radiology-Therapeutic,Subprovider-IPF,Radiology-Diagnostic,Subprovider 2,Interns & Residents,Radioisotope,Adjusted reimburseable bad debts,Islet Acquisition,Medical Records and Medical Rec. Library,Occupational Therapy,Speech Pathology,Intestinal Acquisition,IRF,Total Adults & Pediatrics,Nursery,Home Office Personnel,Other Ancillary,Cardiac Catheterization,FQHC 9 Provider Number,Observation Beds (Distinct Unit),Does the hospital elect a fully prospective payment method for capital costs? (Y/N),Burn Intensive Care Unit,Subprovider-IPF,Burn Intensive Care Unit,Operating Room,Clinic,Other Reimbursable,Durable Medical Equipment Rented,Maintenance and Repairs,Building Improvements,Adults and Pediatrics,OOT,SNF,Other Ancillary,Total Visits,Non-physician Anesthetist,Total Overhead Costs,Impl. Dev. Charged to Patients,ASC (Distinct Part),Impl. Dev. Charged to Patients,Subprovider-IRF,MSP-LCC reconciliation amount,CMHC,Blood Clotting Factors for Hemoph.,ASC (Non Distinct Part),Total,Intensive Care Unit,Observation Beds (Distinct Unit),CT Scan,Radiology-Diagnostic,Total Outpatient Program Pass Thru Cost,Physical Therapy,Total Program Excludable Costs,Drugs Charged to Patients,Hospital Title 18 Payment System (P/T/O),NF,Total Hospital,Intensive Care Unit,Operation of Plant,Surgical Intensive Care Unit,Organ Procurement,Nursery,Other Outpatient Services,Durable Medical Equipment Rented,Swing Bed NF Provider Number,Cross Foot Adjustments,Radiology-Therapeutic,Fixed Equipment,Laboratory,Blood Clotting Factors for Hemoph.,With Outliers:  Total Visits,Electroencephalography,Total Hospital,Liver Acquisition,Liver Acquisition,Radiology-Therapeutic,Delivery Room and Labor Room,New Cap Related Csts Bldg & Fixtures,Nursing Administration,Physical Therapy,Total Visits,Total,Radiology-Diagnostic,Total Program Excludable Costs,Cardiac Catheterization,Radiology-Therapeutic,Organ Procurement,New Cap Related Csts Movable Equipment,Coronary Care Unit,Intensive Care Unit,Electrocardiology,Other Organ Acquisition,W/Out Outliers:  Number of Episodes,Housekeeping,ASC (Non Distinct Part),Electroencephalography,Respiratory Therapy,Pass Through Cost for  Program Ancillary,Title XVIII discharges,Ambulance Services,Subprovider 2,PEP Episodes:  Other Charges,FQHC 7 Provider Number,Outpatient Revenue,Maintenance of Personnel,Program Discharges,Land,Intensive Care Unit,Operating Room,"Number of patients in program at 
end of cost reporting period",CT Scan,Electroencephalography,Total unreimbursed cost for Medicaid and CHIP and state and local indigent care programs,Whole Blood & Packed Red Blood Cells,Burn Intensive Care Unit,Recovery Room,Total,Net Income,Total discharges,certification date,Physical Therapy,Occupational Therapy,Clinic,Hospice,Hospice,Total Hospital,Other Ancillary,Renal Dialysis,HMO,With Outliers:  Number of Episodes,Emergency,Radioisotope,Intensive Care Unit,Clinic,New Cap Related Csts Bldg & Fixtures,Other General Service,RHC,Radioisotope,Subprovider-IRF,ASC (Distinct Part),Renal Dialysis,MRI,Total Subprovider I Interns & Residents,Durable Medical Equipment Sold,Other General Service,Speech Pathology,"Sum of lines 3,4 divided by line 6",Electroencephalography,Total Hospital,Occupational Therapy,Utilization Code (L/N/F),Impl. Dev. Charged to Patients,ASC (Non Distinct Part),Recovery Room,Total Fund Balances,Other Reimbursable,Subprovider-IRF,Recovery Room,"Number of patients on transplant 
list",Interns & Residents,With Outliers:  Other Charges,Component rate ESRD,"Blood Storing, Processing, Trans",Speech Pathology,HHA,Operating Room,ASC (Non Distinct Part),Occupational Therapy,Excluded Area Salaries,Int & Res (non approved teaching program,Total Nonphysician Anesthetist Cost,Renal Dialysis,Occupational Therapy,Burn Intensive Care Unit,"Number of days in year dialysis 
furnished",Durable Medical Equipment Sold,Renal Dialysis,Number of stations,OSP,Management and Administrative Services,RHC,RHC 25 Provider Number,Cardiac Catheterization,Physical Therapy,Clinic,Occupational Therapy,Whole Blood & Packed Red Blood Cells,Physician Part B,Clinic,Non-Physician Part B,Related Salaries,Total Liabilities and Fund Balances,Hospice 3 Provider Number,Interest Expense,Recovery Room,Recovery Room,Beginning Date of SCH status,Other Reimbursable,CT Scan,PEP Episodes:  Total Number of Episodes,OOT,Medical Supplies Charged to Patients,Durable Medical Equipment Sold,Radiology-Therapeutic,Total,Intravenous Therapy,Laboratory,Respiratory Therapy,NF,Recovery Room,Physician-Part A,Recovery Room,Laboratory,Observation Beds (Distinct Unit),NF,Intensive Care Unit,Speech Pathology,Cost of patients approved for charity care and uninsured discounts,CMHC,Physicians' Private Office,Pharmacy,Other Organ Acquisition,Other Nonreimbursable,ASC (Distinct Part),Physical Therapy,Total Allied Health,Radioisotope,Subprovider-IPF,Buildings,Recovery Room,Observation Beds (Distinct Unit),Other Reimbursable,Impl. Dev. Charged to Patients,"If this Hospital is claiming cost for renal services on Worksheet A, are they inpatient services only? (Y/N)",Non-Physician Anesthetist Part B,Nursing School,Home Program Dialysis,Interns & Residents,Occupational Therapy,Medical Records & Med Records Library,Related Salaries,Nonphysician Anesthetists,Medical Supplies Charged to Patients,Anesthesiology,Occupational Therapy,Total Charges,Whole Blood & Packed Red Blood Cells,Delivery Room and Labor Room,Number of Times per week Patient receives Dialysis,Title XIX discharges,RHC 1 Provider Number,Utilization Review SNF,Land,Coronary Intensive Care Unit,Speech Pathology,Social Service,Hospice,New Cap Related Csts Movable Equipment,MRI,Subprovider-IPF,Observation Beds (Distinct Unit),PEP Episodes:  Total Number of Episodes,Radiology-Therapeutic,Other Special Care Unit,Renal Dialysis,Durable Medical Equipment Rented,With Outliers:  Non Routine Med Sup Chgs,Physical Therapy,"Net costs of Epoietin furnished to
all maintenance dialysis patients
by the provider",Electroencephalography,Laboratory,Cardiac Catheterization,Medical Supplies Charged to Patients,Speech Pathology,Laboratory,IPF,Burn Intensive Care Unit,Renal Dialysis,"Gift, Flower, Coffee Shop, Canteen",New Capital Equipment,Total,Drugs Charged to Patients,Non-Physician Anesthetist Part A,Coronary Intensive Care Unit,Laboratory,Physicians' Private Office,Ambulance Services,Intensive Care Unit,Whole Blood & Packed Red Blood Cells,Other Long-term Liabilities,Coronary Care Unit,ICF,Durable Medical Equipment Rented,Related Salaries,Total Adults & Peds,Without Outliers:  Total Visits,Anesthesiology,Home Program Dialysis,OPT,Laboratory,RHC 7 Provider Number,Delivery Room and Labor Room,Total Other Charges,Assets,HHA 3 Provider Number,ASC (Non Distinct Part),Subtotal,Coronary Care Unit,Other Reimbursable,Subprovider II,Other Reimbursable,Nursery,Radiology-Therapeutic,Administrative and General,Delivery Room and Labor Room,Surgical Intensive Care Unit,Nursery,Land Improvements,Adj for Speech therapy in excess of lim,Clinic,Total,Payment to cost ratio,Subtotal Other Wages and Related Csts,Wage Related Costs Core,Cost of patients approved for charity care and uninsured discounts,Whole Blood & Packed Red Blood Cells,Total,Hospice,Employee Benefits,CT Scan,or allied health costs?,Other Ancillary,Durable Medical Equipment Sold,ASC (Non Distinct Part),CORF,"Number of patients in program at 
end of cost reporting period",Recovery Room,Total,Emergency,PEP Episodes:  Total Visits,Electroencephalography,Other Outpatient Services,Dietary under contract,Total Non Routine Medical  Supply Charges,HHA 2 Provider Number,Coronary Care Unit,"Trade, Quantity, and Time Discounts",Land Improvements,Intravenous Therapy,Renal Dialysis,Occupational Therapy,Other Special Purpose,Home Office Name,Received DSH or supplemental payments from Medicaid? (Y/N),Impl. Dev. Charged to Patients,Clinic,Hospice,Impl. Dev. Charged to Patients,Total Number of Outlier Episodes,Other Ancillary,Organ Procurement,Donations,Maintenance and Repairs,Other Capital,Occupational Therapy,Sequestration adjustment,Impl. Dev. Charged to Patients,Target Amount,Total,Radioisotope,Interns & Res Other Program Costs,Speech Pathology,Coronary Care Unit,"Blood Storing, Processing, Trans",Other Special Care Unit,Emergency,Home Program Dialysis,Home Program Dialysis,ASC (Non Distinct Part),Heart Acquisition,ASC (Non Distinct Part),Blood Clotting Factors for Hemoph.,RHC 22 Provider Number,Coronary Care Unit,Intensive Care Unit,Other Special Care Unit,Employee Benefits,Subprovider II,Physical Therapy,Other Ancillary,Hospice,Other Outpatient Services,Disp. And Retirement,Teaching Physician Salaries,Operating Room,Other Nonreimbursable,HHA,Clinic,Kidney Acquisition,IPF Provider Number,SNF Provider Number,Respiratory Therapy,RHC 15 Provider Number,Intensive Care Unit,RHC,Laboratory,"Blood Storing, Processing, Trans",MCP Physician Payment Method (Y/N),Subprovider 1,Non-Physician Anesthetist Part B,Does the hospital qualify as RPCH/CAH? (Y/N),Anesthesiology,Self Insurance,PBP Clinical Lab Services Program Only,OLTC,NF,Radiology-Therapeutic,Total customary charges,Fiscal Year End Date,Medicare Certified Islet TC term date,FQHC 4 Provider Number,Emergency,net of Swing Bed Cost,Radioisotope,FI/Contractor's Name,Laboratory,Interns & Residents,Home Program Dialysis,CMHC,LUPA Episodes:  Total Number of Episodes,Ambulance Services,Interns & Residents,Durable Medical Equipment Sold,Medical Supplies Charged to Patients,"Average patient dialysis time 
including setup",Subtotal,CT Scan,Radiology-Therapeutic,Subtotal,Durable Medical Equipment Rented,FQHC,ASC (Non Distinct Part),Charity care charges and uninsured discounts for the entire facility,PEP:  Total Number of Outlier Episodes,"Blood Storing, Processing, Trans",Intensive Care Unit,Administrative and General,Contract Labor:  Physician Part A,Other Special Purpose,Other Nonreimbursable,Blood Clotting Factors for Hemoph.,Home Office Salaries,CORF,Intestinal Acquisition,Delivery Room and Labor Room,Number of stations,Other Ancillary,Ambulance Services,Pass through Cost for Program Inpatient,Clinic,Durable Medical Equipment Sold,"Blood Storing, Processing, Trans",Medical Supplies Charged to Patients,Interns & Residents,Respiratory Therapy,Subprovider 1,Intravenous Therapy,Medicare Certified Heart TC term date,Telephone Services,Program Inpatient Ancillary Service Cost,PEP Episodes:  Total Charges:,FQHC,Delivery Room and Labor Room,HHA,HHA,Impl. Dev. Charged to Patients,Cardiac Catheterization,ICF,Other Organ Acquisition,net of Swing Bed and Private Room Diff,SNF,Excluded Area Salaries,Medical Supplies Charged to Patients,Physician-Part A,PEP Episodes:  Total Visits,Burn Intensive Care Unit,Other Reimbursable,Drugs Charged to Patients,Radiology-Diagnostic,Laundry and Linen Service,Outpatient Rehab Provider,OPT,Total Program General Inpatient Routine,Total Salaries,Charity care charges and uninsured discounts for the entire facility,Other Current Assets,Durable Medical Equipment Sold,Subtotal Other Wages and Related Csts,Title XIX discharges,Speech Pathology,Home Office Salaries,PEP Episodes:  Total Charges:,Title V discharges,Payments received from patients for amounts previously written off as charity care,Total,HHA,PBP Clinical Lab Services Program Only,NOT IN THIS FILE,Nursing Administration,CT Scan,OPT,Emergency,Cost of Uncompensated Care,Emergency,Medicare Certified Kidney TC term date,Non-Physician Anesthetist Part A,Durable Medical Equipment Sold,Renal Dialysis,Renal 10 Provider Number,Physician Part B,Electroencephalography,Paramedical Education,Intensive Care Unit,Gross Revenue,MRI,Other Medicaid Days,Durable Medical Equipment Sold,Subprovider-IRF,Emergency,Other Reimbursable,Radiology-Therapeutic,Hospital State,Laboratory,Housekeeping under contract,Subprovider I,Physician Part A Teaching,Contract Labor:  Physician Part A,Nonphysician Anesthetists,Administrative and General,Admin & Gen Under Contract,Total Charges,Subprovider-IRF,IRF,Medical Supplies Charged to Patients,Other Outpatient Services,Hospice,Surgical Intensive Care Unit Program Cost,Subprovider-IRF,PEP:  Total Number of Outlier Episodes,Total Swing Bed Cost,Interns & Res Other Program Costs,Subprovider I,Radioisotope,HRR adjustment amount ,Total Adults & Peds,Hospital County,Ending Date of SCH status,"Blood Storing, Processing, Trans",Surgical Intensive Care Unit,Renal Dialysis,Impl. Dev. Charged to Patients,Whole Blood & Packed Red Blood Cells,Emergency,Home Program Dialysis,Employee Benefits,Speech Pathology,Other Special Care Unit,Stand-alone CHIP Charges (Gross Revenue),Excluded Areas,New Capital Buildings and Fixtures,Physicians' Private Office,Electroencephalography,Surgical Intensive Care Unit,Building Improvements,Durable Medical Equipment Sold,Intravenous Therapy,IRF,CMHC,New Cap Related Csts Movable Equipment,IPPS Payment amount (unadjusted),Land,Speech Pathology,Anesthesiology,Number of stations,Subtotal,In State Medicaid paid days,Impl. Dev. Charged to Patients,Other Adjustments (Summed),"Number of Times per week
 Patient receives Dialysis",Cardiac Catheterization,Renal Dialysis,Anesthesiology,Intensive Care Unit,Pass Through Cost for  Program Ancillary,Whole Blood & Packed Red Blood Cells,Whole Blood & Packed Red Blood Cells,Recovery Room,Electrocardiology,CORF,RHC,Laboratory,Without Outliers:  Other Charges,CT Scan,Begin Balance,Blood Clotting Factors for Hemoph.,ASC (Non Distinct Part),Other Ancillary,Management and Administrative Services,ASC (Non Distinct Part),OLTC,RHC/FQHC Combined,Durable Medical Equipment Sold,PBP Clinical Lab Services Program Only,Target Amount per Discharge,Electroencephalography,SNF,Blood Clotting Factors for Hemoph.,Occupational Therapy,Lung  Acquisition,Subprovider-IRF,Cardiac Catheterization,Hospital Zip Code,"Blood Storing, Processing, Trans",PEP Episodes:  Total Number of Episodes,Pancreas Acquisition,FQHC 3 Provider Number,Other Organ Acquisition,Blood Clotting Factors for Hemoph.,Wage Related Costs RHC/FQHC,Total Charges:  LUPA Episodes,Intravenous Therapy,Parking Lot,Electrocardiology,Medical Supplies Charged to Patients,Home Program Dialysis,Intravenous Therapy,SNF,Employee Benefits,CT Scan,Whole Blood & Packed Red Blood Cells,Radioisotope,Speech Pathology,Title V discharges,Movable Equipment,Hospice,Dietary,Burn Intensive Care Unit,Speech Pathology,Total Subprovider I Interns & Residents,Land Improvements,Laboratory,"Blood Storing, Processing, Trans",OLTC,Coronary Care Unit,Total Operating Expense,ICF Provider Number,Adults & Pediatrics,Electrocardiology,Intravenous Therapy,Non-Physician Anesthetist Part A,Electroencephalography,Occupational Therapy,Accounts Receivable,Anesthesiology,RHC 2 Provider Number,Radiology-Diagnostic,IPF,Hospital Adults & Pediatrics,Land Improvements,Medical Supplies Charged to Patients,Total Directly Assigned New Cap Rel Csts,Is this a rural hospital qualifying for an exception to the certified registered nurse anesthetist the CRNA fee schedule? (Y/N),Surgical Intensive Care Unit,Total,Clinic,Subprovider I,Other Ancillary,CMS Region Code,Administrative and General under Contract,Hospice,Accounts Payable,Anesthesiology,certification date,Total Number of Episodes,Bonus Payment,Drugs Charged to Patients,OLTC,LUPA:  Total Non Routine Med Sup Chgs,Total Program General Inp. Rtn Service,Total Salaries,RHC,Payroll taxes payable,Central Services and Supply,Intravenous Therapy,With Outliers:  Total Visits,Observation Beds (Distinct Unit),Laundry and Linen Service,Medicare Certified Pancreas TC term date,Administrative and General under Contract,Dietary under Contract,Clinic,Durable Medical Equipment Rented,Labor and Delivery Days -  Title XIX,Subprovider-IRF,Renal Dialysis,Renal Dialysis,Wage Related Costs Other,Delivery Room and Labor Room,"Number of patients transplanted 
during fiscal year",Total Hospital,Without Outliers:  Non Routine Med Sup Chgs,Other Ancillary,Drugs Charged to Patients,ASC (Distinct Part),Government grants or appropriations or transfers for support of hospital operations,Emergency,Net Revenue from Medicaid,Other Outpatient Services,New Cap Related Csts Bldg & Fixtures,Other Reimbursable,Speech Pathology,Negative Cost Centers,Total Nursing School,Intravenous Therapy,NF,Electroencephalography,Whole Blood & Packed Red Blood Cells,MRI,Housekeeping under Contract,Laboratory,Outpatient Rehab Provider,Laboratory,Adults and Pediatrics,"Blood Storing, Processing, Trans","Percentage of patients re-using
dialyzers",Drugs Charged to Patients,Liver Acquisition,Durable Medical Equipment Rented,"Blood Storing, Processing, Trans",Operating Room,Utilization,Drugs Charged to Patients,OPT,Total Other Expenses,Purchase,Emergency,Liver Acquisition,Intensive Care Unit,Ambulance Services,Contract Labor,Radiology-Therapeutic,Electrocardiology,Laboratory,Total Liabilities,Adj for Physical therapy costs in excess,Total,Electrocardiology,Anesthesiology,ASC (Non Distinct Part),Radiology-Therapeutic,Adults and Pediatrics,Other Reimbursable,Impl. Dev. Charged to Patients,CT Scan,LUPA Episodes:  Other Charges,Other Reimbursable,Employee Benefits,Drugs Charged to Patients,Other Nonreimbursable,Drugs Charged to Patients,Burn Intensive Care Unit,ICF,Impl. Dev. Charged to Patients,Dietary,Cafeteria,Total Hospital Interns & Residents,Other Ancillary,Other Outpatient Services,"Blood Storing, Processing, Trans",Emergency,HHA,Hospital Type,MRI,Medical Supplies Charged to Patients,Subprovider-IRF,Nonpaid Workers,OSP,Intensive Care Unit,Nursery,Average times dialyzers re-used,Operating Room,Depreciation-New Bldgs & Fixtures,Home Program Dialysis,Intravenous Therapy,Teaching Physician Salaries,SNF,Other Special Care,Liver Acquisition,Kidney Acquisition,Excess of customary charges,New Capital Buildings and Fixtures,Heart Acquisition,"Epoietin amount form worksheet A
for home dialysis program",Electrocardiology,"Number of Times per week
 Patient receives Dialysis",Nonpaid Workers,Radioisotope,Laundry and Linen Service,Delivery Room and Labor Room,Laboratory,Operating Room,PBP Clinical Lab Services Program Only,Observation Beds (Distinct Unit),Other Outpatient Services,Total Hospital,OSP,Burn Intensive Care Unit,Net Salaries,Electrocardiology,Adults and Pediatrics,ASC (Non Distinct Part),Impl. Dev. Charged to Patients,Medical Supplies Charged to Patients,Respiratory Therapy,Cardiac Catheterization,Primary payer payments,Major Movable Equipment,Other Outpatient Services,Total Other Medical Education,Other Special Purpose,RHC 19 Provider Number,Drugs Charged to Patients,Other Outpatient Services,HHA,Respiratory Therapy,Total,Impl. Dev. Charged to Patients,Radioisotope,Impl. Dev. Charged to Patients,Nonphysician Anesthetists,Delivery Room and Labor Room,CT Scan,NF,SNF,RHC,Administrative & General under contract,Radioisotope,Islet Acquisition,ASC (Non Distinct Part),Blood Clotting Factors for Hemoph.,"If (SCH), enter the # of periods.",Housekeeping,Delivery Room and Labor Room,Social Service,"Gift, Flower, Coffee Shop, Canteen",City,Other Ancillary,Speech Pathology,Pharmacy,Durable Medical Equipment Sold,Laboratory,Drugs Charged to Patients,CT Scan,"Number of days in year dialysis 
furnished",ICF,Coronary Care Unit,Other Reimbursable,Operation of Plant,RHC 23 Provider Number,Burn Intensive Care Unit,Total Facility FTEs,Radiology-Therapeutic,Total Nursing School,Emergency,Social Service,Medical Supplies Charged to Patients,Radiology-Diagnostic,RHC/FQHC Combined,Total,Other Reimbursable,Physicians' Private Office,Occupational Therapy,Electrocardiology,Cardiac Catheterization,Speech Pathology,Total Facility FTEs,Electrocardiology,Whole Blood & Packed Red Blood Cells,Intravenous Therapy,"Sum of lines 3,4 divided by line 6",CT Scan,Other Capital,Total Other Charges,Notes and Loans Payable (short term),Hospice,Cardiac Catheterization,Total Visits,Impl. Dev. Charged to Patients,Medical Supplies Charged to Patients,Recovery Room,Drugs Charged to Patients,Pharmacy,Blood Clotting Factors for Hemoph.,Surgical Intensive Care Unit,Kidney Acquisition,Prepaid expenses,Medical and Other Services,IPPS Interim payment,Other Outpatient Services,Title XIX discharges,Interns & Residents,Other Ancillary,Total Hospital,Observation Beds (Distinct Unit),Physical Therapy,Radiology-Therapeutic,Radiology-Diagnostic,Title XVIII discharges,Radioisotope,Renal Dialysis,Radiology-Therapeutic,Burn Intensive Care Unit,Pharmacy,Respiratory Therapy,Electroencephalography,Mortgage Payable,Paramedical Education,Radiology-Diagnostic,OSP,Surgical Intensive Care Unit,CT Scan,Radioisotope,Observation Beds (Distinct Unit),"Gift, Flower, Coffee Shop, Canteen",Land,Radioisotope,Adj for Occupational therapy in excess of li,Other Special Care Unit,Home Office Personnel,Radioisotope,Unsecured Loans,Other Nonreimbursable,Tentative settlement,Durable Medical Equipment Rented,Medical and Other Services reimbursed by OPPS,Intravenous Therapy,FQHC,Physical Therapy,Islet Acquisition,Drugs Charged to Patients,Net Patient Revenue,Utilization Review SNF,Renal 8 Provider Number,Int & Res (non approved teaching program,Cardiac Catheterization,Anesthesiology,Rental of quarters to employee and oths,MRI,Lung  Acquisition,Other Ancillary,Protested amounts,Total Number of Episodes,CMHC,Emergency,Other Special Care,Medical Supplies Charged to Patients,ICF,FQHC,Hospital Adults & Pediatrics,Total discharges,MRI,MRI,HHA,Respiratory Therapy,Other Organ Acquisition,"Blood Storing, Processing, Trans",Speech Pathology,Interns & Residents,Radiology-Therapeutic,New Cap Related Csts Bldg & Fixtures,Home Program Dialysis,Emergency,Investments,Cardiac Catheterization,TOTAL,Other Ancillary,Speech Pathology,Recovery Room,Operating Room,Cardiac Catheterization,SNF,CORF,Research,Whole Blood & Packed Red Blood Cells,Delivery Room and Labor Room,Medical Supplies Charged to Patients,Radiology-Therapeutic,"Blood Storing, Processing, Trans",Physician Part A Teaching,Occupational Therapy,Recovery Room,Home Program Dialysis,Subprovider 2,Other Ancillary,Number of EPO units furnished for Line 13,Blood Clotting Factors for Hemoph.,Nursing Administration,Cardiac Catheterization,Anesthesiology,Impl. Dev. Charged to Patients,Interest Expense,Total Current Assets,RHC,Cardiac Catheterization,Medical Supplies Charged to Patients,Physician-Part A,Speech Pathology,Physical Therapy,Whole Blood & Packed Red Blood Cells,Drugs Charged to Patients,Recovery Room,Total Hospital,Pharmacy,Physician Part A,Non-Physician Part B,Laboratory,Nursery,Anesthesiology,Radiology-Diagnostic,Laboratory,Anesthesiology,Blood Clotting Factors for Hemoph.,Occupational Therapy,NF,Speech Pathology,Surgical Intensive Care Unit,FQHC,FQHC 6 Provider Number,Physical Therapy,Physical Therapy,Maintenance of Personnel,Operation of Plant,Radiology-Diagnostic,Renal Dialysis,net of Swing Bed and Private Room Diff,Electroencephalography,RHC,Total,Total,Renal Dialysis,Radiology-Diagnostic,Durable Medical Equipment Rented,Without Outliers:  Other Charges,Respiratory Therapy,Health Information Technology Designated Assets,Radioisotope,Electroencephalography,CORF,Medicare Certified Liver TC term date,NF Provider Number,Impl. Dev. Charged to Patients,NF,Intravenous Therapy,Burn Intensive Care Unit,Physical Therapy,Physician Part A,Interns & Residents,IPF,Total Costs,ASC (Non Distinct Part),OPT,Observation Beds (Distinct Unit),Lesser of cost or charges,Durable Medical Equipment Rented,Emergency,NF,Other Special Care Unit,Electroencephalography,Dietary under contract,Anesthesiology,"Does the facility qualify and is it receiving payments for 
disproportionate share? (Y/N)",Delivery Room and Labor Room,Total prospective payment,Burn Intensive Care Unit,Radiology-Therapeutic,Physicians' Private Office,Rental of Provider space by suppliers,"If an Organ Procurement Organization, enter the OPO number",Nursing Administration,Durable Medical Equipment Sold,Medical Supplies Charged to Patients,PBP Clinical Lab Services Program Only,Delivery Room and Labor Room,Medicare Certified Lung TC term date,Interest expense on Medicare Overpaymts,Medical Supplies Charged to Patients,Hospice,Delivery Room and Labor Room,Negative Cost Centers,Subtotal Other Wages and Related Csts,Recovery Room,ASC (Distinct Part),MRI,OSP,ICF,"Number of patients in program at 
end of cost reporting period",SNF,Ratio of line 15 to line 16,Emergency,Electroencephalography,Nonpaid Workers,Other Special Purpose,Recovery Room,Dietary,Surgical Intensive Care Unit,Are provider based physicians' costs included in Worksheet A? (Y/N),Drugs Charged to Patients,Surgical Intensive Care Unit,Clinic,Drugs Charged to Patients,Anesthesiology,Electroencephalography,Operating Room,CT Scan,Other Special Purpose,Research,Operating Room,Related Organization Transactions,Contract Labor:  Physician Part A,MRI,Paramedical Education,Kidney Acquisition,Operating Room,MRI,ICF,Total Current Liabilities,Blood Clotting Factors for Hemoph.,Title XVIII discharges,Laboratory,Respiratory Therapy,HHA,HMO,Subprovider II,CMHC,Labor and Delivery Days -  Title XIX,Radiology-Therapeutic,Cardiac Catheterization,Number of stations,Recovery Room,ASC 1 Provider Number,Intravenous Therapy,Cost of charity care,OLTC,Intestinal Acquisition,Ambulance Services,Radioisotope,Housekeeping,Observation Beds (Distinct Unit),Delivery Room and Labor Room,SNF,Intensive Care Unit,With Outliers:  Non Routine Med Sup Chgs,Total Program Inpatient Costs,Radioisotope,Home Office Salaries & Wage Related Csts,Total Salaries,Ending Date of SCH status,Electroencephalography,Observation Beds (Distinct Unit),Occupational Therapy,Other Ancillary,Heart Acquisition,"Treatment capacity per day per
station",Coronary Care Unit,Whole Blood & Packed Red Blood Cells,Electrocardiology,Line 2 times line 5,CT Scan,Hospital PO Box,PBP Clinical Lab Services Program Only,MRI,Other Ancillary,"Number of Times per week
 Patient receives Dialysis",Respiratory Therapy,Other adjustments,Speech Pathology,Durable Medical Equipment Rented,Anesthesiology,Other Outpatient Services,Allowable bad debts,Delivery Room and Labor Room,Impl. Dev. Charged to Patients,Payment to cost ratio,Drugs Charged to Patients,Anesthesiology,Speech Pathology,New Cap Related Csts Movable Equipment,Surgical Intensive Care Unit,CORF,Emergency,New Cap Related Csts Bldg & Fixtures,RHC/FQHC Combined,Radiology-Diagnostic,IRF,Emergency,Observation Beds (Distinct Unit),Pancreas Acquisition,Pass through Cost for Program Inpatient,Intravenous Therapy,Other General Service,Nonpaid Workers,Heart Acquisition,Total discharges,Other Outpatient Services,Pancreas Acquisition,"Income from imposition of interest, finance",Int & Res (non approved teaching program,Radiology-Therapeutic,Delivery Room and Labor Room,Durable Medical Equipment Rented,CORF,ASC (Distinct Part),ASC (Distinct Part),"Blood Storing, Processing, Trans",Occupational Therapy,Electrocardiology,Renal Dialysis,Nursery,Burn Intensive Care Unit,Other Special Care Unit,"Blood Storing, Processing, Trans",Delivery Room and Labor Room,"Number of patients in program at 
end of cost reporting period",Home Program Dialysis,Inpatient Revenue,Occupational Therapy,Contract Labor: Pysician Part A,Subprovider I,Stand-alone CHIP -- Costs minus net revenue (0 min),Other Ancillary,Physical Therapy,LUPA Episodes:  Total Visits,Emergency,Occupational Therapy,Beginning Date of SCH status,Maintenance of Personnel,Nursery,Medical Supplies Charged to Patients,Other Organ Acquisition,Renal Dialysis,Respiratory Therapy,MDH status beginning date (MM/DD/YY),Subtotal Wage Related Csts,Delivery Room and Labor Room,Respiratory Therapy,Cost of charity care (patients covered by public program + patients w/ coverage accepted by provider),Other Outpatient Services,Total Allied Health Cost,Cross Foot Adjustments,Speech Pathology,RHC/FQHC Combined,Other Ancillary,Burn Intensive Care Unit,Electrocardiology,Impl. Dev. Charged to Patients,IPF,Operating Room,Subprovider-IPF,Int & Res (non approved teaching program,Blood Clotting Factors for Hemoph.,MRI,"Blood Storing, Processing, Trans",Coronary Care Unit,Coronary Care Unit,Subprovider I,Investment Income-Other,SNF,Total charges to state or local government programs for indigent care (not Medicaid or CHIP),Physicians' Assistant,Adults and Pediatrics,Subprovider-IPF,Delivery Room and Labor Room,SNF,Medical Supplies Charged to Patients,Occupational Therapy,Other Reimbursable,ASC (Distinct Part),Subprovider-IPF,Temporary Investments,Hospital Street Address,TOTAL,Whole Blood & Packed Red Blood Cells,Adults & Pediatrics,Hospital Adults & Pediatrics,Research,"Salaries, Wages, and Fees Payable",Durable Medical Equipment Rented,MRI,TOTAL,Emergency,Administrative and General,Anesthesiology,Occupational Therapy,Net Salaries,Other Ancillary,Pancreas Acquisition,Administrative and General,FFY,Hospital Type (From CMS Hospitals Data Archive),Name and Num
,Curated Name and Num,Hospital type (modified),,Lon,Lat,APPORTIONMENT OF INPATIENT/OUTPATIENT ANCILLARY SERVICE OTHER PASS THROUGH COSTS,Total Inpatient Days/Outpatient Visits,COST ALLOCATION,TRIAL BALANCE OF EXPENSE ACCOUNTS,APPORTIONMENT OF INPATIENT/OUTPATIENT ANCILLARY SERVICE OTHER PASS THROUGH COSTS,HOSPITAL WAGE INDEX DATA,NUMBER OF BEDS,INPATIENT ANCILLARY SERVICE COST APPORTIONMENT,APPORTIONMENT OF INPATIENT/OUTPATIENT ANCILLARY SERVICE OTHER PASS THROUGH COSTS,INPATIENT ANCILLARY SERVICE COST APPORTIONMENT,CALCULATION OF REIMBURSEMENT SETTLEMENT,COST ALLOCATION,,COMPUTATION OF RATIO OF COST TO CHARGES,APPORTIONMENT OF MEDICAL AND OTHER HEALTH SERVICES,COST ALLOCATION,TRIAL BALANCE OF EXPENSE ACCOUNTS,,APPORTIONMENT OF MEDICAL AND OTHER HEALTH SERVICES,TRIAL BALANCE OF EXPENSE ACCOUNTS,COMPUTATION OF RATIO OF COST TO CHARGES,HOSPITAL WAGE INDEX DATA,,INPATIENT ANCILLARY SERVICE COST APPORTIONMENT,COMPUTATION OF RATIO OF COST TO CHARGES,HOSPITAL WAGE INDEX DATA,COMPUTATION OF RATIO OF COST TO CHARGES,APPORTIONMENT OF INPATIENT/OUTPATIENT ANCILLARY SERVICE OTHER PASS THROUGH COSTS,INPATIENT ANCILLARY SERVICE COST APPORTIONMENT,APPORTIONMENT OF MEDICAL AND OTHER HEALTH SERVICES,BALANCE SHEET,COMPUTATION OF RATIO OF COST TO CHARGES,COMPUTATION OF RATIO OF COST TO CHARGES,COMPUTATION OF INPATIENT OPERATING COSTS,COST ALLOCATION,TRIAL BALANCE OF EXPENSE ACCOUNTS,APPORTIONMENT OF MEDICAL AND OTHER HEALTH SERVICES,S-10 DATA,APPORTIONMENT OF INPATIENT/OUTPATIENT ANCILLARY SERVICE OTHER PASS THROUGH COSTS,INPATIENT ANCILLARY SERVICE COST APPORTIONMENT,APPORTIONMENT OF INPATIENT/OUTPATIENT ANCILLARY SERVICE OTHER PASS THROUGH COSTS,TRIAL BALANCE OF EXPENSE ACCOUNTS,COMPUTATION OF RATIO OF COST TO CHARGES,,NUMBER OF BEDS,HHA STATISTICAL DATA,APPORTIONMENT OF INPATIENT/OUTPATIENT ANCILLARY SERVICE OTHER PASS THROUGH COSTS,COST ALLOCATION,APPORTIONMENT OF INPATIENT/OUTPATIENT ANCILLARY SERVICE OTHER PASS THROUGH COSTS,TRIAL BALANCE OF EXPENSE ACCOUNTS,INPATIENT ANCILLARY SERVICE COST APPORTIONMENT,TRIAL BALANCE OF EXPENSE ACCOUNTS,HOSPITAL WAGE INDEX DATA,TRIAL BALANCE OF EXPENSE ACCOUNTS,APPORTIONMENT OF INPATIENT/OUTPATIENT ANCILLARY SERVICE OTHER PASS THROUGH COSTS,COST ALLOCATION,ALLOCATION OF NEW CAPITAL COSTS,COMPUTATION OF RATIO OF COST TO CHARGES,APPORTIONMENT OF MEDICAL AND OTHER HEALTH SERVICES,APPORTIONMENT OF INPATIENT/OUTPATIENT ANCILLARY SERVICE OTHER PASS THROUGH COSTS,RENAL STATISTICAL DATA,APPORTIONMENT OF MEDICAL AND OTHER HEALTH SERVICES,Medicare Inpatient Days/Outpatient Visits,ALLOCATION OF NEW CAPITAL COSTS,APPORTIONMENT OF INPATIENT ROUTINE SERVICE CAPITAL COSTS,HOSPITAL WAGE INDEX DATA,ADJUSTMENTS,COST ALLOCATION,APPORTIONMENT OF INPATIENT/OUTPATIENT ANCILLARY SERVICE OTHER PASS THROUGH COSTS,TRIAL BALANCE OF EXPENSE ACCOUNTS,TRIAL BALANCE OF EXPENSE ACCOUNTS,HOSPITAL WAGE INDEX DATA,COMPUTATION OF RATIO OF COST TO CHARGES,Medicaid Inpatient Days/Outpatient Visits,Total Inpatient Days/Outpatient Visits,COMPUTATION OF RATIO OF COST TO CHARGES,APPORTIONMENT OF INPATIENT/OUTPATIENT ANCILLARY SERVICE OTHER PASS THROUGH COSTS,CALCULATION OF REIMBURSEMENT SETTLEMENT,COMPUTATION OF RATIO OF COST TO CHARGES,APPORTIONMENT OF MEDICAL AND OTHER HEALTH SERVICES,INPATIENT ANCILLARY SERVICE COST APPORTIONMENT,APPORTIONMENT OF MEDICAL AND OTHER HEALTH SERVICES,COMPUTATION OF RATIO OF COST TO CHARGES,HOSPITAL WAGE INDEX DATA,ANALYSIS OF CHANGES IN NEW CAPITAL BALANCES,APPORTIONMENT OF MEDICAL AND OTHER HEALTH SERVICES,INPATIENT ANCILLARY SERVICE COST APPORTIONMENT,APPORTIONMENT OF INPATIENT/OUTPATIENT ANCILLARY SERVICE OTHER PASS THROUGH COSTS,HHA STATISTICAL DATA,APPORTIONMENT OF MEDICAL AND OTHER HEALTH SERVICES,TRIAL BALANCE OF EXPENSE ACCOUNTS,BED DAYS AVAILABLE,ADJUSTMENTS,HOSPITAL WAGE INDEX DATA,COST ALLOCATION,APPORTIONMENT OF INPATIENT/OUTPATIENT ANCILLARY SERVICE OTHER PASS THROUGH COSTS,HOSPITAL WAGE INDEX DATA,COST ALLOCATION,,INPATIENT ANCILLARY SERVICE COST APPORTIONMENT,HOSPITAL WAGE INDEX DATA,TRIAL BALANCE OF EXPENSE ACCOUNTS,TRIAL BALANCE OF EXPENSE ACCOUNTS,INPATIENT ANCILLARY SERVICE COST APPORTIONMENT,HOSPITAL WAGE INDEX DATA,HOSPITAL WAGE INDEX DATA,TRIAL BALANCE OF EXPENSE ACCOUNTS,APPORTIONMENT OF INPATIENT/OUTPATIENT ANCILLARY SERVICE OTHER PASS THROUGH COSTS,COMPUTATION OF INPATIENT OPERATING COSTS,TRIAL BALANCE OF EXPENSE ACCOUNTS,HOSPITAL WAGE INDEX DATA,INPATIENT ANCILLARY SERVICE COST APPORTIONMENT,,HOSPITAL WAGE INDEX DATA,TRIAL BALANCE OF EXPENSE ACCOUNTS,INPATIENT ANCILLARY SERVICE COST APPORTIONMENT,Total Inpatient Days/Outpatient Visits,TRIAL BALANCE OF EXPENSE ACCOUNTS,,HOSPITAL WAGE INDEX DATA,APPORTIONMENT OF MEDICAL AND OTHER HEALTH SERVICES,INPATIENT ANCILLARY SERVICE COST APPORTIONMENT,APPORTIONMENT OF INPATIENT/OUTPATIENT ANCILLARY SERVICE OTHER PASS THROUGH COSTS,TRIAL BALANCE OF EXPENSE ACCOUNTS,CALCULATION OF REIMBURSEMENT SETTLEMENT,COST ALLOCATION,COST ALLOCATION,ALLOCATION OF NEW CAPITAL COSTS,COST ALLOCATION,APPORTIONMENT OF INPATIENT/OUTPATIENT ANCILLARY SERVICE OTHER PASS THROUGH COSTS,APPORTIONMENT OF INPATIENT/OUTPATIENT ANCILLARY SERVICE OTHER PASS THROUGH COSTS,COST ALLOCATION,COMPUTATION OF RATIO OF COST TO CHARGES,APPORTIONMENT OF INPATIENT/OUTPATIENT ANCILLARY SERVICE OTHER PASS THROUGH COSTS,APPORTIONMENT OF MEDICAL AND OTHER HEALTH SERVICES,APPORTIONMENT OF INPATIENT/OUTPATIENT ANCILLARY SERVICE OTHER PASS THROUGH COSTS,APPORTIONMENT OF MEDICAL AND OTHER HEALTH SERVICES,INPATIENT ANCILLARY SERVICE COST APPORTIONMENT,COST ALLOCATION,HHA STATISTICAL DATA,TRIAL BALANCE OF EXPENSE ACCOUNTS,TRIAL BALANCE OF EXPENSE ACCOUNTS,,APPORTIONMENT OF MEDICAL AND OTHER HEALTH SERVICES,APPORTIONMENT OF INPATIENT/OUTPATIENT ANCILLARY SERVICE OTHER PASS THROUGH COSTS,Medicare Inpatient Days/Outpatient Visits,HOSPITAL WAGE INDEX DATA,COST ALLOCATION,APPORTIONMENT OF MEDICAL AND OTHER HEALTH SERVICES,COST ALLOCATION,CALCULATION OF REIMBURSEMENT SETTLEMENT,,COMPUTATION OF INPATIENT OPERATING COSTS,TRIAL BALANCE OF EXPENSE ACCOUNTS,APPORTIONMENT OF INPATIENT ROUTINE SERVICE OTHER PASS THROUGH COSTS,COST ALLOCATION,Total Inpatient Days/Outpatient Visits,HOSPITAL WAGE INDEX DATA,INPATIENT ANCILLARY SERVICE COST APPORTIONMENT,HHA STATISTICAL DATA,APPORTIONMENT OF INPATIENT/OUTPATIENT ANCILLARY SERVICE OTHER PASS THROUGH COSTS,APPORTIONMENT OF MEDICAL AND OTHER HEALTH SERVICES,Total Inpatient Days/Outpatient Visits,TRIAL BALANCE OF EXPENSE ACCOUNTS,TRIAL BALANCE OF EXPENSE ACCOUNTS,APPORTIONMENT OF INPATIENT/OUTPATIENT ANCILLARY SERVICE OTHER PASS THROUGH COSTS,TRIAL BALANCE OF EXPENSE ACCOUNTS,APPORTIONMENT OF INPATIENT/OUTPATIENT ANCILLARY SERVICE OTHER PASS THROUGH COSTS,TRIAL BALANCE OF EXPENSE ACCOUNTS,APPORTIONMENT OF MEDICAL AND OTHER HEALTH SERVICES,INPATIENT ANCILLARY SERVICE COST APPORTIONMENT,TRIAL BALANCE OF EXPENSE ACCOUNTS,COMPUTATION OF RATIO OF COST TO CHARGES,COST ALLOCATION,APPORTIONMENT OF INPATIENT/OUTPATIENT ANCILLARY SERVICE OTHER PASS THROUGH COSTS,APPORTIONMENT OF INPATIENT/OUTPATIENT ANCILLARY SERVICE OTHER PASS THROUGH COSTS,Medicaid Inpatient Days/Outpatient Visits,HOSPITAL WAGE INDEX DATA,ALLOCATION OF NEW CAPITAL COSTS,HHA STATISTICAL DATA,INPATIENT ANCILLARY SERVICE COST APPORTIONMENT,INPATIENT ANCILLARY SERVICE COST APPORTIONMENT,HOSPITAL WAGE INDEX DATA,INPATIENT ANCILLARY SERVICE COST APPORTIONMENT,Total Inpatient Days/Outpatient Visits,COST ALLOCATION,APPORTIONMENT OF INPATIENT/OUTPATIENT ANCILLARY SERVICE OTHER PASS THROUGH COSTS,COMPUTATION OF INPATIENT OPERATING COSTS,TRIAL BALANCE OF EXPENSE ACCOUNTS,COST ALLOCATION,COMPUTATION OF RATIO OF COST TO CHARGES,TRIAL BALANCE OF EXPENSE ACCOUNTS,COST ALLOCATION,HOSPITAL WAGE INDEX DATA,APPORTIONMENT OF INPATIENT/OUTPATIENT ANCILLARY SERVICE OTHER PASS THROUGH COSTS,TRIAL BALANCE OF EXPENSE ACCOUNTS,APPORTIONMENT OF INPATIENT/OUTPATIENT ANCILLARY SERVICE OTHER PASS THROUGH COSTS,APPORTIONMENT OF INPATIENT/OUTPATIENT ANCILLARY SERVICE OTHER PASS THROUGH COSTS,INPATIENT ANCILLARY SERVICE COST APPORTIONMENT,COST ALLOCATION,INPATIENT ANCILLARY SERVICE COST APPORTIONMENT,APPORTIONMENT OF MEDICAL AND OTHER HEALTH SERVICES,COMPUTATION OF RATIO OF COST TO CHARGES,HOSPITAL WAGE INDEX DATA,,S-10 DATA,TRIAL BALANCE OF EXPENSE ACCOUNTS,COMPUTATION OF RATIO OF COST TO CHARGES,APPORTIONMENT OF INPATIENT/OUTPATIENT ANCILLARY SERVICE OTHER PASS THROUGH COSTS,TRIAL BALANCE OF EXPENSE ACCOUNTS,APPORTIONMENT OF INPATIENT/OUTPATIENT ANCILLARY SERVICE OTHER PASS THROUGH COSTS,INPATIENT ANCILLARY SERVICE COST APPORTIONMENT,HOSPITAL WAGE INDEX DATA,,HOSPITAL WAGE INDEX DATA,COMPUTATION OF RATIO OF COST TO CHARGES,APPORTIONMENT OF INPATIENT/OUTPATIENT ANCILLARY SERVICE OTHER PASS THROUGH COSTS,RECONCILIATION OF CAPITAL COST CENTERS,,INPATIENT ANCILLARY SERVICE COST APPORTIONMENT,COMPUTATION OF RATIO OF COST TO CHARGES,,COMPUTATION OF RATIO OF COST TO CHARGES,COMPUTATION OF RATIO OF COST TO CHARGES,NUMBER OF BEDS,COST ALLOCATION,TRIAL BALANCE OF EXPENSE ACCOUNTS,TRIAL BALANCE OF EXPENSE ACCOUNTS,APPORTIONMENT OF INPATIENT/OUTPATIENT ANCILLARY SERVICE OTHER PASS THROUGH COSTS,CALCULATION OF REIMBURSEMENT SETTLEMENT,HOSPITAL WAGE INDEX DATA,COST ALLOCATION,APPORTIONMENT OF INPATIENT/OUTPATIENT ANCILLARY SERVICE OTHER PASS THROUGH COSTS,INPATIENT ANCILLARY SERVICE COST APPORTIONMENT,TRIAL BALANCE OF EXPENSE ACCOUNTS,HHA STATISTICAL DATA,TRIAL BALANCE OF EXPENSE ACCOUNTS,APPORTIONMENT OF INPATIENT ROUTINE SERVICE CAPITAL COSTS,APPORTIONMENT OF INPATIENT/OUTPATIENT ANCILLARY SERVICE OTHER PASS THROUGH COSTS,HOSPITAL IDENTIFICATION INFORMATION,COST ALLOCATION,ALLOCATION OF NEW CAPITAL COSTS,BED DAYS AVAILABLE,ANALYSIS OF CHANGES IN NEW CAPITAL BALANCES,TRIAL BALANCE OF EXPENSE ACCOUNTS,S-10 DATA,APPORTIONMENT OF INPATIENT/OUTPATIENT ANCILLARY SERVICE OTHER PASS THROUGH COSTS,APPORTIONMENT OF INPATIENT ROUTINE SERVICE OTHER PASS THROUGH COSTS,INPATIENT ANCILLARY SERVICE COST APPORTIONMENT,INPATIENT ANCILLARY SERVICE COST APPORTIONMENT,COST ALLOCATION,INPATIENT ANCILLARY SERVICE COST APPORTIONMENT,TRIAL BALANCE OF EXPENSE ACCOUNTS,APPORTIONMENT OF MEDICAL AND OTHER HEALTH SERVICES,,HHA STATISTICAL DATA,COST ALLOCATION,HOSPITAL IDENTIFICATION INFORMATION,Total Inpatient Days/Outpatient Visits,APPORTIONMENT OF INPATIENT/OUTPATIENT ANCILLARY SERVICE OTHER PASS THROUGH COSTS,INPATIENT ANCILLARY SERVICE COST APPORTIONMENT,HOSPITAL WAGE INDEX DATA,HHA STATISTICAL DATA,APPORTIONMENT OF INPATIENT/OUTPATIENT ANCILLARY SERVICE OTHER PASS THROUGH COSTS,APPORTIONMENT OF INPATIENT ROUTINE SERVICE CAPITAL COSTS,APPORTIONMENT OF INPATIENT/OUTPATIENT ANCILLARY SERVICE OTHER PASS THROUGH COSTS,COST ALLOCATION,NUMBER OF BEDS,HOSPITAL WAGE INDEX DATA,ALLOCATION OF NEW CAPITAL COSTS,APPORTIONMENT OF INPATIENT/OUTPATIENT ANCILLARY SERVICE OTHER PASS THROUGH COSTS,ALLOCATION OF NEW CAPITAL COSTS,INPATIENT ANCILLARY SERVICE COST APPORTIONMENT,INPATIENT ANCILLARY SERVICE COST APPORTIONMENT,COST ALLOCATION,HOSPITAL WAGE INDEX DATA,APPORTIONMENT OF MEDICAL AND OTHER HEALTH SERVICES,APPORTIONMENT OF INPATIENT/OUTPATIENT ANCILLARY SERVICE OTHER PASS THROUGH COSTS,,BALANCE SHEET,APPORTIONMENT OF MEDICAL AND OTHER HEALTH SERVICES,,INPATIENT ANCILLARY SERVICE COST APPORTIONMENT,COST ALLOCATION,CALCULATION OF REIMBURSEMENT SETTLEMENT,ANALYSIS OF CHANGES IN NEW CAPITAL BALANCES,COMPUTATION OF RATIO OF COST TO CHARGES,COMPUTATION OF RATIO OF COST TO CHARGES,COMPUTATION OF RATIO OF COST TO CHARGES,RENAL STATISTICAL DATA,HOSPITAL IDENTIFICATION INFORMATION,COMPUTATION OF RATIO OF COST TO CHARGES,APPORTIONMENT OF INPATIENT/OUTPATIENT ANCILLARY SERVICE OTHER PASS THROUGH COSTS,TRIAL BALANCE OF EXPENSE ACCOUNTS,HOSPITAL WAGE INDEX DATA,HHA STATISTICAL DATA,,ALLOCATION OF NEW CAPITAL COSTS,INPATIENT ANCILLARY SERVICE COST APPORTIONMENT,HHA STATISTICAL DATA,APPORTIONMENT OF INPATIENT/OUTPATIENT ANCILLARY SERVICE OTHER PASS THROUGH COSTS,INPATIENT ANCILLARY SERVICE COST APPORTIONMENT,TRIAL BALANCE OF EXPENSE ACCOUNTS,COMPUTATION OF RATIO OF COST TO CHARGES,COST ALLOCATION,INPATIENT ANCILLARY SERVICE COST APPORTIONMENT,COMPUTATION OF RATIO OF COST TO CHARGES,INPATIENT ANCILLARY SERVICE COST APPORTIONMENT,RENAL STATISTICAL DATA,BED DAYS AVAILABLE,HOSPITAL WAGE INDEX DATA,CALCULATION OF REIMBURSEMENT SETTLEMENT,BALANCE SHEET,TRIAL BALANCE OF EXPENSE ACCOUNTS,COMPUTATION OF RATIO OF COST TO CHARGES,Medicaid Inpatient Days/Outpatient Visits,,COST ALLOCATION,APPORTIONMENT OF INPATIENT/OUTPATIENT ANCILLARY SERVICE OTHER PASS THROUGH COSTS,BALANCE SHEET,CALCULATION OF REIMBURSEMENT SETTLEMENT,BED DAYS AVAILABLE,COST ALLOCATION,,,COMPUTATION OF RATIO OF COST TO CHARGES,APPORTIONMENT OF INPATIENT ROUTINE SERVICE OTHER PASS THROUGH COSTS,TRIAL BALANCE OF EXPENSE ACCOUNTS,APPORTIONMENT OF MEDICAL AND OTHER HEALTH SERVICES,HOSPITAL IDENTIFICATION INFORMATION,APPORTIONMENT OF MEDICAL AND OTHER HEALTH SERVICES,ANALYSIS OF CHANGES IN NEW CAPITAL BALANCES,COMPUTATION OF RATIO OF COST TO CHARGES,INPATIENT ANCILLARY SERVICE COST APPORTIONMENT,INPATIENT ANCILLARY SERVICE COST APPORTIONMENT,HOSPITAL WAGE INDEX DATA,HOSPITAL WAGE INDEX DATA,INPATIENT ANCILLARY SERVICE COST APPORTIONMENT,INPATIENT ANCILLARY SERVICE COST APPORTIONMENT,COST ALLOCATION,,,APPORTIONMENT OF INPATIENT/OUTPATIENT ANCILLARY SERVICE OTHER PASS THROUGH COSTS,APPORTIONMENT OF MEDICAL AND OTHER HEALTH SERVICES,TRIAL BALANCE OF EXPENSE ACCOUNTS,Medicare Inpatient Days/Outpatient Visits,APPORTIONMENT OF INPATIENT/OUTPATIENT ANCILLARY SERVICE OTHER PASS THROUGH COSTS,APPORTIONMENT OF MEDICAL AND OTHER HEALTH SERVICES,,HHA STATISTICAL DATA,,TRIAL BALANCE OF EXPENSE ACCOUNTS,COST ALLOCATION,COST ALLOCATION,INPATIENT ANCILLARY SERVICE COST APPORTIONMENT,CALCULATION OF REIMBURSEMENT SETTLEMENT,STATEMENT OF REVENUES AND EXPENSES,TRIAL BALANCE OF EXPENSE ACCOUNTS,APPORTIONMENT OF INPATIENT/OUTPATIENT ANCILLARY SERVICE OTHER PASS THROUGH COSTS,APPORTIONMENT OF INPATIENT/OUTPATIENT ANCILLARY SERVICE OTHER PASS THROUGH COSTS,COST ALLOCATION,COST ALLOCATION,,ALLOCATION OF NEW CAPITAL COSTS,COMPUTATION OF INPATIENT OPERATING COSTS,,APPORTIONMENT OF MEDICAL AND OTHER HEALTH SERVICES,HOSPITAL WAGE INDEX DATA,INPATIENT ANCILLARY SERVICE COST APPORTIONMENT,COST ALLOCATION,INPATIENT ANCILLARY SERVICE COST APPORTIONMENT,APPORTIONMENT OF INPATIENT/OUTPATIENT ANCILLARY SERVICE OTHER PASS THROUGH COSTS,INPATIENT ANCILLARY SERVICE COST APPORTIONMENT,INPATIENT ANCILLARY SERVICE COST APPORTIONMENT,CALCULATION OF REIMBURSEMENT SETTLEMENT,COST ALLOCATION,Total Inpatient Days/Outpatient Visits,ANALYSIS OF CHANGES IN NEW CAPITAL BALANCES,APPORTIONMENT OF MEDICAL AND OTHER HEALTH SERVICES,APPORTIONMENT OF INPATIENT/OUTPATIENT ANCILLARY SERVICE OTHER PASS THROUGH COSTS,APPORTIONMENT OF MEDICAL AND OTHER HEALTH SERVICES,HHA STATISTICAL DATA,HOSPITAL WAGE INDEX DATA,APPORTIONMENT OF INPATIENT/OUTPATIENT ANCILLARY SERVICE OTHER PASS THROUGH COSTS,ALLOCATION OF NEW CAPITAL COSTS,APPORTIONMENT OF INPATIENT ROUTINE SERVICE CAPITAL COSTS,APPORTIONMENT OF MEDICAL AND OTHER HEALTH SERVICES,INPATIENT ANCILLARY SERVICE COST APPORTIONMENT,,CALCULATION OF REIMBURSEMENT SETTLEMENT,COST ALLOCATION,HHA STATISTICAL DATA,S-10 DATA,CALCULATION OF REIMBURSEMENT SETTLEMENT,TRIAL BALANCE OF EXPENSE ACCOUNTS,APPORTIONMENT OF INPATIENT/OUTPATIENT ANCILLARY SERVICE OTHER PASS THROUGH COSTS,HHA STATISTICAL DATA,APPORTIONMENT OF INPATIENT/OUTPATIENT ANCILLARY SERVICE OTHER PASS THROUGH COSTS,COMPUTATION OF INPATIENT OPERATING COSTS,INPATIENT ANCILLARY SERVICE COST APPORTIONMENT,TRIAL BALANCE OF EXPENSE ACCOUNTS,TRIAL BALANCE OF EXPENSE ACCOUNTS,CALCULATION OF REIMBURSEMENT SETTLEMENT,COST ALLOCATION,APPORTIONMENT OF INPATIENT/OUTPATIENT ANCILLARY SERVICE OTHER PASS THROUGH COSTS,ALLOCATION OF NEW CAPITAL COSTS,APPORTIONMENT OF INPATIENT/OUTPATIENT ANCILLARY SERVICE OTHER PASS THROUGH COSTS,COMPUTATION OF RATIO OF COST TO CHARGES,APPORTIONMENT OF INPATIENT/OUTPATIENT ANCILLARY SERVICE OTHER PASS THROUGH COSTS,INPATIENT ANCILLARY SERVICE COST APPORTIONMENT,INPATIENT ANCILLARY SERVICE COST APPORTIONMENT,COST ALLOCATION,RECONCILIATION OF CAPITAL COST CENTERS,APPORTIONMENT OF MEDICAL AND OTHER HEALTH SERVICES,TRIAL BALANCE OF EXPENSE ACCOUNTS,HOSPITAL WAGE INDEX DATA,COST ALLOCATION,INPATIENT ANCILLARY SERVICE COST APPORTIONMENT,Medicaid Inpatient Days/Outpatient Visits,APPORTIONMENT OF INPATIENT/OUTPATIENT ANCILLARY SERVICE OTHER PASS THROUGH COSTS,INPATIENT ANCILLARY SERVICE COST APPORTIONMENT,APPORTIONMENT OF INPATIENT/OUTPATIENT ANCILLARY SERVICE OTHER PASS THROUGH COSTS,TRIAL BALANCE OF EXPENSE ACCOUNTS,TRIAL BALANCE OF EXPENSE ACCOUNTS,APPORTIONMENT OF INPATIENT/OUTPATIENT ANCILLARY SERVICE OTHER PASS THROUGH COSTS,COMPUTATION OF RATIO OF COST TO CHARGES,ALLOCATION OF NEW CAPITAL COSTS,HOSPITAL WAGE INDEX DATA,COMPUTATION OF RATIO OF COST TO CHARGES,HOSPITAL WAGE INDEX DATA,TRIAL BALANCE OF EXPENSE ACCOUNTS,ALLOCATION OF NEW CAPITAL COSTS,TRIAL BALANCE OF EXPENSE ACCOUNTS,COMPUTATION OF INPATIENT OPERATING COSTS,COMPUTATION OF INPATIENT OPERATING COSTS,BALANCE SHEET,COST ALLOCATION,APPORTIONMENT OF INPATIENT/OUTPATIENT ANCILLARY SERVICE OTHER PASS THROUGH COSTS,COST ALLOCATION,Total Inpatient Days/Outpatient Visits,COST ALLOCATION,TRIAL BALANCE OF EXPENSE ACCOUNTS,HHA STATISTICAL DATA,APPORTIONMENT OF INPATIENT/OUTPATIENT ANCILLARY SERVICE OTHER PASS THROUGH COSTS,RECONCILIATION OF CAPITAL COST CENTERS,COMPUTATION OF RATIO OF COST TO CHARGES,HOSPITAL WAGE INDEX DATA,ALLOCATION OF NEW CAPITAL COSTS,COMPUTATION OF RATIO OF COST TO CHARGES,Total Inpatient Days/Outpatient Visits,APPORTIONMENT OF INPATIENT/OUTPATIENT ANCILLARY SERVICE OTHER PASS THROUGH COSTS,HOSPITAL WAGE INDEX DATA,TRIAL BALANCE OF EXPENSE ACCOUNTS,HOSPITAL WAGE INDEX DATA,Medicaid Inpatient Days/Outpatient Visits,INPATIENT ANCILLARY SERVICE COST APPORTIONMENT,COST ALLOCATION,APPORTIONMENT OF MEDICAL AND OTHER HEALTH SERVICES,COMPUTATION OF RATIO OF COST TO CHARGES,HOSPITAL WAGE INDEX DATA,,COMPUTATION OF RATIO OF COST TO CHARGES,APPORTIONMENT OF INPATIENT/OUTPATIENT ANCILLARY SERVICE OTHER PASS THROUGH COSTS,,APPORTIONMENT OF INPATIENT/OUTPATIENT ANCILLARY SERVICE OTHER PASS THROUGH COSTS,APPORTIONMENT OF INPATIENT/OUTPATIENT ANCILLARY SERVICE OTHER PASS THROUGH COSTS,HOSPITAL WAGE INDEX DATA,ANALYSIS OF CHANGES IN NEW CAPITAL BALANCES,COST ALLOCATION,APPORTIONMENT OF INPATIENT/OUTPATIENT ANCILLARY SERVICE OTHER PASS THROUGH COSTS,APPORTIONMENT OF INPATIENT/OUTPATIENT ANCILLARY SERVICE OTHER PASS THROUGH COSTS,APPORTIONMENT OF INPATIENT/OUTPATIENT ANCILLARY SERVICE OTHER PASS THROUGH COSTS,Total Inpatient Days/Outpatient Visits,HHA STATISTICAL DATA,COST ALLOCATION,APPORTIONMENT OF INPATIENT/OUTPATIENT ANCILLARY SERVICE OTHER PASS THROUGH COSTS,,BED DAYS AVAILABLE,COMPUTATION OF RATIO OF COST TO CHARGES,HHA STATISTICAL DATA,INPATIENT ANCILLARY SERVICE COST APPORTIONMENT,INPATIENT ANCILLARY SERVICE COST APPORTIONMENT,COST ALLOCATION,HOSPITAL WAGE INDEX DATA,TRIAL BALANCE OF EXPENSE ACCOUNTS,COMPUTATION OF RATIO OF COST TO CHARGES,APPORTIONMENT OF INPATIENT/OUTPATIENT ANCILLARY SERVICE OTHER PASS THROUGH COSTS,TRIAL BALANCE OF EXPENSE ACCOUNTS,APPORTIONMENT OF INPATIENT/OUTPATIENT ANCILLARY SERVICE OTHER PASS THROUGH COSTS,APPORTIONMENT OF INPATIENT/OUTPATIENT ANCILLARY SERVICE OTHER PASS THROUGH COSTS,RENAL STATISTICAL DATA,COST ALLOCATION,INPATIENT ANCILLARY SERVICE COST APPORTIONMENT,CALCULATION OF REIMBURSEMENT SETTLEMENT,HOSPITAL WAGE INDEX DATA,ANALYSIS OF CHANGES IN NEW CAPITAL BALANCES,,COST ALLOCATION,TRIAL BALANCE OF EXPENSE ACCOUNTS,APPORTIONMENT OF INPATIENT/OUTPATIENT ANCILLARY SERVICE OTHER PASS THROUGH COSTS,HHA STATISTICAL DATA,APPORTIONMENT OF INPATIENT/OUTPATIENT ANCILLARY SERVICE OTHER PASS THROUGH COSTS,ANALYSIS OF CHANGES IN NEW CAPITAL BALANCES,COST ALLOCATION,HOSPITAL IDENTIFICATION INFORMATION,INPATIENT ANCILLARY SERVICE COST APPORTIONMENT,APPORTIONMENT OF INPATIENT ROUTINE SERVICE CAPITAL COSTS,APPORTIONMENT OF INPATIENT/OUTPATIENT ANCILLARY SERVICE OTHER PASS THROUGH COSTS,APPORTIONMENT OF INPATIENT/OUTPATIENT ANCILLARY SERVICE OTHER PASS THROUGH COSTS,TRIAL BALANCE OF EXPENSE ACCOUNTS,APPORTIONMENT OF INPATIENT/OUTPATIENT ANCILLARY SERVICE OTHER PASS THROUGH COSTS,APPORTIONMENT OF MEDICAL AND OTHER HEALTH SERVICES,BALANCE SHEET,APPORTIONMENT OF INPATIENT/OUTPATIENT ANCILLARY SERVICE OTHER PASS THROUGH COSTS,HOSPITAL WAGE INDEX DATA,HOSPITAL WAGE INDEX DATA,ADJUSTMENTS,INPATIENT ANCILLARY SERVICE COST APPORTIONMENT,COMPUTATION OF RATIO OF COST TO CHARGES,HHA STATISTICAL DATA,RENAL STATISTICAL DATA,RECONCILIATION OF CAPITAL COST CENTERS,INPATIENT ANCILLARY SERVICE COST APPORTIONMENT,INPATIENT ANCILLARY SERVICE COST APPORTIONMENT,APPORTIONMENT OF INPATIENT/OUTPATIENT ANCILLARY SERVICE OTHER PASS THROUGH COSTS,,TRIAL BALANCE OF EXPENSE ACCOUNTS,HOSPITAL WAGE INDEX DATA,HOSPITAL WAGE INDEX DATA,ADJUSTMENTS,APPORTIONMENT OF MEDICAL AND OTHER HEALTH SERVICES,COST ALLOCATION,INPATIENT ANCILLARY SERVICE COST APPORTIONMENT,,HOSPITAL WAGE INDEX DATA,APPORTIONMENT OF INPATIENT/OUTPATIENT ANCILLARY SERVICE OTHER PASS THROUGH COSTS,,,BED DAYS AVAILABLE,INPATIENT ANCILLARY SERVICE COST APPORTIONMENT,COST ALLOCATION,BED DAYS AVAILABLE,TRIAL BALANCE OF EXPENSE ACCOUNTS,TRIAL BALANCE OF EXPENSE ACCOUNTS,APPORTIONMENT OF INPATIENT/OUTPATIENT ANCILLARY SERVICE OTHER PASS THROUGH COSTS,HOSPITAL WAGE INDEX DATA,HOSPITAL WAGE INDEX DATA,BALANCE SHEET,COST ALLOCATION,ANALYSIS OF CHANGES IN NEW CAPITAL BALANCES,COST ALLOCATION,APPORTIONMENT OF MEDICAL AND OTHER HEALTH SERVICES,HHA STATISTICAL DATA,,APPORTIONMENT OF INPATIENT/OUTPATIENT ANCILLARY SERVICE OTHER PASS THROUGH COSTS,APPORTIONMENT OF MEDICAL AND OTHER HEALTH SERVICES,ADJUSTMENTS,HOSPITAL WAGE INDEX DATA,INPATIENT ANCILLARY SERVICE COST APPORTIONMENT,BALANCE SHEET,HOSPITAL WAGE INDEX DATA,INPATIENT ANCILLARY SERVICE COST APPORTIONMENT,COMPUTATION OF RATIO OF COST TO CHARGES,RECONCILIATION OF CAPITAL COST CENTERS,RENAL STATISTICAL DATA,INPATIENT ANCILLARY SERVICE COST APPORTIONMENT,HOSPITAL WAGE INDEX DATA,COST ALLOCATION,,,BALANCE SHEET,APPORTIONMENT OF INPATIENT/OUTPATIENT ANCILLARY SERVICE OTHER PASS THROUGH COSTS,ANALYSIS OF CHANGES IN NEW CAPITAL BALANCES,,COST ALLOCATION,APPORTIONMENT OF INPATIENT/OUTPATIENT ANCILLARY SERVICE OTHER PASS THROUGH COSTS,INPATIENT ANCILLARY SERVICE COST APPORTIONMENT,TRIAL BALANCE OF EXPENSE ACCOUNTS,Total Inpatient Days/Outpatient Visits,HHA STATISTICAL DATA,HOSPITAL WAGE INDEX DATA,INPATIENT ANCILLARY SERVICE COST APPORTIONMENT,ANALYSIS OF CHANGES IN NEW CAPITAL BALANCES,BED DAYS AVAILABLE,INPATIENT ANCILLARY SERVICE COST APPORTIONMENT,HOSPITAL WAGE INDEX DATA,ANALYSIS OF CHANGES IN NEW CAPITAL BALANCES,COST ALLOCATION,APPORTIONMENT OF INPATIENT ROUTINE SERVICE CAPITAL COSTS,HOSPITAL WAGE INDEX DATA,HOSPITAL WAGE INDEX DATA,COMPUTATION OF RATIO OF COST TO CHARGES,HOSPITAL WAGE INDEX DATA,ADJUSTMENTS,APPORTIONMENT OF INPATIENT/OUTPATIENT ANCILLARY SERVICE OTHER PASS THROUGH COSTS,INPATIENT ANCILLARY SERVICE COST APPORTIONMENT,APPORTIONMENT OF INPATIENT/OUTPATIENT ANCILLARY SERVICE OTHER PASS THROUGH COSTS,INPATIENT ANCILLARY SERVICE COST APPORTIONMENT,COMPUTATION OF INPATIENT OPERATING COSTS,HOSPITAL WAGE INDEX DATA,APPORTIONMENT OF INPATIENT/OUTPATIENT ANCILLARY SERVICE OTHER PASS THROUGH COSTS,ALLOCATION OF NEW CAPITAL COSTS,Medicaid Inpatient Days/Outpatient Visits,COMPUTATION OF RATIO OF COST TO CHARGES,INPATIENT ANCILLARY SERVICE COST APPORTIONMENT,COST ALLOCATION,TRIAL BALANCE OF EXPENSE ACCOUNTS,,ADJUSTMENTS,COST ALLOCATION,COMPUTATION OF RATIO OF COST TO CHARGES,HHA STATISTICAL DATA,ANALYSIS OF CHANGES IN NEW CAPITAL BALANCES,HHA STATISTICAL DATA,APPORTIONMENT OF MEDICAL AND OTHER HEALTH SERVICES,INPATIENT ANCILLARY SERVICE COST APPORTIONMENT,COMPUTATION OF RATIO OF COST TO CHARGES,APPORTIONMENT OF INPATIENT/OUTPATIENT ANCILLARY SERVICE OTHER PASS THROUGH COSTS,,APPORTIONMENT OF MEDICAL AND OTHER HEALTH SERVICES,INPATIENT ANCILLARY SERVICE COST APPORTIONMENT,APPORTIONMENT OF INPATIENT/OUTPATIENT ANCILLARY SERVICE OTHER PASS THROUGH COSTS,COST ALLOCATION,INPATIENT ANCILLARY SERVICE COST APPORTIONMENT,TRIAL BALANCE OF EXPENSE ACCOUNTS,ANALYSIS OF CHANGES IN NEW CAPITAL BALANCES,,TRIAL BALANCE OF EXPENSE ACCOUNTS,ADJUSTMENTS,APPORTIONMENT OF INPATIENT/OUTPATIENT ANCILLARY SERVICE OTHER PASS THROUGH COSTS,CALCULATION OF REIMBURSEMENT SETTLEMENT,ALLOCATION OF NEW CAPITAL COSTS,COMPUTATION OF RATIO OF COST TO CHARGES,APPORTIONMENT OF INPATIENT/OUTPATIENT ANCILLARY SERVICE OTHER PASS THROUGH COSTS,COST ALLOCATION,COST ALLOCATION,APPORTIONMENT OF INPATIENT/OUTPATIENT ANCILLARY SERVICE OTHER PASS THROUGH COSTS,COMPUTATION OF RATIO OF COST TO CHARGES,TRIAL BALANCE OF EXPENSE ACCOUNTS,COMPUTATION OF INPATIENT OPERATING COSTS,TRIAL BALANCE OF EXPENSE ACCOUNTS,HOSPITAL WAGE INDEX DATA,COMPUTATION OF RATIO OF COST TO CHARGES,HOSPITAL WAGE INDEX DATA,APPORTIONMENT OF INPATIENT ROUTINE SERVICE OTHER PASS THROUGH COSTS,TRIAL BALANCE OF EXPENSE ACCOUNTS,INPATIENT ANCILLARY SERVICE COST APPORTIONMENT,TRIAL BALANCE OF EXPENSE ACCOUNTS,Total Inpatient Days/Outpatient Visits,TRIAL BALANCE OF EXPENSE ACCOUNTS,APPORTIONMENT OF INPATIENT/OUTPATIENT ANCILLARY SERVICE OTHER PASS THROUGH COSTS,APPORTIONMENT OF INPATIENT/OUTPATIENT ANCILLARY SERVICE OTHER PASS THROUGH COSTS,APPORTIONMENT OF INPATIENT/OUTPATIENT ANCILLARY SERVICE OTHER PASS THROUGH COSTS,APPORTIONMENT OF MEDICAL AND OTHER HEALTH SERVICES,APPORTIONMENT OF INPATIENT/OUTPATIENT ANCILLARY SERVICE OTHER PASS THROUGH COSTS,Total Inpatient Days/Outpatient Visits,TRIAL BALANCE OF EXPENSE ACCOUNTS,HHA STATISTICAL DATA,APPORTIONMENT OF INPATIENT ROUTINE SERVICE OTHER PASS THROUGH COSTS,BED DAYS AVAILABLE,APPORTIONMENT OF MEDICAL AND OTHER HEALTH SERVICES,HOSPITAL WAGE INDEX DATA,HHA STATISTICAL DATA,COST ALLOCATION,HHA STATISTICAL DATA,TRIAL BALANCE OF EXPENSE ACCOUNTS,COST ALLOCATION,COST ALLOCATION,APPORTIONMENT OF INPATIENT/OUTPATIENT ANCILLARY SERVICE OTHER PASS THROUGH COSTS,COMPUTATION OF RATIO OF COST TO CHARGES,APPORTIONMENT OF INPATIENT/OUTPATIENT ANCILLARY SERVICE OTHER PASS THROUGH COSTS,COMPUTATION OF INPATIENT OPERATING COSTS,,INPATIENT ANCILLARY SERVICE COST APPORTIONMENT,APPORTIONMENT OF INPATIENT ROUTINE SERVICE CAPITAL COSTS,APPORTIONMENT OF INPATIENT/OUTPATIENT ANCILLARY SERVICE OTHER PASS THROUGH COSTS,CALCULATION OF REIMBURSEMENT SETTLEMENT,Total Inpatient Days/Outpatient Visits,ANALYSIS OF CHANGES IN NEW CAPITAL BALANCES,HOSPITAL WAGE INDEX DATA,APPORTIONMENT OF MEDICAL AND OTHER HEALTH SERVICES,APPORTIONMENT OF INPATIENT/OUTPATIENT ANCILLARY SERVICE OTHER PASS THROUGH COSTS,COMPUTATION OF RATIO OF COST TO CHARGES,APPORTIONMENT OF INPATIENT/OUTPATIENT ANCILLARY SERVICE OTHER PASS THROUGH COSTS,HHA STATISTICAL DATA,,TRIAL BALANCE OF EXPENSE ACCOUNTS,APPORTIONMENT OF INPATIENT/OUTPATIENT ANCILLARY SERVICE OTHER PASS THROUGH COSTS,Total Inpatient Days/Outpatient Visits,TRIAL BALANCE OF EXPENSE ACCOUNTS,TRIAL BALANCE OF EXPENSE ACCOUNTS,TRIAL BALANCE OF EXPENSE ACCOUNTS,APPORTIONMENT OF INPATIENT/OUTPATIENT ANCILLARY SERVICE OTHER PASS THROUGH COSTS,APPORTIONMENT OF INPATIENT/OUTPATIENT ANCILLARY SERVICE OTHER PASS THROUGH COSTS,ANALYSIS OF CHANGES IN NEW CAPITAL BALANCES,HOSPITAL WAGE INDEX DATA,APPORTIONMENT OF MEDICAL AND OTHER HEALTH SERVICES,APPORTIONMENT OF INPATIENT/OUTPATIENT ANCILLARY SERVICE OTHER PASS THROUGH COSTS,,COST ALLOCATION,COST ALLOCATION,INPATIENT ANCILLARY SERVICE COST APPORTIONMENT,COMPUTATION OF RATIO OF COST TO CHARGES,ANALYSIS OF CHANGES IN NEW CAPITAL BALANCES,CALCULATION OF REIMBURSEMENT SETTLEMENT,COMPUTATION OF RATIO OF COST TO CHARGES,ALLOCATION OF NEW CAPITAL COSTS,APPORTIONMENT OF INPATIENT/OUTPATIENT ANCILLARY SERVICE OTHER PASS THROUGH COSTS,,HOSPITAL WAGE INDEX DATA,COMPUTATION OF RATIO OF COST TO CHARGES,APPORTIONMENT OF MEDICAL AND OTHER HEALTH SERVICES,ANALYSIS OF CHANGES IN NEW CAPITAL BALANCES,Total Inpatient Days/Outpatient Visits,ALLOCATION OF NEW CAPITAL COSTS,TRIAL BALANCE OF EXPENSE ACCOUNTS,COMPUTATION OF RATIO OF COST TO CHARGES,APPORTIONMENT OF INPATIENT/OUTPATIENT ANCILLARY SERVICE OTHER PASS THROUGH COSTS,TRIAL BALANCE OF EXPENSE ACCOUNTS,APPORTIONMENT OF INPATIENT/OUTPATIENT ANCILLARY SERVICE OTHER PASS THROUGH COSTS,APPORTIONMENT OF INPATIENT/OUTPATIENT ANCILLARY SERVICE OTHER PASS THROUGH COSTS,COMPUTATION OF INPATIENT OPERATING COSTS,APPORTIONMENT OF INPATIENT/OUTPATIENT ANCILLARY SERVICE OTHER PASS THROUGH COSTS,COST ALLOCATION,INPATIENT ANCILLARY SERVICE COST APPORTIONMENT,HOSPITAL WAGE INDEX DATA,HOSPITAL WAGE INDEX DATA,CALCULATION OF REIMBURSEMENT SETTLEMENT,TRIAL BALANCE OF EXPENSE ACCOUNTS,APPORTIONMENT OF INPATIENT/OUTPATIENT ANCILLARY SERVICE OTHER PASS THROUGH COSTS,APPORTIONMENT OF INPATIENT/OUTPATIENT ANCILLARY SERVICE OTHER PASS THROUGH COSTS,TRIAL BALANCE OF EXPENSE ACCOUNTS,ALLOCATION OF NEW CAPITAL COSTS,INPATIENT ANCILLARY SERVICE COST APPORTIONMENT,APPORTIONMENT OF INPATIENT/OUTPATIENT ANCILLARY SERVICE OTHER PASS THROUGH COSTS,APPORTIONMENT OF INPATIENT/OUTPATIENT ANCILLARY SERVICE OTHER PASS THROUGH COSTS,BED DAYS AVAILABLE,INPATIENT ANCILLARY SERVICE COST APPORTIONMENT,Total Inpatient Days/Outpatient Visits,TRIAL BALANCE OF EXPENSE ACCOUNTS,APPORTIONMENT OF MEDICAL AND OTHER HEALTH SERVICES,APPORTIONMENT OF MEDICAL AND OTHER HEALTH SERVICES,ALLOCATION OF NEW CAPITAL COSTS,COST ALLOCATION,TRIAL BALANCE OF EXPENSE ACCOUNTS,HHA STATISTICAL DATA,HOSPITAL WAGE INDEX DATA,COST ALLOCATION,APPORTIONMENT OF MEDICAL AND OTHER HEALTH SERVICES,Total Inpatient Days/Outpatient Visits,INPATIENT ANCILLARY SERVICE COST APPORTIONMENT,APPORTIONMENT OF INPATIENT/OUTPATIENT ANCILLARY SERVICE OTHER PASS THROUGH COSTS,INPATIENT ANCILLARY SERVICE COST APPORTIONMENT,HHA STATISTICAL DATA,TRIAL BALANCE OF EXPENSE ACCOUNTS,S-10 DATA,APPORTIONMENT OF INPATIENT/OUTPATIENT ANCILLARY SERVICE OTHER PASS THROUGH COSTS,COST ALLOCATION,TRIAL BALANCE OF EXPENSE ACCOUNTS,COMPUTATION OF RATIO OF COST TO CHARGES,COMPUTATION OF INPATIENT OPERATING COSTS,COST ALLOCATION,HHA STATISTICAL DATA,APPORTIONMENT OF MEDICAL AND OTHER HEALTH SERVICES,COST ALLOCATION,Medicare Inpatient Days/Outpatient Visits,ALLOCATION OF NEW CAPITAL COSTS,Total Inpatient Days/Outpatient Visits,COST ALLOCATION,COMPUTATION OF RATIO OF COST TO CHARGES,CALCULATION OF REIMBURSEMENT SETTLEMENT,,,COMPUTATION OF RATIO OF COST TO CHARGES,APPORTIONMENT OF MEDICAL AND OTHER HEALTH SERVICES,RECONCILIATION OF CAPITAL COST CENTERS,APPORTIONMENT OF INPATIENT/OUTPATIENT ANCILLARY SERVICE OTHER PASS THROUGH COSTS,S-10 DATA,APPORTIONMENT OF INPATIENT/OUTPATIENT ANCILLARY SERVICE OTHER PASS THROUGH COSTS,APPORTIONMENT OF INPATIENT/OUTPATIENT ANCILLARY SERVICE OTHER PASS THROUGH COSTS,INPATIENT ANCILLARY SERVICE COST APPORTIONMENT,APPORTIONMENT OF INPATIENT/OUTPATIENT ANCILLARY SERVICE OTHER PASS THROUGH COSTS,TRIAL BALANCE OF EXPENSE ACCOUNTS,COMPUTATION OF RATIO OF COST TO CHARGES,ANALYSIS OF CHANGES IN NEW CAPITAL BALANCES,INPATIENT ANCILLARY SERVICE COST APPORTIONMENT,APPORTIONMENT OF MEDICAL AND OTHER HEALTH SERVICES,ALLOCATION OF NEW CAPITAL COSTS,APPORTIONMENT OF INPATIENT/OUTPATIENT ANCILLARY SERVICE OTHER PASS THROUGH COSTS,APPORTIONMENT OF MEDICAL AND OTHER HEALTH SERVICES,Total Inpatient Days/Outpatient Visits,INPATIENT ANCILLARY SERVICE COST APPORTIONMENT,COST ALLOCATION,APPORTIONMENT OF MEDICAL AND OTHER HEALTH SERVICES,ALLOCATION OF NEW CAPITAL COSTS,INPATIENT ANCILLARY SERVICE COST APPORTIONMENT,HOSPITAL WAGE INDEX DATA,APPORTIONMENT OF INPATIENT/OUTPATIENT ANCILLARY SERVICE OTHER PASS THROUGH COSTS,HOSPITAL WAGE INDEX DATA,TRIAL BALANCE OF EXPENSE ACCOUNTS,COST ALLOCATION,INPATIENT ANCILLARY SERVICE COST APPORTIONMENT,INPATIENT ANCILLARY SERVICE COST APPORTIONMENT,APPORTIONMENT OF INPATIENT/OUTPATIENT ANCILLARY SERVICE OTHER PASS THROUGH COSTS,TRIAL BALANCE OF EXPENSE ACCOUNTS,ANALYSIS OF CHANGES IN NEW CAPITAL BALANCES,Medicare Inpatient Days/Outpatient Visits,APPORTIONMENT OF MEDICAL AND OTHER HEALTH SERVICES,TRIAL BALANCE OF EXPENSE ACCOUNTS,APPORTIONMENT OF INPATIENT/OUTPATIENT ANCILLARY SERVICE OTHER PASS THROUGH COSTS,COMPUTATION OF RATIO OF COST TO CHARGES,COMPUTATION OF RATIO OF COST TO CHARGES,COST ALLOCATION,COMPUTATION OF RATIO OF COST TO CHARGES,COST ALLOCATION,APPORTIONMENT OF INPATIENT/OUTPATIENT ANCILLARY SERVICE OTHER PASS THROUGH COSTS,INPATIENT ANCILLARY SERVICE COST APPORTIONMENT,INPATIENT ANCILLARY SERVICE COST APPORTIONMENT,TRIAL BALANCE OF EXPENSE ACCOUNTS,INPATIENT ANCILLARY SERVICE COST APPORTIONMENT,COST ALLOCATION,APPORTIONMENT OF INPATIENT ROUTINE SERVICE CAPITAL COSTS,APPORTIONMENT OF INPATIENT/OUTPATIENT ANCILLARY SERVICE OTHER PASS THROUGH COSTS,BALANCE SHEET,BALANCE SHEET,INPATIENT ANCILLARY SERVICE COST APPORTIONMENT,CALCULATION OF REIMBURSEMENT SETTLEMENT,S-10 DATA,,ALLOCATION OF NEW CAPITAL COSTS,APPORTIONMENT OF INPATIENT ROUTINE SERVICE CAPITAL COSTS,COMPUTATION OF INPATIENT OPERATING COSTS,HHA STATISTICAL DATA,BALANCE SHEET,HOSPITAL WAGE INDEX DATA,HOSPITAL WAGE INDEX DATA,RENAL STATISTICAL DATA,COST ALLOCATION,INPATIENT ANCILLARY SERVICE COST APPORTIONMENT,APPORTIONMENT OF MEDICAL AND OTHER HEALTH SERVICES,APPORTIONMENT OF INPATIENT/OUTPATIENT ANCILLARY SERVICE OTHER PASS THROUGH COSTS,INPATIENT ANCILLARY SERVICE COST APPORTIONMENT,INPATIENT ANCILLARY SERVICE COST APPORTIONMENT,TRIAL BALANCE OF EXPENSE ACCOUNTS,COMPUTATION OF RATIO OF COST TO CHARGES,HHA STATISTICAL DATA,APPORTIONMENT OF INPATIENT/OUTPATIENT ANCILLARY SERVICE OTHER PASS THROUGH COSTS,COST ALLOCATION,ALLOCATION OF NEW CAPITAL COSTS,HOSPITAL WAGE INDEX DATA,TRIAL BALANCE OF EXPENSE ACCOUNTS,TRIAL BALANCE OF EXPENSE ACCOUNTS,APPORTIONMENT OF INPATIENT/OUTPATIENT ANCILLARY SERVICE OTHER PASS THROUGH COSTS,Total Inpatient Days/Outpatient Visits,TRIAL BALANCE OF EXPENSE ACCOUNTS,COMPUTATION OF INPATIENT OPERATING COSTS,TRIAL BALANCE OF EXPENSE ACCOUNTS,TRIAL BALANCE OF EXPENSE ACCOUNTS,COST ALLOCATION,APPORTIONMENT OF INPATIENT/OUTPATIENT ANCILLARY SERVICE OTHER PASS THROUGH COSTS,COMPUTATION OF RATIO OF COST TO CHARGES,COMPUTATION OF RATIO OF COST TO CHARGES,COMPUTATION OF RATIO OF COST TO CHARGES,BED DAYS AVAILABLE,TRIAL BALANCE OF EXPENSE ACCOUNTS,HOSPITAL WAGE INDEX DATA,HOSPITAL WAGE INDEX DATA,TRIAL BALANCE OF EXPENSE ACCOUNTS,RENAL STATISTICAL DATA,COMPUTATION OF RATIO OF COST TO CHARGES,TRIAL BALANCE OF EXPENSE ACCOUNTS,NUMBER OF BEDS,COMPUTATION OF RATIO OF COST TO CHARGES,COMPUTATION OF RATIO OF COST TO CHARGES,INPATIENT ANCILLARY SERVICE COST APPORTIONMENT,NUMBER OF BEDS,INPATIENT ANCILLARY SERVICE COST APPORTIONMENT,COMPUTATION OF RATIO OF COST TO CHARGES,HOSPITAL WAGE INDEX DATA,COST ALLOCATION,TRIAL BALANCE OF EXPENSE ACCOUNTS,COST ALLOCATION,APPORTIONMENT OF INPATIENT/OUTPATIENT ANCILLARY SERVICE OTHER PASS THROUGH COSTS,COST ALLOCATION,APPORTIONMENT OF INPATIENT/OUTPATIENT ANCILLARY SERVICE OTHER PASS THROUGH COSTS,APPORTIONMENT OF MEDICAL AND OTHER HEALTH SERVICES,HOSPITAL IDENTIFICATION INFORMATION,COST ALLOCATION,APPORTIONMENT OF INPATIENT/OUTPATIENT ANCILLARY SERVICE OTHER PASS THROUGH COSTS,APPORTIONMENT OF MEDICAL AND OTHER HEALTH SERVICES,APPORTIONMENT OF MEDICAL AND OTHER HEALTH SERVICES,INPATIENT ANCILLARY SERVICE COST APPORTIONMENT,COST ALLOCATION,APPORTIONMENT OF INPATIENT/OUTPATIENT ANCILLARY SERVICE OTHER PASS THROUGH COSTS,ALLOCATION OF NEW CAPITAL COSTS,APPORTIONMENT OF MEDICAL AND OTHER HEALTH SERVICES,APPORTIONMENT OF MEDICAL AND OTHER HEALTH SERVICES,TRIAL BALANCE OF EXPENSE ACCOUNTS,HOSPITAL WAGE INDEX DATA,ALLOCATION OF NEW CAPITAL COSTS,APPORTIONMENT OF INPATIENT/OUTPATIENT ANCILLARY SERVICE OTHER PASS THROUGH COSTS,INPATIENT ANCILLARY SERVICE COST APPORTIONMENT,APPORTIONMENT OF INPATIENT/OUTPATIENT ANCILLARY SERVICE OTHER PASS THROUGH COSTS,COMPUTATION OF RATIO OF COST TO CHARGES,S-10 DATA,ALLOCATION OF NEW CAPITAL COSTS,INPATIENT ANCILLARY SERVICE COST APPORTIONMENT,COST ALLOCATION,COST ALLOCATION,,HOSPITAL WAGE INDEX DATA,INPATIENT ANCILLARY SERVICE COST APPORTIONMENT,TRIAL BALANCE OF EXPENSE ACCOUNTS,TRIAL BALANCE OF EXPENSE ACCOUNTS,COST ALLOCATION,HOSPITAL WAGE INDEX DATA,HOSPITAL WAGE INDEX DATA,COST ALLOCATION,APPORTIONMENT OF INPATIENT/OUTPATIENT ANCILLARY SERVICE OTHER PASS THROUGH COSTS,INPATIENT ANCILLARY SERVICE COST APPORTIONMENT,INPATIENT ANCILLARY SERVICE COST APPORTIONMENT,CALCULATION OF REIMBURSEMENT SETTLEMENT,HOSPITAL WAGE INDEX DATA,CALCULATION OF REIMBURSEMENT SETTLEMENT,APPORTIONMENT OF MEDICAL AND OTHER HEALTH SERVICES,TRIAL BALANCE OF EXPENSE ACCOUNTS,Medicare Inpatient Days/Outpatient Visits,COST ALLOCATION,Total Inpatient Days/Outpatient Visits,INPATIENT ANCILLARY SERVICE COST APPORTIONMENT,INPATIENT ANCILLARY SERVICE COST APPORTIONMENT,COST ALLOCATION,COMPUTATION OF RATIO OF COST TO CHARGES,,RECONCILIATION OF CAPITAL COST CENTERS,TRIAL BALANCE OF EXPENSE ACCOUNTS,COMPUTATION OF RATIO OF COST TO CHARGES,ANALYSIS OF CHANGES IN NEW CAPITAL BALANCES,COST ALLOCATION,COST ALLOCATION,INPATIENT ANCILLARY SERVICE COST APPORTIONMENT,Total Inpatient Days/Outpatient Visits,APPORTIONMENT OF INPATIENT/OUTPATIENT ANCILLARY SERVICE OTHER PASS THROUGH COSTS,Total Inpatient Days/Outpatient Visits,APPORTIONMENT OF MEDICAL AND OTHER HEALTH SERVICES,COST ALLOCATION,ADJUSTMENTS,RECONCILIATION OF CAPITAL COST CENTERS,INPATIENT ANCILLARY SERVICE COST APPORTIONMENT,HOSPITAL WAGE INDEX DATA,APPORTIONMENT OF INPATIENT/OUTPATIENT ANCILLARY SERVICE OTHER PASS THROUGH COSTS,APPORTIONMENT OF INPATIENT ROUTINE SERVICE CAPITAL COSTS,APPORTIONMENT OF INPATIENT/OUTPATIENT ANCILLARY SERVICE OTHER PASS THROUGH COSTS,APPORTIONMENT OF INPATIENT/OUTPATIENT ANCILLARY SERVICE OTHER PASS THROUGH COSTS,INPATIENT ANCILLARY SERVICE COST APPORTIONMENT,TRIAL BALANCE OF EXPENSE ACCOUNTS,APPORTIONMENT OF MEDICAL AND OTHER HEALTH SERVICES,COST ALLOCATION,COST ALLOCATION,APPORTIONMENT OF INPATIENT/OUTPATIENT ANCILLARY SERVICE OTHER PASS THROUGH COSTS,INPATIENT ANCILLARY SERVICE COST APPORTIONMENT,TRIAL BALANCE OF EXPENSE ACCOUNTS,ANALYSIS OF CHANGES IN NEW CAPITAL BALANCES,APPORTIONMENT OF INPATIENT/OUTPATIENT ANCILLARY SERVICE OTHER PASS THROUGH COSTS,COMPUTATION OF RATIO OF COST TO CHARGES,APPORTIONMENT OF INPATIENT/OUTPATIENT ANCILLARY SERVICE OTHER PASS THROUGH COSTS,STATEMENT OF REVENUES AND EXPENSES,COST ALLOCATION,TRIAL BALANCE OF EXPENSE ACCOUNTS,APPORTIONMENT OF MEDICAL AND OTHER HEALTH SERVICES,COST ALLOCATION,COST ALLOCATION,COST ALLOCATION,INPATIENT ANCILLARY SERVICE COST APPORTIONMENT,INPATIENT ANCILLARY SERVICE COST APPORTIONMENT,TRIAL BALANCE OF EXPENSE ACCOUNTS,HOSPITAL WAGE INDEX DATA,APPORTIONMENT OF INPATIENT/OUTPATIENT ANCILLARY SERVICE OTHER PASS THROUGH COSTS,ALLOCATION OF NEW CAPITAL COSTS,COST ALLOCATION,Medicare Inpatient Days/Outpatient Visits,HOSPITAL WAGE INDEX DATA,APPORTIONMENT OF MEDICAL AND OTHER HEALTH SERVICES,TRIAL BALANCE OF EXPENSE ACCOUNTS,HOSPITAL IDENTIFICATION INFORMATION,TRIAL BALANCE OF EXPENSE ACCOUNTS,COMPUTATION OF RATIO OF COST TO CHARGES,Total Inpatient Days/Outpatient Visits,APPORTIONMENT OF INPATIENT/OUTPATIENT ANCILLARY SERVICE OTHER PASS THROUGH COSTS,INPATIENT ANCILLARY SERVICE COST APPORTIONMENT,HOSPITAL WAGE INDEX DATA,TRIAL BALANCE OF EXPENSE ACCOUNTS,APPORTIONMENT OF INPATIENT/OUTPATIENT ANCILLARY SERVICE OTHER PASS THROUGH COSTS,Medicare Inpatient Days/Outpatient Visits,INPATIENT ANCILLARY SERVICE COST APPORTIONMENT,HOSPITAL WAGE INDEX DATA,HOSPITAL WAGE INDEX DATA,TRIAL BALANCE OF EXPENSE ACCOUNTS,TRIAL BALANCE OF EXPENSE ACCOUNTS,INPATIENT ANCILLARY SERVICE COST APPORTIONMENT,Total Inpatient Days/Outpatient Visits,BED DAYS AVAILABLE,RENAL STATISTICAL DATA,INPATIENT ANCILLARY SERVICE COST APPORTIONMENT,RENAL STATISTICAL DATA,APPORTIONMENT OF INPATIENT/OUTPATIENT ANCILLARY SERVICE OTHER PASS THROUGH COSTS,,INPATIENT ANCILLARY SERVICE COST APPORTIONMENT,APPORTIONMENT OF INPATIENT/OUTPATIENT ANCILLARY SERVICE OTHER PASS THROUGH COSTS,APPORTIONMENT OF INPATIENT/OUTPATIENT ANCILLARY SERVICE OTHER PASS THROUGH COSTS,COMPUTATION OF RATIO OF COST TO CHARGES,Medicaid Inpatient Days/Outpatient Visits,BED DAYS AVAILABLE,INPATIENT ANCILLARY SERVICE COST APPORTIONMENT,ALLOCATION OF NEW CAPITAL COSTS,TRIAL BALANCE OF EXPENSE ACCOUNTS,TRIAL BALANCE OF EXPENSE ACCOUNTS,INPATIENT ANCILLARY SERVICE COST APPORTIONMENT,,APPORTIONMENT OF MEDICAL AND OTHER HEALTH SERVICES,HOSPITAL IDENTIFICATION INFORMATION,HHA STATISTICAL DATA,TRIAL BALANCE OF EXPENSE ACCOUNTS,APPORTIONMENT OF MEDICAL AND OTHER HEALTH SERVICES,APPORTIONMENT OF MEDICAL AND OTHER HEALTH SERVICES,APPORTIONMENT OF MEDICAL AND OTHER HEALTH SERVICES,APPORTIONMENT OF INPATIENT/OUTPATIENT ANCILLARY SERVICE OTHER PASS THROUGH COSTS,TRIAL BALANCE OF EXPENSE ACCOUNTS,APPORTIONMENT OF INPATIENT/OUTPATIENT ANCILLARY SERVICE OTHER PASS THROUGH COSTS,BED DAYS AVAILABLE,APPORTIONMENT OF INPATIENT/OUTPATIENT ANCILLARY SERVICE OTHER PASS THROUGH COSTS,ANALYSIS OF CHANGES IN NEW CAPITAL BALANCES,APPORTIONMENT OF INPATIENT/OUTPATIENT ANCILLARY SERVICE OTHER PASS THROUGH COSTS,APPORTIONMENT OF MEDICAL AND OTHER HEALTH SERVICES,S-10 DATA,APPORTIONMENT OF INPATIENT/OUTPATIENT ANCILLARY SERVICE OTHER PASS THROUGH COSTS,ADJUSTMENTS,APPORTIONMENT OF MEDICAL AND OTHER HEALTH SERVICES,COST ALLOCATION,APPORTIONMENT OF MEDICAL AND OTHER HEALTH SERVICES,TRIAL BALANCE OF EXPENSE ACCOUNTS,TRIAL BALANCE OF EXPENSE ACCOUNTS,COMPUTATION OF RATIO OF COST TO CHARGES,BED DAYS AVAILABLE,Total Inpatient Days/Outpatient Visits,TRIAL BALANCE OF EXPENSE ACCOUNTS,ALLOCATION OF NEW CAPITAL COSTS,INPATIENT ANCILLARY SERVICE COST APPORTIONMENT,CALCULATION OF REIMBURSEMENT SETTLEMENT,INPATIENT ANCILLARY SERVICE COST APPORTIONMENT,TRIAL BALANCE OF EXPENSE ACCOUNTS,COST ALLOCATION,HOSPITAL WAGE INDEX DATA,CALCULATION OF REIMBURSEMENT SETTLEMENT,Total Inpatient Days/Outpatient Visits,HOSPITAL WAGE INDEX DATA,COST ALLOCATION,APPORTIONMENT OF INPATIENT/OUTPATIENT ANCILLARY SERVICE OTHER PASS THROUGH COSTS,S-10 DATA,APPORTIONMENT OF MEDICAL AND OTHER HEALTH SERVICES,APPORTIONMENT OF INPATIENT/OUTPATIENT ANCILLARY SERVICE OTHER PASS THROUGH COSTS,ANALYSIS OF CHANGES IN NEW CAPITAL BALANCES,INPATIENT ANCILLARY SERVICE COST APPORTIONMENT,ANALYSIS OF CHANGES IN NEW CAPITAL BALANCES,TRIAL BALANCE OF EXPENSE ACCOUNTS,APPORTIONMENT OF MEDICAL AND OTHER HEALTH SERVICES,APPORTIONMENT OF MEDICAL AND OTHER HEALTH SERVICES,Total Inpatient Days/Outpatient Visits,APPORTIONMENT OF INPATIENT ROUTINE SERVICE CAPITAL COSTS,TRIAL BALANCE OF EXPENSE ACCOUNTS,HOSPITAL WAGE INDEX DATA,COST ALLOCATION,APPORTIONMENT OF MEDICAL AND OTHER HEALTH SERVICES,CALCULATION OF REIMBURSEMENT SETTLEMENT (PPS),BALANCE SHEET,HOSPITAL WAGE INDEX DATA,Medicaid Inpatient Days/Outpatient Visits,HHA STATISTICAL DATA,APPORTIONMENT OF INPATIENT/OUTPATIENT ANCILLARY SERVICE OTHER PASS THROUGH COSTS,APPORTIONMENT OF INPATIENT/OUTPATIENT ANCILLARY SERVICE OTHER PASS THROUGH COSTS,APPORTIONMENT OF INPATIENT/OUTPATIENT ANCILLARY SERVICE OTHER PASS THROUGH COSTS,APPORTIONMENT OF INPATIENT/OUTPATIENT ANCILLARY SERVICE OTHER PASS THROUGH COSTS,ANALYSIS OF CHANGES IN NEW CAPITAL BALANCES,INPATIENT ANCILLARY SERVICE COST APPORTIONMENT,INPATIENT ANCILLARY SERVICE COST APPORTIONMENT,TRIAL BALANCE OF EXPENSE ACCOUNTS,ALLOCATION OF NEW CAPITAL COSTS,Total Inpatient Days/Outpatient Visits,TRIAL BALANCE OF EXPENSE ACCOUNTS,APPORTIONMENT OF MEDICAL AND OTHER HEALTH SERVICES,HOSPITAL IDENTIFICATION INFORMATION,CALCULATION OF REIMBURSEMENT SETTLEMENT,,S-10 DATA,COST ALLOCATION,COMPUTATION OF RATIO OF COST TO CHARGES,APPORTIONMENT OF INPATIENT/OUTPATIENT ANCILLARY SERVICE OTHER PASS THROUGH COSTS,RENAL STATISTICAL DATA,APPORTIONMENT OF MEDICAL AND OTHER HEALTH SERVICES,TRIAL BALANCE OF EXPENSE ACCOUNTS,HHA STATISTICAL DATA,APPORTIONMENT OF MEDICAL AND OTHER HEALTH SERVICES,COMPUTATION OF RATIO OF COST TO CHARGES,COMPUTATION OF RATIO OF COST TO CHARGES,APPORTIONMENT OF MEDICAL AND OTHER HEALTH SERVICES,ANALYSIS OF CHANGES IN NEW CAPITAL BALANCES,COST ALLOCATION,Medicaid Inpatient Days/Outpatient Visits,APPORTIONMENT OF INPATIENT/OUTPATIENT ANCILLARY SERVICE OTHER PASS THROUGH COSTS,INPATIENT ANCILLARY SERVICE COST APPORTIONMENT,TRIAL BALANCE OF EXPENSE ACCOUNTS,HHA STATISTICAL DATA,INPATIENT ANCILLARY SERVICE COST APPORTIONMENT,TRIAL BALANCE OF EXPENSE ACCOUNTS,HOSPITAL WAGE INDEX DATA,TRIAL BALANCE OF EXPENSE ACCOUNTS,INPATIENT ANCILLARY SERVICE COST APPORTIONMENT,Medicare Inpatient Days/Outpatient Visits,Total Inpatient Days/Outpatient Visits,APPORTIONMENT OF INPATIENT ROUTINE SERVICE OTHER PASS THROUGH COSTS,APPORTIONMENT OF INPATIENT/OUTPATIENT ANCILLARY SERVICE OTHER PASS THROUGH COSTS,,COMPUTATION OF RATIO OF COST TO CHARGES,COMPUTATION OF RATIO OF COST TO CHARGES,COMPUTATION OF INPATIENT OPERATING COSTS,TRIAL BALANCE OF EXPENSE ACCOUNTS,ALLOCATION OF NEW CAPITAL COSTS,APPORTIONMENT OF INPATIENT/OUTPATIENT ANCILLARY SERVICE OTHER PASS THROUGH COSTS,BALANCE SHEET,HOSPITAL WAGE INDEX DATA,COMPUTATION OF RATIO OF COST TO CHARGES,APPORTIONMENT OF MEDICAL AND OTHER HEALTH SERVICES,APPORTIONMENT OF INPATIENT/OUTPATIENT ANCILLARY SERVICE OTHER PASS THROUGH COSTS,TRIAL BALANCE OF EXPENSE ACCOUNTS,CALCULATION OF REIMBURSEMENT SETTLEMENT (PPS),APPORTIONMENT OF INPATIENT ROUTINE SERVICE CAPITAL COSTS,APPORTIONMENT OF MEDICAL AND OTHER HEALTH SERVICES,APPORTIONMENT OF INPATIENT/OUTPATIENT ANCILLARY SERVICE OTHER PASS THROUGH COSTS,INPATIENT ANCILLARY SERVICE COST APPORTIONMENT,HOSPITAL WAGE INDEX DATA,INPATIENT ANCILLARY SERVICE COST APPORTIONMENT,TRIAL BALANCE OF EXPENSE ACCOUNTS,COST ALLOCATION,HOSPITAL WAGE INDEX DATA,INPATIENT ANCILLARY SERVICE COST APPORTIONMENT,COST ALLOCATION,APPORTIONMENT OF MEDICAL AND OTHER HEALTH SERVICES,INPATIENT ANCILLARY SERVICE COST APPORTIONMENT,COMPUTATION OF RATIO OF COST TO CHARGES,APPORTIONMENT OF INPATIENT/OUTPATIENT ANCILLARY SERVICE OTHER PASS THROUGH COSTS,,INPATIENT ANCILLARY SERVICE COST APPORTIONMENT,HOSPITAL WAGE INDEX DATA,INPATIENT ANCILLARY SERVICE COST APPORTIONMENT,HOSPITAL WAGE INDEX DATA,COMPUTATION OF RATIO OF COST TO CHARGES,TRIAL BALANCE OF EXPENSE ACCOUNTS,APPORTIONMENT OF INPATIENT/OUTPATIENT ANCILLARY SERVICE OTHER PASS THROUGH COSTS,COST ALLOCATION,TRIAL BALANCE OF EXPENSE ACCOUNTS,APPORTIONMENT OF INPATIENT/OUTPATIENT ANCILLARY SERVICE OTHER PASS THROUGH COSTS,APPORTIONMENT OF INPATIENT/OUTPATIENT ANCILLARY SERVICE OTHER PASS THROUGH COSTS,INPATIENT ANCILLARY SERVICE COST APPORTIONMENT,COST ALLOCATION,COMPUTATION OF RATIO OF COST TO CHARGES,COMPUTATION OF RATIO OF COST TO CHARGES,,APPORTIONMENT OF MEDICAL AND OTHER HEALTH SERVICES,ALLOCATION OF NEW CAPITAL COSTS,INPATIENT ANCILLARY SERVICE COST APPORTIONMENT,S-10 DATA,APPORTIONMENT OF INPATIENT/OUTPATIENT ANCILLARY SERVICE OTHER PASS THROUGH COSTS,TRIAL BALANCE OF EXPENSE ACCOUNTS,RENAL STATISTICAL DATA,COST ALLOCATION,INPATIENT ANCILLARY SERVICE COST APPORTIONMENT,,COST ALLOCATION,COST ALLOCATION,INPATIENT ANCILLARY SERVICE COST APPORTIONMENT,APPORTIONMENT OF INPATIENT/OUTPATIENT ANCILLARY SERVICE OTHER PASS THROUGH COSTS,COMPUTATION OF RATIO OF COST TO CHARGES,S-10 DATA,COMPUTATION OF INPATIENT OPERATING COSTS,INPATIENT ANCILLARY SERVICE COST APPORTIONMENT,COST ALLOCATION,APPORTIONMENT OF INPATIENT/OUTPATIENT ANCILLARY SERVICE OTHER PASS THROUGH COSTS,HOSPITAL WAGE INDEX DATA,APPORTIONMENT OF INPATIENT/OUTPATIENT ANCILLARY SERVICE OTHER PASS THROUGH COSTS,,APPORTIONMENT OF INPATIENT/OUTPATIENT ANCILLARY SERVICE OTHER PASS THROUGH COSTS,APPORTIONMENT OF INPATIENT ROUTINE SERVICE OTHER PASS THROUGH COSTS,,INPATIENT ANCILLARY SERVICE COST APPORTIONMENT,HOSPITAL WAGE INDEX DATA,INPATIENT ANCILLARY SERVICE COST APPORTIONMENT,INPATIENT ANCILLARY SERVICE COST APPORTIONMENT,APPORTIONMENT OF INPATIENT/OUTPATIENT ANCILLARY SERVICE OTHER PASS THROUGH COSTS,COST ALLOCATION,COST ALLOCATION,APPORTIONMENT OF INPATIENT/OUTPATIENT ANCILLARY SERVICE OTHER PASS THROUGH COSTS,COMPUTATION OF RATIO OF COST TO CHARGES,Total Inpatient Days/Outpatient Visits,,Total Inpatient Days/Outpatient Visits,Medicare Inpatient Days/Outpatient Visits,COST ALLOCATION,COST ALLOCATION,,COST ALLOCATION,APPORTIONMENT OF MEDICAL AND OTHER HEALTH SERVICES,APPORTIONMENT OF INPATIENT/OUTPATIENT ANCILLARY SERVICE OTHER PASS THROUGH COSTS,APPORTIONMENT OF INPATIENT/OUTPATIENT ANCILLARY SERVICE OTHER PASS THROUGH COSTS,Total Inpatient Days/Outpatient Visits,COMPUTATION OF RATIO OF COST TO CHARGES,COMPUTATION OF RATIO OF COST TO CHARGES,COST ALLOCATION,APPORTIONMENT OF MEDICAL AND OTHER HEALTH SERVICES,S-10 DATA,TRIAL BALANCE OF EXPENSE ACCOUNTS,COMPUTATION OF RATIO OF COST TO CHARGES,COST ALLOCATION,S-10 DATA,Medicare Inpatient Days/Outpatient Visits,ADJUSTMENTS,APPORTIONMENT OF INPATIENT/OUTPATIENT ANCILLARY SERVICE OTHER PASS THROUGH COSTS,Total Inpatient Days/Outpatient Visits,APPORTIONMENT OF INPATIENT/OUTPATIENT ANCILLARY SERVICE OTHER PASS THROUGH COSTS,COMPUTATION OF RATIO OF COST TO CHARGES,APPORTIONMENT OF INPATIENT ROUTINE SERVICE CAPITAL COSTS,,TRIAL BALANCE OF EXPENSE ACCOUNTS,APPORTIONMENT OF INPATIENT/OUTPATIENT ANCILLARY SERVICE OTHER PASS THROUGH COSTS,APPORTIONMENT OF INPATIENT/OUTPATIENT ANCILLARY SERVICE OTHER PASS THROUGH COSTS,INPATIENT ANCILLARY SERVICE COST APPORTIONMENT,INPATIENT ANCILLARY SERVICE COST APPORTIONMENT,APPORTIONMENT OF MEDICAL AND OTHER HEALTH SERVICES,COMPUTATION OF RATIO OF COST TO CHARGES,INPATIENT ANCILLARY SERVICE COST APPORTIONMENT,APPORTIONMENT OF MEDICAL AND OTHER HEALTH SERVICES,HOSPITAL WAGE INDEX DATA,TRIAL BALANCE OF EXPENSE ACCOUNTS,ADJUSTMENTS,ANALYSIS OF CHANGES IN NEW CAPITAL BALANCES,COMPUTATION OF RATIO OF COST TO CHARGES,TRIAL BALANCE OF EXPENSE ACCOUNTS,,APPORTIONMENT OF MEDICAL AND OTHER HEALTH SERVICES,TRIAL BALANCE OF EXPENSE ACCOUNTS,BED DAYS AVAILABLE,APPORTIONMENT OF INPATIENT/OUTPATIENT ANCILLARY SERVICE OTHER PASS THROUGH COSTS,INPATIENT ANCILLARY SERVICE COST APPORTIONMENT,COST ALLOCATION,APPORTIONMENT OF MEDICAL AND OTHER HEALTH SERVICES,COMPUTATION OF RATIO OF COST TO CHARGES,HOSPITAL IDENTIFICATION INFORMATION,APPORTIONMENT OF MEDICAL AND OTHER HEALTH SERVICES,,COST ALLOCATION,TRIAL BALANCE OF EXPENSE ACCOUNTS,COST ALLOCATION,COMPUTATION OF RATIO OF COST TO CHARGES,APPORTIONMENT OF MEDICAL AND OTHER HEALTH SERVICES,APPORTIONMENT OF INPATIENT/OUTPATIENT ANCILLARY SERVICE OTHER PASS THROUGH COSTS,APPORTIONMENT OF INPATIENT/OUTPATIENT ANCILLARY SERVICE OTHER PASS THROUGH COSTS,TRIAL BALANCE OF EXPENSE ACCOUNTS,TRIAL BALANCE OF EXPENSE ACCOUNTS,APPORTIONMENT OF INPATIENT/OUTPATIENT ANCILLARY SERVICE OTHER PASS THROUGH COSTS,BALANCE SHEET,APPORTIONMENT OF INPATIENT/OUTPATIENT ANCILLARY SERVICE OTHER PASS THROUGH COSTS,COMPUTATION OF RATIO OF COST TO CHARGES,APPORTIONMENT OF MEDICAL AND OTHER HEALTH SERVICES,NUMBER OF BEDS,INPATIENT ANCILLARY SERVICE COST APPORTIONMENT,HHA STATISTICAL DATA,TRIAL BALANCE OF EXPENSE ACCOUNTS,ADJUSTMENTS,S-10 DATA,APPORTIONMENT OF INPATIENT/OUTPATIENT ANCILLARY SERVICE OTHER PASS THROUGH COSTS,TRIAL BALANCE OF EXPENSE ACCOUNTS,INPATIENT ANCILLARY SERVICE COST APPORTIONMENT,TRIAL BALANCE OF EXPENSE ACCOUNTS,APPORTIONMENT OF MEDICAL AND OTHER HEALTH SERVICES,INPATIENT ANCILLARY SERVICE COST APPORTIONMENT,COST ALLOCATION,INPATIENT ANCILLARY SERVICE COST APPORTIONMENT,HHA STATISTICAL DATA,APPORTIONMENT OF INPATIENT/OUTPATIENT ANCILLARY SERVICE OTHER PASS THROUGH COSTS,ALLOCATION OF NEW CAPITAL COSTS,COST ALLOCATION,APPORTIONMENT OF INPATIENT/OUTPATIENT ANCILLARY SERVICE OTHER PASS THROUGH COSTS,HOSPITAL WAGE INDEX DATA,COMPUTATION OF INPATIENT OPERATING COSTS,BALANCE SHEET,APPORTIONMENT OF MEDICAL AND OTHER HEALTH SERVICES,CALCULATION OF REIMBURSEMENT SETTLEMENT,APPORTIONMENT OF INPATIENT/OUTPATIENT ANCILLARY SERVICE OTHER PASS THROUGH COSTS,COST ALLOCATION,COST ALLOCATION,COMPUTATION OF RATIO OF COST TO CHARGES,HOSPITAL WAGE INDEX DATA,Medicaid Inpatient Days/Outpatient Visits,TRIAL BALANCE OF EXPENSE ACCOUNTS,INPATIENT ANCILLARY SERVICE COST APPORTIONMENT,COST ALLOCATION,COST ALLOCATION,ALLOCATION OF NEW CAPITAL COSTS,APPORTIONMENT OF MEDICAL AND OTHER HEALTH SERVICES,HHA STATISTICAL DATA,,APPORTIONMENT OF INPATIENT/OUTPATIENT ANCILLARY SERVICE OTHER PASS THROUGH COSTS,RECONCILIATION OF CAPITAL COST CENTERS,COST ALLOCATION,INPATIENT ANCILLARY SERVICE COST APPORTIONMENT,APPORTIONMENT OF INPATIENT/OUTPATIENT ANCILLARY SERVICE OTHER PASS THROUGH COSTS,INPATIENT ANCILLARY SERVICE COST APPORTIONMENT,RENAL STATISTICAL DATA,COST ALLOCATION,INPATIENT ANCILLARY SERVICE COST APPORTIONMENT,COMPUTATION OF RATIO OF COST TO CHARGES,HOSPITAL WAGE INDEX DATA,APPORTIONMENT OF INPATIENT/OUTPATIENT ANCILLARY SERVICE OTHER PASS THROUGH COSTS,APPORTIONMENT OF INPATIENT/OUTPATIENT ANCILLARY SERVICE OTHER PASS THROUGH COSTS,COMPUTATION OF RATIO OF COST TO CHARGES,HOSPITAL WAGE INDEX DATA,Medicaid Inpatient Days/Outpatient Visits,COST ALLOCATION,APPORTIONMENT OF MEDICAL AND OTHER HEALTH SERVICES,APPORTIONMENT OF INPATIENT/OUTPATIENT ANCILLARY SERVICE OTHER PASS THROUGH COSTS,APPORTIONMENT OF INPATIENT/OUTPATIENT ANCILLARY SERVICE OTHER PASS THROUGH COSTS,INPATIENT ANCILLARY SERVICE COST APPORTIONMENT,COMPUTATION OF RATIO OF COST TO CHARGES,COST ALLOCATION,COMPUTATION OF RATIO OF COST TO CHARGES,APPORTIONMENT OF MEDICAL AND OTHER HEALTH SERVICES,APPORTIONMENT OF MEDICAL AND OTHER HEALTH SERVICES,COST ALLOCATION,STATEMENT OF REVENUES AND EXPENSES,APPORTIONMENT OF MEDICAL AND OTHER HEALTH SERVICES,INPATIENT ANCILLARY SERVICE COST APPORTIONMENT,INPATIENT ANCILLARY SERVICE COST APPORTIONMENT,TRIAL BALANCE OF EXPENSE ACCOUNTS,COST ALLOCATION,APPORTIONMENT OF MEDICAL AND OTHER HEALTH SERVICES,COST ALLOCATION,HOSPITAL WAGE INDEX DATA,ALLOCATION OF NEW CAPITAL COSTS,HHA STATISTICAL DATA,INPATIENT ANCILLARY SERVICE COST APPORTIONMENT,HOSPITAL WAGE INDEX DATA,COST ALLOCATION,HOSPITAL WAGE INDEX DATA,NUMBER OF BEDS,ADJUSTMENTS,COST ALLOCATION,HOSPITAL WAGE INDEX DATA,APPORTIONMENT OF INPATIENT/OUTPATIENT ANCILLARY SERVICE OTHER PASS THROUGH COSTS,APPORTIONMENT OF INPATIENT/OUTPATIENT ANCILLARY SERVICE OTHER PASS THROUGH COSTS,TRIAL BALANCE OF EXPENSE ACCOUNTS,HOSPITAL WAGE INDEX DATA,TRIAL BALANCE OF EXPENSE ACCOUNTS,TRIAL BALANCE OF EXPENSE ACCOUNTS,COST ALLOCATION,COMPUTATION OF RATIO OF COST TO CHARGES,APPORTIONMENT OF INPATIENT/OUTPATIENT ANCILLARY SERVICE OTHER PASS THROUGH COSTS,COMPUTATION OF RATIO OF COST TO CHARGES,COST ALLOCATION,TRIAL BALANCE OF EXPENSE ACCOUNTS,BED DAYS AVAILABLE,INPATIENT ANCILLARY SERVICE COST APPORTIONMENT,,COST ALLOCATION,ALLOCATION OF NEW CAPITAL COSTS,HOSPITAL WAGE INDEX DATA,COST ALLOCATION,COST ALLOCATION,TRIAL BALANCE OF EXPENSE ACCOUNTS,APPORTIONMENT OF INPATIENT/OUTPATIENT ANCILLARY SERVICE OTHER PASS THROUGH COSTS,COST ALLOCATION,TRIAL BALANCE OF EXPENSE ACCOUNTS,INPATIENT ANCILLARY SERVICE COST APPORTIONMENT,APPORTIONMENT OF MEDICAL AND OTHER HEALTH SERVICES,TRIAL BALANCE OF EXPENSE ACCOUNTS,APPORTIONMENT OF INPATIENT/OUTPATIENT ANCILLARY SERVICE OTHER PASS THROUGH COSTS,COST ALLOCATION,CALCULATION OF REIMBURSEMENT SETTLEMENT,COST ALLOCATION,Total Inpatient Days/Outpatient Visits,HOSPITAL WAGE INDEX DATA,APPORTIONMENT OF INPATIENT/OUTPATIENT ANCILLARY SERVICE OTHER PASS THROUGH COSTS,APPORTIONMENT OF MEDICAL AND OTHER HEALTH SERVICES,TRIAL BALANCE OF EXPENSE ACCOUNTS,COST ALLOCATION,INPATIENT ANCILLARY SERVICE COST APPORTIONMENT,TRIAL BALANCE OF EXPENSE ACCOUNTS,APPORTIONMENT OF INPATIENT/OUTPATIENT ANCILLARY SERVICE OTHER PASS THROUGH COSTS,APPORTIONMENT OF MEDICAL AND OTHER HEALTH SERVICES,,INPATIENT ANCILLARY SERVICE COST APPORTIONMENT,COMPUTATION OF INPATIENT OPERATING COSTS,RENAL STATISTICAL DATA,APPORTIONMENT OF INPATIENT/OUTPATIENT ANCILLARY SERVICE OTHER PASS THROUGH COSTS,COST ALLOCATION,ALLOCATION OF NEW CAPITAL COSTS,COMPUTATION OF RATIO OF COST TO CHARGES,APPORTIONMENT OF INPATIENT/OUTPATIENT ANCILLARY SERVICE OTHER PASS THROUGH COSTS,INPATIENT ANCILLARY SERVICE COST APPORTIONMENT,COST ALLOCATION,APPORTIONMENT OF MEDICAL AND OTHER HEALTH SERVICES,APPORTIONMENT OF INPATIENT/OUTPATIENT ANCILLARY SERVICE OTHER PASS THROUGH COSTS,APPORTIONMENT OF INPATIENT ROUTINE SERVICE OTHER PASS THROUGH COSTS,TRIAL BALANCE OF EXPENSE ACCOUNTS,TRIAL BALANCE OF EXPENSE ACCOUNTS,TRIAL BALANCE OF EXPENSE ACCOUNTS,,HHA STATISTICAL DATA,HOSPITAL WAGE INDEX DATA,TRIAL BALANCE OF EXPENSE ACCOUNTS,COST ALLOCATION,INPATIENT ANCILLARY SERVICE COST APPORTIONMENT,HOSPITAL WAGE INDEX DATA,APPORTIONMENT OF INPATIENT/OUTPATIENT ANCILLARY SERVICE OTHER PASS THROUGH COSTS,COMPUTATION OF RATIO OF COST TO CHARGES,,COMPUTATION OF RATIO OF COST TO CHARGES,APPORTIONMENT OF INPATIENT/OUTPATIENT ANCILLARY SERVICE OTHER PASS THROUGH COSTS,APPORTIONMENT OF INPATIENT/OUTPATIENT ANCILLARY SERVICE OTHER PASS THROUGH COSTS,TRIAL BALANCE OF EXPENSE ACCOUNTS,STATEMENT OF REVENUES AND EXPENSES,INPATIENT ANCILLARY SERVICE COST APPORTIONMENT,,BED DAYS AVAILABLE,BED DAYS AVAILABLE,TRIAL BALANCE OF EXPENSE ACCOUNTS,Total Inpatient Days/Outpatient Visits,COMPUTATION OF RATIO OF COST TO CHARGES,APPORTIONMENT OF INPATIENT/OUTPATIENT ANCILLARY SERVICE OTHER PASS THROUGH COSTS,APPORTIONMENT OF INPATIENT/OUTPATIENT ANCILLARY SERVICE OTHER PASS THROUGH COSTS,INPATIENT ANCILLARY SERVICE COST APPORTIONMENT,ADJUSTMENTS,COST ALLOCATION,INPATIENT ANCILLARY SERVICE COST APPORTIONMENT,HOSPITAL WAGE INDEX DATA,INPATIENT ANCILLARY SERVICE COST APPORTIONMENT,APPORTIONMENT OF MEDICAL AND OTHER HEALTH SERVICES,COST ALLOCATION,APPORTIONMENT OF INPATIENT/OUTPATIENT ANCILLARY SERVICE OTHER PASS THROUGH COSTS,COST ALLOCATION,APPORTIONMENT OF INPATIENT/OUTPATIENT ANCILLARY SERVICE OTHER PASS THROUGH COSTS,INPATIENT ANCILLARY SERVICE COST APPORTIONMENT,INPATIENT ANCILLARY SERVICE COST APPORTIONMENT,APPORTIONMENT OF MEDICAL AND OTHER HEALTH SERVICES,APPORTIONMENT OF MEDICAL AND OTHER HEALTH SERVICES,Medicare Inpatient Days/Outpatient Visits,APPORTIONMENT OF INPATIENT/OUTPATIENT ANCILLARY SERVICE OTHER PASS THROUGH COSTS,APPORTIONMENT OF MEDICAL AND OTHER HEALTH SERVICES,ADJUSTMENTS,APPORTIONMENT OF INPATIENT/OUTPATIENT ANCILLARY SERVICE OTHER PASS THROUGH COSTS,INPATIENT ANCILLARY SERVICE COST APPORTIONMENT,CALCULATION OF REIMBURSEMENT SETTLEMENT,APPORTIONMENT OF INPATIENT/OUTPATIENT ANCILLARY SERVICE OTHER PASS THROUGH COSTS,S-10 DATA,APPORTIONMENT OF INPATIENT/OUTPATIENT ANCILLARY SERVICE OTHER PASS THROUGH COSTS,BALANCE SHEET,INPATIENT ANCILLARY SERVICE COST APPORTIONMENT,APPORTIONMENT OF INPATIENT/OUTPATIENT ANCILLARY SERVICE OTHER PASS THROUGH COSTS,APPORTIONMENT OF INPATIENT ROUTINE SERVICE OTHER PASS THROUGH COSTS,CALCULATION OF REIMBURSEMENT SETTLEMENT,APPORTIONMENT OF INPATIENT/OUTPATIENT ANCILLARY SERVICE OTHER PASS THROUGH COSTS,ALLOCATION OF NEW CAPITAL COSTS,APPORTIONMENT OF MEDICAL AND OTHER HEALTH SERVICES,COMPUTATION OF INPATIENT OPERATING COSTS,COMPUTATION OF RATIO OF COST TO CHARGES,NUMBER OF BEDS,APPORTIONMENT OF INPATIENT/OUTPATIENT ANCILLARY SERVICE OTHER PASS THROUGH COSTS,APPORTIONMENT OF MEDICAL AND OTHER HEALTH SERVICES,INPATIENT ANCILLARY SERVICE COST APPORTIONMENT,APPORTIONMENT OF INPATIENT/OUTPATIENT ANCILLARY SERVICE OTHER PASS THROUGH COSTS,INPATIENT ANCILLARY SERVICE COST APPORTIONMENT,INPATIENT ANCILLARY SERVICE COST APPORTIONMENT,Medicaid Inpatient Days/Outpatient Visits,COMPUTATION OF INPATIENT OPERATING COSTS,APPORTIONMENT OF INPATIENT/OUTPATIENT ANCILLARY SERVICE OTHER PASS THROUGH COSTS,APPORTIONMENT OF INPATIENT/OUTPATIENT ANCILLARY SERVICE OTHER PASS THROUGH COSTS,APPORTIONMENT OF INPATIENT/OUTPATIENT ANCILLARY SERVICE OTHER PASS THROUGH COSTS,APPORTIONMENT OF INPATIENT/OUTPATIENT ANCILLARY SERVICE OTHER PASS THROUGH COSTS,INPATIENT ANCILLARY SERVICE COST APPORTIONMENT,APPORTIONMENT OF INPATIENT/OUTPATIENT ANCILLARY SERVICE OTHER PASS THROUGH COSTS,APPORTIONMENT OF INPATIENT/OUTPATIENT ANCILLARY SERVICE OTHER PASS THROUGH COSTS,APPORTIONMENT OF INPATIENT/OUTPATIENT ANCILLARY SERVICE OTHER PASS THROUGH COSTS,INPATIENT ANCILLARY SERVICE COST APPORTIONMENT,,HOSPITAL WAGE INDEX DATA,BED DAYS AVAILABLE,INPATIENT ANCILLARY SERVICE COST APPORTIONMENT,INPATIENT ANCILLARY SERVICE COST APPORTIONMENT,COMPUTATION OF INPATIENT OPERATING COSTS,TRIAL BALANCE OF EXPENSE ACCOUNTS,CALCULATION OF REIMBURSEMENT SETTLEMENT,NUMBER OF BEDS,APPORTIONMENT OF MEDICAL AND OTHER HEALTH SERVICES,COMPUTATION OF INPATIENT OPERATING COSTS,INPATIENT ANCILLARY SERVICE COST APPORTIONMENT,APPORTIONMENT OF MEDICAL AND OTHER HEALTH SERVICES,APPORTIONMENT OF INPATIENT/OUTPATIENT ANCILLARY SERVICE OTHER PASS THROUGH COSTS,APPORTIONMENT OF INPATIENT/OUTPATIENT ANCILLARY SERVICE OTHER PASS THROUGH COSTS,COMPUTATION OF INPATIENT OPERATING COSTS,,APPORTIONMENT OF INPATIENT ROUTINE SERVICE OTHER PASS THROUGH COSTS,HOSPITAL WAGE INDEX DATA,APPORTIONMENT OF INPATIENT/OUTPATIENT ANCILLARY SERVICE OTHER PASS THROUGH COSTS,HOSPITAL WAGE INDEX DATA,TRIAL BALANCE OF EXPENSE ACCOUNTS,APPORTIONMENT OF MEDICAL AND OTHER HEALTH SERVICES,TRIAL BALANCE OF EXPENSE ACCOUNTS,INPATIENT ANCILLARY SERVICE COST APPORTIONMENT,APPORTIONMENT OF INPATIENT/OUTPATIENT ANCILLARY SERVICE OTHER PASS THROUGH COSTS,COMPUTATION OF RATIO OF COST TO CHARGES,Total Inpatient Days/Outpatient Visits,COMPUTATION OF RATIO OF COST TO CHARGES,APPORTIONMENT OF INPATIENT/OUTPATIENT ANCILLARY SERVICE OTHER PASS THROUGH COSTS,,,Medicare Inpatient Days/Outpatient Visits,COMPUTATION OF RATIO OF COST TO CHARGES,TRIAL BALANCE OF EXPENSE ACCOUNTS,APPORTIONMENT OF INPATIENT/OUTPATIENT ANCILLARY SERVICE OTHER PASS THROUGH COSTS,INPATIENT ANCILLARY SERVICE COST APPORTIONMENT,INPATIENT ANCILLARY SERVICE COST APPORTIONMENT,TRIAL BALANCE OF EXPENSE ACCOUNTS,COMPUTATION OF RATIO OF COST TO CHARGES,Medicaid Inpatient Days/Outpatient Visits,HOSPITAL WAGE INDEX DATA,APPORTIONMENT OF INPATIENT/OUTPATIENT ANCILLARY SERVICE OTHER PASS THROUGH COSTS,CALCULATION OF REIMBURSEMENT SETTLEMENT,COST ALLOCATION,TRIAL BALANCE OF EXPENSE ACCOUNTS,INPATIENT ANCILLARY SERVICE COST APPORTIONMENT,APPORTIONMENT OF MEDICAL AND OTHER HEALTH SERVICES,COST ALLOCATION,NUMBER OF BEDS,Total Inpatient Days/Outpatient Visits,Total Inpatient Days/Outpatient Visits,HOSPITAL WAGE INDEX DATA,APPORTIONMENT OF INPATIENT/OUTPATIENT ANCILLARY SERVICE OTHER PASS THROUGH COSTS,COMPUTATION OF RATIO OF COST TO CHARGES,,APPORTIONMENT OF INPATIENT/OUTPATIENT ANCILLARY SERVICE OTHER PASS THROUGH COSTS,,APPORTIONMENT OF INPATIENT ROUTINE SERVICE CAPITAL COSTS,COMPUTATION OF RATIO OF COST TO CHARGES,INPATIENT ANCILLARY SERVICE COST APPORTIONMENT,INPATIENT ANCILLARY SERVICE COST APPORTIONMENT,INPATIENT ANCILLARY SERVICE COST APPORTIONMENT,INPATIENT ANCILLARY SERVICE COST APPORTIONMENT,COST ALLOCATION,TRIAL BALANCE OF EXPENSE ACCOUNTS,ANALYSIS OF CHANGES IN NEW CAPITAL BALANCES,COST ALLOCATION,COMPUTATION OF RATIO OF COST TO CHARGES,Medicaid Inpatient Days/Outpatient Visits,COST ALLOCATION,HHA STATISTICAL DATA,ADJUSTMENTS,HOSPITAL WAGE INDEX DATA,INPATIENT ANCILLARY SERVICE COST APPORTIONMENT,TRIAL BALANCE OF EXPENSE ACCOUNTS,APPORTIONMENT OF MEDICAL AND OTHER HEALTH SERVICES,INPATIENT ANCILLARY SERVICE COST APPORTIONMENT,CALCULATION OF REIMBURSEMENT SETTLEMENT,TRIAL BALANCE OF EXPENSE ACCOUNTS,APPORTIONMENT OF MEDICAL AND OTHER HEALTH SERVICES,APPORTIONMENT OF INPATIENT/OUTPATIENT ANCILLARY SERVICE OTHER PASS THROUGH COSTS,NUMBER OF BEDS,NUMBER OF BEDS,ALLOCATION OF NEW CAPITAL COSTS,INPATIENT ANCILLARY SERVICE COST APPORTIONMENT,COST ALLOCATION,APPORTIONMENT OF INPATIENT/OUTPATIENT ANCILLARY SERVICE OTHER PASS THROUGH COSTS,COST ALLOCATION,COMPUTATION OF INPATIENT OPERATING COSTS,TRIAL BALANCE OF EXPENSE ACCOUNTS,,TRIAL BALANCE OF EXPENSE ACCOUNTS,BED DAYS AVAILABLE,BED DAYS AVAILABLE,TRIAL BALANCE OF EXPENSE ACCOUNTS,TRIAL BALANCE OF EXPENSE ACCOUNTS,,INPATIENT ANCILLARY SERVICE COST APPORTIONMENT,APPORTIONMENT OF MEDICAL AND OTHER HEALTH SERVICES,APPORTIONMENT OF MEDICAL AND OTHER HEALTH SERVICES,,COST ALLOCATION,COMPUTATION OF RATIO OF COST TO CHARGES,ANALYSIS OF CHANGES IN NEW CAPITAL BALANCES,INPATIENT ANCILLARY SERVICE COST APPORTIONMENT,COST ALLOCATION,HHA STATISTICAL DATA,TRIAL BALANCE OF EXPENSE ACCOUNTS,BED DAYS AVAILABLE,COMPUTATION OF RATIO OF COST TO CHARGES,COST ALLOCATION,ALLOCATION OF NEW CAPITAL COSTS,COMPUTATION OF RATIO OF COST TO CHARGES,RECONCILIATION OF CAPITAL COST CENTERS,HOSPITAL WAGE INDEX DATA,APPORTIONMENT OF MEDICAL AND OTHER HEALTH SERVICES,HHA STATISTICAL DATA,RECONCILIATION OF CAPITAL COST CENTERS,APPORTIONMENT OF INPATIENT/OUTPATIENT ANCILLARY SERVICE OTHER PASS THROUGH COSTS,COMPUTATION OF INPATIENT OPERATING COSTS,APPORTIONMENT OF INPATIENT/OUTPATIENT ANCILLARY SERVICE OTHER PASS THROUGH COSTS,COST ALLOCATION,,RECONCILIATION OF CAPITAL COST CENTERS,TRIAL BALANCE OF EXPENSE ACCOUNTS,COST ALLOCATION,COST ALLOCATION,COST ALLOCATION,HHA STATISTICAL DATA,COST ALLOCATION,COMPUTATION OF RATIO OF COST TO CHARGES,COST ALLOCATION,INPATIENT ANCILLARY SERVICE COST APPORTIONMENT,COMPUTATION OF INPATIENT OPERATING COSTS,Total Inpatient Days/Outpatient Visits,COMPUTATION OF RATIO OF COST TO CHARGES,NUMBER OF BEDS,HHA STATISTICAL DATA,,STATEMENT OF PATIENT REVENUES AND OPERATING EXPENSES,HOSPITAL WAGE INDEX DATA,COMPUTATION OF INPATIENT OPERATING COSTS,ANALYSIS OF CHANGES IN NEW CAPITAL BALANCES,INPATIENT ANCILLARY SERVICE COST APPORTIONMENT,COST ALLOCATION,RENAL STATISTICAL DATA,TRIAL BALANCE OF EXPENSE ACCOUNTS,APPORTIONMENT OF INPATIENT/OUTPATIENT ANCILLARY SERVICE OTHER PASS THROUGH COSTS,S-10 DATA,TRIAL BALANCE OF EXPENSE ACCOUNTS,COST ALLOCATION,TRIAL BALANCE OF EXPENSE ACCOUNTS,APPORTIONMENT OF MEDICAL AND OTHER HEALTH SERVICES,STATEMENT OF REVENUES AND EXPENSES,Total Inpatient Days/Outpatient Visits,,APPORTIONMENT OF INPATIENT/OUTPATIENT ANCILLARY SERVICE OTHER PASS THROUGH COSTS,TRIAL BALANCE OF EXPENSE ACCOUNTS,COST ALLOCATION,TRIAL BALANCE OF EXPENSE ACCOUNTS,Medicaid Inpatient Days/Outpatient Visits,BED DAYS AVAILABLE,INPATIENT ANCILLARY SERVICE COST APPORTIONMENT,INPATIENT ANCILLARY SERVICE COST APPORTIONMENT,Medicare Inpatient Days/Outpatient Visits,HHA STATISTICAL DATA,APPORTIONMENT OF MEDICAL AND OTHER HEALTH SERVICES,APPORTIONMENT OF INPATIENT/OUTPATIENT ANCILLARY SERVICE OTHER PASS THROUGH COSTS,COMPUTATION OF RATIO OF COST TO CHARGES,INPATIENT ANCILLARY SERVICE COST APPORTIONMENT,RECONCILIATION OF CAPITAL COST CENTERS,HOSPITAL WAGE INDEX DATA,COMPUTATION OF RATIO OF COST TO CHARGES,COST ALLOCATION,ALLOCATION OF NEW CAPITAL COSTS,COMPUTATION OF RATIO OF COST TO CHARGES,COMPUTATION OF RATIO OF COST TO CHARGES,COST ALLOCATION,Total Inpatient Days/Outpatient Visits,TRIAL BALANCE OF EXPENSE ACCOUNTS,HOSPITAL WAGE INDEX DATA,APPORTIONMENT OF MEDICAL AND OTHER HEALTH SERVICES,CALCULATION OF REIMBURSEMENT SETTLEMENT,APPORTIONMENT OF INPATIENT/OUTPATIENT ANCILLARY SERVICE OTHER PASS THROUGH COSTS,BED DAYS AVAILABLE,COMPUTATION OF RATIO OF COST TO CHARGES,HOSPITAL IDENTIFICATION INFORMATION,APPORTIONMENT OF MEDICAL AND OTHER HEALTH SERVICES,APPORTIONMENT OF INPATIENT/OUTPATIENT ANCILLARY SERVICE OTHER PASS THROUGH COSTS,APPORTIONMENT OF INPATIENT/OUTPATIENT ANCILLARY SERVICE OTHER PASS THROUGH COSTS,BALANCE SHEET,APPORTIONMENT OF INPATIENT/OUTPATIENT ANCILLARY SERVICE OTHER PASS THROUGH COSTS,INPATIENT ANCILLARY SERVICE COST APPORTIONMENT,INPATIENT ANCILLARY SERVICE COST APPORTIONMENT,RENAL STATISTICAL DATA,HOSPITAL WAGE INDEX DATA,HHA STATISTICAL DATA,CALCULATION OF REIMBURSEMENT SETTLEMENT,TRIAL BALANCE OF EXPENSE ACCOUNTS,INPATIENT ANCILLARY SERVICE COST APPORTIONMENT,COMPUTATION OF RATIO OF COST TO CHARGES,APPORTIONMENT OF INPATIENT/OUTPATIENT ANCILLARY SERVICE OTHER PASS THROUGH COSTS,INPATIENT ANCILLARY SERVICE COST APPORTIONMENT,APPORTIONMENT OF MEDICAL AND OTHER HEALTH SERVICES,HOSPITAL WAGE INDEX DATA,COST ALLOCATION,APPORTIONMENT OF INPATIENT/OUTPATIENT ANCILLARY SERVICE OTHER PASS THROUGH COSTS,INPATIENT ANCILLARY SERVICE COST APPORTIONMENT,TRIAL BALANCE OF EXPENSE ACCOUNTS,INPATIENT ANCILLARY SERVICE COST APPORTIONMENT,RENAL STATISTICAL DATA,APPORTIONMENT OF MEDICAL AND OTHER HEALTH SERVICES,APPORTIONMENT OF INPATIENT/OUTPATIENT ANCILLARY SERVICE OTHER PASS THROUGH COSTS,RENAL STATISTICAL DATA,COMPUTATION OF RATIO OF COST TO CHARGES,HOSPITAL WAGE INDEX DATA,COMPUTATION OF RATIO OF COST TO CHARGES,,COMPUTATION OF RATIO OF COST TO CHARGES,TRIAL BALANCE OF EXPENSE ACCOUNTS,APPORTIONMENT OF INPATIENT/OUTPATIENT ANCILLARY SERVICE OTHER PASS THROUGH COSTS,APPORTIONMENT OF INPATIENT/OUTPATIENT ANCILLARY SERVICE OTHER PASS THROUGH COSTS,APPORTIONMENT OF MEDICAL AND OTHER HEALTH SERVICES,HOSPITAL WAGE INDEX DATA,APPORTIONMENT OF INPATIENT/OUTPATIENT ANCILLARY SERVICE OTHER PASS THROUGH COSTS,HOSPITAL WAGE INDEX DATA,HOSPITAL WAGE INDEX DATA,BALANCE SHEET,,TRIAL BALANCE OF EXPENSE ACCOUNTS,APPORTIONMENT OF MEDICAL AND OTHER HEALTH SERVICES,COST ALLOCATION,,APPORTIONMENT OF MEDICAL AND OTHER HEALTH SERVICES,APPORTIONMENT OF INPATIENT/OUTPATIENT ANCILLARY SERVICE OTHER PASS THROUGH COSTS,HHA STATISTICAL DATA,ALLOCATION OF NEW CAPITAL COSTS,APPORTIONMENT OF MEDICAL AND OTHER HEALTH SERVICES,APPORTIONMENT OF INPATIENT/OUTPATIENT ANCILLARY SERVICE OTHER PASS THROUGH COSTS,APPORTIONMENT OF INPATIENT/OUTPATIENT ANCILLARY SERVICE OTHER PASS THROUGH COSTS,APPORTIONMENT OF INPATIENT/OUTPATIENT ANCILLARY SERVICE OTHER PASS THROUGH COSTS,ALLOCATION OF NEW CAPITAL COSTS,APPORTIONMENT OF MEDICAL AND OTHER HEALTH SERVICES,TRIAL BALANCE OF EXPENSE ACCOUNTS,COST ALLOCATION,APPORTIONMENT OF INPATIENT/OUTPATIENT ANCILLARY SERVICE OTHER PASS THROUGH COSTS,HOSPITAL WAGE INDEX DATA,APPORTIONMENT OF MEDICAL AND OTHER HEALTH SERVICES,TRIAL BALANCE OF EXPENSE ACCOUNTS,APPORTIONMENT OF MEDICAL AND OTHER HEALTH SERVICES,Total Inpatient Days/Outpatient Visits,Medicaid Inpatient Days/Outpatient Visits,INPATIENT ANCILLARY SERVICE COST APPORTIONMENT,S-10 DATA,TRIAL BALANCE OF EXPENSE ACCOUNTS,COST ALLOCATION,HOSPITAL WAGE INDEX DATA,TRIAL BALANCE OF EXPENSE ACCOUNTS,TRIAL BALANCE OF EXPENSE ACCOUNTS,COST ALLOCATION,COST ALLOCATION,APPORTIONMENT OF INPATIENT/OUTPATIENT ANCILLARY SERVICE OTHER PASS THROUGH COSTS,APPORTIONMENT OF INPATIENT/OUTPATIENT ANCILLARY SERVICE OTHER PASS THROUGH COSTS,INPATIENT ANCILLARY SERVICE COST APPORTIONMENT,BALANCE SHEET,TRIAL BALANCE OF EXPENSE ACCOUNTS,APPORTIONMENT OF INPATIENT/OUTPATIENT ANCILLARY SERVICE OTHER PASS THROUGH COSTS,COST ALLOCATION,COMPUTATION OF RATIO OF COST TO CHARGES,,HOSPITAL WAGE INDEX DATA,TRIAL BALANCE OF EXPENSE ACCOUNTS,APPORTIONMENT OF MEDICAL AND OTHER HEALTH SERVICES,HOSPITAL WAGE INDEX DATA,INPATIENT ANCILLARY SERVICE COST APPORTIONMENT,HOSPITAL WAGE INDEX DATA,HOSPITAL WAGE INDEX DATA,TRIAL BALANCE OF EXPENSE ACCOUNTS,APPORTIONMENT OF MEDICAL AND OTHER HEALTH SERVICES,APPORTIONMENT OF MEDICAL AND OTHER HEALTH SERVICES,ALLOCATION OF NEW CAPITAL COSTS,COMPUTATION OF RATIO OF COST TO CHARGES,APPORTIONMENT OF INPATIENT/OUTPATIENT ANCILLARY SERVICE OTHER PASS THROUGH COSTS,APPORTIONMENT OF INPATIENT/OUTPATIENT ANCILLARY SERVICE OTHER PASS THROUGH COSTS,RENAL STATISTICAL DATA,Total Inpatient Days/Outpatient Visits,,TRIAL BALANCE OF EXPENSE ACCOUNTS,ANALYSIS OF CHANGES IN NEW CAPITAL BALANCES,APPORTIONMENT OF INPATIENT ROUTINE SERVICE CAPITAL COSTS,APPORTIONMENT OF INPATIENT/OUTPATIENT ANCILLARY SERVICE OTHER PASS THROUGH COSTS,HOSPITAL WAGE INDEX DATA,COMPUTATION OF RATIO OF COST TO CHARGES,RECONCILIATION OF CAPITAL COST CENTERS,TRIAL BALANCE OF EXPENSE ACCOUNTS,APPORTIONMENT OF INPATIENT ROUTINE SERVICE CAPITAL COSTS,INPATIENT ANCILLARY SERVICE COST APPORTIONMENT,HHA STATISTICAL DATA,COST ALLOCATION,COST ALLOCATION,APPORTIONMENT OF INPATIENT/OUTPATIENT ANCILLARY SERVICE OTHER PASS THROUGH COSTS,APPORTIONMENT OF MEDICAL AND OTHER HEALTH SERVICES,HHA STATISTICAL DATA,ALLOCATION OF NEW CAPITAL COSTS,RENAL STATISTICAL DATA,COMPUTATION OF RATIO OF COST TO CHARGES,TRIAL BALANCE OF EXPENSE ACCOUNTS,APPORTIONMENT OF MEDICAL AND OTHER HEALTH SERVICES,ALLOCATION OF NEW CAPITAL COSTS,COST ALLOCATION,APPORTIONMENT OF INPATIENT/OUTPATIENT ANCILLARY SERVICE OTHER PASS THROUGH COSTS,BED DAYS AVAILABLE,Medicare Inpatient Days/Outpatient Visits,INPATIENT ANCILLARY SERVICE COST APPORTIONMENT,TRIAL BALANCE OF EXPENSE ACCOUNTS,TRIAL BALANCE OF EXPENSE ACCOUNTS,APPORTIONMENT OF INPATIENT ROUTINE SERVICE CAPITAL COSTS,INPATIENT ANCILLARY SERVICE COST APPORTIONMENT,HOSPITAL WAGE INDEX DATA,APPORTIONMENT OF INPATIENT ROUTINE SERVICE CAPITAL COSTS,INPATIENT ANCILLARY SERVICE COST APPORTIONMENT,TRIAL BALANCE OF EXPENSE ACCOUNTS,APPORTIONMENT OF MEDICAL AND OTHER HEALTH SERVICES,INPATIENT ANCILLARY SERVICE COST APPORTIONMENT,INPATIENT ANCILLARY SERVICE COST APPORTIONMENT,BALANCE SHEET,COST ALLOCATION,TRIAL BALANCE OF EXPENSE ACCOUNTS,INPATIENT ANCILLARY SERVICE COST APPORTIONMENT,HOSPITAL WAGE INDEX DATA,Medicare Inpatient Days/Outpatient Visits,HHA STATISTICAL DATA,APPORTIONMENT OF INPATIENT/OUTPATIENT ANCILLARY SERVICE OTHER PASS THROUGH COSTS,TRIAL BALANCE OF EXPENSE ACCOUNTS,TRIAL BALANCE OF EXPENSE ACCOUNTS,APPORTIONMENT OF INPATIENT/OUTPATIENT ANCILLARY SERVICE OTHER PASS THROUGH COSTS,,ALLOCATION OF NEW CAPITAL COSTS,HHA STATISTICAL DATA,ANALYSIS OF CHANGES IN NEW CAPITAL BALANCES,,INPATIENT ANCILLARY SERVICE COST APPORTIONMENT,CALCULATION OF REIMBURSEMENT SETTLEMENT,APPORTIONMENT OF INPATIENT ROUTINE SERVICE OTHER PASS THROUGH COSTS,COMPUTATION OF RATIO OF COST TO CHARGES,TRIAL BALANCE OF EXPENSE ACCOUNTS,COST ALLOCATION,COMPUTATION OF RATIO OF COST TO CHARGES,APPORTIONMENT OF INPATIENT/OUTPATIENT ANCILLARY SERVICE OTHER PASS THROUGH COSTS,TRIAL BALANCE OF EXPENSE ACCOUNTS,INPATIENT ANCILLARY SERVICE COST APPORTIONMENT,BED DAYS AVAILABLE,COST ALLOCATION,BALANCE SHEET,ADJUSTMENTS,INPATIENT ANCILLARY SERVICE COST APPORTIONMENT,APPORTIONMENT OF MEDICAL AND OTHER HEALTH SERVICES,CALCULATION OF REIMBURSEMENT SETTLEMENT,HOSPITAL WAGE INDEX DATA,HOSPITAL WAGE INDEX DATA,S-10 DATA,ALLOCATION OF NEW CAPITAL COSTS,RECONCILIATION OF CAPITAL COST CENTERS,TRIAL BALANCE OF EXPENSE ACCOUNTS,HOSPITAL WAGE INDEX DATA,APPORTIONMENT OF INPATIENT/OUTPATIENT ANCILLARY SERVICE OTHER PASS THROUGH COSTS,,INPATIENT ANCILLARY SERVICE COST APPORTIONMENT,COMPUTATION OF RATIO OF COST TO CHARGES,INPATIENT ANCILLARY SERVICE COST APPORTIONMENT,COST ALLOCATION,RENAL STATISTICAL DATA,APPORTIONMENT OF MEDICAL AND OTHER HEALTH SERVICES,COST ALLOCATION,COMPUTATION OF RATIO OF COST TO CHARGES,HHA STATISTICAL DATA,APPORTIONMENT OF MEDICAL AND OTHER HEALTH SERVICES,INPATIENT ANCILLARY SERVICE COST APPORTIONMENT,HOSPITAL WAGE INDEX DATA,HHA STATISTICAL DATA,,Medicare Inpatient Days/Outpatient Visits,ADJUSTMENTS,ANALYSIS OF CHANGES IN NEW CAPITAL BALANCES,COST ALLOCATION,INPATIENT ANCILLARY SERVICE COST APPORTIONMENT,APPORTIONMENT OF INPATIENT/OUTPATIENT ANCILLARY SERVICE OTHER PASS THROUGH COSTS,COST ALLOCATION,,S-10 DATA,APPORTIONMENT OF MEDICAL AND OTHER HEALTH SERVICES,INPATIENT ANCILLARY SERVICE COST APPORTIONMENT,COMPUTATION OF RATIO OF COST TO CHARGES,APPORTIONMENT OF INPATIENT/OUTPATIENT ANCILLARY SERVICE OTHER PASS THROUGH COSTS,HHA STATISTICAL DATA,INPATIENT ANCILLARY SERVICE COST APPORTIONMENT,,ANALYSIS OF CHANGES IN NEW CAPITAL BALANCES,TRIAL BALANCE OF EXPENSE ACCOUNTS,TRIAL BALANCE OF EXPENSE ACCOUNTS,COST ALLOCATION,CALCULATION OF REIMBURSEMENT SETTLEMENT,APPORTIONMENT OF INPATIENT/OUTPATIENT ANCILLARY SERVICE OTHER PASS THROUGH COSTS,COMPUTATION OF INPATIENT OPERATING COSTS,APPORTIONMENT OF INPATIENT/OUTPATIENT ANCILLARY SERVICE OTHER PASS THROUGH COSTS,ALLOCATION OF NEW CAPITAL COSTS,TRIAL BALANCE OF EXPENSE ACCOUNTS,COMPUTATION OF RATIO OF COST TO CHARGES,COST ALLOCATION,COMPUTATION OF RATIO OF COST TO CHARGES,APPORTIONMENT OF INPATIENT ROUTINE SERVICE CAPITAL COSTS,INPATIENT ANCILLARY SERVICE COST APPORTIONMENT,COST ALLOCATION,INPATIENT ANCILLARY SERVICE COST APPORTIONMENT,COST ALLOCATION,COMPUTATION OF RATIO OF COST TO CHARGES,APPORTIONMENT OF MEDICAL AND OTHER HEALTH SERVICES,INPATIENT ANCILLARY SERVICE COST APPORTIONMENT,,INPATIENT ANCILLARY SERVICE COST APPORTIONMENT,APPORTIONMENT OF INPATIENT ROUTINE SERVICE CAPITAL COSTS,TRIAL BALANCE OF EXPENSE ACCOUNTS,TRIAL BALANCE OF EXPENSE ACCOUNTS,TRIAL BALANCE OF EXPENSE ACCOUNTS,APPORTIONMENT OF INPATIENT/OUTPATIENT ANCILLARY SERVICE OTHER PASS THROUGH COSTS,APPORTIONMENT OF MEDICAL AND OTHER HEALTH SERVICES,TRIAL BALANCE OF EXPENSE ACCOUNTS,TRIAL BALANCE OF EXPENSE ACCOUNTS,ANALYSIS OF CHANGES IN NEW CAPITAL BALANCES,HOSPITAL WAGE INDEX DATA,INPATIENT ANCILLARY SERVICE COST APPORTIONMENT,COST ALLOCATION,ALLOCATION OF NEW CAPITAL COSTS,COST ALLOCATION,TRIAL BALANCE OF EXPENSE ACCOUNTS,,,ALLOCATION OF NEW CAPITAL COSTS,,BED DAYS AVAILABLE,COST ALLOCATION,APPORTIONMENT OF MEDICAL AND OTHER HEALTH SERVICES,APPORTIONMENT OF INPATIENT/OUTPATIENT ANCILLARY SERVICE OTHER PASS THROUGH COSTS,RENAL STATISTICAL DATA,NUMBER OF BEDS,HOSPITAL WAGE INDEX DATA,,TRIAL BALANCE OF EXPENSE ACCOUNTS,,INPATIENT ANCILLARY SERVICE COST APPORTIONMENT,Total Inpatient Days/Outpatient Visits,COST ALLOCATION,APPORTIONMENT OF MEDICAL AND OTHER HEALTH SERVICES,CALCULATION OF REIMBURSEMENT SETTLEMENT,HOSPITAL IDENTIFICATION INFORMATION,,,APPORTIONMENT OF INPATIENT/OUTPATIENT ANCILLARY SERVICE OTHER PASS THROUGH COSTS,COMPUTATION OF INPATIENT OPERATING COSTS,COMPUTATION OF RATIO OF COST TO CHARGES,,APPORTIONMENT OF INPATIENT/OUTPATIENT ANCILLARY SERVICE OTHER PASS THROUGH COSTS,HOSPITAL WAGE INDEX DATA,COST ALLOCATION,COST ALLOCATION,HHA STATISTICAL DATA,COST ALLOCATION,HOSPITAL WAGE INDEX DATA,APPORTIONMENT OF INPATIENT/OUTPATIENT ANCILLARY SERVICE OTHER PASS THROUGH COSTS,APPORTIONMENT OF INPATIENT/OUTPATIENT ANCILLARY SERVICE OTHER PASS THROUGH COSTS,RENAL STATISTICAL DATA,ANALYSIS OF CHANGES IN NEW CAPITAL BALANCES,COMPUTATION OF RATIO OF COST TO CHARGES,INPATIENT ANCILLARY SERVICE COST APPORTIONMENT,CALCULATION OF REIMBURSEMENT SETTLEMENT,INPATIENT ANCILLARY SERVICE COST APPORTIONMENT,COMPUTATION OF RATIO OF COST TO CHARGES,INPATIENT ANCILLARY SERVICE COST APPORTIONMENT,S-10 DATA,HHA STATISTICAL DATA,APPORTIONMENT OF MEDICAL AND OTHER HEALTH SERVICES,COST ALLOCATION,HOSPITAL WAGE INDEX DATA,HOSPITAL WAGE INDEX DATA,TRIAL BALANCE OF EXPENSE ACCOUNTS,COST ALLOCATION,APPORTIONMENT OF INPATIENT/OUTPATIENT ANCILLARY SERVICE OTHER PASS THROUGH COSTS,HOSPITAL WAGE INDEX DATA,COST ALLOCATION,COMPUTATION OF RATIO OF COST TO CHARGES,APPORTIONMENT OF INPATIENT/OUTPATIENT ANCILLARY SERVICE OTHER PASS THROUGH COSTS,RENAL STATISTICAL DATA,INPATIENT ANCILLARY SERVICE COST APPORTIONMENT,COMPUTATION OF RATIO OF COST TO CHARGES,COMPUTATION OF INPATIENT OPERATING COSTS,APPORTIONMENT OF MEDICAL AND OTHER HEALTH SERVICES,INPATIENT ANCILLARY SERVICE COST APPORTIONMENT,APPORTIONMENT OF MEDICAL AND OTHER HEALTH SERVICES,INPATIENT ANCILLARY SERVICE COST APPORTIONMENT,HOSPITAL WAGE INDEX DATA,COST ALLOCATION,Total Inpatient Days/Outpatient Visits,INPATIENT ANCILLARY SERVICE COST APPORTIONMENT,,ADJUSTMENTS,COMPUTATION OF INPATIENT OPERATING COSTS,HHA STATISTICAL DATA,COST ALLOCATION,APPORTIONMENT OF INPATIENT/OUTPATIENT ANCILLARY SERVICE OTHER PASS THROUGH COSTS,Total Inpatient Days/Outpatient Visits,Medicaid Inpatient Days/Outpatient Visits,INPATIENT ANCILLARY SERVICE COST APPORTIONMENT,TRIAL BALANCE OF EXPENSE ACCOUNTS,TRIAL BALANCE OF EXPENSE ACCOUNTS,COMPUTATION OF RATIO OF COST TO CHARGES,COMPUTATION OF INPATIENT OPERATING COSTS,Total Inpatient Days/Outpatient Visits,HOSPITAL WAGE INDEX DATA,APPORTIONMENT OF INPATIENT/OUTPATIENT ANCILLARY SERVICE OTHER PASS THROUGH COSTS,HOSPITAL WAGE INDEX DATA,HHA STATISTICAL DATA,INPATIENT ANCILLARY SERVICE COST APPORTIONMENT,INPATIENT ANCILLARY SERVICE COST APPORTIONMENT,APPORTIONMENT OF INPATIENT/OUTPATIENT ANCILLARY SERVICE OTHER PASS THROUGH COSTS,APPORTIONMENT OF INPATIENT/OUTPATIENT ANCILLARY SERVICE OTHER PASS THROUGH COSTS,TRIAL BALANCE OF EXPENSE ACCOUNTS,Total Inpatient Days/Outpatient Visits,ALLOCATION OF NEW CAPITAL COSTS,COMPUTATION OF INPATIENT OPERATING COSTS,TRIAL BALANCE OF EXPENSE ACCOUNTS,S-10 DATA,BALANCE SHEET,APPORTIONMENT OF MEDICAL AND OTHER HEALTH SERVICES,HOSPITAL WAGE INDEX DATA,Total Inpatient Days/Outpatient Visits,ALLOCATION OF NEW CAPITAL COSTS,HOSPITAL WAGE INDEX DATA,HHA STATISTICAL DATA,Total Inpatient Days/Outpatient Visits,S-10 DATA,RECONCILIATION OF CAPITAL COST CENTERS,TRIAL BALANCE OF EXPENSE ACCOUNTS,INPATIENT ANCILLARY SERVICE COST APPORTIONMENT,HOSPITAL IDENTIFICATION INFORMATION,TRIAL BALANCE OF EXPENSE ACCOUNTS,COMPUTATION OF RATIO OF COST TO CHARGES,COMPUTATION OF RATIO OF COST TO CHARGES,APPORTIONMENT OF INPATIENT/OUTPATIENT ANCILLARY SERVICE OTHER PASS THROUGH COSTS,S-10 DATA,ALLOCATION OF NEW CAPITAL COSTS,,HOSPITAL WAGE INDEX DATA,APPORTIONMENT OF INPATIENT/OUTPATIENT ANCILLARY SERVICE OTHER PASS THROUGH COSTS,TRIAL BALANCE OF EXPENSE ACCOUNTS,,HOSPITAL WAGE INDEX DATA,COST ALLOCATION,TRIAL BALANCE OF EXPENSE ACCOUNTS,APPORTIONMENT OF INPATIENT ROUTINE SERVICE CAPITAL COSTS,STATEMENT OF REVENUES AND EXPENSES,APPORTIONMENT OF MEDICAL AND OTHER HEALTH SERVICES,,COMPUTATION OF RATIO OF COST TO CHARGES,COST ALLOCATION,APPORTIONMENT OF INPATIENT/OUTPATIENT ANCILLARY SERVICE OTHER PASS THROUGH COSTS,APPORTIONMENT OF INPATIENT/OUTPATIENT ANCILLARY SERVICE OTHER PASS THROUGH COSTS,APPORTIONMENT OF INPATIENT/OUTPATIENT ANCILLARY SERVICE OTHER PASS THROUGH COSTS,,APPORTIONMENT OF INPATIENT/OUTPATIENT ANCILLARY SERVICE OTHER PASS THROUGH COSTS,HOSPITAL WAGE INDEX DATA,INPATIENT ANCILLARY SERVICE COST APPORTIONMENT,HOSPITAL WAGE INDEX DATA,HOSPITAL WAGE INDEX DATA,TRIAL BALANCE OF EXPENSE ACCOUNTS,TRIAL BALANCE OF EXPENSE ACCOUNTS,HOSPITAL WAGE INDEX DATA,HHA STATISTICAL DATA,COST ALLOCATION,Medicaid Inpatient Days/Outpatient Visits,APPORTIONMENT OF INPATIENT/OUTPATIENT ANCILLARY SERVICE OTHER PASS THROUGH COSTS,TRIAL BALANCE OF EXPENSE ACCOUNTS,Total Inpatient Days/Outpatient Visits,COMPUTATION OF INPATIENT OPERATING COSTS,COST ALLOCATION,HHA STATISTICAL DATA,COMPUTATION OF INPATIENT OPERATING COSTS,COST ALLOCATION,COST ALLOCATION,APPORTIONMENT OF MEDICAL AND OTHER HEALTH SERVICES,CALCULATION OF REIMBURSEMENT SETTLEMENT (PPS),Medicaid Inpatient Days/Outpatient Visits,,,APPORTIONMENT OF INPATIENT/OUTPATIENT ANCILLARY SERVICE OTHER PASS THROUGH COSTS,INPATIENT ANCILLARY SERVICE COST APPORTIONMENT,APPORTIONMENT OF INPATIENT/OUTPATIENT ANCILLARY SERVICE OTHER PASS THROUGH COSTS,APPORTIONMENT OF MEDICAL AND OTHER HEALTH SERVICES,COST ALLOCATION,APPORTIONMENT OF MEDICAL AND OTHER HEALTH SERVICES,TRIAL BALANCE OF EXPENSE ACCOUNTS,HOSPITAL WAGE INDEX DATA,COMPUTATION OF RATIO OF COST TO CHARGES,TRIAL BALANCE OF EXPENSE ACCOUNTS,S-10 DATA,HOSPITAL WAGE INDEX DATA,COST ALLOCATION,COST ALLOCATION,INPATIENT ANCILLARY SERVICE COST APPORTIONMENT,APPORTIONMENT OF INPATIENT ROUTINE SERVICE CAPITAL COSTS,ANALYSIS OF CHANGES IN NEW CAPITAL BALANCES,APPORTIONMENT OF MEDICAL AND OTHER HEALTH SERVICES,APPORTIONMENT OF MEDICAL AND OTHER HEALTH SERVICES,Total Inpatient Days/Outpatient Visits,COMPUTATION OF RATIO OF COST TO CHARGES,RECONCILIATION OF CAPITAL COST CENTERS,CALCULATION OF REIMBURSEMENT SETTLEMENT (PPS),ANALYSIS OF CHANGES IN NEW CAPITAL BALANCES,COST ALLOCATION,APPORTIONMENT OF INPATIENT/OUTPATIENT ANCILLARY SERVICE OTHER PASS THROUGH COSTS,RENAL STATISTICAL DATA,ANALYSIS OF CHANGES IN NEW CAPITAL BALANCES,,COST ALLOCATION,ADJUSTMENTS,RENAL STATISTICAL DATA,APPORTIONMENT OF INPATIENT/OUTPATIENT ANCILLARY SERVICE OTHER PASS THROUGH COSTS,TRIAL BALANCE OF EXPENSE ACCOUNTS,INPATIENT ANCILLARY SERVICE COST APPORTIONMENT,COST ALLOCATION,COMPUTATION OF INPATIENT OPERATING COSTS,APPORTIONMENT OF INPATIENT/OUTPATIENT ANCILLARY SERVICE OTHER PASS THROUGH COSTS,COMPUTATION OF RATIO OF COST TO CHARGES,APPORTIONMENT OF INPATIENT/OUTPATIENT ANCILLARY SERVICE OTHER PASS THROUGH COSTS,APPORTIONMENT OF INPATIENT/OUTPATIENT ANCILLARY SERVICE OTHER PASS THROUGH COSTS,TRIAL BALANCE OF EXPENSE ACCOUNTS,APPORTIONMENT OF INPATIENT/OUTPATIENT ANCILLARY SERVICE OTHER PASS THROUGH COSTS,COST ALLOCATION,HHA STATISTICAL DATA,INPATIENT ANCILLARY SERVICE COST APPORTIONMENT,ANALYSIS OF CHANGES IN NEW CAPITAL BALANCES,COMPUTATION OF RATIO OF COST TO CHARGES,INPATIENT ANCILLARY SERVICE COST APPORTIONMENT,APPORTIONMENT OF INPATIENT/OUTPATIENT ANCILLARY SERVICE OTHER PASS THROUGH COSTS,HOSPITAL WAGE INDEX DATA,APPORTIONMENT OF MEDICAL AND OTHER HEALTH SERVICES,ALLOCATION OF NEW CAPITAL COSTS,Medicare Inpatient Days/Outpatient Visits,TRIAL BALANCE OF EXPENSE ACCOUNTS,COST ALLOCATION,COMPUTATION OF INPATIENT OPERATING COSTS,APPORTIONMENT OF INPATIENT/OUTPATIENT ANCILLARY SERVICE OTHER PASS THROUGH COSTS,COMPUTATION OF RATIO OF COST TO CHARGES,APPORTIONMENT OF MEDICAL AND OTHER HEALTH SERVICES,COMPUTATION OF RATIO OF COST TO CHARGES,ALLOCATION OF NEW CAPITAL COSTS,TRIAL BALANCE OF EXPENSE ACCOUNTS,APPORTIONMENT OF INPATIENT/OUTPATIENT ANCILLARY SERVICE OTHER PASS THROUGH COSTS,,APPORTIONMENT OF MEDICAL AND OTHER HEALTH SERVICES,HHA STATISTICAL DATA,COMPUTATION OF RATIO OF COST TO CHARGES,,ALLOCATION OF NEW CAPITAL COSTS,INPATIENT ANCILLARY SERVICE COST APPORTIONMENT,HOSPITAL WAGE INDEX DATA,HHA STATISTICAL DATA,TRIAL BALANCE OF EXPENSE ACCOUNTS,ADJUSTMENTS,INPATIENT ANCILLARY SERVICE COST APPORTIONMENT,COST ALLOCATION,COMPUTATION OF RATIO OF COST TO CHARGES,APPORTIONMENT OF INPATIENT/OUTPATIENT ANCILLARY SERVICE OTHER PASS THROUGH COSTS,BED DAYS AVAILABLE,HOSPITAL WAGE INDEX DATA,APPORTIONMENT OF INPATIENT/OUTPATIENT ANCILLARY SERVICE OTHER PASS THROUGH COSTS,APPORTIONMENT OF MEDICAL AND OTHER HEALTH SERVICES,INPATIENT ANCILLARY SERVICE COST APPORTIONMENT,COST ALLOCATION,Total Inpatient Days/Outpatient Visits,ANALYSIS OF CHANGES IN NEW CAPITAL BALANCES,COMPUTATION OF RATIO OF COST TO CHARGES,TRIAL BALANCE OF EXPENSE ACCOUNTS,APPORTIONMENT OF INPATIENT ROUTINE SERVICE CAPITAL COSTS,APPORTIONMENT OF INPATIENT/OUTPATIENT ANCILLARY SERVICE OTHER PASS THROUGH COSTS,Total Inpatient Days/Outpatient Visits,ANALYSIS OF CHANGES IN NEW CAPITAL BALANCES,APPORTIONMENT OF INPATIENT/OUTPATIENT ANCILLARY SERVICE OTHER PASS THROUGH COSTS,APPORTIONMENT OF INPATIENT/OUTPATIENT ANCILLARY SERVICE OTHER PASS THROUGH COSTS,COST ALLOCATION,ALLOCATION OF NEW CAPITAL COSTS,STATEMENT OF REVENUES AND EXPENSES,,APPORTIONMENT OF INPATIENT ROUTINE SERVICE CAPITAL COSTS,COST ALLOCATION,APPORTIONMENT OF MEDICAL AND OTHER HEALTH SERVICES,HOSPITAL WAGE INDEX DATA,COMPUTATION OF RATIO OF COST TO CHARGES,APPORTIONMENT OF INPATIENT/OUTPATIENT ANCILLARY SERVICE OTHER PASS THROUGH COSTS,BALANCE SHEET,APPORTIONMENT OF MEDICAL AND OTHER HEALTH SERVICES,,APPORTIONMENT OF MEDICAL AND OTHER HEALTH SERVICES,BED DAYS AVAILABLE,NUMBER OF BEDS,ANALYSIS OF CHANGES IN NEW CAPITAL BALANCES,APPORTIONMENT OF INPATIENT/OUTPATIENT ANCILLARY SERVICE OTHER PASS THROUGH COSTS,ALLOCATION OF NEW CAPITAL COSTS,,TRIAL BALANCE OF EXPENSE ACCOUNTS,APPORTIONMENT OF INPATIENT/OUTPATIENT ANCILLARY SERVICE OTHER PASS THROUGH COSTS,APPORTIONMENT OF INPATIENT/OUTPATIENT ANCILLARY SERVICE OTHER PASS THROUGH COSTS,ALLOCATION OF NEW CAPITAL COSTS,COMPUTATION OF RATIO OF COST TO CHARGES,HOSPITAL IDENTIFICATION INFORMATION,HOSPITAL WAGE INDEX DATA,COST ALLOCATION,BALANCE SHEET,APPORTIONMENT OF INPATIENT/OUTPATIENT ANCILLARY SERVICE OTHER PASS THROUGH COSTS,,HHA STATISTICAL DATA,COMPUTATION OF INPATIENT OPERATING COSTS,APPORTIONMENT OF INPATIENT/OUTPATIENT ANCILLARY SERVICE OTHER PASS THROUGH COSTS,COMPUTATION OF RATIO OF COST TO CHARGES,HHA STATISTICAL DATA,COMPUTATION OF INPATIENT OPERATING COSTS,TRIAL BALANCE OF EXPENSE ACCOUNTS,COST ALLOCATION,BALANCE SHEET,HOSPITAL WAGE INDEX DATA,COMPUTATION OF RATIO OF COST TO CHARGES,HHA STATISTICAL DATA,APPORTIONMENT OF MEDICAL AND OTHER HEALTH SERVICES,HOSPITAL WAGE INDEX DATA,,HOSPITAL WAGE INDEX DATA,HOSPITAL WAGE INDEX DATA,APPORTIONMENT OF MEDICAL AND OTHER HEALTH SERVICES,INPATIENT ANCILLARY SERVICE COST APPORTIONMENT,Total Inpatient Days/Outpatient Visits,APPORTIONMENT OF INPATIENT ROUTINE SERVICE CAPITAL COSTS,APPORTIONMENT OF INPATIENT/OUTPATIENT ANCILLARY SERVICE OTHER PASS THROUGH COSTS,APPORTIONMENT OF MEDICAL AND OTHER HEALTH SERVICES,HOSPITAL WAGE INDEX DATA,TRIAL BALANCE OF EXPENSE ACCOUNTS,RENAL STATISTICAL DATA,NUMBER OF BEDS,HHA STATISTICAL DATA,APPORTIONMENT OF INPATIENT/OUTPATIENT ANCILLARY SERVICE OTHER PASS THROUGH COSTS,INPATIENT ANCILLARY SERVICE COST APPORTIONMENT,COST ALLOCATION,S-10 DATA,INPATIENT ANCILLARY SERVICE COST APPORTIONMENT,S-10 DATA,APPORTIONMENT OF INPATIENT/OUTPATIENT ANCILLARY SERVICE OTHER PASS THROUGH COSTS,RECONCILIATION OF CAPITAL COST CENTERS,INPATIENT ANCILLARY SERVICE COST APPORTIONMENT,INPATIENT ANCILLARY SERVICE COST APPORTIONMENT,COST ALLOCATION,APPORTIONMENT OF INPATIENT/OUTPATIENT ANCILLARY SERVICE OTHER PASS THROUGH COSTS,APPORTIONMENT OF MEDICAL AND OTHER HEALTH SERVICES,ALLOCATION OF NEW CAPITAL COSTS,APPORTIONMENT OF MEDICAL AND OTHER HEALTH SERVICES,APPORTIONMENT OF MEDICAL AND OTHER HEALTH SERVICES,APPORTIONMENT OF INPATIENT/OUTPATIENT ANCILLARY SERVICE OTHER PASS THROUGH COSTS,HOSPITAL WAGE INDEX DATA,APPORTIONMENT OF INPATIENT/OUTPATIENT ANCILLARY SERVICE OTHER PASS THROUGH COSTS,Total Inpatient Days/Outpatient Visits,APPORTIONMENT OF MEDICAL AND OTHER HEALTH SERVICES,INPATIENT ANCILLARY SERVICE COST APPORTIONMENT,APPORTIONMENT OF INPATIENT/OUTPATIENT ANCILLARY SERVICE OTHER PASS THROUGH COSTS,RENAL STATISTICAL DATA,APPORTIONMENT OF MEDICAL AND OTHER HEALTH SERVICES,TRIAL BALANCE OF EXPENSE ACCOUNTS,ALLOCATION OF NEW CAPITAL COSTS,APPORTIONMENT OF INPATIENT/OUTPATIENT ANCILLARY SERVICE OTHER PASS THROUGH COSTS,INPATIENT ANCILLARY SERVICE COST APPORTIONMENT,RENAL STATISTICAL DATA,INPATIENT ANCILLARY SERVICE COST APPORTIONMENT,COMPUTATION OF RATIO OF COST TO CHARGES,STATEMENT OF REVENUES AND EXPENSES,ANALYSIS OF CHANGES IN NEW CAPITAL BALANCES,INPATIENT ANCILLARY SERVICE COST APPORTIONMENT,ALLOCATION OF NEW CAPITAL COSTS,BED DAYS AVAILABLE,ALLOCATION OF NEW CAPITAL COSTS,HOSPITAL WAGE INDEX DATA,INPATIENT ANCILLARY SERVICE COST APPORTIONMENT,APPORTIONMENT OF MEDICAL AND OTHER HEALTH SERVICES,APPORTIONMENT OF MEDICAL AND OTHER HEALTH SERVICES,BALANCE SHEET,ADJUSTMENTS,APPORTIONMENT OF MEDICAL AND OTHER HEALTH SERVICES,INPATIENT ANCILLARY SERVICE COST APPORTIONMENT,COMPUTATION OF RATIO OF COST TO CHARGES,TRIAL BALANCE OF EXPENSE ACCOUNTS,APPORTIONMENT OF INPATIENT/OUTPATIENT ANCILLARY SERVICE OTHER PASS THROUGH COSTS,TRIAL BALANCE OF EXPENSE ACCOUNTS,COMPUTATION OF RATIO OF COST TO CHARGES,INPATIENT ANCILLARY SERVICE COST APPORTIONMENT,INPATIENT ANCILLARY SERVICE COST APPORTIONMENT,HHA STATISTICAL DATA,APPORTIONMENT OF MEDICAL AND OTHER HEALTH SERVICES,TRIAL BALANCE OF EXPENSE ACCOUNTS,COST ALLOCATION,COST ALLOCATION,APPORTIONMENT OF MEDICAL AND OTHER HEALTH SERVICES,TRIAL BALANCE OF EXPENSE ACCOUNTS,TRIAL BALANCE OF EXPENSE ACCOUNTS,APPORTIONMENT OF INPATIENT/OUTPATIENT ANCILLARY SERVICE OTHER PASS THROUGH COSTS,HOSPITAL WAGE INDEX DATA,HOSPITAL WAGE INDEX DATA,Total Inpatient Days/Outpatient Visits,APPORTIONMENT OF INPATIENT/OUTPATIENT ANCILLARY SERVICE OTHER PASS THROUGH COSTS,APPORTIONMENT OF INPATIENT/OUTPATIENT ANCILLARY SERVICE OTHER PASS THROUGH COSTS,COST ALLOCATION,COST ALLOCATION,Total Inpatient Days/Outpatient Visits,,INPATIENT ANCILLARY SERVICE COST APPORTIONMENT,INPATIENT ANCILLARY SERVICE COST APPORTIONMENT,TRIAL BALANCE OF EXPENSE ACCOUNTS,COST ALLOCATION,COMPUTATION OF RATIO OF COST TO CHARGES,APPORTIONMENT OF INPATIENT ROUTINE SERVICE CAPITAL COSTS,TRIAL BALANCE OF EXPENSE ACCOUNTS,RENAL STATISTICAL DATA,APPORTIONMENT OF MEDICAL AND OTHER HEALTH SERVICES,ADJUSTMENTS,COMPUTATION OF RATIO OF COST TO CHARGES,COMPUTATION OF RATIO OF COST TO CHARGES,HOSPITAL WAGE INDEX DATA,HOSPITAL WAGE INDEX DATA,BED DAYS AVAILABLE,COST ALLOCATION,COMPUTATION OF RATIO OF COST TO CHARGES,CALCULATION OF REIMBURSEMENT SETTLEMENT,TRIAL BALANCE OF EXPENSE ACCOUNTS,COMPUTATION OF RATIO OF COST TO CHARGES,RENAL STATISTICAL DATA,APPORTIONMENT OF MEDICAL AND OTHER HEALTH SERVICES,RENAL STATISTICAL DATA,COST ALLOCATION,COST ALLOCATION,ADJUSTMENTS,COST ALLOCATION,COST ALLOCATION,INPATIENT ANCILLARY SERVICE COST APPORTIONMENT,COMPUTATION OF RATIO OF COST TO CHARGES,APPORTIONMENT OF MEDICAL AND OTHER HEALTH SERVICES,APPORTIONMENT OF MEDICAL AND OTHER HEALTH SERVICES,Total Inpatient Days/Outpatient Visits,COST ALLOCATION,COST ALLOCATION,HOSPITAL WAGE INDEX DATA,APPORTIONMENT OF INPATIENT/OUTPATIENT ANCILLARY SERVICE OTHER PASS THROUGH COSTS,TRIAL BALANCE OF EXPENSE ACCOUNTS,COMPUTATION OF RATIO OF COST TO CHARGES,APPORTIONMENT OF MEDICAL AND OTHER HEALTH SERVICES,APPORTIONMENT OF MEDICAL AND OTHER HEALTH SERVICES,INPATIENT ANCILLARY SERVICE COST APPORTIONMENT,INPATIENT ANCILLARY SERVICE COST APPORTIONMENT,CALCULATION OF REIMBURSEMENT SETTLEMENT,BALANCE SHEET,COMPUTATION OF RATIO OF COST TO CHARGES,APPORTIONMENT OF INPATIENT/OUTPATIENT ANCILLARY SERVICE OTHER PASS THROUGH COSTS,COMPUTATION OF RATIO OF COST TO CHARGES,,COMPUTATION OF RATIO OF COST TO CHARGES,COST ALLOCATION,COST ALLOCATION,COST ALLOCATION,APPORTIONMENT OF INPATIENT ROUTINE SERVICE OTHER PASS THROUGH COSTS,INPATIENT ANCILLARY SERVICE COST APPORTIONMENT,APPORTIONMENT OF MEDICAL AND OTHER HEALTH SERVICES,COST ALLOCATION,COST ALLOCATION,INPATIENT ANCILLARY SERVICE COST APPORTIONMENT,APPORTIONMENT OF MEDICAL AND OTHER HEALTH SERVICES,Total Inpatient Days/Outpatient Visits,COST ALLOCATION,APPORTIONMENT OF INPATIENT/OUTPATIENT ANCILLARY SERVICE OTHER PASS THROUGH COSTS,HOSPITAL WAGE INDEX DATA,COST ALLOCATION,TRIAL BALANCE OF EXPENSE ACCOUNTS,APPORTIONMENT OF INPATIENT/OUTPATIENT ANCILLARY SERVICE OTHER PASS THROUGH COSTS,INPATIENT ANCILLARY SERVICE COST APPORTIONMENT,,TRIAL BALANCE OF EXPENSE ACCOUNTS,INPATIENT ANCILLARY SERVICE COST APPORTIONMENT,HOSPITAL WAGE INDEX DATA,TRIAL BALANCE OF EXPENSE ACCOUNTS,,APPORTIONMENT OF INPATIENT/OUTPATIENT ANCILLARY SERVICE OTHER PASS THROUGH COSTS,APPORTIONMENT OF INPATIENT/OUTPATIENT ANCILLARY SERVICE OTHER PASS THROUGH COSTS,HOSPITAL WAGE INDEX DATA,APPORTIONMENT OF INPATIENT/OUTPATIENT ANCILLARY SERVICE OTHER PASS THROUGH COSTS,APPORTIONMENT OF INPATIENT/OUTPATIENT ANCILLARY SERVICE OTHER PASS THROUGH COSTS,APPORTIONMENT OF INPATIENT/OUTPATIENT ANCILLARY SERVICE OTHER PASS THROUGH COSTS,ALLOCATION OF NEW CAPITAL COSTS,RENAL STATISTICAL DATA,ALLOCATION OF NEW CAPITAL COSTS,INPATIENT ANCILLARY SERVICE COST APPORTIONMENT,APPORTIONMENT OF INPATIENT/OUTPATIENT ANCILLARY SERVICE OTHER PASS THROUGH COSTS,HOSPITAL WAGE INDEX DATA,,COMPUTATION OF RATIO OF COST TO CHARGES,Total Inpatient Days/Outpatient Visits,COMPUTATION OF RATIO OF COST TO CHARGES,APPORTIONMENT OF INPATIENT/OUTPATIENT ANCILLARY SERVICE OTHER PASS THROUGH COSTS,APPORTIONMENT OF MEDICAL AND OTHER HEALTH SERVICES,HOSPITAL WAGE INDEX DATA,TRIAL BALANCE OF EXPENSE ACCOUNTS,COMPUTATION OF RATIO OF COST TO CHARGES,Total Inpatient Days/Outpatient Visits,APPORTIONMENT OF INPATIENT/OUTPATIENT ANCILLARY SERVICE OTHER PASS THROUGH COSTS,ALLOCATION OF NEW CAPITAL COSTS,COST ALLOCATION,COMPUTATION OF RATIO OF COST TO CHARGES,APPORTIONMENT OF INPATIENT/OUTPATIENT ANCILLARY SERVICE OTHER PASS THROUGH COSTS,COST ALLOCATION,APPORTIONMENT OF INPATIENT/OUTPATIENT ANCILLARY SERVICE OTHER PASS THROUGH COSTS,Total Inpatient Days/Outpatient Visits,COMPUTATION OF RATIO OF COST TO CHARGES,APPORTIONMENT OF INPATIENT/OUTPATIENT ANCILLARY SERVICE OTHER PASS THROUGH COSTS,INPATIENT ANCILLARY SERVICE COST APPORTIONMENT,CALCULATION OF REIMBURSEMENT SETTLEMENT,APPORTIONMENT OF MEDICAL AND OTHER HEALTH SERVICES,TRIAL BALANCE OF EXPENSE ACCOUNTS,HHA STATISTICAL DATA,BALANCE SHEET,COST ALLOCATION,INPATIENT ANCILLARY SERVICE COST APPORTIONMENT,HHA STATISTICAL DATA,APPORTIONMENT OF INPATIENT/OUTPATIENT ANCILLARY SERVICE OTHER PASS THROUGH COSTS,COMPUTATION OF RATIO OF COST TO CHARGES,APPORTIONMENT OF MEDICAL AND OTHER HEALTH SERVICES,INPATIENT ANCILLARY SERVICE COST APPORTIONMENT,HOSPITAL WAGE INDEX DATA,TRIAL BALANCE OF EXPENSE ACCOUNTS,TRIAL BALANCE OF EXPENSE ACCOUNTS,COMPUTATION OF RATIO OF COST TO CHARGES,BALANCE SHEET,CALCULATION OF REIMBURSEMENT SETTLEMENT,CALCULATION OF REIMBURSEMENT SETTLEMENT (PPS),APPORTIONMENT OF MEDICAL AND OTHER HEALTH SERVICES,Total Inpatient Days/Outpatient Visits,HOSPITAL WAGE INDEX DATA,APPORTIONMENT OF INPATIENT/OUTPATIENT ANCILLARY SERVICE OTHER PASS THROUGH COSTS,BED DAYS AVAILABLE,APPORTIONMENT OF INPATIENT/OUTPATIENT ANCILLARY SERVICE OTHER PASS THROUGH COSTS,APPORTIONMENT OF MEDICAL AND OTHER HEALTH SERVICES,COST ALLOCATION,COMPUTATION OF RATIO OF COST TO CHARGES,Total Inpatient Days/Outpatient Visits,APPORTIONMENT OF INPATIENT/OUTPATIENT ANCILLARY SERVICE OTHER PASS THROUGH COSTS,APPORTIONMENT OF INPATIENT/OUTPATIENT ANCILLARY SERVICE OTHER PASS THROUGH COSTS,APPORTIONMENT OF INPATIENT/OUTPATIENT ANCILLARY SERVICE OTHER PASS THROUGH COSTS,NUMBER OF BEDS,TRIAL BALANCE OF EXPENSE ACCOUNTS,APPORTIONMENT OF INPATIENT/OUTPATIENT ANCILLARY SERVICE OTHER PASS THROUGH COSTS,INPATIENT ANCILLARY SERVICE COST APPORTIONMENT,BALANCE SHEET,COST ALLOCATION,INPATIENT ANCILLARY SERVICE COST APPORTIONMENT,TRIAL BALANCE OF EXPENSE ACCOUNTS,COST ALLOCATION,APPORTIONMENT OF MEDICAL AND OTHER HEALTH SERVICES,INPATIENT ANCILLARY SERVICE COST APPORTIONMENT,APPORTIONMENT OF MEDICAL AND OTHER HEALTH SERVICES,COST ALLOCATION,ANALYSIS OF CHANGES IN NEW CAPITAL BALANCES,TRIAL BALANCE OF EXPENSE ACCOUNTS,ADJUSTMENTS,COST ALLOCATION,HOSPITAL WAGE INDEX DATA,APPORTIONMENT OF MEDICAL AND OTHER HEALTH SERVICES,BALANCE SHEET,TRIAL BALANCE OF EXPENSE ACCOUNTS,CALCULATION OF REIMBURSEMENT SETTLEMENT,COMPUTATION OF RATIO OF COST TO CHARGES,CALCULATION OF REIMBURSEMENT SETTLEMENT,APPORTIONMENT OF INPATIENT/OUTPATIENT ANCILLARY SERVICE OTHER PASS THROUGH COSTS,COST ALLOCATION,APPORTIONMENT OF INPATIENT/OUTPATIENT ANCILLARY SERVICE OTHER PASS THROUGH COSTS,COMPUTATION OF RATIO OF COST TO CHARGES,APPORTIONMENT OF INPATIENT/OUTPATIENT ANCILLARY SERVICE OTHER PASS THROUGH COSTS,STATEMENT OF REVENUES AND EXPENSES,TRIAL BALANCE OF EXPENSE ACCOUNTS,,COMPUTATION OF RATIO OF COST TO CHARGES,APPORTIONMENT OF INPATIENT/OUTPATIENT ANCILLARY SERVICE OTHER PASS THROUGH COSTS,INPATIENT ANCILLARY SERVICE COST APPORTIONMENT,ADJUSTMENTS,APPORTIONMENT OF MEDICAL AND OTHER HEALTH SERVICES,COMPUTATION OF RATIO OF COST TO CHARGES,APPORTIONMENT OF MEDICAL AND OTHER HEALTH SERVICES,CALCULATION OF REIMBURSEMENT SETTLEMENT,HHA STATISTICAL DATA,Medicare Inpatient Days/Outpatient Visits,TRIAL BALANCE OF EXPENSE ACCOUNTS,Medicaid Inpatient Days/Outpatient Visits,COST ALLOCATION,COST ALLOCATION,COST ALLOCATION,BED DAYS AVAILABLE,Total Inpatient Days/Outpatient Visits,APPORTIONMENT OF INPATIENT/OUTPATIENT ANCILLARY SERVICE OTHER PASS THROUGH COSTS,INPATIENT ANCILLARY SERVICE COST APPORTIONMENT,COST ALLOCATION,TRIAL BALANCE OF EXPENSE ACCOUNTS,COMPUTATION OF RATIO OF COST TO CHARGES,INPATIENT ANCILLARY SERVICE COST APPORTIONMENT,APPORTIONMENT OF MEDICAL AND OTHER HEALTH SERVICES,HOSPITAL WAGE INDEX DATA,INPATIENT ANCILLARY SERVICE COST APPORTIONMENT,RECONCILIATION OF CAPITAL COST CENTERS,ALLOCATION OF NEW CAPITAL COSTS,COST ALLOCATION,BALANCE SHEET,APPORTIONMENT OF INPATIENT/OUTPATIENT ANCILLARY SERVICE OTHER PASS THROUGH COSTS,INPATIENT ANCILLARY SERVICE COST APPORTIONMENT,APPORTIONMENT OF INPATIENT/OUTPATIENT ANCILLARY SERVICE OTHER PASS THROUGH COSTS,TRIAL BALANCE OF EXPENSE ACCOUNTS,APPORTIONMENT OF INPATIENT/OUTPATIENT ANCILLARY SERVICE OTHER PASS THROUGH COSTS,APPORTIONMENT OF INPATIENT/OUTPATIENT ANCILLARY SERVICE OTHER PASS THROUGH COSTS,COST ALLOCATION,HOSPITAL WAGE INDEX DATA,TRIAL BALANCE OF EXPENSE ACCOUNTS,TRIAL BALANCE OF EXPENSE ACCOUNTS,APPORTIONMENT OF INPATIENT/OUTPATIENT ANCILLARY SERVICE OTHER PASS THROUGH COSTS,APPORTIONMENT OF INPATIENT/OUTPATIENT ANCILLARY SERVICE OTHER PASS THROUGH COSTS,TRIAL BALANCE OF EXPENSE ACCOUNTS,APPORTIONMENT OF MEDICAL AND OTHER HEALTH SERVICES,INPATIENT ANCILLARY SERVICE COST APPORTIONMENT,HOSPITAL WAGE INDEX DATA,INPATIENT ANCILLARY SERVICE COST APPORTIONMENT,INPATIENT ANCILLARY SERVICE COST APPORTIONMENT,INPATIENT ANCILLARY SERVICE COST APPORTIONMENT,BED DAYS AVAILABLE,INPATIENT ANCILLARY SERVICE COST APPORTIONMENT,RENAL STATISTICAL DATA,TRIAL BALANCE OF EXPENSE ACCOUNTS,HOSPITAL WAGE INDEX DATA,APPORTIONMENT OF INPATIENT/OUTPATIENT ANCILLARY SERVICE OTHER PASS THROUGH COSTS,APPORTIONMENT OF INPATIENT/OUTPATIENT ANCILLARY SERVICE OTHER PASS THROUGH COSTS,COST ALLOCATION,TRIAL BALANCE OF EXPENSE ACCOUNTS,BALANCE SHEET,APPORTIONMENT OF INPATIENT/OUTPATIENT ANCILLARY SERVICE OTHER PASS THROUGH COSTS,TRIAL BALANCE OF EXPENSE ACCOUNTS,INPATIENT ANCILLARY SERVICE COST APPORTIONMENT,HOSPITAL WAGE INDEX DATA,APPORTIONMENT OF INPATIENT/OUTPATIENT ANCILLARY SERVICE OTHER PASS THROUGH COSTS,INPATIENT ANCILLARY SERVICE COST APPORTIONMENT,COMPUTATION OF RATIO OF COST TO CHARGES,APPORTIONMENT OF MEDICAL AND OTHER HEALTH SERVICES,APPORTIONMENT OF INPATIENT/OUTPATIENT ANCILLARY SERVICE OTHER PASS THROUGH COSTS,BED DAYS AVAILABLE,TRIAL BALANCE OF EXPENSE ACCOUNTS,HOSPITAL WAGE INDEX DATA,HOSPITAL WAGE INDEX DATA,APPORTIONMENT OF MEDICAL AND OTHER HEALTH SERVICES,APPORTIONMENT OF INPATIENT ROUTINE SERVICE CAPITAL COSTS,APPORTIONMENT OF MEDICAL AND OTHER HEALTH SERVICES,APPORTIONMENT OF INPATIENT/OUTPATIENT ANCILLARY SERVICE OTHER PASS THROUGH COSTS,APPORTIONMENT OF INPATIENT/OUTPATIENT ANCILLARY SERVICE OTHER PASS THROUGH COSTS,APPORTIONMENT OF INPATIENT/OUTPATIENT ANCILLARY SERVICE OTHER PASS THROUGH COSTS,APPORTIONMENT OF MEDICAL AND OTHER HEALTH SERVICES,APPORTIONMENT OF MEDICAL AND OTHER HEALTH SERVICES,TRIAL BALANCE OF EXPENSE ACCOUNTS,COMPUTATION OF RATIO OF COST TO CHARGES,INPATIENT ANCILLARY SERVICE COST APPORTIONMENT,COMPUTATION OF RATIO OF COST TO CHARGES,,COMPUTATION OF RATIO OF COST TO CHARGES,INPATIENT ANCILLARY SERVICE COST APPORTIONMENT,HOSPITAL WAGE INDEX DATA,HOSPITAL WAGE INDEX DATA,COST ALLOCATION,APPORTIONMENT OF MEDICAL AND OTHER HEALTH SERVICES,COMPUTATION OF INPATIENT OPERATING COSTS,APPORTIONMENT OF INPATIENT/OUTPATIENT ANCILLARY SERVICE OTHER PASS THROUGH COSTS,ALLOCATION OF NEW CAPITAL COSTS,ANALYSIS OF CHANGES IN NEW CAPITAL BALANCES,APPORTIONMENT OF INPATIENT ROUTINE SERVICE CAPITAL COSTS,APPORTIONMENT OF INPATIENT/OUTPATIENT ANCILLARY SERVICE OTHER PASS THROUGH COSTS,APPORTIONMENT OF INPATIENT/OUTPATIENT ANCILLARY SERVICE OTHER PASS THROUGH COSTS,TRIAL BALANCE OF EXPENSE ACCOUNTS,HHA STATISTICAL DATA,INPATIENT ANCILLARY SERVICE COST APPORTIONMENT,BALANCE SHEET,APPORTIONMENT OF INPATIENT/OUTPATIENT ANCILLARY SERVICE OTHER PASS THROUGH COSTS,COMPUTATION OF RATIO OF COST TO CHARGES,ALLOCATION OF NEW CAPITAL COSTS,,,APPORTIONMENT OF INPATIENT/OUTPATIENT ANCILLARY SERVICE OTHER PASS THROUGH COSTS,BED DAYS AVAILABLE,COMPUTATION OF RATIO OF COST TO CHARGES,Medicaid Inpatient Days/Outpatient Visits,COMPUTATION OF RATIO OF COST TO CHARGES,HOSPITAL WAGE INDEX DATA,HOSPITAL WAGE INDEX DATA,NUMBER OF BEDS,APPORTIONMENT OF INPATIENT ROUTINE SERVICE OTHER PASS THROUGH COSTS,COST ALLOCATION,COST ALLOCATION,APPORTIONMENT OF MEDICAL AND OTHER HEALTH SERVICES,CALCULATION OF REIMBURSEMENT SETTLEMENT,INPATIENT ANCILLARY SERVICE COST APPORTIONMENT,APPORTIONMENT OF INPATIENT/OUTPATIENT ANCILLARY SERVICE OTHER PASS THROUGH COSTS,TRIAL BALANCE OF EXPENSE ACCOUNTS,TRIAL BALANCE OF EXPENSE ACCOUNTS,TRIAL BALANCE OF EXPENSE ACCOUNTS,HOSPITAL WAGE INDEX DATA,COST ALLOCATION,,APPORTIONMENT OF INPATIENT/OUTPATIENT ANCILLARY SERVICE OTHER PASS THROUGH COSTS,CALCULATION OF REIMBURSEMENT SETTLEMENT,COST ALLOCATION,TRIAL BALANCE OF EXPENSE ACCOUNTS,TRIAL BALANCE OF EXPENSE ACCOUNTS,ADJUSTMENTS,,TRIAL BALANCE OF EXPENSE ACCOUNTS,COST ALLOCATION,APPORTIONMENT OF INPATIENT/OUTPATIENT ANCILLARY SERVICE OTHER PASS THROUGH COSTS,COMPUTATION OF RATIO OF COST TO CHARGES,APPORTIONMENT OF INPATIENT/OUTPATIENT ANCILLARY SERVICE OTHER PASS THROUGH COSTS,,ADJUSTMENTS,APPORTIONMENT OF MEDICAL AND OTHER HEALTH SERVICES,Total Inpatient Days/Outpatient Visits,APPORTIONMENT OF MEDICAL AND OTHER HEALTH SERVICES,ALLOCATION OF NEW CAPITAL COSTS,HOSPITAL WAGE INDEX DATA,TRIAL BALANCE OF EXPENSE ACCOUNTS,COST ALLOCATION,APPORTIONMENT OF INPATIENT/OUTPATIENT ANCILLARY SERVICE OTHER PASS THROUGH COSTS,TRIAL BALANCE OF EXPENSE ACCOUNTS,Total Inpatient Days/Outpatient Visits,RENAL STATISTICAL DATA,TRIAL BALANCE OF EXPENSE ACCOUNTS,CALCULATION OF REIMBURSEMENT SETTLEMENT,COST ALLOCATION,COST ALLOCATION,COST ALLOCATION,COST ALLOCATION,COST ALLOCATION,TRIAL BALANCE OF EXPENSE ACCOUNTS,COMPUTATION OF RATIO OF COST TO CHARGES,,APPORTIONMENT OF INPATIENT/OUTPATIENT ANCILLARY SERVICE OTHER PASS THROUGH COSTS,APPORTIONMENT OF INPATIENT ROUTINE SERVICE CAPITAL COSTS,APPORTIONMENT OF INPATIENT/OUTPATIENT ANCILLARY SERVICE OTHER PASS THROUGH COSTS,APPORTIONMENT OF INPATIENT/OUTPATIENT ANCILLARY SERVICE OTHER PASS THROUGH COSTS,APPORTIONMENT OF INPATIENT/OUTPATIENT ANCILLARY SERVICE OTHER PASS THROUGH COSTS,TRIAL BALANCE OF EXPENSE ACCOUNTS,APPORTIONMENT OF INPATIENT/OUTPATIENT ANCILLARY SERVICE OTHER PASS THROUGH COSTS,TRIAL BALANCE OF EXPENSE ACCOUNTS,COST ALLOCATION,COST ALLOCATION,INPATIENT ANCILLARY SERVICE COST APPORTIONMENT,ADJUSTMENTS,HOSPITAL WAGE INDEX DATA,APPORTIONMENT OF MEDICAL AND OTHER HEALTH SERVICES,TRIAL BALANCE OF EXPENSE ACCOUNTS,TRIAL BALANCE OF EXPENSE ACCOUNTS,INPATIENT ANCILLARY SERVICE COST APPORTIONMENT,APPORTIONMENT OF INPATIENT/OUTPATIENT ANCILLARY SERVICE OTHER PASS THROUGH COSTS,COMPUTATION OF RATIO OF COST TO CHARGES,BALANCE SHEET,ALLOCATION OF NEW CAPITAL COSTS,Total Inpatient Days/Outpatient Visits,INPATIENT ANCILLARY SERVICE COST APPORTIONMENT,APPORTIONMENT OF MEDICAL AND OTHER HEALTH SERVICES,Total Inpatient Days/Outpatient Visits,Medicaid Inpatient Days/Outpatient Visits,COST ALLOCATION,COMPUTATION OF RATIO OF COST TO CHARGES,Medicaid Inpatient Days/Outpatient Visits,APPORTIONMENT OF MEDICAL AND OTHER HEALTH SERVICES,ALLOCATION OF NEW CAPITAL COSTS,RENAL STATISTICAL DATA,ALLOCATION OF NEW CAPITAL COSTS,,COST ALLOCATION,S-10 DATA,Total Inpatient Days/Outpatient Visits,COST ALLOCATION,COMPUTATION OF RATIO OF COST TO CHARGES,INPATIENT ANCILLARY SERVICE COST APPORTIONMENT,HOSPITAL WAGE INDEX DATA,COST ALLOCATION,APPORTIONMENT OF MEDICAL AND OTHER HEALTH SERVICES,COST ALLOCATION,COST ALLOCATION,HHA STATISTICAL DATA,COMPUTATION OF INPATIENT OPERATING COSTS,INPATIENT ANCILLARY SERVICE COST APPORTIONMENT,HOSPITAL WAGE INDEX DATA,HOSPITAL WAGE INDEX DATA,,APPORTIONMENT OF INPATIENT/OUTPATIENT ANCILLARY SERVICE OTHER PASS THROUGH COSTS,APPORTIONMENT OF INPATIENT/OUTPATIENT ANCILLARY SERVICE OTHER PASS THROUGH COSTS,APPORTIONMENT OF INPATIENT/OUTPATIENT ANCILLARY SERVICE OTHER PASS THROUGH COSTS,APPORTIONMENT OF INPATIENT/OUTPATIENT ANCILLARY SERVICE OTHER PASS THROUGH COSTS,COST ALLOCATION,RENAL STATISTICAL DATA,COST ALLOCATION,COST ALLOCATION,APPORTIONMENT OF MEDICAL AND OTHER HEALTH SERVICES,CALCULATION OF REIMBURSEMENT SETTLEMENT,APPORTIONMENT OF INPATIENT/OUTPATIENT ANCILLARY SERVICE OTHER PASS THROUGH COSTS,,APPORTIONMENT OF MEDICAL AND OTHER HEALTH SERVICES,COMPUTATION OF RATIO OF COST TO CHARGES,APPORTIONMENT OF INPATIENT/OUTPATIENT ANCILLARY SERVICE OTHER PASS THROUGH COSTS,RENAL STATISTICAL DATA,APPORTIONMENT OF INPATIENT/OUTPATIENT ANCILLARY SERVICE OTHER PASS THROUGH COSTS,CALCULATION OF REIMBURSEMENT SETTLEMENT,TRIAL BALANCE OF EXPENSE ACCOUNTS,INPATIENT ANCILLARY SERVICE COST APPORTIONMENT,INPATIENT ANCILLARY SERVICE COST APPORTIONMENT,INPATIENT ANCILLARY SERVICE COST APPORTIONMENT,CALCULATION OF REIMBURSEMENT SETTLEMENT,INPATIENT ANCILLARY SERVICE COST APPORTIONMENT,APPORTIONMENT OF MEDICAL AND OTHER HEALTH SERVICES,CALCULATION OF REIMBURSEMENT SETTLEMENT,INPATIENT ANCILLARY SERVICE COST APPORTIONMENT,TRIAL BALANCE OF EXPENSE ACCOUNTS,APPORTIONMENT OF INPATIENT/OUTPATIENT ANCILLARY SERVICE OTHER PASS THROUGH COSTS,RECONCILIATION OF CAPITAL COST CENTERS,INPATIENT ANCILLARY SERVICE COST APPORTIONMENT,COMPUTATION OF RATIO OF COST TO CHARGES,TRIAL BALANCE OF EXPENSE ACCOUNTS,RECONCILIATION OF CAPITAL COST CENTERS,Total Inpatient Days/Outpatient Visits,APPORTIONMENT OF INPATIENT/OUTPATIENT ANCILLARY SERVICE OTHER PASS THROUGH COSTS,BED DAYS AVAILABLE,TRIAL BALANCE OF EXPENSE ACCOUNTS,TRIAL BALANCE OF EXPENSE ACCOUNTS,COST ALLOCATION,COMPUTATION OF INPATIENT OPERATING COSTS,INPATIENT ANCILLARY SERVICE COST APPORTIONMENT,TRIAL BALANCE OF EXPENSE ACCOUNTS,COST ALLOCATION,COST ALLOCATION,Total Inpatient Days/Outpatient Visits,COMPUTATION OF RATIO OF COST TO CHARGES,COST ALLOCATION,ADJUSTMENTS,COST ALLOCATION,APPORTIONMENT OF MEDICAL AND OTHER HEALTH SERVICES,APPORTIONMENT OF INPATIENT/OUTPATIENT ANCILLARY SERVICE OTHER PASS THROUGH COSTS,INPATIENT ANCILLARY SERVICE COST APPORTIONMENT,TRIAL BALANCE OF EXPENSE ACCOUNTS,COMPUTATION OF RATIO OF COST TO CHARGES,COST ALLOCATION,COST ALLOCATION,TRIAL BALANCE OF EXPENSE ACCOUNTS,APPORTIONMENT OF INPATIENT/OUTPATIENT ANCILLARY SERVICE OTHER PASS THROUGH COSTS,COST ALLOCATION,COST ALLOCATION,TRIAL BALANCE OF EXPENSE ACCOUNTS,APPORTIONMENT OF INPATIENT ROUTINE SERVICE OTHER PASS THROUGH COSTS,APPORTIONMENT OF MEDICAL AND OTHER HEALTH SERVICES,COST ALLOCATION,RENAL STATISTICAL DATA,INPATIENT ANCILLARY SERVICE COST APPORTIONMENT,STATEMENT OF PATIENT REVENUES AND OPERATING EXPENSES,INPATIENT ANCILLARY SERVICE COST APPORTIONMENT,HOSPITAL WAGE INDEX DATA,TRIAL BALANCE OF EXPENSE ACCOUNTS,S-10 DATA,APPORTIONMENT OF MEDICAL AND OTHER HEALTH SERVICES,APPORTIONMENT OF INPATIENT/OUTPATIENT ANCILLARY SERVICE OTHER PASS THROUGH COSTS,HHA STATISTICAL DATA,APPORTIONMENT OF INPATIENT/OUTPATIENT ANCILLARY SERVICE OTHER PASS THROUGH COSTS,APPORTIONMENT OF INPATIENT/OUTPATIENT ANCILLARY SERVICE OTHER PASS THROUGH COSTS,,HOSPITAL WAGE INDEX DATA,TRIAL BALANCE OF EXPENSE ACCOUNTS,TRIAL BALANCE OF EXPENSE ACCOUNTS,COST ALLOCATION,ALLOCATION OF NEW CAPITAL COSTS,APPORTIONMENT OF INPATIENT/OUTPATIENT ANCILLARY SERVICE OTHER PASS THROUGH COSTS,,HOSPITAL WAGE INDEX DATA,APPORTIONMENT OF MEDICAL AND OTHER HEALTH SERVICES,APPORTIONMENT OF INPATIENT/OUTPATIENT ANCILLARY SERVICE OTHER PASS THROUGH COSTS,S-10 DATA,COMPUTATION OF RATIO OF COST TO CHARGES,APPORTIONMENT OF INPATIENT ROUTINE SERVICE OTHER PASS THROUGH COSTS,ALLOCATION OF NEW CAPITAL COSTS,INPATIENT ANCILLARY SERVICE COST APPORTIONMENT,Total Inpatient Days/Outpatient Visits,APPORTIONMENT OF MEDICAL AND OTHER HEALTH SERVICES,ALLOCATION OF NEW CAPITAL COSTS,INPATIENT ANCILLARY SERVICE COST APPORTIONMENT,TRIAL BALANCE OF EXPENSE ACCOUNTS,Medicare Inpatient Days/Outpatient Visits,APPORTIONMENT OF INPATIENT/OUTPATIENT ANCILLARY SERVICE OTHER PASS THROUGH COSTS,INPATIENT ANCILLARY SERVICE COST APPORTIONMENT,COST ALLOCATION,COMPUTATION OF RATIO OF COST TO CHARGES,APPORTIONMENT OF MEDICAL AND OTHER HEALTH SERVICES,INPATIENT ANCILLARY SERVICE COST APPORTIONMENT,INPATIENT ANCILLARY SERVICE COST APPORTIONMENT,Medicaid Inpatient Days/Outpatient Visits,COMPUTATION OF RATIO OF COST TO CHARGES,ADJUSTMENTS,ALLOCATION OF NEW CAPITAL COSTS,S-10 DATA,ADJUSTMENTS,COST ALLOCATION,COST ALLOCATION,COMPUTATION OF RATIO OF COST TO CHARGES,BED DAYS AVAILABLE,APPORTIONMENT OF MEDICAL AND OTHER HEALTH SERVICES,COST ALLOCATION,APPORTIONMENT OF INPATIENT/OUTPATIENT ANCILLARY SERVICE OTHER PASS THROUGH COSTS,COMPUTATION OF RATIO OF COST TO CHARGES,INPATIENT ANCILLARY SERVICE COST APPORTIONMENT,BALANCE SHEET,,INPATIENT ANCILLARY SERVICE COST APPORTIONMENT,COMPUTATION OF RATIO OF COST TO CHARGES,APPORTIONMENT OF INPATIENT ROUTINE SERVICE CAPITAL COSTS,Medicaid Inpatient Days/Outpatient Visits,COST ALLOCATION,BALANCE SHEET,INPATIENT ANCILLARY SERVICE COST APPORTIONMENT,TRIAL BALANCE OF EXPENSE ACCOUNTS,INPATIENT ANCILLARY SERVICE COST APPORTIONMENT,APPORTIONMENT OF INPATIENT/OUTPATIENT ANCILLARY SERVICE OTHER PASS THROUGH COSTS,HOSPITAL WAGE INDEX DATA,APPORTIONMENT OF INPATIENT/OUTPATIENT ANCILLARY SERVICE OTHER PASS THROUGH COSTS,APPORTIONMENT OF INPATIENT/OUTPATIENT ANCILLARY SERVICE OTHER PASS THROUGH COSTS,HOSPITAL WAGE INDEX DATA,APPORTIONMENT OF INPATIENT/OUTPATIENT ANCILLARY SERVICE OTHER PASS THROUGH COSTS,COST ALLOCATION,COST ALLOCATION,FFY,Hospital Type (From CMS Hospitals Data Archive),Name and Num
,Curated Name and Num,Hospital type (modified),Type of Control of Hospital (See Table I) (S2_1_C1_21),Lon,Lat,Emergency (D_4_HOS_C1_91),Total Subprovider II Interns & Residents (S3_1_C10_1801),"Allocation of Interns & Residents Salary and Fringes, Interns & Res Salary and Fringe Benefits (B_1_C21_21)",SNF (A_C6_44),Total Allied Health (D_4_IPF_C3_200),"AVERAGE HOURLY WAGE, Laundry and Linen Service (S3_2_C6_31)",ICF (S3_1_C2_2001),Drugs Charged to Patients (D3_HOS_C3_73),Occupational Therapy (D_4_HOS_C11_67),Electroencephalography (D3_IPF_C3_70),ESRD DME costs (E_B_HOS_C1_29),"Net Expense for Cost Allocation, Subprovider II (B_1_C0_4201)",Organ Procurement (D4_ISLET_C1_69),"Total Outpatient Charges, Operating Room (C_1_C7_50)","PPS REIMBURSED SERVICES -  CHARGES, Physical Therapy (D_5_HOS_C2_66)","Net Expense for Cost Allocation, RHC (B_1_C0_88)",Observation Beds (Distinct Unit) (A_C1_9201),RHC 4 Provider Number (S2_1_C2_1503),"PPS REIMBURSED SERVICES -  CHARGES, Total (D_5_HOS_C2_200)",Housekeeping (A_C2_9),Subprovider II (C_1_C5_4201),"AVERAGE HOURLY WAGE, Other General Service (S3_2_C6_43)","Is this a teaching hospital or
affiliated with a teaching hospital? (Y/N) (S2_1_C1_56)",Home Program Dialysis (D3_IPF_C3_94),Total (C_1_C5_202),"ADJUSTED SALARIES, Cafeteria (S3_2_C4_36)",Liver Acquisition (C_1_C6_107),Respiratory Therapy (D_4_HOS_C13_65),TOTAL (D3_IRF_C3_200),"COST REIMBURSED SERVICES SUBJECT TO DEDUCTIBLES  AND COINSURANCE - CHARGES, Blood Storing, Processing, Trans (D_5_HOS_C3_63)",Minor Equipment Depreciable (G_C1THRU4_25),OLTC (C_1_C5_46),ICF (C_1_C5_4501),Total Program Inpatient Costs (D1_IPF_C1_49),"Net Expense for Cost Allocation, Blood Clotting Factors for Hemoph. (B_1_C0_6250)",Home Program Dialysis (A_C2_94),"COST SERVICES SUBJECT TO DEDUCTIBLES AND COINSURANCE - COST, Renal Dialysis (D_5_HOS_C6_74)",Net Revenue from stand-alone SCHIP (S10_C1_9),Recovery Room (D_4_HOS_C2_51),Whole Blood & Packed Red Blood Cells (D3_SNF_C3_62),Physical Therapy (D_4_HOS_C10_66),Other Special Purpose (A_C2_117),Nursery (C_1_C5_43),Premiums (S2_1_C1_11801),OLTC (S3_1_C2_21),"HHA I, PEP:  Total Non Routine Med Supply Chgs (S4_HHA1_C4_38)",Operating Room (D_4_IRF_C13_50),Electroencephalography (B_1_C26_70),Respiratory Therapy (D_4_IRF_C13_65),HHA (A_C2_101),Impl. Dev. Charged to Patients (D3_IPF_C3_72),OLTC (A_C1_46),"ADJUSTED SALARIES, Wage Related Costs Other (S3_2_C4_18)",Respiratory Therapy (A_C6_65),Radiology-Diagnostic (D_4_IRF_C13_54),"Allocation of Interns & Residents Program Costs, Cardiac Catheterization (B_1_C22_59)","TOTAL CAPITAL COSTS AFTER COST ALLOCATION, Subprovider II (B_2_C26_4201)",Respiratory Therapy (C_1_C7_65),"COST REIMBURSED SERVICES SUBJECT TO DEDUCTIBLES  AND COINSURANCE - CHARGES, Speech Pathology (D_5_HOS_C3_68)",CT Scan (D_4_IRF_C11_57),Average times dialyzers re-used (S5_C1_9),"COST REIMBURSED SERVICES NOT SUBJECT TO DEDUCTIBLES AND COINSURANCE - CHARGES, Laboratory (D_5_HOS_C4_60)",Labor and Delivery Days Title 18 (S3_1_C6_32),Total (B_2_C26_202),Subprovider-IPF (D_1_HOS_C7_40),"AVERAGE HOURLY WAGE, Employee Benefits (S3_2_C6_26)",Vending Machines (A8_C2_20),"Net Expense for Cost Allocation, Operating Room (B_1_C0_50)",Clinic (D_4_IRF_C11_90),Interns & Res Salary and Fringe Benefits (A_C6_21),Durable Medical Equipment Sold (A_C6_97),"AMOUNT REPORTED, Interns & Residents (S3_2_C2_2550)","Blood Storing, Processing, Trans (C_1_C5_63)",RPCH/CAH Visits (S3_1_C7_15),Total discharges (S3_1_C15_21),Other Reimbursable (C_1_C6_98),Emergency (D_4_IRF_C13_91),Cost of physicians svcs in a teaching hospita (E_B_HOS_C1_23),Int & Res (non approved teaching program (C_1_C6_100),"COST SERVICES SUBJECT TO DEDUCTIBLES AND COINSURANCE - COST, Physical Therapy (D_5_HOS_C6_66)",CT Scan (D3_IPF_C3_57),"COST REIMBURSED SERVICES SUBJECT TO DEDUCTIBLES  AND COINSURANCE - CHARGES, Emergency (D_5_HOS_C3_91)","Total Inpatient Charges, NF (C_1_C6_45)","PAID HOURS RELATED TO SALARIES, Total Overhead Costs (S3_3_C5_7)","Purchases, Total (A7_1_C2_10)","COST SERVICES SUBJECT TO DEDUCTIBLES AND COINSURANCE - COST, Radioisotope (D_5_HOS_C6_56)",Emergency (D3_IRF_C2_91),Home Program Dialysis (D_4_HOS_C11_94),"HHA III, Without Outliers:  Total Visits (S4_HHA3_C1_33)","COST REIMBURSED SERVICES SUBJECT TO DEDUCTIBLES  AND COINSURANCE - CHARGES, Clinic (D_5_HOS_C3_90)",OSP (A_C6_9940),Coronary Care Unit (S3_1_C4_9),Sale of medical and surgical supplies to (A8_C2_16),"PAID HOURS RELATED TO SALARIES, Nursing Administration (S3_2_C5_38)",Other Organ Acquisition (B_1_C22_112),Emergency (D_4_HOS_C3_91),"PAID HOURS RELATED TO SALARIES, Non-Physician Anesthetist Part B (S3_2_C5_3)","Net Expense for Cost Allocation, Drugs Charged to Patients (B_1_C0_73)","Medicare certified kidney 
transplant center cert date (S2_1_C1_126)","Blood Storing, Processing, Trans (D3_HOS_C2_63)","ADJUSTED SALARIES, Home Office Salaries (S3_2_C4_1401)",Whole Blood & Packed Red Blood Cells (A_C6_62),Subprovider-IRF (A_C2_41),Intensive Care Unit (D3_SNF_C2_31),"AMOUNT REPORTED, Social Service (S3_2_C2_42)","AMOUNT REPORTED, Management and Administrative Services (S3_2_C2_12)",Int & Res (non approved teaching program (A_C2_100),Cardiac Catheterization (D_4_IRF_C11_59),Program Inpatient Ancillary Service Cost (D1_IPF_C1_48),Subprovider-IPF (A_C1_40),"ADJUSTED SALARIES, Laundry and Linen Service (S3_2_C4_31)",Anesthesiology (D3_SNF_C2_53),FQHC 1 Provider Number (S2_1_C2_16),"ADJUSTED SALARIES, Home Office:  Physician Part A (S3_2_C4_15)",Social Service (A_C6_17),Occupational Therapy (D3_HOS_C2_67),OLTC (S3_1_C9_21),Nonphysician Anesthetists (A_C1_19),MDH status ending date (MM/DD/YY) (S2_1_C2_3801),"AMOUNT REPORTED, Total (S3_3_C2_6)","COST REIMBURSED SERVICES SUBJECT TO DEDUCTIBLES  AND COINSURANCE - CHARGES, CT Scan (D_5_HOS_C3_57)",Intravenous Therapy (D3_IRF_C2_64),ASC (Non Distinct Part) (D_4_IPF_C13_75),Subprovider I (A_C1_42),Subtotal (E_B_HOS_C1_37),"Net Expense for Cost Allocation, Other Outpatient Services (B_1_C0_93)","Allocation of Interns & Residents Salary and Fringes, CT Scan (B_1_C21_57)",Nonpaid Workers (B_2_C26_193),"Net Expense for Cost Allocation, Lung  Acquisition (B_1_C0_108)",Recovery Room (D_4_IPF_C11_51),Total (D_4_HOS_C11_200),Other Ancillary (B_1_C22_76),Drugs Charged to Patients (C_1_C6_73),Delivery Room and Labor Room (D_4_HOS_C2_52),"COST REIMBURSED SERVICES NOT SUBJECT TO DEDUCTIBLES AND COINSURANCE - CHARGES, Electrocardiology (D_5_HOS_C4_69)",Clinic (D_4_IRF_C13_90),"COST SERVICES NOT SUBJECT TO DEDUCTIBLES AND COINSURANCE - COST, Home Program Dialysis (D_5_HOS_C7_94)",Occupational Therapy (D3_IRF_C3_67),"Net Expense for Cost Allocation, OOT (B_1_C0_9930)","HHA III, With Outliers:  Total Charges (S4_HHA3_C2_35)",Heart Acquisition (A_C6_106),OPT (A_C1_9920),"Medical certified liver 
transplant center cert date (S2_1_C1_128)","PPS REIMBURSED SERVICES -  CHARGES, Respiratory Therapy (D_5_HOS_C2_65)",Clinic (D_4_HOS_C12_90),HHA (S3_1_C6_22),"AMOUNT REPORTED, Excluded Area Salaries (S3_2_C2_10)",Home Program Dialysis (B_1_C21_94),"COST SERVICES NOT SUBJECT TO DEDUCTIBLES AND COINSURANCE - COST, Durable Medical Equipment Rented (D_5_HOS_C7_96)","Net Expense for Cost Allocation, Total (B_1_C0_200)",Organ acquisition (E_B_HOS_C1_10),Hospice 1 Provider Number (S2_1_C2_14),Total Program Excludable Costs (D1_IRF_C1_52),OLTC (A_C2_46),SNF (D_3_HOS_C9_44),"Net Expense for Cost Allocation, Employee Benefits (B_1_C0_4)",Title XVIII discharges (S3_1_C13_17),"AMOUNT REPORTED, Home Office Salaries (S3_2_C3_1401)",Intravenous Therapy (D3_IPF_C3_64),"HHA I, With Outliers:  Non Routine Med Sup Chgs (S4_HHA1_C2_38)",Renal Dialysis (D_4_IPF_C13_74),"PPS REIMBURSED SERVICES -  CHARGES, Emergency (D_5_HOS_C2_91)",Outpatient Rehab Provider (S3_1_C11_25),Radioisotope (A_C1_56),Other Reimbursable (A_C6_98),Impl. Dev. Charged to Patients (D_4_HOS_C13_72),Other Organ Acquisition (A_C6_112),Impl. Dev. Charged to Patients (D_4_SNF_C11_72),PBP Clinical Lab Services Program Only (A_C6_61),"COST REIMBURSED SERVICES NOT SUBJECT TO DEDUCTIBLES AND COINSURANCE - CHARGES, Durable Medical Equipment Rented (D_5_HOS_C4_96)",Laboratory (D3_IPF_C3_60),Pancreas Acquisition (A_C2_109),Islet Acquisition (C_1_C5_111),"Allocation of Interns & Residents Program Costs, Blood Storing, Processing, Trans (B_1_C22_63)",Radioisotope (D_4_IRF_C11_56),Whole Blood & Packed Red Blood Cells (D_4_HOS_C2_62),Nursery (S3_1_C7_13),"AMOUNT REPORTED, Operation of Plant (S3_2_C2_30)",Other Special Purpose (B_2_C26_117),"HHA I, Without Outliers:  Total Charges (S4_HHA1_C1_35)",Other Ancillary (D3_HOS_C2_76),Clinic (D3_IPF_C2_90),"AMOUNT REPORTED, Interns & Residents (S3_2_C3_2550)",Laboratory (D3_IPF_C2_60),NF (S3_1_C10_20),Heart Acquisition (B_1_C26_106),Drugs Charged to Patients (D_4_SNF_C13_73),"General Inpatient Routine Service Cost, net of Swing Bed and Private Room Diff (D1_HOS_C1_37)",FQHC (A_C2_89),Islet Acquisition (B_1_C22_111),Other Ancillary (C_1_C7_76),Cardiac Catheterization (A_C2_59),Observation Beds (Distinct Unit) (B_1_C21_9201),"AMOUNT REPORTED, Wage Related Costs Core (S3_2_C2_17)",Respiratory Therapy (D_4_HOS_C2_65),Social Service (A_C1_17),Radiology-Therapeutic (D_4_HOS_C11_55),Radiology-Therapeutic (D_4_IPF_C13_55),Recovery Room (D3_SNF_C3_51),"Allocation of Interns & Residents Program Costs, OLTC (B_1_C22_46)",MRI (D3_IRF_C2_58),"PPS REIMBURSED SERVICES -  CHARGES, Durable Medical Equipment Rented (D_5_HOS_C2_96)",Drugs Charged to Patients (C_1_C5_73),"AMOUNT REPORTED, Home Office:  Physician Part A (S3_2_C2_15)",Renal 2 Provider Number (S2_1_C2_1801),State or local govt (not Medicaid or CHIP) -- Costs minus net revenue (0 min) (S10_C1_16),CMHC (A_C1_99),Subprovider-IPF (C_1_C5_40),Intravenous Therapy (D_4_HOS_C12_64),Speech Pathology (A_C1_68),Electrocardiology (D_4_IPF_C13_69),TOTAL (D3_IPF_C3_200),"PAID HOURS RELATED TO SALARIES, Central Services and Supply (S3_2_C5_39)",Renal 9 Provider Number (S2_1_C2_1808),"PAID HOURS RELATED TO SALARIES, Non-Physician Anesthetist Part A (S3_2_C5_2)",Emergency (C_1_C7_91),Other Reimbursable (D_4_HOS_C10_98),"Depreciation, Total (A7_3_C9_3)",Hospital City (S2_1_C1_2),PBP Clinical Lab Services Program Only (D3_IRF_C2_61),Total (C_1_C6_202),Is this hospital an All-Inclusive rate provider? (Y/N) (S2_1_C1_115),"Total Inpatient Charges, Subprovider II (C_1_C6_4201)",Electrocardiology (C_1_C6_69),Other Special Care (S3_1_C2_12),"Net Expense for Cost Allocation, OSP (B_1_C0_9940)",Adults and Pediatrics (A_C6_30),Liver Acquisition (A_C6_107),MRI (D_4_HOS_C12_58),Allowable bad debts for dual eligibles beneficiaries (E_B_HOS_C1_36),"PAID HOURS RELATED TO SALARIES, Total Salaries (S3_2_C5_1)","Allocation of Interns & Residents Salary and Fringes, Laboratory (B_1_C21_60)",Clinic (D_4_HOS_C2_90),Radiology-Diagnostic (D3_IRF_C2_54),CT Scan (A_C6_57),"HHA I, PEP Episodes:  Total Visits (S4_HHA1_C4_33)",Ambulance Services (A_C2_95),Burn Intensive Care Unit (D_1_HOS_C7_33),Physical Therapy (D_4_HOS_C4_66),Census Division Code (CENSUS),"Net Expense for Cost Allocation, Pharmacy (B_1_C0_15)",Other Nonreimbursable (B_2_C26_194),Coronary Care Unit (S3_1_C5_9),"Disposals and Retirements, Subtotal (A7_1_C5_8)",Drugs Charged to Patients (A_C1_73),Cost To Charge Ratio (S10_C1_1),Delivery Room and Labor Room (D_4_HOS_C4_52),Subprovider-IPF (D_3_HOS_C9_40),Recovery Room (D3_IRF_C3_51),Electrocardiology (D3_SNF_C2_69),Other Outpatient Services (B_1_C26_93),Cardiac Catheterization (D3_IRF_C3_59),Clinic (A_C2_90),"COST SERVICES NOT SUBJECT TO DEDUCTIBLES AND COINSURANCE - COST, Drugs Charged to Patients (D_5_HOS_C7_73)",FQHC 2 Provider Number (S2_1_C2_1601),"HHA II, With Outliers:  Total Charges (S4_HHA2_C2_35)","Allocation of Interns & Residents Program Costs, Adults and Pediatrics (B_1_C22_30)",Fiscal Intermediary Number (FI_NUM),NF (S3_1_C8_20),FQHC (D_4_HOS_C4_89),Radiology-Diagnostic (D3_SNF_C2_54),"AMOUNT REPORTED, SNF (S3_2_C2_9)","HHA I, Total Non Routine Medical  Supply Charges (S4_HHA1_C5_38)",Durable Medical Equipment Rented (D_4_HOS_C10_96),Coronary Intensive Care Unit (D_1_HOS_C7_32),Drugs Charged to Patients (D_4_HOS_C12_73),"Net Expense for Cost Allocation, Radioisotope (B_1_C0_56)",Coronary Care Unit (S3_1_C2_9),"PAID HOURS RELATED TO SALARIES, Physician-Part B (S3_2_C5_5)",FQHC (B_2_C26_89),Intravenous Therapy (D_4_IPF_C13_64),OSP (B_2_C26_9940),Observation Beds (Distinct Unit) (D3_IRF_C3_9201),CT Scan (D3_HOS_C3_57),"Allocation of Interns & Residents Salary and Fringes, Delivery Room and Labor Room (B_1_C21_52)","ADJUSTED SALARIES, Non-Physician Anesthetist Part B (S3_2_C4_21)","PPS REIMBURSED SERVICES -  CHARGES, Radiology-Diagnostic (D_5_HOS_C2_54)",Speech Pathology (D_4_HOS_C11_68),RHC 24 Provider Number (S2_1_C2_1523),Less: Allowances for uncollectible notes and accounts receivable (G_C1THRU4_6),"COST REIMBURSED SERVICES SUBJECT TO DEDUCTIBLES  AND COINSURANCE - CHARGES, Radiology-Diagnostic (D_5_HOS_C3_54)",Renal 7 Provider Number (S2_1_C2_1806),Operating Room (D3_IPF_C2_50),"Net Expense for Cost Allocation, FQHC (B_1_C0_89)",Deductibles and coinsurance related to line 24 (E_B_HOS_C1_26),"Beginning Balances, Total (A7_1_C1_10)",Observation Beds (Distinct Unit) (C_1_C6_9201),Subtotal (C_1_C5_200),Renal Dialysis (C_1_C6_74),Utilization (S5_C2_8),Fiscal Year Begin Date (FY_BGN_DT),HHA (C_1_C6_101),Total Nursing School (D_4_IPF_C2_200),Drugs Charged to Patients (A_C2_73),"AMOUNT REPORTED, Home Office Salaries & Wage Related Csts (S3_2_C3_14)","HHA II, LUPA Episodes:  Total Number of Episodes (S4_HHA2_C3_36)",HHA 1 Provider Number (S2_1_C2_12),"TOTAL CAPITAL COSTS AFTER COST ALLOCATION, MRI (B_2_C26_58)",Electroencephalography (D3_HOS_C2_70),"HHA II, Without Outliers:  Total Charges (S4_HHA2_C1_35)","Blood Storing, Processing, Trans (D_4_HOS_C13_63)",Clinic (D3_SNF_C2_90),Cafeteria (A_C2_11),CORF (C_1_C6_9910),"Allocation of Interns & Residents Program Costs, Physical Therapy (B_1_C22_66)",Radioisotope (D3_SNF_C2_56),Durable Medical Equipment Rented (C_1_C7_96),Recovery Room (D3_IPF_C3_51),CAPD exchanges per day (S5_C4_4),NF (S3_1_C5_20),"AMOUNT REPORTED, Medical Records & Med Records Library (S3_2_C2_41)",Line 2 times line 5 (E_B_HOS_C101_6),Deferred Income (G_C1THRU4_41),Research (A_C6_191),Adults & Pediatrics (C_1_C5_30),Hospital Adlts & Ped Swing Bed NF (S3_1_C7_6),"If this facility qualifies as a RPCH/CAH, has it elected the all inclusive payment for outpatient service? (Y/N) (S2_1_C1_106)",Other Ancillary (B_1_C26_76),Occupational Therapy (D_4_HOS_C4_67),Total Fixed Assets (G_C1THRU4_30),interns and residents (E_B_HOS_C1_28),OLTC (S3_1_C3_21),Renal Dialysis (B_1_C21_74),RHC 16 Provider Number (S2_1_C2_1515),RHC 10 Provider Number (S2_1_C2_1509),"Total Outpatient Charges, Delivery Room and Labor Room (C_1_C7_52)",Total Other Medical Education Cost (D_3_HOS_C3_200),"Blood Storing, Processing, Trans (A_C2_63)","COST REIMBURSED SERVICES SUBJECT TO DEDUCTIBLES  AND COINSURANCE - CHARGES, Electrocardiology (D_5_HOS_C3_69)",Report Status Code (RPT_STUS_CD),"COST REIMBURSED SERVICES SUBJECT TO DEDUCTIBLES  AND COINSURANCE - CHARGES, Renal Dialysis (D_5_HOS_C3_74)","Beginning Balances, Subtotal (A7_1_C1_8)",Lung  Acquisition (C_1_C6_108),Laboratory (D3_IRF_C3_60),Blood Clotting Factors for Hemoph. (D3_IRF_C2_6250),"ADJUSTED SALARIES, Interns & Residents (S3_2_C4_7)","PAID HOURS RELATED TO SALARIES, Home Office:  Physician Part A (S3_2_C5_15)",Anesthesiology (D3_IRF_C2_53),Operating Room (D3_IRF_C3_50),"Net Expense for Cost Allocation, Operation of Plant (B_1_C0_7)",Hospice 2 Provider Number (S2_1_C2_1401),Organ Procurement (D4_INTESTINE_C1_69),Observation Beds (Distinct Unit) (D_4_HOS_C2_9201),"COST REIMBURSED SERVICES SUBJECT TO DEDUCTIBLES  AND COINSURANCE - CHARGES, Whole Blood & Packed Red Blood Cells (D_5_HOS_C3_62)",RHC (A_C6_88),Ambulance Trips (S3_1_C6_29),Radioisotope (D_4_HOS_C3_56),"COST SERVICES SUBJECT TO DEDUCTIBLES AND COINSURANCE - COST, Electrocardiology (D_5_HOS_C6_69)","If Line 32, Col 1 is yes, enter the method used: (A, B, or E only) (S2_1_C2_115)","HHA II, LUPA Episodes:  Other Charges (S4_HHA2_C3_34)",Have you established a new subprovider excluded unit under 42 CFR 413.40(f)(1)(I)?(Y/N) (S2_1_C1_86),Interns & Res Other Program Costs (A_C2_22),Heart Acquisition (B_1_C22_106),Radiology-Therapeutic (B_1_C26_55),Delivery Room and Labor Room (D3_HOS_C3_52),Balance due provider/program (E_B_HOS_C1_43),Less Contractual Allowance and Discounts on Patients' Accounts (G3_C1_2),Other Special Purpose (A_C6_117),MRI (D_4_HOS_C3_58),Anesthesiology (D_4_IPF_C11_53),Kidney Acquisition (B_1_C26_105),Nursery (B_1_C26_43),RHC 20 Provider Number (S2_1_C2_1519),Durable Medical Equipment Sold (B_2_C26_97),"Total Program Inpatient Operating Cost excluding Capital Related, Nonphysician, Anesthetist, and Medical Education Costs (D1_IRF_C1_53)",Renal 1 Provider Number (S2_1_C2_18),"COST REIMBURSED SERVICES SUBJECT TO DEDUCTIBLES  AND COINSURANCE - CHARGES, Drugs Charged to Patients (D_5_HOS_C3_73)","AMOUNT REPORTED, Other General Service (S3_2_C2_43)",Recovery Room (D3_IRF_C2_51),CMHC (B_1_C22_99),Renal Dialysis (D3_SNF_C3_74),ASC (Non Distinct Part) (D_4_HOS_C4_75),Cardiac Catheterization (D3_HOS_C3_59),Subprovider-IRF (D3_HOS_C2_41),Medical and Other Services reimbursed by OPPS (E_B_HOS_C1_2),"Net Expense for Cost Allocation, HHA (B_1_C0_101)",Hospital Adlts & Ped Swing Bed NF (S3_1_C8_6),"Disposals and Retirements, Land Improvements (A7_1_C7_2)","PPS REIMBURSED SERVICES -  CHARGES, Intravenous Therapy (D_5_HOS_C2_64)",CT Scan (D_4_HOS_C11_57),"PPS SERVICES COST, Anesthesiology (D_5_HOS_C5_53)","HHA II, LUPA Episodes:  Total Visits (S4_HHA2_C3_33)","PAID HOURS RELATED TO SALARIES, Home Office Salaries & Wage Related Csts (S3_2_C5_14)",Electrocardiology (D_4_HOS_C12_69),Electrocardiology (B_2_C26_69),Total (D_1_HOS_C4_200),"PPS REIMBURSED SERVICES -  CHARGES, Clinic (D_5_HOS_C2_90)",Impl. Dev. Charged to Patients (D3_IPF_C2_72),IRF Provider Number (S2_1_C1_5),Ancillary service charges (E_B_HOS_C1_12),RHC (B_1_C26_88),"HHA II, Total Charges (S4_HHA2_C5_35)",Total Bad Debt expense (S10_C1_26),Aggregate amount collected from patients (E_B_HOS_C1_15),Cafeteria (A_C6_11),Renal Dialysis (D_4_HOS_C4_74),"HHA II, With Outliers:  Number of Episodes (S4_HHA2_C2_37)",Electrocardiology (D_4_HOS_C4_69),"General Inpatient Routine Service Cost, net of Swing Bed and Private Room Diff (D1_IRF_C1_37)",Radiology-Diagnostic (D3_IPF_C3_54),ASC (Non Distinct Part) (A_C6_75),Medical Records and Medical Rec. Library (A_C1_16),OPPS payments (E_B_HOS_C1_3),Speech Pathology (B_1_C26_68),Durable Medical Equipment Rented (D_4_HOS_C12_96),ASC (Distinct Part) (B_2_C26_115),Cardiac Catheterization (D_4_HOS_C2_59),Occupational Therapy (C_1_C2_67),Recovery Room (D_4_IRF_C13_51),Medical Supplies Charged to Patients (D3_HOS_C3_71),"Blood Storing, Processing, Trans (D3_IPF_C3_63)",Drugs Charged to Patients (B_1_C21_73),"Taxes, Total (A7_3_C6_3)","COST REIMBURSED SERVICES SUBJECT TO DEDUCTIBLES  AND COINSURANCE - CHARGES, Ambulance Services (D_5_HOS_C3_95)",Radioisotope (A_C6_56),"ADJUSTED SALARIES, Interns & Residents (S3_2_C4_2551)","Net Expense for Cost Allocation, Central Services and Supply (B_1_C0_14)",Physical Therapy (D3_SNF_C3_66),IPF (S3_1_C7_16),Operating Room (D_4_IPF_C11_50),Drugs Charged to Patients (D3_HOS_C2_73),Medical Supplies Charged to Patients (D_4_IRF_C11_71),Administrative and General (A_C6_5),Impl. Dev. Charged to Patients (A_C2_72),Anesthesiology (D_4_HOS_C1_53),OSP (C_1_C6_9940),"TOTAL CAPITAL COSTS AFTER COST ALLOCATION, Radiology-Diagnostic (B_2_C26_54)","AMOUNT REPORTED, Physician Part B (S3_2_C3_23)","Total Outpatient Charges, Anesthesiology (C_1_C7_53)","AMOUNT REPORTED, Maintenance and Repairs (S3_2_C2_29)",Other Nonreimbursable (A_C1_194),"TOTAL CAPITAL COSTS AFTER COST ALLOCATION, Other Special Care Unit (B_2_C26_35)",Whole Blood & Packed Red Blood Cells (A_C1_62),Intensive Care Unit Program Cost (D1_HOS_C5_43),Allowable Inpatient Cost Plus Incentive Pt (D1_HOS_C1_63),Inventory (G_C1THRU4_7),"Allocation of Interns & Residents Salary and Fringes, MRI (B_1_C21_58)",Medical Supplies Charged to Patients (D_4_HOS_C4_71),Kidney Acquisition (B_1_C21_105),Subprovider 2 (S3_1_C8_1801),Clinic (B_1_C22_90),Burn Intensive Care Unit (A_C6_33),"HHA II, Without Outliers:  Total Visits (S4_HHA2_C1_33)","Blood Storing, Processing, Trans (D_4_HOS_C11_63)","Interest, Total (A7_3_C11_3)",Clinic (C_1_C7_90),"ADJUSTED SALARIES, Subtotal Wage Related Csts (S3_3_C4_5)",Drugs Charged to Patients (B_2_C26_73),Laboratory (C_1_C5_60),OLTC (S3_1_C11_21),Respiratory Therapy (D_4_IPF_C11_65),"ADJUSTED SALARIES, Admin & Gen Under Contract (S3_2_C4_29)",Coronary Care Unit (A_C6_32),"ADJUSTED SALARIES, Dietary (S3_2_C4_34)",Outpatient Rehab Provider (S3_1_C7_25),Medical Supplies Charged to Patients (D3_IPF_C3_71),"Allocation of Interns & Residents Program Costs, Recovery Room (B_1_C22_51)","PPS SERVICES COST, ASC (Non Distinct Part) (D_5_HOS_C5_75)",Pancreas Acquisition (C_1_C6_109),"AMOUNT REPORTED, Wage Related Costs RHC/FQHC (S3_2_C2_24)",RHC 14 Provider Number (S2_1_C2_1513),MRI (C_1_C5_58),Intravenous Therapy (D_4_HOS_C3_64),RHC 11 Provider Number (S2_1_C2_1510),Durable Medical Equipment Rented (D_4_HOS_C3_96),Radiology-Therapeutic (D_4_HOS_C2_55),"AMOUNT REPORTED, Non-Physician Anesthetist Part B (S3_2_C2_21)","Disposals and Retirements, Buildings and Fixtures (A7_1_C7_3)","Allocation of Interns & Residents Salary and Fringes, Surgical Intensive Care Unit (B_1_C21_34)",Clinic (D_4_IPF_C13_90),Observation Beds (Distinct Unit) (D_4_HOS_C12_9201),Impl. Dev. Charged to Patients (D_4_HOS_C10_72),Title XVIII discharges (S3_1_C13_16),"HHA III, PEP Episodes:  Total Charges: (S4_HHA3_C4_35)",Clinic (B_1_C21_90),Intravenous Therapy (D_4_HOS_C13_64),"Is this a New Hospital under
42 CFR 412.300 PPS capital
(Y/N) (S2_1_C1_47)",Surgical Intensive Care Unit (S3_1_C5_11),Lung  Acquisition (C_1_C7_108),"HHA III, LUPA:  Total Non Routine Med Sup Chgs (S4_HHA3_C3_38)",Laboratory (D3_IRF_C2_60),Speech Pathology (D3_SNF_C3_68),Lung  Acquisition (B_1_C21_108),"ADJUSTED SALARIES, Non-Physician Anesthetist Part A (S3_2_C4_20)",Maintenance of Personnel (A_C6_12),"Total Inpatient Charges, Radioisotope (C_1_C6_56)",Total Other Medical Education (D_4_HOS_C4_200),Operation of Plant (A_C2_7),ASC (Non Distinct Part) (D_4_IRF_C11_75),"Blood Storing, Processing, Trans (D_4_IPF_C11_63)","Average patient dialysis time 
including setup (S5_C2_3)","Allocation of Interns & Residents Program Costs, Occupational Therapy (B_1_C22_67)",Whole Blood & Packed Red Blood Cells (D3_HOS_C3_62),Deductibles and coinsurance (E_B_HOS_C1_25),"AVERAGE HOURLY WAGE, Central Services and Supply (S3_2_C6_39)","Purchases, Building Improvements (A7_1_C2_4)",Paid Losses (S2_1_C2_11801),"Net Expense for Cost Allocation, Subprovider-IPF (B_1_C0_40)",OOT (A_C6_9930),Cardiac Catheterization (D_4_SNF_C11_59),"HHA II, LUPA:  Total Non Routine Med Sup Chgs (S4_HHA2_C3_38)",Home Program Dialysis (D_4_HOS_C3_94),"Donations, Total (A7_1_C3_10)","Net Expense for Cost Allocation, Durable Medical Equipment Sold (B_1_C0_97)",Fiscal Intermediary/MAC Create Date (FI_CREAT_DT),Whole Blood & Packed Red Blood Cells (D3_SNF_C2_62),Subprovider II (D_1_HOS_C4_4201),Radioisotope (D_4_HOS_C11_56),Radioisotope (D_4_SNF_C11_56),RHC (A_C1_88),Electroencephalography (D_4_SNF_C11_70),"COST SERVICES SUBJECT TO DEDUCTIBLES AND COINSURANCE - COST, Radiology-Diagnostic (D_5_HOS_C6_54)",Cash on Hand and in Banks (G_C1THRU4_1),Laboratory (D_4_SNF_C11_60),"ADJUSTED SALARIES, Central Services and Supply (S3_2_C4_39)","PAID HOURS RELATED TO SALARIES, Dietary (S3_2_C5_34)",Utilization Review-physicians compens (A8_C2_25),Other Outpatient Services (D3_IRF_C2_93),Speech Pathology (C_1_C7_68),"HHA III, Without Outliers:  Non Routine Med Sup Chgs (S4_HHA3_C1_38)",CAPD exchanges per day (S5_C6_4),"Total, New Cap Related Csts Bldg & Fixtures (A7_3_C15_1)",Home Program Dialysis (D3_HOS_C2_94),Whole Blood & Packed Red Blood Cells (D3_IPF_C2_62),CT Scan (D_4_IPF_C11_57),Out of State Medicaid paid days (S2_1_C3_24),"Blood Storing, Processing, Trans (A_C6_63)","ADJUSTED SALARIES, Non-Physician Part B (S3_2_C4_6)","AMOUNT REPORTED, Subtotal Salaries (S3_3_C2_3)",Provider-based physician adjustment (A8_C2_10),"COST REIMBURSED SERVICES SUBJECT TO DEDUCTIBLES  AND COINSURANCE - CHARGES, Home Program Dialysis (D_5_HOS_C3_94)",Physicians' Private Office (B_1_C22_192),Other Outpatient Services (D3_HOS_C3_93),IPF Provider Number (S2_1_C2_4),"PAID HOURS RELATED TO SALARIES, Housekeeping under Contract (S3_2_C5_33)",Operating Room (D_4_HOS_C12_50),Medicaid HMO Days (S2_1_C5_24),Urban/Rural Indicator at beginning (S2_1_C1_26),IRF (S3_1_C3_17),MRI (D3_IPF_C2_58),Other Nonreimbursable (B_1_C26_194),Subprovider 1 (S3_1_C3_18),HHA (A_C1_101),Islet Acquisition (A_C2_111),Observation Beds (Distinct Unit) (D_4_IPF_C11_9201),"AMOUNT REPORTED, Wage Related Costs RHC/FQHC (S3_2_C3_24)","PAID HOURS RELATED TO SALARIES, Teaching Physician Salaries (S3_2_C5_16)",Other Assets (G_C1THRU4_34),"Allocation of Interns & Residents Salary and Fringes, Operating Room (B_1_C21_50)","Beginning Balances, Movable Equipment (A7_1_C1_6)",NF (B_1_C26_45),"PPS SERVICES COST, Respiratory Therapy (D_5_HOS_C5_65)","HHA III, Total Number of Outlier Episodes (S4_HHA3_C5_37)","Medical certified lung
transplant center cert date (S2_1_C1_129)",Medical Supplies Charged to Patients (D_4_SNF_C11_71),"COST REIMBURSED SERVICES NOT SUBJECT TO DEDUCTIBLES AND COINSURANCE - CHARGES, Anesthesiology (D_5_HOS_C4_53)",Total (A8_C2_50),"AVERAGE HOURLY WAGE, Excluded Area Salaries (S3_2_C6_10)",Emergency (D3_IPF_C2_91),Land (G_C1THRU4_12),"AMOUNT REPORTED, Housekeeping (S3_2_C2_32)",Speech Pathology (D3_IPF_C3_68),Other Special Purpose (C_1_C5_117),"Depreciation, New Cap Related Csts Bldg & Fixtures (A7_3_C9_1)","Number of patients in program at 
end of cost reporting period (S5_C2_1)",Respiratory Therapy (D3_SNF_C3_65),"ADJUSTED SALARIES, Maintenance of Personnel (S3_2_C4_37)","Net Expense for Cost Allocation, Maintenance of Personnel (B_1_C0_12)",RHC 12 Provider Number (S2_1_C2_1511),Renal 3 Provider Number (S2_1_C2_1802),Other Current Liabilities (G_C1THRU4_44),Impl. Dev. Charged to Patients (D_4_IRF_C13_72),"Disposals and Retirements, Movable Equipment (A7_1_C7_6)",IRF Provider Number (S2_1_C2_5),"Allocation of Interns & Residents Program Costs, Subprovider-IPF (B_1_C22_40)",Anesthesiology (D_4_SNF_C11_53),Other Reimbursable (D3_HOS_C3_98),Other General Service (A_C2_18),Hospital Adlts & Ped Swing Bed SNF (S3_1_C8_5),"HHA I, With Outliers:  Number of Episodes (S4_HHA1_C2_37)","AMOUNT REPORTED, Physician-Part A (S3_2_C2_4)",Renal Dialysis (D3_IPF_C2_74),"Disposals and Retirements, Fixed Equipment (A7_1_C7_5)",Labor and Delivery (S3_1_C3_32),TOTAL (D3_SNF_C2_202),"AVERAGE HOURLY WAGE, Medical Records & Med Records Library (S3_2_C6_41)","Purchases, Subtotal (A7_1_C2_8)","Allocation of Interns & Residents Program Costs, Subprovider I (B_1_C22_42)",Surgical Intensive Care Unit (D_1_HOS_C7_34),"AMOUNT REPORTED, Non-Physician Anesthetist Part A (S3_2_C2_2)","AVERAGE HOURLY WAGE, Administrative and General (S3_2_C6_27)",Heart Acquisition (C_1_C7_106),"AVERAGE HOURLY WAGE, Dietary (S3_2_C6_34)",Investment Income-New Movable Equip (A8_C2_2),Emergency (D_4_HOS_C12_91),Radiology-Therapeutic (D3_SNF_C3_55),Blood Clotting Factors for Hemoph. (D_4_HOS_C10_6250),"Blood Storing, Processing, Trans (D3_IRF_C3_63)",Utilization Review - Physician Compen (D1_SNF_C1_85),"ADJUSTED SALARIES, Administrative and General (S3_2_C4_27)",Drugs Charged to Patients (D_4_IPF_C11_73),"TOTAL CAPITAL COSTS AFTER COST ALLOCATION, Nursery (B_2_C26_43)",NF (S3_1_C7_20),"Total Outpatient Charges, Cardiac Catheterization (C_1_C7_59)",Observation Beds (Distinct Unit) (D3_IPF_C2_9201),Adults and Pediatrics (B_1_C26_30),Laundry and Linen Service (A_C1_8),Organ Procurement (D4_LIVER_C1_69),Cafeteria employees and guests (A8_C2_14),Surgical Intensive Care Unit (B_1_C26_34),Subprovider-IRF (C_1_C5_41),"HHA II, Total Charges:  LUPA Episodes (S4_HHA2_C3_35)","Purchases, Buildings and Fixtures (A7_1_C2_3)","HHA III, Total Non Routine Medical  Supply Charges (S4_HHA3_C5_38)","PPS SERVICES COST, Intravenous Therapy (D_5_HOS_C5_64)",Respiratory Therapy (D3_IPF_C3_65),Respiratory Therapy (C_1_C6_65),Anesthesiology (D_4_IRF_C11_53),"Medicare certified heart
transplant center cert date (S2_1_C1_127)","COST SERVICES NOT SUBJECT TO DEDUCTIBLES AND COINSURANCE - COST, Cardiac Catheterization (D_5_HOS_C7_59)",Blood Clotting Factors for Hemoph. (D3_IRF_C3_6250),Operating Room (D_4_IRF_C11_50),"Net Expense for Cost Allocation, Medical Records and Medical Rec. Library (B_1_C0_16)",Radioisotope (D3_SNF_C3_56),Subprovider-IPF (A_C6_40),"Donations, Fixed Equipment (A7_1_C3_5)",Home Office Street (S2_1_C1_142),Maintenance of Personnel (A_C2_12),"Sale of scrap, waste, etc. (A8_C2_11)",Cardiac Catheterization (D_4_HOS_C3_59),Outlier payments (E_B_HOS_C1_4),"Gift, Flower, Coffee Shop, Canteen (B_2_C26_190)",Medical Supplies Charged to Patients (C_1_C5_71),Intravenous Therapy (D_4_HOS_C11_64),Subprovider I (B_1_C26_42),"Net Expense for Cost Allocation, Occupational Therapy (B_1_C0_67)",Total Outpatient Program Pass Thru Cost (D_4_IPF_C6_200),Medical Supplies Charged to Patients (C_1_C6_71),Nursing School (A_C2_20),"Difference between Adjusted Inpatient, Operating Cost and Target Amount (D1_HOS_C1_57)",FQHC (A_C1_89),"AVERAGE HOURLY WAGE, Interns & Residents (S3_2_C6_7)",Coronary Care Unit (C_1_C5_32),"ADJUSTED SALARIES, Housekeeping (S3_2_C4_32)",Subprovider-IRF (D_3_HOS_C9_41),Other Ancillary (A_C2_76),Electrocardiology (D3_IPF_C2_69),Liver Acquisition (A_C1_107),CAH Visits (S3_1_C8_15),Interns & Res Salary and Fringe Benefits (A_C2_21),Physical Therapy (D_4_HOS_C2_66),Electrocardiology (D_4_HOS_C3_69),Radiology-Therapeutic (D_4_SNF_C11_55),"COST SERVICES NOT SUBJECT TO DEDUCTIBLES AND COINSURANCE - COST, Delivery Room and Labor Room (D_5_HOS_C7_52)",Radiology-Diagnostic (D_4_HOS_C13_54),Total Facility FTEs (S3_1_C9_27),Int & Res (non approved teaching program (A_C1_100),"HHA I, LUPA Episodes:  Total Number of Episodes (S4_HHA1_C3_36)",Adults & Pediatrics (D_3_HOS_C9_30),Hospice (S3_1_C3_24),"PPS REIMBURSED SERVICES -  CHARGES, Recovery Room (D_5_HOS_C2_51)","AVERAGE HOURLY WAGE, Dietary under Contract (S3_2_C6_35)","HHA II, Without Outliers:  Other Charges (S4_HHA2_C1_34)",Other Outpatient Services (B_1_C22_93),"HHA II, Total Other Charges (S4_HHA2_C5_34)",Ambulance Services (A_C6_95),"Net Expense for Cost Allocation, Other Reimbursable (B_1_C0_98)",Hospice (B_1_C22_116),Occupational Therapy (D_4_HOS_C12_67),OOT (C_1_C7_9930),Whole Blood & Packed Red Blood Cells (D_4_IPF_C13_62),Relief Payment (D1_HOS_C1_62),RHC 5 Provider Number (S2_1_C2_1504),Cardiac Catheterization (D3_SNF_C3_59),Other Special Care Unit (D_1_HOS_C7_35),Intravenous Therapy (D_4_IPF_C11_64),Total reasonable charges (E_B_HOS_C1_14),SNF (S3_1_C8_19),"Fully Depreciated Assets, Ending Balance (A7_1_C6_7)","PAID HOURS RELATED TO SALARIES, Excluded Area Salaries (S3_2_C5_10)","COST REIMBURSED SERVICES SUBJECT TO DEDUCTIBLES  AND COINSURANCE - CHARGES, PBP Clinical Lab Services Program Only (D_5_HOS_C3_61)",Whole Blood & Packed Red Blood Cells (D_4_SNF_C11_62),"Total Inpatient Charges, Operating Room (C_1_C6_50)",Cardiac Catheterization (D_4_IPF_C11_59),"HHA III, PEP:  Total Non Routine Med Supply Chgs (S4_HHA3_C4_38)",Renal 6 Provider Number (S2_1_C2_1805),Delivery Room and Labor Room (A_C1_52),Renal Dialysis (D_4_IRF_C11_74),Hospital Adults & Pediatrics (S3_1_C8_1),Paramedical Education (A_C1_23),Operating Room (A_C1_50),Intestinal Acquisition (A_C1_110),"Blood Storing, Processing, Trans (D_4_HOS_C10_63)",Total (D_4_HOS_C13_200),"Donations, Movable Equipment (A7_1_C3_6)","PAID HOURS RELATED TO SALARIES, Non-Physician Part B (S3_2_C5_6)","COST REIMBURSED SERVICES NOT SUBJECT TO DEDUCTIBLES AND COINSURANCE - CHARGES, Respiratory Therapy (D_5_HOS_C4_65)",CT Scan (D_4_HOS_C10_57),Hospital Name (S2_1_C1_3),"Net Expense for Cost Allocation, Nursing Administration (B_1_C0_13)","Net Expense for Cost Allocation, Observation Beds (Distinct Unit) (B_1_C0_9201)",Adults and Pediatrics (D3_SNF_C2_30),OOT (C_1_C6_9930),"Fully Depreciated Assets, Total (A7_1_C4_7)",Amounts expected under 42 CFR (E_B_HOS_C1_16),"Total Inpatient Charges, Laboratory (C_1_C6_60)","TOTAL CAPITAL COSTS AFTER COST ALLOCATION, Subprovider-IPF (B_2_C26_40)",Other Ancillary (D_4_HOS_C3_76),Renal 4 Provider Number (S2_1_C2_1803),"ADJUSTED SALARIES, Interns & Residents (S3_2_C4_2552)",Physical Therapy (C_1_C7_66),"COST SERVICES SUBJECT TO DEDUCTIBLES AND COINSURANCE - COST, Home Program Dialysis (D_5_HOS_C6_94)","Purchases, Fixed Equipment (A7_1_C2_5)",Title XVIII discharges (S3_1_C13_14),Kidney Acquisition (B_2_C26_105),Cafeteria (A_C1_11),Other Ancillary (C_1_C5_76),Medical Supplies Charged to Patients (D_4_HOS_C10_71),Delivery Room and Labor Room (A_C6_52),Occupational Therapy (D_4_IPF_C13_67),Electroencephalography (D_4_IPF_C13_70),Total Program Inpatient Costs (D1_IRF_C1_49),Recovery Room (D_4_HOS_C3_51),"Net Expense for Cost Allocation, New Capital Equipment (B_1_C0_2)",Coronary Care Unit (D3_IRF_C2_32),"ADJUSTED SALARIES, Excluded Area Salaries (S3_3_C4_2)","AVERAGE HOURLY WAGE, Admin & Gen Under Contract (S3_2_C6_29)",Excess of reasonable cost over reasonable charges (E_B_HOS_C1_20),Laundry and Linen Service (A_C2_8),Total Other Medical Education (D_4_IPF_C4_200),MRI (D_4_HOS_C11_58),Subprovider I (A_C6_42),"TOTAL CAPITAL COSTS AFTER COST ALLOCATION, Intensive Care Unit (B_2_C26_31)",Emergency (D3_HOS_C2_91),Delivery Room and Labor Room (D_4_IPF_C11_52),Electrocardiology (D_4_SNF_C11_69),Other Special Care (S3_1_C4_12),Other Outpatient Services (D3_IPF_C2_93),Other Special Care (S3_1_C8_12),Utilization Review SNF (A_C2_114),"COST REIMBURSED SERVICES NOT SUBJECT TO DEDUCTIBLES AND COINSURANCE - CHARGES, Whole Blood & Packed Red Blood Cells (D_5_HOS_C4_62)","COST SERVICES NOT SUBJECT TO DEDUCTIBLES AND COINSURANCE - COST, Whole Blood & Packed Red Blood Cells (D_5_HOS_C7_62)",Other Outpatient Services (B_2_C26_93),Drugs Charged to Patients (B_1_C26_73),ASC (Non Distinct Part) (A_C1_75),"HHA II, Total Number of Outlier Episodes (S4_HHA2_C5_37)","AMOUNT REPORTED, Home Office Personnel (S3_2_C2_8)",CMHC (B_1_C21_99),"PPS SERVICES COST, Radioisotope (D_5_HOS_C5_56)",Medicaid Observation Days (S3_1_C8_28),MRI (D3_HOS_C3_58),Radioisotope (D_4_HOS_C13_56),Respiratory Therapy (D3_HOS_C2_65),"HHA I, With Outliers:  Total Charges (S4_HHA1_C2_35)",Operating Room (A_C2_50),Payments received from patients for amounts previously written off as charity care (S10_C3_22),Radiology-Therapeutic (D_4_IPF_C11_55),"Allocation of Interns & Residents Salary and Fringes, Other Special Care Unit (B_1_C21_35)",Coronary Care Unit (A_C1_32),Home Program Dialysis (C_1_C7_94),"General Inpatient Routine Service Cost, net of Swing Bed Cost (D1_HOS_C1_27)","Allocation of Interns & Residents Program Costs, Whole Blood & Packed Red Blood Cells (B_1_C22_62)","HHA III, Total Charges:  LUPA Episodes (S4_HHA3_C3_35)","COST SERVICES NOT SUBJECT TO DEDUCTIBLES AND COINSURANCE - COST, Respiratory Therapy (D_5_HOS_C7_65)","Allocation of Interns & Residents Program Costs, CT Scan (B_1_C22_57)",SNF (S3_1_C6_19),CMHC (B_2_C26_99),Title V discharges (S3_1_C12_1),"Net Expense for Cost Allocation, Hospice (B_1_C0_116)",NF (C_1_C5_45),Outlier payments (E_B_HOS_C101_4),Number of periods hospital was in MDH status (S2_1_C1_37),RHC 21 Provider Number (S2_1_C2_1520),Operating Room (C_1_C5_50),"COST SERVICES NOT SUBJECT TO DEDUCTIBLES AND COINSURANCE - COST, Speech Pathology (D_5_HOS_C7_68)","Total, New Cap Related Csts Movable Equipment (A7_3_C15_2)",Durable Medical Equipment Sold (D_4_HOS_C13_97),Net revenue from state/local govt indigent care (not Medicaid or CHIP) (S10_C1_13),Drugs Charged to Patients (D_4_HOS_C3_73),Radiology-Diagnostic (D_4_HOS_C10_54),Other Ancillary (D3_IRF_C3_76),Other Reimbursable (D_4_HOS_C12_98),Intensive Care Unit (A_C2_31),Anesthesiology (C_1_C5_53),"Purchases, Movable Equipment (A7_1_C2_6)","Blood Storing, Processing, Trans (D3_IRF_C2_63)","COST REIMBURSED SERVICES SUBJECT TO DEDUCTIBLES  AND COINSURANCE - CHARGES, Other Ancillary (D_5_HOS_C3_76)",Impl. Dev. Charged to Patients (B_2_C26_72),Whole Blood & Packed Red Blood Cells (D_4_HOS_C3_62),"COST SERVICES SUBJECT TO DEDUCTIBLES AND COINSURANCE - COST, Radiology-Therapeutic (D_5_HOS_C6_55)",Hospice (S3_1_C8_24),MRI (D3_IPF_C3_58),"Net Expense for Cost Allocation, Anesthesiology (B_1_C0_53)","COST REIMBURSED SERVICES SUBJECT TO DEDUCTIBLES  AND COINSURANCE - CHARGES, Cardiac Catheterization (D_5_HOS_C3_59)","Blood Storing, Processing, Trans (B_2_C26_63)",Physical Therapy (D3_IRF_C2_66),"AMOUNT REPORTED, Nursing Administration (S3_2_C2_38)",Total (D_4_IRF_C13_200),"AMOUNT REPORTED, Cafeteria (S3_2_C2_36)",Nonpaid Workers (A_C6_193),Other Organ Acquisition (B_1_C21_112),Other Reimbursable (D3_SNF_C3_98),Radiology-Diagnostic (D3_SNF_C3_54),Recovery Room (D_4_IRF_C11_51),Intestinal Acquisition (A_C6_110),"Fully Depreciated Assets, Total (A7_1_C7_10)",Intensive Care Unit (S3_1_C6_8),"COST REIMBURSED SERVICES NOT SUBJECT TO DEDUCTIBLES AND COINSURANCE - CHARGES, Other Outpatient Services (D_5_HOS_C4_93)",Radiology-Diagnostic (A_C2_54),Emergency (D_4_HOS_C10_91),Observation Beds (Distinct Unit) (C_1_C5_9201),"Total Inpatient Charges, Burn Intensive Care Unit (C_1_C6_33)",Whole Blood & Packed Red Blood Cells (B_1_C26_62),Other Organ Acquisition (C_1_C6_112),Operating Room (B_1_C26_50),Electrocardiology (D_4_IRF_C13_69),Subprovider-IRF (D3_IPF_C2_41),Other Outpatient Services (D3_IRF_C3_93),Electrocardiology (A_C1_69),Intravenous Therapy (D3_SNF_C2_64),Intravenous Therapy (B_1_C26_64),Subprovider-IRF (D_1_HOS_C6_41),MRI (D_4_HOS_C10_58),Total Long-term Liabilities (G_C1THRU4_50),Total Assets (G_C1THRU4_36),Other Ancillary (D3_SNF_C2_76),Subtotal (E_B_HOS_C1_40),Cost of patients approved for charity care and uninsured discounts (S10_C1_21),Out of State Medicaid eligible days (S2_1_C4_24),Other Ancillary (B_2_C26_76),Subprovider I (D_1_HOS_C4_42),Program Ancillary Services (D1_SNF_C1_84),"HHA III, Without Outliers:  Total Charges (S4_HHA3_C1_35)",Leasehold Improvements (G_C1THRU4_17),"AVERAGE HOURLY WAGE, Contract Labor (S3_2_C6_11)","AVERAGE HOURLY WAGE, Home Office:  Physician Part A (S3_2_C6_15)",Initial Physician Payment Method (Y/N) (S5_C2_21),Islet Acquisition (B_1_C26_111),Electroencephalography (D3_SNF_C2_70),"COST REIMBURSED SERVICES SUBJECT TO DEDUCTIBLES  AND COINSURANCE - CHARGES, Total (D_5_HOS_C3_200)",Medical Supplies Charged to Patients (D_4_HOS_C2_71),Physical Therapy (D3_IPF_C2_66),Physical Therapy (D3_IRF_C3_66),Radiology-Therapeutic (A_C6_55),RHC (C_1_C5_88),"HHA III, W/Out Outliers:  Number of Episodes (S4_HHA3_C1_36)",ASC (Non Distinct Part) (D_4_IRF_C13_75),"Allocation of Interns & Residents Salary and Fringes, Nursery (B_1_C21_43)","TOTAL CAPITAL COSTS AFTER COST ALLOCATION, Anesthesiology (B_2_C26_53)","AMOUNT REPORTED, Subtotal Other Wages and Related Csts (S3_3_C2_4)",Operation of Plant (A_C1_7),SNF (A_C1_44),Medical Supplies Charged to Patients (D_4_HOS_C3_71),Surgical Intensive Care Unit (S3_1_C8_11),ASC (Distinct Part) (A_C6_115),Program Inpatient Ancillary Service Cost (D1_HOS_C1_48),New Capital Buildings and Fixtures (A_C2_1),Blood Clotting Factors for Hemoph. (A_C6_6250),ASC (Non Distinct Part) (B_1_C26_75),Blood Clotting Factors for Hemoph. (D_4_HOS_C3_6250),Kidney Acquisition (C_1_C7_105),Electrocardiology (C_1_C5_69),Recovery Room (C_1_C5_51),Nursery (S3_1_C5_13),Housekeeping (A_C6_9),"PAID HOURS RELATED TO SALARIES, Net Salaries (S3_3_C5_1)","AVERAGE HOURLY WAGE, Total (S3_3_C6_6)",Operating Room (A_C6_50),"Treatment capacity per day per
station (S5_C2_7)",Islet Acquisition (C_1_C7_111),OLTC (A_C6_46),Total Facility (S3_1_C2_27),OPT (C_1_C6_9920),"Total Inpatient Charges, Subprovider-IRF (C_1_C6_41)",Observation Beds (Distinct Unit) (D3_SNF_C2_9201),SNF (S3_1_C2_19),Whole Blood & Packed Red Blood Cells (D3_IRF_C2_62),"Total Inpatient Charges, Intensive Care Unit (C_1_C6_31)","PAID HOURS RELATED TO SALARIES, Home Office Personnel (S3_2_C5_8)","Net Expense for Cost Allocation, Laundry and Linen Service (B_1_C0_8)",Intestinal Acquisition (A_C2_110),HHA (B_1_C26_101),Other Outpatient Services (D_4_HOS_C11_93),"Net Expense for Cost Allocation, Social Service (B_1_C0_17)",Intravenous Therapy (D_4_IRF_C11_64),"PPS REIMBURSED SERVICES -  CHARGES, Occupational Therapy (D_5_HOS_C2_67)",Hospital Provider Number (PRVDR_NUM),Lung  Acquisition (B_1_C26_108),Other Ancillary (D_4_HOS_C12_76),"COST REIMBURSED SERVICES NOT SUBJECT TO DEDUCTIBLES AND COINSURANCE - CHARGES, Occupational Therapy (D_5_HOS_C4_67)","COST SERVICES SUBJECT TO DEDUCTIBLES AND COINSURANCE - COST, Cardiac Catheterization (D_5_HOS_C6_59)",Electrocardiology (D3_IPF_C3_69),Physical Therapy (B_1_C26_66),Electroencephalography (D_4_IRF_C13_70),Intestinal Acquisition (B_2_C26_110),"PPS SERVICES COST, Blood Clotting Factors for Hemoph. (D_5_HOS_C5_6250)","COST SERVICES NOT SUBJECT TO DEDUCTIBLES AND COINSURANCE - COST, Observation Beds (Distinct Unit) (D_5_HOS_C7_9201)",Other General Service (A_C1_18),"AVERAGE HOURLY WAGE, Housekeeping (S3_2_C6_32)","TOTAL CAPITAL COSTS AFTER COST ALLOCATION, Surgical Intensive Care Unit (B_2_C26_34)",Radiology-Therapeutic (D_4_HOS_C4_55),Delivery Room and Labor Room (D3_IPF_C3_52),"Blood Storing, Processing, Trans (D_4_IRF_C13_63)","Total Outpatient Charges, Blood Clotting Factors for Hemoph. (C_1_C7_6250)",Medicare allowable bad debts for the entire hospital complex (S10_C1_2701),Clinic (B_2_C26_90),Radioisotope (D3_IPF_C2_56),"Net Expense for Cost Allocation, Maintenance and Repairs (B_1_C0_6)",Research (B_1_C26_191),Organ Procurement (D4_PANCREAS_C1_69),"ADJUSTED SALARIES, Physician-Part B (S3_2_C4_5)",Occupational Therapy (D3_SNF_C3_67),Intensive Care Unit (A_C1_31),Interns & Res Salary and Fringe Benefits (A_C1_21),PBP Clinical Lab Services Program Only (B_1_C26_61),"ADJUSTED SALARIES, Total Salaries (S3_2_C4_1)","AVERAGE HOURLY WAGE, Home Office Salaries & Wage Related Csts (S3_2_C6_14)","Allocation of Interns & Residents Salary and Fringes, Respiratory Therapy (B_1_C21_65)",Intravenous Therapy (D_4_HOS_C10_64),CT Scan (D3_IRF_C3_57),Renal Dialysis (D3_IPF_C3_74),Partial or full credits from manufacturers (E_B_HOS_C1_3998),"ADJUSTED SALARIES, Management and Administrative Services (S3_2_C4_12)",Transitional corridor payment (E_B_HOS_C101_8),"PPS SERVICES COST, Physical Therapy (D_5_HOS_C5_66)",Lung  Acquisition (A_C1_108),Surgical Intensive Care Unit (S3_1_C6_11),"Allocation of Interns & Residents Program Costs, MRI (B_1_C22_58)",Total discharges (S3_1_C15_1),Other Special Care Unit (D3_SNF_C2_35),Cardiac Catheterization (D3_IRF_C2_59),Pancreas Acquisition (B_1_C22_109),Respiratory Therapy (C_1_C5_65),Zip Code (S2_1_C3_143),"Lease, Total (A7_3_C10_3)",Maintenance and Repairs (A_C6_6),ASC (Non Distinct Part) (C_1_C7_75),"Disposals and Retirements, Fixed Equipment (A7_1_C5_5)",MRI (B_1_C26_58),Renal Dialysis (B_1_C26_74),CT Scan (D3_SNF_C3_57),Intensive Care Unit (S3_1_C8_8),Operating Room (D_4_HOS_C11_50),SNF (S3_1_C9_19),"COST SERVICES NOT SUBJECT TO DEDUCTIBLES AND COINSURANCE - COST, Renal Dialysis (D_5_HOS_C7_74)","Allocation of Interns & Residents Program Costs, Impl. Dev. Charged to Patients (B_1_C22_72)",Television and Radio Service (A8_C2_8),"Taxes, New Cap Related Csts Movable Equipment (A7_3_C6_2)",Home Program Dialysis (D3_IRF_C3_94),"AMOUNT REPORTED, Related  Salaries (S3_2_C2_1402)",Observation Beds (Distinct Unit) (D_4_IRF_C11_9201),Subprovider-IRF (D_1_HOS_C4_41),Radiology-Diagnostic (D_4_HOS_C4_54),Other Outpatient Services (D_4_HOS_C3_93),Medical Supplies Charged to Patients (D3_IRF_C3_71),Social Service (A_C2_17),"COST SERVICES SUBJECT TO DEDUCTIBLES AND COINSURANCE - COST, Durable Medical Equipment Sold (D_5_HOS_C6_97)","Gift, Flower, Coffee Shop, Canteen (B_1_C22_190)",Other Special Purpose (B_1_C26_117),Emergency (D_4_HOS_C2_91),Electroencephalography (D3_IRF_C3_70),Anesthesiology (A_C2_53),"Donations, Buildings and Fixtures (A7_1_C3_3)",Medical Supplies Charged to Patients (D_4_HOS_C13_71),Durable Medical Equipment Rented (C_1_C5_96),Physical Therapy (D_4_HOS_C3_66),Total Income (G3_C1_26),"Net Expense for Cost Allocation, Research (B_1_C0_191)",Total Salaries (A_C1_200),"COST SERVICES SUBJECT TO DEDUCTIBLES AND COINSURANCE - COST, Other Outpatient Services (D_5_HOS_C6_93)",Int & Res (non approved teaching program (B_1_C21_100),"Net Expense for Cost Allocation, Radiology-Diagnostic (B_1_C0_54)",OLTC (B_1_C26_46),Impl. Dev. Charged to Patients (D3_IRF_C2_72),Observation Beds (Distinct Unit) (D3_HOS_C3_9201),Intravenous Therapy (A_C6_64),"AVERAGE HOURLY WAGE, Cafeteria (S3_2_C6_36)",Drugs Charged to Patients (D_4_HOS_C13_73),Heart Acquisition (B_2_C26_106),Liver Acquisition (B_1_C21_107),Total Hospital (S3_1_C6_14),"PAID HOURS RELATED TO SALARIES, Operation of Plant (S3_2_C5_30)","COST REIMBURSED SERVICES NOT SUBJECT TO DEDUCTIBLES AND COINSURANCE - CHARGES, Total (D_5_HOS_C4_200)",Physical Therapy (A_C6_66),SSA State Code (STATE),Other Ancillary (A_C1_76),Impl. Dev. Charged to Patients (C_1_C7_72),Total Hospital Interns & Residents (S3_1_C9_14),Physical Therapy (D_4_IRF_C11_66),Speech Pathology (D3_SNF_C2_68),"AVERAGE HOURLY WAGE, Net Salaries (S3_3_C6_1)",Clinic (A_C1_90),Observation Beds (Distinct Unit) (D_4_HOS_C11_9201),Hospital Adults & Ped Swing Bed SNF (S3_1_C6_5),Cardiac Catheterization (D3_IPF_C3_59),"ADJUSTED SALARIES, Contract Labor (S3_2_C4_11)","PAID HOURS RELATED TO SALARIES, Subtotal Salaries (S3_3_C5_3)",OOT (A_C1_9930),Medical Records and Medical Rec. Library (A_C2_16),Clinic (D3_HOS_C2_90),HHA (S3_1_C9_22),Burn Intensive Care Unit (S3_1_C3_10),"Number of days in year dialysis 
furnished (S5_C5_2)",Radioisotope (D3_HOS_C2_56),"Percentage of patients re-using
dialyzers (S5_C1_10)",Laboratory (D_4_HOS_C12_60),Is this a New Hospital under 42 CFR 413.40(f)(1)(I) (TEFRA)? (Y/N) (S2_1_C1_85),Whole Blood & Packed Red Blood Cells (D3_HOS_C2_62),FQHC (D_4_HOS_C3_89),Radiology-Diagnostic (D_4_HOS_C3_54),Total Costs (C_1_C3_202),Total Hospital (S3_1_C7_14),Other Special Care (S3_1_C5_12),TOTAL (D3_IPF_C2_200),Hospice (B_2_C26_116),Intravenous Therapy (A_C1_64),Other Organ Acquisition (A_C1_112),Delivery Room and Labor Room (D3_SNF_C2_52),Does the facility operate an ICF/MR facility for purposes of Title XIX? (Y/N) (S2_1_C1_93),"COST SERVICES NOT SUBJECT TO DEDUCTIBLES AND COINSURANCE - COST, Radioisotope (D_5_HOS_C7_56)",Report Record Number (RPT_REC_NUM),"HHA I, LUPA Episodes:  Total Visits (S4_HHA1_C3_33)",Radiology-Therapeutic (A_C2_55),"PPS REIMBURSED SERVICES -  CHARGES, Home Program Dialysis (D_5_HOS_C2_94)","COST REIMBURSED SERVICES SUBJECT TO DEDUCTIBLES  AND COINSURANCE - CHARGES, Electroencephalography (D_5_HOS_C3_70)","COST SERVICES NOT SUBJECT TO DEDUCTIBLES AND COINSURANCE - COST, Electroencephalography (D_5_HOS_C7_70)",ASC (Non Distinct Part) (D_4_HOS_C2_75),Electrocardiology (A_C2_69),Speech Pathology (D_4_SNF_C11_68),Coronary Care Unit (S3_1_C3_9),Operating Room (D_4_SNF_C11_50),"Beginning Balances, Buildings and Fixtures (A7_1_C1_3)",ASC (Non Distinct Part) (D_4_HOS_C13_75),"COST SERVICES SUBJECT TO DEDUCTIBLES AND COINSURANCE - COST, Electroencephalography (D_5_HOS_C6_70)",Payments received from patients for amounts previously written off as charity care (S10_C2_22),MRI (D_4_IPF_C13_58),Depreciation-New Movable Equipment (A8_C2_27),"COST REIMBURSED SERVICES SUBJECT TO DEDUCTIBLES  AND COINSURANCE - CHARGES, Physical Therapy (D_5_HOS_C3_66)","Allocation of Interns & Residents Program Costs, Laboratory (B_1_C22_60)","COST REIMBURSED SERVICES NOT SUBJECT TO DEDUCTIBLES AND COINSURANCE - CHARGES, Radiology-Diagnostic (D_5_HOS_C4_54)",Islet Acquisition (A_C1_111),Nursing School (A_C1_20),Observation Beds (Distinct Unit) (C_1_C7_9201),Hospital Adults & Pediatrics (S3_1_C3_1),Total Hospital Interns & Residents (S3_1_C11_14),Clinic (A_C6_90),"TOTAL CAPITAL COSTS AFTER COST ALLOCATION, Laboratory (B_2_C26_60)",Durable Medical Equipment Rented (D3_IPF_C3_96),OPPS payments (E_B_HOS_C101_3),Radiology-Therapeutic (D3_IPF_C2_55),Dietary (A_C1_10),Anesthesiology (B_1_C26_53),"PAID HOURS RELATED TO SALARIES, Total (S3_3_C5_6)",Transitional corridor payment (E_B_HOS_C1_8),Coronary Care Unit (S3_1_C8_9),"AMOUNT REPORTED, Physician Part A (S3_2_C3_22)","Net Expense for Cost Allocation, Blood Storing, Processing, Trans (B_1_C0_63)",Operating Room (D_4_HOS_C1_50),Medicaid charges (S10_C1_6),"COST REIMBURSED SERVICES NOT SUBJECT TO DEDUCTIBLES AND COINSURANCE - CHARGES, Intravenous Therapy (D_5_HOS_C4_64)",Radiology-Diagnostic (D_4_IRF_C11_54),"Disposals and Retirements, Land (A7_1_C7_1)",Subprovider I (D3_IPF_C2_42),"Donations, Building Improvements (A7_1_C3_4)",Durable Medical Equipment Rented (A_C1_96),"COST REIMBURSED SERVICES SUBJECT TO DEDUCTIBLES  AND COINSURANCE - CHARGES, Respiratory Therapy (D_5_HOS_C3_65)","COST SERVICES SUBJECT TO DEDUCTIBLES AND COINSURANCE - COST, Occupational Therapy (D_5_HOS_C6_67)",RHC/FQHC Combined (S3_1_C9_26),Subprovider-IPF (D_1_HOS_C4_40),"Gift, Flower, Coffee Shop, Canteen (A_C2_190)","AVERAGE HOURLY WAGE, Physician-Part B (S3_2_C6_5)",Emergency (B_1_C22_91),"COST SERVICES SUBJECT TO DEDUCTIBLES AND COINSURANCE - COST, Operating Room (D_5_HOS_C6_50)",HVBP payment adjustment amount (E_A_HOS_C1_7093),Notes Receivable (G_C1THRU4_3),"PAID HOURS RELATED TO SALARIES, Pharmacy (S3_2_C5_40)",Surgical Intensive Care Unit (S3_1_C7_11),"HHA II, PEP:  Total Non Routine Med Supply Chgs (S4_HHA2_C4_38)",Occupational Therapy (D_4_HOS_C3_67),CT Scan (D_4_HOS_C13_57),"Blood Storing, Processing, Trans (D_4_IPF_C13_63)",MRI (D_4_HOS_C4_58),"Disposals and Retirements, Buildings and Fixtures (A7_1_C5_3)",Intravenous Therapy (D3_IRF_C3_64),Observation Beds (Distinct Unit) (D3_HOS_C2_9201),New Capital Equipment (A_C2_2),ASC (Non Distinct Part) (B_2_C26_75),IPF (S3_1_C8_16),Ambulance Services (A_C1_95),"PPS SERVICES COST, Delivery Room and Labor Room (D_5_HOS_C5_52)",SSA State County Code (ST_CTY_CD),Organ acquisition charges (E_B_HOS_C1_13),FQHC 8 Provider Number (S2_1_C2_1607),Private grants or donations or endowment income restricted to funding charity care (S10_C1_17),"Net Expense for Cost Allocation, Dietary (B_1_C0_10)",Liver Acquisition (C_1_C5_107),Speech Pathology (D_4_HOS_C10_68),"Number of patients in program at 
end of cost reporting period (S5_C6_1)","COST REIMBURSED SERVICES SUBJECT TO DEDUCTIBLES  AND COINSURANCE - CHARGES, Other Reimbursable (D_5_HOS_C3_98)",OOT (A_C2_9930),"HHA I, With Outliers:  Total Visits (S4_HHA1_C2_33)","COST REIMBURSED SERVICES SUBJECT TO DEDUCTIBLES  AND COINSURANCE - CHARGES, Operating Room (D_5_HOS_C3_50)",Intestinal Acquisition (C_1_C5_110),"Total Inpatient Charges, Coronary Care Unit (C_1_C6_32)","COST REIMBURSED SERVICES NOT SUBJECT TO DEDUCTIBLES AND COINSURANCE - CHARGES, MRI (D_5_HOS_C4_58)","Beginning Balances, Building Improvements (A7_1_C1_4)","Net Expense for Cost Allocation, Other General Service (B_1_C0_18)",ICF (S3_1_C7_2001),Electroencephalography (D_4_HOS_C2_70),Emergency (D3_IRF_C3_91),Nonpaid Workers (A_C2_193),"HHA II, PEP Episodes:  Other Charges (S4_HHA2_C4_34)",Recovery Room (D3_HOS_C2_51),Pancreas Acquisition (A_C6_109),"ADJUSTED SALARIES, Teaching Physician Salaries (S3_2_C4_16)",FQHC (A_C6_89),Impl. Dev. Charged to Patients (D3_SNF_C2_72),Other Special Care (S3_1_C6_12),Hospice (S3_1_C9_24),Surgical Intensive Care Unit (D_3_HOS_C9_34),Intravenous Therapy (D_4_IRF_C13_64),In State Medicaid eligible days (S2_1_C2_24),SNF (C_1_C5_44),"Total Outpatient Charges, Laboratory (C_1_C7_60)",Total Program General Inpatient Routine (D1_HOS_C1_41),Subprovider II (A_C1_4201),"TOTAL CAPITAL COSTS AFTER COST ALLOCATION, Adults & Pediatrics (B_2_C26_30)",Total Allied Health (D_4_HOS_C3_200),Notes Payable (G_C1THRU4_47),"ADJUSTED SALARIES, Physician Part A (S3_2_C4_22)",Renal Dialysis (C_1_C5_74),"PPS REIMBURSED SERVICES -  CHARGES, Speech Pathology (D_5_HOS_C2_68)",Renal Dialysis (D_4_HOS_C13_74),Renal Dialysis (A_C6_74),HAC reduction adjustment amount (E_A_HOS_C1_7099),Other Special Care Unit (D_1_HOS_C6_35),"COST REIMBURSED SERVICES NOT SUBJECT TO DEDUCTIBLES AND COINSURANCE - CHARGES, Drugs Charged to Patients (D_5_HOS_C4_73)",Impl. Dev. Charged to Patients (D_4_IPF_C11_72),Radiology-Diagnostic (D3_HOS_C2_54),"AMOUNT REPORTED, Subtotal Wage Related Csts (S3_3_C2_5)",Other Reimbursable (D3_IPF_C2_98),Nonpaid Workers (A_C1_193),"Allocation of Interns & Residents Salary and Fringes, NF (B_1_C21_45)","ADJUSTED SALARIES, Subtotal Salaries (S3_3_C4_3)",CT Scan (D3_HOS_C2_57),"Allocation of Interns & Residents Program Costs, Coronary Care Unit (B_1_C22_32)","COST SERVICES NOT SUBJECT TO DEDUCTIBLES AND COINSURANCE - COST, Other Ancillary (D_5_HOS_C7_76)",MRI (D3_HOS_C2_58),HHA (C_1_C7_101),Drugs Charged to Patients (D_4_HOS_C10_73),RHC 6 Provider Number (S2_1_C2_1505),Occupational Therapy (D3_IRF_C2_67),"ADJUSTED SALARIES, Administrative & General under contract (S3_2_C4_28)",Intensive Care Unit (D3_IRF_C2_31),"AVERAGE HOURLY WAGE, Teaching Physician Salaries (S3_2_C6_16)","Total Inpatient Charges, Adults & Pediatrics (C_1_C6_30)",Central Services and Supply (A_C2_14),Respiratory Therapy (D_4_IRF_C11_65),Liver Acquisition (B_1_C26_107),RHC (A_C2_88),Renal Dialysis (D_4_HOS_C11_74),Whole Blood & Packed Red Blood Cells (D_4_IRF_C11_62),Anesthesiology (D3_HOS_C2_53),"Net Expense for Cost Allocation, OPT (B_1_C0_9920)","Total Outpatient Charges, Radiology-Therapeutic (C_1_C7_55)",Emergency (C_1_C5_91),CMHC 1 Provider Number (S2_1_C2_17),"COST SERVICES NOT SUBJECT TO DEDUCTIBLES AND COINSURANCE - COST, Blood Clotting Factors for Hemoph. (D_5_HOS_C7_6250)",Research (B_2_C26_191),Other Reimbursable (D3_HOS_C2_98),Charity care charges and uninsured discounts for the entire facility (S10_C1_20),Impl. Dev. Charged to Patients (D_4_IPF_C13_72),Radiology-Diagnostic (A_C6_54),"Average patient dialysis time 
including setup (S5_C4_3)","Net Expense for Cost Allocation, Nursing School (B_1_C0_20)",Radiology-Therapeutic (D3_IRF_C2_55),Renal 5 Provider Number (S2_1_C2_1804),OOT (B_1_C26_9930),"Net Expense for Cost Allocation, OLTC (B_1_C0_46)",Subprovider-IRF (D3_IRF_C2_40),Radiology-Therapeutic (D_4_IRF_C13_55),Total (C_1_C7_202),Medicare reimbursable bad debts for the entire hospital complex (S10_C1_27),Pass Through Cost for  Program Ancillary (D1_IRF_C1_51),Intravenous Therapy (D3_HOS_C2_64),Ambulance Services (B_1_C21_95),Physical Therapy (D_4_HOS_C12_66),"AMOUNT REPORTED, Interns & Residents (S3_2_C2_7)",Clinic (D_4_IPF_C11_90),Swing Bed SNF Provider Number (S2_1_C2_7),ASC (Non Distinct Part) (D_4_IPF_C11_75),Total Patient Days (D_3_HOS_C6_200),Provider's actual MSA or CBSA (S2_1_C3_3),"Blood Storing, Processing, Trans (D3_SNF_C3_63)","AMOUNT REPORTED, Physician-Part B (S3_2_C2_5)",ASC (Non Distinct Part) (D3_HOS_C2_75),PBP Clinical Lab Services Program Only (D3_IRF_C3_61),Electrocardiology (D_4_HOS_C13_69),Lung  Acquisition (B_1_C22_108),"Net Expense for Cost Allocation, Medical Supplies Charged to Patients (B_1_C0_71)",ASC (Non Distinct Part) (D_4_HOS_C10_75),Physical Therapy (C_1_C5_66),ICF (S3_1_C8_2001),State (S2_1_C2_143),SNF (S3_1_C10_19),IRF (S3_1_C6_17),"Gift, Flower, Coffee Shop, Canteen (B_1_C26_190)","Net Expense for Cost Allocation, Renal Dialysis (B_1_C0_74)",RHC 8 Provider Number (S2_1_C2_1507),"Net Expense for Cost Allocation, Kidney Acquisition (B_1_C0_105)","COST REIMBURSED SERVICES NOT SUBJECT TO DEDUCTIBLES AND COINSURANCE - CHARGES, ASC (Non Distinct Part) (D_5_HOS_C4_75)",Other Reimbursable (D_4_HOS_C2_98),Total (D_4_SNF_C13_200),Burn Intensive Care Unit (S3_1_C8_10),Respiratory Therapy (C_1_C2_65),CT Scan (C_1_C5_57),"Net Expense for Cost Allocation, Interns & Res Salary and Fringe Benefits (B_1_C0_21)","COST REIMBURSED SERVICES NOT SUBJECT TO DEDUCTIBLES AND COINSURANCE - CHARGES, CT Scan (D_5_HOS_C4_57)",Stand-alone CHIP cost (S10_C1_11),Electrocardiology (A_C6_69),"Total Outpatient Charges, Recovery Room (C_1_C7_51)","Allocation of Interns & Residents Salary and Fringes, Electrocardiology (B_1_C21_69)",Total costs for patients covered by a state or local government program (S10_C1_15),Hospital Adults & Pediatrics (S3_1_C6_1),Sale of medical records and abstracts (A8_C2_18),Intravenous Therapy (D_4_SNF_C11_64),Total discharges (S3_1_C15_16),Impl. Dev. Charged to Patients (D_4_HOS_C12_72),Clinic (C_1_C5_90),Adults & Pediatrics (D_1_HOS_C6_30),RHC 9 Provider Number (S2_1_C2_1508),Nursery (A_C1_43),Radioisotope (D_4_IRF_C13_56),Anesthesiology (D_4_HOS_C3_53),Other Special Care Unit (D3_HOS_C2_35),Electroencephalography (D3_IPF_C2_70),"COST SERVICES NOT SUBJECT TO DEDUCTIBLES AND COINSURANCE - COST, Recovery Room (D_5_HOS_C7_51)","Total Inpatient Charges, Other Special Care Unit (C_1_C6_35)",Surgical Intensive Care Unit (D3_IPF_C2_34),"COST REIMBURSED SERVICES SUBJECT TO DEDUCTIBLES  AND COINSURANCE - CHARGES, Blood Clotting Factors for Hemoph. (D_5_HOS_C3_6250)","ADJUSTED SALARIES, Housekeeping under contract (S3_2_C4_33)",Physical Therapy (A_C1_66),Sale of drugs to other than patients (A8_C2_17),"Disposals and Retirements, Land Improvements (A7_1_C5_2)",CMHC (C_1_C7_99),MRI (A_C1_58),MDH status ending date (MM/DD/YY) (S2_1_C2_38),"COST SERVICES NOT SUBJECT TO DEDUCTIBLES AND COINSURANCE - COST, Medical Supplies Charged to Patients (D_5_HOS_C7_71)",Central Services and Supply (A_C1_14),Burn Intensive Care Unit (S3_1_C5_10),Recovery Room (D_4_HOS_C13_51),Other Special Care Unit (D3_IRF_C2_35),"Allocation of Interns & Residents Salary and Fringes, Intravenous Therapy (B_1_C21_64)","PPS SERVICES COST, Cardiac Catheterization (D_5_HOS_C5_59)",Clinic (C_1_C6_90),Geographic MSA (MSA),"PPS REIMBURSED SERVICES -  CHARGES, Other Reimbursable (D_5_HOS_C2_98)",RHC 17 Provider Number (S2_1_C2_1516),"Net Expense for Cost Allocation, Ambulance Services (B_1_C0_95)",Durable Medical Equipment Rented (A_C6_96),"Net Expense for Cost Allocation, SNF (B_1_C0_44)",Radioisotope (C_1_C5_56),"COST SERVICES SUBJECT TO DEDUCTIBLES AND COINSURANCE - COST, Durable Medical Equipment Rented (D_5_HOS_C6_96)",Drugs Charged to Patients (D_4_HOS_C1_73),Operating Room (D_4_HOS_C4_50),Other Reimbursable (A_C2_98),Heart Acquisition (A_C2_106),Other Outpatient Services (D_4_HOS_C12_93),General Fund Balance (G_C1THRU4_52),MRI (D_4_HOS_C2_58),Int & Res (non approved teaching program (C_1_C5_100),"PPS SERVICES COST, CT Scan (D_5_HOS_C5_57)",NF (S3_1_C2_20),Speech Pathology (D3_IRF_C3_68),"HHA II, Without Outliers:  Non Routine Med Sup Chgs (S4_HHA2_C1_38)",Other Ancillary (A_C6_76),Adj for Respiratory therapy costs in excess (A8_C2_23),Total unreimbursed and uncompensated care (S10_C1_31),Other Outpatient Services (D_4_SNF_C11_93),OPT (A_C2_9920),Physical Therapy (D3_HOS_C2_66),Research (A_C2_191),"COST SERVICES NOT SUBJECT TO DEDUCTIBLES AND COINSURANCE - COST, Anesthesiology (D_5_HOS_C7_53)",Observation Beds (Distinct Unit) (D3_IPF_C3_9201),"Net Expense for Cost Allocation, Other Ancillary (B_1_C0_76)",Medical Supplies Charged to Patients (D3_HOS_C2_71),"HHA I, PEP:  Total Number of Outlier Episodes (S4_HHA1_C4_37)",Total Nonphysician Anesthetist Cost (D_4_IPF_C1_200),Pancreas Acquisition (B_2_C26_109),Subprovider-IPF (B_1_C26_40),Other Outpatient Services (D_4_HOS_C13_93),"ADJUSTED SALARIES, Interns & Residents (S3_2_C4_25)",Total Program General Inpatient Routine (D1_IRF_C1_41),Fixed Equipment (G_C1THRU4_19),"COST REIMBURSED SERVICES NOT SUBJECT TO DEDUCTIBLES AND COINSURANCE - CHARGES, Cardiac Catheterization (D_5_HOS_C4_59)",Ancillary service other pass through costs (E_B_HOS_C1_9),Physical Therapy (D_4_SNF_C11_66),Electrocardiology (B_1_C26_69),Kidney Acquisition (B_1_C22_105),Pancreas Acquisition (C_1_C7_109),"PAID HOURS RELATED TO SALARIES, Excluded Area Salaries (S3_3_C5_2)",Hospital Adlts & Ped Swing Bed SNF (S3_1_C7_5),Nursing Administration (A_C1_13),ASC (Non Distinct Part) (D3_SNF_C2_75),CMHC (B_1_C26_99),"Net Expense for Cost Allocation, Subprovider-IRF (B_1_C0_41)",Physicians' Private Office (B_2_C26_192),"COST SERVICES NOT SUBJECT TO DEDUCTIBLES AND COINSURANCE - COST, Clinic (D_5_HOS_C7_90)","HHA III, Total Charges (S4_HHA3_C5_35)",RHC 18 Provider Number (S2_1_C2_1517),Recovery Room (D_4_HOS_C12_51),"Other Capital Related Costs, New Cap Related Csts Movable Equipment (A7_3_C7_2)","Net Expense for Cost Allocation, CT Scan (B_1_C0_57)",Respiratory Therapy (D3_IPF_C2_65),CT Scan (D_4_HOS_C4_57),Recovery Room (D3_HOS_C3_51),"Average patient dialysis time 
including setup (S5_C1_3)",Intestinal Acquisition (B_1_C26_110),Anesthesiology (D3_HOS_C3_53),"Total Outpatient Charges, MRI (C_1_C7_58)","AMOUNT REPORTED, Interns & Residents (S3_2_C2_2551)",Electroencephalography (D_4_HOS_C3_70),Other Ancillary (D_4_HOS_C13_76),"Total Inpatient Charges, PBP Clinical Lab Services Program Only (C_1_C6_61)","PAID HOURS RELATED TO SALARIES, Contract Labor (S3_2_C5_11)",RHC/FQHC Combined (S3_1_C7_26),"Net Expense for Cost Allocation, Delivery Room and Labor Room (B_1_C0_52)","PPS SERVICES COST, Operating Room (D_5_HOS_C5_50)",Clinic (D_4_HOS_C10_90),Respiratory Therapy (D_4_IPF_C13_65),Home Program Dialysis (D3_IRF_C2_94),"Blood Storing, Processing, Trans (C_1_C7_63)","Allocation of Interns & Residents Salary and Fringes, Cardiac Catheterization (B_1_C21_59)",Other Special Care Unit (C_1_C5_35),"PPS SERVICES COST, Radiology-Diagnostic (D_5_HOS_C5_54)","PPS SERVICES COST, Clinic (D_5_HOS_C5_90)",Observation Beds (Distinct Unit) (B_1_C22_9201),Net Income from Service to Patients (G3_C1_5),"COST SERVICES SUBJECT TO DEDUCTIBLES AND COINSURANCE - COST, Delivery Room and Labor Room (D_5_HOS_C6_52)",Other Outpatient Services (D3_IPF_C3_93),MRI (D3_SNF_C2_58),Physicians' Private Office (A_C6_192),"Net Expense for Cost Allocation, ICF (B_1_C0_4501)","COST SERVICES NOT SUBJECT TO DEDUCTIBLES AND COINSURANCE - COST, Other Outpatient Services (D_5_HOS_C7_93)",Other Special Care Unit (B_1_C26_35),"AVERAGE HOURLY WAGE, Total Salaries (S3_2_C6_1)",Electroencephalography (B_2_C26_70),"HHA II, W/Out Outliers:  Number of Episodes (S4_HHA2_C1_36)",Other Reimbursable (D3_IRF_C2_98),"AVERAGE HOURLY WAGE, Excluded Area Salaries (S3_3_C6_2)","Gift, Flower, Coffee Shop, Canteen (B_1_C21_190)","AVERAGE HOURLY WAGE, Total Overhead Costs (S3_3_C6_7)",Labor and Delivery (S3_1_C2_32),Investment Income-New Bldgs & Fixtures (A8_C2_1),Respiratory Therapy (B_1_C26_65),"AMOUNT REPORTED, Home Office Salaries & Wage Related Csts (S3_2_C2_14)",Radioisotope (D_4_IPF_C11_56),Total (D_4_IPF_C11_200),Central Services and Supply (A_C6_14),"AVERAGE HOURLY WAGE, Subtotal Salaries (S3_3_C6_3)",Lung  Acquisition (A_C2_108),Kidney Acquisition (A_C6_105),Durable Medical Equipment Rented (B_1_C26_96),Subprovider I (C_1_C5_42),Respiratory Therapy (D_4_HOS_C3_65),Surgical Intensive Care Unit (C_1_C5_34),"Net Expense for Cost Allocation, Cafeteria (B_1_C0_11)",Other Reimbursable (A_C1_98),Burn Intensive Care Unit (S3_1_C4_10),Delivery Room and Labor Room (D3_IPF_C2_52),RHC 13 Provider Number (S2_1_C2_1512),Recovery Room (B_1_C26_51),Islet Acquisition (B_2_C26_111),"AVERAGE HOURLY WAGE, SNF (S3_2_C6_9)","Allocation of Interns & Residents Program Costs, Medical Supplies Charged to Patients (B_1_C22_71)",Other Reimbursable (B_1_C26_98),Employee Benefits (A_C6_4),Delivery Room and Labor Room (D_4_HOS_C13_52),ASC (Non Distinct Part) (B_1_C21_75),Radiology-Diagnostic (A_C1_54),Medical Supplies Charged to Patients (D3_IRF_C2_71),"PPS SERVICES COST, Occupational Therapy (D_5_HOS_C5_67)",Lung  Acquisition (A_C6_108),CT Scan (D_4_IRF_C13_57),"Allocation of Interns & Residents Program Costs, Burn Intensive Care Unit (B_1_C22_33)",Total cost (E_B_HOS_C1_11),Ambulance Services (B_1_C22_95),Title V discharges (S3_1_C12_16),"AMOUNT REPORTED, Laundry and Linen Service (S3_2_C2_31)",Laboratory (D_4_IRF_C13_60),"PPS REIMBURSED SERVICES -  CHARGES, ASC (Non Distinct Part) (D_5_HOS_C2_75)",Int & Res (non approved teaching program (A_C6_100),"Net Expense for Cost Allocation, Surgical Intensive Care Unit (B_1_C0_34)",Anesthesiology (D3_IPF_C2_53),Heart Acquisition (A_C1_106),Total Outpatient Program Pass Thru Cost (D_4_IRF_C6_200),"COST REIMBURSED SERVICES NOT SUBJECT TO DEDUCTIBLES AND COINSURANCE - CHARGES, Other Reimbursable (D_5_HOS_C4_98)",RHC 3 Provider Number (S2_1_C2_1502),Whole Blood & Packed Red Blood Cells (D3_IRF_C3_62),"Total Program Inpatient Operating Cost excluding Capital Related, Nonphysician, Anesthetist, and Medical Education Costs (D1_HOS_C1_53)","Number of Times per week 
Patient receives Dialysis (S5_C3_2)",Laboratory (D_4_HOS_C11_60),"Allocation of Interns & Residents Salary and Fringes, Radiology-Diagnostic (B_1_C21_54)",Int & Res (non approved teaching program (B_2_C26_100),Durable Medical Equipment Sold (C_1_C5_97),Other Outpatient Services (D_4_HOS_C4_93),Other Special Care Unit (D3_IPF_C2_35),"Net Expense for Cost Allocation, Subprovider I (B_1_C0_42)","COST SERVICES NOT SUBJECT TO DEDUCTIBLES AND COINSURANCE - COST, Operating Room (D_5_HOS_C7_50)",Other Outpatient Services (D_4_IRF_C11_93),Burn Intensive Care Unit (D_3_HOS_C9_33),Pharmacy (A_C6_15),Laboratory (A_C2_60),Pancreas Acquisition (A_C1_109),Home Office PO Box (S2_1_C2_142),"HHA III, Total Number of Episodes (S4_HHA3_C5_36)","ADJUSTED SALARIES, Total (S3_3_C4_6)",Interns & Res Other Program Costs (A_C1_22),"Allocation of Interns & Residents Program Costs, Anesthesiology (B_1_C22_53)",Observation Beds (Distinct Unit) (D3_SNF_C3_9201),"AMOUNT REPORTED, Excluded Areas (S3_2_C2_19)",Electroencephalography (D_4_HOS_C11_70),FQHC (C_1_C7_89),Is this hospital classified as a referral center? (Y/N) (S2_1_C1_116),"Total Inpatient Charges, Recovery Room (C_1_C6_51)",Whole Blood & Packed Red Blood Cells (D_4_HOS_C13_62),ASC (Non Distinct Part) (D_4_HOS_C3_75),Impl. Dev. Charged to Patients (A_C1_72),Total Other Income (G3_C1_25),Durable Medical Equipment Sold (D3_HOS_C2_97),FQHC 5 Provider Number (S2_1_C2_1604),Surgical Intensive Care Unit (S3_1_C4_11),Hospital Adults & Pediatrics (S3_1_C5_1),Intensive Care Unit (A_C6_31),Title XIX discharges (S3_1_C14_14),Intestinal Acquisition (C_1_C7_110),Anesthesiology (D_4_HOS_C2_53),Other Outpatient Services (D_4_HOS_C10_93),Physical Therapy (D3_SNF_C2_66),Nursing School (A8_C2_19),CT Scan (B_1_C26_57),Emergency (D3_HOS_C3_91),"AMOUNT REPORTED, Interns & Residents (S3_2_C2_25)",Radiology-Diagnostic (D3_IPF_C2_54),"PPS SERVICES COST, Other Reimbursable (D_5_HOS_C5_98)","Allocation of Interns & Residents Program Costs, SNF (B_1_C22_44)",Observation Beds (Distinct Unit) (D_4_IPF_C13_9201),Home Program Dialysis (B_1_C26_94),Clinic (D_4_HOS_C13_90),Home Program Dialysis (D3_HOS_C3_94),Drugs Charged to Patients (D3_IPF_C3_73),"COST REIMBURSED SERVICES NOT SUBJECT TO DEDUCTIBLES AND COINSURANCE - CHARGES, Renal Dialysis (D_5_HOS_C4_74)","COST SERVICES NOT SUBJECT TO DEDUCTIBLES AND COINSURANCE - COST, Radiology-Therapeutic (D_5_HOS_C7_55)",Hospice (S3_1_C6_24),Speech Pathology (D_4_IPF_C11_68),"COST SERVICES SUBJECT TO DEDUCTIBLES AND COINSURANCE - COST, ASC (Non Distinct Part) (D_5_HOS_C6_75)",Refunds and Rebates of Expenses (A8_C2_5),Whole Blood & Packed Red Blood Cells (D_4_HOS_C10_62),Clinic (D3_SNF_C3_90),Subtotal (E_B_HOS_C1_30),MRI (D_4_IRF_C13_58),Cost of charity care (uninsured patients + patients w/ coverage not accepted by provider) (S10_C1_23),Operating Room (D_4_HOS_C13_50),Total Other Assets (G_C1THRU4_35),Renal Dialysis (D3_SNF_C2_74),Speech Pathology (D_4_IPF_C13_68),Total Inpatient Program Days (D_3_HOS_C8_200),Interns and residents (E_B_HOS_C1_22),Radiology-Diagnostic (D_4_HOS_C11_54),"TOTAL CAPITAL COSTS AFTER COST ALLOCATION, Operating Room (B_2_C26_50)","COST REIMBURSED SERVICES NOT SUBJECT TO DEDUCTIBLES AND COINSURANCE - CHARGES, Emergency (D_5_HOS_C4_91)",Coronary Care Unit Program Cost (D1_HOS_C5_44),Impl. Dev. Charged to Patients (C_1_C6_72),Hospice (S3_1_C2_24),Drugs Charged to Patients (D_4_IPF_C13_73),"COST REIMBURSED SERVICES NOT SUBJECT TO DEDUCTIBLES AND COINSURANCE - CHARGES, Blood Storing, Processing, Trans (D_5_HOS_C4_63)",Electrocardiology (D3_IRF_C2_69),Respiratory Therapy (D_4_HOS_C4_65),Other Outpatient Services (D3_SNF_C3_93),Laboratory (D3_HOS_C2_60),Subprovider 1 (S3_1_C7_18),"General Inpatient Routine Service Cost, net of Swing Bed Cost (D1_IRF_C1_27)",Speech Pathology (D_4_HOS_C2_68),CT Scan (D_4_HOS_C3_57),Cardiac Catheterization (D_4_HOS_C4_59),Other Outpatient Services (D_4_IPF_C11_93),Respiratory Therapy (D3_IRF_C2_65),Delivery Room and Labor Room (D_4_HOS_C11_52),Home Program Dialysis (D_4_HOS_C2_94),Total (D_4_IPF_C13_200),Radiology-Therapeutic (D3_SNF_C2_55),"Does this facility operate 
transplant center? (Y/N) (S2_1_C1_125)","ADJUSTED SALARIES, Teaching Physician Salaries (S3_2_C4_1601)",ICF (S3_1_C3_2001),Electroencephalography (D3_IRF_C2_70),Electrocardiology (D3_IRF_C3_69),Burn Intensive Care Unit Program Cost (D1_HOS_C5_45),Other Outpatient Services (A_C1_93),Interim payments (E_B_HOS_C1_41),Surgical Intensive Care Unit (S3_1_C2_11),"COST REIMBURSED SERVICES NOT SUBJECT TO DEDUCTIBLES AND COINSURANCE - CHARGES, Operating Room (D_5_HOS_C4_50)",Pass through Cost for Program Inpatient Routine (D1_HOS_C1_50),Cardiac Catheterization (D3_IPF_C2_59),"PPS SERVICES COST, Electroencephalography (D_5_HOS_C5_70)",Physical Therapy (D_4_HOS_C11_66),Emergency (D_4_HOS_C11_91),"Total Program Inpatient Operating Cost excluding Capital Related, Nonphysician, Anesthetist, and Medical Education Costs (D1_IPF_C1_53)",MDH status beginning date  (MM/DD/YY) (S2_1_C1_3801),Intensive Care Unit (D_3_HOS_C9_31),"AMOUNT REPORTED, Non-Physician Anesthetist Part B (S3_2_C2_3)",Electroencephalography (D_4_HOS_C13_70),"ADJUSTED SALARIES, Medical Records & Med Records Library (S3_2_C4_41)",PBP Clinical Lab Services Program Only (A_C2_61),"PPS REIMBURSED SERVICES -  CHARGES, MRI (D_5_HOS_C2_58)",ASC (Distinct Part) (A_C2_115),Radiology-Diagnostic (D3_IRF_C3_54),Home Program Dialysis (D_4_HOS_C12_94),Less Observation Beds (C_1_C5_201),Title XIX discharges (S3_1_C14_17),Other Special Purpose (C_1_C6_117),Other Outpatient Services (D_4_IRF_C13_93),"Are there any related organization or how office costs as defined in HCFA Pub. 15-I, chapter 10? (Y/N) (S2_1_C1_140)",Urban (1) or Rural (2) (S2_1_C1_27),RPCH/CAH Visits (S3_1_C6_15),CORF (C_1_C7_9910),Maintenance of Personnel (A_C1_12),Electrocardiology (D_4_HOS_C2_69),ASC (Non Distinct Part) (D3_HOS_C3_75),Radiology-Therapeutic (D3_HOS_C3_55),Subprovider-IPF (A_C2_40),"Total Inpatient Charges, Radiology-Diagnostic (C_1_C6_54)",Subprovider 2 (S3_1_C7_1801),"ADJUSTED SALARIES, Interns & Residents (S3_2_C4_2553)",Radioisotope (D_4_HOS_C2_56),Adjusted reimburseable bad debts (E_B_HOS_C1_35),"Net Expense for Cost Allocation, Islet Acquisition (B_1_C0_111)",Medical Records and Medical Rec. Library (A_C6_16),Occupational Therapy (D3_IPF_C2_67),"PPS SERVICES COST, Speech Pathology (D_5_HOS_C5_68)","Net Expense for Cost Allocation, Intestinal Acquisition (B_1_C0_110)",IRF (S3_1_C2_17),Total Adults & Pediatrics (S3_1_C8_7),Nursery (S3_1_C8_13),"AVERAGE HOURLY WAGE, Home Office Personnel (S3_2_C6_8)",Other Ancillary (D_4_IRF_C13_76),Cardiac Catheterization (C_1_C5_59),FQHC 9 Provider Number (S2_1_C2_1608),Observation Beds (Distinct Unit) (D_4_HOS_C3_9201),Does the hospital elect a fully prospective payment method for capital costs? (Y/N) (S2_1_C1_48),Burn Intensive Care Unit (D_1_HOS_C6_33),"Total Inpatient Charges, Subprovider-IPF (C_1_C6_40)",Burn Intensive Care Unit (D3_IRF_C2_33),Operating Room (D3_SNF_C3_50),Clinic (D3_IPF_C3_90),Other Reimbursable (D3_IRF_C3_98),"Net Expense for Cost Allocation, Durable Medical Equipment Rented (B_1_C0_96)",Maintenance and Repairs (A_C1_6),"Disposals and Retirements, Building Improvements (A7_1_C5_4)","Allocation of Interns & Residents Salary and Fringes, Adults and Pediatrics (B_1_C21_30)",OOT (C_1_C5_9930),SNF (S3_1_C7_19),Other Ancillary (B_1_C21_76),"HHA III, Total Visits (S4_HHA3_C5_33)",Non-physician Anesthetist (A8_C2_28),"ADJUSTED SALARIES, Total Overhead Costs (S3_3_C4_7)",Impl. Dev. Charged to Patients (D3_HOS_C3_72),ASC (Distinct Part) (A_C1_115),"COST SERVICES SUBJECT TO DEDUCTIBLES AND COINSURANCE - COST, Impl. Dev. Charged to Patients (D_5_HOS_C6_72)",Subprovider-IRF (D3_IRF_C2_41),MSP-LCC reconciliation amount (E_B_HOS_C1_38),CMHC (A_C6_99),"PPS REIMBURSED SERVICES -  CHARGES, Blood Clotting Factors for Hemoph. (D_5_HOS_C2_6250)",ASC (Non Distinct Part) (D_4_HOS_C12_75),Total (S3_1_C2_7),Intensive Care Unit (S3_1_C2_8),Observation Beds (Distinct Unit) (B_2_C26_9201),CT Scan (D3_SNF_C2_57),"Allocation of Interns & Residents Program Costs, Radiology-Diagnostic (B_1_C22_54)",Total Outpatient Program Pass Thru Cost (D_4_HOS_C6_200),"Net Expense for Cost Allocation, Physical Therapy (B_1_C0_66)",Total Program Excludable Costs (D1_IPF_C1_52),Drugs Charged to Patients (A_C6_73),Hospital Title 18 Payment System (P/T/O) (S2_1_C7_3),NF (A_C6_45),Total Hospital (S3_1_C3_7),Intensive Care Unit (S3_1_C5_8),Operation of Plant (A_C6_7),Surgical Intensive Care Unit (A_C1_34),Organ Procurement (D4_LUNG_C1_69),Nursery (D3_HOS_C2_43),"PPS SERVICES COST, Other Outpatient Services (D_5_HOS_C5_93)","COST REIMBURSED SERVICES SUBJECT TO DEDUCTIBLES  AND COINSURANCE - CHARGES, Durable Medical Equipment Rented (D_5_HOS_C3_96)",Swing Bed NF Provider Number (S2_1_C2_8),Cross Foot Adjustments (B_1_C26_200),Radiology-Therapeutic (C_1_C5_55),"Beginning Balances, Fixed Equipment (A7_1_C1_5)",Laboratory (D3_HOS_C3_60),Blood Clotting Factors for Hemoph. (B_1_C26_6250),"HHA II, With Outliers:  Total Visits (S4_HHA2_C2_33)",Electroencephalography (A_C6_70),Total Hospital (S3_1_C4_14),Liver Acquisition (C_1_C7_107),"Net Expense for Cost Allocation, Liver Acquisition (B_1_C0_107)","TOTAL CAPITAL COSTS AFTER COST ALLOCATION, Radiology-Therapeutic (B_2_C26_55)",Delivery Room and Labor Room (C_1_C5_52),"Taxes, New Cap Related Csts Bldg & Fixtures (A7_3_C6_1)","AVERAGE HOURLY WAGE, Nursing Administration (S3_2_C6_38)","COST SERVICES NOT SUBJECT TO DEDUCTIBLES AND COINSURANCE - COST, Physical Therapy (D_5_HOS_C7_66)","HHA I, Total Visits (S4_HHA1_C5_33)","Other Capital Related Costs, Total (A7_3_C7_3)",Radiology-Diagnostic (D_4_IPF_C13_54),Total Program Excludable Costs (D1_HOS_C1_52),Cardiac Catheterization (D_4_HOS_C10_59),"Allocation of Interns & Residents Program Costs, Radiology-Therapeutic (B_1_C22_55)",Organ Procurement (D4_KIDNEY_C1_69),"Insurance, New Cap Related Csts Movable Equipment (A7_3_C5_2)",Coronary Care Unit (A_C2_32),"Net Expense for Cost Allocation, Intensive Care Unit (B_1_C0_31)","Net Expense for Cost Allocation, Electrocardiology (B_1_C0_69)","Net Expense for Cost Allocation, Other Organ Acquisition (B_1_C0_112)","HHA I, W/Out Outliers:  Number of Episodes (S4_HHA1_C1_36)","Net Expense for Cost Allocation, Housekeeping (B_1_C0_9)",ASC (Non Distinct Part) (C_1_C5_75),"Net Expense for Cost Allocation, Electroencephalography (B_1_C0_70)",Respiratory Therapy (D3_IRF_C3_65),Pass Through Cost for  Program Ancillary (D1_HOS_C1_51),Title XVIII discharges (S3_1_C13_1),Ambulance Services (C_1_C7_95),Subprovider 2 (S3_1_C2_1801),"HHA I, PEP Episodes:  Other Charges (S4_HHA1_C4_34)",FQHC 7 Provider Number (S2_1_C2_1606),Outpatient Revenue (G2_C2_28),"AMOUNT REPORTED, Maintenance of Personnel (S3_2_C2_37)",Program Discharges (D1_HOS_C1_54),"Donations, Land (A7_1_C3_1)",Intensive Care Unit (D3_IPF_C2_31),"Allocation of Interns & Residents Program Costs, Operating Room (B_1_C22_50)","Number of patients in program at 
end of cost reporting period (S5_C5_1)",CT Scan (A_C2_57),Electroencephalography (D_4_IPF_C11_70),Total unreimbursed cost for Medicaid and CHIP and state and local indigent care programs (S10_C1_19),Whole Blood & Packed Red Blood Cells (A_C2_62),Burn Intensive Care Unit (B_1_C26_33),Recovery Room (A_C2_51),"COST SERVICES NOT SUBJECT TO DEDUCTIBLES AND COINSURANCE - COST, Total (D_5_HOS_C7_200)",Net Income (G3_C1_29),Total discharges (S3_1_C15_14),certification date (S2_1_C1_131),Physical Therapy (D_4_IPF_C13_66),Occupational Therapy (A_C1_67),"Net Expense for Cost Allocation, Clinic (B_1_C0_90)",Hospice (A_C6_116),Hospice (S3_1_C7_24),Total Hospital (S3_1_C3_14),Other Ancillary (D3_IPF_C2_76),Renal Dialysis (D3_IRF_C3_74),HMO (S3_1_C6_2),"HHA III, With Outliers:  Number of Episodes (S4_HHA3_C2_37)","COST SERVICES NOT SUBJECT TO DEDUCTIBLES AND COINSURANCE - COST, Emergency (D_5_HOS_C7_91)",Radioisotope (D_4_HOS_C4_56),Intensive Care Unit (C_1_C5_31),Clinic (D3_IRF_C2_90),"Interest, New Cap Related Csts Bldg & Fixtures (A7_3_C11_1)","ADJUSTED SALARIES, Other General Service (S3_2_C4_43)",RHC (C_1_C6_88),Radioisotope (B_1_C26_56),"TOTAL CAPITAL COSTS AFTER COST ALLOCATION, Subprovider-IRF (B_2_C26_41)",ASC (Distinct Part) (C_1_C5_115),Renal Dialysis (C_1_C7_74),"Net Expense for Cost Allocation, MRI (B_1_C0_58)",Total Subprovider I Interns & Residents (S3_1_C9_18),Durable Medical Equipment Sold (A_C1_97),"PAID HOURS RELATED TO SALARIES, Other General Service (S3_2_C5_43)","COST REIMBURSED SERVICES NOT SUBJECT TO DEDUCTIBLES AND COINSURANCE - CHARGES, Speech Pathology (D_5_HOS_C4_68)","Sum of lines 3,4 divided by line 6 (E_B_HOS_C101_7)",Electroencephalography (D_4_HOS_C4_70),Total Hospital (S3_1_C5_7),Occupational Therapy (C_1_C6_67),Utilization Code (L/N/F) (UTIL_CODE),"COST REIMBURSED SERVICES NOT SUBJECT TO DEDUCTIBLES AND COINSURANCE - CHARGES, Impl. Dev. Charged to Patients (D_5_HOS_C4_72)",ASC (Non Distinct Part) (D_4_HOS_C11_75),Recovery Room (D_4_HOS_C10_51),Total Fund Balances (G_C1THRU4_53),Other Reimbursable (D_4_HOS_C11_98),Subprovider-IRF (D3_SNF_C2_41),Recovery Room (D3_IPF_C2_51),"Number of patients on transplant 
list (S5_C1_11)","AMOUNT REPORTED, Interns & Residents (S3_2_C3_2553)","HHA I, With Outliers:  Other Charges (S4_HHA1_C2_34)",Component rate ESRD (E_B_HOS_C1_33),"Blood Storing, Processing, Trans (A_C1_63)",Speech Pathology (D3_HOS_C2_68),HHA (C_1_C5_101),Operating Room (D_4_HOS_C10_50),ASC (Non Distinct Part) (D3_IRF_C3_75),"COST REIMBURSED SERVICES SUBJECT TO DEDUCTIBLES  AND COINSURANCE - CHARGES, Occupational Therapy (D_5_HOS_C3_67)","AMOUNT REPORTED, Excluded Area Salaries (S3_3_C2_2)","Net Expense for Cost Allocation, Int & Res (non approved teaching program (B_1_C0_100)",Total Nonphysician Anesthetist Cost (D_4_IRF_C1_102),Renal Dialysis (D3_IRF_C2_74),Occupational Therapy (A_C6_67),Burn Intensive Care Unit (D3_IPF_C2_33),"Number of days in year dialysis 
furnished (S5_C2_5)","COST REIMBURSED SERVICES SUBJECT TO DEDUCTIBLES  AND COINSURANCE - CHARGES, Durable Medical Equipment Sold (D_5_HOS_C3_97)",Renal Dialysis (D_4_IRF_C13_74),Number of stations (S5_C4_6),OSP (C_1_C5_9940),"PAID HOURS RELATED TO SALARIES, Management and Administrative Services (S3_2_C5_12)",RHC (C_1_C7_88),RHC 25 Provider Number (S2_1_C2_1524),"Total Inpatient Charges, Cardiac Catheterization (C_1_C6_59)",Physical Therapy (A_C2_66),Clinic (D_4_HOS_C11_90),Occupational Therapy (D_4_HOS_C2_67),"PPS REIMBURSED SERVICES -  CHARGES, Whole Blood & Packed Red Blood Cells (D_5_HOS_C2_62)","AMOUNT REPORTED, Physician Part B (S3_2_C2_23)",Clinic (D_4_SNF_C11_90),"AMOUNT REPORTED, Non-Physician Part B (S3_2_C2_6)","ADJUSTED SALARIES, Related Salaries (S3_2_C4_1402)",Total Liabilities and Fund Balances (G_C1THRU4_54),Hospice 3 Provider Number (S2_1_C2_1402),Interest Expense (A_C6_113),"COST REIMBURSED SERVICES NOT SUBJECT TO DEDUCTIBLES AND COINSURANCE - CHARGES, Recovery Room (D_5_HOS_C4_51)","Allocation of Interns & Residents Salary and Fringes, Recovery Room (B_1_C21_51)",Beginning Date of SCH status (S2_1_C1_36),"COST SERVICES SUBJECT TO DEDUCTIBLES AND COINSURANCE - COST, Other Reimbursable (D_5_HOS_C6_98)",CT Scan (D_4_HOS_C12_57),"HHA II, PEP Episodes:  Total Number of Episodes (S4_HHA2_C4_36)",OOT (B_2_C26_9930),"PPS REIMBURSED SERVICES -  CHARGES, Medical Supplies Charged to Patients (D_5_HOS_C2_71)",Durable Medical Equipment Sold (D_4_HOS_C12_97),Radiology-Therapeutic (D_4_HOS_C12_55),Total (D_4_HOS_C12_200),Intravenous Therapy (B_2_C26_64),"COST SERVICES SUBJECT TO DEDUCTIBLES AND COINSURANCE - COST, Laboratory (D_5_HOS_C6_60)",Respiratory Therapy (A_C2_65),"Net Expense for Cost Allocation, NF (B_1_C0_45)",Recovery Room (D_4_HOS_C11_51),"PAID HOURS RELATED TO SALARIES, Physician-Part A (S3_2_C5_4)","COST REIMBURSED SERVICES SUBJECT TO DEDUCTIBLES  AND COINSURANCE - CHARGES, Recovery Room (D_5_HOS_C3_51)",Laboratory (A_C6_60),"PPS SERVICES COST, Observation Beds (Distinct Unit) (D_5_HOS_C5_9201)",NF (S3_1_C9_20),Intensive Care Unit (S3_1_C7_8),Speech Pathology (D3_IRF_C2_68),Cost of patients approved for charity care and uninsured discounts (S10_C2_21),CMHC (A_C2_99),Physicians' Private Office (B_1_C26_192),"AVERAGE HOURLY WAGE, Pharmacy (S3_2_C6_40)",Other Organ Acquisition (A_C2_112),Other Nonreimbursable (A_C2_194),ASC (Distinct Part) (B_1_C21_115),"Allocation of Interns & Residents Salary and Fringes, Physical Therapy (B_1_C21_66)",Total Allied Health (D_4_IRF_C3_200),Radioisotope (D_4_IPF_C13_56),Subprovider-IPF (D3_SNF_C2_40),Buildings (G_C1THRU4_15),Recovery Room (A_C1_51),Observation Beds (Distinct Unit) (D_4_HOS_C13_9201),Other Reimbursable (B_1_C21_98),Impl. Dev. Charged to Patients (C_1_C5_72),"If this Hospital is claiming cost for renal services on Worksheet A, are they inpatient services only? (Y/N) (S2_1_C1_145)","ADJUSTED SALARIES, Non-Physician Anesthetist Part B (S3_2_C4_3)",Nursing School (A_C6_20),"COST REIMBURSED SERVICES NOT SUBJECT TO DEDUCTIBLES AND COINSURANCE - CHARGES, Home Program Dialysis (D_5_HOS_C4_94)","PAID HOURS RELATED TO SALARIES, Interns & Residents (S3_2_C5_7)",Occupational Therapy (D3_SNF_C2_67),"PAID HOURS RELATED TO SALARIES, Medical Records & Med Records Library (S3_2_C5_41)","AVERAGE HOURLY WAGE, Related Salaries (S3_2_C6_1402)",Nonphysician Anesthetists (A_C6_19),"COST REIMBURSED SERVICES SUBJECT TO DEDUCTIBLES  AND COINSURANCE - CHARGES, Medical Supplies Charged to Patients (D_5_HOS_C3_71)","PPS REIMBURSED SERVICES -  CHARGES, Anesthesiology (D_5_HOS_C2_53)",Occupational Therapy (B_2_C26_67),Total Charges (C_1_C8_202),Whole Blood & Packed Red Blood Cells (D_4_IRF_C13_62),Delivery Room and Labor Room (D_4_HOS_C12_52),Number of Times per week Patient receives Dialysis (S5_C1_2),Title XIX discharges (S3_1_C14_16),RHC 1 Provider Number (S2_1_C2_15),Utilization Review SNF (A_C6_114),"Disposals and Retirements, Land (A7_1_C5_1)",Coronary Intensive Care Unit (D_1_HOS_C6_32),Speech Pathology (D_4_HOS_C4_68),"ADJUSTED SALARIES, Social Service (S3_2_C4_42)",Hospice (C_1_C7_116),"Interest, New Cap Related Csts Movable Equipment (A7_3_C11_2)",MRI (A_C6_58),Subprovider-IPF (D_1_HOS_C6_40),Observation Beds (Distinct Unit) (D3_IRF_C2_9201),"HHA I, PEP Episodes:  Total Number of Episodes (S4_HHA1_C4_36)","Allocation of Interns & Residents Salary and Fringes, Radiology-Therapeutic (B_1_C21_55)","Allocation of Interns & Residents Program Costs, Other Special Care Unit (B_1_C22_35)",Renal Dialysis (D_4_HOS_C12_74),"PPS SERVICES COST, Durable Medical Equipment Rented (D_5_HOS_C5_96)","HHA II, With Outliers:  Non Routine Med Sup Chgs (S4_HHA2_C2_38)",Physical Therapy (B_2_C26_66),"Net costs of Epoietin furnished to
all maintenance dialysis patients
by the provider (S5_C1_13)",Electroencephalography (C_1_C5_70),Laboratory (A_C1_60),"PPS REIMBURSED SERVICES -  CHARGES, Cardiac Catheterization (D_5_HOS_C2_59)",Medical Supplies Charged to Patients (B_2_C26_71),"Net Expense for Cost Allocation, Speech Pathology (B_1_C0_68)",Laboratory (D_4_IPF_C13_60),IPF (S3_1_C5_16),Burn Intensive Care Unit (S3_1_C6_10),Renal Dialysis (D3_HOS_C2_74),"Gift, Flower, Coffee Shop, Canteen (A_C6_190)",New Capital Equipment (A_C6_2),Total (D_1_HOS_C6_200),Drugs Charged to Patients (D3_IRF_C2_73),"AMOUNT REPORTED, Non-Physician Anesthetist Part A (S3_2_C2_20)",Coronary Intensive Care Unit (D_1_HOS_C4_32),Laboratory (D3_SNF_C2_60),Physicians' Private Office (A_C2_192),"COST SERVICES SUBJECT TO DEDUCTIBLES AND COINSURANCE - COST, Ambulance Services (D_5_HOS_C6_95)",Intensive Care Unit (D3_HOS_C2_31),Whole Blood & Packed Red Blood Cells (D3_IPF_C3_62),Other Long-term Liabilities (G_C1THRU4_49),Coronary Care Unit (B_1_C26_32),ICF (A_C2_4501),Durable Medical Equipment Rented (D3_SNF_C3_96),"AMOUNT REPORTED, Related Salaries (S3_2_C3_1402)",Total Adults & Peds (S3_1_C6_7),"HHA I, Without Outliers:  Total Visits (S4_HHA1_C1_33)",Anesthesiology (D_4_HOS_C4_53),Home Program Dialysis (A_C6_94),OPT (A_C6_9920),Laboratory (D_4_HOS_C13_60),RHC 7 Provider Number (S2_1_C2_1506),"TOTAL CAPITAL COSTS AFTER COST ALLOCATION, Delivery Room and Labor Room (B_2_C26_52)","HHA III, Total Other Charges (S4_HHA3_C5_34)","Fully Depreciated Assets, Assets (A7_1_C7_7)",HHA 3 Provider Number (S2_1_C2_1202),ASC (Non Distinct Part) (D3_IPF_C2_75),Subtotal (E_B_HOS_C1_32),Coronary Care Unit (D_3_HOS_C9_32),Other Reimbursable (C_1_C7_98),Subprovider II (A_C6_4201),Other Reimbursable (B_1_C22_98),"Total Inpatient Charges, Nursery (C_1_C6_43)",Radiology-Therapeutic (D_4_IRF_C11_55),Administrative and General (A_C2_5),Delivery Room and Labor Room (D3_SNF_C3_52),Surgical Intensive Care Unit (S3_1_C3_11),"Allocation of Interns & Residents Program Costs, Nursery (B_1_C22_43)",Land Improvements (G_C1THRU4_13),Adj for Speech therapy in excess of lim (A8_C2_31),Clinic (D3_IRF_C3_90),"COST SERVICES SUBJECT TO DEDUCTIBLES AND COINSURANCE - COST, Total (D_5_HOS_C6_200)",Payment to cost ratio (E_B_HOS_C101_5),"PAID HOURS RELATED TO SALARIES, Subtotal Other Wages and Related Csts (S3_3_C5_4)","ADJUSTED SALARIES, Wage Related Costs Core (S3_2_C4_17)",Cost of patients approved for charity care and uninsured discounts (S10_C3_21),"TOTAL CAPITAL COSTS AFTER COST ALLOCATION, Whole Blood & Packed Red Blood Cells (B_2_C26_62)","Insurance, Total (A7_3_C5_3)",Hospice (A_C1_116),"PAID HOURS RELATED TO SALARIES, Employee Benefits (S3_2_C5_26)",CT Scan (D_4_HOS_C2_57),or allied health costs? (S2_1_C1_60),Other Ancillary (D3_HOS_C3_76),Durable Medical Equipment Sold (C_1_C6_97),ASC (Non Distinct Part) (D3_SNF_C3_75),CORF (B_1_C26_9910),"Number of patients in program at 
end of cost reporting period (S5_C4_1)","PPS SERVICES COST, Recovery Room (D_5_HOS_C5_51)",Total (B_1_C26_202),Emergency (C_1_C6_91),"HHA III, PEP Episodes:  Total Visits (S4_HHA3_C4_33)","COST REIMBURSED SERVICES NOT SUBJECT TO DEDUCTIBLES AND COINSURANCE - CHARGES, Electroencephalography (D_5_HOS_C4_70)",Other Outpatient Services (D3_HOS_C2_93),"ADJUSTED SALARIES, Dietary under contract (S3_2_C4_35)","HHA II, Total Non Routine Medical  Supply Charges (S4_HHA2_C5_38)",HHA 2 Provider Number (S2_1_C2_1201),Coronary Care Unit (S3_1_C6_9),"Trade, Quantity, and Time Discounts (A8_C2_4)","Donations, Land Improvements (A7_1_C3_2)","Allocation of Interns & Residents Program Costs, Intravenous Therapy (B_1_C22_64)",Renal Dialysis (D3_HOS_C3_74),Occupational Therapy (D_4_HOS_C10_67),"Net Expense for Cost Allocation, Other Special Purpose (B_1_C0_117)",Home Office Name (S2_1_C1_141),Received DSH or supplemental payments from Medicaid? (Y/N) (S10_C1_3),"COST REIMBURSED SERVICES SUBJECT TO DEDUCTIBLES  AND COINSURANCE - CHARGES, Impl. Dev. Charged to Patients (D_5_HOS_C3_72)",Clinic (D3_HOS_C3_90),Hospice (C_1_C6_116),Impl. Dev. Charged to Patients (D_4_HOS_C11_72),"HHA I, Total Number of Outlier Episodes (S4_HHA1_C5_37)",Other Ancillary (D3_IPF_C3_76),Organ Procurement (D4_HEART_C1_69),"Fully Depreciated Assets, Donations (A7_1_C3_7)",Maintenance and Repairs (A_C2_6),Other Capital (A_C6_3),Occupational Therapy (B_1_C26_67),Sequestration adjustment (E_B_HOS_C1_4001),Impl. Dev. Charged to Patients (D_4_HOS_C3_72),Target Amount (D1_HOS_C1_56),Total (D_4_IRF_C11_200),"TOTAL CAPITAL COSTS AFTER COST ALLOCATION, Radioisotope (B_2_C26_56)",Interns & Res Other Program Costs (A_C6_22),Speech Pathology (C_1_C2_68),"Net Expense for Cost Allocation, Coronary Care Unit (B_1_C0_32)","Blood Storing, Processing, Trans (C_1_C6_63)",Other Special Care Unit (D_1_HOS_C4_35),Emergency (D3_IPF_C3_91),Home Program Dialysis (B_1_C22_94),Home Program Dialysis (D3_SNF_C3_94),"Net Expense for Cost Allocation, ASC (Non Distinct Part) (B_1_C0_75)",Heart Acquisition (C_1_C5_106),"COST SERVICES NOT SUBJECT TO DEDUCTIBLES AND COINSURANCE - COST, ASC (Non Distinct Part) (D_5_HOS_C7_75)",Blood Clotting Factors for Hemoph. (D3_HOS_C2_6250),RHC 22 Provider Number (S2_1_C2_1521),Coronary Care Unit (D3_SNF_C2_32),Intensive Care Unit (D_1_HOS_C4_31),Other Special Care Unit (A_C2_35),Employee Benefits (A_C1_4),Subprovider II (A_C2_4201),Physical Therapy (D_4_HOS_C13_66),"COST SERVICES SUBJECT TO DEDUCTIBLES AND COINSURANCE - COST, Other Ancillary (D_5_HOS_C6_76)",Hospice (A_C2_116),Other Outpatient Services (A_C6_93),"Fully Depreciated Assets, Disp. And Retirement (A7_1_C5_7)","ADJUSTED SALARIES, Teaching Physician Salaries (S3_2_C4_1602)",Operating Room (D3_HOS_C2_50),"Net Expense for Cost Allocation, Other Nonreimbursable (B_1_C0_194)",HHA (B_2_C26_101),Clinic (B_1_C26_90),Kidney Acquisition (A_C2_105),IPF Provider Number (S2_1_C1_4),SNF Provider Number (S2_1_C2_9),Respiratory Therapy (B_2_C26_65),RHC 15 Provider Number (S2_1_C2_1514),Intensive Care Unit (S3_1_C4_8),RHC (B_1_C21_88),"PPS SERVICES COST, Laboratory (D_5_HOS_C5_60)","Blood Storing, Processing, Trans (D_4_HOS_C3_63)",MCP Physician Payment Method (Y/N) (S5_C1_21),Subprovider 1 (S3_1_C2_18),"AVERAGE HOURLY WAGE, Non-Physician Anesthetist Part B (S3_2_C6_3)",Does the hospital qualify as RPCH/CAH? (Y/N) (S2_1_C1_105),Anesthesiology (A_C6_53),Self Insurance (S2_1_C3_11801),PBP Clinical Lab Services Program Only (D3_HOS_C2_61),OLTC (S3_1_C10_21),"Allocation of Interns & Residents Program Costs, NF (B_1_C22_45)","PPS SERVICES COST, Radiology-Therapeutic (D_5_HOS_C5_55)",Total customary charges (E_B_HOS_C1_18),Fiscal Year End Date (FY_END_DT),Medicare Certified Islet TC term date (S2_1_C2_132),FQHC 4 Provider Number (S2_1_C2_1603),Emergency (D_4_IPF_C13_91),"General Inpatient Routine Service Cost, net of Swing Bed Cost (D1_IPF_C1_27)","Total Outpatient Charges, Radioisotope (C_1_C7_56)",FI/Contractor's Name (S2_1_C2_140),Laboratory (D_4_IRF_C11_60),"ADJUSTED SALARIES, Interns & Residents (S3_2_C4_2550)","Net Expense for Cost Allocation, Home Program Dialysis (B_1_C0_94)","Net Expense for Cost Allocation, CMHC (B_1_C0_99)","HHA III, LUPA Episodes:  Total Number of Episodes (S4_HHA3_C3_36)",Ambulance Services (B_1_C26_95),"AMOUNT REPORTED, Interns & Residents (S3_2_C2_2552)",Durable Medical Equipment Sold (D_4_HOS_C10_97),Medical Supplies Charged to Patients (D_4_HOS_C11_71),"Average patient dialysis time 
including setup (S5_C3_3)","Donations, Subtotal (A7_1_C3_8)","Total Outpatient Charges, CT Scan (C_1_C7_57)",Radiology-Therapeutic (D3_HOS_C2_55),Subtotal (E_B_HOS_C1_27),Durable Medical Equipment Rented (D3_HOS_C2_96),FQHC (C_1_C5_89),ASC (Non Distinct Part) (D3_IRF_C2_75),Charity care charges and uninsured discounts for the entire facility (S10_C3_20),"HHA II, PEP:  Total Number of Outlier Episodes (S4_HHA2_C4_37)","PPS SERVICES COST, Blood Storing, Processing, Trans (D_5_HOS_C5_63)","Allocation of Interns & Residents Program Costs, Intensive Care Unit (B_1_C22_31)","AMOUNT REPORTED, Administrative and General (S3_2_C2_27)","AVERAGE HOURLY WAGE, Contract Labor:  Physician Part A (S3_2_C6_13)",Other Special Purpose (A_C1_117),Other Nonreimbursable (B_1_C22_194),Blood Clotting Factors for Hemoph. (D_4_HOS_C12_6250),"AVERAGE HOURLY WAGE, Home Office Salaries (S3_2_C6_1401)","Net Expense for Cost Allocation, CORF (B_1_C0_9910)",Intestinal Acquisition (C_1_C6_110),Delivery Room and Labor Room (D_4_HOS_C10_52),Number of stations (S5_C3_6),Other Ancillary (D3_IRF_C2_76),Ambulance Services (C_1_C5_95),Pass through Cost for Program Inpatient (D1_IPF_C1_50),"COST SERVICES SUBJECT TO DEDUCTIBLES AND COINSURANCE - COST, Clinic (D_5_HOS_C6_90)",Durable Medical Equipment Sold (D3_HOS_C3_97),"COST SERVICES NOT SUBJECT TO DEDUCTIBLES AND COINSURANCE - COST, Blood Storing, Processing, Trans (D_5_HOS_C7_63)",Medical Supplies Charged to Patients (D3_IPF_C2_71),"AMOUNT REPORTED, Interns & Residents (S3_2_C3_2551)","Net Expense for Cost Allocation, Respiratory Therapy (B_1_C0_65)",Subprovider 1 (S3_1_C8_18),Intravenous Therapy (D3_SNF_C3_64),Medicare Certified Heart TC term date (S2_1_C2_127),Telephone Services (A8_C2_7),Program Inpatient Ancillary Service Cost (D1_IRF_C1_48),"HHA I, PEP Episodes:  Total Charges: (S4_HHA1_C4_35)",FQHC (B_1_C21_89),Delivery Room and Labor Room (D_4_IPF_C13_52),HHA (S3_1_C11_22),HHA (S3_1_C7_22),Impl. Dev. Charged to Patients (D3_HOS_C2_72),Cardiac Catheterization (A_C6_59),ICF (A_C1_4501),Other Organ Acquisition (C_1_C5_112),"General Inpatient Routine Service Cost, net of Swing Bed and Private Room Diff (D1_IPF_C1_37)",SNF (S3_1_C11_19),"ADJUSTED SALARIES, Excluded Area Salaries (S3_2_C4_10)",Medical Supplies Charged to Patients (D_4_HOS_C12_71),"AVERAGE HOURLY WAGE, Physician-Part A (S3_2_C6_4)","HHA II, PEP Episodes:  Total Visits (S4_HHA2_C4_33)",Burn Intensive Care Unit (D3_HOS_C2_33),Other Reimbursable (D3_SNF_C2_98),Drugs Charged to Patients (D_4_SNF_C11_73),Radiology-Diagnostic (D_4_SNF_C11_54),Laundry and Linen Service (A_C6_8),Outpatient Rehab Provider (S3_1_C10_25),OPT (B_2_C26_9920),Total Program General Inpatient Routine (D1_IPF_C1_41),Total Salaries (A_C2_200),Charity care charges and uninsured discounts for the entire facility (S10_C2_20),Other Current Assets (G_C1THRU4_9),"PPS SERVICES COST, Durable Medical Equipment Sold (D_5_HOS_C5_97)","ADJUSTED SALARIES, Subtotal Other Wages and Related Csts (S3_3_C4_4)",Title XIX discharges (S3_1_C14_1),Speech Pathology (B_2_C26_68),"AMOUNT REPORTED, Home Office Salaries (S3_2_C2_1401)","HHA II, PEP Episodes:  Total Charges: (S4_HHA2_C4_35)",Title V discharges (S3_1_C12_17),Payments received from patients for amounts previously written off as charity care (S10_C1_22),"Total, Total (A7_3_C15_3)",HHA (A_C6_101),PBP Clinical Lab Services Program Only (D3_HOS_C3_61),NOT IN THIS FILE (TRNSMTL_NUM),Nursing Administration (A_C6_13),"Total Inpatient Charges, CT Scan (C_1_C6_57)",OPT (C_1_C7_9920),Emergency (D_4_SNF_C11_91),Cost of Uncompensated Care (S10_C1_30),Emergency (B_2_C26_91),Medicare Certified Kidney TC term date (S2_1_C2_126),"ADJUSTED SALARIES, Non-Physician Anesthetist Part A (S3_2_C4_2)",Durable Medical Equipment Sold (D_4_HOS_C3_97),Renal Dialysis (A_C1_74),Renal 10 Provider Number (S2_1_C2_1809),"ADJUSTED SALARIES, Physician Part B (S3_2_C4_23)","Allocation of Interns & Residents Program Costs, Electroencephalography (B_1_C22_70)",Paramedical Education (A_C2_23),Intensive Care Unit (D_1_HOS_C6_31),Gross Revenue (G3_C1_1),"COST SERVICES NOT SUBJECT TO DEDUCTIBLES AND COINSURANCE - COST, MRI (D_5_HOS_C7_58)",Other Medicaid Days (S2_1_C6_24),Durable Medical Equipment Sold (C_1_C7_97),"Allocation of Interns & Residents Program Costs, Subprovider-IRF (B_1_C22_41)",Emergency (D_4_HOS_C13_91),Other Reimbursable (D_4_HOS_C3_98),Radiology-Therapeutic (D_4_HOS_C10_55),Hospital State (S2_1_C2_2),Laboratory (D_4_IPF_C11_60),"AMOUNT REPORTED, Housekeeping under contract (S3_2_C2_33)",Subprovider I (D3_HOS_C2_42),"ADJUSTED SALARIES, Physician Part A Teaching (S3_2_C4_2201)","ADJUSTED SALARIES, Contract Labor:  Physician Part A (S3_2_C4_13)",Nonphysician Anesthetists (A_C2_19),Administrative and General (A_C1_5),"PAID HOURS RELATED TO SALARIES, Admin & Gen Under Contract (S3_2_C5_29)","HHA I, Total Charges (S4_HHA1_C5_35)",Subprovider-IRF (B_1_C26_41),IRF (S3_1_C7_17),Medical Supplies Charged to Patients (D_4_IRF_C13_71),Other Outpatient Services (A_C2_93),Hospice (S3_1_C11_24),Surgical Intensive Care Unit Program Cost (D1_HOS_C5_46),"Allocation of Interns & Residents Salary and Fringes, Subprovider-IRF (B_1_C21_41)","HHA III, PEP:  Total Number of Outlier Episodes (S4_HHA3_C4_37)",Total Swing Bed Cost (D1_HOS_C1_26),"Net Expense for Cost Allocation, Interns & Res Other Program Costs (B_1_C0_22)","Allocation of Interns & Residents Salary and Fringes, Subprovider I (B_1_C21_42)","COST REIMBURSED SERVICES SUBJECT TO DEDUCTIBLES  AND COINSURANCE - CHARGES, Radioisotope (D_5_HOS_C3_56)",HRR adjustment amount  (E_A_HOS_C1_7094),Total Adults & Peds (S3_1_C7_7),Hospital County (S2_1_C4_2),Ending Date of SCH status (S2_1_C2_36),"Blood Storing, Processing, Trans (D_4_IRF_C11_63)",Surgical Intensive Care Unit (D3_IRF_C2_34),Renal Dialysis (D_4_HOS_C3_74),"COST SERVICES NOT SUBJECT TO DEDUCTIBLES AND COINSURANCE - COST, Impl. Dev. Charged to Patients (D_5_HOS_C7_72)","Net Expense for Cost Allocation, Whole Blood & Packed Red Blood Cells (B_1_C0_62)","COST SERVICES SUBJECT TO DEDUCTIBLES AND COINSURANCE - COST, Emergency (D_5_HOS_C6_91)",Home Program Dialysis (A_C1_94),"ADJUSTED SALARIES, Employee Benefits (S3_2_C4_26)",Speech Pathology (C_1_C5_68),Other Special Care Unit (A_C6_35),Stand-alone CHIP Charges (Gross Revenue) (S10_C1_10),"ADJUSTED SALARIES, Excluded Areas (S3_2_C4_19)","Net Expense for Cost Allocation, New Capital Buildings and Fixtures (B_1_C0_1)","Net Expense for Cost Allocation, Physicians' Private Office (B_1_C0_192)",Electroencephalography (D3_HOS_C3_70),Surgical Intensive Care Unit (D_1_HOS_C6_34),"Disposals and Retirements, Building Improvements (A7_1_C7_4)","PPS REIMBURSED SERVICES -  CHARGES, Durable Medical Equipment Sold (D_5_HOS_C2_97)","COST SERVICES SUBJECT TO DEDUCTIBLES AND COINSURANCE - COST, Intravenous Therapy (D_5_HOS_C6_64)",IRF (S3_1_C8_17),CMHC (C_1_C5_99),"Depreciation, New Cap Related Csts Movable Equipment (A7_3_C9_2)",IPPS Payment amount (unadjusted) (E_A_HOS_C1_59),"Purchases, Land (A7_1_C2_1)","Allocation of Interns & Residents Program Costs, Speech Pathology (B_1_C22_68)",Anesthesiology (D_4_HOS_C10_53),Number of stations (S5_C1_6),"Fully Depreciated Assets, Subtotal (A7_1_C7_8)",In State Medicaid paid days (S2_1_C1_24),"Allocation of Interns & Residents Salary and Fringes, Impl. Dev. Charged to Patients (B_1_C21_72)",Other Adjustments (Summed) (A8_C2_33),"Number of Times per week
 Patient receives Dialysis (S5_C6_2)",Cardiac Catheterization (D_4_IPF_C13_59),Renal Dialysis (A_C2_74),Anesthesiology (D3_SNF_C3_53),"Allocation of Interns & Residents Salary and Fringes, Intensive Care Unit (B_1_C21_31)",Pass Through Cost for  Program Ancillary (D1_IPF_C1_51),Whole Blood & Packed Red Blood Cells (D_4_IPF_C11_62),"Total Outpatient Charges, Whole Blood & Packed Red Blood Cells (C_1_C7_62)",Recovery Room (D_4_IPF_C13_51),Electrocardiology (D_4_IRF_C11_69),CORF (A_C2_9910),RHC (D_4_HOS_C4_88),Laboratory (B_1_C26_60),"HHA III, Without Outliers:  Other Charges (S4_HHA3_C1_34)",CT Scan (D3_IRF_C2_57),"Fully Depreciated Assets, Begin Balance (A7_1_C1_7)","Total Inpatient Charges, Blood Clotting Factors for Hemoph. (C_1_C6_6250)",ASC (Non Distinct Part) (D3_IPF_C3_75),Other Ancillary (D_4_HOS_C1_76),"AVERAGE HOURLY WAGE, Management and Administrative Services (S3_2_C6_12)","COST REIMBURSED SERVICES SUBJECT TO DEDUCTIBLES  AND COINSURANCE - CHARGES, ASC (Non Distinct Part) (D_5_HOS_C3_75)","TOTAL CAPITAL COSTS AFTER COST ALLOCATION, OLTC (B_2_C26_46)",RHC/FQHC Combined (S3_1_C6_26),Durable Medical Equipment Sold (A_C2_97),"Net Expense for Cost Allocation, PBP Clinical Lab Services Program Only (B_1_C0_61)",Target Amount per Discharge (D1_HOS_C1_55),Electroencephalography (D_4_HOS_C10_70),"Total Inpatient Charges, SNF (C_1_C6_44)","COST REIMBURSED SERVICES NOT SUBJECT TO DEDUCTIBLES AND COINSURANCE - CHARGES, Blood Clotting Factors for Hemoph. (D_5_HOS_C4_6250)",Occupational Therapy (C_1_C5_67),Lung  Acquisition (B_2_C26_108),Subprovider-IRF (A_C6_41),Cardiac Catheterization (D_4_HOS_C11_59),Hospital Zip Code (S2_1_C3_2),"COST SERVICES SUBJECT TO DEDUCTIBLES AND COINSURANCE - COST, Blood Storing, Processing, Trans (D_5_HOS_C6_63)","HHA III, PEP Episodes:  Total Number of Episodes (S4_HHA3_C4_36)",Pancreas Acquisition (C_1_C5_109),FQHC 3 Provider Number (S2_1_C2_1602),Other Organ Acquisition (B_2_C26_112),Blood Clotting Factors for Hemoph. (D3_IPF_C2_6250),"ADJUSTED SALARIES, Wage Related Costs RHC/FQHC (S3_2_C4_24)","HHA I, Total Charges:  LUPA Episodes (S4_HHA1_C3_35)",Intravenous Therapy (A_C2_64),Parking Lot (A8_C2_9),Electrocardiology (D3_HOS_C2_69),"Allocation of Interns & Residents Salary and Fringes, Medical Supplies Charged to Patients (B_1_C21_71)",Home Program Dialysis (C_1_C5_94),Intravenous Therapy (D_4_HOS_C4_64),SNF (S3_1_C3_19),"AMOUNT REPORTED, Employee Benefits (S3_2_C2_26)",CT Scan (D_4_IPF_C13_57),"COST SERVICES SUBJECT TO DEDUCTIBLES AND COINSURANCE - COST, Whole Blood & Packed Red Blood Cells (D_5_HOS_C6_62)",Radioisotope (D3_HOS_C3_56),"Allocation of Interns & Residents Salary and Fringes, Speech Pathology (B_1_C21_68)",Title V discharges (S3_1_C12_14),"Disposals and Retirements, Movable Equipment (A7_1_C5_6)",Hospice (C_1_C5_116),Dietary (A_C6_10),Burn Intensive Care Unit (D_1_HOS_C4_33),Speech Pathology (D_4_HOS_C12_68),Total Subprovider I Interns & Residents (S3_1_C10_18),"Beginning Balances, Land Improvements (A7_1_C1_2)",Laboratory (D_4_HOS_C4_60),"Blood Storing, Processing, Trans (D_4_HOS_C12_63)","Allocation of Interns & Residents Salary and Fringes, OLTC (B_1_C21_46)","TOTAL CAPITAL COSTS AFTER COST ALLOCATION, Coronary Care Unit (B_2_C26_32)",Total Operating Expense (G3_C1_4),ICF Provider Number (S2_1_C2_1001),Adults & Pediatrics (D_1_HOS_C7_30),"Allocation of Interns & Residents Program Costs, Electrocardiology (B_1_C22_69)","COST REIMBURSED SERVICES SUBJECT TO DEDUCTIBLES  AND COINSURANCE - CHARGES, Intravenous Therapy (D_5_HOS_C3_64)","AVERAGE HOURLY WAGE, Non-Physician Anesthetist Part A (S3_2_C6_2)",Electroencephalography (C_1_C6_70),Occupational Therapy (D_4_SNF_C11_67),Accounts Receivable (G_C1THRU4_4),"COST SERVICES SUBJECT TO DEDUCTIBLES AND COINSURANCE - COST, Anesthesiology (D_5_HOS_C6_53)",RHC 2 Provider Number (S2_1_C2_1501),"COST SERVICES NOT SUBJECT TO DEDUCTIBLES AND COINSURANCE - COST, Radiology-Diagnostic (D_5_HOS_C7_54)",IPF (S3_1_C3_16),Hospital Adults & Pediatrics (S3_1_C2_1),"Purchases, Land Improvements (A7_1_C2_2)",Medical Supplies Charged to Patients (D_4_IPF_C11_71),"TOTAL CAPITAL COSTS AFTER COST ALLOCATION, Total Directly Assigned New Cap Rel Csts (B_2_C0_202)",Is this a rural hospital qualifying for an exception to the certified registered nurse anesthetist the CRNA fee schedule? (Y/N) (S2_1_C1_108),Surgical Intensive Care Unit (A_C2_34),Total (D_4_SNF_C11_200),Clinic (D_4_HOS_C4_90),"TOTAL CAPITAL COSTS AFTER COST ALLOCATION, Subprovider I (B_2_C26_42)",Other Ancillary (C_1_C6_76),CMS Region Code (REGION),"PAID HOURS RELATED TO SALARIES, Administrative and General under Contract (S3_2_C5_28)",Hospice (B_1_C26_116),Accounts Payable (G_C1THRU4_37),Anesthesiology (D_4_IPF_C13_53),certification date (S2_1_C1_132),"HHA I, Total Number of Episodes (S4_HHA1_C5_36)",Bonus Payment (D1_HOS_C1_58),Drugs Charged to Patients (D_4_HOS_C4_73),"Total Inpatient Charges, OLTC (C_1_C6_46)","HHA I, LUPA:  Total Non Routine Med Sup Chgs (S4_HHA1_C3_38)",Total Program General Inp. Rtn Service (D1_SNF_C1_74),Total Salaries (A_C6_200),RHC (B_1_C22_88),Payroll taxes payable (G_C1THRU4_39),"AMOUNT REPORTED, Central Services and Supply (S3_2_C2_39)",Intravenous Therapy (C_1_C7_64),"HHA III, With Outliers:  Total Visits (S4_HHA3_C2_33)","PPS REIMBURSED SERVICES -  CHARGES, Observation Beds (Distinct Unit) (D_5_HOS_C2_9201)","PAID HOURS RELATED TO SALARIES, Laundry and Linen Service (S3_2_C5_31)",Medicare Certified Pancreas TC term date (S2_1_C2_130),"AVERAGE HOURLY WAGE, Administrative and General under Contract (S3_2_C6_28)","PAID HOURS RELATED TO SALARIES, Dietary under Contract (S3_2_C5_35)","COST REIMBURSED SERVICES NOT SUBJECT TO DEDUCTIBLES AND COINSURANCE - CHARGES, Clinic (D_5_HOS_C4_90)",Durable Medical Equipment Rented (D3_SNF_C2_96),Labor and Delivery Days -  Title XIX (S3_1_C8_32),Subprovider-IRF (D_1_HOS_C7_41),Renal Dialysis (D_4_SNF_C11_74),"PPS REIMBURSED SERVICES -  CHARGES, Renal Dialysis (D_5_HOS_C2_74)","AMOUNT REPORTED, Wage Related Costs Other (S3_2_C2_18)",Delivery Room and Labor Room (A_C2_52),"Number of patients transplanted 
during fiscal year (S5_C1_12)",Total Hospital (S3_1_C2_14),"HHA I, Without Outliers:  Non Routine Med Sup Chgs (S4_HHA1_C1_38)",Other Ancillary (D_4_HOS_C11_76),Drugs Charged to Patients (D3_IPF_C2_73),ASC (Distinct Part) (B_1_C22_115),Government grants or appropriations or transfers for support of hospital operations (S10_C1_18),Emergency (D3_SNF_C2_91),Net Revenue from Medicaid (S10_C1_2),Other Outpatient Services (D_4_HOS_C2_93),"Other Capital Related Costs, New Cap Related Csts Bldg & Fixtures (A7_3_C7_1)",Other Reimbursable (D3_IPF_C3_98),Speech Pathology (D3_IPF_C2_68),Negative Cost Centers (B_1_C26_201),Total Nursing School (D_4_HOS_C2_200),"COST SERVICES NOT SUBJECT TO DEDUCTIBLES AND COINSURANCE - COST, Intravenous Therapy (D_5_HOS_C7_64)","TOTAL CAPITAL COSTS AFTER COST ALLOCATION, NF (B_2_C26_45)","PPS REIMBURSED SERVICES -  CHARGES, Electroencephalography (D_5_HOS_C2_70)","PPS SERVICES COST, Whole Blood & Packed Red Blood Cells (D_5_HOS_C5_62)",MRI (D_4_SNF_C11_58),"AVERAGE HOURLY WAGE, Housekeeping under Contract (S3_2_C6_33)",Laboratory (D_4_HOS_C10_60),Outpatient Rehab Provider (S3_1_C8_25),"COST SERVICES NOT SUBJECT TO DEDUCTIBLES AND COINSURANCE - COST, Laboratory (D_5_HOS_C7_60)",Adults and Pediatrics (D3_HOS_C2_30),"Blood Storing, Processing, Trans (D_4_SNF_C11_63)","Percentage of patients re-using
dialyzers (S5_C2_10)","PPS SERVICES COST, Drugs Charged to Patients (D_5_HOS_C5_73)",Liver Acquisition (A_C2_107),Durable Medical Equipment Rented (B_2_C26_96),"Blood Storing, Processing, Trans (D_4_HOS_C2_63)",Operating Room (D3_SNF_C2_50),Utilization (S5_C1_8),Drugs Charged to Patients (D3_SNF_C3_73),OPT (C_1_C5_9920),Total Other Expenses (G3_C1_28),"Fully Depreciated Assets, Purchase (A7_1_C2_7)",Emergency (D3_SNF_C3_91),Liver Acquisition (B_2_C26_107),Intensive Care Unit (S3_1_C3_8),Ambulance Services (B_2_C26_95),"AMOUNT REPORTED, Contract Labor (S3_2_C2_11)",Radiology-Therapeutic (D3_IPF_C3_55),"COST SERVICES NOT SUBJECT TO DEDUCTIBLES AND COINSURANCE - COST, Electrocardiology (D_5_HOS_C7_69)","PPS REIMBURSED SERVICES -  CHARGES, Laboratory (D_5_HOS_C2_60)",Total Liabilities (G_C1THRU4_51),Adj for Physical therapy costs in excess (A8_C2_24),"PPS SERVICES COST, Total (D_5_HOS_C5_200)",Electrocardiology (D3_HOS_C3_69),"Total Inpatient Charges, Anesthesiology (C_1_C6_53)",ASC (Non Distinct Part) (A_C2_75),Radiology-Therapeutic (D_4_HOS_C3_55),Adults and Pediatrics (A_C1_30),Other Reimbursable (C_1_C5_98),Impl. Dev. Charged to Patients (D3_SNF_C3_72),CT Scan (D3_IPF_C2_57),"HHA I, LUPA Episodes:  Other Charges (S4_HHA1_C3_34)","COST SERVICES NOT SUBJECT TO DEDUCTIBLES AND COINSURANCE - COST, Other Reimbursable (D_5_HOS_C7_98)",Employee Benefits (A_C2_4),Drugs Charged to Patients (B_1_C22_73),Other Nonreimbursable (B_1_C21_194),"PPS REIMBURSED SERVICES -  CHARGES, Drugs Charged to Patients (D_5_HOS_C2_73)",Burn Intensive Care Unit (A_C2_33),ICF (A_C6_4501),Impl. Dev. Charged to Patients (D_4_HOS_C4_72),"AMOUNT REPORTED, Dietary (S3_2_C2_34)","PAID HOURS RELATED TO SALARIES, Cafeteria (S3_2_C5_36)",Total Hospital Interns & Residents (S3_1_C10_14),Other Ancillary (D_4_IPF_C13_76),Other Outpatient Services (D_4_IPF_C13_93),"Allocation of Interns & Residents Salary and Fringes, Blood Storing, Processing, Trans (B_1_C21_63)",Emergency (B_1_C26_91),HHA (S3_1_C8_22),Hospital Type (S2_1_C4_3),MRI (D3_SNF_C3_58),Medical Supplies Charged to Patients (D3_SNF_C3_71),Subprovider-IRF (A_C1_41),Nonpaid Workers (B_1_C26_193),OSP (C_1_C7_9940),Intensive Care Unit (D_1_HOS_C7_31),Nursery (A_C6_43),Average times dialyzers re-used (S5_C2_9),"PPS REIMBURSED SERVICES -  CHARGES, Operating Room (D_5_HOS_C2_50)",Depreciation-New Bldgs & Fixtures (A8_C2_26),Home Program Dialysis (C_1_C6_94),Intravenous Therapy (C_1_C6_64),"AMOUNT REPORTED, Teaching Physician Salaries (S3_2_C2_16)","ADJUSTED SALARIES, SNF (S3_2_C4_9)",Other Special Care (S3_1_C3_12),Liver Acquisition (B_1_C22_107),Kidney Acquisition (C_1_C6_105),Excess of customary charges (E_B_HOS_C1_19),New Capital Buildings and Fixtures (A_C6_1),Heart Acquisition (C_1_C6_106),"Epoietin amount form worksheet A
for home dialysis program (S5_C1_14)","PPS REIMBURSED SERVICES -  CHARGES, Electrocardiology (D_5_HOS_C2_69)","Number of Times per week
 Patient receives Dialysis (S5_C2_2)",Nonpaid Workers (B_1_C22_193),"Allocation of Interns & Residents Salary and Fringes, Radioisotope (B_1_C21_56)",Laundry and Linen Service (A8_C2_13),Delivery Room and Labor Room (B_1_C26_52),"Net Expense for Cost Allocation, Laboratory (B_1_C0_60)",Operating Room (D3_IRF_C2_50),"Total Outpatient Charges, PBP Clinical Lab Services Program Only (C_1_C7_61)","COST REIMBURSED SERVICES NOT SUBJECT TO DEDUCTIBLES AND COINSURANCE - CHARGES, Observation Beds (Distinct Unit) (D_5_HOS_C4_9201)","COST REIMBURSED SERVICES SUBJECT TO DEDUCTIBLES  AND COINSURANCE - CHARGES, Other Outpatient Services (D_5_HOS_C3_93)",Total Hospital (S3_1_C8_14),OSP (B_1_C26_9940),"Net Expense for Cost Allocation, Burn Intensive Care Unit (B_1_C0_33)","ADJUSTED SALARIES, Net Salaries (S3_3_C4_1)",Electrocardiology (D_4_HOS_C11_69),Adults and Pediatrics (A_C2_30),ASC (Non Distinct Part) (C_1_C6_75),"PPS REIMBURSED SERVICES -  CHARGES, Impl. Dev. Charged to Patients (D_5_HOS_C2_72)","COST SERVICES SUBJECT TO DEDUCTIBLES AND COINSURANCE - COST, Medical Supplies Charged to Patients (D_5_HOS_C6_71)",Respiratory Therapy (D3_SNF_C2_65),Cardiac Catheterization (D3_SNF_C2_59),Primary payer payments (E_B_HOS_C1_31),Major Movable Equipment (G_C1THRU4_23),Other Outpatient Services (C_1_C7_93),Total Other Medical Education (D_4_IRF_C4_200),Other Special Purpose (C_1_C7_117),RHC 19 Provider Number (S2_1_C2_1518),Drugs Charged to Patients (C_1_C7_73),Other Outpatient Services (B_1_C21_93),HHA (B_1_C22_101),"Allocation of Interns & Residents Program Costs, Respiratory Therapy (B_1_C22_65)",Total (D_3_HOS_C9_200),Impl. Dev. Charged to Patients (D3_IRF_C3_72),"PPS REIMBURSED SERVICES -  CHARGES, Radioisotope (D_5_HOS_C2_56)","Net Expense for Cost Allocation, Impl. Dev. Charged to Patients (B_1_C0_72)","Net Expense for Cost Allocation, Nonphysician Anesthetists (B_1_C0_19)",Delivery Room and Labor Room (D3_IRF_C2_52),"PPS REIMBURSED SERVICES -  CHARGES, CT Scan (D_5_HOS_C2_57)",NF (S3_1_C11_20),SNF (B_1_C26_44),RHC (D_4_HOS_C2_88),"AMOUNT REPORTED, Administrative & General under contract (S3_2_C2_28)","Allocation of Interns & Residents Program Costs, Radioisotope (B_1_C22_56)",Islet Acquisition (A_C6_111),ASC (Non Distinct Part) (D_4_SNF_C11_75),Blood Clotting Factors for Hemoph. (D3_HOS_C3_6250),"If (SCH), enter the # of periods. (S2_1_C1_35)",Housekeeping (A_C1_9),Delivery Room and Labor Room (D3_IRF_C3_52),"PAID HOURS RELATED TO SALARIES, Social Service (S3_2_C5_42)","Gift, Flower, Coffee Shop, Canteen (A_C1_190)",City (S2_1_C1_143),Other Ancillary (D_4_HOS_C10_76),Speech Pathology (D_4_HOS_C13_68),"AMOUNT REPORTED, Pharmacy (S3_2_C2_40)",Durable Medical Equipment Sold (D_4_HOS_C2_97),Laboratory (D_4_HOS_C3_60),Drugs Charged to Patients (D_4_HOS_C2_73),"TOTAL CAPITAL COSTS AFTER COST ALLOCATION, CT Scan (B_2_C26_57)","Number of days in year dialysis 
furnished (S5_C1_5)","TOTAL CAPITAL COSTS AFTER COST ALLOCATION, ICF (B_2_C26_4501)",Coronary Care Unit (D3_IPF_C2_32),Other Reimbursable (D_4_HOS_C13_98),"ADJUSTED SALARIES, Operation of Plant (S3_2_C4_30)",RHC 23 Provider Number (S2_1_C2_1522),Burn Intensive Care Unit (C_1_C5_33),Total Facility FTEs (S3_1_C11_27),"Total Inpatient Charges, Radiology-Therapeutic (C_1_C6_55)",Total Nursing School (D_4_IRF_C2_200),"PPS SERVICES COST, Emergency (D_5_HOS_C5_91)","AVERAGE HOURLY WAGE, Social Service (S3_2_C6_42)",Medical Supplies Charged to Patients (A_C6_71),"Total Outpatient Charges, Radiology-Diagnostic (C_1_C7_54)",RHC/FQHC Combined (S3_1_C11_26),Total (D_4_HOS_C1_200),Other Reimbursable (B_2_C26_98),Physicians' Private Office (B_1_C21_192),Occupational Therapy (C_1_C7_67),Electrocardiology (D_4_HOS_C10_69),"Net Expense for Cost Allocation, Cardiac Catheterization (B_1_C0_59)",Speech Pathology (D_4_IRF_C11_68),Total Facility FTEs (S3_1_C10_27),Electrocardiology (C_1_C7_69),Whole Blood & Packed Red Blood Cells (D_4_HOS_C11_62),Intravenous Therapy (D3_HOS_C3_64),"Sum of lines 3,4 divided by line 6 (E_B_HOS_C1_7)","COST SERVICES NOT SUBJECT TO DEDUCTIBLES AND COINSURANCE - COST, CT Scan (D_5_HOS_C7_57)",Other Capital (A_C2_3),"HHA I, Total Other Charges (S4_HHA1_C5_34)",Notes and Loans Payable (short term) (G_C1THRU4_40),Hospice (B_1_C21_116),Cardiac Catheterization (D3_HOS_C2_59),"HHA II, Total Visits (S4_HHA2_C5_33)",Impl. Dev. Charged to Patients (D_4_IRF_C11_72),Medical Supplies Charged to Patients (C_1_C7_71),"COST SERVICES SUBJECT TO DEDUCTIBLES AND COINSURANCE - COST, Recovery Room (D_5_HOS_C6_51)",Drugs Charged to Patients (D3_IRF_C3_73),"ADJUSTED SALARIES, Pharmacy (S3_2_C4_40)",Blood Clotting Factors for Hemoph. (A_C1_6250),Surgical Intensive Care Unit (A_C6_34),Kidney Acquisition (C_1_C5_105),Prepaid expenses (G_C1THRU4_8),Medical and Other Services (E_B_HOS_C1_1),IPPS Interim payment (E_A_HOS_C1_72),"PPS REIMBURSED SERVICES -  CHARGES, Other Outpatient Services (D_5_HOS_C2_93)",Title XIX discharges (S3_1_C14_18),"AMOUNT REPORTED, Interns & Residents (S3_2_C3_2552)",Other Ancillary (D_4_IRF_C11_76),Total Hospital (S3_1_C4_7),Observation Beds (Distinct Unit) (D_4_HOS_C10_9201),"COST REIMBURSED SERVICES NOT SUBJECT TO DEDUCTIBLES AND COINSURANCE - CHARGES, Physical Therapy (D_5_HOS_C4_66)","Net Expense for Cost Allocation, Radiology-Therapeutic (B_1_C0_55)",Radiology-Diagnostic (C_1_C5_54),Title XVIII discharges (S3_1_C13_2),Radioisotope (D_4_HOS_C10_56),Renal Dialysis (D_4_IPF_C11_74),Radiology-Therapeutic (D_4_HOS_C13_55),Burn Intensive Care Unit (S3_1_C2_10),Pharmacy (A_C1_15),Respiratory Therapy (D_4_HOS_C12_65),Electroencephalography (D3_SNF_C3_70),Mortgage Payable (G_C1THRU4_46),"Net Expense for Cost Allocation, Paramedical Education (B_1_C0_23)",Radiology-Diagnostic (D3_HOS_C3_54),OSP (A_C2_9940),"Allocation of Interns & Residents Program Costs, Surgical Intensive Care Unit (B_1_C22_34)","COST SERVICES SUBJECT TO DEDUCTIBLES AND COINSURANCE - COST, CT Scan (D_5_HOS_C6_57)",Radioisotope (D3_IRF_C2_56),"COST SERVICES SUBJECT TO DEDUCTIBLES AND COINSURANCE - COST, Observation Beds (Distinct Unit) (D_5_HOS_C6_9201)","Net Expense for Cost Allocation, Gift, Flower, Coffee Shop, Canteen (B_1_C0_190)","Beginning Balances, Land (A7_1_C1_1)",Radioisotope (A_C2_56),Adj for Occupational therapy in excess of li (A8_C2_30),"Net Expense for Cost Allocation, Other Special Care Unit (B_1_C0_35)","ADJUSTED SALARIES, Home Office Personnel (S3_2_C4_8)","COST REIMBURSED SERVICES NOT SUBJECT TO DEDUCTIBLES AND COINSURANCE - CHARGES, Radioisotope (D_5_HOS_C4_56)",Unsecured Loans (G_C1THRU4_48),Other Nonreimbursable (A_C6_194),Tentative settlement (E_B_HOS_C1_42),Durable Medical Equipment Rented (C_1_C6_96),Medical and Other Services reimbursed by OPPS (E_B_HOS_C101_2),Intravenous Therapy (D_4_HOS_C2_64),FQHC (B_1_C26_89),Physical Therapy (D_4_IRF_C13_66),Islet Acquisition (C_1_C6_111),Drugs Charged to Patients (D_4_HOS_C11_73),Net Patient Revenue (G3_C1_3),Utilization Review SNF (A_C1_114),Renal 8 Provider Number (S2_1_C2_1807),Int & Res (non approved teaching program (C_1_C7_100),Cardiac Catheterization (D_4_IRF_C13_59),Anesthesiology (D3_IPF_C3_53),Rental of quarters to employee and oths (A8_C2_15),"COST REIMBURSED SERVICES SUBJECT TO DEDUCTIBLES  AND COINSURANCE - CHARGES, MRI (D_5_HOS_C3_58)",Lung  Acquisition (C_1_C5_108),"PPS SERVICES COST, Other Ancillary (D_5_HOS_C5_76)",Protested amounts (E_B_HOS_C1_44),"HHA II, Total Number of Episodes (S4_HHA2_C5_36)",CMHC (S3_1_C6_25),Emergency (A_C1_91),Other Special Care (S3_1_C7_12),Medical Supplies Charged to Patients (B_1_C26_71),ICF (B_1_C26_4501),FQHC (B_1_C22_89),Hospital Adults & Pediatrics (S3_1_C4_1),Total discharges (S3_1_C15_17),MRI (D_4_IRF_C11_58),MRI (D3_IRF_C3_58),HHA (B_1_C21_101),Respiratory Therapy (A_C1_65),Other Organ Acquisition (C_1_C7_112),"Blood Storing, Processing, Trans (D3_SNF_C2_63)","COST SERVICES SUBJECT TO DEDUCTIBLES AND COINSURANCE - COST, Speech Pathology (D_5_HOS_C6_68)","AMOUNT REPORTED, Interns & Residents (S3_2_C2_2553)",Radiology-Therapeutic (D3_IRF_C3_55),"Insurance, New Cap Related Csts Bldg & Fixtures (A7_3_C5_1)",Home Program Dialysis (B_2_C26_94),Emergency (B_1_C21_91),Investments (G_C1THRU4_31),Cardiac Catheterization (D_4_HOS_C13_59),TOTAL (D3_SNF_C3_200),Other Ancillary (D_4_SNF_C11_76),Speech Pathology (A_C6_68),Recovery Room (D_4_SNF_C11_51),Operating Room (D_4_IPF_C13_50),Cardiac Catheterization (B_1_C26_59),"PAID HOURS RELATED TO SALARIES, SNF (S3_2_C5_9)",CORF (A_C1_9910),Research (A_C1_191),Whole Blood & Packed Red Blood Cells (D_4_HOS_C12_62),Delivery Room and Labor Room (D_4_HOS_C3_52),Medical Supplies Charged to Patients (A_C2_71),"COST REIMBURSED SERVICES SUBJECT TO DEDUCTIBLES  AND COINSURANCE - CHARGES, Radiology-Therapeutic (D_5_HOS_C3_55)","Blood Storing, Processing, Trans (D3_HOS_C3_63)","AMOUNT REPORTED, Physician Part A Teaching (S3_2_C3_2201)",Occupational Therapy (D3_IPF_C3_67),Recovery Room (D3_SNF_C2_51),Home Program Dialysis (D3_SNF_C2_94),Subprovider 2 (S3_1_C3_1801),Other Ancillary (D3_SNF_C3_76),Number of EPO units furnished for Line 13 (S5_C1_15),Blood Clotting Factors for Hemoph. (A_C2_6250),"ADJUSTED SALARIES, Nursing Administration (S3_2_C4_38)",Cardiac Catheterization (D_4_HOS_C12_59),Anesthesiology (D_4_HOS_C12_53),Impl. Dev. Charged to Patients (B_1_C26_72),Interest Expense (A_C2_113),Total Current Assets (G_C1THRU4_11),RHC (D_4_HOS_C3_88),Cardiac Catheterization (A_C1_59),Medical Supplies Charged to Patients (D3_SNF_C2_71),"ADJUSTED SALARIES, Physician-Part A (S3_2_C4_4)",Speech Pathology (D_4_HOS_C3_68),Physical Therapy (D3_HOS_C3_66),"Total Inpatient Charges, Whole Blood & Packed Red Blood Cells (C_1_C6_62)","COST SERVICES SUBJECT TO DEDUCTIBLES AND COINSURANCE - COST, Drugs Charged to Patients (D_5_HOS_C6_73)",Recovery Room (D_4_HOS_C4_51),Total Hospital (S3_1_C5_14),Pharmacy (A_C2_15),"AMOUNT REPORTED, Physician Part A (S3_2_C2_22)","AVERAGE HOURLY WAGE, Non-Physician Part B (S3_2_C6_6)","COST REIMBURSED SERVICES SUBJECT TO DEDUCTIBLES  AND COINSURANCE - CHARGES, Laboratory (D_5_HOS_C3_60)",Nursery (D_1_HOS_C4_43),"COST REIMBURSED SERVICES SUBJECT TO DEDUCTIBLES  AND COINSURANCE - CHARGES, Anesthesiology (D_5_HOS_C3_53)",Radiology-Diagnostic (D_4_HOS_C2_54),Laboratory (D_4_HOS_C2_60),Anesthesiology (D_4_HOS_C13_53),"COST SERVICES SUBJECT TO DEDUCTIBLES AND COINSURANCE - COST, Blood Clotting Factors for Hemoph. (D_5_HOS_C6_6250)","COST SERVICES NOT SUBJECT TO DEDUCTIBLES AND COINSURANCE - COST, Occupational Therapy (D_5_HOS_C7_67)",NF (A_C1_45),Speech Pathology (C_1_C6_68),Surgical Intensive Care Unit (D3_SNF_C2_34),FQHC (C_1_C6_89),FQHC 6 Provider Number (S2_1_C2_1605),Physical Therapy (C_1_C2_66),Physical Therapy (D3_IPF_C3_66),"PAID HOURS RELATED TO SALARIES, Maintenance of Personnel (S3_2_C5_37)","AVERAGE HOURLY WAGE, Operation of Plant (S3_2_C6_30)",Radiology-Diagnostic (B_1_C26_54),"PPS SERVICES COST, Renal Dialysis (D_5_HOS_C5_74)","General Inpatient Routine Service Cost, net of Swing Bed and Private Room Diff (D1_SNF_C1_37)",Electroencephalography (D_4_IRF_C11_70),RHC (B_2_C26_88),"Disposals and Retirements, Total (A7_1_C5_10)",Total (D_1_HOS_C7_200),Renal Dialysis (D_4_HOS_C2_74),Radiology-Diagnostic (D_4_IPF_C11_54),Durable Medical Equipment Rented (A_C2_96),"HHA I, Without Outliers:  Other Charges (S4_HHA1_C1_34)",Respiratory Therapy (D3_HOS_C3_65),Health Information Technology Designated Assets (G_C1THRU4_27),Radioisotope (D_4_HOS_C12_56),Electroencephalography (C_1_C7_70),CORF (B_2_C26_9910),Medicare Certified Liver TC term date (S2_1_C2_128),NF Provider Number (S2_1_C2_10),Impl. Dev. Charged to Patients (D_4_HOS_C2_72),NF (S3_1_C3_20),Intravenous Therapy (C_1_C5_64),Burn Intensive Care Unit (S3_1_C7_10),Physical Therapy (C_1_C6_66),"AMOUNT REPORTED, Physician Part A (S3_2_C2_2201)","AMOUNT REPORTED, Interns & Residents (S3_2_C3_25)",IPF (S3_1_C2_16),Total Costs (D_3_HOS_C5_200),ASC (Non Distinct Part) (B_1_C22_75),OPT (B_1_C26_9920),"COST REIMBURSED SERVICES SUBJECT TO DEDUCTIBLES  AND COINSURANCE - CHARGES, Observation Beds (Distinct Unit) (D_5_HOS_C3_9201)",Lesser of cost or charges (E_B_HOS_C1_21),Durable Medical Equipment Rented (D3_IRF_C3_96),Emergency (D_4_IRF_C11_91),NF (A_C2_45),Other Special Care Unit (A_C1_35),Electroencephalography (A_C1_70),"AMOUNT REPORTED, Dietary under contract (S3_2_C2_35)","Allocation of Interns & Residents Salary and Fringes, Anesthesiology (B_1_C21_53)","Does the facility qualify and is it receiving payments for 
disproportionate share? (Y/N) (S2_1_C1_22)",Delivery Room and Labor Room (D_4_SNF_C11_52),Total prospective payment (E_B_HOS_C1_24),"Allocation of Interns & Residents Salary and Fringes, Burn Intensive Care Unit (B_1_C21_33)",Radiology-Therapeutic (A_C1_55),Physicians' Private Office (A_C1_192),Rental of Provider space by suppliers (A8_C2_6),"If an Organ Procurement Organization, enter the OPO number (S2_1_C1_134)",Nursing Administration (A_C2_13),Durable Medical Equipment Sold (B_1_C26_97),Medical Supplies Charged to Patients (D_4_IPF_C13_71),PBP Clinical Lab Services Program Only (C_1_C5_61),Delivery Room and Labor Room (D_4_IRF_C13_52),Medicare Certified Lung TC term date (S2_1_C2_129),Interest expense on Medicare Overpaymts (A8_C2_22),"COST REIMBURSED SERVICES NOT SUBJECT TO DEDUCTIBLES AND COINSURANCE - CHARGES, Medical Supplies Charged to Patients (D_5_HOS_C4_71)",Hospice (S3_1_C10_24),"PPS REIMBURSED SERVICES -  CHARGES, Delivery Room and Labor Room (D_5_HOS_C2_52)",Negative Cost Centers (B_2_C26_201),"AVERAGE HOURLY WAGE, Subtotal Other Wages and Related Csts (S3_3_C6_4)",Recovery Room (A_C6_51),"Net Expense for Cost Allocation, ASC (Distinct Part) (B_1_C0_115)",MRI (D_4_HOS_C13_58),OSP (A_C1_9940),ICF (S3_1_C10_2001),"Number of patients in program at 
end of cost reporting period (S5_C1_1)",SNF (A_C2_44),Ratio of line 15 to line 16 (E_B_HOS_C1_17),"Net Expense for Cost Allocation, Emergency (B_1_C0_91)","Allocation of Interns & Residents Salary and Fringes, Electroencephalography (B_1_C21_70)","Net Expense for Cost Allocation, Nonpaid Workers (B_1_C0_193)",Other Special Purpose (B_1_C21_117),"Net Expense for Cost Allocation, Recovery Room (B_1_C0_51)",Dietary (A_C2_10),"Total Inpatient Charges, Surgical Intensive Care Unit (C_1_C6_34)",Are provider based physicians' costs included in Worksheet A? (Y/N) (S2_1_C1_144),Drugs Charged to Patients (D_4_IRF_C11_73),Surgical Intensive Care Unit (D_1_HOS_C4_34),Clinic (D_4_HOS_C3_90),Drugs Charged to Patients (D_4_IRF_C13_73),Anesthesiology (D_4_HOS_C11_53),Electroencephalography (A_C2_70),Operating Room (D_4_HOS_C3_50),CT Scan (A_C1_57),Other Special Purpose (B_1_C22_117),Research (B_1_C22_191),Operating Room (D3_HOS_C3_50),Related Organization Transactions (A8_C2_12),"PAID HOURS RELATED TO SALARIES, Contract Labor:  Physician Part A (S3_2_C5_13)","PPS SERVICES COST, MRI (D_5_HOS_C5_58)",Paramedical Education (A_C6_23),Kidney Acquisition (A_C1_105),Operating Room (D3_IPF_C3_50),MRI (D_4_IPF_C11_58),"Total Inpatient Charges, ICF (C_1_C6_4501)",Total Current Liabilities (G_C1THRU4_45),"TOTAL CAPITAL COSTS AFTER COST ALLOCATION, Blood Clotting Factors for Hemoph. (B_2_C26_6250)",Title XVIII discharges (S3_1_C13_18),Laboratory (D3_SNF_C3_60),"COST SERVICES SUBJECT TO DEDUCTIBLES AND COINSURANCE - COST, Respiratory Therapy (D_5_HOS_C6_65)",HHA (S3_1_C10_22),HMO (S3_1_C7_2),Subprovider II (B_1_C26_4201),CMHC (C_1_C6_99),Labor and Delivery Days -  Title XIX (S3_1_C7_32),"COST REIMBURSED SERVICES NOT SUBJECT TO DEDUCTIBLES AND COINSURANCE - CHARGES, Radiology-Therapeutic (D_5_HOS_C4_55)","TOTAL CAPITAL COSTS AFTER COST ALLOCATION, Cardiac Catheterization (B_2_C26_59)",Number of stations (S5_C2_6),"TOTAL CAPITAL COSTS AFTER COST ALLOCATION, Recovery Room (B_2_C26_51)",ASC 1 Provider Number (S2_1_C2_13),"Net Expense for Cost Allocation, Intravenous Therapy (B_1_C0_64)",Cost of charity care (S10_C3_23),OLTC (S3_1_C8_21),Intestinal Acquisition (B_1_C22_110),Ambulance Services (C_1_C6_95),Radioisotope (D3_IPF_C3_56),"PAID HOURS RELATED TO SALARIES, Housekeeping (S3_2_C5_32)",Observation Beds (Distinct Unit) (B_1_C26_9201),"COST REIMBURSED SERVICES NOT SUBJECT TO DEDUCTIBLES AND COINSURANCE - CHARGES, Delivery Room and Labor Room (D_5_HOS_C4_52)","Allocation of Interns & Residents Salary and Fringes, SNF (B_1_C21_44)",Intensive Care Unit (B_1_C26_31),"HHA III, With Outliers:  Non Routine Med Sup Chgs (S4_HHA3_C2_38)",Total Program Inpatient Costs (D1_HOS_C1_49),Radioisotope (D3_IRF_C3_56),"ADJUSTED SALARIES, Home Office Salaries & Wage Related Csts (S3_2_C4_14)","AMOUNT REPORTED, Total Salaries (S3_2_C2_1)",Ending Date of SCH status (S2_1_C2_3601),Electroencephalography (D_4_HOS_C12_70),Observation Beds (Distinct Unit) (D_4_SNF_C11_9201),Occupational Therapy (D_4_IPF_C11_67),Other Ancillary (D_4_IPF_C11_76),"Net Expense for Cost Allocation, Heart Acquisition (B_1_C0_106)","Treatment capacity per day per
station (S5_C1_7)","Allocation of Interns & Residents Salary and Fringes, Coronary Care Unit (B_1_C21_32)","Allocation of Interns & Residents Salary and Fringes, Whole Blood & Packed Red Blood Cells (B_1_C21_62)","PPS SERVICES COST, Electrocardiology (D_5_HOS_C5_69)",Line 2 times line 5 (E_B_HOS_C1_6),CT Scan (D_4_SNF_C11_57),Hospital PO Box (S2_1_C2_1),"COST SERVICES SUBJECT TO DEDUCTIBLES AND COINSURANCE - COST, PBP Clinical Lab Services Program Only (D_5_HOS_C6_61)","Total Inpatient Charges, MRI (C_1_C6_58)",Other Ancillary (D_4_HOS_C4_76),"Number of Times per week
 Patient receives Dialysis (S5_C4_2)",Respiratory Therapy (D_4_HOS_C10_65),Other adjustments (E_B_HOS_C1_39),Speech Pathology (A_C2_68),Durable Medical Equipment Rented (D3_IPF_C2_96),Anesthesiology (D3_IRF_C3_53),Other Outpatient Services (D3_SNF_C2_93),Allowable bad debts (E_B_HOS_C1_34),Delivery Room and Labor Room (D3_HOS_C2_52),"PPS SERVICES COST, Impl. Dev. Charged to Patients (D_5_HOS_C5_72)",Payment to cost ratio (E_B_HOS_C1_5),Drugs Charged to Patients (D3_SNF_C2_73),Anesthesiology (A_C1_53),Speech Pathology (D_4_IRF_C13_68),"Lease, New Cap Related Csts Movable Equipment (A7_3_C10_2)",Surgical Intensive Care Unit (D3_HOS_C2_34),CORF (C_1_C5_9910),Emergency (A_C6_91),"Lease, New Cap Related Csts Bldg & Fixtures (A7_3_C10_1)",RHC/FQHC Combined (S3_1_C8_26),Radiology-Diagnostic (D_4_HOS_C12_54),IRF (S3_1_C5_17),Emergency (A_C2_91),Observation Beds (Distinct Unit) (A_C6_9201),"Net Expense for Cost Allocation, Pancreas Acquisition (B_1_C0_109)",Pass through Cost for Program Inpatient (D1_IRF_C1_50),Intravenous Therapy (D3_IPF_C2_64),Other General Service (A_C6_18),Nonpaid Workers (B_1_C21_193),Heart Acquisition (B_1_C21_106),Total discharges (S3_1_C15_18),Other Outpatient Services (C_1_C5_93),Pancreas Acquisition (B_1_C26_109),"Income from imposition of interest, finance (A8_C2_21)",Int & Res (non approved teaching program (B_1_C22_100),"PPS REIMBURSED SERVICES -  CHARGES, Radiology-Therapeutic (D_5_HOS_C2_55)",Delivery Room and Labor Room (D_4_IRF_C11_52),Durable Medical Equipment Rented (D3_HOS_C3_96),CORF (A_C6_9910),ASC (Distinct Part) (C_1_C7_115),ASC (Distinct Part) (B_1_C26_115),"Blood Storing, Processing, Trans (B_1_C26_63)",Occupational Therapy (A_C2_67),Electrocardiology (D_4_IPF_C11_69),Renal Dialysis (B_1_C22_74),"Net Expense for Cost Allocation, Nursery (B_1_C0_43)",Burn Intensive Care Unit (A_C1_33),Other Special Care Unit (D_3_HOS_C9_35),"PPS REIMBURSED SERVICES -  CHARGES, Blood Storing, Processing, Trans (D_5_HOS_C2_63)","Allocation of Interns & Residents Program Costs, Delivery Room and Labor Room (B_1_C22_52)","Number of patients in program at 
end of cost reporting period (S5_C3_1)",Home Program Dialysis (D3_IPF_C2_94),Inpatient Revenue (G2_C1_28),Occupational Therapy (D3_HOS_C3_67),"AMOUNT REPORTED, Contract Labor: Pysician Part A (S3_2_C2_13)",Subprovider I (A_C2_42),Stand-alone CHIP -- Costs minus net revenue (0 min) (S10_C1_12),"COST REIMBURSED SERVICES NOT SUBJECT TO DEDUCTIBLES AND COINSURANCE - CHARGES, Other Ancillary (D_5_HOS_C4_76)",Physical Therapy (D_4_IPF_C11_66),"HHA III, LUPA Episodes:  Total Visits (S4_HHA3_C3_33)",Emergency (D_4_IPF_C11_91),Occupational Therapy (D_4_IRF_C11_67),Beginning Date of SCH status (S2_1_C1_3601),"AVERAGE HOURLY WAGE, Maintenance of Personnel (S3_2_C6_37)",Nursery (A_C2_43),Medical Supplies Charged to Patients (A_C1_71),Other Organ Acquisition (B_1_C26_112),Renal Dialysis (B_2_C26_74),Respiratory Therapy (D_4_SNF_C11_65),MDH status beginning date (MM/DD/YY) (S2_1_C1_38),"AVERAGE HOURLY WAGE, Subtotal Wage Related Csts (S3_3_C6_5)","COST REIMBURSED SERVICES SUBJECT TO DEDUCTIBLES  AND COINSURANCE - CHARGES, Delivery Room and Labor Room (D_5_HOS_C3_52)",Respiratory Therapy (D_4_HOS_C11_65),Cost of charity care (patients covered by public program + patients w/ coverage accepted by provider) (S10_C2_23),Other Outpatient Services (C_1_C6_93),Total Allied Health Cost (D_3_HOS_C2_200),Cross Foot Adjustments (B_2_C26_200),Speech Pathology (D3_HOS_C3_68),RHC/FQHC Combined (S3_1_C10_26),"PPS REIMBURSED SERVICES -  CHARGES, Other Ancillary (D_5_HOS_C2_76)","TOTAL CAPITAL COSTS AFTER COST ALLOCATION, Burn Intensive Care Unit (B_2_C26_33)",Electrocardiology (D3_SNF_C3_69),Impl. Dev. Charged to Patients (A_C6_72),IPF (S3_1_C6_16),Operating Room (D_4_HOS_C2_50),Subprovider-IPF (D3_IPF_C2_40),Int & Res (non approved teaching program (B_1_C26_100),Blood Clotting Factors for Hemoph. (C_1_C5_6250),"COST SERVICES SUBJECT TO DEDUCTIBLES AND COINSURANCE - COST, MRI (D_5_HOS_C6_58)","Blood Storing, Processing, Trans (D3_IPF_C2_63)",Coronary Care Unit (D3_HOS_C2_32),Coronary Care Unit (S3_1_C7_9),"Total Inpatient Charges, Subprovider I (C_1_C6_42)",Investment Income-Other (A8_C2_3),"TOTAL CAPITAL COSTS AFTER COST ALLOCATION, SNF (B_2_C26_44)",Total charges to state or local government programs for indigent care (not Medicaid or CHIP) (S10_C1_14),Physicians' Assistant (A8_C2_29),"Net Expense for Cost Allocation, Adults and Pediatrics (B_1_C0_30)","Allocation of Interns & Residents Salary and Fringes, Subprovider-IPF (B_1_C21_40)","Total Inpatient Charges, Delivery Room and Labor Room (C_1_C6_52)",SNF (S3_1_C5_19),"PPS SERVICES COST, Medical Supplies Charged to Patients (D_5_HOS_C5_71)","Allocation of Interns & Residents Salary and Fringes, Occupational Therapy (B_1_C21_67)",Other Reimbursable (D_4_IRF_C11_98),ASC (Distinct Part) (C_1_C6_115),Subprovider-IPF (D3_HOS_C2_40),Temporary Investments (G_C1THRU4_2),Hospital Street Address (S2_1_C1_1),TOTAL (D3_IRF_C2_200),Whole Blood & Packed Red Blood Cells (C_1_C5_62),Adults & Pediatrics (D_1_HOS_C4_30),Hospital Adults & Pediatrics (S3_1_C7_1),Research (B_1_C21_191),"Salaries, Wages, and Fees Payable (G_C1THRU4_38)",Durable Medical Equipment Rented (D3_IRF_C2_96),MRI (A_C2_58),TOTAL (D3_HOS_C3_200),Emergency (D_4_HOS_C4_91),"PAID HOURS RELATED TO SALARIES, Administrative and General (S3_2_C5_27)",Anesthesiology (D_4_IRF_C13_53),Occupational Therapy (D_4_HOS_C13_67),"AMOUNT REPORTED, Net Salaries (S3_3_C2_1)",Other Ancillary (D_4_HOS_C2_76),Pancreas Acquisition (B_1_C21_109),"Net Expense for Cost Allocation, Administrative and General (B_1_C0_5)",FFY,Hospital Type (From CMS Hospitals Data Archive),Name and Num
2106,MEMORIAL HERMANN  HOSPITAL SYS (450184),General Short Term (Acute Care Hospitals),Voluntary Nonprofit-Other,-95.430899,29.812266,,,,,519853.0,,,15966125.0,,1689.0,,,,164076638.0,611034.0,,5264921.0,,302393523.0,4090141.0,,,Y,,900091449.0,2035263.0,,8130.0,2439602.0,,,,,3094491.0,,,,3020756.0,,,3378972.0,,4541990.0,,,1832.0,,2624400.0,1.0,4549285.0,,,8610140.0,-19107.0,,,,2925815.0,,,,,,90190830.0,231261.0,37.02,,38386544.0,,,,,,,,,,,,,8500.0,,,2829913.0,29506906.0,,91847.0,,,,,,,117638.0,,16002.0,,1901439.0,,,,,380550.0,,,11581.0,,2.0,451539.0,1530101.0,,,,,,1072176.0,,,,472090624.0,,,,,42842461.0,1089218.0,,,,,160303.0,,194007370.0,,,,,548223.0,,,,,,1135616.0,,80689.0,21377282.0,,,918301983.0,,,567208.0,,,75384995.0,445.0,,,959.0,,33589044.0,,965803.0,,,,,,,74133.0,,,,,,1452.0,6494949.0,,12092268.0,96050.0,,,503473.0,,,,73293375.0,,,3485325.0,2114838.0,,67596071.0,,,1.0,,,,108618.0,,57301231.0,,,1415662.0,,3297110.0,,677724.0,,451539.0,196592.0,,,236039574.0,,73241670.0,HOUSTON,,1576082549.0,N,,49210855.0,61.0,,-576111.0,,15267905.0,,11892185.0,,,278876.0,-1420.0,1067.0,,,,7.0,43047069.0,609323.0,,10609145.0,,0.303161,,16784.0,,,2203136.0,3532.0,,207473.0,,,2462796.0,04011,,,,,87647.0,,,14530671.0,1278976.0,,,,,,,1159213.0,,,28432933.0,,,,1169.0,,5412.0,,11672936.0,1002455293.0,2916507.0,920373953.0,,,2010-07-01 00:00:00,,,1901521.0,,,457741,2003410.0,700839.0,,,,,,,,,,,,9702224.0,,,,188510162.0,,N,1039121.0,,449706230.0,495007.0,,,,,4542586.0,,,,4,,1002455293.0,,91014.0,,,,154928.0,17360.0,27001933.0,,,,,,,,,,,,,,10820654.0,64925.0,-9510.0,1891346495.0,,,,,4496266.0,,,5761308.0,,-3637.0,,,,,,3035718.0,,67617475.0,20412388.0,,,,,1571561.0,,1549712.0,14389675.0,1342095.0,286267.0,,,MEMORIAL HERMANN HOSP SYS- REHAB,,,,208945973.0,,-2633229.0,,,,6165213.0,27866.0,,9702224.0,52397299.0,1230446.0,,,,,,14783119.0,,,,,-23.0,,13555853.0,,,,69329614.0,,-44995823.0,39287862.0,,,9557115.0,,26318830.0,,892722.0,1628165.0,,20538252.0,,2309231.0,,,,,3702720.0,,,,,,76206211.0,1300317.0,41396776.0,,117.0,,,3169646.0,,14211.0,,,,,,6201373.0,,,,,,,,,5873971.0,24087222.0,274.0,,,,N,,,,618117.0,,,,,7935066.0,,19309552.0,,,,,,7033.0,18.9,678913.0,,1638017.0,,,,,,,2018-12-20 00:00:00,,,,,,,309.0,11775.0,,3715473.0,204353.0,,,516070.0,,,39484443.0,,,,3.0,,,315871430.0,-8484756.0,,,,45S184,1735.0,53924259.0,29960.0,1.0,17885.0,30093.0,8809400.0,,15861116.0,,,,,722260.0,,373024525.0,,645899.0,,,,,-27726536.0,33.09,348141.0,26286290.0,6317975.0,5951.0,,39484443.0,,,,,,,1227748.0,,,45T184,,,,,,5.0,2052765.0,,,,,36.86,29506906.0,,,,28.22,,15.51,,33589044.0,,,,,20771266.0,807.0,419492.0,,39064667.0,,188469980.0,,,,,6450630.0,,15827364.0,,,9294.0,23501067.0,,,,,3.0,17572989.0,,-16305.0,,909 FROSTWOOD,,,10346.0,470165.0,,67732080.0,,,2715725.0,519853.0,149629419.0,,,,,,6401817.0,,78944.0,83155.0,,,,,,,,,44.69,,639.0,78790.0,,,15.66,,,,,,,-177.0,,,,,,,,932330.0,,,719720.0,,,185547115.0,,,,7880103.0,,200298.0,418895.0,25477879.0,,,37560.0,,,,29757753.0,MEMORIAL HERMANN  HOSPITAL SYS,5906580.0,4581506.0,,,,,166060973.0,288509.0,,,,46090584.0,,,15349.0,,,1052851.0,47812100.0,-7972.0,,,6328516.0,,33757227.0,,23814260.0,,,4370719.0,,,,3633982.0,30367567.0,,,,,16220.0,,,,757979.0,57301231.0,,,,,725561.0,24149.0,577809.0,,10078006.0,26716.0,12859757.0,73198.0,,,,,188510162.0,,,,,,,,,,,,,81531663.0,,33757227.0,,2741279.0,289210.0,27452179.0,273.0,,2964912.0,16456425.0,12897592.0,,,3854386.0,,,,2477.0,10280017.0,,,1471759.0,4596156.0,2.0,,,,,,,,,11993.0,,12194176.0,30367567.0,9022431.0,,,,81490546.0,,,,3083505.0,,,5406.0,7020259.0,3874986.0,575627728.0,,42842461.0,18457398.0,65.0,100503.0,,,,18476797.0,35.4,,,,,31419.0,,89099.0,675602.0,-1056577.0,,,,,1427407.0,80012983.0,6494949.0,,,,,105311065.0,40884904.0,,,,,8797123.0,,,110282.0,11898055.0,37.02,-312718.0,,,,1154.0,,8294930.0,,,,74105979.0,,4383581.0,,34637914.0,,,,-177.0,450184,,1885126.0,,,7574.0,25456215.0,,,,,,11.32,,,,,,6573967.0,58988.0,1037.0,,,,,,21911390.0,,,341634998.0,48.82,,,7786.0,,,11581.0,,280454.0,,,,63111.0,,10051.0,,15044837.0,77024,,,,,6201373.0,,,27000.0,2191.0,,,,,,,,,8967.0,,,258421.0,,,,,,2814.0,8826806.0,,,,,268137470.0,,337162086.0,,,31775077.0,,855.0,581677.0,,15.62,16885.0,,,76575.0,325157.0,900911.0,983595.0,45,443399.0,40303450.0,44.69,,,28.72,,,,,2262365.0,11178335.0,,6674529.0,,,,,3179144.0,,6587786.0,N,,,,899437589.0,24955.0,,2218849.0,,,,,N,,639887,1600.0,3096214.0,,,,,630067.0,,,,578885033.0,,,,,,,,,,,18628149.0,329595.0,,5159932.0,1267513.0,,,,7255106.0,16456367.0,12808455.0,,,,,,396188501.0,,,,,,,,,,4138.0,,,538657.0,,,,248313.0,,,,,,,6342393.0,,1388986.0,22176987.0,,4138.0,,10166.0,45610,,,,5479881.0,,359016.0,,,,175.0,,,,,20320402.0,,,,19337.0,,,,,,,,,,,,5097.0,,115082769.0,54241776.0,,17671211.0,549242.0,,,,,,,,,900911.0,,27452179.0,76206211.0,,,,317907364.0,29757753.0,,,7020259.0,,69329614.0,,1446793.0,,,,235845249.0,9829661.0,1089.0,,,,,17095705.0,,52030923.0,65815282.0,,,,,60883154.0,,4387074.0,,,,,,,,,1390782890.0,4601776.0,180355.0,,,611034.0,,,,,286267.0,26420,,,,,,,44419437.0,,25459699.0,,TX,,5406.0,,,,,,,,,,10286478.0,,,2766813.0,-578859.0,,,4156941.0,64582.0,,,359.0,16946896.0,6437330.0,64582.0,,2233523.0,,,,6297.0,,35632237.0,,,21872.0,10043509.0,,,,1297909.0,,,3666813.0,,,,,5674555.0,,3360,,,,,,3186399.0,,,,,,,704047108.0,,,1792369.0,,194175.0,,-13966.0,,97684811.0,,,3378972.0,,,,517261.0,47812100.0,,,,3280956.0,,,3888914.0,,,37560.0,,8648574.0,,,719720.0,,4596156.0,,,3059981.0,,,,,,,4318315.0,16325.0,,,,,4539921.0,55609581.0,,,,,63917.0,,9310823.0,12568720.0,,,,,,21130715.0,7524605.0,,,256818427.0,,,,,,,21117785.0,28.73,376098.0,,,33.09,,24.09,,,15030691.0,75661972.0,,942.0,10719.0,28.44,,,,,189193.0,,856667.0,,,,,,,,,,-2296171.0,2.0,,14989352.0,835796.0,-67.0,,,,217568.0,,,,,,,,,,519853.0,,,,163581979.0,,,,,,,,,,,,680175.0,19942876.0,,,,474126558.0,,,,4704074.0,,,N,,,,,11319043.0,,,,,-2398.0,5630.0,,,,,,10286478.0,6393345.0,,105297.0,,,,,,,159848.0,,,,,,,,,41937630.0,,18384200.0,1833.0,722260.0,,,85298.0,,,13509906.0,,,57701899.0,,1.0,,201269.0,,,61563063.0,,6450630.0,,,,,152108.0,11.0,,1.0,,N,,,10495.0,18332.0,,1766584.0,41771455.0,,,6797617.0,,554091.0,,1549.0,2818021.0,,20148.0,,,9830976.0,,15267905.0,,73803.0,,20282504.0,2.0,,,Y,1.0,,,,,,218614.0,103916.0,67305124.0,,,,904831.0,,719961.0,64492.0,,,49.0,200298.0,5495.0,,,21589016.0,,,N,,8110026.0,,,,,,,2522518.0,,,,,,,68165028.0,14511371.0,,,4979666.0,,,,,903.0,123.0,693250.0,,9456.0,549242.0,15351742.0,276470.0,-82.0,P,,329595.0,,1111241.0,,,,,,,,10917116.0,,9064792.0,,,-76782.0,,,,3216205.0,18405488.0,,39.59,,80689.0,,,16509114.0,8638655.0,,,,,25201790.0,3413017.0,,4503.0,10602240.0,,1234773.0,86595.0,9711497.0,15349.0,,,1053.0,,47944859.0,,,,,2203430.0,,1989979.0,,1415662.0,,,,207473.0,59191497.0,63111.0,,,2545924.0,5159932.0,,,396755.0,,,29144.0,,,,46238096.0,,,,,3186399.0,641691.0,,,1950108.0,,,,,,,,4839159.0,F,,,,,,,,,,371.0,,,359016.0,34637914.0,64441895.0,,,21377282.0,,,,-1153.0,,,,,,,495.0,,,22370621.0,4046927.0,,,,,,,,,,,,,,,46011279.0,,,6457051.0,,14450785.0,302393523.0,,-132.0,1090006.0,,,15996.0,,-943499.0,2459890.0,,1409.0,252953.0,15935758.0,,,38.95,,2287544.0,,,519853.0,,,605386683.0,,,,59043374.0,,,,,,,266714.0,,,34786.0,7656457.0,195473.0,2966865439.0,,19950.0,,,,,,,,,,,-107.0,3317.0,,95.0,,,,,,3107477.0,,2701227.0,8945011.0,16155778.0,4392406.0,715668.0,,,,,,12325163.0,85298.0,1588385.0,,,,,,32240628.0,,3874986.0,,,,,64582.0,77847.0,,,,,,1904334.0,,,,,41937630.0,,,,,5256635.0,,194650367.0,,,,7907883.0,,,10095.0,,1630120.0,67596071.0,34393156.0,,,,33600.0,,Y,27232.0,,,,,,908246989.0,76574597.0,,,,64754.0,,,,,,,,1072176.0,,MEMORIAL HERMANN,Y,,,,,5.0,,,,,,4633265.0,,,,2945.0,496399.0,7785898.0,,,,16220.0,73295.0,,,,,,,,,27000.0,1963053.0,1227742.0,,,,,-3581797.0,,,64441895.0,5307271.0,1579684.0,6437330.0,,MEMORIAL HERMANN HOSP SYS-PSYCH,,1014152.0,,,,970012.0,,,,,N,-2686.0,,,,,2858799.0,932330.0,2011-06-30,,,,3297110.0,24719212.0,HO9956,,,,,,,,,,,,184965854.0,1095292.0,41442623.0,,,,82634383.0,,,293813.0,20614921.0,129.85,,,,,,,127406.0,,962.0,,248045.0,,,,45961.0,,9001144.0,,,,,2439602.0,163018.0,,,,,24087222.0,-17817.0,,,3172975.0,,23814260.0,6457051.0,128.33,,,,,,12862.0,,,2642952.0,608866433.0,21751229.0,,,80012983.0,5630.0,61298.0,,,,73198.0,73241670.0,-208496.0,,B,856561.0,79093546.0,,,96269149.0,4637993.0,,,,,,,,86097.0,11993.0,3094193441.0,,9972.0,,,1713.0,,1095292.0,TX,,21872.0,,,2077065.0,,20614921.0,,12529017.0,6381624.0,82.0,,2148598.0,,,,,,7959420.0,,,,14513.0,HARRIS,,,,,,,,,1244035.0,1230446.0,-535326.0,9126548.0,4704074.0,39484443.0,,187938.0,,,,,8967.0,,33757227.0,178946913.0,,,17095705.0,,,20962.0,,-14164091.0,,,,,,28425.0,,,,,,,41396776.0,,199862.0,,,,,23.4,,,,,,,700839.0,,,4633265.0,,-70783.0,1451.0,77008-,,,,,,,,247015.0,,,21679663.0,,,,,1227742.0,,,310221.0,,,1744234.0,,44842.0,,,,7799696.0,,,,,946028519.0,,5084541.0,550984.0,,,1680930.0,,121356834.0,,,,6570.0,903.0,103037.0,,16949160.0,N,,,,,228141.0,6.0,,,6670906.0,,,5237.0,,,,9254.0,,-27726536.0,,,3666813.0,,,5873971.0,,,,4135.0,,,2793.0,386853.0,,,8610140.0,1334120.0,,1087.0,75602.0,,694109.0,,,,77002408.0,,,,7753.0,,,,,2126753.0,,,12.61,61563063.0,,,74889134.0,,,3346312.0,,,,,,,,208945973.0,,,,44895.0,,2262365.0,,,6587786.0,-128419380.0,,67655035.0,1974670.0,48029714.0,,64.0,82155080.0,,,218205.0,3580.0,,80910043.0,44579.0,,14530671.0,,,,7255106.0,130275.0,5371.43,,,,65750249.0,93453.0,General Short Term,,,2674448.0,,,1614138.0,-45737.0,,53924259.0,,,,,,22265.0,,,714762.0,-1303314.0,,,14389675.0,,,,,18405488.0,28063092.0,74444.0,,,,249013.0,,,341721624.0,,5410736.0,,16946896.0,10756.0,,,,386152120.0,,,,,54811542.0,,,248559.0,115722.0,515.0,7435553.0,39287862.0,,,46011279.0,,,,,,,,,,6317975.0,,,,HOUSTON,96050.0,,9565529.0,,,,1950759.0,,,,,6581140.0,,,,2665743.0,,7064582.0,,,155030434.0,,,,,7388286.0,21679663.0,8747860.0,,5717.41,47371512.0,,,,,,172827.0,,,8638655.0,,,69432213.0,,365794.0,9671637.0,,,,51479.0,217568.0,167035254.0,,,,,,1388986.0,,3844546.0,58839786.0,5469.0,3179144.0,,14.0,,9565529.0,1135616.0,,,530408.0,7265054.0,,,,19354.0,,,22425637.0,300379.0,,11686497.0,,,,-1534496.0,1080516.0,,,,,,,80561.0,1202846946.0,,,,,,,,,527505.0,,,,25765312.0,7581.0,67732080.0,,,,750.0,,8940.0,,7790250.0,,,,,,,,,,2714.0,,,-332.0,,,21578558.0,,,,,3085.0,44419437.0,,,,24438.0,,,,,,,4657149.0,16155778.0,7656457.0,59043374.0,,125199238.0,,6563736.0,,2052765.0,,1551097.0,,-838.0,,,32695257.0,,,-899.0,5495.0,,,,,,,,1086841.0,,,,,40900.0,,20.24,58839786.0,,,,,10609145.0,7316793.0,,,,167823.0,5737409.0,,7435553.0,8392212.0,,,,,,,,9371797.0,,,18.0,355765.0,,,,217568.0,,5.0,,10127376.0,965298.0,64754.0,,Y,,52905024.0,,1750736.0,,,,392870.0,,,,,,,,,19950.0,,49.08,,,,,,,,,37329276.0,,,,,5254144.0,,Y,1846.0,,,1.0,,221385.0,11953.0,2299244.0,,,15027721.0,-5077689.0,15996.0,1256640.0,-974.0,,1262.0,,,-132294366.0,,,,,279.44,39932.0,,,1172.0,,6299307.0,,,,,34319958.0,,,,101.0,565353.0,9022431.0,,,46238096.0,,180091093.0,1889.0,75661972.0,337162086.0,,2126753.0,,,,,,,,1288538.0,,,,,19735884.0,,,10078006.0,,29282.0,,65197.0,,1292616.0,127406.0,10209674.0,,,1399821.0,,,,,-1075539.0,,,28432933.0,,12215953.0,-5242.0,,386853.0,,,,,,2203136.0,,,,14450785.0,,,,,,,137169.0,,,2348514.0,,,,,,,3046248582.0,406272.0,2077065.0,,,,,,18.0,,,,131088.0,,,,,,23.97,,72148.0,15935758.0,,355765.0,194003.0,275592.0,,1885126.0,,,,3317.0,,6478713.0,,,,,,,,,,13711990.0,,89238891.0,,31575805.0,,1996469.0,,,,,1266761.0,1635 NORTH LOOP WEST,7517472.0,,224447.0,14513.0,,18664233.0,,635082.0,105311065.0,,736048.0,,,337248712.0,,,169211990.0,2010,Acute Care Hospitals,MEMORIAL HERMANN  HOSPITAL SYS (450184)
8246,MEMORIAL HERMANN  HOSPITAL SYS (450184),General Short Term (Acute Care Hospitals),Voluntary Nonprofit-Other,-95.430899,29.812266,,,7523751.0,,478050.0,,,16119330.0,,,,,,174718043.0,786744.0,,7656383.0,,324830733.0,12972282.0,,,Y,,927997248.0,301086.0,,,2709466.0,,,,,3275450.0,,,,3080605.0,,,3903150.0,,2791481.0,,,4190.0,,2718674.0,,5934822.0,,,8447934.0,-28383.0,,,,3127471.0,,,,,,87115849.0,228299.0,36.04,,41095956.0,,6038866.0,,,,,,,,,,,7974.0,5.0,,2038444.0,81640117.0,5.0,51227.0,,,,,,,177949.0,,19654.0,,2140594.0,,,,,417195.0,,,,,,449008.0,1625536.0,,,,,,1236891.0,,,,481718821.0,73.0,,,,42055465.0,5148302.0,,,,,115431.0,,169522439.0,,,,,630245.0,,,,,,1125868.0,,72554.0,22287897.0,,,947175205.0,,,540681.0,,,74909781.0,538.0,,,585.0,,39990653.0,,1003242.0,,,,,,,86014.0,,,,,,13660.0,6490433.0,,11260065.0,,,,622202.0,,,,188452368.0,,,,1781648.0,,70961977.0,,,,,,,192991.0,,64168162.0,,,4065379.0,,3638396.0,,783093.0,,449008.0,205350.0,,,286177433.0,,66550064.0,HOUSTON,,1653194346.0,N,,57111023.0,61.0,,-753694.0,,16751975.0,458283.0,11065544.0,,,363303.0,-9562.0,1109.0,,,,7.0,43474386.0,690899.0,,7695412.0,,0.285979,,31643.0,,,6897790.0,1049.0,,250271.0,,,477159.0,04011,,,,,280413.0,,,15395131.0,1094474.0,,,,,,36206.0,1081406.0,,,30503088.0,,,,,,,,11576998.0,1038267347.0,6158750.0,949187540.0,,,2011-07-01 00:00:00,,,2140594.0,,,457741,1073416.0,1171391.0,,,,,,,,,,,,9508089.0,,,,188452368.0,,N,,,442205182.0,554825.0,,,,,4999052.0,,,11.0,4,,1038267347.0,,103098.0,,,,204127.0,23869.0,24860733.0,,,,,,,,1.0,,,,,,13030627.0,45761.0,106604.0,2069281786.0,,,,,2791481.0,,,6607860.0,,1372.0,,,,,,2726480.0,10079.0,65997296.0,22891601.0,,,,,2092291.0,,1518308.4,16521512.0,1253271.0,293179.0,,,MEMORIAL HERMANN HOSP SYS- REHAB,905257.0,,,259861359.0,,,,,,6918946.0,28673.0,,9508089.0,51604747.0,1386159.0,,,,,,13077257.0,,44482.0,,,,,16148935.0,,,,56833650.0,,-59800368.0,38651162.0,,,9440917.0,,35434176.0,,496681.0,1656988.0,,19344907.0,,2785343.0,,,,,1397897.0,,,,,4554501.0,79409911.0,2347380.0,43519606.0,,,,,458139.0,,6608.0,,,,,,5095591.0,,,,,,,,,8301521.0,23059409.0,322.0,,3666594.0,,N,,,,745781.0,,,,,10597344.0,,16658949.0,,,,,,4442.0,19.05,2106669.0,,1764069.0,,,,,,,2021-07-15 00:00:00,,,,,,,,12875.0,,3911302.0,17041.0,,,761111.0,,,36167241.0,,,,43.0,,,317896592.0,-8779710.0,,,,45S184,,51697232.0,33682.0,1.0,17934.0,32656.0,9294935.0,,16711894.0,,,,,1336017.0,1359477.0,384177883.0,,687031.0,,,,,-40776044.0,28.8,443096.0,22425637.0,,4222.0,,36167241.0,,,,,,,1618735.0,,,45T184,,,,,,2.0,,,,,,37.97,81640117.0,,,,29.21,,26.88,,39990653.0,,,,,21344396.0,638.0,283121.0,,40679187.0,136238.0,188432338.0,,,,,7072155.0,,63456643.0,,,13486.0,22775326.0,,,,,8.0,19931060.0,,-63259.0,,929 GESSNER ROAD SUITE 2600,,,7643.0,256599.0,,59622315.0,,,2958629.0,478050.0,132866152.0,,,,,,,,,107113.0,,,,,,,,,44.68,,696.0,110145.0,,,,,,,,,,663.0,,,,,,,,905257.0,,17137739.0,794951.0,,,187248759.0,,,,7758336.0,,188476.0,465507.0,27101299.0,,,44772.0,,,,35668787.0,MEMORIAL HERMANN  HOSPITAL SYS,7555253.0,6578188.0,,,223446.0,,181819137.0,293899.0,,,,70292319.0,,,15082.0,,,,43118422.0,-234118.0,,,7148541.0,,30382823.0,,22895624.0,,,4654098.0,,,,3518889.0,34006235.0,,,,,17667.0,,,,4940524.0,64168162.0,,,,,718076.0,23878.0,521173.0,,8775385.0,18035.0,13874776.0,539072.0,,,,,188452368.0,,,,,,,,,,,,,94070411.0,,30382823.0,,3740048.0,416032.0,30345824.0,,,2409748.0,19480675.0,15853359.0,,,432194.0,,,,1925.0,10710887.0,,,2019776.0,6201193.0,,,,,,,,,,11043.0,,10050202.0,34006235.0,12463729.0,,,,94046268.0,,,,3011590.0,,,6339.0,8843482.0,4228971.0,585218555.0,,42055465.0,19663816.0,37.0,,,,,19247447.0,42.44,,,,,22848.0,,123467.0,746410.0,-331923.0,,,,,2139017.0,84412318.0,6490433.0,,,,,100566816.0,45990951.0,,,,,8727073.0,,,103470.0,11065544.0,40.95,-267983.0,,,,1157.0,,10142541.0,,,,80806436.0,,4919153.0,,39693645.0,,,,663.0,450184,,,,,8381.0,30437716.0,,,,,,,,,,,,5865350.0,58537.0,,,,,,,23412402.0,,,344362521.0,53.07,199157.0,,7341.0,,,,,290742.0,,,,63488.0,,3661.0,,15828595.0,77024,,,,,5095591.0,,,27528.0,5217.0,,,,,,,,,10099.0,,,244899.0,,,,,,2819.0,8544733.0,,,,,340546973.0,,340184489.0,,,29675413.0,,18005.0,894138.0,,26.89,28312.0,,,75081.0,306344.0,882409.0,2212255.0,45,,35799054.0,44.68,,,31.12,,,,,2022965.0,10270593.0,,7648507.0,,,,,4029275.0,,7236480.0,N,,,,927488072.0,35012.0,,2308880.0,,,,,N,,694177,1804.0,3389902.0,,,,,404886.0,,,,588370004.0,,,,,,,,,,,29864032.0,333060.0,,5453205.0,1245878.0,,,,1029426.0,19465615.0,11851123.4,,,,,,430151344.0,,,,,,,,,,4127.0,,,149835.0,,,,297391.0,,,,,,,1200000.0,,2584245.0,19842317.0,,4127.0,,15649.0,45610,,,,3823642.0,,384108.0,,,,111.0,1.0,,,,18476797.0,,,,9249.0,,,,,,,,,,,,6142.0,,132988065.0,56829883.0,,16383218.0,519011.0,,,,116.0,,,,,882409.0,,30345824.0,79409911.0,,,,321466897.0,35668787.0,,,8843482.0,,56833650.0,,1820145.0,,,,252583573.0,12225240.0,,,,,,16654270.0,,66561998.0,68161131.0,,,,,68759650.0,,4250770.0,,,430.0,,,,,,1590012740.0,4105745.0,139739.0,,,786744.0,,,,,293179.0,26420,,,,,,,46425239.0,,30437716.0,,TX,,6339.0,,,,,,,,,,9809483.0,6038866.0,,2747479.0,-3965.0,,403875.0,7805427.0,64038.0,,,433.0,15247704.0,6835361.0,64038.0,,1432056.0,,,,,,40774745.0,,,,11565424.0,,,,1346460.0,,,3863837.0,,,,,4503524.0,,3360,,,,,,3002612.0,,,,,,,784702991.0,,,1603748.0,,191504.0,,,,116970452.0,,,3903150.0,,,47138.0,,43118422.0,1.0,,,3609027.0,,,4439075.0,,,44772.0,,8723555.0,,,794951.0,,6201193.0,,,3369734.0,,,,,,,3583942.0,22070.0,,,,,4270374.0,60911377.0,,,,,47671.0,,8939798.0,13431975.0,,,,,,23965072.0,7032761.0,,,325701542.0,,,,,,,23908726.0,31.12,370103.0,,,28.8,,29.82,,,15806489.0,80574093.0,,661.0,12393.0,31.3,,,,,,,4570691.0,,,,,,,,,,-1727372.0,3.0,,15183087.0,807483.0,230.0,,,,257153.0,,,,,,,,883.0,,478050.0,,,,162281851.0,,,14153.0,,,,,,,,,658397.0,20925383.0,,,,485289126.0,,,,4718060.0,,,N,,,,,14845431.0,,,,,-183329.0,5263.0,,,,,,9799996.0,6139622.0,,124363.0,,,,,,,98461.0,,,,,,,,,41136656.0,,19124744.0,4394.0,1336017.0,,,84626.0,,,17040811.0,,,56525547.0,,,,255251.0,,,64554018.0,,7072155.0,,,,,200988.0,10.0,,,,N,,,12729.0,19972.0,,1037361.0,42338641.0,,,6483396.0,,592685.0,,1768.0,2988953.0,,21092.0,,,9624889.0,,16751975.0,,83763.0,,21190292.0,3.0,,,Y,1.0,,,,,,193681.0,145970.0,79803004.0,,,,918809.0,,2292598.0,58749.0,81.0,,49.0,188476.0,21404.0,,,19594043.0,,,N,,8665205.0,,,,,,,,1251557.0,,,,,,60793239.0,12236406.0,,66.0,6384861.0,,,,,910.0,119.0,719460.0,,5396.0,519011.0,18795011.0,286497.0,,P,,333060.0,,1631620.0,,,,,,,,13053563.0,,8924077.0,,,-34458.0,,,,3986571.0,18086866.0,,35.28,,72554.0,,,14459755.0,9511762.0,,,,,26018206.0,3460508.0,,4131.0,13075752.0,,1294794.0,122819.0,7976359.0,15082.0,,,,,1680202338.0,,,,,518303.0,,1002256.0,,4065379.0,,,,250271.0,80685614.0,63488.0,,,2800643.0,5453205.0,,,398940.0,,,32026.0,,,,48222979.0,,,,,3002612.0,638772.0,,,1876984.0,,,,,,,,5849402.0,F,,,,,,,,,,,,,384108.0,39693645.0,61376368.0,,,22287897.0,,,,-5088.0,,,,,,,,,,27677869.0,4348570.0,,,,,,,,,,,,,,,52948209.0,,,5973348.0,,16848000.0,324830733.0,,,642290.0,,,,,-1130578.0,2872293.0,,2543.0,275456.0,20639594.0,,,36.65,,1937830.0,,,478050.0,,,650626647.0,,,,48991757.0,,,,,,,253499.0,,,21156.0,10331634.0,185196.0,3243207086.0,,29357.0,,,,,,,,,,,,3206.0,104642.0,89.0,,,,,,1926227.0,,2757787.0,9389663.0,15796516.0,543803.0,815303.0,,,,,,10602407.0,84626.0,1385356.0,,,,,,31941623.0,,3779575.0,,,,,64038.0,69530.0,,,,,,1866425.0,,,,,41136656.0,,,,,2394851.0,,214128137.0,,,,7902733.0,,,6882.0,,1580530.4,70961977.0,40303410.0,,,,38989.0,,Y,,,,,,,936783007.0,91354933.0,,,,,,,,,,,,1236891.0,,MEMORIAL HERMANN,Y,124.0,,,,3.0,,,,,,5030880.0,,,,2559.0,445348.0,2093243.0,,,,17667.0,79998.0,,,,,,,,,27528.0,2216319.0,1388221.0,,,,,-1598784.0,,,61376368.0,6170955.0,1931310.0,6835361.0,,MEMORIAL HERMANN HOSP SYS-PSYCH,,967509.0,,,,1000385.0,,,,,N,-15135.0,,,,,3189057.0,905257.0,2012-06-30,,,,3638396.0,32940549.0,HO9956,,,,,,,,,,,,223595180.0,1021432.0,40581831.0,,,,95184111.0,,,70678.0,21116068.0,124.75,,,,,,,85849.0,,,,259942.0,,,,21787.0,,9545094.0,,,,,2709466.0,181050.0,,,,,23059409.0,-108842.0,,,3479992.0,,22895624.0,5973348.0,,,,,,,265055.0,,,2826442.0,647766760.0,26424461.0,,,84412318.0,5263.0,58424.0,,,,539072.0,66550064.0,39591.0,,C,925422.0,99955689.0,,,112905073.0,4285213.0,,,,,,,2313.0,89636.0,11043.0,3382934577.0,,6945.0,,,2080.0,,1021432.0,TX,,,,,1815260.0,,21116068.0,,11744865.0,6996090.0,,,1336597.0,,,,,,2207669.0,,76.0,,14046.0,HARRIS,,,,,,,1.0,,1405274.0,1386159.0,-602016.0,9607276.0,4718060.0,36167241.0,,259444.0,,,,,10099.0,,30382823.0,180345007.0,,,16654270.0,,,20507.0,,-28654126.0,,,,,185383.0,26555.0,,,,,,,43519606.0,,242118.0,16914293.0,,,,,,,,,,,1171391.0,,,5030880.0,,-76409.0,1065.0,77008-,,,,,,,,285715.0,,,23982031.0,,,,,1388221.0,,,277879.0,,,6495412.0,,-3131195.0,,116.0,,7902733.0,,,,,987951249.0,,4940532.0,153978.0,,,2637814.0,,137454913.0,1.0,,,6588.0,910.0,,,20565785.0,N,,,,,,6.0,,,8518207.0,,,4916.0,,,,13489.0,,-40776044.0,,,3863837.0,,,8301521.0,,,,,,,3024.0,400942.0,,,8447934.0,1310274.0,,1090.0,262149.0,,347156.0,,,,81356272.0,,,,6073.0,,,,,2714468.0,,,,64554018.0,,,78737275.0,,,4366413.0,,,,,,,,259861359.0,223446.0,,,43554.0,,2022965.0,,,7236480.0,-199484436.0,,66042068.0,1876474.0,50055932.0,,,83245533.0,,,263027.0,,,79409911.0,16959.0,,15395131.0,,,,1029426.0,11196.0,4960.03,,,,68111874.0,94702.0,General Short Term,,,2988279.0,,,1411627.0,-5915.0,,51697232.0,,,,,,22326.0,,,648104.0,-5028162.0,,,16521512.0,,,,,18086866.0,29299814.0,91842.0,,,,255075.0,,,344362521.0,,5512946.0,,15247704.0,6416.0,,,,393535829.0,,,,,56722518.0,,,75929.0,162880.0,9554.0,10412183.0,38651162.0,,,52948209.0,,,,,,,,,,,,,,HOUSTON,,,10814260.0,,,,1256388.0,,,,,6570164.0,,,,2279778.0,,7214834.0,,,168027285.0,,,,,8679771.0,23982031.0,8020501.0,,5319.97,54424742.0,,,,,,,,,9511762.0,,,63720740.0,,392919.0,10900619.0,,,,70218.0,257153.0,170000892.0,,,,,,2584245.0,,5234738.0,57139847.0,5906.0,4029275.0,,,,10814260.0,1125868.0,,449396.0,607109.0,6996533.0,,,2.0,6028.0,,,22425637.0,78908.0,,13207136.0,,,,-563438.0,-389780.0,,,,,,,104517.0,1313652791.0,,,,,159.0,,24.0,,,,,,26580948.0,4763.0,59622315.0,,,,840.0,,11374.0,,8799121.0,,,,,82.0,,,393007.0,,1769.0,,,,,,19488312.0,,,,,4040.0,46425239.0,,,,20342.0,,,,,,,6277370.0,15796516.0,10331634.0,48991757.0,,141677356.0,,6129191.0,,,,1442413.0,,389.0,,,31915370.0,,,,21404.0,6.0,,,,,,,1232714.0,,,,,45627.0,,21.45,57139437.0,,,,,7695412.0,6981400.0,,,,,5362436.0,,10412183.0,9813590.0,,,,,,,,12071732.0,,,18.0,476163.0,,,,257153.0,,3.0,,11379849.0,1050134.0,,,Y,,51906118.0,,2150343.0,,,,352461.0,,,,,,,,,29357.0,,53.41,,,,,,,,,37660661.0,6066.0,,,,14777238.0,,Y,2548.0,,,,,235809.0,30681.0,2559803.0,,,15950920.0,-3342208.0,14551.0,987244.0,-239.0,,,,,-203713407.0,,,,,287.95,30607.0,,,1737.0,,4954847.0,,,,,39764338.0,,,,,,12463729.0,,,48187374.0,,176741606.0,416.0,80574093.0,340184489.0,,2714468.0,,,,,,,,1292197.0,,,,,25553487.0,,,8775385.0,,22590.0,,71878.0,,1312584.0,85849.0,8091148.0,,,2109104.0,,,,,-1649869.0,,,30503088.0,,12339865.0,-1252.0,,400942.0,,,,,,6897790.0,,,,16848000.0,,,,,,,128670.0,,,1387907.0,,,,,,,1702732239.0,428287.0,1815260.0,,,,,,23.0,,,,17364.0,,,,,,24.7,,,20639594.0,,476163.0,181294.0,267042.0,,,,,,3206.0,,6747534.0,,,1.0,,,,,,,27293708.0,,90675315.0,,28932313.0,,1811639.0,,,,,1157312.0,1635 NORTH LOOP WEST,8801339.0,,212354.0,14046.0,,18749528.0,,513984.0,100566816.0,,730685.0,,,340184489.0,,,174557991.0,2011,Acute Care Hospitals,MEMORIAL HERMANN  HOSPITAL SYS (450184)
14326,MEMORIAL HERMANN  HOSPITAL SYS (450184),General Short Term (Acute Care Hospitals),Voluntary Nonprofit-Other,-95.430899,29.812266,,,10155899.0,,443006.0,,,14191530.0,,700.0,,,,213821232.0,735567.0,,7960166.0,,321542333.0,13494299.0,,,Y,,956042077.0,342834.0,,,1735951.0,,,,,3409329.0,,,,4087050.0,,,5142875.0,,9909727.0,,,4514.0,,2811982.0,,6426744.0,,,,-14836.0,,,,2711152.0,,,,,,81971183.0,233107.0,37.4,,44836964.0,,8267852.0,,,,,,,,,,1.0,5632.0,424.0,,1866840.0,41514143.0,1.0,43665.0,,,,,,,188267.0,,13502.0,,2029207.0,,,,,393506.0,,,,,,416937.0,1831600.0,,,,,,1897471.0,,,,503657120.0,201.0,,,,41060966.0,5859.0,,,,,101226.0,,177234897.0,,,,,419586.0,,,,,,931607.0,,65211.0,21966393.0,,,975486419.0,,,420412.0,,,83751665.0,358.0,,,3875.0,,43155134.0,,1065935.0,,,,,,,87879.0,,,,,,15840.0,3449091.0,,10074295.0,,,,713462.0,,,,119445577.0,,,,2749555.0,,80268704.0,,,2.0,,,,172139.0,,58113022.0,,,3461799.0,,3726732.0,,782224.0,,416937.0,205016.0,,,329654569.0,,64945288.0,HOUSTON,,1802859429.0,N,,55726206.0,61.0,,-1629794.0,,15746625.0,1588869.0,11046894.0,,,265481.0,-365.0,905.0,,,,7.0,41515998.0,754944.0,,,,0.265661,,39399.0,,,7197.0,,,262839.0,,,89858.0,04011,,,,,302778.0,,,13804904.0,1130150.0,,,,,,11730.0,1046672.0,,,31242700.0,,,,1.0,,,,10736089.0,1112212052.0,8847320.0,977584841.0,,,2012-07-01 00:00:00,,,2029207.0,,,457741,942843.0,920264.0,,,,,,,,,,,,7565226.0,,,,188921349.0,,N,,,435879826.0,550032.0,,,,,5204998.0,,,1.0,4,,1112212052.0,,64631.0,,,,82330.0,18024.0,21291523.0,,,,,,,,,,,,,,12025123.0,49817.0,29516.0,2630791049.0,,,,,9909727.0,,,4772320.0,,253.0,,,,,,2578176.0,2623.0,61693720.0,23228840.0,,,,,2293170.0,,1859558.61,14366060.0,1130023.0,302913.0,,,MEMORIAL HERMANN HOSP SYS- REHAB,1087184.0,,,292405491.0,,,,,,5841516.0,22282.0,,7565226.0,48608892.0,1385356.0,,,,,,15640808.0,,84181.0,,,,,17145425.0,,,,57086949.0,,-65679245.0,42524627.0,,,7609579.0,,53346412.0,,598417.0,1433590.0,,20137743.0,,3054544.0,,,,,191017.0,,,,,472226.0,80268704.0,1238261.0,43105290.0,,,,,471611.0,,9391.0,,,,,,5108664.0,,,,,,,,,7865050.0,22982182.0,335.0,,4548262.0,,N,,,,524719.0,,,,,10269521.0,,20271828.0,,,,,,4106.0,19.55,705061.0,,1767849.0,,,,,,,2020-06-01 00:00:00,,,,,,,,11625.0,,4008587.0,16732.0,,,788763.0,,,35795424.0,,,,,,,325926579.0,-12073477.0,,,,45S184,,57405444.0,42447.0,1.0,17885.0,8645.0,9616348.0,,16336056.0,,,,,364362.0,1906786.0,393535830.0,,644451.0,,,,,-36696683.0,29.55,471091.0,22425637.0,749.0,3577.0,,35795424.0,,,,,,,1206592.0,,,45T184,,,,,,9.0,,,,,,37.91,41514143.0,,,,29.37,,28.19,,43155134.0,,,,,22060232.0,651.0,360253.0,,38027686.0,8876.0,188867368.0,,,,,6403505.0,,13493443.0,,,9633.0,21166016.0,,,,,6.0,26305519.0,,-376010.0,,929 GESSNER ROAD SUITE 2600,,,1640.0,483751.0,,73222947.0,,,3376415.0,443006.0,132989013.0,,,,,,760.0,,,116823.0,,,,,,,,,43.9,,735.0,105598.0,,,,,,,,,,735.0,,,,,,,,1087184.0,,18338000.0,765670.0,,,212515088.0,,,,8352809.0,,196407.0,447028.0,29721140.0,,,34631.0,,,,36388247.0,MEMORIAL HERMANN  HOSPITAL SYS,8007368.0,7170834.0,,,1200261.0,,200227050.0,290289.0,,,,83771693.0,,,15010.0,,,,42994057.0,-898809.0,,,5192732.0,,29149864.0,,22624162.0,,,4996527.0,,,,3123268.0,39053418.0,,,,,16914.0,,,,57.0,58113022.0,,,,,648307.0,25279.0,489042.0,,8296228.0,59630.0,14887811.0,141262.0,,,,,188921349.0,,,,,,,,,,,,,93181020.0,,29149864.0,,2589872.0,375496.0,33700779.0,,,2572015.0,19351267.0,26115378.0,,,4298252.0,,,,496.0,12159763.0,96.0,,1504457.0,6706508.0,18.0,,,,,,,,,11649.0,,10150998.0,39053418.0,13196085.0,,,,93100188.0,,,,3245492.0,,,4344.0,8530148.0,4310434.0,579977663.0,,41060966.0,21557553.0,10.0,,,,,21288527.0,44.64,,,,,29885.0,,157205.0,506742.0,-387091.0,,,,,1268483.0,97461837.0,3449091.0,,,,,102939412.0,41483092.0,,,,,8798222.0,,,79534.0,11034206.0,41.61,-331081.0,,,,1176.0,,8490425.0,,,,88870654.0,,4214089.0,,38807597.0,,,,735.0,450184,,,,27.0,9519.0,33164322.0,,,,,,42.22,,,,,,7624396.0,67411.0,,,,,,,24252018.0,,,353061762.0,49.71,238008.0,,4742.0,,,,,247759.0,,,,66135.0,,,,16523691.0,77024,,,,,5108664.0,,,28296.0,4991.0,,,,,,,,,8047.0,,,164070.0,,,,,,2450.0,9852056.0,,,,,79105480.0,,348153460.0,,,28021086.0,,9728.0,1049626.0,,28.19,22171.0,,,76038.0,136319.0,1057299.0,2295906.0,45,,36823695.0,43.9,,,31.97,,,,,2659853.0,10268536.0,,9575392.0,,,,,3733875.0,,7357879.0,N,,,,955287645.0,32820.0,,2328893.0,,,,,N,,669583,1863.0,3455714.0,,,,,294521.0,,,,650626647.0,,,140835.0,,,2.0,,,,,30058905.0,339085.0,,6084883.0,1033884.0,,,,1078374.0,19335360.0,12205875.61,,,,,,469951920.0,,,,,,,125.0,,,4603.0,,,20704.0,11.0,5303.0,,318277.0,,,,,,,,,3094627.0,19430044.0,,4603.0,,21639.0,45610,,,,3687123.0,,414758.0,,,,374.0,51.0,,,,20583466.0,,,,7745.0,,,,,,,,,,,,4624.0,,149733410.0,54872306.0,,15835747.0,484562.0,332089.0,,,233.0,,,,,1057299.0,,33700779.0,80268704.0,,,,330177112.0,36388247.0,,,8530148.0,44142279.0,57086949.0,,1282545.0,,,,268705277.0,13131765.0,,,,,,19921515.0,,67728174.0,78253997.0,,,,,81146850.0,,2216670.0,,,,,,,,,1793035872.0,5337077.0,114464.0,,,735567.0,,,,,302913.0,26420,,,,,,,47888363.0,,33164322.0,,TX,,4344.0,,,,,,,,,,9575154.0,8267852.0,,3204887.0,-7713.0,,466325.0,6051671.0,64389.0,,,460.0,13425292.0,7501817.0,64389.0,,1438632.0,,,,2823.0,,42380641.0,,,,13024872.0,,,,1394095.0,,,3952859.0,,,,,3913189.0,,3360,,,,,,3030464.0,,,,,,,868670846.0,,,1432892.0,,158511.0,,,,124388079.0,,,5142875.0,,,3011.0,,42994057.0,3.0,,,3708875.0,,,3456781.0,,,34631.0,,8795000.0,,,765670.0,,6706508.0,,,3153086.0,,,,,,,3628486.0,13920.0,,,,,3950884.0,63940515.0,,,,,59581.0,,9413322.0,12535799.0,,,,,,22254158.0,5849727.0,,,62335417.0,,,,,,,22167334.0,31.96,291809.0,,,29.55,,31.19,,,16517342.0,92446401.0,,666.0,5073.0,32.15,,,,,,,5037449.0,,,,,,,,,,7039844.0,24.0,,15431621.0,451001.0,240.0,,,,271618.0,,,,,,,,276.0,,443006.0,,,,163555708.0,,,16957.0,,,,,,,,,596899.0,26073489.0,,,,507907653.0,,,,4523877.0,,,N,,,,,16770063.0,,,,,-67714.0,6479.0,,,,,,9575154.0,6927100.0,,119004.0,,,,,,,100834.0,,,,,,,,,39208729.0,,21557126.0,4248.0,364362.0,,,84078.0,,,15392686.0,,,59183501.0,,5.0,,111561.0,,,66909891.0,,6403505.0,,,,,110983.0,56.0,,5.0,,N,,,9879.0,9090.0,,,40130869.0,,,6008427.0,,620546.0,,1211.0,3114120.0,,17706.0,,,7671881.0,,15746625.0,,49708.0,,21542764.0,1.0,,,Y,1.0,,,,,,126105.0,243675.0,90156741.0,,,,1852237.0,,8743800.0,83799.0,145.0,,49.0,196407.0,23367.0,,,18646609.0,,,N,,10356019.0,,,,,,,,2139570.0,,,,,,58228862.0,15364140.0,,76.0,4601899.0,,,,,929.0,119.0,650082.0,,712.0,484562.0,19924716.0,295209.0,,P,,339085.0,,-2478022.0,,,,,,,,12057318.0,,8241425.0,,,-94903.0,,,,2552740.0,18351708.0,,36.12,,65211.0,,,14393753.0,8962238.0,,,,,27197056.0,3602667.0,,3848.0,13574593.0,,1431419.0,76803.0,8385326.0,15010.0,,,,,1844186155.0,,,,,80081.0,,960897.0,,3461799.0,,,,262839.0,79105480.0,66135.0,,,3072504.0,6084883.0,,,404785.0,,,38079.0,,,,48915475.0,,,,,3030464.0,566786.0,,,1887424.0,,,,,,,,6820090.0,F,,,,,,,,,,,,,414758.0,38807597.0,67441945.0,,,21966393.0,,,,-125.0,,,,,,,,,,26791442.0,4477812.0,,,,,,,,,,,,,,,49815448.0,,,5288529.0,,14649668.0,321542333.0,,1001.0,681027.0,,,,,-2837534.0,2667644.0,,1208.0,254926.0,23247107.0,,,37.72,,2086433.0,,,443006.0,,,664120090.0,,,,64183160.0,,,,,,,202374.0,,,20416.0,14246049.0,180109.0,3595895301.0,,46074.0,,,,,,,,,,,-98.0,3696.0,34584.0,76.0,,,,,,3636938.0,,2889505.0,6366105.0,13767539.0,4864750.0,814809.0,,,,,,9719820.0,84078.0,791667.0,,,,,,36481656.0,,3978345.0,,,,,64389.0,62069.0,,,,,,1629692.0,,,,,39208729.0,,,,,13489031.0,,213630495.0,,,,7902733.0,,,8779.0,,1937339.61,80268704.0,44804660.0,,,,36637.0,,Y,,,,,,,964903993.0,111523862.0,,,,,,,,,,,,1897471.0,,MEMORIAL HERMANN,Y,114.0,,,,12.0,,,,,,5639998.0,205305.0,,,1278.0,439323.0,,,,,16914.0,83560.0,,,,,,,,,28296.0,2266446.0,1350998.0,,,,,,,,67441945.0,6161406.0,2333728.0,7501817.0,,MEMORIAL HERMANN HOSP SYS-PSYCH,,937584.0,,,,906285.0,,,,,N,-19018.0,,,,,2541849.0,1087184.0,2013-06-30,,,,3726732.0,33582167.0,HO9956,,,,,,,,,,,,228145628.0,724851.0,38658697.0,,,,106269324.0,,,11039.0,21753548.0,129.43,,,,,,,106038.0,,,,272506.0,,,,25815.0,,10091537.0,,,,,1735951.0,145210.0,,,,,22982182.0,-228993.0,,,3726732.0,,22624162.0,5288529.0,,,,,,,-782438.0,,,2992392.0,664029642.0,25122474.0,,,97461837.0,6479.0,58562.0,,,,427.0,64945288.0,235733.0,,D,771456.0,104739098.0,,,120926280.0,4296531.0,,,,,,,,69762.0,11649.0,3705309568.0,,1862.0,,,1338.0,,724851.0,TX,,,,,2355583.0,,21753548.0,,10580195.0,6336971.0,20.0,,5859.0,,,,,,260488.0,,8.0,,11324.0,HARRIS,,,,,,,75.0,,1370045.0,1385356.0,-1319532.0,12063823.0,4523877.0,35795424.0,,228209.0,,,,,8047.0,,29149864.0,185481000.0,,,19921515.0,,,20246.0,,-11196743.0,,,,,262838.0,22703.0,,,,,,,43105290.0,,164869.0,17137739.0,,,,,,,,,,,920264.0,,,5639998.0,,-66902.0,224.0,77008-,,,,,,,,301060.0,,,22196916.0,,,,,1350998.0,,,258037.0,,,,,-3242504.0,,233.0,,7902733.0,,,,,1012183102.0,,4599306.0,19585.0,,,2181355.0,,139159985.0,,,,6570.0,929.0,,,17025895.0,N,,,,,,6.0,,,4940891.0,,,4659.0,,,,15454.0,,-36696683.0,,,3952859.0,,,7865050.0,,,,,,,3318.0,305948.0,,,,1912563.0,,1109.0,278935.0,,405617.0,,,,76763674.0,,,,5753.0,,,,,2571370.0,,,,66909891.0,,,83980644.0,,,3431830.0,,,,,,,,,1200261.0,,,43435.0,,2659853.0,,,7357879.0,-288693183.0,,61728351.0,1808627.0,64100335.0,,193.0,89619117.0,,,195784.0,,,80250078.0,3535.0,,13804904.0,,,,1078374.0,12162.0,4965.59,,,,78206815.0,90693.0,General Short Term,,,2753292.0,,,1285817.0,,,57405444.0,,,,,,22265.0,,,815566.0,-5687668.0,,,14366060.0,,,,,18345725.0,29691810.0,82467.0,,,,264984.0,,,352801274.0,,6745607.0,,13425292.0,7427.0,,,,419651208.0,,,,,56530567.0,,,9996.0,162703.0,6503.0,9381199.0,42524627.0,,,49815448.0,,,,,,,,,,749.0,,,,HOUSTON,,,11902065.0,,,,646577.0,,,,,3497717.0,,,,1577231.0,,7650024.0,,1207.0,186587091.0,,,,,10419649.0,22196916.0,8818893.0,,5311.01,52252791.0,,,2.84,,,,,,8962238.0,,,68289126.0,,196804.0,12004138.0,,,,70218.0,271618.0,172525782.0,,,,,,3094627.0,,5308547.0,51816721.0,7085.0,3733875.0,,44.0,,11902065.0,931607.0,,,588535.0,6310033.0,,,6.0,7620.0,,,22425637.0,49187.0,,12308111.0,,,,-633315.0,695276.0,,,,,,,91682.0,1074518519.0,,,,,57.0,,59.0,,,,,,28117033.0,4448.0,73222947.0,,,,657.0,,9869.0,,9329069.0,,,,,,,,492972.0,,344.0,,,-173.0,,,18423703.0,,,,,20542.0,47887156.0,,,,27415.0,,,,,,,6801057.0,13767539.0,14246049.0,64183160.0,,143733475.0,,5914904.0,,,,1732259.0,,63.0,,,28914961.0,,,8127.0,23367.0,3.0,,,,,,,1439234.0,,,,,52951.0,,25.66,51816055.0,,,,,,6424178.0,,,,,5741230.0,,9381199.0,9470721.0,,,,,,,,14689425.0,,,18.0,468810.0,,,,271618.0,,1.0,,11127323.0,1126306.0,,,Y,,49127274.0,,2208784.0,,,,441355.0,,,,,,,,,46074.0,,50.31,,,,,,,,,45710420.0,,,,,14974933.0,,Y,1271.0,,,18.0,,298669.0,31633.0,2630864.0,,,14740246.0,-13426463.0,18200.0,902770.0,-281.0,,,,,-293003617.0,,,,86.0,275.54,34431.0,,,1938.0,,3933356.0,,,,,44663398.0,,,,,18.0,13196085.0,,,48879004.0,,177949461.0,527.0,92446401.0,348153460.0,,2571370.0,,,,,,,,1170130.0,1727424160.0,,,,25167551.0,,,8296228.0,,21730.0,,28416.0,,2646053.0,106038.0,8975130.0,28.0,,2246636.0,,,,,4031241.0,,,31242700.0,,13107299.0,-2437.0,,305948.0,,,,,,7197.0,,,,14649668.0,,,,,,,260720.0,,,5788483.0,,,,,,,1861123413.0,620760.0,2355583.0,,,,,,15.0,,,,29760.0,,,,,,24.31,,,23106272.0,,468810.0,173046.0,257894.0,,,,,,3696.0,,8296443.0,,,3.0,,,,,,,22779674.0,,93162861.0,,33857736.0,,1923914.0,,,,,1329151.0,1635 NORTH LOOP WEST,5904621.0,,221686.0,11324.0,,19360878.0,,473773.0,102939412.0,,751038.0,,,347892972.0,,,168573611.0,2012,Acute Care Hospitals,MEMORIAL HERMANN  HOSPITAL SYS (450184)
20582,MEMORIAL HERMANN  HOSPITAL SYS (450184),General Short Term (Acute Care Hospitals),Voluntary Nonprofit-Other,-95.430899,29.812266,,,7916397.0,,497407.0,,,13615444.0,,3121.0,,,,265677134.0,781931.0,,8238073.0,,357797437.0,13979512.0,,,Y,,993728691.0,748.0,,,1720952.0,,,,,2958681.0,,,,3375064.0,,,5435764.0,,8915494.0,,,5814.0,,2851190.0,,5551315.0,,,,-10961.0,,,,2649424.0,,,,,,86094794.0,212281.0,47.64,,47807799.0,,6409503.0,,,,,,,,,,,4362.0,22.0,,3310160.86,64643014.0,-7.0,23621.0,,,,,,,208851.0,,26697.0,,2016500.0,,,,,437958.0,,,,,,354175.0,1609491.0,,,,,,2017111.0,,,,555044861.0,-28.0,,,,43616178.0,,,,,,106981.0,,179758127.0,,,,,332480.0,,,,,,898299.0,498166.0,41803.0,20702762.0,,,1013136706.0,,,449552.0,,,70650836.0,338.0,,,3227.0,,48949931.0,,1078574.0,,,,,,,66350.0,,,,,,21631.0,3430969.0,,6299435.0,,1556.0,,582535.0,,,,117129865.0,,,,1857284.0,,71014322.0,,,,,,,70892.0,,61807205.0,,,1523017.0,,3452431.0,,895849.0,,354175.0,209156.0,,,390860454.0,,66807672.0,HOUSTON,,2041636887.0,N,,55623409.0,61.0,,-938314.0,,19813746.0,1567270.0,11077209.0,,,267365.0,,1465.0,,,,7.0,45356398.0,954050.0,,,,0.244584,,26059.0,,,,,175550.0,292058.0,,,310959.0,04011,,,,,199880.0,,,13846681.0,1264287.0,,,,,,8793.0,1007238.0,,,32497475.0,,,,,,343.0,,11105728.0,1153726195.0,9880517.0,1015939477.0,,,2013-07-01 00:00:00,,,2016500.0,,,457741,1214176.0,673761.0,,,,,,,,,,,,8470135.0,,,-85364.0,182917605.0,,N,,,451503174.0,574665.0,,,,,6586896.0,,,-9.0,4,,1153726195.0,,76841.0,,,,117648.0,11573.0,22228607.0,,,,,,,,-1.0,,,,,,11197953.0,69595.0,51041.0,3024579573.0,,,,,8915494.0,,,4671882.0,,-1265.0,,,,,,2306304.0,,62720009.0,20702928.0,,,,,2091186.0,,1971116.0,13862385.0,1117775.0,317971.0,498166.0,,MEMORIAL HERMANN HOSP SYS- REHAB,1149187.0,,,276723303.0,,,,,,6559547.0,21676.0,,8470135.0,52517785.0,1579857.0,,,,,,15626099.0,,79643.0,,,,,18308556.0,,,,52634110.0,,-67515783.0,45134332.0,,,9053146.0,,68062378.0,,782975.0,1453531.0,,19364462.0,,3209736.0,,,,,2124843.0,,,,,7348182.0,71014322.0,1259390.0,44589189.0,,,,,1039.0,,10658.0,,,,,,6412568.0,,,,,,,,,7478455.0,23513941.0,306.0,,6175871.0,,N,,,,674645.0,,,,,10624943.0,,21550927.0,,,,,,4248.0,20.35,4122869.0,,1770151.0,,,,,,,2021-09-08 00:00:00,,,,,,,,11425.0,,4256144.0,43.0,,,485187.0,,,37824416.0,,,,,,,380674059.0,-8708521.0,,,,45S184,655719.0,66789948.0,39981.0,1.0,20440.0,9995.0,9500435.0,,14568578.0,,,,,2137262.0,184885.0,419651208.0,,618165.0,,,,,-61750723.0,31.27,418301.0,34279061.0,121.0,4175.0,,37824416.0,,,,,,,937005.0,,,45T184,,,,,,8.0,,,,,,38.64,64643014.0,,,,33.15,,24.16,,48949931.0,,,,,25122532.0,560.0,675025.0,,47963124.0,18468.0,182850765.0,,,,,7322891.0,,37537269.0,,,9164.0,21508241.0,,,,,1.0,28773818.0,,-24476.0,,929 GESSNER ROAD SUITE 2600,,,10594.0,253681.0,,81164984.0,,,3623462.0,497407.0,147511424.0,,,,,,123.0,4928.0,,83497.0,,,,,,,,,46.48,,511.0,108363.0,,,15.38,,,,,,,4796.0,,,,,,,,1149187.0,,21792664.0,674429.8,,,263578555.0,,,,8946201.0,,206807.0,504323.0,31194122.0,,,38460.0,,,,35854970.0,MEMORIAL HERMANN  HOSPITAL SYS,9109927.0,7193611.0,,,3454664.0,,232795606.0,281377.0,,,,100320870.0,,,14738.0,,,,43918580.0,-881191.0,,,5121434.0,,28983256.0,,21090447.0,,,5970318.0,,,,3220373.0,44801162.0,,,,,17337.0,,,,,61807205.0,,,,,692253.0,28582.0,474328.0,,7562179.0,58265.0,16375962.0,53109.0,,,,,182917605.0,,,,,,,,,,,,,98177236.0,,28983256.0,,2791222.0,448145.0,34222222.0,,,3069228.0,17824893.0,19528212.0,,,4606312.0,,,,553.0,10883286.0,6.0,,2081751.0,7672726.0,5.0,,,,,,,,,10930.0,,11812224.0,44801162.0,13221252.0,,,,98068086.0,,,,3354709.0,,1049215.0,4248.0,8567763.0,4329343.0,593189715.0,,43616477.0,34233698.0,40.0,,,,,25411396.0,45.85,,,,,19866.0,,149802.0,623780.0,-900001.0,,,,,1199944.0,103356480.0,3430969.0,,,,,101781552.0,39713667.0,,,,,8828364.0,,,51718.0,12502834.86,40.28,-364119.0,,,,1200.0,,10260860.0,,,,97809616.0,,5744869.0,,34712087.0,,,,4796.0,450184,,,,1.0,6884.0,35375834.0,,,,,,12.3,,,,,,4155417.0,79357.0,,,,,,,26801642.0,,,374658037.0,49.38,,,5718.0,,,,,234299.0,,,,68892.0,,,,16634530.0,77024,,,,,6412568.0,,,29574.0,1043.0,,,,,,,,,9148.0,,,123144.0,,,,,,884.0,8492807.0,,,,,71865968.0,,369445598.0,,,33271766.0,,438.0,1140409.0,,24.13,25976.0,,,75050.0,131078.0,1129321.0,-7326582.0,45,,38389882.0,46.48,,,32.52,334753.0,,,,3831759.0,11828405.06,,9340919.0,,,,,3439522.0,,17260677.0,N,,,,992996192.0,43780.0,,2012716.0,,465447.0,,,N,,698333,1315.0,3931661.0,,,,,360622.0,,,,664120090.0,,,52858.0,,,,,,,,28590648.0,351130.0,,6609066.0,1208093.0,,,,2352.0,17808028.0,13900168.23,,,,,,525897862.0,,,,,,,,,,3636.0,,,128200.0,1.0,-54139.0,,302914.0,,,,,,,,,3318354.0,18665900.0,,3636.0,,4089.0,45610,,,,3723155.0,,414676.0,,,,374.0,6.0,,,,21288527.0,,,,3458.0,,,,,,,,,,,,6723.0,,158685476.0,49827011.0,,15208934.0,545782.0,210911.0,,,1.0,,,,,1129027.0,,34222222.0,71014322.0,,,,385498813.0,35854970.0,,,8567763.0,39046377.0,52634110.0,,1072478.0,13425545.0,,,286065316.0,14040162.0,,,,,,24929964.0,,56480926.0,77257081.0,,,,,139967036.0,,4678697.0,,,,,,,,,2018304520.0,2701021.0,112515.0,,,781931.0,,,,,317971.0,26420,,,,,,,53257102.0,,35375834.0,,TX,,4248.0,,,,,,,,,,9607932.0,6409503.0,,2646680.0,-44889.0,,,4314239.0,64120.0,,,423.0,12883672.0,8961949.0,64120.0,,1398066.0,,,,14151.0,,45538637.0,,,11086907.0,15150106.0,,,,1708683.0,,,4196157.0,,,,,3729541.0,42929.0,3360,,,,,,3258133.0,,,,,,,942833235.0,,,1411977.0,,205311.0,,,,120977304.0,,,5435764.0,85364.0,,6347.0,,43918580.0,3.0,,,3427955.0,,,3400482.0,,,38460.0,,8804100.0,,,674429.8,,7672726.0,,,3710288.0,,303.0,,,,,4065709.0,13309.0,,,,,3777648.0,86651586.0,,,,,83577.17,,16772723.0,12375777.0,,,,,,21906838.0,6223104.0,330430.0,,51116826.0,,,,,,,21847443.0,33.82,278132.0,,,31.27,,28.78,,,16624124.0,97338556.0,,581.0,12250.0,32.59,,,,,,,5176906.0,,,,,,,,,,-11449491.0,1.0,,16541689.0,346107.0,1487.0,,,,299610.0,,,,,,,,1119.0,,497407.0,,,,157122273.0,,,,,,,,,,,,480603.0,27529578.0,,,,559869615.0,,,,4236033.0,,,N,,,,,20749142.0,,,,,-224765.0,7827.0,,,,,,9607932.0,6559562.0,,113196.0,,,,,,,77286.0,,,,,,,,,42574225.0,,34233447.0,868.0,2137262.0,,,82041.0,,,16320117.0,,,61710244.0,,,,82523.0,,,72536414.0,,7322891.0,,,,,92996.0,11.0,,,,N,,,4009.0,6804.0,,,41069144.0,,,5454659.0,,613564.0,,2285.0,2700575.0,,13335.0,,,8591222.0,,19813746.0,,51199.0,,22210786.0,11.0,,,Y,1.0,,,,,,66591.0,129785.0,97592292.0,,,,1043704.0,,10480697.0,116436.0,1.0,,56.0,206807.0,22887.0,,,17625657.0,,,N,,8597830.0,,,1032.0,,,,,903803.0,,,,,,95280114.0,15946026.0,,56.0,4758842.0,-299.0,,,,962.0,103.0,726682.0,,,545782.0,22232275.0,258106.0,,P,,351130.0,,-2802337.0,,,,,,,,11231497.0,,8261825.0,,,-132816.0,,,,2383943.0,31560146.0,,37.26,,41803.0,,,13850752.0,10511678.0,,,,,30117930.0,3755337.0,,2436.0,14031353.0,,1473735.0,64035.0,8396093.0,14738.0,,,,,2066905620.0,,,,,63611.0,,968513.0,,1523017.0,,,,292361.0,71865968.0,68892.0,,,3182512.0,7124155.0,,,410990.0,,,44316.0,,,,52395800.0,,,,,3258133.0,715168.0,,,2444797.0,,,,,,,,7318645.0,F,,,,,,,,,,,,,414676.0,34712087.0,80206731.0,,,20702762.0,,,,-135.0,,,,,,,,,,32371306.0,14192169.0,,,,,,,,,,,,,,,50262585.0,,,6383005.0,,14266344.0,357797437.0,73902.0,,798058.0,,,,,-3492903.0,2570098.0,,1869.0,294657.0,18252232.0,,,39.66,,2318760.0,,,497407.0,,,689803936.0,,,,67883121.0,,,,,,,222313.0,,,21152.0,16927110.0,190678.0,4059941407.0,,9283.0,,,,,,,,,,,,2743.0,25587.0,114.0,,,,,,3402279.0,,2952081.0,6506791.0,17140537.0,5460841.0,971257.0,,,,,,10317356.0,82041.0,631000.0,,,,,,35405197.0,,4118432.0,,,,,64120.0,38649.0,,,,,,2446478.0,,,,,42572474.0,,,,,14729607.0,,223086980.0,,,,7902733.0,,,7249.0,,2071763.17,71014322.0,52485930.0,,,,37282.0,,Y,,,,,,,1002496627.0,136799261.0,,,,7744184.0,,,,,,,,2017111.0,,MEMORIAL HERMANN,Y,83.0,,,,11.0,,,,,,5830903.0,872330.0,,,1186.0,547822.0,1791340.0,,,,17337.0,61246.0,,,,,,,,,29574.0,2412025.0,1751101.0,,,,,,,,80206731.0,6479343.0,2228834.0,8961949.0,,MEMORIAL HERMANN HOSP SYS-PSYCH,,1046184.0,,,,1965974.0,,,,,N,-16865.0,,,,,2758440.0,1149187.0,2014-06-30,,,,3452431.0,31679226.0,HO9956,,,,,,,,,,,,232390150.0,343375.0,41999560.0,,,,160507288.0,,,68667.0,24844685.0,128.07,,,,,,,157996.0,,,,238340.0,,,,29956.0,,10532253.0,,,,,1720952.0,241100.0,,,,,23513941.0,-146383.0,,,3452431.0,,21090447.0,6383005.0,,,,,,,-225449.0,,,2604506.0,705441831.0,20540252.0,,,103356480.0,7827.0,68162.0,,,,251.0,66807672.0,374766.0,,E,737416.0,109626205.0,,,119454287.0,4722507.0,,,,,,,,91348.0,10930.0,4150583828.0,,1806.0,,,2496.0,,343375.0,TX,,11086907.0,,,2186165.0,,24844685.0,,6812695.0,7279952.0,143.0,,,,,,,,2116753.0,,-85.0,,14906.0,HARRIS,,,,,,,3.0,,1776134.0,1579857.0,-1598086.0,10821151.0,4236033.0,37824416.0,,148578.0,,,,,9148.0,,28983256.0,183654822.0,,,24929964.0,,,22122.0,,-220250117.0,,,,,199581.0,19766.0,,,,,,,44589189.0,,203541.0,18338000.0,,,,,,,,,,,673761.0,,,5830903.0,,-42939.0,1388.0,77008-,,,,,,,,213895.0,40413.0,,20890849.0,,,,,1751101.0,,,264902.0,,,,,-3474496.0,,1.0,,7902733.0,,,,,1074887429.0,,4142793.0,,,,1893159.0,,134605046.0,-1.0,,,6570.0,962.0,,,19287122.0,N,,,,,,6.0,281475.69,,7325461.0,,,3061.0,,,,736.0,,-61750723.0,,,4196157.0,2874546.0,,7478455.0,,,47.7,503494.17,294.0,,2881.0,332109.0,,,,1822439.0,,1126.0,190103.0,,298771.0,,,,78511342.0,,,,5992.0,,,,,2880800.0,,,16.91,72536414.0,,,88174145.0,,,3581873.0,,,,,,,,,3454664.0,,,37595.0,,3831759.0,,,17260677.0,-349643520.0,,62758469.0,1722367.0,84256364.0,,,94471958.0,,,155289.0,,,85604729.0,27402.0,,13846681.0,,,,2352.0,31.0,5273.01,,,,77218618.0,83180.0,General Short Term,,,3237395.0,,,1190168.0,,,66789948.0,,,45065.0,,,22265.0,,,849577.0,-1889251.0,,,13862385.0,,,,,31560146.0,30636486.0,62388.0,,,,276605.0,,,406589260.0,,6095536.0,,12883672.0,7526.0,,,1751.0,439179420.0,,,,,59173679.0,,,,152685.0,297.0,8988311.0,45134332.0,,113.0,50262585.0,,,,13425545.0,,,,,,121.0,50.0,,,HOUSTON,,,11932245.0,,,,292755.0,,,,,3480017.0,,,,1433738.0,,7163431.0,,,211929045.0,,,,,11490037.0,20890849.0,8123587.0,,5575.67,51457386.0,,,,,,,,,10511678.0,,,80609873.0,,163228.0,12013105.0,,,,73277.0,299610.0,171635855.0,,,,,,3318354.0,,5030893.0,59271918.0,8190.0,3439522.0,,,,11932245.0,898299.0,,,692602.0,6553384.0,,,-1.0,11209.0,,,22425637.0,170294.0,,12398582.0,,,,-782456.0,1623962.0,,,,,,,98742.0,1126004255.0,,,,,274.0,,-11.0,,,,,,30501685.0,5374.0,81164984.0,,,,693.0,,3925.0,,9639704.0,,,,,,,,372614.0,,2263.0,,,,,,17479674.0,,,,,5085.0,53257102.0,,,,36096.0,,,,,,,7782414.0,17140537.0,16927110.0,67883121.0,,139549279.0,,6109461.0,,,,1628783.0,,-327.0,,,32862690.0,,,,22887.0,-5.0,,,,,,,1782177.0,,,,,44887.0,,26.55,59271729.0,,,,,,5877351.0,,,,,5207180.0,,8988311.0,11493717.0,,,,,,1049215.0,,17739625.0,,,18.0,489341.0,,,,299610.0,,1.0,,11445027.0,1176409.0,7744184.0,,Y,,52809926.0,,1929975.0,,,,604497.0,,,,,,,,,9283.0,,49.89,,,,,,,,,44161101.0,,,,,16521042.0,,Y,1184.0,,,5.0,,274543.0,6886.0,3053543.0,,,14878429.0,167207915.0,17070.0,1096929.0,,,64.0,,,-353972863.0,,,,,227.89,27156.0,,,1814.0,,3472959.0,,,,512514.0,52432821.0,,,,,10.0,13221252.0,,,52336706.0,,170973025.0,863.0,97338556.0,369445598.0,,2880800.0,,,,,,,,1139751.0,,,,,29177952.0,,,7562179.0,,62601.0,,38569.0,,1605699.0,157996.0,8737088.0,,,2317366.0,,,,,675917.0,,,32497475.0,,12479029.0,,,337037.0,,,,,,,,,,14266344.0,,,,,,,395589.0,,,4735877.0,,,,,,,2083678208.0,625327.0,2186165.0,,,,,,21.0,,,,30895.0,,,,,,18.42,,,18199374.0,,489341.0,185868.0,288938.0,,,,,,2743.0,,6744790.0,,,-1.0,,,,,,,17639090.0,,92647618.0,,65061596.0,,2271054.0,,,,,1542455.0,1635 NORTH LOOP WEST,6062968.0,,235389.0,14906.0,,20665056.0,,711687.0,101781552.0,,757794.0,,,401376821.0,,,179154067.0,2013,Acute Care Hospitals,MEMORIAL HERMANN  HOSPITAL SYS (450184)
26860,MEMORIAL HERMANN  HOSPITAL SYS (450184),General Short Term (Acute Care Hospitals),Voluntary Nonprofit-Other,-95.430899,29.812266,,,2971001.0,,719740.0,,,13299426.0,,255.0,,,,286543577.0,1281793.0,,8777650.0,,394913847.0,14905546.0,,,Y,,1027500914.0,800.0,,,2994692.0,,,,,389343.0,,,,2537272.0,,,6156655.0,,10371715.0,,,2507.0,,3037305.0,,5302970.0,,,,-33032.0,,,,3019558.0,,,,,,90592843.0,52862.0,41.98,,49332045.0,,2261825.0,,,,,,,,,,,51.0,73.0,,3299057.52,64467951.0,,24282.0,,,,,,,282059.0,,64367.0,,2318761.0,,,,,810201.0,,,,,1.0,3026.0,212407.0,,,,,,2322866.0,,,,603210879.0,91.0,594.0,,,47973106.0,,,,,,146168.0,,204021262.0,,,,,460006.0,,,,,,984087.0,41476.0,37114.0,20927056.0,,,1046936395.0,,,644845.0,,,84062079.0,499.0,,,7708.0,,53939588.0,,1139363.0,,,,,,,859.0,,,,,,13397.0,3685498.0,,5586235.0,8512011.0,,,8861.0,,,,160833842.0,,,16455529.0,1963772.0,,73894784.0,,,,,,,106771.0,,61454842.0,,,1147593.0,,386317.0,852987.0,969341.0,,3026.0,94222.0,,,467672574.0,,71058104.0,HOUSTON,,2289566015.0,N,,74121272.0,61.0,,-11625750.0,,25000727.0,1865639.0,11292041.0,,,545103.0,,1245.0,,,,7.0,46533387.0,1215696.0,,,,0.225212,,,,,,1530.0,237052.0,314408.0,,,438252.0,04011,,,,,241079.0,,,14090477.0,1376469.0,,,,,,7977.0,1006276.0,,,35712429.0,,,,,,,,10997523.0,1218369209.0,10917122.0,1049356747.0,,,2014-07-01 00:00:00,,,2318761.0,,,457741,1068769.0,646944.0,,,,,,,,,,,,8678228.0,,,-142676.0,193592289.0,,N,9343092.0,,439503340.0,564818.0,,,,,5741953.0,,,,4,,1218369209.0,,120808.0,,,,51562.0,41856.0,25721030.0,,,,,,,,,,,,,,10035459.0,62519.0,,3355248271.0,,,,,10371715.0,,,7429004.0,,,,,,,,2196964.0,,62404736.0,19284604.0,,,852987.0,,641359.0,,2302485.91,15932761.0,996280.0,335439.0,41476.0,,MEMORIAL HERMANN HOSP SYS- REHAB,1379592.0,,,255906284.0,,,,,,9890181.0,387.0,,8678228.0,54476099.0,1605013.0,,,,,,16400901.0,,19573.0,,,,,26636071.0,,,,57558074.0,,-123922379.0,48849980.0,,,8384150.0,,57192879.0,,850834.0,1364984.0,,18537520.0,,3241988.0,,,,,5930335.0,,,,,7226610.0,73894784.0,1279589.0,42026615.0,,,,,1089.0,,92.0,,,,,,6437911.0,,,,,,,,,6850205.0,25840683.0,3.0,,2232313.0,,N,,,,1246822.0,,,,,13378957.0,,24588717.0,,,,,,5100.0,20.53,731352.0,,262872.0,,,,,,,2023-10-26 00:00:00,,,,,,,,11625.0,,1934300.0,44.0,,,432715.0,,,40747916.0,,,,44.0,,,404897888.0,-9831358.0,,,,45S184,682950.0,69799428.0,39459.0,1.0,24455.0,,9702456.0,,14061235.0,,,,,2735571.0,346888.0,439179420.0,,593312.0,,,,,-121752675.0,32.39,5084.0,35335663.0,,,,40747916.0,,,,,,,498036.0,,,45T184,,,,,,14.0,,,,,,39.31,64467951.0,,,,34.79,,24.75,,53939588.0,,,,,24439686.0,3.0,903139.0,,63689055.0,,193188837.0,,,,,11026626.0,,16872091.0,,292165.0,,27372830.0,,,,,1.0,30826909.0,,-1296.0,,929 GESSNER ROAD SUITE 2600,,,12154.0,196249.0,,90266644.0,,,3840965.0,719740.0,149680364.0,,,,,,,9516.0,5158444.0,821.0,,,,,,,,,43.67,,462.0,119095.0,,,16.84,,,,,,,12294.0,,,,,,,,1379592.0,,35503158.0,655849.0,,,310962986.0,,,,8679086.0,,221336.0,656703.0,31600681.0,,,49527.0,,,,36518824.0,MEMORIAL HERMANN  HOSPITAL SYS,13193056.0,7065203.0,,,13710494.0,,252884561.0,52862.0,,,,121868905.0,,,14962.0,,,9351946.0,42355949.0,-177252.0,,,8073849.0,,30310188.0,,21243623.0,,,6122722.0,,,,3139468.0,43978039.0,,,,,18125.0,,,,,61454842.0,,,,,620190.0,28168.0,444782.0,,8559464.0,101725.0,16349305.0,1910.0,,,,,193592289.0,,,,,,,,,,,,,99798897.0,,30310188.0,,1998029.0,627841.0,35465648.0,90089.0,,4342257.0,7149290.0,20243988.0,,,4974722.0,,,,,3748971.0,22.0,,4263953.0,11504183.0,49.0,,,,,,,,,10967.0,,11189428.0,43978039.0,12377665.0,,,,99742882.0,,,,3534536.0,,1003401.0,7049.0,9620019.0,3711918.0,594510367.0,,47973905.0,42234313.0,7.0,485161.0,,,,26142748.0,56.07,,,,,18878.0,,477.0,1183827.0,-413527.0,,,,,602537.0,124418207.0,3685498.0,,,,,101420838.0,42481461.0,,,,,9257930.0,,,254356.0,12800221.52,41.55,-514523.0,,,,1220.0,,18024193.0,,,,110015098.0,,5889424.0,,31216132.0,,,,12294.0,450184,,6560489.0,,4.0,55.0,40887360.0,,,,,,,,,,,,13823006.0,83137.0,,,,,,,28273521.0,,,394483564.0,49.43,,32045.0,10504.0,,5005.0,,,355872.0,,,,69965.0,,8767.0,,18356797.0,77024,,,,,6437911.0,,,30634.0,359.0,,,,,,,,,15303.0,,,255083.0,,,,,,1019.0,3233832.0,,,,,143925126.0,,390108737.0,,,33912250.0,,78748.0,1100983.0,,25.0,33268.0,,,77131.0,136919.0,1360714.0,-6920831.0,45,1512369.0,41170935.0,43.67,,,33.61,193324.0,,,,7951397.0,12144372.52,,8588738.0,,,,,4711558.0,,28792908.0,N,,,,1026370217.0,35650.0,,22807.0,,484467.0,,,N,,751580,1166.0,3070143.0,,,,,419441.0,,,,701657359.0,,,,,,,,,,,30065678.0,357700.0,,7422942.0,1254940.0,,,,2517.0,7149290.0,14615795.43,,,,,,567419135.0,,,,,,,,,,14.0,,,368151.0,19.0,-78319.0,,298912.0,,,,,,,,203.0,3645384.0,18973588.0,,14.0,,9069.0,45610,,,,3912066.0,,527403.0,,,,643.0,113.0,,,,25411396.0,,,,3477.0,,,,,,,,,,,,3750.0,,180857306.0,51337309.0,,16611123.0,770424.0,85736.0,,,15.0,,,,,1360714.0,,35465648.0,73894784.0,,,,408956148.0,36518824.0,,,9620019.0,39446468.0,57558074.0,,1679368.0,16473228.0,,,324541501.0,24712137.0,,,,,,19233197.0,,52166606.0,86872342.0,,,,,187531361.0,,4472801.0,,,,,,,,,2267777394.0,8984954.0,224795.0,32045.0,,1281793.0,,,,,335439.0,26420,,,,,,,60563820.0,,40887360.0,,TX,,7049.0,,,,,,,,,,10046684.0,2546482.0,,2002100.0,-211902.0,,,3145622.0,66164.0,,,4.0,13423766.0,9331626.0,66164.0,,1314760.0,,,,1179.0,,52601912.0,,,11720888.0,18101227.0,,,,1837044.0,,,1912503.0,,,,,3747762.0,27473.0,3360,,,,,,3288631.0,,,,,,,1101734154.0,,,1431307.0,,278027.0,,19993.0,,120303528.0,,,6156655.0,142676.0,,,6708042.0,42355949.0,3.0,,,385021.0,,56400.0,5079157.0,,,49527.0,,9140174.0,,,655849.0,,11504183.0,,,5968510.0,,,,,,,4633243.0,,,,,,1006415.0,105336634.0,,,,,141800.0,,16412408.0,11651758.0,,,,,,22589432.0,5834161.0,12810.0,,117069986.0,,,,,,,22520725.0,34.93,366089.0,,,32.39,,30.51,,,18323765.0,113808836.0,,4.0,-10366.0,33.67,,,,,,,5572350.0,,,,,,,,,,-7341971.0,4.0,,18039266.0,658762.0,3368.0,,,,321645.0,,,,,,,,,,719740.0,,,,156944951.0,,,,,,,,,,,,177345.0,27287073.0,,,,607269139.0,,,,4209065.0,,,N,,,,,26855140.0,,,,,-112662.0,7649.0,,,,,,10046684.0,6297611.0,56400.0,2370.0,,,,,,,309.0,,,,,,,,,44605715.0,,42232403.0,279.0,2735571.0,,,84194.0,,,17706222.0,,,68520339.0,,,,202591.0,,,76192041.0,,11026626.0,,,,,187252.0,27.0,,,,N,,,4714.0,13486.0,,,43041286.0,,,5682190.0,,696102.0,,4662.0,336286.0,,33998.0,,,8777135.0,,25000727.0,,89053.0,,21855833.0,12.0,,,Y,1.0,,,,,,35378.0,49340.0,105926595.0,,,,3396777.0,,13758711.0,578.0,8.0,,67.0,221336.0,21859.0,,,18428269.0,,,N,,33239.0,,,,,,,,164968.0,,,,,,100660539.0,16988880.0,,30.0,8355703.0,-799.0,,,,980.0,110.0,590150.0,,,770424.0,25636424.0,53057.0,,P,,357700.0,,-2595189.0,,,,,,,,10035459.0,,7382475.0,,,-73055.0,,,,2515926.0,30314582.0,,41.25,,37114.0,,,14350716.0,12587093.0,,,,,30788366.0,4197463.0,,2202.0,15159902.0,,1641157.0,113099.0,8668526.0,14962.0,,,,,2309094939.0,,,,,921537.0,,1191826.0,,1147593.0,,,,314408.0,143925126.0,69965.0,,,3376546.0,7855521.0,,,420115.0,,,52816.0,,,,51780706.0,,,,,3288631.0,891273.0,,,2678029.0,,,,,,,,9248461.0,F,,,,,,,,,,,,,527403.0,31216132.0,89843008.0,,,20927056.0,,,,,,,,,,,,,,41892279.0,14249726.0,,,,,,,,,,,,,,,51943648.0,,,7128980.0,,10326043.0,394913847.0,74823.0,,1248527.0,,,,,-4619159.0,2068906.0,,1596.0,529731.0,17565421.0,,,41.63,,1147113.0,,,719740.0,,,718529450.0,,,,72116212.0,,,,,,,223275.0,,,18518.0,12256747.0,201842.0,4557343409.0,,23994.0,,,,,,,,,,,,14.0,26412.0,87.0,,,,,,4328230.0,,3087100.0,7190703.0,21507711.0,6190097.0,1007432.0,,,,,,11336600.0,84194.0,1139238.0,,,,,,38394088.0,,3626182.0,,,,,66164.0,34060.0,,,,,,2479025.0,,,,,44576329.0,,,,,14998935.0,,250237657.0,,,,7902733.0,,,7237.0,,2471422.91,73894784.0,59799734.0,,,,40502.0,,Y,2681280.0,,,,,,1036072673.0,138980106.0,,,,7806748.0,,,,,,,,2322866.0,,MEMORIAL HERMANN,Y,46.0,,,,17.0,,,,,,5972240.0,959478.0,,,2695.0,484128.0,6475054.0,,,,18125.0,728.0,,,,,,,,,30634.0,3184800.0,1680950.0,,,,,,,,89843008.0,6579557.0,1645524.0,9331626.0,,MEMORIAL HERMANN HOSP SYS-PSYCH,,1560073.0,,,,2789831.0,,,,,N,,,,,,1966306.0,1379592.0,2015-06-30,,,,386317.0,33207284.0,HO9956,,,,,,,,,,,,249210072.0,185787.0,44040897.0,,,,211412910.0,,,182450.0,24265655.0,97.95,,,,,,,165354.0,,284429.0,,52862.0,,,,237.0,,12137034.0,,,,,2994692.0,204970.0,,,,,25840683.0,-30528.0,,,386317.0,,21243623.0,7128980.0,,,,,,,-233298.0,,,386317.0,778580333.0,23881549.0,,,124418207.0,7649.0,78604.0,,,,1910.0,71058104.0,-239858.0,,G,619862.0,115395613.0,,,119155935.0,4647296.0,,,,,,,,109411.0,10967.0,4641007327.0,,1612.0,,,5718.0,,185787.0,TX,,11720888.0,,,2657974.0,,24265655.0,,6080760.0,10838319.0,175.0,,,,,,,,6656028.0,,,,14178.0,HARRIS,,,,,,,10.0,,1700108.0,1605013.0,-1602198.0,8889846.0,4209065.0,40747916.0,,139788.0,,,,,15303.0,,30310188.0,186084835.0,12910026.0,,19233197.0,,,22629.0,,-279255725.0,,,,,68679.0,195.0,,,,,,,42026615.0,,381194.0,21792664.0,,,,,,,,,,,646944.0,,,5972240.0,,-272511.0,1448.0,77008-,,,,,,,,187830.0,27726.0,,27216000.0,,,,,1680950.0,,,332598.0,,,,,-3682037.0,,15.0,,7902733.0,,,,,1168689070.0,,4405199.0,,,,1942686.0,,146899446.0,,,,730.0,980.0,,,19534739.0,N,,,,,16747940.0,6.0,374078.0,,8623909.0,,,2751.0,,,,24025.0,,-121752675.0,,,1912503.0,2868693.0,,6850205.0,,,44.04,463492.52,,,2842.0,410534.0,,,,1420575.0,,1151.0,206839.0,,1337.0,,,,79182101.0,,,,,,,,,3274403.0,,,17.16,76192041.0,,,97209210.0,,,3255760.0,,,,,,,,,13710494.0,,,40150.0,,7951397.0,,,28792908.0,-507223787.0,,62454263.0,1811769.0,79434996.0,,,99495390.0,,,1863.0,,,94149249.0,51996.0,,14090477.0,,,,2517.0,32.0,5206.68,,,,86823264.0,81474.0,General Short Term,,,5145877.0,,,1123898.0,,,69799428.0,,,60770.0,,,22265.0,,,1057947.0,-1733545.0,,,15932761.0,,,,,30305061.0,29940570.0,250593.0,,,,291954.0,,,430199771.0,,7351395.0,,13423766.0,7170.0,,,29386.0,459423408.0,,,,,61947347.0,,,,162609.0,51773.0,8785562.0,48849980.0,,,51943648.0,,,,16473228.0,,,,,,,,,,HOUSTON,8512011.0,,12379097.0,,,,299793.0,,,,,3727502.0,,,,534493.0,,7719780.0,,,237707368.0,,,,,12554709.0,27216000.0,8332614.0,,5507.46,64949771.0,,10976.0,,,,,,,12587093.0,,,83436915.0,,263233.0,12443758.0,,,,48856.0,321645.0,173280908.0,,,,,,3645384.0,,4409247.0,57070241.0,9340.0,4711558.0,,,,12379097.0,984087.0,,,846743.0,5794023.0,,,3.0,28432.0,,,22425637.0,224121.0,,13233209.0,,,,908.0,3973141.0,,,,,,,135895.0,1285759056.0,,,,,,,15.0,,1617275.0,,,,34315455.0,6479.0,90266644.0,,,,991.0,,4937.0,,10781976.0,,,,,,,,138580.0,,2473.0,,,,,,18397741.0,,,,,13270.0,60563820.0,,,,158.0,,,,,,,11635297.0,21507711.0,12256747.0,72116212.0,,152271456.0,,6320584.0,,,,1709309.0,,,,,33912284.0,,,,21859.0,,,,,,,,2625352.0,,,,,132.0,,27.22,57068547.0,,,,,,5992493.0,,,,,5169856.0,,8785562.0,12344543.0,,,,,,1003401.0,,25400941.0,,,2.0,599149.0,,,,321645.0,,3.0,,12212126.0,1314377.0,7806748.0,,Y,,54721875.0,,1732881.0,,,,956597.0,,,,,,,,,23994.0,,50.34,,,,,,,,,52595630.0,,,,,17734913.0,,Y,2690.0,,,49.0,,368805.0,2108.0,3402637.0,,,15006118.0,167334408.0,27137.0,1155909.0,-3281.0,,,,,-510935705.0,,,,,217.44,30239.0,,,1612.0,,3934644.0,,,,517715.0,59797824.0,,,,,,12377665.0,,,51668044.0,,171295667.0,2007.0,113808836.0,390108737.0,,3274403.0,,,,,,,,1047149.0,,,,,33906438.0,,,8559464.0,5005.0,27043.0,,2698.0,,5225810.0,165354.0,8825415.0,,,473740.0,,,,,-2040246.0,,,35712429.0,,17559977.0,,,420050.0,,,,,,,,,,10326043.0,,,,,,,425936.0,,,5575814.0,,,,,,,2331912388.0,636270.0,2657974.0,,,,,,1.0,,,,26767.0,,,,,,18.07,,,17565421.0,,599149.0,182547.0,276805.0,,6560489.0,,,,14.0,,33239.0,,,1.0,,,,,,,13967383.0,,99966994.0,,74435428.0,,2760455.0,,,,,2069541.0,1635 NORTH LOOP WEST,11699318.0,,249504.0,14178.0,,20811952.0,,820048.0,101420838.0,,702572.0,,,425824944.0,,,136951845.0,2014,Acute Care Hospitals,MEMORIAL HERMANN  HOSPITAL SYS (450184)
33315,MEMORIAL HERMANN  HOSPITAL SYS (450184),General Short Term (Acute Care Hospitals),Voluntary Nonprofit-Other,-95.430899,29.812266,,,7819838.0,,,,,14634872.0,,,,,,323880449.0,1280813.0,,10053171.0,,440239623.0,17235271.0,,,Y,,1168080566.0,,,,3543278.0,,,,,,,,,2781064.0,,,6057673.0,,7432403.0,,,4544.0,,3301995.0,,6652170.0,,,,-11804.0,,,,3408414.0,,,,,,119591682.0,,61.76,,52979300.0,,6718801.0,,,,,,,,,,,,5.0,,3760747.0,171703039.0,,83433.0,,,,,,,394168.0,,54183.0,,3811806.0,,,,,601224.0,,,,,2.0,,,,,,,,2587495.0,,,,701755701.0,26.0,568.0,,,48721239.0,,,,,,220289.0,,228250497.0,,,,,560177.0,,,,,,916218.0,1687.0,36675.0,22782108.0,,,1187941726.0,,,1165754.0,,,107781242.0,612.0,,,19151.0,,58783600.0,,1288256.0,,,,,,,,,,,,,10231.0,3759563.0,,5548760.0,8870529.0,,,,,,,198765385.0,,,22197226.0,2353063.0,,87478129.0,,,,,,,154094.0,,71996814.0,,,1789867.0,,,658950.0,1184833.0,,,103742.0,,,550149358.0,,93313628.0,HOUSTON,,2544186890.0,N,,83551884.0,71.0,,-3720889.0,,27573707.0,1424868.0,12162657.52,,,723714.0,-902.0,914.0,,,,7.0,50925029.0,635309.0,,6704806.0,,0.225838,,,,,,1424.0,36425.0,325999.0,,,264172.0,04011,,,,,234263.0,,,13358409.0,1407633.0,,,,,,16053.0,938300.0,,,38242846.0,,,,16973.0,,,,11206181.0,1282837160.0,10911347.0,1196645804.0,,,2015-07-01 00:00:00,,,3811806.0,,,457741,1472496.0,755033.0,,,,,,,,,,,,10058568.0,,,-70427.0,238364944.0,,N,11521375.0,,580947112.0,583664.0,,,,,3365736.0,,,,4,,1282837160.0,,151509.0,,,,44610.0,38533.0,25779711.0,,,,,,,,,,,,,,7118963.0,44417.0,,3914048889.0,,,,,7432403.0,,,9181875.0,,123.0,,,,,,2679373.0,,68675491.0,21934311.0,,,658950.0,,807744.0,,2572875.34,19360849.0,1418884.0,356564.0,1687.0,,MEMORIAL HERMANN HOSP SYS- REHAB,1385850.0,,,281837334.0,,,,,,12958278.0,,,10058568.0,57263051.0,1961032.0,,,,,,17783161.0,,37384.0,,,,,28769885.0,,,,60360940.0,,-126825462.0,55347210.0,,,10078071.0,,62580345.0,,892030.0,1880083.0,,18971539.0,,3677641.0,,,,,2619668.0,,,,,5865502.0,87478129.0,1927659.0,48090973.0,,,,,1119.0,,,,,,,,7268529.0,,,,,,,,,7279172.0,31820536.0,,,5741781.0,,N,,,,1576167.0,,,,,12919219.0,,24715780.0,,,,5685.0,,5129.0,21.03,2312083.0,,,,,,,,,2024-02-15 00:00:00,,,,,,,2642.0,13125.0,,2181553.0,102.0,,,633217.0,,,58984679.0,,,,185.0,,,459219309.0,-10872251.0,,,,,771177.0,74711403.0,38923.0,1.0,24888.0,,9511532.0,,15140738.0,,,,,4790705.0,1055107.0,459423408.0,,591382.0,,,,,-84649132.0,33.07,,50738837.0,,,,58984679.0,,,,,,,489176.0,,,45T184,,,,,,21.0,,,,,,39.24,171703039.0,,,,33.88,,10.97,,58783600.0,,,,,24029759.0,,937114.0,,70425073.0,,237897432.0,,,,,13985828.0,,99178503.0,,276647.0,,30314115.0,,,,,,33506244.0,,,,929 GESSNER ROAD SUITE 2600,,,24256.0,227660.0,,103316666.0,,,4591461.0,,161596318.0,,,,,,,495.0,6925200.0,,,,,,,,,,45.45,,370.0,111954.0,,,15.66,,,,,,,71846.0,,,,,,,,1385850.0,,36021099.0,704932.0,,,355636923.0,,,,17875400.0,,236071.0,714458.0,35321531.0,,,64981.0,,,,39861506.0,MEMORIAL HERMANN  HOSPITAL SYS,15755363.0,8346638.0,,,517941.0,,275246908.0,,,,,125398390.0,,2250144.0,14168.0,,,11523064.0,42502673.0,-17656.0,,,10347629.0,,34328949.0,,23310177.0,,,6767716.0,,,,4322360.0,42815010.0,,,,,17143.0,,,,,71996814.0,,,,,675054.0,32142.0,438063.0,,8630037.0,153295.0,17318577.0,982544.0,,,,,238364944.0,,,,,,,,,,,,,116893790.0,,34328949.0,,1798548.0,1032173.0,35111271.0,116673.0,,4470180.0,9247049.0,52011294.0,,3.0,5721915.0,,,,,5031949.0,490.0,,4936481.0,13947506.0,12.0,,,,,,,,,10937.0,,12990972.0,42815010.0,15543630.0,,,,116811892.0,,,,3861048.0,,1280248.0,8245.0,9356124.0,1876091.0,766288590.0,,48721205.0,66295178.0,35.0,570885.0,,,,27435606.0,59.01,,,,,41282.0,,,1281155.0,,,,,,944258.0,155058263.0,3759563.0,,,,,107567265.0,42997356.0,,,,,10011859.0,,,272847.0,13952295.52,43.45,-81898.0,,,,1284.0,,20798579.0,,,,121506917.0,,6584043.0,,31894942.0,,,,71846.0,450184,,8056709.0,,90.0,,39967111.0,,,,,,,,,,,,6398987.0,89032.0,,,,,,,31497662.0,,,429885089.0,52.41,,20092.0,13235.0,,500.0,,,332407.0,,,,71867.0,,7707.0,,21778332.0,77024,,,,2250144.0,7268529.0,,,33081.0,98.0,,,,,,,,,16947.0,,,288568.0,,,,,,3338.0,4039883.0,,,,,105115373.0,,429273618.0,,,37077704.0,,72111.0,1151269.0,,,46434.0,,,72790.0,137375.0,1344568.0,-7552739.0,45,1572009.0,54714636.0,45.45,,,34.59,185283.0,,,,15592670.0,13247363.52,,8409511.0,,,,,3713320.0,,33369325.0,N,,,,1167042582.0,43618.0,,,,511016.0,,,N,,763933,909.0,2676756.0,,,,,352607.0,,,,718529450.0,,,376590.0,,,1.0,,,,,32489769.0,371124.0,,7783958.0,2159926.0,,,,2615.0,9247049.0,16153639.45,,,,,,629306417.0,,,,,,,,,,,,,99801.0,404.0,131532.0,,321203.0,,,,,,,3435437.0,238.0,3214587.0,21444939.0,,,,6985.0,45610,,,,4258466.0,,588902.0,,,,966.0,2349.0,,,,26142748.0,,,,11534.0,,,,,,,,,,,,10461.0,,225051504.0,54969998.0,,26134171.0,1177219.0,,,,8918.0,,,,,1344568.0,,35111271.0,87478129.0,,,,459302711.0,39861506.0,,,9356124.0,34911023.0,60360940.0,,2068448.0,31618200.0,,,348438315.0,27526942.0,,,,,,20282157.0,,47765973.0,97660233.0,,,,,293551917.0,,4677775.0,,,,,,,,,2623416848.0,4159342.0,296401.0,20092.0,,1280813.0,,,,,356564.0,26420,,,,,,,70115322.0,,39967111.0,,TX,,8245.0,,,,,,,,,,10902659.0,6718801.0,,2394825.0,-158953.0,,,3588415.0,61853.0,,,,18064647.0,9451568.0,61853.0,,,,,,,,52591005.0,,,12540237.0,17981887.0,,,,2164732.0,,,2161367.0,,,,,4271989.0,,3360,,,,,,3455809.0,,,,,,,1155320958.0,,,1485999.0,,378979.0,,-1689.0,,148997143.0,,,6057673.0,70427.0,,,8510201.0,42502673.0,4.0,,,,,,6804351.0,,,64981.0,,9950640.0,,,704932.0,,13947506.0,,,6707312.0,,,,,,,4354661.0,,,,,,1257210.0,119414926.0,,,,,264235.59,,16910760.0,12843189.0,,,,,,23926689.0,5952422.0,2627.0,,78322908.0,,,,,,,23866160.0,35.34,419612.0,,,33.07,,32.7,,,21766528.0,134848780.0,,,-938610.0,34.67,,,,,,,6572010.0,,,,,,,,,,3733330.0,2.0,,19223266.0,689692.0,19457.0,,,,337138.0,,,,,,,,,,1119117.0,,,,163271321.0,,,,,,,,,,,,217316.0,27101305.0,,,,701839103.0,,,,5015378.0,,,N,,,,,26792465.0,,,,,-2833769.0,8061.0,,,,,,10902659.0,5918790.0,,,,,,,,,,,,,,,,,,47265184.0,,65689224.0,75.0,4790705.0,,,81035.0,,,23384266.0,,,89337833.0,,,,325867.0,,,74958467.0,,13985828.0,,,,,238428.0,10.0,,,,N,,,15949.0,19662.0,,,45572659.0,,,7611467.0,,725036.0,,3297.0,,,43529.0,,,10152508.0,,27573707.0,,112645.0,,28565238.0,,,,Y,1.0,,,,,,16895.0,,117365793.0,,,,1490119.0,,15110020.0,,4083.0,,68.0,236071.0,21180.0,,,21918429.0,,,N,,,,,,,,,1019225.0,579012.0,,,,,,122969482.0,17919098.0,,38.0,10219710.0,34.0,,,,1014.0,131.0,1145779.0,,,1177219.0,25812497.0,,,P,,371124.0,,-2730744.0,,,,,,,,7118963.0,,7205383.0,,,-45793.0,,,,1795868.0,32126006.0,,35.72,,36675.0,,,18237481.0,14498302.0,,,,,31985724.0,4156930.0,,1969.0,17508118.0,,1894073.0,153979.0,10626014.0,14168.0,,,,,2673471282.0,,,,,481389.0,,722726.0,,1789867.0,,,,325999.0,105115373.0,71867.0,,,4115319.0,8007396.0,,,445056.0,,,58945.0,,,,57383019.0,,,,,3455809.0,1785945.0,,,3051598.0,,,,,,,,11766719.0,F,,,,,,,,,,,,,588902.0,31894942.0,98444917.0,,,22782108.0,,,,,,,,,,,,,,48177397.0,15215412.0,,,,,,,,,,,,,,,63129228.0,,,6872612.0,,11081313.0,440239623.0,164629.0,,1977353.0,,,,,-2355312.0,2606955.0,,1806.0,827845.0,17450552.0,,,43.1,,1268124.0,,,1119117.0,,,814272516.0,,,,81120233.0,,,,,,,258697.0,,,18448.0,13031079.0,310976.0,5167603738.0,,17334.0,,,,,,,,,,,,,44823.0,61.0,,,,,,4844034.0,,3347788.0,7994036.0,23154538.0,7266576.0,1230220.0,,,,,,12884010.0,81035.0,1412040.0,,,,,,39377115.0,,1876091.0,,,,,61853.0,33886.0,,,,,,3293052.0,,,,,47231120.0,,,,,14422016.0,,259993549.0,,,,7932633.0,,,11139.0,,2906275.93,87478129.0,83745730.0,,,,28079.0,,Y,2965920.0,,,,,,1176554114.0,156297632.0,,,,8997304.0,,,,,,,,2587495.0,,MEMORIAL HERMANN,Y,67.0,,,,25.0,,,,,,7380970.0,974424.0,,,4916.0,545097.0,2216043.0,,,,17143.0,,,,,,,,,,33081.0,2157874.0,1717998.0,,,1.0,,,,,98444917.0,7419394.0,1387911.0,9451568.0,,,,2542845.0,,,,3207626.0,,,,,N,,,,,,1638162.0,1385850.0,2016-06-30,,,,,36730819.0,HO9956,,,,,,,,,,,,323722356.0,114287.0,46681520.0,,,,318713222.0,,,80003.0,27172764.0,66.75,,,,,,,110194.0,,347020.0,,,,,,,,14152724.0,,,,,3543278.0,150840.0,,,,100.0,31820536.0,-36376.0,,,,,23310177.0,6872612.0,,,,,,,-183673.0,,,,843317240.0,25161305.0,,,155058263.0,8061.0,83451.0,,,,605954.0,93313628.0,,,H,789509.0,139450748.0,,,147207276.0,6469272.0,,,,,,,,100500.0,10937.0,5264962655.0,,1427.0,,,4526.0,,114287.0,TX,,12540237.0,,,4616813.0,,27172764.0,,6002095.0,13877756.0,334.0,,,,,,,,2937949.0,,,-366122.0,17322.0,HARRIS,,,,,,,1.0,,1734043.0,1961032.0,-116828.0,10604174.0,5015378.0,58984679.0,,158046.0,,,,,16947.0,,34328949.0,179222377.0,15403174.0,,20282157.0,,,19407.0,,-296126259.0,,,,,175350.0,,,,,,,,48090973.0,,562267.0,35503158.0,,,,,,,,,,,755033.0,,,7380970.0,,-147368.0,2972.0,77008-,,,,,,,,149200.0,28555.0,,27502986.0,,,,,1717998.0,,,258458.0,,,,,-4262083.0,,8918.0,,7902733.0,,,,,1272590858.0,,6026956.0,,,,2225840.0,,174603453.0,168.0,,,,1014.0,29900.0,,26278054.0,N,,,,,19051915.0,6.0,462378.0,,11591702.0,,,2400.0,,,,18012.0,,-84649132.0,,,2161367.0,3005669.0,,7279172.0,,,68.38,574589.0,,,2608.0,868858.0,,,,2727947.0,,1216.0,192556.0,,,,,,87391437.0,,,,,,,,,3511749.0,,,16.26,74958467.0,,,90972842.0,,,3238826.0,,,,,,,,,517941.0,,,47946.0,,15592670.0,,,33369325.0,-389032367.0,,68740472.0,1659503.0,86598147.0,,,102765232.0,,,,,,103005781.0,17056.0,,13358409.0,,,,2615.0,,5539.53,,,,97602846.0,90234.0,General Short Term,,,6034882.0,,,1429028.0,,,74711403.0,,,43778.0,,,25986.0,,,1048712.0,15987323.0,,,19360849.0,,,,,32118617.0,32814687.0,223998.0,,,,307475.0,,,482612888.0,,10182513.0,,18064647.0,7719.0,,,34064.0,511434702.0,,,,,68697485.0,,,,155978.0,40608.0,9698630.0,55347210.0,,,63129228.0,,,,31618200.0,,,,,,,,,,HOUSTON,8870529.0,,14025581.0,,,,595919.0,,,,,3794675.0,,,,390072.0,,8121542.0,,,274359070.0,,,,,15487480.0,27502986.0,9269571.0,,5856.09,82374869.0,,8435.0,,,,,,,14498302.0,,,85335948.0,,342358.0,13842319.0,,,,48856.0,337138.0,165727699.0,,,,,,3214587.0,,4295751.0,61730986.0,10602.0,3713320.0,,,,14025581.0,916218.0,,,1129806.0,5465034.0,,,1.0,37792.0,,,35335663.0,107346.0,,13673257.0,,,,,2174122.0,,,,,,,209815.0,1350913766.0,,,,,,,1.0,,1910545.0,,,,37812772.0,14259.0,103316666.0,,,,1187.0,,7215.0,,12052499.0,,,,,,,,218743.0,,4747.0,,,,,,21882053.0,,,,,7560.0,70115322.0,,,,,,,,,,,14077765.0,23154538.0,13031079.0,81120233.0,,180550773.0,,6881367.0,,,,1572136.0,,30.0,,,36865394.0,,,,21180.0,2715.0,,,,,,,3650481.0,,,,,,,27.62,61730459.0,,,,,6704806.0,8324842.0,,,,,5573364.0,,9698630.0,13767556.0,,,,,,1280248.0,,28600669.0,,,,628462.0,,,1.0,337138.0,,6.0,,11655854.0,1483056.0,8997304.0,,Y,,57555692.0,,1604015.0,,,,900539.0,,,,,,,,,17334.0,,53.35,,,,,,,,,57184838.0,,,,,20340829.0,,Y,4908.0,,,12.0,,442959.0,945.0,3599223.0,,,16934987.0,222349378.0,69165.0,1291029.0,-6075.0,,,,,-390908458.0,,,,,224.65,25393.0,,,1427.0,,5017843.0,,,,544344.0,82763186.0,,,,,,15543630.0,,,57285230.0,,181508802.0,2630.0,134848780.0,429273618.0,,3511749.0,,,,,,,,1161070.0,,,,,35827173.0,,,8630037.0,500.0,34322.0,,2765.0,,2292490.0,110194.0,10172745.0,,,962081.0,,,,,-2941014.0,,,38242846.0,,21324817.0,,,869353.0,,,,,,,,,,11081313.0,,,,,,,437708.0,,,3644796.0,,,,,,,2591491373.0,700745.0,4616813.0,,,,,,,,,,,,,,,,19.05,,,17073962.0,,628462.0,246444.0,269593.0,,8056709.0,,,,,,,,,,,,,,,,15889333.0,,118253173.0,,76335370.0,,2875508.0,12461.0,,,,1648830.0,1635 NORTH LOOP WEST,14393054.0,,268213.0,17322.0,,20812100.0,,866649.0,107567265.0,,709237.0,,,482001417.0,,,151884190.0,2015,Acute Care Hospitals,MEMORIAL HERMANN  HOSPITAL SYS (450184)
39457,MEMORIAL HERMANN  HOSPITAL SYS (450184),General Short Term (Acute Care Hospitals),Voluntary Nonprofit-Other,-95.430899,29.812266,,,8230387.0,,,,,15999266.0,406.0,,,,,398221755.0,2243407.0,,12816770.0,,509421713.0,19274268.0,,,Y,,1245459377.0,,,,3634794.0,,,,,,,,,3548781.0,,,7155873.0,,7293376.0,,,3253.0,,3292360.0,,5830684.0,,,,,,,,3791277.0,,,,,,108877271.0,,51.35,,55157672.0,,6993021.0,,33297847.0,,,,,,,,,,,,3218234.0,83558815.0,,46415.0,,,,,,,406382.0,,41874.0,,5296565.0,,,116158180.0,,537950.0,,,,,2.0,,,,,,,,3078693.0,,,,734086880.0,3.0,208.0,,,54344229.0,,,,,,103982.0,,249213134.0,,,,,490919.0,,,,,,797906.0,,45157.0,26036203.0,,,1054976697.0,,,974361.0,,,116677568.0,642.0,,,30905.0,,67523488.0,,1453361.0,,,,,,,,,,,,,9674.0,3957004.0,,6860310.0,9443916.0,,2.0,,,,,200437789.0,,,28147054.0,3406567.0,,98562647.0,,,,,,,171444.0,,81460888.0,,,1590569.0,,,1069684.0,1178107.0,,,104314.0,,,618545344.0,,81199473.0,HOUSTON,,2887273648.0,N,,93289607.0,71.0,,-32103720.0,,30685931.0,1663906.0,12944432.0,,,781611.0,-17412.0,898.0,,,,7.0,56590839.0,388269.0,,10515135.0,,0.210261,,,,,,1950.0,46381.0,787909.0,,,569750.0,04011,,,,,272517.0,,,14320474.0,1640211.0,,,,,,9683.0,1083562.0,,,43088470.0,,,,,,,,11730164.0,1447835393.0,15168600.0,1272271023.0,,,2016-07-01 00:00:00,,,5300210.0,,,457741,1830797.0,641094.0,,,,,,,,,,,,10909262.0,,,-70427.0,240198088.0,,N,12951424.0,,599369833.0,621298.0,,,,,2282369.0,,,,4,,1447835393.0,,144310.0,,,,58327.0,50425.0,26011806.0,,,,,,,,,,,,,,7356089.0,44419.0,,4617756256.0,,,,,7293376.0,,,9831256.0,,106.0,,,,,,2580663.0,,73877223.0,23387484.0,,,1069684.0,,777689.0,,,22676883.0,1107165.0,372312.0,,,MEMORIAL HERMANN HOSP SYS- REHAB,3226938.0,,,285101809.0,,-4180696.0,,,,13554137.0,,,10909262.0,62592765.0,1911823.0,,,,,,19061501.0,,80149.0,,,-5398.0,,31868277.0,,,,63546391.0,,-108868252.0,56241337.0,,,10279503.0,,72941780.0,,975631.0,1497116.0,,20646243.0,,3304053.0,,,,,2050330.0,,,,,7236066.0,131860496.0,1754570.0,50448429.0,,,,,319.0,,,,,,,,8479886.0,,,,,,,,,11565053.0,35227467.0,,,5166824.0,,N,,,,1572177.0,,,,,14905722.0,,25611160.0,,,,11170.0,,2908.0,21.3,11762610.0,,,,,,,,,2024-02-09 00:00:00,,,,,,,,92036.0,,2222228.0,12.0,,,643992.0,,,43206891.0,,,,19.0,,,475246043.0,-41294031.0,,,,,768246.0,83973464.0,38710.0,1.0,24820.0,,11820755.0,,17504214.0,,,,,4064353.0,984691.0,511434702.0,,469216.0,,,,,-335323023.0,33.08,,50738837.0,,,,43206891.0,,,,,,,1004475.0,,,45T184,,,,,,37.0,,,,,,38.71,83558815.0,,,,39.2,,26.58,,67523488.0,,,,,28783355.0,,656044.0,,86223660.0,,240198088.0,,,,,15021696.0,,48221954.0,,353396.0,,36307132.0,,,,,3.0,35440513.0,,,,929 GESSNER ROAD SUITE 2600,,,25969.0,264619.0,,111077281.0,,,4302131.0,,154544748.0,,,,,,,13851.0,7854475.0,,,,,,90.0,,,,44.98,,414.0,106011.0,,,17.49,,,,,,,211141.0,,,,,,,,3226938.0,,42080392.0,791667.0,,,423842804.0,,,,18978076.0,,244809.0,692641.0,38289626.0,,,38656.0,,,,50349059.0,MEMORIAL HERMANN  HOSPITAL SYS,17904008.0,13645544.0,,,6059293.0,,297906776.0,,,,,123354145.0,,1510194.0,14756.0,,,12951424.0,39157786.0,-511571.0,,,10805617.0,,37992582.0,,26187627.0,,,7725391.0,,,,4631315.0,50010468.0,,,,,18631.0,,,,,81460888.0,,,,,750542.0,30760.0,502981.0,,9957536.0,240490.0,16692879.0,359950.0,,,,,240198088.0,,,,,,,,,,,,,119718185.0,,37992582.0,,2746413.0,478086.0,39225018.0,151946.0,,8892971.0,9561849.0,15934860.0,,5.0,5368852.0,,,,,4914215.0,,,5574014.0,15961841.0,2.0,,,,,,,,,11230.0,,12956936.0,50010468.0,24582460.0,,,,119718185.0,,,,3990244.0,,1174122.0,8446.0,11162958.0,10223005.0,784636771.0,,54344527.0,82230566.0,65.0,428169.0,,,,30446217.0,63.24,,,,,14657.0,,,1375711.0,,,,,,828688.0,126980343.0,3957004.0,,,,,110228349.0,48227517.0,,,,,9629376.0,,,284545.0,14110990.0,46.04,,,,,1411.0,,23536947.0,,,,151769111.0,,7360149.0,,34363772.0,,,,211141.0,450184,,9674722.0,,,,38816541.0,,,,19.0,,,,,,,,7680586.0,135936.0,,,,,,,35072348.0,,,467217350.0,,,12470.0,15681.0,,334101.0,,,553691.0,,,,75366.0,,11666.0,,23580246.0,77024,,,,1510194.0,8479886.0,,,39621.0,987.0,,,,,,,,,17693.0,,,358205.0,,,,,,4101.0,3071149.0,,,,,42888765.0,,465429440.0,,,37866340.0,,43074.0,1743431.0,,,21166.0,,,73225.0,137341.0,3212281.0,-7347760.0,45,1778167.0,67494399.0,44.98,,,35.65,16945.0,,,,7535479.0,13319323.0,,9659837.0,,,,,4315119.0,,36224615.0,N,,,,1245459377.0,38247.0,,,,568802.0,,,N,124.0,763538,1010.0,2615102.0,,,,,368828.0,,,,814272516.0,,,,,,,,706.0,,,50518442.0,410990.0,,-205316291.0,1849985.0,,,,319.0,9561849.0,15980722.21,,,,,,713077029.0,,,,,,,,,,,,,102042.0,,552087.0,,366859.0,,,3594.0,,,,252941.0,69.0,4658641.0,25175286.0,,,,5757.0,45610,,,,8959621.0,,720996.0,,,,1501.0,1.0,,,5449.0,27435606.0,,,,6145.0,,,,,,,,,,,,7180.0,,251699008.0,54037322.0,,21351811.0,631736.0,8626315.0,,,25563.0,,,,,3129441.0,,39225018.0,131860494.0,,,,476882529.0,50349059.0,,7252.0,11162958.0,39723184.0,63546391.0,,1951870.0,19571201.0,,,374175880.0,31151992.0,,,,,,22677844.0,,53128966.0,107013386.0,,,,,391088056.0,,4620311.0,,,,,,,,,3036128901.0,4992381.0,279002.0,12470.0,,2243407.0,,,,,372312.0,26420,,,,,,,74804506.0,,38816541.0,,TX,,8446.0,,,,,,,,,,12647767.0,6993021.0,24521.0,2559142.0,-346902.0,,,4336982.0,61995.0,,,,21226959.0,10201850.0,61995.0,,,,,,,,61677382.0,,,13431895.0,19021284.0,,,,2473654.0,,,2219364.0,,,,,4759220.0,,3360,,,,,,3856085.0,,,,,,,761678209.0,,,1650156.0,,374865.0,,-9799.0,,186940090.0,,,7155873.0,70427.0,,,9642638.0,39157786.0,1.0,,,,,,7170823.0,,,38656.0,,9629376.0,,,791667.0,,15961841.0,,,7470935.0,,,,,,,4936448.0,,,,,,1267805.0,144201728.0,,,,,119150.0,,18766023.0,12229140.0,,,,,,25850651.0,5984773.0,,,12321905.0,,,,,,,25850651.0,36.09,291003.0,,,33.08,,35.57,,,23580246.0,,,,-1505943.0,35.8,,,,,,,2443295.0,,,,,,,,,,955754.0,4.0,,20251910.0,735856.0,53104.0,,,,805173.0,,,,,,,,,,578997.0,,,,169298091.0,,,41506.0,,,,,,1470.0,,,558540.0,30258464.0,,,,735723368.0,,24611.0,,5857998.0,,,N,,,,,30566860.0,,,,,-1760486.0,10470.0,,,,,,12647767.0,6620586.0,,,,,,,,,,,,,,,,,,52589439.0,,81870616.0,756.0,4064353.0,,,81671.0,,,20565603.0,9.0,,101517879.0,,,,420986.0,,,77683272.0,,15021696.0,,,,,248990.0,29.0,,,,N,,,20792.0,21333.0,,,50709244.0,,10091.0,6244182.0,,683787.0,,2601.0,,,22123.0,,,10926342.0,,30685931.0,,108562.0,,26811646.0,14.0,,,Y,1.0,,,,,,26967.0,,138653091.0,,,,1798075.0,,15126404.0,,9648.0,,68.0,244809.0,20798.0,,,23514410.0,,,N,,,,,,,,,8752000.0,1435769.0,,,,,,114468573.0,17402510.0,,166.0,11224551.0,-298.0,,,,1126.0,146.0,1421094.0,,16471.0,631736.0,24758416.0,,-3645.0,P,,410990.0,,-3561465.0,,,,,,,,7356089.0,,7130548.0,,,,,,,1853272.0,33962730.0,,39.36,,45157.0,,,15613823.0,15441977.0,,,,,42524773.0,4046570.0,,2414.0,19558813.0,,1863312.0,146421.0,9369641.0,14756.0,,,,,3086041604.0,,,,,390751.0,,1064560.0,,1590569.0,,,,798065.0,42888765.0,75366.0,,,3853562.0,-205252481.0,,,490195.0,,,65681.0,,1.0,,72842962.0,,,,,3856085.0,1427685.0,,,3697572.0,,,,,,,,13543406.0,F,807.0,,,,,,,,,,,,720996.0,34363772.0,109673963.0,,,26036203.0,,,,,,,,,,,,,,54480040.0,13034558.0,,,,,,,,,,,,,,,76676542.0,,,9434167.0,,12709259.0,509421713.0,113091.0,,2238781.0,,,,,-5006979.0,4328059.0,,2851.0,993185.0,42459836.0,,,44.19,,1934492.0,,,578997.0,,,862241529.0,,,,83492710.0,,,,,,,282266.0,,,14204.0,13910907.0,214730.0,5923402549.0,,14357.0,,,,,,,,,,,,,25874.0,79.0,,,,,,4454748.0,,3292360.0,8905455.0,28477861.0,7141507.0,1201138.0,,,,,,12817296.0,81671.0,1341446.0,,,,,,46084425.0,,1596690.0,,,,,61995.0,41748.0,,,,,,2545684.0,,,,,52546154.0,,,,,15055779.0,,288632156.0,,,,8002537.0,,,7108.0,,2661399.21,98562647.0,124690402.0,,,,1348.0,,Y,3156730.0,,,,,,1043480279.0,189810564.0,,,,3295338.0,,,,,,,,3078693.0,,MEMORIAL HERMANN,Y,337.0,,,,38.0,,,,,,6865949.0,1086891.0,,,2248.0,473252.0,2070980.0,,,,18631.0,,,,,,,,,,39621.0,2606975.0,46726.0,,,1.0,,,,,109673963.0,9570974.0,885168.0,-203598003.0,,,,2646919.0,,,,3325057.0,,,,,N,,3527623.0,,,,1745490.0,3226938.0,2017-06-30,,,,,44908778.0,HO9956,,33297849.0,,,,,,,,,,408993446.0,196351.0,51968141.0,,,,441885215.0,,,69101.0,28638827.0,88.24,,,,46.37,,,110764.0,,451306.0,,,,,,,,15392769.0,,,,,3634794.0,148250.0,,,,256.0,35227467.0,-25.0,,,,,26187627.0,9434167.0,,,,,,,-365242.0,,,,924870280.0,50797159.0,,,126980343.0,10470.0,62724.0,116158180.0,,,359950.0,81199473.0,-8255.0,,J,1038957.0,178693621.0,,,185349521.0,6862223.0,,,,,,,,99296.0,11230.0,6020377881.0,246.0,1466.0,,,3511.0,,196351.0,TX,,13431895.0,,,3286684.0,,28638827.0,,7413360.0,15021696.0,276.0,,,,,,,,2677842.0,,,-808663.0,17863.0,HARRIS,,,,,399.0,,,,69216.0,1911823.0,-6056.0,12171265.0,5857998.0,43206891.0,,126444.0,,,,,17693.0,,37992582.0,185726769.0,,,22677844.0,,,25570.0,,-287524236.0,,,,,174134.0,,,,,,,,50448429.0,,728652.0,36021099.0,,,,,,,,,,,641094.0,,,6865949.0,,-50003.0,2857.0,77008-,,,,,,,,164310.0,19046.0,,29482221.0,,,,,46726.0,,,278183.0,,,,,,,25563.0,,7932633.0,,,,,1390299720.0,,4803373.0,,,,2352282.0,,175444050.0,,,98.0,,1126.0,69904.0,,27677798.0,N,,,,,20900306.0,6.0,228825.0,,7485250.0,,,2907.0,,,,20506.0,,-335323023.0,,,2219364.0,3536154.0,,11565053.0,,,85.53,188463.0,,,2625.0,681508.0,,,,5635781.0,,1343.0,217853.0,,,,,,94936169.0,,,,,,,,,3466933.0,,,17.48,77683272.0,,,93148201.0,,,3605509.0,,,,,,,,,6059293.0,,,53290.0,,7535479.0,,,36224615.0,22958563.0,,73915879.0,1493982.0,98097060.0,,90.0,109528617.0,,,,,,117267884.0,31805.0,,14320474.0,,,,319.0,,5914.71,,,,107013386.0,106232.0,General Short Term,,,6863717.0,,,1312675.0,,,83973464.0,,,17763.0,,,25915.0,,,2421765.0,-5020626.0,,,22676883.0,,,,,33962730.0,34169934.0,346252.0,,50.0,,323859.0,,,503070156.0,,8622433.0,,21226959.0,6914.0,,,43285.0,527369562.0,,,,,74336344.0,,,,141985.0,21279.0,11642269.0,56241337.0,,,76676542.0,,,,19571201.0,,,,,,,,,,HOUSTON,9443916.0,,16172205.0,,,,769376.0,,,,,3962111.0,,,,432187.0,,8939029.0,,,318388674.0,,,,,13755310.0,29482221.0,10514593.0,,6272.6,96737806.0,,4120.0,,528.0,,,,,15441977.0,,,73639753.0,,337740.0,16210876.0,,,,30118.0,805173.0,172873165.0,,,,,,4658641.0,,4277094.0,64292986.0,12401.0,4315119.0,,25.0,,16172205.0,797906.0,,,750637.0,5448433.0,,,,69227.0,,,50738837.0,190372.0,,15257493.0,,1917.0,,-13299.0,2548392.0,,,,,,,93922.0,1402621625.0,,,,,,,1.0,,2067697.0,,,,41593305.0,7859.0,111077281.0,,,,1297.0,,7725.0,,13114362.0,,,,,,,,257146.0,,5268.0,,,,,,23514410.0,,,,,22105.0,74804506.0,,,,,,,,,,,15995692.0,28477861.0,13910907.0,83492710.0,,181202585.0,,7057105.0,,,,1766127.0,,27.0,,,39812753.0,,,,20798.0,,,,,,,,4421280.0,,,,,,,28.85,64292986.0,,,,,10515135.0,6797556.0,,,,,5855619.0,,11642269.0,14340646.0,,,,,,1174122.0,,33920190.0,,,,589564.0,,,,805173.0,,2.0,,12622423.0,1538739.0,3295338.0,62020.0,Y,,62896040.0,,1659850.0,,,,869359.0,,,,,,,,,14357.0,,47.71,,,,,,,,,62422996.0,,,,,22237684.0,,Y,1983.0,,,2.0,,309058.0,7189.0,3884287.0,,,15971929.0,-6504756.0,37248.0,1382647.0,-5600.0,,,,,12735558.0,,,,,252.07,33297.0,,,1466.0,,4864797.0,,,,588582.0,124330452.0,,,,,,24582460.0,,,72842962.0,,184911914.0,4463.0,,465429440.0,,3466933.0,,,,,,,,1149128.0,,,,,43999656.0,,,9957536.0,334101.0,18511.0,,3261.0,,2766269.0,110764.0,10486203.0,,,1840690.0,,,,,-3702979.0,,,43088470.0,,22067211.0,,,695359.0,,,,,,,,,,12709259.0,,,,,,,442096.0,,,3828720.0,,,,,,,2934336277.0,774328.0,3286684.0,,,39254.0,,,,258.0,,,,,,,,,27.65,,,42459836.0,,589564.0,176175.0,272131.0,,9674722.0,,,,,,,,,,,,,,,,20626661.0,,117175133.0,,82408297.0,,4592430.0,28148.0,,,,1773460.0,1635 NORTH LOOP WEST,15593372.0,,275569.0,17863.0,,21837078.0,,1220725.0,110228349.0,,734178.0,,28.0,501282246.0,,,176431198.0,2016,Acute Care Hospitals,MEMORIAL HERMANN  HOSPITAL SYS (450184)
45642,MEMORIAL HERMANN  HOSPITAL SYS (450184),General Short Term (Acute Care Hospitals),Voluntary Nonprofit-Other,-95.430899,29.812266,,,7373524.0,,,,,15012921.0,,,,,,417482089.0,2327231.0,,13734343.0,,521826626.0,19229448.0,,,Y,,1268152909.0,,,,3767504.0,,,,,,,,,3301090.0,,,7379952.0,,6904832.0,,,9428.0,,3386135.0,,6125090.0,,,,-6100.0,,,,3809162.0,,,,,,118559824.0,,,,59302902.0,,6291784.0,,33527272.0,,,,,,,,,,,,3371452.0,115492762.0,,82038.0,,,,,,,387905.0,,37106.0,,5265357.0,,,120178693.0,,738001.0,,,,,,,,,,,,,3303701.0,,,,751980657.0,26.0,3498.0,,,53633461.0,,,,,,169816.0,,246901311.0,,,,,452399.0,,,,,,743544.0,,55630.0,29768519.0,,,1289988270.0,,,1051759.0,,,107806385.0,698.0,,,38728.0,,69438273.0,,1411377.0,,,,,,,,,,,,,9309.0,4129600.0,,8167191.0,9619224.0,,,,,,,170927237.0,,,30629737.0,2054471.0,,96156601.0,,,63.0,,,,192325.0,,83818485.0,,,1473790.0,,,831570.0,1187071.0,,,92174.0,,,685079055.0,,86973460.0,HOUSTON,,3161966642.0,N,,103377365.0,83.0,,-1387964.0,,31695633.0,1427156.0,12734412.0,,,855313.0,-17353.0,1898.0,,,,7.0,59523787.0,1967785.0,,1950048.0,,0.196552,,,,,,,538003.0,739545.0,,,726258.0,04011,,,,,333250.0,,,15405116.0,1658618.0,,,,,,3171.0,1086015.0,,,42651153.0,,,,4.0,,,,11503745.0,1520879073.0,16171346.0,1293232884.0,,,2017-07-01 00:00:00,,,5269058.0,,,457741,2174812.0,704644.0,,,,,,,,,,,,866213.0,,,-90760.0,237692087.0,,N,15186807.0,,624716222.0,664176.0,,,,,1819976.0,,,,4,,1520879073.0,,155909.0,,,,87777.0,61213.0,26103911.0,,,,,,,,,,,,,,7942237.0,49923.0,,5097194580.0,,,,,6904832.0,,,9766449.0,,956.0,,,,,,2309500.0,,72651133.0,27408983.0,,,831570.0,,769882.0,,,22955907.0,1129194.0,375455.0,,,MEMORIAL HERMANN HOSP SYS- REHAB,2941221.0,,,329254454.0,,-4514880.0,,,,13783734.0,,,866213.0,61903778.0,1866636.0,,,,,,19780315.0,,78422.0,,,-6006.0,,30865776.0,,,,58097292.0,,-160681801.0,63518851.0,,,11057366.0,,80636473.0,,855364.0,1427614.0,,20269469.0,,10174455.0,,,,,2314817.0,,,,,3174349.0,129683873.0,4442576.0,52715905.0,,,,,,,,,,,,,9023650.0,,,,,,,,,12266845.0,36217874.0,,,4331638.0,,N,,,,1800230.0,,,,,14536918.0,,19981481.0,,,,14967.0,,1261.0,20.85,17453854.0,,,,,,,,,2024-02-15 00:00:00,,,,,,,1.0,24186.0,,1921999.0,,,,587920.0,,,47795073.0,,,,6.0,,,492173444.0,-44348074.0,,,,,836185.0,85537398.0,39974.0,1.0,24820.0,,10521446.0,,21284001.0,,,,,5392934.0,872640.0,527369562.0,,409517.0,,,,,-128069231.0,35.05,,50738837.0,,,,47795073.0,,,,,,,1445947.0,,,45T184,,,,,,73.0,,,,,,45.77,115492762.0,,,,42.2,,,,69438273.0,,,,,31935573.0,,624039.0,,92560877.0,,237692087.0,,,,,15280938.0,,65465802.0,,308156.0,,39794715.0,,,,,1.0,38734925.0,,,,929 GESSNER ROAD SUITE 2600,,,20999.0,269172.0,,114248725.0,,,4222099.0,,135784749.0,,,,,,,,9083027.0,,,,,,,,,,47.39,,432.0,95962.0,,,16.31,,,,,,,293371.0,,,,,,,,2941221.0,,44842252.0,858585.0,,,475014906.0,,,,17698568.0,,253363.0,659689.0,39863847.0,,,62014.0,,,,56808842.0,MEMORIAL HERMANN  HOSPITAL SYS,17258517.0,14325435.0,,,2761860.0,,336956155.0,,,,,131442427.0,,,14532.0,,,15186807.0,34071330.0,-374985.0,,,10818208.0,,39178387.0,,30095913.0,,,6965548.0,,,,4846441.0,54822621.0,,,,,16488.0,,,,,83818485.0,,,,,755198.0,29887.0,483392.0,,10031890.0,448495.0,20791397.0,,,,,,237692087.0,,,,,,,,,,,,,123760854.0,,39178387.0,,3048114.0,895788.0,39740386.0,164827.0,,10081960.0,8728328.0,29278821.0,,35.0,5989830.0,,,,,4563793.0,,,7377677.0,15201742.0,44.0,,,,,,,,,9969.0,,11854603.0,54822621.0,25195224.0,,,,123760854.0,,,,4360709.0,,1387707.0,9145.0,11553615.0,38456975.0,825314531.0,,53632449.0,95686693.0,318.0,497597.0,,,,47900069.0,51.39,,,,,7342.0,,,1623642.0,,,,,,758011.0,130123340.0,4129600.0,,,,,110182400.0,50132793.0,,,,,10417576.0,,,250741.0,14321651.0,46.08,-1392848.0,,,,1376.0,,29744893.0,,,,162509983.0,,6892774.0,,39431913.0,,,,293371.0,450184,,9362400.0,,,,37901206.0,,,,29.0,,,,,,,,6041848.0,113269.0,,,,,,,36552295.0,,,474818545.0,,,157822.0,12507.0,,34000.0,,,512165.0,,,,75859.0,,,,24015449.0,77024,,,,,9023650.0,,,37324.0,353.0,,,,,,,,,19820.0,,,408038.0,,,,,,2151.0,3445853.0,,,,31737.0,63163957.0,,473703415.0,,,38431418.0,,54722.0,1635132.0,,,42549.0,,,71483.0,137179.0,2933879.0,-9102599.0,45,2316577.0,67949378.0,47.39,1357.0,,36.52,105135.0,,,,6889922.0,13463066.0,,1479196.0,1996.0,,,,3892798.0,,35850769.0,N,,,,1268152909.0,34402.0,,,,652267.0,,,N,111.0,763934,1086.0,3014350.0,,,,,397531.0,,,,862241529.0,,,,,,,,3050.0,,,57830561.0,394200.0,,3281533.0,2059688.0,,,,,8728328.0,16335991.0,,,,,,786963400.0,,,,,,,,,,,,,90445.0,2.0,895381.0,,363027.0,,,,,,,,1296.0,4802614.0,25344244.0,,,,3144.0,45610,,,,9404943.0,,654427.0,,,,2824.0,13.0,,,2781.0,30446216.0,,,,9840.0,,,,,,,,,,,,32545.0,,271735262.0,51620088.0,,21204920.0,1083897.0,36860285.0,,,22865.0,,,,,2861905.0,,39740386.0,129683873.0,,,,492961180.0,56808842.0,,6196.0,11553615.0,48120420.0,58097292.0,,1824850.0,25703275.0,,,428659763.0,29911915.0,,,,,,24277678.0,,59114882.0,108899688.0,,,,,486826350.0,,5016766.0,,,,,,,,,3290032286.0,3927201.0,313940.0,157822.0,,2327231.0,,,,,375455.0,26420,,,,,,,79130066.0,,37901206.0,,TX,,9145.0,,,,,,,,,,13309943.0,6291784.0,22603.0,2265541.0,-63031.0,,,4521904.0,61514.0,,,,18268042.0,4757538.0,61514.0,,,,,,,,58773092.0,,,15047416.0,20096177.0,,,,2687645.0,,,1920048.0,,,,,3837493.0,70120.0,3360,,,,,,3863168.0,,,,,,,820726776.0,,,1556674.0,,247520.0,,,,192387737.0,,,7379952.0,90760.0,,,11401958.0,34071330.0,10.0,,,,,,7050704.0,,1.0,62014.0,,10417576.0,,,858585.0,,15201742.0,,,7697298.0,,,,,,,4954961.0,,,,,,1174918.0,163469417.0,,,,,134076.0,,18643454.0,11861300.0,1996.0,,,,,23014557.0,5628886.0,,,20798740.0,,,,,,,23014557.0,37.29,491490.0,,,35.05,,35.42,,,24015449.0,,,,-968138.0,36.62,,,,,,,2207680.0,,,,,,,,,,-6163003.0,3.0,,21538163.0,702840.0,72730.0,,,,752389.0,,,,,,,,,,1037173.0,,,,165832232.0,,,,,,,,,1542.0,,,-63089.0,32224432.0,,,,752768393.0,,201630.0,,6507027.0,,,N,,,,,42365217.0,,,,,-907000.0,9600.0,,,,,,13309943.0,6575973.0,,,,,,,,,,,,,,,,,,52146523.0,,95686693.0,257.0,5392934.0,,,80628.0,,,22246076.0,2.0,,113603932.0,,,,291867.0,,,81758178.0,,15280938.0,,,,,179581.0,41.0,,,,N,,,11188.0,14628.0,,,50248101.0,,11123.0,6008135.0,,679183.0,1358.0,2248.0,,,12760.0,,,867093.0,,31695633.0,,113065.0,,25079975.0,21.0,,,Y,1.0,,,,,,23158.0,,151398356.0,,,,1518654.0,,36388636.0,,11112.0,,68.0,253363.0,18573.0,,,22556015.0,,,N,,,,,,,,,,1359023.0,,,,,,119408272.0,18329504.0,,106.0,13666767.0,1012.0,,,,1080.0,145.0,1352180.0,,,1083897.0,24352211.0,,-3701.0,P,,394200.0,,1988634.0,,,,,,,,7942237.0,,7080667.0,,,,,,,1954220.0,33024461.0,,39.23,,55630.0,,,16239725.0,16061396.0,,,,,45835921.0,4699640.0,,2838.0,19480189.0,,1996970.0,98907.0,10231590.0,14532.0,,,,,3349334673.0,,,,,466336.0,,614293.0,,1473790.0,,,,748488.0,63163957.0,75859.0,,,3714698.0,3924778.0,,,477420.0,,,76408.0,,,,75888972.0,,,,,3863168.0,1599062.0,,,3980481.0,,,,,,,,14408470.0,F,,,,,,,,,,,,,654427.0,39431913.0,117530171.0,,,29768519.0,,,,,,,,,,,,,,64304214.0,13338213.0,,,,,,,,,,,,,,,81428771.0,,,12182295.0,,15182872.0,521826626.0,187624.0,,2311019.0,,,,,-6176034.0,4176456.0,,2639.0,509337.0,29584523.0,,,45.15,,2498229.0,,,1037173.0,,,927707332.0,,,,91882388.0,,,,,,,18944.0,,,6094.0,15908306.0,226044.0,6451998928.0,,7707.0,,,,,,,,,,,,,9314.0,131.0,,,,,,4186974.0,,3386135.0,9886841.0,26687807.0,7456754.0,1211917.0,,,,,,13834143.0,80628.0,1375764.0,,,,,,43432640.0,,1596690.0,,,,,61514.0,49822.0,,,,,,2644898.0,,,,,52114807.0,,,,,14890763.0,,304326629.0,,,,8534962.0,,,3901.0,,2872925.0,96156601.0,125271216.0,,,,,,Y,3195659.0,,,,,,1278674355.0,222797057.0,,,,8192300.0,,,,,,,,3303701.0,,MEMORIAL HERMANN,Y,209.0,456.0,,,83.0,,,,,,6596117.0,1072649.0,,,5161.0,546781.0,2170320.0,,,,16488.0,,,,,,,,,,37324.0,2071141.0,15138.0,,428.0,7.0,,,,,117530171.0,8512960.0,892142.0,4757538.0,,,,2880187.0,,,,3104856.0,,,,,N,,,,,,2023634.0,2941221.0,2018-06-30,,,,,48006066.0,HO9956,,33527272.0,,,,,,,,,,478339211.0,173751.0,51482347.0,,,,527038094.0,,,84030.0,31258204.0,74.89,,,,44.54,,,122375.0,,493509.0,,,,,,,,16031065.0,,,,,3767504.0,310095.0,,,,449.0,36217874.0,,,,,,30095913.0,12182295.0,,,,,,,-72774.0,,,,944354086.0,40211744.0,,,130123340.0,9600.0,55098.0,120178693.0,,,,86973460.0,-21735.0,,L,1231786.0,217902887.0,,,190913947.0,7835330.0,,,,,,,,107900.0,9969.0,6536050821.0,116.0,1910.0,,,2847.0,,173751.0,TX,,15047416.0,,,3054725.0,,31258204.0,,9103326.0,15280938.0,271.0,,,,,,,,3260535.0,,2.0,-1419019.0,17098.0,HARRIS,,,,,,,,,,1866636.0,-592310.0,11526422.0,6507027.0,47795073.0,,135457.0,,,,,19820.0,,39178387.0,194980374.0,,,24277678.0,,,1.0,,-76039336.0,,,,,157243.0,,,,,,,,52715905.0,,654222.0,42080392.0,,,,,,,,,,,704644.0,,,6596117.0,,-17250.0,2152.0,77008-,,,,,,,,177545.0,83162.0,,29873111.0,,,,,15138.0,,,240450.0,,,1950048.0,,-125761.0,,22865.0,,8002537.0,,,,,1418057501.0,,4604938.0,,,,2589600.0,,182640557.0,,,403.0,,1080.0,532425.0,,31586364.0,N,,,,,24543690.0,6.0,276920.0,,11264989.0,,,3401.0,,,,20799.0,,-128069231.0,,,1920048.0,3190174.0,,12266845.0,,,92.82,502282.0,,,2985.0,737819.0,,,,5888192.0,,1308.0,264295.0,,,,,,110762387.0,,,,,,,,,3533088.0,,,18.0,81758178.0,,,105910413.0,,,3980836.0,,,,,,,,,2761860.0,,,52925.0,,6889922.0,,,35850769.0,4587755.0,,72713147.0,1497210.0,99720902.0,,21595.0,111514508.0,,,,,,114987324.0,41908.0,,15405116.0,,,,,,5736.18,,,,108899688.0,132349.0,General Short Term,,,6969465.0,,,1294475.0,,,85537398.0,,,554603.0,,,30295.0,,,2188832.0,-2337720.0,,,22955907.0,,,,,33024461.0,35945285.0,441435.0,,86.0,,325748.0,,,523057093.0,,6677823.0,,18268042.0,3538.0,,,31716.0,554698335.0,,,,,77460537.0,,,,108722.0,27694.0,12226364.0,63518851.0,,,81428771.0,,,,25703275.0,,,,,,,,,,HOUSTON,9619224.0,,16660364.0,,,,916136.0,,,,,4133796.0,,,,473768.0,,8329121.0,,,338192306.0,,,,,12198381.0,29873111.0,9889441.0,,6124.81,104480462.0,,58484.0,,432.0,,,,,16061396.0,,,61007246.0,,355511.0,16389631.0,,,,,752389.0,181429650.0,,,,,,4802614.0,,4701313.0,65455368.0,14540.0,3892798.0,,5496.0,,16660364.0,743544.0,,,1052196.0,5245146.0,,,,46797.0,,,50738837.0,251813.0,,13478525.0,,1794.0,,-51300.0,2311699.0,,,,,,,160465.0,1438856241.0,,,,,,,3.0,,2215711.0,,,,44390935.0,5356.0,114248725.0,,,,1493.0,,8047.0,,13698861.0,,,,,,,,169246.0,,3576.0,,,,,,22556015.0,,,,,27442.0,79130066.0,,,,,,,,,,,15217189.0,26687807.0,15908306.0,91882388.0,,195205375.0,,7827017.0,,,,1624143.0,,247.0,,,43197245.0,,,,18573.0,,,,,,,,3253164.0,,,,,,,30.13,65455368.0,,,,,1950048.0,6637232.0,,,,,5525204.0,,12226364.0,15024959.0,,,,,,1387707.0,,40776997.0,,,,490487.0,,,,752389.0,,3.0,,11987513.0,1503387.0,8192300.0,377304.0,Y,,62234964.0,,1685251.0,,,,809542.0,,,,,,,,,7707.0,,45.29,,,,,,,,,62504243.0,,,,,21463062.0,,Y,3800.0,,,44.0,,492055.0,2506.0,4353597.0,,,16297674.0,-7681821.0,40792.0,1326114.0,-3725.0,,,,,-33869220.0,,,,,285.13,38458.0,,,1894.0,,4614761.0,,,,736092.0,125271216.0,,,,,,25195224.0,,,75888972.0,,182071957.0,2891.0,,473703415.0,,3533088.0,,,,,,,,1150527.0,,,,,52208706.0,,,10031890.0,34000.0,23640.0,,4248.0,,2336391.0,122375.0,9245273.0,,,1116805.0,,,,,-3381707.0,,,42651153.0,,21439859.0,,,737819.0,,,,,,,,,,15182872.0,,,,,,,503626.0,,,3693467.0,,,,,,,3186716148.0,819021.0,3054725.0,,,30317.0,,,,,,,,,,,,,26.31,,,29584523.0,,490487.0,180925.0,318029.0,,9362400.0,,,,,,,,,,,,,,,,23006146.0,,117810517.0,,79131883.0,,7072504.0,28008.0,,,,1807874.0,1635 NORTH LOOP WEST,16994284.0,,283250.0,17098.0,,22758351.0,,1290105.0,110182400.0,,756836.0,,,521941963.0,,,174301389.0,2017,Acute Care Hospitals,MEMORIAL HERMANN  HOSPITAL SYS (450184)
51890,MEMORIAL HERMANN  HOSPITAL SYS (450184),General Short Term (Acute Care Hospitals),Voluntary Nonprofit-Other,-95.430899,29.812266,,,4855882.0,,,,,14564052.0,,,,,,485211880.0,2416155.0,,15822594.0,,564254241.0,20372294.0,,,Y,,1331354102.0,,,,4165777.0,,,,,,,,,3331873.0,,,7504874.0,,7316157.0,,,5710.0,,3667123.0,,4514972.0,,,,-6850.0,,,,4196735.0,,,,,,127442369.0,,,,63789750.0,,4187679.0,,29418461.0,,,,,,,,,,,,3791217.0,63477755.0,,149738.0,,,,,,,456173.0,,33858.0,,5268539.0,,,117644429.0,,739053.0,,,,,14.0,,,,,,,,4186504.0,,,,794425353.0,16.0,9817.0,,,58827593.0,,,,,,176412.0,,247891249.0,,,,,4622.0,,,,,,851363.0,23278.0,55955.0,29373055.0,,,1355222861.0,,,1138671.0,,,119445614.0,772.0,,,40908.0,,70044157.0,,1494352.0,,,,,,,,,,,,,8462.0,4343595.0,,8110760.0,10727249.0,,,,,,,181240162.0,,,30589166.0,2547734.0,,107409864.0,,,14.0,,,,312461.0,,84587023.0,,,628437.0,,,700129.0,1175269.0,,,100033.0,,,729887620.0,,96612676.0,HOUSTON,,3472301844.0,N,,106494115.0,85.0,,-703046.0,,31902248.0,1914204.0,13392586.19,13722.0,,1208579.0,-1004.0,1402.0,,,,7.0,60761666.0,2170388.0,,22649741.0,,0.186464,,,,,,13474.0,420150.0,492260.0,,,1207674.0,04011,,,,,189100.0,,,14228156.0,1997922.0,,,,,,43247.0,1354097.0,,,44832270.0,,,,3.0,,,,12243787.0,1589579535.0,18604522.0,1360408197.0,,,2018-07-01 00:00:00,,,5268539.0,,,457741,4413552.0,820345.0,,,,,,,,,,,,10020561.0,,,,248587941.0,,N,14479534.0,,619213354.0,733498.0,,,,,2083943.0,,,,4,,1589579535.0,,171507.0,,,,60530.0,40566.0,27656539.0,,,,,,,,,,,,,,8266516.0,37469.0,,5643411098.0,,,,,7316157.0,,,11296735.0,,493.0,,,,,,2571682.0,,77982269.0,24035268.0,,,700129.0,,932103.0,,,22058934.0,1170276.0,386893.0,23278.0,,MEMORIAL HERMANN HOSP SYS- REHAB,2086812.0,,,197766466.0,,-4783191.0,,,,15873919.0,,,10020561.0,67709382.0,1849656.0,,,,,,19824000.0,,48026.0,,,,,33137051.0,,,,56079643.0,,-207822841.0,72838963.0,,,11445019.0,,98323051.0,,692076.0,1642965.0,,19400824.0,,8751100.0,,,,,4031809.0,,,,,9116250.0,136828325.0,4446893.0,54498671.0,,,,,,,,,,,,,12266430.0,,,,,,,,,14381510.0,39424479.0,,,2735988.0,,N,,,,2070341.0,,,,,14653383.0,,20770484.0,,,,5055.0,,575.0,21.69,,,,,,,,,,2024-03-06 00:00:00,,,,,,,,25449.0,,2169922.0,,,,623960.0,,,45623899.0,,,,,,,531806839.0,-62416593.0,,,,,886678.0,97900021.0,44596.0,1.0,28470.0,,11857147.0,,19529092.0,,,,,2788535.0,606690.0,509856083.0,,453705.0,,,,,-118766931.0,35.6,,50738837.0,,,,45623899.0,,,,,,,2015364.0,,,45T184,,,,,,110.0,,,,,,40.93,63477755.0,,,,43.35,,,,70044157.0,,,,,27359859.0,,640682.0,,106415637.0,,248587941.0,,,,,17612151.0,,14403803.0,,123139.0,,40819662.0,,,,,3.0,38215936.0,,,,929 GESSNER ROAD SUITE 2600,,,25445.0,129071.0,,121527252.0,,,3819384.0,,136122044.0,,,,,,,,6989617.0,,,,,,,,,,54.54,,400.0,97896.0,,,16.16,,,,,,,274935.0,,,,,,,,2086812.0,,45224635.0,835100.0,,,525792807.0,,,,19825400.0,,256761.0,683554.0,43822902.0,,,59236.0,,,,69291622.0,MEMORIAL HERMANN  HOSPITAL SYS,19409725.0,16549787.0,,,382383.0,,367249997.0,,,,,147006331.0,,,14487.0,,,14479534.0,32948513.0,-3854629.0,,,12435406.0,,50988777.0,,29725976.0,,,,,,,5374759.0,57124227.0,,,,,16757.0,,,,,84587023.0,,,,,912425.0,33981.0,658814.0,,9738995.0,691000.0,20126679.0,,,,,,248587941.0,,,,,,,,,,,,,134911017.0,,50988777.0,,2696654.0,966529.0,40911607.0,186909.0,,11210992.0,10034178.0,48691569.0,,19.0,5701823.0,,,,,5345844.0,,,11039722.0,16920036.0,3.0,,,,,,,,,9991.0,,12228026.0,57124227.0,29186223.0,,,,134911017.0,,,,4226222.0,,1776383.0,10105.0,12422492.0,37743905.0,830507658.0,,58826740.0,130968506.0,6.0,683954.0,,,,40920793.0,52.27,,,,,3418.0,,,2447827.0,,,,,96296.0,853602.0,125790189.0,4343595.0,,,,,111193296.0,42448335.0,,,,,10301052.0,,,365959.0,15235370.19,46.08,-220545.0,,,,1388.0,,34643391.0,,,,181879861.0,,7762270.0,,34731083.0,,,,274935.0,450184,,11049754.0,,,,43571310.0,,,,,,,,,,,,7668096.0,177226.0,,,,,,,38165522.0,,,510115247.0,,,1621293.0,20001.0,,,,,535732.0,,,,80012.0,,101210.0,,23989952.0,77024,,,,,12266430.0,,,38745.0,1084.0,,,,,,,,,21521.0,,,444165.0,,,,,,2631.0,4068092.0,,,,20417.0,145112982.0,,509183368.0,,,42018506.0,,37350.0,1749921.0,,,42215.0,,,71561.0,140363.0,2083394.0,-375157.0,45,3484359.0,84668481.0,54.54,1148.0,,36.9,144337.0,,,,6871884.0,14400270.19,,2906623.0,6763.0,,,,3995100.0,,37428935.0,N,,,,1331354102.0,31262.0,,,,884828.0,,,N,335.0,765420,1007.0,2915129.0,,,,,428971.0,,,,927707332.0,,,,,,,20220.0,10000.0,,,70722944.0,389820.0,,9850449.0,2251012.0,,,,,10034178.0,17250850.53,,,,,,840574379.0,,,,,,,,,,,,,465792.0,1.0,178281.0,,361275.0,,,,,,,3751305.0,1727.0,5355813.0,29851329.0,,,,4521.0,45610,,,,9733806.0,,803293.0,,,,4315.0,9.0,,,4792.0,47900069.0,,,,15909.0,,,,,,,,,,,,4108.0,,290630301.0,52642966.0,,21758895.0,1131554.0,36147215.0,,,24181.0,,,,,1895472.0,,40911607.0,136828325.0,,,,532385797.0,69291622.0,,14179.0,12422492.0,47039077.0,56079643.0,,19848.0,25517296.0,,,463303935.0,16305823.0,,,,,,25263056.0,,59261318.0,103413164.0,,,,,702379582.0,,6361291.0,,,,,,,,,3667700164.0,4984262.0,393528.0,1621293.0,,2416155.0,,,,,386893.0,26420,,,,,,,85843887.0,,43571310.0,,TX,,10105.0,,,,,,,,,,16511587.0,4187679.0,60418.0,2186866.0,-21373.0,,,3325091.0,61570.0,,,,24308002.0,12310072.0,61570.0,,,,,,,,64226602.0,,,16673386.0,22808245.0,,,,3173094.0,,,2166920.0,,,,,3924941.0,92735.0,3360,,,,,,4706392.0,,,,,,,965839758.0,,,1825090.0,,993.0,,,,173416409.0,,,7504874.0,,,,10478803.0,32948513.0,5.0,,,,,,8269629.0,,,59236.0,,10301052.0,,,835100.0,,16920036.0,,,9115318.0,,,,,,,5700846.0,,,,,,1196736.0,177177476.0,,,,,131474.0,,15794559.0,13064073.0,6763.0,,,,,22896612.0,5781883.0,3258.0,,113418001.0,,,,,,,22896612.0,38.09,494584.0,,,35.6,,34.52,,,23989952.0,,,,14661306.0,36.97,,,,,,,2276011.0,,,,,,,,,,6466008.0,2.0,,23396774.0,738225.0,64027.0,,,,515832.0,,,,,,,,,,1077542.0,,,,166899280.0,,,,,,,,,4476.0,,,535089.0,18078267.0,,,,795004311.0,,176568.0,,6649671.0,,,N,,,,,31694981.0,,,,,-5193532.0,9938.0,,,,,,16511587.0,6069221.0,,,,,,,,,,,,,,,,,,56902657.0,,130968506.0,881.0,2788535.0,,,81666.0,,,25605876.0,,,126624446.0,,,,264284.0,,,84562207.0,,17612151.0,,,,,319610.0,17.0,,,,N,,,13374.0,12762.0,,,54889433.0,,33543.0,6117124.0,,698113.0,781.0,1999.0,,,25377.0,,,10034444.0,,31902248.0,,155867.0,,29054095.0,10.0,,,Y,1.0,,,,,,12525.0,,161988960.0,,,,1968955.0,,25274869.0,,13054.0,,78.0,256761.0,19128.0,,,24052870.0,,,N,,,,,,,,,6979277.0,819528.0,,,,,,130884690.0,19291186.0,,29.0,16214189.0,853.0,,,,1068.0,157.0,1784990.0,,,1131554.0,28325944.0,,,P,,389820.0,,2536442.0,,,,,,,,8266516.0,,7005133.0,,,,,,,2157893.0,28926735.0,,37.14,,55955.0,,,16337806.0,19316784.0,,,,,44235858.0,4639675.0,,2846.0,20738253.0,,2172513.0,170325.0,10220682.0,14487.0,,,,,3730403684.0,,,,,894032.0,,774850.0,,628437.0,,,,513975.0,145112982.0,80012.0,,,3317751.0,10415136.0,,,478150.0,,,81714.0,,,,75236322.0,,,,,4706392.0,1586851.0,,,4889216.0,,,,,,,,13787652.0,F,,,,,,,,,,,,,803293.0,34731083.0,120418031.0,,,29373055.0,,,,,,,,,,,,,,74253585.0,5861256.0,,,,,,,,,,,,,,,93393201.0,,,13376022.0,,12948045.0,564254241.0,187557.0,,1970403.0,,,,,8862136.0,4698914.0,,2097.0,1839.0,3689130.0,,,48.89,,3182245.0,,,1077542.0,,,938359830.0,,,,103389789.0,,,,,,,245190.0,,,2817.0,19676659.0,213850.0,7140002008.0,,15133.0,,,,,,,,,,,,,132361.0,101.0,,,,,,4567725.0,,3667123.0,10461903.0,29481578.0,6712253.0,1198716.0,,,,,,21137448.0,81666.0,1516095.0,,,,,,46547444.0,,1596690.0,,,,,61570.0,49231.0,,,,,,2582540.0,,,,,56858638.0,,,,,16436460.0,,353522355.0,,,141904.0,8534962.0,,,1857.0,,2850580.34,107409864.0,134657636.0,,,,,,Y,3229048.0,,,,,,1343211249.0,243446602.0,,,,10174215.0,,,,,,,,4186504.0,,MEMORIAL HERMANN,Y,59.0,946.0,,,115.0,,,,,,5968965.0,1176535.0,,,5668.0,892467.0,5699373.0,,,,16757.0,,,,,,,,,,38745.0,2048233.0,11371.0,,251.0,4.0,,,,,120418031.0,9836498.0,825995.0,12310072.0,,,,2531980.0,,,,3100613.0,,,,,N,,,,,,1798341.0,2086812.0,2019-06-30,,,,,49711350.0,HO9956,,29418461.0,,,,,,,,,,574646765.0,90178.0,56169159.0,,,,718065104.0,,,141904.0,27084517.0,161.11,,,,43.39,,,125417.0,,617796.0,,,,,,,,15928056.0,,,,,4165777.0,231225.0,,,,,39424479.0,-3300.0,,,,,29725976.0,13376022.0,,,,,,,7762270.0,,,,964806424.0,15685522.0,,,125790189.0,9938.0,65523.0,117644429.0,,,,96612676.0,-35853.0,,M,1351140.0,270273811.0,,,172787972.0,7702314.0,,,,,,,,116827.0,9991.0,7230818657.0,254.0,2337.0,,,2452.0,,90178.0,TX,,16673386.0,,,1273876.0,,27084517.0,,9197990.0,17612151.0,434.0,,,,,,,,6067744.0,,1.0,-1979380.0,14377.0,HARRIS,,,,,,,,,,1849656.0,-1529163.0,11728085.0,6649671.0,45623899.0,,161393.0,,,,,21521.0,,50988777.0,210723181.0,,,25263056.0,,,21902.0,,-60096574.0,,,,,96296.0,,,,,,,,54498671.0,,1023512.0,44842252.0,,,,,,,,,,,820345.0,,,5968965.0,,-103800.0,2724.0,77008-,,,,,,,,165005.0,109825.0,,30010267.0,,,,,11371.0,,,292126.0,,,11919159.0,,,,24181.0,,8534962.0,,,,,1473989558.0,,4607899.0,,,,2791079.0,,196529590.0,,,1290.0,,1068.0,,,30829693.0,N,,,,,26343091.0,6.0,340735.0,,22174281.0,,,3347.0,,,,5501.0,,-118766931.0,,,2166920.0,3380020.0,,14381510.0,,,74.89,629595.0,,,3687.0,745143.0,,,,5252543.0,,1310.0,136981.0,,,,,,139057007.0,,,,,,,,,3548440.0,,,18.8,84562207.0,,,112098403.0,,,3695095.0,,,,,,,,,382383.0,,,57305.0,,6871884.0,,,37428935.0,-135332100.0,,78041505.0,1449166.0,113498346.0,,9337.0,116434222.0,,,,,,113915304.0,70772.0,,14228156.0,,,,,,6110.82,,,,103413164.0,116021.0,General Short Term,,,8468333.0,,,1385952.0,,,97900021.0,,,6719892.0,,,31025.0,,,1570980.0,3175564.0,,,22058934.0,,,,,28926735.0,37416800.0,303992.0,,,,331391.0,,,562111773.0,,6114523.0,,24308002.0,1695.0,,,44019.0,591853130.0,,,,,77815198.0,,,,123273.0,18276.0,12478286.0,72838963.0,,,93393201.0,,,,25517296.0,,,,,,,,,,HOUSTON,10727249.0,,17949834.0,,,,2196949.0,,,,,4349613.0,,,,257627.0,,7441912.0,,,380211866.0,,,,,11843238.0,30010267.0,10889591.0,,6494.14,106825372.0,,285155.0,,1181.0,,,,,19316784.0,,,65862668.0,,393734.0,17662477.0,,,,,515832.0,195203652.0,,,,,,5355813.0,,4806319.0,70781942.0,15737.0,3995100.0,,2033.0,,17949834.0,851363.0,,,1109379.0,5277861.0,,,,24576.0,,,50738837.0,501500.0,,12997069.0,,4583.0,,,2760772.0,,,,,,,166388.0,1587407559.0,,,,,,,1.0,,2374996.0,,,,48150429.0,6326.0,121527252.0,,,,1590.0,,16571.0,,13945183.0,,,,,,,,316087.0,,4157.0,,,,,,24052870.0,,,,,12825.0,85843887.0,,,,,,,,,,,16943478.0,29481578.0,19676659.0,103389789.0,,208505769.0,,8333611.0,,,,1664048.0,,128.0,,,42564100.0,,,,19128.0,,,,,,,,2802381.0,,,,,,,30.99,70781942.0,,,,,22649741.0,6738994.0,,,,,5190066.0,,12478286.0,15848505.0,,,,,,1776383.0,,49501096.0,,,,560398.0,,,,515832.0,,5.0,,12460735.0,1701007.0,10174215.0,119819.0,Y,,67897689.0,,1888573.0,,,,1115107.0,,,,,,,,,15133.0,,44.13,,,,,,,,,56605733.0,,,,,22754226.0,,Y,4498.0,,,3.0,,469149.0,9131.0,4920183.0,,,16068943.0,3746236.0,7907.0,1691904.0,-4175.0,,,,,-173076005.0,,,,,264.11,39350.0,,,2337.0,,4423087.0,,,,995879.0,134657636.0,,,,,,29186223.0,,,75236322.0,,183237086.0,1797.0,,509183368.0,,3548440.0,,,,,,,,1065204.0,,,,,54114617.0,,,9738995.0,,21819.0,,2867.0,,3029162.0,125417.0,11894392.0,,,1275984.0,,,,,-12335495.0,,,44832270.0,,20724089.0,,,745143.0,,,,,,,,,,12948045.0,,,,,,,497036.0,,,3932877.0,,,,,,,3500414973.0,974961.0,1273876.0,,,74586.0,,,,,,,77.0,,,,,,25.7,,,3689130.0,,560398.0,178889.0,433645.0,,11049754.0,,,,,,,,,,,,,,,,17832347.0,,123530435.0,,94739169.0,,8047898.0,3430.0,,,,2453129.0,1635 NORTH LOOP WEST,19965260.0,,290742.0,14377.0,,25407738.0,,1711726.0,111193296.0,,631175.0,,,561179894.0,,,172694821.0,2018,Acute Care Hospitals,MEMORIAL HERMANN  HOSPITAL SYS (450184)
57957,MEMORIAL HERMANN  HOSPITAL SYS (450184),General Short Term (Acute Care Hospitals),Voluntary Nonprofit-Other,-95.430899,29.812266,,,3772885.0,,,,,15121770.0,,,,,,470474026.0,1891803.0,,16371439.0,,544247723.0,20892528.0,,,Y,,1467161793.0,,,,3750777.0,,,,,,,,,2368448.0,,,7835834.0,,6030434.0,,,1836.0,,3271621.0,,5251018.0,,,,-6500.0,,,,4225116.0,,,,,,124691288.0,,,,65706178.0,,2980506.0,,30591953.0,,,,,,,,,,,,4044670.0,44076070.0,,78517.0,,,,,,,467402.0,,15948.0,,5677168.0,,,115664035.0,,724787.0,,,,,1.0,,,,,,,,4624486.0,,,,818087761.0,,10924.0,,,55577820.0,,,,,,196287.0,,253790324.0,,,,,3417.0,,,,,,868533.0,,48306.0,30012857.0,,,1490620061.0,,,942328.0,,,117169474.0,624.0,,,21765.0,,66739662.0,,1592385.0,,,,,,,,,,,,,8473.0,4508487.0,,15003256.0,10955093.0,,,,,,,223047111.0,,,32000904.0,2260013.0,,104440868.0,,,,,,,190194.0,,89851362.0,,,579163.0,,,796810.0,1292130.0,,,352964.0,,,741352799.0,,90918672.0,HOUSTON,,3574705883.0,N,,104895621.0,93.0,,-66479.0,,31116301.0,1628671.0,14037569.0,7880.0,,795880.0,,852.0,,,,7.0,58177020.0,1914410.0,,,,0.202878,,,,,,1576.0,494595.0,156931.0,,,1456819.0,04011,,,,,151879.0,,,14432538.0,2425176.0,,,,,,17871.0,1549367.0,,,41914112.0,,,,,,,,11372865.0,1630407549.0,17951070.0,1502484456.0,,,2019-07-01 00:00:00,,,5677168.0,,,457741,4486168.0,1310255.0,,,,,,,,,,,,10959312.0,,,,282356223.0,,N,16971808.0,,590081208.0,751976.0,,,,,2185957.0,,,,2,,1630407549.0,,136396.0,,,,48994.0,32701.0,26507994.0,,,,,,,,,,,,,,5946415.0,46673.0,-24444.0,5709796920.0,,,,,6030434.0,,,10389620.0,,,,,,,,2933901.0,,82153309.0,25555696.0,,,796810.0,,972353.0,,,19691852.0,1114800.0,378420.0,,,MEMORIAL HERMANN HOSP SYS- REHAB,645628.0,,,225392104.0,,-4286878.0,,,,17991985.0,,,10959312.0,63968862.0,2153011.0,,,,,,20811072.0,,5254.0,,,,,32674228.0,,,,55631968.0,,-109490737.0,73435654.0,,,11958168.0,,101167260.0,,325942.0,1730843.0,,21110867.0,,9818019.0,,,,,4944506.0,,,,,4767810.0,135032821.0,4243561.0,59591643.0,,,,,,,,,,,,,13600799.0,,,,,,,,,14268919.0,37130563.0,,,2199323.0,,N,,,,1542191.0,,,,,14102421.0,,19647456.0,,,,,,,22.14,-816509.0,,,,,,,,,2024-02-22 00:00:00,,,,,,,,196286.0,,7814883.0,,,,729860.0,,,43215318.0,,,,179.0,,,561391730.0,-64558883.0,,,,,885672.0,93005479.0,41013.0,1.0,26718.0,,11203205.0,,20292109.0,,,,,3065796.0,444490.0,546628493.0,,481231.0,,,,,-44203501.0,35.83,,50738837.0,,,,43215318.0,,,,,,,4093712.0,,,45T184,,,,,,200.0,,,,,,41.51,44076070.0,,,,41.15,,,,66739662.0,,,,,33424115.0,,33811.0,,97290294.0,,282356223.0,,,,,19992206.0,,10118823.0,,135255.0,,44424950.0,,,,,2.0,41896760.0,,,,929 GESSNER ROAD SUITE 2600,,,10389.0,150923.0,,130590128.0,,,4126414.0,,126468843.0,,,,,,,,7424485.0,,,,,,,,,,50.62,,446.0,98279.0,,,31.93,,,,,,,32182.0,,,,,,,,645628.0,,46612320.0,846866.0,,,524697328.0,,,,20056457.0,,245350.0,747048.0,46155866.0,,,60678.0,,,,70493069.0,MEMORIAL HERMANN  HOSPITAL SYS,23978184.0,13689047.0,,,1387685.0,,384767128.0,,,,,142857471.0,,,13015.0,,,16971808.0,29662769.0,-2633858.0,,,11331948.0,,47703354.0,,30341435.0,,,,,,,5543201.0,55097623.0,,,,,16589.0,,,,,89851362.0,,,,,1064715.0,35082.0,821557.0,,10647148.0,1774747.0,21115713.0,,,,,,282356223.0,,,,,,,,,,,,,146035494.0,,47703354.0,,1624247.0,1117906.0,38459936.0,185964.0,,10277269.0,10620240.0,33386071.0,,,5889580.0,,,,,5330654.0,,,9964270.0,17600511.0,1.0,,,,,,,,,10493.0,,13561855.0,55097623.0,26225230.0,,,,146035494.0,,,,3948254.0,,1951425.0,7889.0,14196343.0,1596690.0,778847040.0,,55577895.0,149239256.0,912.0,861646.0,,,,40104283.0,57.45,,,,,,,,2419554.0,,,,,73925.0,754327.0,121663210.0,4508487.0,,,,,118862877.0,40570991.0,,,,,10480428.0,,,371926.0,15611167.0,47.47,-1603459.0,,,,1408.0,,34209488.0,,,,210129372.0,,6942931.0,,40458698.0,,,,32182.0,450184,,11077835.0,,,,47725772.0,,,,2.0,,,,,,,,7208838.0,105371.0,,,,,,,41954979.0,,,540123321.0,,,1994595.0,19240.0,,17395.0,,,459373.0,,,,76891.0,,10768.0,,26955685.0,77024,,,,,13600799.0,,,41672.0,1174.0,,,,,,,,,20804.0,,,343227.0,,,,,,1454.0,4003253.0,,,,24150.0,139654724.0,,539339104.0,,,42903651.0,,33621.0,1451258.0,,,48811.0,,,66018.0,144375.0,645628.0,-978336.0,45,3642344.0,86230271.0,50.62,1226.0,,37.93,173690.0,,,,4754422.0,14764301.0,,3207041.0,,,,,3790136.0,,35897349.0,N,,,,1467161793.0,61553.0,,,,960813.0,,,N,438.0,764307,970.0,2102545.0,,,,,321575.0,,,,938359830.0,,,,,,,17717.0,5226.0,,,73328461.0,389790.0,,3355555.0,1189323.0,,,,,10620240.0,17243508.0,,,,,,822985991.0,,,,,,,,,,,,,654248.0,,-480265.0,,390566.0,,,,,,,,1854.0,5051246.0,34235194.0,,,,1252.0,45610,,,,12434389.0,,1955635.0,,,,4880.0,,,,6581.0,40920792.0,,,,9988.0,,,,,,,,,,,,33676.0,,289017290.0,55905902.0,,19919228.0,1248352.0,,,,45832.0,,,,,577337.0,,38459936.0,135032821.0,,,,561847369.0,70493069.0,,2771.0,14196343.0,65335513.0,55631968.0,,13820.0,24240688.0,,,464977733.0,23375431.0,,,,,,25399421.0,,60343084.0,125765254.0,,,,,735610841.0,,6468209.0,,,,,,,,,3657050567.0,4685745.0,317598.0,1994595.0,,1891803.0,,,,,378420.0,26420,,,,,,,84311632.0,,47725772.0,,TX,,7889.0,,,,,,,,,,18941990.0,2980506.0,25163.0,1757153.0,,,,2203410.0,55525.0,,,,24128308.0,5301426.0,55525.0,,,,,,,,66318288.0,,,17078855.0,23173283.0,,,,3275253.0,,,7808445.0,,,,,4144294.0,65574.0,3360,,,,,,5737789.0,,,,,,,1105494482.0,,,1997231.0,,1036.0,,,,199926936.0,,,7835834.0,,,,11069833.0,29662769.0,5.0,,,,,,7581171.0,,,60678.0,,10480428.0,,,846866.0,,17600511.0,,,9313914.0,,,,,,,5824090.0,,,,,,1226817.0,172585874.0,,,,,82751.0,,17029875.0,13647996.0,,,,,,26712358.0,6048793.0,,,77353875.0,,,,,,,26712358.0,38.48,377236.0,,,35.83,,36.11,,,26955685.0,,,,1483914.0,38.05,,,,,,,2369069.0,,,,,,,,,,6087255.0,,,22854742.0,489214.0,7957.0,,,,163995.0,,,,,,,,,,1186255.0,,,,180668772.0,,,5254.0,,,,,,1941.0,,,455793.0,17385198.0,,,,818543400.0,,41760.0,,6216160.0,,,N,,,,,62300849.0,,,,,-8817937.0,7460.0,,,,,,18941990.0,7009189.0,,,,,,,,,,,,,,,,,,53723569.0,,149239256.0,930.0,3065796.0,,,73907.0,,,22926902.0,1.0,,126210656.0,,,,235091.0,,,84171041.0,,19992206.0,,,,,187638.0,10.0,,,,N,,,6669.0,11983.0,,,51966266.0,,13227.0,5458565.0,,581432.0,964.0,882.0,,,20566.0,,,10968349.0,,31116301.0,,114857.0,,35322663.0,10.0,,,Y,1.0,,,,,,4088.0,,157892624.0,,,,1878590.0,,27721370.0,,14095.0,,73.0,245350.0,18923.0,,,25613551.0,,,N,,,,,,,,,,647995.0,,,,,,146062615.0,19950697.0,,,13250686.0,-75.0,,,,1065.0,177.0,1177400.0,,11811.0,1248352.0,29165880.0,,,P,,389790.0,,2348334.0,,,,,,,,5946415.0,,7444339.0,,,,,,,1438898.0,36523386.0,,37.69,,48306.0,,,15210874.0,20043181.0,,,,,43448905.0,4273085.0,,3064.0,21264454.0,,1819253.0,103965.0,9752309.0,13015.0,,,,,3720936641.0,,,,,999299.0,,687536.0,,579163.0,,,,163995.0,139654724.0,76891.0,,,3658120.0,4023983.0,,,488610.0,,,84204.0,,,,83839757.0,,,,,5737789.0,1647447.0,,,4629518.0,,,,,,,,15845740.0,F,,,,,,,,,,,,,1955635.0,40458698.0,117427094.0,,,30012857.0,,,,,,,,,,,,,,77690598.0,6951825.0,,,,,,,,,,,,,,,90869975.0,,,12244442.0,,13616790.0,544247723.0,154374.0,,1654296.0,,,,,10714742.0,4099560.0,,5902.0,3370.0,3320839.0,,,47.44,,2611674.0,,,1186255.0,,,948478652.0,,,,114147041.0,,,,,,,264220.0,,,,20131109.0,144259.0,7231756450.0,,3743.0,,,,,,,,,,,,,62201.0,62.0,,,,,,4517386.0,,3271621.0,10675102.0,28312081.0,6754128.0,1310444.0,,,,,,13468160.0,73907.0,1151762.0,,,,,,52426098.0,,1596690.0,,,,,55525.0,41604.0,,,,,,3218015.0,,,,,53699230.0,,,,,16972973.0,,379527733.0,,,166198.0,8564408.0,,,,,2479207.0,104440868.0,152560095.0,,,,,,Y,3533176.0,,,,,,1478364998.0,247262439.0,,,,11879019.0,,,,,,,,4624486.0,,MEMORIAL HERMANN,Y,,,,,205.0,,,,,,6797045.0,928151.0,,,5125.0,822843.0,5567676.0,,,,16589.0,,,,,,,,,,41672.0,2328479.0,2132.0,,233.0,,,,,,117427094.0,8677792.0,826934.0,5301426.0,,,,1976350.0,,,,3174869.0,,,,,N,,362388.0,,,,1340015.0,645628.0,2020-06-30,,,,,51767824.0,HO9956,,30591953.0,,,,,,,,,,580843702.0,41544.0,52971593.0,,,,749852856.0,,,178009.0,33055222.0,134.71,,,,48.45,,,139554.0,,573764.0,,,,,,,,16567271.0,,,,,3750777.0,300457.0,,,,,37130563.0,,,,,,30341435.0,12244442.0,,,,,,,6942931.0,,,,995484458.0,14242015.0,,,121663210.0,7460.0,42309.0,115664035.0,,,,90918672.0,-4163.0,,S,5569493.0,280988209.0,,,199347773.0,11800394.0,,,,,,,,99409.0,10493.0,7321974079.0,381.0,2501.0,,,1068.0,,41544.0,TX,,17078855.0,,,1244753.0,,33055222.0,,17427832.0,19992206.0,547.0,,,,,,,,6700755.0,,,-2287225.0,42521.0,HARRIS,,,,,,,,,,2153011.0,-1071392.0,8661133.0,6216160.0,43215318.0,,285681.0,,,,,20804.0,,47703354.0,220347252.0,,,25399421.0,,,23501.0,,25835347.0,,,,,79179.0,,,,,,,,59591643.0,,875362.0,45224635.0,,,,,,,,,,,1310255.0,,,6797045.0,,-65762.0,1183.0,77008-,,,,,,,,349372.0,100000.0,,28246103.0,,,,,2132.0,,,330147.0,,,,,-49509.0,,45832.0,,8534962.0,,,,,1534823284.0,,3943941.0,,,,4671787.0,,173114650.0,,,754.0,,1065.0,,,33772616.0,N,,,,,28675640.0,6.0,355286.0,,11694672.0,,,3572.0,,,,6480.0,,-44203501.0,,,7808445.0,3562508.0,,14268919.0,,,68.23,372000.0,,,3910.0,624730.0,,,,4031596.0,,1335.0,121798.0,,,,,,136439159.0,,,,,,,,,2666691.0,,,19.28,84171041.0,,,105655926.0,,,3923024.0,,,,,,,,,1387685.0,,,64782.0,,4754422.0,,,35897349.0,-326647442.0,,82213987.0,1439732.0,118711099.0,,,121791902.0,,,,,,111863933.0,11811.0,,14432538.0,,,,,,6415.28,,,,125765254.0,107508.0,General Short Term,,,8647758.0,,,1395779.0,,,93005479.0,,,7933676.0,,,34038.0,,,481633.0,2644327.0,,,19691852.0,,,,,36523386.0,38783844.0,222843.0,,6.0,,322534.0,,,592188804.0,,5564385.0,,24128308.0,,,,24339.0,626626882.0,,,,,76766974.0,,,,118845.0,18065.0,12223074.0,73435654.0,,,90869975.0,,,,24240688.0,,,,,,,,,,HOUSTON,10955093.0,,18817792.0,,,,2285469.0,,,,,4512204.0,,,,82721.0,,8490219.0,,,368940732.0,,,,,11646462.0,28246103.0,10637766.0,,6805.79,100720227.0,,338573.0,,553.0,,,,,20043181.0,,,59665864.0,,313070.0,18529478.0,,,,,163995.0,198139611.0,,,,,,5051246.0,,3131276.0,76973574.0,15471.0,3790136.0,,,,18817792.0,868533.0,,,1147603.0,5551817.0,,,,13619.0,,,50738837.0,831478.0,,14458631.0,,5033.0,,-5051.0,2707922.0,,,,,,,188147.0,1612177159.0,,,,,,,,,2738233.0,,,,49619561.0,4657.0,130590128.0,,,,1502.0,,11007.0,,14907183.0,,,,,,,,291010.0,,1670.0,,,,,,25613551.0,,,,,7746.0,84311632.0,,,,,,,,,,,17615024.0,28312081.0,20131109.0,114147041.0,,185700036.0,,8370851.0,,,,1902721.0,,,,,39191749.0,,,,18923.0,,,,,,,,6270933.0,,,,,,,31.25,76973574.0,,,,,,5964450.0,,,,,5899297.0,,12223074.0,10333206.0,,,,,,1951425.0,,53688133.0,,,,578047.0,,,,163995.0,,1.0,,13190668.0,1422812.0,11879019.0,18575.0,Y,,64180463.0,,1027883.0,,,,793667.0,,,,,,,,,3743.0,,49.07,,,,,,,,,59500692.0,,,,,24884803.0,,Y,3895.0,,,1.0,,395268.0,10116.0,5132322.0,,,17231721.0,-5479965.0,9240.0,1800731.0,-3300.0,,,,,-328244132.0,,,,,270.57,37728.0,,,2501.0,,4787968.0,,,,1061605.0,152560095.0,,,,,,26225230.0,,,83839757.0,,195879646.0,1186.0,,539339104.0,,2666691.0,,,,,,,,1003713.0,,,,,62434880.0,,,10647148.0,17395.0,17249.0,,2366.0,,2890138.0,139554.0,12964429.0,,,1326307.0,,,,,-11300331.0,,,41914112.0,,21140548.0,,,624730.0,,,,,,,,,,13616790.0,,,,,,,465278.0,,,3847178.0,,,,,,,3601037438.0,1143335.0,1244753.0,,,12646.0,,,,,,,,,,,,,24.03,,,3320839.0,,578047.0,48539.0,601432.0,,11077835.0,,,,,,,,,,,,,,,,10860765.0,,131396388.0,,107021222.0,,8590566.0,,,,,2571081.0,1635 NORTH LOOP WEST,16510712.0,,280432.0,42521.0,,27321693.0,,1351564.0,118862877.0,,812185.0,,,591404587.0,,,302325529.0,2019,Acute Care Hospitals,MEMORIAL HERMANN  HOSPITAL SYS (450184)
63418,MEMORIAL HERMANN  HOSPITAL SYS (450184),General Short Term (Acute Care Hospitals),Voluntary Nonprofit-Other,-95.430899,29.812266,,,3920336.0,,,,,15393740.0,,,,,,454108996.0,2101610.0,,18454574.0,,527987428.0,19387431.0,,,Y,,1610616186.0,,,,2534393.0,,,,,,,,,1898674.0,,,7520541.0,,5100682.0,,,346.0,,2950705.0,,8233043.0,,,,,,,,4622446.0,,,,126.0,,122134749.0,,,,68467679.0,,3111395.0,,28012481.0,,,,,,,,,,,,3910870.24,29319296.0,,26612.0,,,,,,,391866.0,,11688.0,,5091893.0,,,138263650.0,,1010392.0,,,,,2.0,,,,,,,,4358508.0,,,,912445404.0,,21080.0,,,53369374.0,,,,,,202854.0,,349295781.0,,,,,2318.0,,,,,,662250.0,,38347.0,27957122.0,,,1627333381.0,,,810220.0,,,124991080.0,467.0,,,12584.0,,61427728.0,,1636903.0,,,,,,,,,,,,,10977.0,4151290.0,,12671073.0,12197571.0,,,,,,,241374656.0,,,38727455.0,2568432.0,,116012378.0,,,,,,,116438.0,,106825330.0,,,874177.0,,,792794.0,1244787.0,,,322091.0,,,708088560.0,,87638258.0,HOUSTON,,4116737199.0,N,,124507760.0,93.0,,-167880.0,,29487845.0,1162392.0,14338413.85,,,646169.0,-17899.0,169.0,,,,7.0,71747527.0,1989127.0,,26035652.0,,0.202183,,,,,,2750.0,487853.0,142574.0,,,1628530.0,04011,,,,,126443.0,,,14615983.0,2507229.0,,,,,,,1471273.0,,,41711064.0,,,,,,,,10304346.0,1674483619.0,19072710.0,1645849262.0,,,2020-07-01 00:00:00,,,5091893.0,,,457741,3964680.0,1394362.0,,,,,,,,,,,,11457724.0,,,,310691675.0,,N,19753917.0,,657381845.0,741023.0,,,,,5122405.0,,,,2,,1674483619.0,,148978.0,,,,54993.0,36146.0,26877500.0,,,,,,,,,,,,,,5936595.0,49577.0,31819.0,6191573581.0,,,,,5100682.0,,,8490457.0,,,,,,,,2878034.0,,78672276.0,27880701.0,,,792794.0,,748341.0,,,19663786.0,1074700.0,417466.0,,,MEMORIAL HERMANN HOSP SYS- REHAB,632100.0,,,196448605.0,,-8188672.0,,,,15590543.0,,,11457724.0,61355679.0,2104678.0,,,,,,20143185.0,,,,,,,31754653.0,,,,62717164.0,,-127797957.0,77532064.0,,,11425565.0,,107537233.0,,226734.0,1955188.0,,23312708.0,,8808029.0,,,,,4597996.0,,,,,4774258.0,144024859.0,4394061.0,79731422.0,,,,,,,,,,,,,13419490.0,,,,,,,,,11929568.0,34926302.0,,,2099174.0,,N,,,,1520698.0,,,,,14726338.0,,20563627.0,,,,,,6.0,23.18,2552777.0,,,,,,,,,2024-03-15 00:00:00,,,,,,,,51210.0,,7467076.0,,,,687598.0,,,42809310.0,,,,631.0,,,601577578.0,-57498691.0,,,,,853188.0,82398207.0,43266.0,1.0,26645.0,,4209818.0,,19425097.0,,,,,2249727.0,428978.0,580014564.0,,233574.0,,,,,-70550891.0,37.04,,62279609.0,468.0,,,42809310.0,,,,,,,1257775.0,,,45T184,,,,,,173.0,,,,,,42.52,29319296.0,,,,47.66,,,,61427728.0,,,,,44533245.0,,100216.0,,113804633.0,,310691675.0,,,,,18200653.0,,15196301.0,,121013.0,,94122552.0,,,,,2.0,42530610.0,,,,929 GESSNER ROAD SUITE 2600,,,18678.0,174850.0,,140210244.0,,,4193092.0,,142947214.0,,,,,,473.0,,8237444.0,,,,,,,,,,56.97,,577.0,96103.0,,,22.7,,,,,,,36239.0,,,,,,,,632100.0,,34691564.0,774428.0,,,480927447.0,,,,20322938.0,,277990.0,742635.0,47894981.0,,,56713.0,,,,72068235.0,MEMORIAL HERMANN  HOSPITAL SYS,23242035.0,14093093.0,,,,,495890816.0,,,,,163506536.0,,,11412.0,,,19753917.0,29273970.0,-2812120.0,,,9300677.0,,44828948.0,,28682855.0,,,,,,,6221594.0,55941074.0,,,,,18321.0,,,,,106825330.0,,,,,904274.0,35557.0,693983.0,,14226118.0,1328974.0,20465479.0,,,,,,310691675.0,,,,,,,,,,,,,147598908.0,,44828948.0,,1118145.0,1354887.0,40045872.0,94716.0,,25855941.0,8447376.0,,,,5936926.0,,,,,3847380.0,,,7401144.0,15222675.0,,,,,,,,,,10287.0,,12433117.0,55941074.0,26689378.0,,,,147598908.0,,,,3731951.0,,2163105.0,5779.0,12420717.0,2226514.0,11920127435.0,,53369392.0,163614188.0,144.0,916135.0,,,,42657060.0,95.61,,,,,28.0,,,1628829.0,,,,,69636.0,786010.0,166842967.0,4151290.0,,,,,115338480.0,40234384.0,,,,,10089030.0,,,361788.0,15750671.09,50.91,-441532.0,,,,1414.0,,27775511.0,,,,280953072.0,,7015984.0,,44124461.0,,,,36239.0,450184,,11682728.0,,,,47304365.0,,,,,,,,,,,,5289904.0,95937.0,,,,,,,52491943.0,,,583138715.0,,,2251960.0,13772.0,,,,,462518.0,,,,75463.0,,20375.0,,34827041.0,77024,,,,,13419490.0,,,53864.0,897.0,,,,,,,,,15545.0,,,238644.0,,,,,,2215.0,3991155.0,,,,2063.0,271771367.0,,582845233.0,,,41532131.0,,45214.0,1404434.0,,,45500.0,,,66161.0,125021.0,632072.0,-3238468.0,45,4679649.0,101344437.0,56.97,74.0,,39.99,192248.0,,,,27568568.0,14976243.09,,3729837.0,,,,,3329162.0,,36590931.0,N,,,,1610616186.0,30272.0,,,,1046076.0,,,N,425.0,766345,997.0,2335301.0,,,,,289066.0,,,,948478653.0,,,,,,,,4804.0,,,68270568.0,390915.0,,3838533.0,1069330.0,,,,,8447376.0,17914938.27,,,,,,924656724.0,,,,,,,,,,,,,757212.0,,-566501.0,,395925.0,,,,,,,,3218.0,4596126.0,33094373.0,,,,2596.0,45610,,,,12187429.0,,1754788.0,,,,3581.0,,,,3792.0,40104283.0,,,,3647.0,,,,,,,,,,,,39887.0,,317965510.0,55364988.0,,18776959.0,1463906.0,,,,44731.0,,,,,580875.0,,40045872.0,144024859.0,,,,601145327.0,72068235.0,,1776.0,12420717.0,79355998.0,62717164.0,,10136.0,24774000.0,,,561370161.0,23935618.0,,,,,,22832738.0,,65447875.0,135511369.0,,,,,809238105.0,,6053108.0,,,,,,,,,3849402933.0,3438437.0,195912.0,2251960.0,,2101610.0,,,,,417466.0,26420,,,,,,,92883431.0,,47304365.0,,TX,,5779.0,,,,,,,,,,19779866.0,3111395.0,21490.0,1421509.0,-37919.0,,,1992322.0,55874.0,,,,27146766.0,5898736.0,55874.0,,,,,,,,76751454.0,,,16923322.0,23093471.0,,,,3199802.0,,,7382492.0,,,,,3922726.0,103231.0,3360,,,,,,5678548.0,,,,,,,1377257799.0,,,1898314.0,,509.0,,,,209010424.0,,,7520541.0,,,,12970710.0,29273970.0,,,,,,,6766284.0,,,56713.0,,10089030.0,,,774428.0,,15222675.0,,,8525633.0,,,,,,,6467354.0,,,,,,859904.0,178147036.0,,,,,288354.0,,19922982.0,13006887.0,,,,,,29262342.0,5261267.0,,,202978176.0,,,,,,,29262342.0,40.67,269082.0,,,37.04,,38.57,,,34827041.0,,,,351959.0,40.14,,,,,,,5602379.0,,,,,,,,,,357062.0,,,22784851.0,346820.0,8287.0,,,,147180.0,,,,,,,,,,1402671.0,,,,180723546.0,,,,,,,,,1117.0,,,-999558.0,32315967.0,,,,912013153.0,,353185.0,,6019478.0,,,N,,,,,68793191.0,,,,,-9872687.0,9820.0,,,,,,19779866.0,7666724.0,,,,,,,,,,,,,,,,,,52171093.0,,163614188.0,742.0,2249727.0,,,71940.0,,,22880438.0,,,122162770.0,,,,165184.0,,,94731783.0,,18200653.0,,,,,155480.0,8.0,,,,N,,,11871.0,7019.0,,,51330432.0,,7079.0,4646593.0,,366830.0,75.0,671.0,,,15945.0,,,11588999.0,,29487845.0,,81505.0,,35233076.0,9.0,,,Y,1.0,,,,,,2144.0,,190456125.0,,,,1231334.0,,27211774.0,,12616.0,,73.0,277990.0,16189.0,,,27456087.0,,,N,,,,,,,,,,743491.0,,,,,,150852863.0,18349965.0,,,10201919.0,-18.0,,,,1071.0,177.0,1328920.0,,,1463906.0,29104805.0,,,P,,390915.0,,2115020.0,,,,,,,,5936595.0,,9280589.0,,,,,,,1337582.0,40082178.0,,39.29,,38347.0,,,13292630.0,21327145.0,,,,,69076617.0,4025856.0,,3897.0,19749692.0,,1596750.0,54837.0,8646037.0,11412.0,,,,,3933541022.0,,,,,939626.0,,1373077.0,,874177.0,,,,147161.0,271771367.0,75463.0,,,3630895.0,4520837.0,,,489465.0,,,104781.0,,,,122068191.0,,,,,5678548.0,1652416.0,,,5108263.0,,,,,,,,16720842.0,F,,,,,,,,,,,,,1754788.0,44124461.0,99709261.0,,,27957122.0,,,,,,,,,,,,,,89653234.0,8985211.0,,,,,,,,,,,,,,,92986215.0,,,11707019.0,,12551334.0,527987428.0,203675.0,,4280563.0,,,,,12418309.0,3645306.0,,2908.0,1805.0,4021552.0,,,48.92,,2988168.0,,,1402671.0,,,963674954.0,,,,117428756.0,,,,,,,272565.0,,,28.0,19870447.0,129728.0,7966140132.0,,6997.0,,,,,,,,,,,,,,32.0,,,,,,4112183.0,,2950705.0,9928666.0,29068645.0,7104652.0,1284179.0,,,,,,11734575.0,71940.0,740421.0,,,,,,53730344.0,,2226514.0,,,,,55874.0,33600.0,,,,,,2980901.0,,,,,52138040.0,,,,,15120886.0,,407671985.0,,,152529.0,8564408.0,,,19.0,,2938695.18,116012378.0,167635740.0,,,,,,Y,3742873.0,,,,,,1614826004.0,280686770.0,,,,6602686.0,,,,,,,,4358508.0,,MEMORIAL HERMANN,Y,,,,,173.0,,,,,,6825819.0,,,,2383.0,839150.0,5204609.0,,,,18321.0,,,,,,,,,,53864.0,2006831.0,33148.0,,21.0,,,,11920756.0,,99709261.0,3217500.0,904250.0,5898736.0,,,,1456621.0,,,,3584704.0,,,,,N,-1502004.0,862064.0,,,,1138042.0,632100.0,2021-06-30,,,,,48640101.0,HO9956,,28012481.0,,,,,,,,,,649517828.0,23643.0,51430070.0,,,,820391657.0,,,157963.0,50307718.0,150.0,,,,52.3,,,133619.0,,306953.0,,,,,,,,22037561.0,,,,,2534393.0,64431.0,,,,,34926302.0,,,,,,28682855.0,11707019.0,,,,,,,7015984.0,,,,1115039039.0,11153552.0,,,166842967.0,9820.0,44389.0,138263650.0,,,,87638258.0,,,O,6978228.0,319386848.0,,,208136247.0,11091533.0,,,,,,,,94565.0,10287.0,8092435722.0,212.0,2386.0,,,737.0,,23643.0,TX,,16923322.0,,,1010749.0,,50307718.0,,14441763.0,18200653.0,81.0,,,,,,,,6815150.0,,,-1749835.0,12065.0,HARRIS,,,,,,,,,,2104678.0,-1137696.0,7030803.0,6019478.0,42809310.0,,260231.0,,,,,15545.0,,44828948.0,225794506.0,11540772.0,,22832738.0,,,23213.0,,-130542873.0,,,,,72116.0,,,,,,,,79731422.0,,674616.0,46612320.0,,,,,,,,,,,1394362.0,,,6825819.0,,-134064.0,1962.0,77008-,,,,,,,,377285.0,174678.0,,29163751.0,,,,,33148.0,,,298340.0,,,14114896.0,,-132154.0,,44731.0,,8534962.0,,,,,1697883965.0,,3346294.0,,,,5936547.0,,216517218.0,,,606.0,,1071.0,29446.0,,34496491.0,N,,,,,37255428.0,6.0,324972.0,,25385030.0,,,4506.0,,,,5471.0,,-70550891.0,,,7382492.0,4011269.0,,11929568.0,,,76.23,290881.24,,,3641.0,614308.0,,,,4131637.0,,1341.0,108042.0,,,,,,228561103.0,,,,,,,,,1965537.0,,,19.84,94731783.0,,12.0,111977638.0,,,3587449.0,,,,,,,,,,,,64605.0,,27568568.0,,,36590931.0,10542869636.0,,78728989.0,1239255.0,116764519.0,,,133845500.0,,,,,,125034654.0,,,14615983.0,,,,,,6542.46,,,,135511369.0,103964.0,General Short Term,,,7562656.0,,,1188251.0,,,82398207.0,,,10159944.0,,,33945.0,,,484920.0,2574926.0,,,19663786.0,,,,,40082178.0,54776698.0,228981.0,,,,366364.0,,,629828182.0,,14727047.0,,27146766.0,19.0,,,33053.0,565899668.0,,,,,85931632.0,,,,112048.0,23755.0,10090771.0,77532064.0,,,92986215.0,,,,24774000.0,,,,,,468.0,,,,HOUSTON,12197571.0,,19548563.0,,,,2308181.0,,,,,4198853.0,,,,26153.0,,8418670.0,,,391658547.0,,,,,13128818.0,29163751.0,11736716.0,,6895.74,112918209.0,,343741.0,,439.0,,,,,21327145.0,,,60819544.0,,181734.0,19367122.0,,,,-16116.0,147180.0,202165529.0,,,,,,4596126.0,,3268367.0,74455239.0,16738.0,3329162.0,,,,19548563.0,662250.0,,,1334297.0,5054265.0,,,,13656.0,,,50738837.0,851572.0,,15147191.0,,4741.0,,,2007141.0,,,,,,,195239.0,1900862141.0,,,,,,,,,2554752.0,,,,49193507.0,4322.0,140210244.0,,,,1186.0,,6506.0,,17555854.0,,,,,,,,345698.0,,2674.0,,,,,,27456087.0,,,,,6761.0,92883431.0,,,,,,,,,,,15397087.0,29068645.0,19870447.0,117428756.0,,11260495863.0,,9064429.0,,,,1655106.0,,,,,53466935.0,,,,16189.0,,,,,,,,6774729.0,,,,,,,33.59,74455239.0,,,,,26035652.0,5148853.0,,,,,5017509.0,34691564.0,10090771.0,9873821.0,,,,,,2163105.0,,51437270.0,,,,623577.0,,,,147180.0,,,,14116320.0,1355079.0,6602686.0,161243.0,Y,,61587242.0,,922497.0,,,,866720.0,,,,,,,,,6997.0,,56.77,,,,,,,,,69874680.0,,,,,26110634.0,,Y,2305.0,,,,,226145.0,8594.0,5054268.0,,,15739506.0,117490673.0,6738.33,1647574.0,-3800.0,,,,,10540643122.0,,,,,252.28,76869.0,,,2386.0,,4737186.0,,,,1232739.0,167635740.0,,,,,,26689378.0,,,122068191.0,,194016176.0,1224.0,,582845233.0,,1965537.0,,,,,,,,835573.0,,,,,62031336.0,,,14226118.0,,25130.0,,2071.0,,1894360.0,133619.0,14262667.0,,,1342844.0,,,,,-3393751.0,,,41711064.0,,23511295.0,,,614308.0,,,,,,,,,,12551334.0,,,,,,,520596.0,,,2746836.0,,,,,,,4158894700.0,996673.0,1010749.0,,,9165.0,,,,,,,,,,,,,23.96,,,4021552.0,,623577.0,47434.0,494920.0,,11682728.0,,,,,,,,,,,,,,,,9854052.0,,155160539.0,,102906161.0,,8055506.0,,,,,2985760.0,1635 NORTH LOOP WEST,12508646.0,,313547.0,12065.0,,30237338.0,,1871799.0,115338480.0,,934361.0,,,629534700.0,,,322903886.0,2020,Acute Care Hospitals,MEMORIAL HERMANN  HOSPITAL SYS (450184)
69214,MEMORIAL HERMANN  HOSPITAL SYS (450184),General Short Term (Acute Care Hospitals),Voluntary Nonprofit-Other,-95.430899,29.812266,,,4196715.0,,,,,12972812.0,,,,,,522650206.0,2280807.0,,16565421.0,,578504038.0,21952741.0,,,Y,,1800919181.0,,,,2528464.0,,,,,,,,,1360632.0,,,7459085.0,,7419390.0,,,2148.0,,3578073.0,,7443176.0,,,,,,,,5497092.0,,,,87.0,,121639749.0,,,,89957066.0,,3350743.0,,36037638.0,,,,,,,,,,,,3855685.86,184812407.0,,56187.0,,,,,,,448143.44,,18066.0,,5638744.0,,,192245594.0,,1165392.0,,,,,1.0,,,,,,,,4779716.0,,,,1084173182.0,13586.0,17332.0,,,57988159.0,,,,,,185988.0,,347195221.0,,,,,2826.0,,,,,,843416.0,3568.0,42122.0,28961457.0,,,1818557405.0,,,776650.0,,,140503568.0,441.0,,,20118.0,,65483283.0,,1694707.0,,,,,,,,,,,,,12134.0,4485919.0,,13847587.0,9415954.0,,,,,,,281574153.0,,,45486141.0,6598603.0,,120773751.0,,,,,,,133866.0,,107889787.0,,,792702.0,,,799560.0,1525223.0,,,320661.27,,,813164466.0,,89637844.0,HOUSTON,,4347825579.0,N,,130731843.0,93.0,,-89244.0,,29870752.0,1007062.0,14188876.57,36580.0,,794451.0,,620.0,,,,7.0,71455533.0,1956019.0,,2230284.0,,0.206193,,,,,,3183.0,1128531.0,101285.0,,,7354211.0,04011,,,,,172486.0,,,16996678.0,2131878.0,,,,,,,1331575.0,,,45000732.0,,,,3521.0,,,,9700943.0,1677767263.0,21413574.0,1844645131.0,,,2021-07-01 00:00:00,,,5638744.0,,,457741,3835251.0,1468283.0,,,,,,,,,,,,12382398.0,,,,363389448.0,,N,21929346.0,,712827337.0,840258.0,,,,,2633208.0,,,,1,,1677767263.0,,143602.0,,,,52317.0,40447.0,35314044.0,,,,,,,,,,,,,,6427335.0,32511.0,1869780.0,6862472901.0,,,,,7419390.0,,,9252492.0,,840752.0,,,,,,3349507.0,,89068524.0,27590793.0,,,799560.0,,980260.0,,,21159203.0,1104580.0,411174.0,3568.0,,MEMORIAL HERMANN HOSP SYS- REHAB,1349989.0,,,219233145.0,,-8237001.0,,,,15738422.0,,,12382398.0,65160223.0,2610511.0,,,,,,17671954.0,,,,,,,26299862.0,,,,54899290.0,,-137746807.0,90411998.0,,,11972196.0,,124204036.0,,202712.0,1969948.0,,22077667.0,,10264003.0,,,,,,,,,,10250595.0,156811389.0,4340918.0,84605481.0,,,,,,,,,,,,,13138932.0,,,,,,,,,14662710.0,35215793.0,,,,,N,,,,1588925.0,,,,,13545416.0,,22623229.0,,,,,,91.0,23.4,842219.0,,,,,,,,,2023-12-29 00:00:00,,,,,,,431.0,64020.0,,7503412.0,,,,726767.0,,,44895589.0,,,,711.0,,,637899593.0,-72576467.0,,,,,827509.0,90648878.0,46523.0,1.0,26645.0,,4382619.0,,20047834.0,,,,,1167935.0,326067.0,565899668.0,,314289.0,,,,,-62795954.0,37.01,,62096273.0,,,,44895589.0,,,,,,,1459829.0,,,45T184,,,,,,187.0,,,,,,45.44,184812407.0,,,,76.41,,,,65483283.0,,,,,57984625.0,,114182.0,,135055653.0,,363389448.0,,,,,19668475.0,,175664159.0,,129486.0,,94591222.0,,,,,3.0,44349897.0,,,,929 GESSNER ROAD SUITE 2600,,,11095.0,378771.0,,142801750.0,,,4856967.0,,141258986.0,,,,,,,,8984263.0,,,,,,,,,,58.64,,526.0,81449.0,,,25.31,,,,,,,63096.0,,,,,,,,1349989.0,,32644616.0,801090.64,,,514735416.0,,,,21440608.0,,271903.0,750387.0,52993088.0,,,67318.0,,,,67503528.0,MEMORIAL HERMANN  HOSPITAL SYS,29765645.0,16609327.0,,,,,539303930.0,,,,,184450098.0,,,10355.0,,,21929346.0,25383445.0,-2574688.0,,,10029142.0,,44742255.0,,29651574.0,,,,,,,6031103.0,53510804.0,,,,,19014.0,,,,,107889787.0,,,,,763315.0,37193.0,581851.0,,11056942.0,1386891.0,36950647.0,,,,,,363389448.0,,,,,,,,,,,,,181052372.0,,44742255.0,,1056399.0,1493737.0,39223657.0,133266.0,,40245879.0,10923489.0,7332247.0,,18620.0,5204204.0,,,,,5724268.0,,,7736794.0,17950098.0,,,,,,,,,,8016.0,,14004896.0,53510804.0,30595433.0,,,,181052372.0,,,,4263735.0,,2231732.0,5662.0,10939919.0,2226514.0,2256674927.0,,57988640.0,171253603.0,140.0,918970.0,,,,43499279.0,127.99,,,,,894298.0,,,1668850.0,,,,,,818296.0,289462200.0,4485919.0,,,,,108014252.0,42129826.0,,,,,11472913.0,,,405780.0,15627639.75,57.81,-250427.0,,,,1447.0,,27719785.0,,,,281152903.0,,8112296.0,,43724994.0,,,,63096.0,450184,,9895349.0,,,,51656082.0,,,,,,,,,,,,4524713.0,40619.0,,,,,,,48301962.0,,,617360127.0,,,1877047.0,14558.0,,,,,491977.0,,,,75203.0,,21228.0,,37296711.0,77024,,,,,13138932.0,,,50749.0,1112.0,,,,,,,,,14847.0,,,174315.0,,,,,,4777.0,4179556.0,,,,13371.0,187742486.0,,616856431.0,,,44643479.0,,22480.0,1285150.0,,,55613.0,,,57379.0,132165.62,455691.0,-2551124.0,45,5510606.0,117238294.0,58.64,433.0,,42.7,425774.0,,,,95992097.0,14826549.11,,3986880.0,17464.0,,,,2707389.0,,43151221.0,N,,,,1800919181.0,31086.0,,,,1037141.0,,,N,,760810,927.0,2608237.0,,,,,464986.0,,,,963674954.0,,,,,,,78961.0,1795.0,,,86306013.0,400040.0,,3665117.0,1076864.0,,,,287.0,10923489.0,18751373.29,,,,,,1119758685.0,,,,,,,,,,,,,495411.0,1800.0,-120568.0,,424560.39,,,,,,,,2807.0,4524714.0,33729548.0,,,,3193.0,45610,,,,10936001.0,,1634396.0,,,,3763.0,10314.0,,,3505.0,42657060.0,,,,7912.0,,,,,,,,,,,,34877.0,,396840094.0,58033611.0,,19169010.0,1619884.0,,,,42104.0,,,,,428627.0,,39223657.0,156811389.0,,,,637713172.0,67503528.0,,1579.0,10939919.0,86885929.0,54899290.0,,12092.0,27142661.0,,,593302954.0,18215517.0,,,,,,21715186.0,,77993994.0,155853988.0,,,,,830550031.0,,6690402.0,,,,,,,,,4386330220.0,2941063.0,188595.0,1877047.0,,2280807.0,,,,,411174.0,26420,,,,,,,98398040.0,,51656082.0,,TX,,5662.0,,,,,,,,,,20443562.0,3350743.0,6926.0,1379266.0,-5466.0,,,1849101.0,49363.0,,,,30541372.0,6812877.0,49363.0,,,,,,,,85326643.0,,,17625776.0,25000999.0,,,,3465956.0,,,7466251.0,,,,,5396415.0,624931.0,3360,,,,,,5124480.0,,,,,,,952762324.0,,,1863880.0,,701.0,,-247609.0,,226275313.0,,,7459085.0,,,,14274688.0,25383445.0,3.0,,,,,,7500678.0,,,67318.0,,11472913.0,,,801090.64,,17950098.0,,,9042932.0,,,,,,,6899534.0,,,,,,941549.0,184537757.0,,,,,749978.56,,20630589.0,15820767.0,17464.0,,,,,32835233.0,5512275.0,371.0,,124802728.0,,,,,,,32835233.0,43.51,335349.0,,,37.01,,44.94,,,37296711.0,,,,580933.0,43.01,,,,,,,10112508.0,,,,,,,,,,5725474.0,1.0,,23829577.0,250381.0,14747.0,,,,309299.0,,,,,,,,,,1558318.0,,,,176795012.0,,,,,,,,,918.0,,,-2019518.0,34301341.0,,,,1083986761.0,,426470.0,,6076108.0,,,N,,,,,62939758.0,,,,,-5694959.0,10451.0,,,,,,20443562.0,7534696.0,,,,,,,,,,,,,,,,,,57054835.0,,171253603.0,1088.0,1167935.0,,,63041.0,,,24030986.0,,,135738412.0,,,,226886.0,,,92494672.0,,19668475.0,,,,,105832.0,8.0,,,,N,,,24070.0,10258.0,,,55973888.0,,5258.0,4114801.0,,461366.0,418.0,856.0,,,19238.0,,,12444028.0,,29870752.0,,97315.0,,43725950.0,5.0,,,Y,1.0,,,,,,6280.0,,211411397.0,,,,960409.0,,27918989.0,,13890.0,,73.0,271903.0,17468.0,,,35287599.0,,,N,,,,,,,,,,3406988.0,,,,,,173282492.0,18328306.0,,1.0,10710481.0,-481.0,,,,1096.0,185.0,1263789.0,,,1619884.0,31770152.0,,,P,,400040.0,,8182569.0,,,,,,,,6427335.0,,8359391.0,,,,,,,1306534.0,42341824.0,,40.25,,42122.0,,,11330518.0,22336596.0,,,,,83093291.0,4744476.0,,4332.0,22358521.0,,1957338.0,39437.0,7215717.0,10355.0,,,,,4478753241.0,,,,,703837.0,,1340078.0,,811336.0,,,,104333.0,187742486.0,75203.0,,,4289397.0,5221541.0,,,501510.0,,,107330.0,,,,139772942.0,,,,,5124480.0,1542075.0,,,4572091.0,,,,,,,,20275444.0,F,,,,,,,,,,,,,1634396.0,43724994.0,92642165.0,,,28961457.0,,,,,,,,,,,,,,100263677.0,9195841.0,,,,,,,,,,,,,,,94488482.0,,,12573386.0,,17084260.0,578504038.0,196165.0,16.0,7967255.0,,,,,12668553.0,4164635.0,,2633.0,2126.0,8355348.0,,,49.71,,3164956.0,,,1558318.0,,,1139339113.0,,,,131663476.0,,,,,,,273831.95,,,455.0,22607997.0,135657.0,8734155799.0,,8743.0,,,,,183336.0,,,,,,,,,92.0,,,,,,4300919.0,,3578073.0,10843846.0,35986658.0,5656314.0,1589777.0,,,,,,11012707.0,63041.0,686591.0,,,,,,45214632.0,,2226514.0,,,,,49363.0,36812.0,,,,,,3124546.0,,,,,57027750.0,,,,,17301669.0,,431346673.0,,,,9538190.0,,,204966.0,,3924824.18,120773751.0,179608951.0,,,,,,Y,3089621.0,,,,,,1805301800.0,293700578.0,,,,6928234.0,,,,,,,,4779716.0,,MEMORIAL HERMANN,Y,2.0,1815.0,,,190.0,,,,,,7967868.0,144972.0,,,2685.0,798780.0,5540751.0,,,,19014.0,,,,,,,,,,50749.0,2511914.0,7513.0,,128.0,3096.0,,,2046948.0,,92642165.0,3368278.0,1202840.0,6812877.0,,,,1346757.0,,,,3899878.0,,,,,N,,8818325.0,,,,1404582.0,1349989.0,2022-06-30,,,,,41493723.0,HO9956,,36037638.0,,,,,,,,,,704585176.0,76380.0,56214577.0,,,,844971373.0,,,,60243475.0,156.23,,,,60.7,,,89010.0,,403723.0,,,,,,,,24115362.0,,,,,2528464.0,231412.0,,,,,35215793.0,,,,,,29651574.0,12573386.0,,,,,,,8112296.0,,,,1264496928.0,14421342.0,,,289462200.0,10451.0,52924.0,192245594.0,,,,89637844.0,,,O,10666255.0,331813064.0,,,225463977.0,11202236.0,,,,,,,,118059.0,8016.0,8868628667.0,186.0,2540.0,,,1048.0,,76380.0,TX,,17625776.0,,,1224509.0,,60243475.0,,15814108.0,19668475.0,59.0,,,,,,,,7232803.0,,,-997326.0,12019.0,HARRIS,,,,,,,,,,2610511.0,-925576.0,6689201.0,6076108.0,44895589.0,,291394.0,,,,,14847.0,,44742255.0,204253182.0,,,21715186.0,,,23622.0,,-86524624.0,,,,,,,,,,,,,84605481.0,,738009.0,34691564.0,,,,,,,,,,,1468283.0,,,7967868.0,,-122605.0,1050.0,77008-,,,,,,,,348218.0,223375.0,,27665569.0,,,,,7513.0,,,252074.0,,,,,,,42104.0,,8564408.0,,,,,1881353038.0,,3061493.0,,,,6518965.0,,233523867.0,,,220.0,,1096.0,973782.0,,32001905.0,N,,,,,39802297.0,6.0,396149.3,,19739622.0,,,4950.0,,,,4524.0,,-62795954.0,,,7466251.0,3590242.0,,14662710.0,,,68.52,273776.88,,,3868.0,588055.0,,,,7019913.0,,1374.0,145696.0,,,,,,235833876.0,,,,,,,,,2324742.0,,,21.3,92494672.0,,8.0,105716948.0,,,4016349.0,,,,,,,,,,,,67525.0,,95992097.0,,,43151221.0,1303912603.0,,89135842.0,1250843.0,127725701.0,,,141144102.0,,,,,,135405456.0,,,16996678.0,,,,287.0,,6458.35,,,,155853988.0,102990.0,General Short Term,,,7960524.0,,,952621.0,,,90648878.0,,,10190418.0,,,33945.0,,,1040690.0,2765763.0,,,21159203.0,,,,,42341824.0,57867712.0,231750.0,,,,359134.0,,,667364746.0,,39918227.0,,30541372.0,317.0,,,27085.0,605876531.0,,,,,109379676.0,,,,100687.0,11700.0,8198340.0,90411998.0,,,94488482.0,,,,27142661.0,,,,,,,,,,HOUSTON,9415954.0,,21544806.0,,,,2037265.0,,,,,4508246.0,,,,183451.0,,9220505.0,,,435595015.0,,,,,13816427.0,27665569.0,17130698.0,,6824.19,123018043.0,,303982.0,,137.0,,,,,22336596.0,,,63857030.0,,162243.0,21106070.0,,,,,309299.0,179517911.0,,,,,,4524714.0,,3566050.0,80403078.0,17689.0,2707389.0,,,,21544806.0,843416.0,,,1413875.0,4805325.0,,,268.0,9436.0,,,62279609.0,428736.0,,17036126.0,,,,-399.0,,,,,,,,179630.0,2006155766.0,,,,,,,6876.0,,1965835.0,2108240.0,,,49970320.0,4300.0,142801750.0,,,,1102.0,,7120.0,,16068132.0,,,,,,,,229509.0,,1691.0,,,,,,35287599.0,,,,,10100.0,98398040.0,,,,,,,,,,,18039440.0,35986658.0,22607997.0,131663476.0,,1542679655.0,,10479934.0,,,,1608947.0,,198671.0,,,52368981.0,,,172.0,17468.0,,,,,,,,7186290.0,,,,,,,34.11,80403078.0,,,,,2230284.0,4602169.0,,,,,4120237.0,32644616.0,8198340.0,11510271.0,,,,,,2231732.0,,55028035.0,,,,633295.0,,,,309299.0,,1.0,,15373271.0,1568375.0,6928234.0,197571.0,Y,,65606312.0,,953069.0,,,,1059950.0,,,,,,,,,8743.0,,73.75,,,,,,,,,81985230.0,,,,,29285510.0,,Y,2247.0,,,,,381157.0,11949.0,5531922.0,,,16168652.0,96305137.0,7837.8,1588706.0,-4275.0,,,,,1301686089.0,,,,,266.37,74787.0,,,2540.0,,4508892.0,,,,1265678.0,179608951.0,,,,,,30595433.0,,,139772942.0,,188125530.0,879.0,,616856431.0,,2324742.0,,,,,,,,956671.0,,,,,62499685.0,,,11056942.0,,56962.0,,2268.0,,1477553.0,89010.0,15895471.0,,,1537062.0,,,,,-9612588.0,,,45000732.0,,41378784.0,,,588055.0,,,,,,,,,,17084260.0,,,,,,,546220.0,,,4345503.0,,,,,,,4389875426.0,1117106.0,1224509.0,,18634.0,9493.0,,,,,,,,,,,,,24.59,,,8355348.0,,633295.0,45561.0,539186.0,,9895349.0,,,,,,,,,366.0,,,,,,,8967816.0,,187258554.0,,113292994.0,,8753591.0,,,,,1614546.0,1635 NORTH LOOP WEST,13114476.0,,309096.0,12019.0,,27855212.0,,1088884.0,108014252.0,,758888.01,,,666861050.0,,,350016105.0,2021,Acute Care Hospitals,MEMORIAL HERMANN  HOSPITAL SYS (450184)
74958,MEMORIAL HERMANN  HOSPITAL SYS (450184),General Short Term (Acute Care Hospitals),Voluntary Nonprofit-Other,-95.430899,29.812266,,,4291349.0,,,,,13780729.0,,,,,,578143447.0,2264381.0,,17315482.0,,604565722.0,25704488.0,,,Y,,1893782089.0,,,,2870943.0,,,,,,,,,1005485.0,,,8205158.0,,8637369.0,,,1144.0,,4158737.0,,7506379.0,,,,27748.0,,,,6970776.0,,,,,,131903181.0,,442.38,,90581984.0,,3465984.0,,40306243.0,,,,,,,,,,,,3574454.7,115404491.0,,30245.0,,,,,,,477170.26,,23937.0,,5870513.0,,,198521544.0,,1564848.0,,,,,3.0,,,,,,,,5528139.0,,,,1062231745.0,367.0,18881.0,,,59617644.0,,,,,,199762.0,,333828046.0,,,,,582.0,,,,,,851589.0,5552.0,38924.0,18860696.0,,,1911923927.0,,,737142.0,,,155084406.0,440.0,,,15071.0,,71477016.0,,1639383.0,,,,,,,,,,,,,13867.0,4562635.0,,12436199.0,9433120.0,,,,,,,317263095.0,,,58344645.0,58656570.0,,132877112.0,,,,,,,188612.0,,109767372.0,,,809929.0,,,631986.0,1726959.0,,,327856.91,,,995708212.0,,104070136.0,HOUSTON,,4861117409.0,N,,165944256.0,93.0,,-87657.0,,26098127.0,800153.0,14892604.62,53314.0,,1088766.0,,368.0,,,,7.0,70493946.0,2075900.0,,1651162.0,,0.195081,,,,,,2069.0,2009298.0,78042.0,,,7666044.0,04011,,,,,142319.0,,,15950355.0,2030205.0,,,,,,,1563580.0,,,47558315.0,,,,90.0,,,,10280574.0,1860349386.0,27561537.0,1930791290.0,,,2022-07-01 00:00:00,,,,,,457741,3417654.0,1850745.0,,,,,,,,,,,,14941618.0,,,,383202142.0,,N,22053723.0,,717904781.0,906881.0,,,,,2515722.0,,,,1,,1860349386.0,,179586.0,,,,60685.0,38344.0,42745619.0,,,,,,,,,,,,,,6731352.0,43764.0,2354423.0,7716254252.0,,,,,8637369.0,,,9287384.0,,15054.0,,,,,,4215513.0,,89422987.0,12648358.0,,,631986.0,,1044639.0,,,23221354.0,1307080.0,419645.0,5552.0,,MEMORIAL HERMANN HOSP SYS- REHAB,371314.0,,,209934647.0,,-5639919.0,,,,18389739.0,,,14941618.0,67196040.0,3094787.0,,,,,,19445048.0,,,,,,,27802061.0,,,,57211358.0,,-172084558.0,,,,12664311.0,,141384453.0,,274148.0,2138047.0,,22583953.0,,7820834.0,,,,,,,,,,8477247.0,173183355.0,2628873.0,91290528.0,,,,,2.0,,,,,,,,13753637.0,,,,,,,,,16689813.0,49126582.0,,,,,N,,,,2179974.0,,,,,14323971.0,,34154397.0,,,,,,322.0,24.74,,,,,,,,,,2023-12-13 00:00:00,,,,,,,11.0,-6273924.0,,8110018.0,,,,812160.0,,,53888963.0,,,,507.0,,,667560347.0,-64594437.0,,,,,868331.0,93167968.0,48352.0,1.0,26645.0,,4572325.0,,8638091.0,,,,,4064803.0,296604.0,573231915.0,,446019.0,,,,,-77475400.0,42.76,,62096273.0,,,,53888963.0,,,,,,,914996.0,,,45T184,,,,,,260.0,,,,,,48.8,115404491.0,,,,41.83,,,,71477016.0,,,,,31659544.0,,196894.0,,163295673.0,,383202142.0,,,,,20913385.0,,48996247.0,,70248.0,,62941540.0,,,,,5.0,50608676.0,,,,929 GESSNER ROAD SUITE 2600,,,54012.0,251062.0,,165866398.0,,,5330908.0,,130379567.0,,,,,,,,9575618.0,,,,,,,,,,58.51,,498.0,74985.0,,,22.01,,,,,,,68741.0,,,,,,,,371314.0,,32142242.0,454381.7,,,590145397.0,,,,24537988.0,,289055.0,785668.0,59539922.0,,,67824.0,,,,72341080.0,MEMORIAL HERMANN  HOSPITAL SYS,38375061.0,16387630.0,,,,,631829422.0,,,,,205850934.0,,,10966.0,,,22053723.0,23824840.0,-2716008.0,,,10024526.0,,50181173.0,,19431145.0,,,,,,,6232745.0,55457191.0,,,,,19284.0,,,,,109767372.0,,,,,736856.0,30901.0,688243.0,,11704595.0,1774755.0,158094553.0,,,,,,383202142.0,,,,,,,,,,,,,190266439.0,,50181173.0,,947658.0,1503487.0,44106985.0,81045.0,,20870228.0,12740158.0,66408244.0,,509.0,5419885.0,,,,,6339762.0,,,8364508.0,20868437.0,,,,,,,,,,8050.0,,37473940.0,55457191.0,31740575.0,,,,190266439.0,,,,4629941.0,,2373572.0,5789.0,12199652.0,2226514.0,1183840897.0,,59618014.0,166713529.0,416.0,919852.0,,,,42350491.0,94.07,,,,,18016.0,,,1886740.0,,,,,,1039646.0,221488043.0,4562635.0,,,,,122618967.0,,,,,,13218541.0,,,167903.0,15949808.61,56.08,-226352.0,,,,1490.0,,34624211.0,,,,287225336.0,,9346715.0,,19241906.0,,,,68741.0,450184,,15103586.0,,,,60814151.0,,,,,,,,,,,,6830589.0,27273.0,,,,,,,59161833.0,,,669005088.0,,,3531385.0,18189.0,,,,,510765.0,,,,81575.0,,13852.0,,36616487.0,77024,,,,,13753637.0,,,44353.0,2072.0,,,,,,,,,16924.0,,,144850.0,,,,,,1443.0,5474602.0,,,,17186.0,183598453.0,,661311219.0,,,47591942.0,,52539.0,1292069.0,,,52620.0,,,60123.0,132197.14,353298.0,-424499.0,45,5900608.0,120523270.0,58.51,535.0,,43.52,350623.0,,,,21728868.0,15495426.91,,6541061.0,3786.0,,,,2508291.0,,48885164.0,N,,,,1893782089.0,34181.0,,,,1097829.0,,,N,,758011,813.0,3083049.0,,,,,541854.0,,,,1139339113.0,,,,,,,115267.0,1946.0,,,106563785.0,411355.0,,2712952.0,1417615.0,,,,,12740158.0,19067235.16,,,,,,1272751682.0,,,,,,,,,,,,,473652.0,44.0,,,453552.05,,,,,,,,2099.0,5459854.0,,,,,,45610,,,,10969317.0,,2226014.0,,,,4759.0,268.0,,,2567.0,43499279.0,,,,3575.0,,,,,,,,,,,,32267.0,,476333957.0,62366270.0,,22140440.0,1676791.0,,,,58938.0,,,,,323995.0,,44106985.0,173183355.0,,,,674683767.0,72341080.0,,1596.0,12199652.0,21823598.0,57211358.0,,2449.0,1302371.0,,,662851475.0,23930367.0,,,,,,25235653.0,,85747916.0,156892390.0,,,,,854586194.0,,7487514.0,,,,,,,,,4846531276.0,4439882.0,200791.0,3531385.0,,2264381.0,,,,,419645.0,26420,,,,,,,115894569.0,,60814151.0,,TX,,5789.0,,,,,,,,,,23850355.0,3465984.0,7893.0,1159849.0,,,,1757587.0,52073.0,,,,30430020.0,6492529.0,52073.0,,,,,,,,90957164.0,,,20423604.0,27306955.0,,,,3683206.0,,,8070841.0,,,,,5863776.0,557946.0,3360,,,,,,5420627.0,,,,,,,1136360777.0,,,2117255.0,,83.0,,,,219274286.0,,,8205158.0,,,,14307433.0,23824840.0,4.0,,,,,,7153583.0,,,67824.0,,13218541.0,,,454381.7,,20868437.0,,,9732527.0,,,,,,,8361523.0,,,,,,1105675.0,169167342.0,,,,,230977.38,,25095702.0,15173242.0,3786.0,,,,,35198638.0,5916920.0,427.0,,155778077.0,,,,,,,35198638.0,44.92,492529.0,,,42.76,,36.58,,,36616487.0,,,,649602.0,43.54,,,,,,,16968281.0,,,,,,,,,,4179311.0,,,25495431.0,177476.0,16325.0,,,,86269.0,,,,,,,,,,1632380.0,,,,194775397.0,,,,,,,,,939.0,,,-1910231.0,46705622.0,,,,1069355165.0,,381925.0,,3974843.0,,,N,,,,,27820376.0,,,,,-5344772.0,10244.0,,,,,,23850355.0,6555816.0,,,,,,,,,,,,,,,,,,58227180.0,,166713529.0,1863.0,4064803.0,,,65912.0,,,27138886.0,24.0,,174957691.0,,,,218960.0,,,109382723.0,,20913385.0,,,,,191991.0,10.0,,,,N,,,6966.0,9354.0,,,56071231.0,,5767.0,4846090.0,,375011.0,525.0,998.0,,,36386.0,,,15033135.0,,26098127.0,,135731.0,,37009201.0,5.0,,,Y,1.0,,,,,,6357.0,,232848632.0,,,,1415838.0,,29300115.0,,17805.0,,73.0,289055.0,19128.0,,,44092412.0,,,N,,,,,,,,,1148788.0,3545709.0,,,,,,130744021.0,25588858.0,,,11728083.0,-370.0,,,,1127.0,197.0,1672924.0,,,1676791.0,35798713.0,,,P,,411355.0,,12498738.0,,,,,,,,6731352.0,,9010949.0,,,,,,,1305086.0,49146265.0,,43.99,,38924.0,,,12793793.0,28229325.0,,,,,67801325.0,5124647.0,,3960.0,25006959.0,,2196226.0,100555.0,7947703.0,10966.0,,,,,4951928061.0,,,,,641276.0,,3629617.0,,964293.0,,,,81186.0,183598453.0,81575.0,,,4686308.0,5075261.0,,,517205.0,,,121345.0,,3.0,,124430511.0,,,,,5420627.0,1567974.0,,,5123583.0,,,,,,,,23882499.0,F,,,,,,,,,,,,,2226014.0,19241906.0,103608545.0,,,18860696.0,,,,,,,,,,,,,,131970755.0,18811440.0,,,,,,,,,,,,,,,97957567.0,,,13395175.0,,16188266.0,604565722.0,171584.0,,5644183.0,,,,,14988835.0,3949628.0,,1384.0,274.0,9584014.0,,,51.55,,3318510.0,,,1632380.0,,,1188335360.0,,,,153908967.0,,,,,,,308033.99,,,1609.0,23842587.0,193175.0,9707648685.0,,,,,,,,,,,,,-522822.0,,,45.0,,,,,,4703757.0,,4158737.0,11963187.0,39266969.0,5856665.0,1764231.0,,,,,,12243773.0,65912.0,927965.0,,,,,,49104886.0,,2226514.0,,,,,52073.0,32984.0,,,,,,3481279.0,,,,,58201806.0,,,,,20315650.0,,648430602.0,,,,9538190.0,,,5083.0,,3571808.25,132877112.0,176297543.0,,,,64.32,,Y,2629658.0,,,,,,1898354414.0,331484715.0,,,,5220781.0,,,,,,,,5528139.0,,MEMORIAL HERMANN,Y,,291.0,,,264.0,,,,,,9200141.0,1192360.0,,,3605.0,873080.0,5656741.0,,,,19284.0,,,,,,,,,,44353.0,2983881.0,40613.0,,145.0,74.0,,,502374.0,,103608545.0,3519366.0,266205.0,6492529.0,,,,1285001.0,,,,4027160.0,,,,,N,,12895941.0,,,,1268869.0,371314.0,2023-06-30,,,,,42861305.0,HO9956,,40306243.0,,,,,,,,,,738832202.0,81107.0,57320299.0,,,,877068608.0,,,,25658112.0,150.0,,,,59.57,,,138232.0,,287895.0,,,,,,,,21275235.0,,,,,2870943.0,137097.0,,,,,49126582.0,,,,,,19431145.0,13395175.0,,,,,,,9346715.0,,,,1328088108.0,22482414.0,,,221488043.0,10244.0,81712.0,198521544.0,,,,104070136.0,,,S,16547372.0,364612087.0,,,218309993.0,11647581.0,,,,,,,,137683.0,8050.0,9861431654.0,145.0,3058.0,,,1287.0,,81107.0,TX,,20423604.0,,,1237631.0,,25658112.0,,14656965.0,20913385.0,26.0,,,,,,,,7493673.0,,,-505857.0,13156.0,HARRIS,,,,,,,,,28454.0,3094787.0,-922560.0,5945474.0,3974843.0,53888963.0,,383302.0,,,,,16924.0,,50181173.0,217023363.0,,,25235653.0,,,25966.0,,-107058298.0,,,,,,,,,,,,,91290528.0,,841530.0,32644616.0,,,,,,,,,,,1850745.0,,,9200141.0,,-169313.0,5166.0,77008-,,,,,,,,308914.0,376461.0,,34448206.0,,,,,40613.0,,,237763.0,,,,,,,58938.0,,9538190.0,,,,,1989399325.0,,3603452.0,,,,8925917.0,,219723899.0,,,242.0,,1127.0,,,27833045.0,N,,,,,43577301.0,6.0,13125.52,,15954829.0,,,4503.0,,,,4399.0,,-77475400.0,,,8070841.0,4317324.0,,16689813.0,,,99.22,237187.47,,,4476.0,536351.0,,,,12323130.0,,1417.0,121705.0,,,,,,137616517.0,,,,,,,,,1810712.0,,,23.52,109382723.0,,,125044972.0,,,3842026.0,,,,,,,,,,,,71905.0,,21728868.0,,,48885164.0,47480120.0,,89490811.0,1471662.0,149392275.0,,,175886968.0,,,,,,11836813.0,,,15950355.0,,,,,,6961.96,,,,156892390.0,74208.0,General Short Term,,,9162789.0,,,1131267.0,,,93167968.0,,,17036471.0,,,33945.0,,,285045.0,2895454.0,,,23221354.0,,,,,49146265.0,60700957.0,235440.0,,,,371820.0,,,694114912.0,,25788994.0,,30430020.0,1313.0,,,25374.0,671782401.0,,,,,121875976.0,,,,111371.0,27366.0,7773476.0,106989845.0,,,97957567.0,,,,1302371.0,,,,,,,,,,HOUSTON,9433120.0,,23658419.0,,,,2053655.0,,,,,4595165.0,,,,130887.0,,8449584.0,,,471296900.0,,,,,14856352.0,34448206.0,18915385.0,,7159.91,143470565.0,,392531.0,,171.0,,,,,28229325.0,,,72846589.0,,223523.0,23381880.0,,,,,86269.0,194440510.0,,,,,,5459854.0,,3734767.0,88667995.0,20366.0,2508291.0,,,,23658419.0,851589.0,,,1365370.0,5492501.0,,,8.0,26465.0,,,62096273.0,3124870.0,,18460270.0,,,,,,,,,,,,188740.0,2145177402.0,,,,,,,119.0,,2482530.0,1497306.0,,,58707133.0,5774.0,165866398.0,,,,1245.0,,10641.0,,19742807.0,,,,,,,,219074.0,,7186.0,,,,,,44092412.0,,,,,10639.0,,,,,,,,,,,,20989067.0,39266969.0,23842587.0,153908967.0,,461871313.0,,13584306.0,,,,1850796.0,,3626.0,,,50875406.0,,,,19128.0,,,,,,,,9432339.0,,,,,,,34.76,88667995.0,,,,,1651162.0,5271070.0,,,,,6130270.0,,7773476.0,11154267.0,,,,,,2373572.0,,63756580.0,,,,660217.0,,,,86269.0,,1.0,,17156484.0,1614555.0,5220781.0,176648.0,Y,,67514926.0,,993861.0,,,,11000277.0,,,,,,,,,,,62.01,,,,,,,,,79222939.0,,,,,33591653.0,,Y,3061.0,,,,,993976.0,23119.0,6213124.0,,,16873584.0,94271536.0,8250.87,1472326.0,-7600.0,,,,,45253606.0,,,,,91.72,73327.0,,,3058.0,,7422967.0,,,,1327899.0,176297543.0,,,,,,31740575.0,,,124430511.0,,207569190.0,2509.0,,661311219.0,,1810712.0,,,,,,,,992039.0,,,,,74626242.0,,,11704595.0,,49714.0,,2659.0,,2178213.0,138232.0,15850267.0,,,1714955.0,,,,,-9587866.0,,,47558315.0,,47817979.0,,,536351.0,,,,,,,,,,16188266.0,,,,,,,635602.0,,,4579154.0,,,,,,,4909503593.0,1312883.0,1237631.0,,154364.0,10960.0,,,,,,,,,,,,,25.67,,,9584014.0,,660217.0,62906.0,672463.0,,15103586.0,,,,,,,,,7.0,,,,,-94201.0,,9009522.0,,190158057.0,,152716235.0,,10932700.0,,,,,2236545.0,1635 NORTH LOOP WEST,14915473.0,,319956.0,13156.0,,28383781.0,,2139576.0,122618967.0,,756936.04,,,686421043.0,,,356186807.0,2022,Acute Care Hospitals,MEMORIAL HERMANN  HOSPITAL SYS (450184)
