,RPT_REC_NUM,PRVDR_NUM,FI_NUM,FI_CREAT_DT,FY_BGN_DT,FY_END_DT,UTIL_CODE,STATE,ST_CTY_CD,CENSUS,REGION,MSA,A7_1_C3_1,A7_1_C3_10,A7_1_C3_2,A7_1_C3_3,A7_1_C3_4,A7_1_C3_5,A7_1_C3_6,A7_1_C3_7,A7_1_C3_8,A7_1_C5_2,A7_1_C5_4,A7_1_C5_7,A7_1_C7_1,A7_1_C7_10,A7_1_C7_2,A7_1_C7_3,A7_1_C7_4,A7_1_C7_5,A7_1_C7_6,A7_1_C7_7,A7_1_C7_8,A8_C2_11,A8_C2_15,A8_C2_16,A8_C2_19,A8_C2_20,A8_C2_25,A8_C2_26,A8_C2_27,A8_C2_29,A8_C2_3,A8_C2_30,A8_C2_31,A8_C2_5,A8_C2_9,A_C1_100,A_C1_105,A_C1_106,A_C1_107,A_C1_108,A_C1_109,A_C1_110,A_C1_111,A_C1_114,A_C1_42,A_C1_4201,A_C1_45,A_C1_4501,A_C1_46,A_C1_94,A_C2_100,A_C2_105,A_C2_106,A_C2_107,A_C2_108,A_C2_109,A_C2_110,A_C2_111,A_C2_114,A_C2_42,A_C2_4201,A_C2_45,A_C2_4501,A_C2_46,A_C2_61,A_C2_94,A_C6_100,A_C6_105,A_C6_106,A_C6_107,A_C6_108,A_C6_109,A_C6_110,A_C6_111,A_C6_114,A_C6_42,A_C6_4201,A_C6_45,A_C6_4501,A_C6_46,A_C6_61,A_C6_74,A_C6_94,A_C6_95,B_1_C0_100,B_1_C0_105,B_1_C0_106,B_1_C0_107,B_1_C0_108,B_1_C0_109,B_1_C0_110,B_1_C0_111,B_1_C0_42,B_1_C0_4201,B_1_C0_45,B_1_C0_4501,B_1_C0_46,B_1_C0_61,B_1_C0_94,B_1_C21_100,B_1_C21_105,B_1_C21_106,B_1_C21_107,B_1_C21_108,B_1_C21_109,B_1_C21_40,B_1_C21_42,B_1_C21_44,B_1_C21_45,B_1_C21_46,B_1_C21_74,B_1_C21_94,B_1_C21_95,B_1_C22_100,B_1_C22_105,B_1_C22_106,B_1_C22_107,B_1_C22_108,B_1_C22_109,B_1_C22_110,B_1_C22_111,B_1_C22_40,B_1_C22_42,B_1_C22_43,B_1_C22_44,B_1_C22_45,B_1_C22_46,B_1_C22_74,B_1_C22_94,B_1_C22_95,B_1_C26_100,B_1_C26_105,B_1_C26_106,B_1_C26_107,B_1_C26_108,B_1_C26_109,B_1_C26_110,B_1_C26_111,B_1_C26_42,B_1_C26_4201,B_1_C26_45,B_1_C26_4501,B_1_C26_46,B_1_C26_61,B_1_C26_94,B_2_C26_100,B_2_C26_105,B_2_C26_106,B_2_C26_107,B_2_C26_108,B_2_C26_109,B_2_C26_110,B_2_C26_111,B_2_C26_42,B_2_C26_4201,B_2_C26_45,B_2_C26_4501,B_2_C26_46,B_2_C26_94,C_1_C5_100,C_1_C5_105,C_1_C5_106,C_1_C5_107,C_1_C5_108,C_1_C5_109,C_1_C5_110,C_1_C5_111,C_1_C5_42,C_1_C5_4201,C_1_C5_45,C_1_C5_4501,C_1_C5_46,C_1_C5_61,C_1_C5_94,C_1_C6_100,C_1_C6_105,C_1_C6_106,C_1_C6_107,C_1_C6_108,C_1_C6_109,C_1_C6_110,C_1_C6_111,C_1_C6_42,C_1_C6_4201,C_1_C6_45,C_1_C6_4501,C_1_C6_46,C_1_C6_61,C_1_C6_94,C_1_C7_100,C_1_C7_105,C_1_C7_106,C_1_C7_107,C_1_C7_108,C_1_C7_109,C_1_C7_110,C_1_C7_111,C_1_C7_61,C_1_C7_94,D1_HOS_C1_54,D1_HOS_C1_55,D1_HOS_C1_56,D1_HOS_C1_57,D1_HOS_C1_58,D1_HOS_C1_62,D1_HOS_C1_63,D1_SNF_C1_85,D3_HOS_C2_40,D3_HOS_C2_41,D3_HOS_C2_42,D3_HOS_C2_43,D3_HOS_C2_61,D3_HOS_C2_94,D3_HOS_C3_61,D3_HOS_C3_94,D3_IPF_C2_41,D3_IPF_C2_42,D3_IPF_C2_74,D3_IPF_C2_94,D3_IPF_C3_74,D3_IPF_C3_94,D3_IRF_C2_40,D3_IRF_C2_61,D3_IRF_C2_94,D3_IRF_C3_61,D3_IRF_C3_94,D3_SNF_C2_30,D3_SNF_C2_40,D3_SNF_C2_41,D3_SNF_C2_74,D3_SNF_C2_94,D3_SNF_C3_74,D3_SNF_C3_94,D_1_HOS_C4_42,D_1_HOS_C4_4201,D_3_HOS_C3_200,D_3_HOS_C9_41,D_3_HOS_C9_44,D_4_HOS_C11_74,D_4_HOS_C11_94,D_4_HOS_C12_94,D_4_HOS_C13_74,D_4_HOS_C1_200,D_4_HOS_C2_74,D_4_HOS_C2_94,D_4_HOS_C3_74,D_4_HOS_C3_94,D_4_HOS_C4_200,D_4_HOS_C4_74,D_4_IPF_C11_74,D_4_IPF_C13_200,D_4_IPF_C13_74,D_4_IPF_C1_200,D_4_IPF_C2_200,D_4_IPF_C4_200,D_4_IRF_C11_74,D_4_IRF_C13_200,D_4_IRF_C13_74,D_4_IRF_C4_200,D_4_SNF_C11_200,D_4_SNF_C11_74,D_4_SNF_C13_200,D_5_HOS_C2_94,D_5_HOS_C3_61,D_5_HOS_C3_94,D_5_HOS_C3_95,D_5_HOS_C4_94,D_5_HOS_C6_61,D_5_HOS_C6_94,D_5_HOS_C6_95,D_5_HOS_C7_94,E_B_HOS_C101_2,E_B_HOS_C101_3,E_B_HOS_C101_4,E_B_HOS_C101_6,E_B_HOS_C101_7,E_B_HOS_C101_8,E_B_HOS_C1_10,E_B_HOS_C1_13,E_B_HOS_C1_15,E_B_HOS_C1_16,E_B_HOS_C1_17,E_B_HOS_C1_22,E_B_HOS_C1_23,E_B_HOS_C1_33,E_B_HOS_C1_3998,E_B_HOS_C1_4001,E_B_HOS_C1_42,E_B_HOS_C1_8,S2_1_C1_37,S3_1_C10_18,S3_1_C10_1801,S3_1_C10_20,S3_1_C10_2001,S3_1_C10_21,S3_1_C11_14,S3_1_C11_19,S3_1_C11_21,S3_1_C11_27,S3_1_C2_18,S3_1_C2_1801,S3_1_C2_20,S3_1_C2_2001,S3_1_C2_21,S3_1_C3_18,S3_1_C3_1801,S3_1_C3_20,S3_1_C3_2001,S3_1_C3_21,S3_1_C5_1,S3_1_C5_13,S3_1_C5_14,S3_1_C5_16,S3_1_C5_17,S3_1_C5_19,S3_1_C5_20,S3_1_C5_7,S3_1_C6_15,S3_1_C7_15,S3_1_C7_18,S3_1_C7_1801,S3_1_C7_20,S3_1_C7_2001,S3_1_C7_5,S3_1_C8_15,S3_1_C8_18,S3_1_C8_1801,S3_1_C8_20,S3_1_C8_2001,S3_1_C8_21,S3_1_C9_18,S3_1_C9_19,S3_1_C9_20,S3_1_C9_21,S3_2_C2_14,S3_2_C2_1402,S3_2_C2_16,S3_2_C2_18,S3_2_C2_2,S3_2_C2_20,S3_2_C2_2201,S3_2_C2_2551,S3_2_C2_2553,S3_2_C2_36,S3_2_C2_37,S3_2_C2_43,S3_2_C2_8,S3_2_C2_9,S3_2_C3_14,S3_2_C3_1401,S3_2_C3_1402,S3_2_C3_22,S3_2_C3_2201,S3_2_C3_23,S3_2_C3_24,S3_2_C3_25,S3_2_C3_2550,S3_2_C3_2551,S3_2_C3_2552,S3_2_C3_2553,S3_2_C4_14,S3_2_C4_1402,S3_2_C4_16,S3_2_C4_18,S3_2_C4_2,S3_2_C4_20,S3_2_C4_2201,S3_2_C4_2551,S3_2_C4_2553,S3_2_C4_37,S3_2_C4_43,S3_2_C4_8,S3_2_C4_9,S3_2_C5_14,S3_2_C5_16,S3_2_C5_2,S3_2_C5_37,S3_2_C5_43,S3_2_C5_8,S3_2_C5_9,S3_2_C6_14,S3_2_C6_1402,S3_2_C6_16,S3_2_C6_2,S3_2_C6_37,S3_2_C6_43,S3_2_C6_8,S3_2_C6_9,S4_HHA1_C1_34,S4_HHA1_C2_34,S4_HHA1_C3_34,S4_HHA1_C4_34,S4_HHA1_C4_36,S4_HHA1_C4_38,S4_HHA1_C5_34,S4_HHA2_C1_33,S4_HHA2_C1_34,S4_HHA2_C1_35,S4_HHA2_C1_36,S4_HHA2_C1_38,S4_HHA2_C2_33,S4_HHA2_C2_34,S4_HHA2_C2_35,S4_HHA2_C2_37,S4_HHA2_C2_38,S4_HHA2_C3_33,S4_HHA2_C3_34,S4_HHA2_C3_35,S4_HHA2_C3_36,S4_HHA2_C3_38,S4_HHA2_C4_33,S4_HHA2_C4_34,S4_HHA2_C4_35,S4_HHA2_C4_36,S4_HHA2_C4_37,S4_HHA2_C4_38,S4_HHA2_C5_33,S4_HHA2_C5_34,S4_HHA2_C5_35,S4_HHA2_C5_36,S4_HHA2_C5_37,S4_HHA2_C5_38,S4_HHA3_C1_33,S4_HHA3_C1_34,S4_HHA3_C1_35,S4_HHA3_C1_36,S4_HHA3_C1_38,S4_HHA3_C2_33,S4_HHA3_C2_34,S4_HHA3_C2_35,S4_HHA3_C2_37,S4_HHA3_C2_38,S4_HHA3_C3_33,S4_HHA3_C3_34,S4_HHA3_C3_35,S4_HHA3_C3_36,S4_HHA3_C3_38,S4_HHA3_C4_33,S4_HHA3_C4_34,S4_HHA3_C4_35,S4_HHA3_C4_36,S4_HHA3_C4_37,S4_HHA3_C4_38,S4_HHA3_C5_33,S4_HHA3_C5_34,S4_HHA3_C5_35,S4_HHA3_C5_36,S4_HHA3_C5_37,S4_HHA3_C5_38,S5_C1_10,S5_C1_14,S5_C1_15,S5_C1_8,S5_C1_9,S5_C2_10,S5_C2_8,S5_C2_9,S5_C3_2,S5_C3_3,S5_C3_6,S5_C4_2,S5_C4_3,S5_C4_4,S5_C4_6,S5_C5_2,S5_C6_2,S5_C6_4,A7_1_C1_1,A7_1_C1_10,A7_1_C1_3,A7_1_C1_6,A7_1_C1_8,A7_1_C2_10,A7_1_C2_6,A7_1_C2_8,A7_3_C11_3,A7_3_C15_3,A7_3_C9_3,A8_C2_10,A8_C2_14,A8_C2_18,A8_C2_2,A8_C2_22,A8_C2_50,A8_C2_7,A8_C2_8,A_C1_200,A_C1_30,A_C2_113,A_C2_200,A_C2_30,A_C6_200,A_C6_30,B_1_C0_200,B_1_C0_30,B_1_C26_202,B_1_C26_30,B_2_C26_202,B_2_C26_30,C_1_C3_202,C_1_C6_202,C_1_C6_30,C_1_C7_202,C_1_C8_202,D1_HOS_C1_26,D1_HOS_C1_27,D1_HOS_C1_37,D1_HOS_C1_41,D1_HOS_C1_48,D1_HOS_C1_49,D3_HOS_C2_30,D3_HOS_C3_200,D_5_HOS_C3_200,D_5_HOS_C6_200,E_B_HOS_C1_1,E_B_HOS_C1_25,E_B_HOS_C1_26,E_B_HOS_C1_27,E_B_HOS_C1_30,E_B_HOS_C1_32,E_B_HOS_C1_37,E_B_HOS_C1_40,E_B_HOS_C1_41,E_B_HOS_C1_43,S10_C1_1,S2_1_C1_27,S3_1_C10_14,S3_1_C10_27,S3_1_C2_1,S3_1_C2_14,S3_1_C2_27,S3_1_C2_7,S3_1_C3_1,S3_1_C3_14,S3_1_C3_7,S3_1_C4_1,S3_1_C4_14,S3_1_C4_7,S3_1_C6_1,S3_1_C6_14,S3_1_C6_2,S3_1_C6_5,S3_1_C6_7,S3_1_C8_1,S3_1_C8_14,S3_1_C8_28,S3_1_C8_5,S3_1_C8_6,S3_1_C8_7,A7_1_C1_2,A7_1_C1_4,A7_1_C1_5,A7_1_C1_7,A7_1_C2_1,A7_1_C2_2,A7_1_C2_3,A7_1_C2_4,A7_1_C2_7,A7_1_C4_7,A7_1_C5_10,A7_1_C5_6,A7_1_C5_8,A7_1_C6_7,A7_3_C10_3,A7_3_C5_3,A7_3_C6_3,A7_3_C7_3,A8_C2_1,A_C1_43,A_C2_3,A_C2_43,A_C6_3,A_C6_43,B_1_C0_43,B_1_C26_43,B_2_C26_200,B_2_C26_43,C_1_C5_200,C_1_C5_201,C_1_C5_202,C_1_C5_30,C_1_C5_43,C_1_C6_43,D1_HOS_C1_50,D1_HOS_C1_51,D1_HOS_C1_52,D1_HOS_C1_53,D_1_HOS_C4_200,D_1_HOS_C4_30,D_1_HOS_C4_43,D_1_HOS_C6_200,D_1_HOS_C6_30,D_1_HOS_C7_200,D_1_HOS_C7_30,D_3_HOS_C6_200,D_3_HOS_C8_200,D_4_HOS_C11_200,D_4_HOS_C12_200,D_4_HOS_C13_200,D_4_HOS_C3_200,D_4_HOS_C6_200,D_5_HOS_C2_200,D_5_HOS_C4_200,D_5_HOS_C5_200,D_5_HOS_C7_200,E_B_HOS_C1_12,E_B_HOS_C1_14,E_B_HOS_C1_18,E_B_HOS_C1_19,E_B_HOS_C1_2,E_B_HOS_C1_24,E_B_HOS_C1_3,E_B_HOS_C1_31,E_B_HOS_C1_34,E_B_HOS_C1_35,E_B_HOS_C1_36,E_B_HOS_C1_4,S2_1_C1_11801,S2_1_C1_24,S2_1_C5_24,S3_1_C2_32,S3_1_C3_32,S3_1_C6_32,S3_1_C7_1,S3_1_C7_13,S3_1_C7_14,S3_1_C7_2,S3_1_C7_32,S3_1_C7_7,S3_1_C8_13,S3_1_C8_32,S3_2_C2_1,S3_2_C2_10,S3_2_C2_11,S3_2_C2_13,S3_2_C2_17,S3_2_C2_19,S3_2_C2_21,S3_2_C2_22,S3_2_C2_23,S3_2_C2_26,S3_2_C2_27,S3_2_C2_28,S3_2_C2_3,S3_2_C2_30,S3_2_C2_32,S3_2_C2_34,S3_2_C2_38,S3_2_C2_39,S3_2_C2_4,S3_2_C2_40,S3_2_C2_41,S3_2_C2_42,S3_2_C2_5,S3_2_C4_1,S3_2_C4_10,S3_2_C4_11,S3_2_C4_13,S3_2_C4_17,S3_2_C4_19,S3_2_C4_21,S3_2_C4_22,S3_2_C4_23,S3_2_C4_26,S3_2_C4_27,S3_2_C4_28,S3_2_C4_3,S3_2_C4_30,S3_2_C4_32,S3_2_C4_34,S3_2_C4_36,S3_2_C4_38,S3_2_C4_39,S3_2_C4_4,S3_2_C4_40,S3_2_C4_41,S3_2_C4_42,S3_2_C4_5,S3_2_C5_1,S3_2_C5_10,S3_2_C5_11,S3_2_C5_13,S3_2_C5_26,S3_2_C5_27,S3_2_C5_28,S3_2_C5_3,S3_2_C5_30,S3_2_C5_32,S3_2_C5_34,S3_2_C5_36,S3_2_C5_38,S3_2_C5_39,S3_2_C5_4,S3_2_C5_40,S3_2_C5_41,S3_2_C5_42,S3_2_C5_5,S3_2_C6_1,S3_2_C6_10,S3_2_C6_11,S3_2_C6_13,S3_2_C6_26,S3_2_C6_27,S3_2_C6_28,S3_2_C6_3,S3_2_C6_30,S3_2_C6_32,S3_2_C6_34,S3_2_C6_36,S3_2_C6_38,S3_2_C6_39,S3_2_C6_4,S3_2_C6_40,S3_2_C6_41,S3_2_C6_42,S3_2_C6_5,S3_3_C2_1,S3_3_C2_2,S3_3_C2_3,S3_3_C2_4,S3_3_C2_5,S3_3_C2_6,S3_3_C4_1,S3_3_C4_2,S3_3_C4_3,S3_3_C4_4,S3_3_C4_5,S3_3_C4_6,S3_3_C4_7,S3_3_C5_1,S3_3_C5_2,S3_3_C5_3,S3_3_C5_4,S3_3_C5_6,S3_3_C5_7,S3_3_C6_1,S3_3_C6_2,S3_3_C6_3,S3_3_C6_4,S3_3_C6_5,S3_3_C6_6,S3_3_C6_7,A8_C2_12,A_C1_44,A_C1_95,A_C2_40,A_C2_44,A_C2_95,B_1_C0_40,B_1_C0_44,B_1_C0_95,B_1_C26_40,B_1_C26_44,B_1_C26_95,B_2_C26_44,B_2_C26_95,C_1_C5_40,C_1_C5_44,C_1_C5_95,C_1_C6_40,C_1_C6_44,C_1_C7_95,D1_IPF_C1_27,D1_IPF_C1_37,D1_IPF_C1_48,D1_IPF_C1_49,D1_IPF_C1_53,D1_SNF_C1_37,D1_SNF_C1_74,D1_SNF_C1_84,D3_IPF_C2_200,D3_IPF_C3_200,D3_SNF_C2_202,D3_SNF_C3_200,S3_1_C10_19,S3_1_C2_19,S3_1_C3_19,S3_1_C6_19,S3_1_C7_19,S3_1_C8_19,A_C6_44,A7_1_C5_3,A7_1_C5_5,A8_C2_4,A_C6_113,B_2_C26_201,A_C1_74,A_C2_74,B_1_C0_74,B_1_C26_74,B_2_C26_74,C_1_C5_74,C_1_C6_74,C_1_C7_74,D3_HOS_C2_74,D3_HOS_C3_74,D_4_HOS_C12_74,D_5_HOS_C2_74,D_5_HOS_C3_74,D_5_HOS_C4_74,D_5_HOS_C5_74,D_5_HOS_C6_74,D_5_HOS_C7_74,E_B_HOS_C1_6,E_B_HOS_C1_7,S2_1_C1_35,S2_1_C6_24,S3_1_C6_29,S3_2_C2_12,S3_2_C2_1401,S3_2_C2_2550,S3_2_C2_31,S3_2_C2_33,S3_2_C4_12,S3_2_C4_1401,S3_2_C4_2550,S3_2_C4_31,S3_2_C4_33,S3_2_C5_12,S3_2_C5_31,S3_2_C5_33,S3_2_C6_12,S3_2_C6_1401,S3_2_C6_31,S3_2_C6_33,S4_HHA1_C1_33,S4_HHA1_C1_35,S4_HHA1_C1_36,S4_HHA1_C1_38,S4_HHA1_C2_33,S4_HHA1_C2_35,S4_HHA1_C2_37,S4_HHA1_C2_38,S4_HHA1_C3_33,S4_HHA1_C3_35,S4_HHA1_C3_36,S4_HHA1_C3_38,S4_HHA1_C4_33,S4_HHA1_C4_35,S4_HHA1_C4_37,S4_HHA1_C5_33,S4_HHA1_C5_35,S4_HHA1_C5_36,S4_HHA1_C5_37,S4_HHA1_C5_38,S5_C1_11,S5_C1_12,S5_C1_2,S5_C1_3,S5_C1_5,S5_C1_6,S5_C1_7,S5_C2_2,S5_C2_3,S5_C2_5,S5_C2_6,S5_C2_7,A7_1_C5_1,A8_C2_13,A8_C2_6,A_C1_41,A_C2_41,A_C6_41,B_1_C0_41,B_1_C21_30,B_1_C21_43,B_1_C26_41,B_2_C26_41,C_1_C5_41,C_1_C6_41,D1_IRF_C1_27,D1_IRF_C1_37,D1_IRF_C1_41,D1_IRF_C1_48,D1_IRF_C1_49,D1_IRF_C1_50,D1_IRF_C1_51,D1_IRF_C1_52,D1_IRF_C1_53,D3_IRF_C2_200,D3_IRF_C2_41,D3_IRF_C3_200,D_1_HOS_C4_41,D_1_HOS_C6_41,D_1_HOS_C7_41,D_3_HOS_C5_200,D_3_HOS_C9_200,D_3_HOS_C9_30,D_4_HOS_C2_200,D_4_IRF_C11_200,D_4_IRF_C2_200,D_4_IRF_C3_200,D_4_IRF_C6_200,E_B_HOS_C1_28,S2_1_C2_24,S2_1_C3_24,S3_1_C2_17,S3_1_C3_17,S3_1_C6_17,S3_1_C7_17,S3_1_C8_17,S3_1_C9_14,S3_1_C9_27,S3_2_C2_29,S3_2_C4_29,S3_2_C5_29,S3_2_C6_29,A7_1_C2_5,B_2_C0_202,S3_2_C2_15,S3_2_C2_2552,S3_2_C4_15,S3_2_C4_2552,S3_2_C5_15,S3_2_C6_15,A8_C2_17,B_1_C26_201,A8_C2_21,A8_C2_28,A_C1_40,B_1_C21_41,B_1_C22_30,B_1_C22_41,B_2_C26_40,C_1_C6_95,D1_IPF_C1_41,D1_IPF_C1_50,D1_IPF_C1_51,D1_IPF_C1_52,D3_IPF_C2_40,D3_IRF_C2_74,D3_IRF_C3_74,D_1_HOS_C4_40,D_1_HOS_C6_40,D_1_HOS_C7_40,D_3_HOS_C2_200,D_3_HOS_C9_40,D_4_IPF_C11_200,D_4_IPF_C3_200,D_4_IPF_C6_200,E_B_HOS_C1_38,E_B_HOS_C1_44,S2_1_C2_11801,S2_1_C3_11801,S3_1_C2_16,S3_1_C3_16,S3_1_C6_16,S3_1_C8_16,S3_2_C2_25,S3_2_C2_35,S3_2_C2_7,S3_2_C4_25,S3_2_C4_35,S3_2_C4_7,S3_2_C5_35,S3_2_C5_7,S3_2_C6_35,S3_2_C6_7,S2_1_C4_24,S3_2_C2_24,S3_2_C2_6,S3_2_C4_24,S3_2_C4_6,S3_2_C5_6,S3_2_C6_6,S3_1_C7_6,A_C6_40,S3_1_C7_16,S2_1_C2_10,S2_1_C2_1001,S2_1_C2_1201,S2_1_C2_1202,S2_1_C2_13,S2_1_C2_1401,S2_1_C2_1502,S2_1_C2_1503,S2_1_C2_1504,S2_1_C2_1505,S2_1_C2_1506,S2_1_C2_1507,S2_1_C2_1508,S2_1_C2_1509,S2_1_C2_1510,S2_1_C2_1511,S2_1_C2_1512,S2_1_C2_1513,S2_1_C2_1514,S2_1_C2_1515,S2_1_C2_1516,S2_1_C2_1517,S2_1_C2_1518,S2_1_C2_1519,S2_1_C2_1520,S2_1_C2_1521,S2_1_C2_1522,S2_1_C2_1523,S2_1_C2_1524,S2_1_C2_16,S2_1_C2_1601,S2_1_C2_1602,S2_1_C2_1603,S2_1_C2_1604,S2_1_C2_1605,S2_1_C2_1606,S2_1_C2_1607,S2_1_C2_1608,S2_1_C2_17,S2_1_C2_1801,S2_1_C2_1802,S2_1_C2_1803,S2_1_C2_1804,S2_1_C2_1805,S2_1_C2_1806,S2_1_C2_1807,S2_1_C2_1808,S2_1_C2_1809,S2_1_C1_3601,S2_1_C2_3601,S2_1_C1_38,S2_1_C2_38,S2_1_C1_3801,S2_1_C2_3801,S2_1_C1_126,S2_1_C2_126,S2_1_C1_127,S2_1_C2_127,S2_1_C1_128,S2_1_C2_128,S2_1_C1_129,S2_1_C2_129,S2_1_C2_130,S2_1_C1_131,S2_1_C1_132,S2_1_C2_132,S2_1_C1_134,S2_1_C1_1,S2_1_C1_2,S2_1_C2_2,S2_1_C3_2,S2_1_C4_2,S2_1_C1_3,S2_1_C3_3,S2_1_C7_3,S2_1_C2_7,S2_1_C1_21,S2_1_C2_140,S2_1_C1_141,S2_1_C1_142,S2_1_C1_143,S2_1_C2_143,S2_1_C3_143,S2_1_C1_4,S2_1_C2_4,S2_1_C2_9,S2_1_C2_15,S2_1_C2_1501,S2_1_C2_1,S2_1_C2_142,S2_1_C2_12,S2_1_C2_14,S2_1_C2_18,S2_1_C1_36,S2_1_C2_36,S2_1_C1_5,S2_1_C2_5,S2_1_C2_8,S2_1_C2_115,A_C1_11,A_C1_112,A_C1_115,A_C1_117,A_C1_12,A_C1_18,A_C1_19,A_C1_22,A_C1_33,A_C1_62,A_C1_6250,A_C1_72,A_C1_89,A_C1_96,A_C1_97,A_C1_98,A_C1_99,A_C1_9910,A_C1_9920,A_C1_9930,A_C1_9940,A_C2_11,A_C2_112,A_C2_115,A_C2_117,A_C2_12,A_C2_19,A_C2_22,A_C2_33,A_C2_62,A_C2_6250,A_C2_64,A_C2_89,A_C2_96,A_C2_97,A_C2_98,A_C2_99,A_C2_9910,A_C2_9920,A_C2_9930,A_C2_9940,A_C6_101,A_C6_112,A_C6_115,A_C6_116,A_C6_117,A_C6_12,A_C6_18,A_C6_191,A_C6_192,A_C6_193,A_C6_33,A_C6_62,A_C6_63,A_C6_64,A_C6_67,A_C6_68,A_C6_70,A_C6_72,A_C6_75,A_C6_88,A_C6_89,A_C6_93,A_C6_96,A_C6_97,A_C6_98,A_C6_99,A_C6_9910,A_C6_9920,A_C6_9930,A_C6_9940,B_1_C0_112,B_1_C0_115,B_1_C0_117,B_1_C0_12,B_1_C0_19,B_1_C0_33,B_1_C0_62,B_1_C0_6250,B_1_C0_89,B_1_C0_96,B_1_C0_97,B_1_C0_98,B_1_C0_99,B_1_C0_9910,B_1_C0_9920,B_1_C0_9930,B_1_C0_9940,B_1_C21_101,B_1_C21_112,B_1_C21_115,B_1_C21_116,B_1_C21_191,B_1_C21_192,B_1_C21_193,B_1_C21_194,B_1_C21_33,B_1_C21_51,B_1_C21_53,B_1_C21_54,B_1_C21_55,B_1_C21_56,B_1_C21_57,B_1_C21_58,B_1_C21_59,B_1_C21_60,B_1_C21_62,B_1_C21_63,B_1_C21_64,B_1_C21_65,B_1_C21_66,B_1_C21_67,B_1_C21_68,B_1_C21_69,B_1_C21_70,B_1_C21_71,B_1_C21_72,B_1_C21_73,B_1_C21_75,B_1_C21_76,B_1_C21_88,B_1_C21_89,B_1_C21_9201,B_1_C21_98,B_1_C21_99,B_1_C22_101,B_1_C22_112,B_1_C22_115,B_1_C22_116,B_1_C22_191,B_1_C22_192,B_1_C22_193,B_1_C22_194,B_1_C22_32,B_1_C22_33,B_1_C22_34,B_1_C22_35,B_1_C22_51,B_1_C22_53,B_1_C22_54,B_1_C22_55,B_1_C22_56,B_1_C22_57,B_1_C22_58,B_1_C22_59,B_1_C22_60,B_1_C22_62,B_1_C22_63,B_1_C22_64,B_1_C22_65,B_1_C22_66,B_1_C22_67,B_1_C22_68,B_1_C22_69,B_1_C22_70,B_1_C22_71,B_1_C22_72,B_1_C22_73,B_1_C22_75,B_1_C22_76,B_1_C22_88,B_1_C22_89,B_1_C22_9201,B_1_C22_98,B_1_C22_99,B_1_C26_112,B_1_C26_115,B_1_C26_117,B_1_C26_33,B_1_C26_62,B_1_C26_6250,B_1_C26_89,B_1_C26_96,B_1_C26_97,B_1_C26_98,B_1_C26_99,B_1_C26_9910,B_1_C26_9920,B_1_C26_9930,B_1_C26_9940,B_2_C26_112,B_2_C26_115,B_2_C26_117,B_2_C26_33,B_2_C26_62,B_2_C26_6250,B_2_C26_89,B_2_C26_96,B_2_C26_97,B_2_C26_98,B_2_C26_99,B_2_C26_9910,B_2_C26_9920,B_2_C26_9930,B_2_C26_9940,C_1_C2_65,C_1_C2_66,C_1_C2_67,C_1_C2_68,C_1_C5_112,C_1_C5_115,C_1_C5_117,C_1_C5_33,C_1_C5_62,C_1_C5_6250,C_1_C5_89,C_1_C5_96,C_1_C5_97,C_1_C5_98,C_1_C5_99,C_1_C5_9910,C_1_C5_9920,C_1_C5_9930,C_1_C5_9940,C_1_C6_101,C_1_C6_112,C_1_C6_115,C_1_C6_116,C_1_C6_117,C_1_C6_33,C_1_C6_62,C_1_C6_6250,C_1_C6_88,C_1_C6_89,C_1_C6_96,C_1_C6_97,C_1_C6_98,C_1_C6_99,C_1_C6_9910,C_1_C6_9920,C_1_C6_9930,C_1_C6_9940,C_1_C7_112,C_1_C7_115,C_1_C7_117,C_1_C7_62,C_1_C7_6250,C_1_C7_89,C_1_C7_96,C_1_C7_97,C_1_C7_98,C_1_C7_99,C_1_C7_9910,C_1_C7_9920,C_1_C7_9930,C_1_C7_9940,D1_HOS_C5_44,D1_HOS_C5_45,D1_HOS_C5_46,D3_HOS_C2_33,D3_HOS_C2_35,D3_HOS_C2_62,D3_HOS_C2_6250,D3_HOS_C2_96,D3_HOS_C2_97,D3_HOS_C2_98,D3_HOS_C3_62,D3_HOS_C3_6250,D3_HOS_C3_96,D3_HOS_C3_97,D3_HOS_C3_98,D3_IPF_C2_31,D3_IPF_C2_32,D3_IPF_C2_33,D3_IPF_C2_34,D3_IPF_C2_35,D3_IPF_C2_52,D3_IPF_C2_55,D3_IPF_C2_56,D3_IPF_C2_59,D3_IPF_C2_62,D3_IPF_C2_63,D3_IPF_C2_64,D3_IPF_C2_67,D3_IPF_C2_70,D3_IPF_C2_75,D3_IPF_C2_76,D3_IPF_C2_90,D3_IPF_C2_9201,D3_IPF_C2_93,D3_IPF_C2_96,D3_IPF_C2_98,D3_IPF_C3_52,D3_IPF_C3_55,D3_IPF_C3_56,D3_IPF_C3_59,D3_IPF_C3_62,D3_IPF_C3_63,D3_IPF_C3_64,D3_IPF_C3_67,D3_IPF_C3_70,D3_IPF_C3_75,D3_IPF_C3_76,D3_IPF_C3_90,D3_IPF_C3_9201,D3_IPF_C3_93,D3_IPF_C3_96,D3_IPF_C3_98,D3_IRF_C2_31,D3_IRF_C2_32,D3_IRF_C2_33,D3_IRF_C2_34,D3_IRF_C2_35,D3_IRF_C2_52,D3_IRF_C2_56,D3_IRF_C2_59,D3_IRF_C2_62,D3_IRF_C2_63,D3_IRF_C2_70,D3_IRF_C2_75,D3_IRF_C2_91,D3_IRF_C2_9201,D3_IRF_C2_93,D3_IRF_C2_96,D3_IRF_C2_98,D3_IRF_C3_52,D3_IRF_C3_56,D3_IRF_C3_59,D3_IRF_C3_62,D3_IRF_C3_63,D3_IRF_C3_70,D3_IRF_C3_75,D3_IRF_C3_91,D3_IRF_C3_9201,D3_IRF_C3_93,D3_IRF_C3_96,D3_IRF_C3_98,D3_SNF_C2_31,D3_SNF_C2_32,D3_SNF_C2_34,D3_SNF_C2_35,D3_SNF_C2_50,D3_SNF_C2_51,D3_SNF_C2_52,D3_SNF_C2_53,D3_SNF_C2_55,D3_SNF_C2_56,D3_SNF_C2_57,D3_SNF_C2_58,D3_SNF_C2_59,D3_SNF_C2_62,D3_SNF_C2_63,D3_SNF_C2_64,D3_SNF_C2_65,D3_SNF_C2_67,D3_SNF_C2_68,D3_SNF_C2_69,D3_SNF_C2_70,D3_SNF_C2_71,D3_SNF_C2_72,D3_SNF_C2_75,D3_SNF_C2_76,D3_SNF_C2_90,D3_SNF_C2_91,D3_SNF_C2_9201,D3_SNF_C2_93,D3_SNF_C2_96,D3_SNF_C2_98,D3_SNF_C3_50,D3_SNF_C3_51,D3_SNF_C3_52,D3_SNF_C3_53,D3_SNF_C3_55,D3_SNF_C3_56,D3_SNF_C3_57,D3_SNF_C3_58,D3_SNF_C3_59,D3_SNF_C3_62,D3_SNF_C3_63,D3_SNF_C3_64,D3_SNF_C3_65,D3_SNF_C3_67,D3_SNF_C3_68,D3_SNF_C3_69,D3_SNF_C3_70,D3_SNF_C3_71,D3_SNF_C3_72,D3_SNF_C3_75,D3_SNF_C3_76,D3_SNF_C3_90,D3_SNF_C3_91,D3_SNF_C3_9201,D3_SNF_C3_93,D3_SNF_C3_96,D3_SNF_C3_98,D_1_HOS_C4_33,D_1_HOS_C6_33,D_1_HOS_C6_35,D_1_HOS_C7_33,D_1_HOS_C7_35,D_3_HOS_C9_33,D_3_HOS_C9_35,D_4_HOS_C10_62,D_4_HOS_C10_6250,D_4_HOS_C10_96,D_4_HOS_C10_97,D_4_HOS_C10_98,D_4_HOS_C11_51,D_4_HOS_C11_52,D_4_HOS_C11_55,D_4_HOS_C11_56,D_4_HOS_C11_57,D_4_HOS_C11_58,D_4_HOS_C11_62,D_4_HOS_C11_63,D_4_HOS_C11_64,D_4_HOS_C11_66,D_4_HOS_C11_67,D_4_HOS_C11_68,D_4_HOS_C11_70,D_4_HOS_C11_71,D_4_HOS_C11_72,D_4_HOS_C11_75,D_4_HOS_C11_9201,D_4_HOS_C11_98,D_4_HOS_C12_62,D_4_HOS_C12_6250,D_4_HOS_C12_96,D_4_HOS_C12_97,D_4_HOS_C12_98,D_4_HOS_C13_51,D_4_HOS_C13_52,D_4_HOS_C13_55,D_4_HOS_C13_56,D_4_HOS_C13_57,D_4_HOS_C13_58,D_4_HOS_C13_62,D_4_HOS_C13_63,D_4_HOS_C13_64,D_4_HOS_C13_66,D_4_HOS_C13_67,D_4_HOS_C13_68,D_4_HOS_C13_70,D_4_HOS_C13_71,D_4_HOS_C13_72,D_4_HOS_C13_75,D_4_HOS_C13_9201,D_4_HOS_C13_97,D_4_HOS_C13_98,D_4_HOS_C1_50,D_4_HOS_C1_53,D_4_HOS_C1_73,D_4_HOS_C1_76,D_4_HOS_C1_91,D_4_HOS_C2_51,D_4_HOS_C2_53,D_4_HOS_C2_54,D_4_HOS_C2_55,D_4_HOS_C2_56,D_4_HOS_C2_57,D_4_HOS_C2_58,D_4_HOS_C2_59,D_4_HOS_C2_60,D_4_HOS_C2_62,D_4_HOS_C2_63,D_4_HOS_C2_64,D_4_HOS_C2_65,D_4_HOS_C2_66,D_4_HOS_C2_67,D_4_HOS_C2_68,D_4_HOS_C2_69,D_4_HOS_C2_70,D_4_HOS_C2_71,D_4_HOS_C2_72,D_4_HOS_C2_73,D_4_HOS_C2_75,D_4_HOS_C2_76,D_4_HOS_C2_88,D_4_HOS_C2_90,D_4_HOS_C2_9201,D_4_HOS_C2_93,D_4_HOS_C2_97,D_4_HOS_C2_98,D_4_HOS_C3_51,D_4_HOS_C3_52,D_4_HOS_C3_55,D_4_HOS_C3_56,D_4_HOS_C3_57,D_4_HOS_C3_58,D_4_HOS_C3_62,D_4_HOS_C3_6250,D_4_HOS_C3_63,D_4_HOS_C3_64,D_4_HOS_C3_66,D_4_HOS_C3_67,D_4_HOS_C3_68,D_4_HOS_C3_70,D_4_HOS_C3_71,D_4_HOS_C3_72,D_4_HOS_C3_75,D_4_HOS_C3_88,D_4_HOS_C3_89,D_4_HOS_C3_9201,D_4_HOS_C3_97,D_4_HOS_C3_98,D_4_HOS_C4_50,D_4_HOS_C4_51,D_4_HOS_C4_52,D_4_HOS_C4_53,D_4_HOS_C4_54,D_4_HOS_C4_55,D_4_HOS_C4_56,D_4_HOS_C4_57,D_4_HOS_C4_58,D_4_HOS_C4_59,D_4_HOS_C4_60,D_4_HOS_C4_64,D_4_HOS_C4_65,D_4_HOS_C4_66,D_4_HOS_C4_67,D_4_HOS_C4_68,D_4_HOS_C4_69,D_4_HOS_C4_70,D_4_HOS_C4_71,D_4_HOS_C4_72,D_4_HOS_C4_73,D_4_HOS_C4_75,D_4_HOS_C4_76,D_4_HOS_C4_88,D_4_HOS_C4_89,D_4_HOS_C4_90,D_4_HOS_C4_91,D_4_HOS_C4_93,D_4_IPF_C11_50,D_4_IPF_C11_51,D_4_IPF_C11_52,D_4_IPF_C11_54,D_4_IPF_C11_55,D_4_IPF_C11_56,D_4_IPF_C11_57,D_4_IPF_C11_58,D_4_IPF_C11_59,D_4_IPF_C11_60,D_4_IPF_C11_62,D_4_IPF_C11_63,D_4_IPF_C11_64,D_4_IPF_C11_65,D_4_IPF_C11_66,D_4_IPF_C11_67,D_4_IPF_C11_68,D_4_IPF_C11_70,D_4_IPF_C11_71,D_4_IPF_C11_72,D_4_IPF_C11_75,D_4_IPF_C11_76,D_4_IPF_C11_90,D_4_IPF_C11_9201,D_4_IPF_C11_93,D_4_IPF_C13_50,D_4_IPF_C13_51,D_4_IPF_C13_52,D_4_IPF_C13_53,D_4_IPF_C13_54,D_4_IPF_C13_55,D_4_IPF_C13_56,D_4_IPF_C13_57,D_4_IPF_C13_58,D_4_IPF_C13_59,D_4_IPF_C13_60,D_4_IPF_C13_62,D_4_IPF_C13_63,D_4_IPF_C13_64,D_4_IPF_C13_65,D_4_IPF_C13_66,D_4_IPF_C13_67,D_4_IPF_C13_68,D_4_IPF_C13_69,D_4_IPF_C13_70,D_4_IPF_C13_71,D_4_IPF_C13_72,D_4_IPF_C13_73,D_4_IPF_C13_75,D_4_IPF_C13_76,D_4_IPF_C13_90,D_4_IPF_C13_91,D_4_IPF_C13_9201,D_4_IPF_C13_93,D_4_IRF_C11_51,D_4_IRF_C11_52,D_4_IRF_C11_55,D_4_IRF_C11_56,D_4_IRF_C11_57,D_4_IRF_C11_58,D_4_IRF_C11_59,D_4_IRF_C11_62,D_4_IRF_C11_63,D_4_IRF_C11_64,D_4_IRF_C11_66,D_4_IRF_C11_67,D_4_IRF_C11_68,D_4_IRF_C11_70,D_4_IRF_C11_71,D_4_IRF_C11_72,D_4_IRF_C11_75,D_4_IRF_C11_76,D_4_IRF_C11_90,D_4_IRF_C11_91,D_4_IRF_C11_9201,D_4_IRF_C11_93,D_4_IRF_C11_98,D_4_IRF_C13_50,D_4_IRF_C13_51,D_4_IRF_C13_53,D_4_IRF_C13_54,D_4_IRF_C13_55,D_4_IRF_C13_56,D_4_IRF_C13_57,D_4_IRF_C13_58,D_4_IRF_C13_59,D_4_IRF_C13_60,D_4_IRF_C13_62,D_4_IRF_C13_63,D_4_IRF_C13_65,D_4_IRF_C13_66,D_4_IRF_C13_68,D_4_IRF_C13_69,D_4_IRF_C13_70,D_4_IRF_C13_71,D_4_IRF_C13_72,D_4_IRF_C13_73,D_4_IRF_C13_75,D_4_IRF_C13_76,D_4_IRF_C13_90,D_4_IRF_C13_91,D_4_SNF_C11_50,D_4_SNF_C11_51,D_4_SNF_C11_52,D_4_SNF_C11_53,D_4_SNF_C11_54,D_4_SNF_C11_55,D_4_SNF_C11_56,D_4_SNF_C11_57,D_4_SNF_C11_58,D_4_SNF_C11_59,D_4_SNF_C11_60,D_4_SNF_C11_62,D_4_SNF_C11_63,D_4_SNF_C11_64,D_4_SNF_C11_65,D_4_SNF_C11_66,D_4_SNF_C11_67,D_4_SNF_C11_68,D_4_SNF_C11_69,D_4_SNF_C11_70,D_4_SNF_C11_71,D_4_SNF_C11_72,D_4_SNF_C11_73,D_4_SNF_C11_75,D_4_SNF_C11_76,D_4_SNF_C11_90,D_4_SNF_C11_91,D_4_SNF_C11_9201,D_4_SNF_C11_93,D_4_SNF_C13_73,D_5_HOS_C2_62,D_5_HOS_C2_6250,D_5_HOS_C2_96,D_5_HOS_C2_97,D_5_HOS_C2_98,D_5_HOS_C3_51,D_5_HOS_C3_52,D_5_HOS_C3_56,D_5_HOS_C3_59,D_5_HOS_C3_62,D_5_HOS_C3_6250,D_5_HOS_C3_64,D_5_HOS_C3_70,D_5_HOS_C3_75,D_5_HOS_C3_9201,D_5_HOS_C3_93,D_5_HOS_C3_96,D_5_HOS_C3_97,D_5_HOS_C3_98,D_5_HOS_C4_52,D_5_HOS_C4_53,D_5_HOS_C4_54,D_5_HOS_C4_55,D_5_HOS_C4_56,D_5_HOS_C4_57,D_5_HOS_C4_58,D_5_HOS_C4_62,D_5_HOS_C4_63,D_5_HOS_C4_64,D_5_HOS_C4_65,D_5_HOS_C4_66,D_5_HOS_C4_67,D_5_HOS_C4_68,D_5_HOS_C4_69,D_5_HOS_C4_70,D_5_HOS_C4_71,D_5_HOS_C4_72,D_5_HOS_C4_75,D_5_HOS_C4_98,D_5_HOS_C5_62,D_5_HOS_C5_6250,D_5_HOS_C5_96,D_5_HOS_C5_97,D_5_HOS_C5_98,D_5_HOS_C6_51,D_5_HOS_C6_52,D_5_HOS_C6_56,D_5_HOS_C6_59,D_5_HOS_C6_62,D_5_HOS_C6_6250,D_5_HOS_C6_64,D_5_HOS_C6_70,D_5_HOS_C6_75,D_5_HOS_C6_9201,D_5_HOS_C6_93,D_5_HOS_C6_96,D_5_HOS_C6_97,D_5_HOS_C6_98,D_5_HOS_C7_52,D_5_HOS_C7_53,D_5_HOS_C7_54,D_5_HOS_C7_55,D_5_HOS_C7_56,D_5_HOS_C7_57,D_5_HOS_C7_58,D_5_HOS_C7_62,D_5_HOS_C7_63,D_5_HOS_C7_64,D_5_HOS_C7_65,D_5_HOS_C7_66,D_5_HOS_C7_67,D_5_HOS_C7_68,D_5_HOS_C7_69,D_5_HOS_C7_70,D_5_HOS_C7_71,D_5_HOS_C7_72,D_5_HOS_C7_75,D_5_HOS_C7_98,E_B_HOS_C1_39,S3_1_C10_25,S3_1_C11_22,S3_1_C11_24,S3_1_C11_25,S3_1_C11_26,S3_1_C2_10,S3_1_C2_24,S3_1_C3_10,S3_1_C3_24,S3_1_C4_10,S3_1_C4_11,S3_1_C4_12,S3_1_C4_8,S3_1_C4_9,S3_1_C5_10,S3_1_C5_11,S3_1_C5_12,S3_1_C5_8,S3_1_C5_9,S3_1_C6_10,S3_1_C6_12,S3_1_C6_24,S3_1_C6_25,S3_1_C7_10,S3_1_C7_22,S3_1_C7_24,S3_1_C7_25,S3_1_C8_10,S3_1_C8_25,S3_1_C9_22,S3_1_C9_24,S3_1_C9_26,A7_3_C11_1,A7_3_C11_2,A7_3_C15_1,A7_3_C15_2,A7_3_C9_1,A7_3_C9_2,A8_C2_33,A_C1_10,A_C1_13,A_C1_14,A_C1_15,A_C1_16,A_C1_192,A_C1_5,A_C1_50,A_C1_54,A_C1_60,A_C1_65,A_C1_66,A_C1_67,A_C1_69,A_C1_7,A_C1_9,A_C1_91,A_C2_1,A_C2_10,A_C2_13,A_C2_14,A_C2_15,A_C2_16,A_C2_192,A_C2_2,A_C2_4,A_C2_5,A_C2_50,A_C2_53,A_C2_54,A_C2_57,A_C2_60,A_C2_65,A_C2_66,A_C2_69,A_C2_7,A_C2_9,A_C2_91,A_C6_11,A_C6_16,A_C6_2,A_C6_5,A_C6_50,A_C6_91,B_1_C0_1,B_1_C0_10,B_1_C0_11,B_1_C0_13,B_1_C0_14,B_1_C0_15,B_1_C0_16,B_1_C0_192,B_1_C0_194,B_1_C0_2,B_1_C0_4,B_1_C0_5,B_1_C0_50,B_1_C0_53,B_1_C0_54,B_1_C0_57,B_1_C0_60,B_1_C0_65,B_1_C0_66,B_1_C0_67,B_1_C0_69,B_1_C0_7,B_1_C0_71,B_1_C0_73,B_1_C0_9,B_1_C0_91,B_1_C26_190,B_1_C26_192,B_1_C26_194,B_1_C26_50,B_1_C26_53,B_1_C26_54,B_1_C26_57,B_1_C26_60,B_1_C26_65,B_1_C26_66,B_1_C26_67,B_1_C26_69,B_1_C26_71,B_1_C26_73,B_1_C26_91,B_2_C26_190,B_2_C26_192,B_2_C26_194,B_2_C26_50,B_2_C26_53,B_2_C26_54,B_2_C26_57,B_2_C26_60,B_2_C26_65,B_2_C26_66,B_2_C26_67,B_2_C26_69,B_2_C26_71,B_2_C26_73,B_2_C26_91,C_1_C6_50,C_1_C6_53,C_1_C6_54,C_1_C6_57,C_1_C6_60,C_1_C6_65,C_1_C6_66,C_1_C6_67,C_1_C6_69,C_1_C6_71,C_1_C6_73,C_1_C6_91,C_1_C7_50,C_1_C7_53,C_1_C7_54,C_1_C7_57,C_1_C7_60,C_1_C7_65,C_1_C7_66,C_1_C7_67,C_1_C7_69,C_1_C7_71,C_1_C7_73,C_1_C7_91,D3_HOS_C2_50,D3_HOS_C2_53,D3_HOS_C2_54,D3_HOS_C2_57,D3_HOS_C2_60,D3_HOS_C2_65,D3_HOS_C2_66,D3_HOS_C2_67,D3_HOS_C2_69,D3_HOS_C2_71,D3_HOS_C2_73,D3_HOS_C2_91,D3_HOS_C3_50,D3_HOS_C3_53,D3_HOS_C3_54,D3_HOS_C3_57,D3_HOS_C3_60,D3_HOS_C3_65,D3_HOS_C3_66,D3_HOS_C3_67,D3_HOS_C3_69,D3_HOS_C3_71,D3_HOS_C3_73,D3_HOS_C3_91,D_4_HOS_C10_50,D_4_HOS_C10_53,D_4_HOS_C10_54,D_4_HOS_C10_57,D_4_HOS_C10_60,D_4_HOS_C10_65,D_4_HOS_C10_66,D_4_HOS_C10_67,D_4_HOS_C10_69,D_4_HOS_C10_71,D_4_HOS_C10_73,D_4_HOS_C10_91,D_5_HOS_C3_50,D_5_HOS_C3_53,D_5_HOS_C3_54,D_5_HOS_C3_57,D_5_HOS_C3_60,D_5_HOS_C3_65,D_5_HOS_C3_66,D_5_HOS_C3_67,D_5_HOS_C3_69,D_5_HOS_C3_71,D_5_HOS_C3_73,D_5_HOS_C3_91,D_5_HOS_C6_50,D_5_HOS_C6_53,D_5_HOS_C6_54,D_5_HOS_C6_57,D_5_HOS_C6_60,D_5_HOS_C6_65,D_5_HOS_C6_66,D_5_HOS_C6_67,D_5_HOS_C6_69,D_5_HOS_C6_71,D_5_HOS_C6_73,D_5_HOS_C6_91,A7_3_C10_1,A7_3_C10_2,A7_3_C5_1,A7_3_C5_2,A7_3_C6_1,A7_3_C6_2,A7_3_C7_1,A7_3_C7_2,A_C1_17,A_C1_190,A_C1_191,A_C1_194,A_C1_23,A_C1_31,A_C1_34,A_C1_4,A_C1_51,A_C1_52,A_C1_53,A_C1_55,A_C1_57,A_C1_58,A_C1_59,A_C1_63,A_C1_90,A_C1_9201,A_C2_17,A_C2_190,A_C2_191,A_C2_194,A_C2_23,A_C2_31,A_C2_34,A_C2_51,A_C2_52,A_C2_55,A_C2_58,A_C2_59,A_C2_63,A_C2_71,A_C2_90,A_C6_1,A_C6_17,A_C6_31,A_C6_4,A_C6_52,A_C6_53,A_C6_54,A_C6_55,A_C6_59,A_C6_60,A_C6_65,A_C6_69,A_C6_7,A_C6_71,A_C6_9,A_C6_9201,B_1_C0_17,B_1_C0_190,B_1_C0_191,B_1_C0_23,B_1_C0_31,B_1_C0_34,B_1_C0_51,B_1_C0_52,B_1_C0_55,B_1_C0_58,B_1_C0_59,B_1_C0_63,B_1_C0_72,B_1_C0_8,B_1_C0_90,B_1_C0_9201,B_1_C26_191,B_1_C26_31,B_1_C26_34,B_1_C26_51,B_1_C26_52,B_1_C26_55,B_1_C26_58,B_1_C26_59,B_1_C26_63,B_1_C26_72,B_1_C26_90,B_1_C26_9201,B_2_C26_191,B_2_C26_31,B_2_C26_34,B_2_C26_51,B_2_C26_52,B_2_C26_55,B_2_C26_58,B_2_C26_59,B_2_C26_63,B_2_C26_72,B_2_C26_90,B_2_C26_9201,C_1_C5_31,C_1_C5_34,C_1_C5_50,C_1_C5_51,C_1_C5_52,C_1_C5_53,C_1_C5_54,C_1_C5_55,C_1_C5_57,C_1_C5_58,C_1_C5_59,C_1_C5_60,C_1_C5_63,C_1_C5_65,C_1_C5_66,C_1_C5_69,C_1_C5_71,C_1_C5_72,C_1_C5_73,C_1_C5_90,C_1_C5_91,C_1_C5_9201,C_1_C6_31,C_1_C6_34,C_1_C6_51,C_1_C6_52,C_1_C6_55,C_1_C6_58,C_1_C6_59,C_1_C6_63,C_1_C6_72,C_1_C6_90,C_1_C6_9201,C_1_C7_51,C_1_C7_52,C_1_C7_55,C_1_C7_58,C_1_C7_59,C_1_C7_63,C_1_C7_72,C_1_C7_90,C_1_C7_9201,D1_HOS_C5_43,D3_HOS_C2_31,D3_HOS_C2_34,D3_HOS_C2_51,D3_HOS_C2_52,D3_HOS_C2_55,D3_HOS_C2_58,D3_HOS_C2_59,D3_HOS_C2_63,D3_HOS_C2_72,D3_HOS_C2_90,D3_HOS_C2_9201,D3_HOS_C3_51,D3_HOS_C3_52,D3_HOS_C3_55,D3_HOS_C3_58,D3_HOS_C3_59,D3_HOS_C3_63,D3_HOS_C3_72,D3_HOS_C3_90,D3_HOS_C3_9201,D_1_HOS_C4_31,D_1_HOS_C4_34,D_1_HOS_C6_31,D_1_HOS_C6_34,D_1_HOS_C7_31,D_1_HOS_C7_34,D_4_HOS_C10_51,D_4_HOS_C10_52,D_4_HOS_C10_55,D_4_HOS_C10_58,D_4_HOS_C10_59,D_4_HOS_C10_63,D_4_HOS_C10_72,D_4_HOS_C10_90,D_4_HOS_C10_9201,D_4_HOS_C11_60,D_4_HOS_C12_50,D_4_HOS_C12_51,D_4_HOS_C12_52,D_4_HOS_C12_53,D_4_HOS_C12_54,D_4_HOS_C12_55,D_4_HOS_C12_57,D_4_HOS_C12_58,D_4_HOS_C12_59,D_4_HOS_C12_60,D_4_HOS_C12_63,D_4_HOS_C12_65,D_4_HOS_C12_66,D_4_HOS_C12_69,D_4_HOS_C12_71,D_4_HOS_C12_72,D_4_HOS_C12_73,D_4_HOS_C12_90,D_4_HOS_C12_91,D_4_HOS_C12_9201,D_4_HOS_C13_60,D_4_HOS_C3_60,D_5_HOS_C2_50,D_5_HOS_C2_51,D_5_HOS_C2_52,D_5_HOS_C2_53,D_5_HOS_C2_54,D_5_HOS_C2_55,D_5_HOS_C2_57,D_5_HOS_C2_58,D_5_HOS_C2_59,D_5_HOS_C2_60,D_5_HOS_C2_63,D_5_HOS_C2_65,D_5_HOS_C2_66,D_5_HOS_C2_69,D_5_HOS_C2_71,D_5_HOS_C2_72,D_5_HOS_C2_73,D_5_HOS_C2_90,D_5_HOS_C2_91,D_5_HOS_C2_9201,D_5_HOS_C4_73,D_5_HOS_C5_50,D_5_HOS_C5_51,D_5_HOS_C5_52,D_5_HOS_C5_53,D_5_HOS_C5_54,D_5_HOS_C5_55,D_5_HOS_C5_57,D_5_HOS_C5_58,D_5_HOS_C5_59,D_5_HOS_C5_60,D_5_HOS_C5_63,D_5_HOS_C5_65,D_5_HOS_C5_66,D_5_HOS_C5_69,D_5_HOS_C5_71,D_5_HOS_C5_72,D_5_HOS_C5_73,D_5_HOS_C5_90,D_5_HOS_C5_91,D_5_HOS_C5_9201,D_5_HOS_C7_73,S3_1_C2_11,S3_1_C2_8,S3_1_C3_11,S3_1_C3_8,S3_1_C6_11,S3_1_C6_8,S3_1_C7_11,S3_1_C7_8,S3_1_C8_11,S3_1_C8_8,A_C1_68,A_C2_67,A_C2_68,A_C2_73,A_C2_8,B_1_C0_68,B_1_C26_68,B_2_C26_68,C_1_C5_67,C_1_C5_68,C_1_C6_68,D3_HOS_C2_68,D3_HOS_C3_68,D_4_HOS_C10_68,A_C1_71,A_C1_88,A_C2_88,A_C6_194,B_1_C0_88,B_1_C26_88,B_2_C26_88,C_1_C5_88,C_1_C7_88,D3_IPF_C2_50,D3_IPF_C3_50,D3_SNF_C2_54,D3_SNF_C2_60,D3_SNF_C2_66,D3_SNF_C2_73,D3_SNF_C3_54,D3_SNF_C3_60,D3_SNF_C3_66,D3_SNF_C3_73,S3_1_C10_26,S3_1_C6_26,S3_1_C8_26,A_C1_8,A_C6_10,A_C6_90,D_5_HOS_C3_72,D_5_HOS_C3_90,D_5_HOS_C6_72,D_5_HOS_C6_90,A_C1_101,A_C1_116,A_C1_193,A_C1_73,A_C1_76,A_C2_101,A_C2_116,A_C2_18,A_C2_193,A_C2_72,A_C2_76,A_C6_14,A_C6_66,A_C6_73,B_1_C0_101,B_1_C0_116,B_1_C0_18,B_1_C0_193,B_1_C0_76,B_1_C26_101,B_1_C26_116,B_1_C26_193,B_1_C26_76,B_2_C26_101,B_2_C26_116,B_2_C26_193,B_2_C26_76,C_1_C5_101,C_1_C5_116,C_1_C5_76,C_1_C7_101,C_1_C7_116,C_1_C7_68,C_1_C7_76,D_4_HOS_C12_67,D_4_HOS_C12_68,D_4_HOS_C12_76,D_5_HOS_C2_67,D_5_HOS_C2_68,D_5_HOS_C2_76,D_5_HOS_C4_90,D_5_HOS_C5_67,D_5_HOS_C5_68,D_5_HOS_C5_76,D_5_HOS_C7_90,S3_1_C10_22,S3_1_C10_24,S3_1_C6_22,S3_1_C8_22,S3_1_C8_24,A_C1_20,A_C1_32,A_C1_35,A_C1_6,A_C1_64,A_C2_20,A_C2_32,A_C2_35,A_C2_6,A_C6_15,A_C6_20,A_C6_23,A_C6_32,A_C6_34,A_C6_35,A_C6_6,A_C6_76,A_C6_8,B_1_C0_20,B_1_C0_21,B_1_C0_32,B_1_C0_35,B_1_C0_6,B_1_C0_64,B_1_C21_21,B_1_C21_32,B_1_C21_34,B_1_C21_35,B_1_C21_50,B_1_C21_90,B_1_C21_91,B_1_C26_32,B_1_C26_35,B_1_C26_64,B_2_C26_32,B_2_C26_35,B_2_C26_64,C_1_C5_32,C_1_C5_35,C_1_C5_64,C_1_C6_32,C_1_C6_35,C_1_C6_64,C_1_C6_76,C_1_C7_64,D3_HOS_C2_32,D3_HOS_C2_64,D3_HOS_C2_76,D3_HOS_C3_64,D3_HOS_C3_76,D3_IRF_C2_54,D3_IRF_C2_57,D3_IRF_C2_60,D3_IRF_C2_64,D3_IRF_C2_65,D3_IRF_C2_66,D3_IRF_C2_67,D3_IRF_C2_68,D3_IRF_C2_69,D3_IRF_C2_73,D3_IRF_C2_76,D3_IRF_C2_90,D3_IRF_C3_54,D3_IRF_C3_57,D3_IRF_C3_60,D3_IRF_C3_64,D3_IRF_C3_65,D3_IRF_C3_66,D3_IRF_C3_67,D3_IRF_C3_68,D3_IRF_C3_69,D3_IRF_C3_73,D3_IRF_C3_76,D3_IRF_C3_90,D_1_HOS_C4_32,D_1_HOS_C4_35,D_1_HOS_C6_32,D_1_HOS_C7_32,D_3_HOS_C9_32,D_3_HOS_C9_34,D_4_HOS_C10_64,D_4_HOS_C10_76,D_4_HOS_C11_50,D_4_HOS_C11_54,D_4_HOS_C11_73,D_4_HOS_C11_91,D_4_HOS_C12_64,D_4_HOS_C13_50,D_4_HOS_C13_54,D_4_HOS_C13_73,D_4_HOS_C13_91,D_4_HOS_C2_50,D_4_HOS_C2_52,D_4_HOS_C2_91,D_4_HOS_C3_54,D_4_HOS_C3_73,D_4_IRF_C11_54,D_4_IRF_C11_60,D_4_IRF_C11_73,D_5_HOS_C2_64,D_5_HOS_C5_64,S3_1_C2_9,S3_1_C3_9,S3_1_C6_9,S3_1_C7_9,S3_1_C8_9,A_C1_56,A_C1_70,A_C2_56,A_C2_70,A_C6_13,A_C6_51,A_C6_56,A_C6_57,A_C6_58,B_1_C0_56,B_1_C0_70,B_1_C26_56,B_1_C26_70,B_2_C26_56,B_2_C26_70,C_1_C5_56,C_1_C5_70,C_1_C6_56,C_1_C6_70,C_1_C7_56,C_1_C7_70,D3_HOS_C2_56,D3_HOS_C2_70,D3_HOS_C3_56,D3_HOS_C3_70,D_4_HOS_C10_56,D_4_HOS_C10_70,D_5_HOS_C3_55,D_5_HOS_C3_58,D_5_HOS_C3_68,D_5_HOS_C4_91,D_5_HOS_C6_55,D_5_HOS_C6_58,D_5_HOS_C6_68,D_5_HOS_C7_91,A_C1_75,A_C2_75,B_1_C0_75,B_1_C26_75,B_2_C26_75,C_1_C5_75,C_1_C6_75,C_1_C7_75,D3_HOS_C2_75,D3_HOS_C3_75,D_4_HOS_C10_75,D_4_HOS_C12_56,D_4_HOS_C12_75,D_5_HOS_C2_56,D_5_HOS_C2_75,D_5_HOS_C5_56,D_5_HOS_C5_75,A_C1_21,A_C1_93,A_C2_21,A_C2_93,A_C6_19,A_C6_190,A_C6_21,A_C6_22,B_1_C0_22,B_1_C0_93,B_1_C21_190,B_1_C21_31,B_1_C21_52,B_1_C21_93,B_1_C22_190,B_1_C22_31,B_1_C22_50,B_1_C22_52,B_1_C22_90,B_1_C22_91,B_1_C22_93,B_1_C26_93,B_2_C26_93,C_1_C5_93,C_1_C6_93,C_1_C7_93,D3_HOS_C2_93,D3_HOS_C3_93,D3_IPF_C2_51,D3_IPF_C2_53,D3_IPF_C2_54,D3_IPF_C2_57,D3_IPF_C2_58,D3_IPF_C2_60,D3_IPF_C2_65,D3_IPF_C2_66,D3_IPF_C2_69,D3_IPF_C2_71,D3_IPF_C2_72,D3_IPF_C2_73,D3_IPF_C2_91,D3_IPF_C3_51,D3_IPF_C3_53,D3_IPF_C3_54,D3_IPF_C3_57,D3_IPF_C3_58,D3_IPF_C3_60,D3_IPF_C3_65,D3_IPF_C3_66,D3_IPF_C3_69,D3_IPF_C3_71,D3_IPF_C3_72,D3_IPF_C3_73,D3_IPF_C3_91,D3_IRF_C2_50,D3_IRF_C2_51,D3_IRF_C2_53,D3_IRF_C2_55,D3_IRF_C2_58,D3_IRF_C2_71,D3_IRF_C2_72,D3_IRF_C3_50,D3_IRF_C3_51,D3_IRF_C3_53,D3_IRF_C3_55,D3_IRF_C3_58,D3_IRF_C3_71,D3_IRF_C3_72,D_3_HOS_C9_31,D_4_HOS_C10_93,D_4_HOS_C11_53,D_4_HOS_C11_59,D_4_HOS_C11_65,D_4_HOS_C11_69,D_4_HOS_C11_76,D_4_HOS_C11_90,D_4_HOS_C11_93,D_4_HOS_C12_93,D_4_HOS_C13_53,D_4_HOS_C13_59,D_4_HOS_C13_65,D_4_HOS_C13_69,D_4_HOS_C13_76,D_4_HOS_C13_90,D_4_HOS_C13_93,D_4_HOS_C3_50,D_4_HOS_C3_53,D_4_HOS_C3_59,D_4_HOS_C3_65,D_4_HOS_C3_69,D_4_HOS_C3_76,D_4_HOS_C3_90,D_4_HOS_C3_91,D_4_HOS_C3_93,D_4_IPF_C11_53,D_4_IPF_C11_69,D_4_IPF_C11_73,D_4_IPF_C11_91,D_4_IRF_C11_50,D_4_IRF_C11_53,D_4_IRF_C11_65,D_4_IRF_C11_69,D_5_HOS_C2_93,D_5_HOS_C4_50,D_5_HOS_C4_51,D_5_HOS_C4_59,D_5_HOS_C4_9201,D_5_HOS_C4_93,D_5_HOS_C5_93,D_5_HOS_C7_50,D_5_HOS_C7_51,D_5_HOS_C7_59,D_5_HOS_C7_9201,D_5_HOS_C7_93,S3_1_C2_12,S3_1_C3_12,S3_1_C7_12,S3_1_C8_12,D_4_HOS_C12_70,D_5_HOS_C2_70,D_5_HOS_C5_70,D_5_HOS_C4_76,D_5_HOS_C7_76,D_5_HOS_C4_60,D_5_HOS_C7_60,D3_IPF_C2_68,D3_IPF_C3_68,D_5_HOS_C3_63,D_5_HOS_C3_76,D_5_HOS_C6_63,D_5_HOS_C6_76,S3_1_C7_26,Lat,Lon,"Control type, text","Hospital type, text",Num and Name
,Report Record Number,Hospital Provider Number ,Fiscal Intermediary Number,Fiscal Intermediary/MAC Create Date,Fiscal Year Begin Date ,Fiscal Year End Date ,Utilization Code (L/N/F),SSA State Code,SSA State County Code,Census Division Code,CMS Region Code,Geographic MSA,Land ,Total,Land Improvements,Buildings and Fixtures,Building Improvements,Fixed Equipment,Movable Equipment,Donations,Subtotal,Land Improvements,Building Improvements,Disp. And Retirement,Land ,Total,Land Improvements,Buildings and Fixtures,Building Improvements,Fixed Equipment,Movable Equipment,Assets,Subtotal,"Sale of scrap, waste, etc. ",Rental of quarters to employee and oths,Sale of medical and surgical supplies to ,Nursing School,Vending Machines,Utilization Review-physicians compens,Depreciation-New Bldgs & Fixtures,Depreciation-New Movable Equipment,Physicians' Assistant,Investment Income-Other,Adj for Occupational therapy in excess of li,Adj for Speech therapy in excess of lim,Refunds and Rebates of Expenses,Parking Lot,Int & Res (non approved teaching program,Kidney Acquisition,Heart Acquisition,Liver Acquisition,Lung  Acquisition,Pancreas Acquisition,Intestinal Acquisition,Islet Acquisition,Utilization Review SNF,Subprovider I,Subprovider II,NF,ICF,OLTC,Home Program Dialysis,Int & Res (non approved teaching program,Kidney Acquisition,Heart Acquisition,Liver Acquisition,Lung  Acquisition,Pancreas Acquisition,Intestinal Acquisition,Islet Acquisition,Utilization Review SNF,Subprovider I,Subprovider II,NF,ICF,OLTC,PBP Clinical Lab Services Program Only,Home Program Dialysis,Int & Res (non approved teaching program,Kidney Acquisition,Heart Acquisition,Liver Acquisition,Lung  Acquisition,Pancreas Acquisition,Intestinal Acquisition,Islet Acquisition,Utilization Review SNF,Subprovider I,Subprovider II,NF,ICF,OLTC,PBP Clinical Lab Services Program Only,Renal Dialysis,Home Program Dialysis,Ambulance Services,Int & Res (non approved teaching program,Kidney Acquisition,Heart Acquisition,Liver Acquisition,Lung  Acquisition,Pancreas Acquisition,Intestinal Acquisition,Islet Acquisition,Subprovider I,Subprovider II,NF,ICF,OLTC,PBP Clinical Lab Services Program Only,Home Program Dialysis,Int & Res (non approved teaching program,Kidney Acquisition,Heart Acquisition,Liver Acquisition,Lung  Acquisition,Pancreas Acquisition,Subprovider-IPF,Subprovider I,SNF,NF,OLTC,Renal Dialysis,Home Program Dialysis,Ambulance Services,Int & Res (non approved teaching program,Kidney Acquisition,Heart Acquisition,Liver Acquisition,Lung  Acquisition,Pancreas Acquisition,Intestinal Acquisition,Islet Acquisition,Subprovider-IPF,Subprovider I,Nursery,SNF,NF,OLTC,Renal Dialysis,Home Program Dialysis,Ambulance Services,Int & Res (non approved teaching program,Kidney Acquisition,Heart Acquisition,Liver Acquisition,Lung  Acquisition,Pancreas Acquisition,Intestinal Acquisition,Islet Acquisition,Subprovider I,Subprovider II,NF,ICF,OLTC,PBP Clinical Lab Services Program Only,Home Program Dialysis,Int & Res (non approved teaching program,Kidney Acquisition,Heart Acquisition,Liver Acquisition,Lung  Acquisition,Pancreas Acquisition,Intestinal Acquisition,Islet Acquisition,Subprovider I,Subprovider II,NF,ICF,OLTC,Home Program Dialysis,Int & Res (non approved teaching program,Kidney Acquisition,Heart Acquisition,Liver Acquisition,Lung  Acquisition,Pancreas Acquisition,Intestinal Acquisition,Islet Acquisition,Subprovider I,Subprovider II,NF,ICF,OLTC,PBP Clinical Lab Services Program Only,Home Program Dialysis,Int & Res (non approved teaching program,Kidney Acquisition,Heart Acquisition,Liver Acquisition,Lung  Acquisition,Pancreas Acquisition,Intestinal Acquisition,Islet Acquisition,Subprovider I,Subprovider II,NF,ICF,OLTC,PBP Clinical Lab Services Program Only,Home Program Dialysis,Int & Res (non approved teaching program,Kidney Acquisition,Heart Acquisition,Liver Acquisition,Lung  Acquisition,Pancreas Acquisition,Intestinal Acquisition,Islet Acquisition,PBP Clinical Lab Services Program Only,Home Program Dialysis,Program Discharges,Target Amount per Discharge,Target Amount   ,Operating Cost and Target Amount,Bonus Payment,Relief Payment,Allowable Inpatient Cost Plus Incentive Pt,Utilization Review - Physician Compen,Subprovider-IPF,Subprovider-IRF,Subprovider I,Nursery,PBP Clinical Lab Services Program Only,Home Program Dialysis,PBP Clinical Lab Services Program Only,Home Program Dialysis,Subprovider-IRF,Subprovider I,Renal Dialysis,Home Program Dialysis,Renal Dialysis,Home Program Dialysis,Subprovider-IRF,PBP Clinical Lab Services Program Only,Home Program Dialysis,PBP Clinical Lab Services Program Only,Home Program Dialysis,Adults and Pediatrics,Subprovider-IPF,Subprovider-IRF,Renal Dialysis,Home Program Dialysis,Renal Dialysis,Home Program Dialysis,Subprovider I,Subprovider II,Total Other Medical Education Cost,Subprovider-IRF,SNF,Renal Dialysis,Home Program Dialysis,Home Program Dialysis,Renal Dialysis,Total ,Renal Dialysis,Home Program Dialysis,Renal Dialysis,Home Program Dialysis,Total Other Medical Education,Renal Dialysis,Renal Dialysis,Total ,Renal Dialysis,Total Nonphysician Anesthetist Cost,Total Nursing School,Total Other Medical Education,Renal Dialysis,Total ,Renal Dialysis,Total Other Medical Education,Total ,Renal Dialysis,Total ,Home Program Dialysis,PBP Clinical Lab Services Program Only,Home Program Dialysis,Ambulance Services,Home Program Dialysis,PBP Clinical Lab Services Program Only,Home Program Dialysis,Ambulance Services,Home Program Dialysis,Medical and Other Services reimbursed by OPPS,OPPS payments,Outlier payments,Line 2 times line 5,"Sum of lines 3,4 divided by line 6",Transitional corridor payment,Organ acquisition,Organ acquisition charges,Aggregate amount collected from patients,Amounts expected under 42 CFR ,Ratio of line 15 to line 16,Interns and residents,Cost of physicians svcs in a teaching hospita,Component rate ESRD,Partial or full credits from manufacturers,Sequestration adjustment,Tentative settlement,Transitional corridor payment,Number of periods hospital was in MDH status,Total Subprovider I Interns & Residents,Total Subprovider II Interns & Residents,NF,ICF,OLTC,Total Hospital Interns & Residents,SNF,OLTC,Total Facility FTEs ,Subprovider 1,Subprovider 2,NF,ICF,OLTC,Subprovider 1,Subprovider 2,NF,ICF,OLTC,Hospital Adults & Pediatrics,Nursery,Total Hospital,IPF,IRF,SNF,NF,Total Hospital,RPCH/CAH Visits,RPCH/CAH Visits,Subprovider 1,Subprovider 2,NF,ICF,Hospital Adlts & Ped Swing Bed SNF,CAH Visits,Subprovider 1,Subprovider 2,NF,ICF,OLTC,Total Subprovider I Interns & Residents,SNF,NF,OLTC,Home Office Salaries & Wage Related Csts,Related  Salaries ,Teaching Physician Salaries,Wage Related Costs Other,Non-Physician Anesthetist Part A,Non-Physician Anesthetist Part A,Physician Part A,Interns & Residents,Interns & Residents,Cafeteria,Maintenance of Personnel,Other General Service,Home Office Personnel,SNF,Home Office Salaries & Wage Related Csts,Home Office Salaries,Related Salaries,Physician Part A,Physician Part A Teaching,Physician Part B,Wage Related Costs RHC/FQHC,Interns & Residents,Interns & Residents,Interns & Residents,Interns & Residents,Interns & Residents,Home Office Salaries & Wage Related Csts,Related Salaries,Teaching Physician Salaries,Wage Related Costs Other,Non-Physician Anesthetist Part A,Non-Physician Anesthetist Part A,Physician Part A Teaching,Interns & Residents,Interns & Residents,Maintenance of Personnel,Other General Service,Home Office Personnel,SNF,Home Office Salaries & Wage Related Csts,Teaching Physician Salaries,Non-Physician Anesthetist Part A,Maintenance of Personnel,Other General Service,Home Office Personnel,SNF,Home Office Salaries & Wage Related Csts,Related Salaries ,Teaching Physician Salaries,Non-Physician Anesthetist Part A,Maintenance of Personnel,Other General Service,Home Office Personnel,SNF,Without Outliers:  Other Charges,With Outliers:  Other Charges  ,LUPA Episodes:  Other Charges,PEP Episodes:  Other Charges ,PEP Episodes:  Total Number of Episodes  ,PEP:  Total Non Routine Med Supply Chgs,Total Other Charges,Without Outliers:  Total Visits,Without Outliers:  Other Charges,Without Outliers:  Total Charges,W/Out Outliers:  Number of Episodes,Without Outliers:  Non Routine Med Sup Chgs,With Outliers:  Total Visits,With Outliers:  Other Charges  ,With Outliers:  Total Charges,With Outliers:  Number of Episodes,With Outliers:  Non Routine Med Sup Chgs,LUPA Episodes:  Total Visits,LUPA Episodes:  Other Charges,Total Charges:  LUPA Episodes,LUPA Episodes:  Total Number of Episodes,LUPA:  Total Non Routine Med Sup Chgs,PEP Episodes:  Total Visits,PEP Episodes:  Other Charges ,PEP Episodes:  Total Charges:,PEP Episodes:  Total Number of Episodes  ,PEP:  Total Number of Outlier Episodes,PEP:  Total Non Routine Med Supply Chgs,Total Visits,Total Other Charges,Total Charges ,Total Number of Episodes,Total Number of Outlier Episodes,Total Non Routine Medical  Supply Charges,Without Outliers:  Total Visits,Without Outliers:  Other Charges,Without Outliers:  Total Charges,W/Out Outliers:  Number of Episodes,Without Outliers:  Non Routine Med Sup Chgs,With Outliers:  Total Visits,With Outliers:  Other Charges  ,With Outliers:  Total Charges,With Outliers:  Number of Episodes,With Outliers:  Non Routine Med Sup Chgs,LUPA Episodes:  Total Visits,LUPA Episodes:  Other Charges,Total Charges:  LUPA Episodes,LUPA Episodes:  Total Number of Episodes,LUPA:  Total Non Routine Med Sup Chgs,PEP Episodes:  Total Visits,PEP Episodes:  Other Charges ,PEP Episodes:  Total Charges:,PEP Episodes:  Total Number of Episodes  ,PEP:  Total Number of Outlier Episodes,PEP:  Total Non Routine Med Supply Chgs,Total Visits,Total Other Charges,Total Charges ,Total Number of Episodes,Total Number of Outlier Episodes,Total Non Routine Medical  Supply Charges,"Percentage of patients re-using
dialyzers","Epoietin amount form worksheet A
for home dialysis program",Number of EPO units furnished for Line 13,Utilization,Average times dialyzers re-used,"Percentage of patients re-using
dialyzers",Utilization,Average times dialyzers re-used,"Number of Times per week 
Patient receives Dialysis","Average patient dialysis time 
including setup",Number of stations,"Number of Times per week
 Patient receives Dialysis","Average patient dialysis time 
including setup",CAPD exchanges per day,Number of stations,"Number of days in year dialysis 
furnished","Number of Times per week
 Patient receives Dialysis",CAPD exchanges per day,Land ,Total,Buildings and Fixtures,Movable Equipment,Subtotal,Total,Movable Equipment,Subtotal,Total,Total,Total,Provider-based physician adjustment,Cafeteria employees and guests,Sale of medical records and abstracts,Investment Income-New Movable Equip,Interest expense on Medicare Overpaymts,Total,Telephone Services,Television and Radio Service,Total Salaries,Adults and Pediatrics,Interest Expense,Total Salaries,Adults and Pediatrics,Total Salaries,Adults and Pediatrics,Total,Adults and Pediatrics,Total  ,Adults and Pediatrics,Total  ,Adults & Pediatrics,Total,Total,Adults & Pediatrics,Total,Total,Total Swing Bed Cost,net of Swing Bed Cost,net of Swing Bed and Private Room Diff,Total Program General Inpatient Routine ,Program Inpatient Ancillary Service Cost,Total Program Inpatient Costs,Adults and Pediatrics,TOTAL,Total ,Total ,Medical and Other Services,Deductibles and coinsurance,Deductibles and coinsurance related to line 24,Subtotal,Subtotal,Subtotal,Subtotal,Subtotal,Interim payments,Balance due provider/program, ,Urban (1) or Rural (2),Total Hospital Interns & Residents,Total Facility FTEs ,Hospital Adults & Pediatrics,Total Hospital,Total Facility,Total,Hospital Adults & Pediatrics,Total Hospital,Total Hospital,Hospital Adults & Pediatrics,Total Hospital,Total Hospital,Hospital Adults & Pediatrics,Total Hospital,HMO,Hospital Adults & Ped Swing Bed SNF,Total Adults & Peds,Hospital Adults & Pediatrics,Total Hospital,Medicaid Observation Days,Hospital Adlts & Ped Swing Bed SNF,Hospital Adlts & Ped Swing Bed NF,Total Adults & Pediatrics,Land Improvements,Building Improvements,Fixed Equipment,Begin Balance,Land ,Land Improvements,Buildings and Fixtures,Building Improvements,Purchase,Total,Total,Movable Equipment,Subtotal,Ending Balance,Total,Total,Total,Total,Investment Income-New Bldgs & Fixtures,Nursery,Other Capital,Nursery,Other Capital,Nursery,Nursery,Nursery,Cross Foot Adjustments,Nursery,Subtotal,Less Observation Beds,Total,Adults & Pediatrics,Nursery,Nursery,Pass through Cost for Program Inpatient Routine ,Pass Through Cost for  Program Ancillary,Total Program Excludable Costs,"Anesthetist, and Medical Education Costs",Total,Adults & Pediatrics,Nursery,Total,Adults & Pediatrics,Total,Adults & Pediatrics,Total Patient Days,Total Inpatient Program Days,Total ,Total ,Total ,Total Allied Health,Total Outpatient Program Pass Thru Cost,Total ,Total ,Total ,Total ,Ancillary service charges,Total reasonable charges,Total customary charges,Excess of customary charges,Medical and Other Services reimbursed by OPPS,Total prospective payment,OPPS payments,Primary payer payments,Allowable bad debts,Adjusted reimburseable bad debts,Allowable bad debts for dual eligibles beneficiaries,Outlier payments,Premiums,In State Medicaid paid days,Medicaid HMO Days,Labor and Delivery,Labor and Delivery,Labor and Delivery Days Title 18,Hospital Adults & Pediatrics,Nursery,Total Hospital,HMO,Labor and Delivery Days -  Title XIX,Total Adults & Peds,Nursery,Labor and Delivery Days -  Title XIX,Total Salaries,Excluded Area Salaries,Contract Labor,Contract Labor: Pysician Part A,Wage Related Costs Core,Excluded Areas ,Non-Physician Anesthetist Part B,Physician Part A,Physician Part B,Employee Benefits,Administrative and General,Administrative & General under contract ,Non-Physician Anesthetist Part B,Operation of Plant,Housekeeping,Dietary,Nursing Administration,Central Services and Supply,Physician-Part A,Pharmacy   ,Medical Records & Med Records Library,Social Service,Physician-Part B,Total Salaries,Excluded Area Salaries,Contract Labor,Contract Labor:  Physician Part A,Wage Related Costs Core,Excluded Areas ,Non-Physician Anesthetist Part B,Physician Part A,Physician Part B,Employee Benefits,Administrative and General,Administrative & General under contract ,Non-Physician Anesthetist Part B,Operation of Plant,Housekeeping,Dietary,Cafeteria,Nursing Administration,Central Services and Supply,Physician-Part A,Pharmacy   ,Medical Records & Med Records Library,Social Service,Physician-Part B,Total Salaries,Excluded Area Salaries,Contract Labor,Contract Labor:  Physician Part A,Employee Benefits,Administrative and General,Administrative and General under Contract,Non-Physician Anesthetist Part B,Operation of Plant,Housekeeping,Dietary   ,Cafeteria,Nursing Administration,Central Services and Supply,Physician-Part A,Pharmacy   ,Medical Records & Med Records Library,Social Service,Physician-Part B,Total Salaries,Excluded Area Salaries,Contract Labor,Contract Labor:  Physician Part A,Employee Benefits,Administrative and General,Administrative and General under Contract,Non-Physician Anesthetist Part B,Operation of Plant,Housekeeping,Dietary,Cafeteria,Nursing Administration,Central Services and Supply,Physician-Part A,Pharmacy   ,Medical Records & Med Records Library,Social Service,Physician-Part B,Net Salaries,Excluded Area Salaries,Subtotal Salaries,Subtotal Other Wages and Related Csts,Subtotal Wage Related Csts,Total,Net Salaries,Excluded Area Salaries,Subtotal Salaries,Subtotal Other Wages and Related Csts,Subtotal Wage Related Csts,Total,Total Overhead Costs,Net Salaries,Excluded Area Salaries,Subtotal Salaries,Subtotal Other Wages and Related Csts,Total,Total Overhead Costs,Net Salaries,Excluded Area Salaries,Subtotal Salaries,Subtotal Other Wages and Related Csts,Subtotal Wage Related Csts,Total,Total Overhead Costs,Related Organization Transactions,SNF,Ambulance Services,Subprovider-IPF,SNF,Ambulance Services,Subprovider-IPF,SNF,Ambulance Services,Subprovider-IPF,SNF,Ambulance Services,SNF,Ambulance Services,Subprovider-IPF,SNF,Ambulance Services,Subprovider-IPF,SNF,Ambulance Services,net of Swing Bed Cost,net of Swing Bed and Private Room Diff,Program Inpatient Ancillary Service Cost,Total Program Inpatient Costs,"Anesthetist, and Medical Education Costs",net of Swing Bed and Private Room Diff,Total Program General Inp. Rtn Service ,Program Ancillary Services ,TOTAL,TOTAL,TOTAL,TOTAL,SNF,SNF,SNF,SNF,SNF,SNF,SNF,Buildings and Fixtures,Fixed Equipment,"Trade, Quantity, and Time Discounts",Interest Expense,Negative Cost Centers,Renal Dialysis,Renal Dialysis,Renal Dialysis,Renal Dialysis,Renal Dialysis,Renal Dialysis,Renal Dialysis,Renal Dialysis,Renal Dialysis,Renal Dialysis,Renal Dialysis,Renal Dialysis,Renal Dialysis,Renal Dialysis,Renal Dialysis,Renal Dialysis,Renal Dialysis,Line 2 times line 5,"Sum of lines 3,4 divided by line 6","If (SCH), enter the # of periods.",Other Medicaid Days,Ambulance Trips,Management and Administrative Services,Home Office Salaries,Interns & Residents,Laundry and Linen Service,Housekeeping under contract  ,Management and Administrative Services,Home Office Salaries,Interns & Residents,Laundry and Linen Service,Housekeeping under contract  ,Management and Administrative Services,Laundry and Linen Service,Housekeeping under Contract,Management and Administrative Services,Home Office Salaries,Laundry and Linen Service,Housekeeping under Contract,Without Outliers:  Total Visits,Without Outliers:  Total Charges,W/Out Outliers:  Number of Episodes,Without Outliers:  Non Routine Med Sup Chgs,With Outliers:  Total Visits,With Outliers:  Total Charges,With Outliers:  Number of Episodes,With Outliers:  Non Routine Med Sup Chgs,LUPA Episodes:  Total Visits,Total Charges:  LUPA Episodes,LUPA Episodes:  Total Number of Episodes,LUPA:  Total Non Routine Med Sup Chgs,PEP Episodes:  Total Visits,PEP Episodes:  Total Charges:,PEP:  Total Number of Outlier Episodes,Total Visits,Total Charges ,Total Number of Episodes,Total Number of Outlier Episodes,Total Non Routine Medical  Supply Charges,"Number of patients on transplant 
list","Number of patients transplanted 
during fiscal year",Number of Times per week Patient receives Dialysis,"Average patient dialysis time 
including setup","Number of days in year dialysis 
furnished",Number of stations,"Treatment capacity per day per
station","Number of Times per week
 Patient receives Dialysis","Average patient dialysis time 
including setup","Number of days in year dialysis 
furnished",Number of stations,"Treatment capacity per day per
station",Land ,Laundry and Linen Service,Rental of Provider space by suppliers,Subprovider-IRF,Subprovider-IRF,Subprovider-IRF,Subprovider-IRF,Adults and Pediatrics,Nursery,Subprovider-IRF,Subprovider-IRF,Subprovider-IRF,Subprovider-IRF,net of Swing Bed Cost,net of Swing Bed and Private Room Diff,Total Program General Inpatient Routine ,Program Inpatient Ancillary Service Cost,Total Program Inpatient Costs,Pass through Cost for Program Inpatient ,Pass Through Cost for  Program Ancillary,Total Program Excludable Costs,"Anesthetist, and Medical Education Costs",TOTAL,Subprovider-IRF,TOTAL,Subprovider-IRF,Subprovider-IRF,Subprovider-IRF,Total Costs,Total,Adults & Pediatrics,Total Nursing School,Total ,Total Nursing School,Total Allied Health,Total Outpatient Program Pass Thru Cost,interns and residents,In State Medicaid eligible days,Out of State Medicaid paid days,IRF,IRF,IRF,IRF,IRF,Total Hospital Interns & Residents,Total Facility FTEs ,Maintenance and Repairs,Admin & Gen Under Contract,Admin & Gen Under Contract,Admin & Gen Under Contract,Fixed Equipment,Total Directly Assigned New Cap Rel Csts ,Home Office:  Physician Part A,Interns & Residents,Home Office:  Physician Part A,Interns & Residents,Home Office:  Physician Part A,Home Office:  Physician Part A,Sale of drugs to other than patients,Negative Cost Centers,"Income from imposition of interest, finance",Non-physician Anesthetist,Subprovider-IPF,Subprovider-IRF,Adults and Pediatrics,Subprovider-IRF,Subprovider-IPF,Ambulance Services,Total Program General Inpatient Routine ,Pass through Cost for Program Inpatient ,Pass Through Cost for  Program Ancillary,Total Program Excludable Costs,Subprovider-IPF,Renal Dialysis,Renal Dialysis,Subprovider-IPF,Subprovider-IPF,Subprovider-IPF,Total Allied Health Cost,Subprovider-IPF,Total ,Total Allied Health,Total Outpatient Program Pass Thru Cost,MSP-LCC reconciliation amount,Protested amounts,Paid Losses,Self Insurance,IPF,IPF,IPF,IPF,Interns & Residents,Dietary under contract ,Interns & Residents,Interns & Residents,Dietary under contract ,Interns & Residents,Dietary under Contract,Interns & Residents,Dietary under Contract,Interns & Residents,Out of State Medicaid eligible days,Wage Related Costs RHC/FQHC,Non-Physician Part B,Wage Related Costs RHC/FQHC,Non-Physician Part B,Non-Physician Part B,Non-Physician Part B,Hospital Adlts & Ped Swing Bed NF,Subprovider-IPF,IPF,NF Provider Number,ICF Provider Number,HHA 2 Provider Number,HHA 3 Provider Number,ASC 1 Provider Number,Hospice 2 Provider Number,RHC 3 Provider Number,RHC 4 Provider Number,RHC 5 Provider Number,RHC 6 Provider Number,RHC 7 Provider Number,RHC 8 Provider Number,RHC 9 Provider Number,RHC 10 Provider Number,RHC 11 Provider Number,RHC 12 Provider Number,RHC 13 Provider Number,RHC 14 Provider Number,RHC 15 Provider Number,RHC 16 Provider Number,RHC 17 Provider Number,RHC 18 Provider Number,RHC 19 Provider Number,RHC 20 Provider Number,RHC 21 Provider Number,RHC 22 Provider Number,RHC 23 Provider Number,RHC 24 Provider Number,RHC 25 Provider Number,FQHC 1 Provider Number,FQHC 2 Provider Number,FQHC 3 Provider Number,FQHC 4 Provider Number,FQHC 5 Provider Number,FQHC 6 Provider Number,FQHC 7 Provider Number,FQHC 8 Provider Number,FQHC 9 Provider Number,CMHC 1 Provider Number,Renal 2 Provider Number,Renal 3 Provider Number,Renal 4 Provider Number,Renal 5 Provider Number,Renal 6 Provider Number,Renal 7 Provider Number,Renal 8 Provider Number,Renal 9 Provider Number,Renal 10 Provider Number,Beginning Date of SCH status ,Ending Date of SCH status  ,MDH status beginning date (MM/DD/YY),MDH status ending date (MM/DD/YY),MDH status beginning date  (MM/DD/YY),MDH status ending date (MM/DD/YY),"Medicare certified kidney 
transplant center cert date ",Medicare Certified Kidney TC term date,"Medicare certified heart
transplant center cert date  ",Medicare Certified Heart TC term date,"Medical certified liver 
transplant center cert date  ",Medicare Certified Liver TC term date,"Medical certified lung
transplant center cert date  ",Medicare Certified Lung TC term date,Medicare Certified Pancreas TC term date,certification date,certification date,Medicare Certified Islet TC term date,"If an Organ Procurement Organization, enter the OPO number",Hospital Street Address,Hospital City,Hospital State,Hospital Zip Code,Hospital County,Hospital Name ,Provider's actual MSA or CBSA,Hospital Title 18 Payment System (P/T/O),Swing Bed SNF Provider Number,Type of Control of Hospital (See Table I),FI/Contractor's Name,Home Office Name,Home Office Street,City ,State,Zip Code,IPF Provider Number,IPF Provider Number,SNF Provider Number,RHC 1 Provider Number,RHC 2 Provider Number,Hospital PO Box,Home Office PO Box,HHA 1 Provider Number,Hospice 1 Provider Number,Renal 1 Provider Number,Beginning Date of SCH status  ,Ending Date of SCH status  ,IRF Provider Number,IRF Provider Number,Swing Bed NF Provider Number,"If Line 32, Col 1 is yes, enter the method used: (A, B, or E only)",Cafeteria,Other Organ Acquisition,ASC (Distinct Part),Other Special Purpose,Maintenance of Personnel,Other General Service,Nonphysician Anesthetists,Interns & Res Other Program Costs,Burn Intensive Care Unit,Whole Blood & Packed Red Blood Cells,Blood Clotting Factors for Hemoph.,Impl. Dev. Charged to Patients ,FQHC,Durable Medical Equipment Rented,Durable Medical Equipment Sold,Other Reimbursable,CMHC,CORF,OPT,OOT,OSP,Cafeteria,Other Organ Acquisition,ASC (Distinct Part),Other Special Purpose,Maintenance of Personnel,Nonphysician Anesthetists,Interns & Res Other Program Costs,Burn Intensive Care Unit,Whole Blood & Packed Red Blood Cells,Blood Clotting Factors for Hemoph.,Intravenous Therapy,FQHC,Durable Medical Equipment Rented,Durable Medical Equipment Sold,Other Reimbursable,CMHC,CORF,OPT,OOT,OSP,HHA,Other Organ Acquisition,ASC (Distinct Part),Hospice,Other Special Purpose,Maintenance of Personnel,Other General Service,Research,Physicians' Private Office,Nonpaid Workers,Burn Intensive Care Unit,Whole Blood & Packed Red Blood Cells,"Blood Storing, Processing, Trans",Intravenous Therapy,Occupational Therapy,Speech Pathology,Electroencephalography,Impl. Dev. Charged to Patients ,ASC (Non Distinct Part),RHC,FQHC,Other Outpatient Services,Durable Medical Equipment Rented,Durable Medical Equipment Sold,Other Reimbursable,CMHC,CORF,OPT,OOT,OSP,Other Organ Acquisition,ASC (Distinct Part),Other Special Purpose,Maintenance of Personnel,Nonphysician Anesthetists,Burn Intensive Care Unit,Whole Blood & Packed Red Blood Cells,Blood Clotting Factors for Hemoph.,FQHC,Durable Medical Equipment Rented,Durable Medical Equipment Sold,Other Reimbursable,CMHC,CORF,OPT,OOT,OSP,HHA,Other Organ Acquisition,ASC (Distinct Part),Hospice,Research,Physicians' Private Office,Nonpaid Workers,Other Nonreimbursable,Burn Intensive Care Unit,Recovery Room,Anesthesiology,Radiology-Diagnostic,Radiology-Therapeutic,Radioisotope,CT Scan,MRI,Cardiac Catheterization,Laboratory,Whole Blood & Packed Red Blood Cells,"Blood Storing, Processing, Trans",Intravenous Therapy,Respiratory Therapy,Physical Therapy,Occupational Therapy,Speech Pathology,Electrocardiology,Electroencephalography,Medical Supplies Charged to Patients,Impl. Dev. Charged to Patients ,Drugs Charged to Patients,ASC (Non Distinct Part),Other Ancillary,RHC,FQHC,Observation Beds (Distinct Unit),Other Reimbursable,CMHC,HHA,Other Organ Acquisition,ASC (Distinct Part),Hospice,Research,Physicians' Private Office,Nonpaid Workers,Other Nonreimbursable,Coronary Care Unit,Burn Intensive Care Unit,Surgical Intensive Care Unit,Other Special Care Unit,Recovery Room,Anesthesiology,Radiology-Diagnostic,Radiology-Therapeutic,Radioisotope,CT Scan,MRI,Cardiac Catheterization,Laboratory,Whole Blood & Packed Red Blood Cells,"Blood Storing, Processing, Trans",Intravenous Therapy,Respiratory Therapy,Physical Therapy,Occupational Therapy,Speech Pathology,Electrocardiology,Electroencephalography,Medical Supplies Charged to Patients,Impl. Dev. Charged to Patients ,Drugs Charged to Patients,ASC (Non Distinct Part),Other Ancillary,RHC,FQHC,Observation Beds (Distinct Unit),Other Reimbursable,CMHC,Other Organ Acquisition,ASC (Distinct Part),Other Special Purpose,Burn Intensive Care Unit,Whole Blood & Packed Red Blood Cells,Blood Clotting Factors for Hemoph.,FQHC,Durable Medical Equipment Rented,Durable Medical Equipment Sold,Other Reimbursable,CMHC,CORF,OPT,OOT,OSP,Other Organ Acquisition,ASC (Distinct Part),Other Special Purpose,Burn Intensive Care Unit,Whole Blood & Packed Red Blood Cells,Blood Clotting Factors for Hemoph.,FQHC,Durable Medical Equipment Rented,Durable Medical Equipment Sold,Other Reimbursable,CMHC,CORF,OPT,OOT,OSP,Respiratory Therapy,Physical Therapy,Occupational Therapy,Speech Pathology,Other Organ Acquisition,ASC (Distinct Part),Other Special Purpose,Burn Intensive Care Unit,Whole Blood & Packed Red Blood Cells,Blood Clotting Factors for Hemoph.,FQHC,Durable Medical Equipment Rented,Durable Medical Equipment Sold,Other Reimbursable,CMHC,CORF,OPT,OOT,OSP,HHA,Other Organ Acquisition,ASC (Distinct Part),Hospice,Other Special Purpose,Burn Intensive Care Unit,Whole Blood & Packed Red Blood Cells,Blood Clotting Factors for Hemoph.,RHC,FQHC,Durable Medical Equipment Rented,Durable Medical Equipment Sold,Other Reimbursable,CMHC,CORF,OPT,OOT,OSP,Other Organ Acquisition,ASC (Distinct Part),Other Special Purpose,Whole Blood & Packed Red Blood Cells,Blood Clotting Factors for Hemoph.,FQHC,Durable Medical Equipment Rented,Durable Medical Equipment Sold,Other Reimbursable,CMHC,CORF,OPT,OOT,OSP,Coronary Care Unit Program Cost,Burn Intensive Care Unit Program Cost,Surgical Intensive Care Unit Program Cost,Burn Intensive Care Unit,Other Special Care Unit,Whole Blood & Packed Red Blood Cells,Blood Clotting Factors for Hemoph.,Durable Medical Equipment Rented,Durable Medical Equipment Sold,Other Reimbursable,Whole Blood & Packed Red Blood Cells,Blood Clotting Factors for Hemoph.,Durable Medical Equipment Rented,Durable Medical Equipment Sold,Other Reimbursable,Intensive Care Unit,Coronary Care Unit,Burn Intensive Care Unit,Surgical Intensive Care Unit,Other Special Care Unit,Delivery Room and Labor Room,Radiology-Therapeutic,Radioisotope,Cardiac Catheterization,Whole Blood & Packed Red Blood Cells,"Blood Storing, Processing, Trans",Intravenous Therapy,Occupational Therapy,Electroencephalography,ASC (Non Distinct Part),Other Ancillary,Clinic,Observation Beds (Distinct Unit),Other Outpatient Services,Durable Medical Equipment Rented,Other Reimbursable,Delivery Room and Labor Room,Radiology-Therapeutic,Radioisotope,Cardiac Catheterization,Whole Blood & Packed Red Blood Cells,"Blood Storing, Processing, Trans",Intravenous Therapy,Occupational Therapy,Electroencephalography,ASC (Non Distinct Part),Other Ancillary,Clinic,Observation Beds (Distinct Unit),Other Outpatient Services,Durable Medical Equipment Rented,Other Reimbursable,Intensive Care Unit,Coronary Care Unit,Burn Intensive Care Unit,Surgical Intensive Care Unit,Other Special Care Unit,Delivery Room and Labor Room,Radioisotope,Cardiac Catheterization,Whole Blood & Packed Red Blood Cells,"Blood Storing, Processing, Trans",Electroencephalography,ASC (Non Distinct Part),Emergency,Observation Beds (Distinct Unit),Other Outpatient Services,Durable Medical Equipment Rented,Other Reimbursable,Delivery Room and Labor Room,Radioisotope,Cardiac Catheterization,Whole Blood & Packed Red Blood Cells,"Blood Storing, Processing, Trans",Electroencephalography,ASC (Non Distinct Part),Emergency,Observation Beds (Distinct Unit),Other Outpatient Services,Durable Medical Equipment Rented,Other Reimbursable,Intensive Care Unit,Coronary Care Unit,Surgical Intensive Care Unit,Other Special Care Unit,Operating Room,Recovery Room,Delivery Room and Labor Room,Anesthesiology,Radiology-Therapeutic,Radioisotope,CT Scan,MRI,Cardiac Catheterization,Whole Blood & Packed Red Blood Cells,"Blood Storing, Processing, Trans",Intravenous Therapy,Respiratory Therapy,Occupational Therapy,Speech Pathology,Electrocardiology,Electroencephalography,Medical Supplies Charged to Patients,Impl. Dev. Charged to Patients ,ASC (Non Distinct Part),Other Ancillary,Clinic,Emergency,Observation Beds (Distinct Unit),Other Outpatient Services,Durable Medical Equipment Rented,Other Reimbursable,Operating Room,Recovery Room,Delivery Room and Labor Room,Anesthesiology,Radiology-Therapeutic,Radioisotope,CT Scan,MRI,Cardiac Catheterization,Whole Blood & Packed Red Blood Cells,"Blood Storing, Processing, Trans",Intravenous Therapy,Respiratory Therapy,Occupational Therapy,Speech Pathology,Electrocardiology,Electroencephalography,Medical Supplies Charged to Patients,Impl. Dev. Charged to Patients ,ASC (Non Distinct Part),Other Ancillary,Clinic,Emergency,Observation Beds (Distinct Unit),Other Outpatient Services,Durable Medical Equipment Rented,Other Reimbursable,Burn Intensive Care Unit,Burn Intensive Care Unit,Other Special Care Unit,Burn Intensive Care Unit,Other Special Care Unit,Burn Intensive Care Unit,Other Special Care Unit,Whole Blood & Packed Red Blood Cells,Blood Clotting Factors for Hemoph.,Durable Medical Equipment Rented,Durable Medical Equipment Sold,Other Reimbursable,Recovery Room,Delivery Room and Labor Room,Radiology-Therapeutic,Radioisotope,CT Scan,MRI,Whole Blood & Packed Red Blood Cells,"Blood Storing, Processing, Trans",Intravenous Therapy,Physical Therapy,Occupational Therapy,Speech Pathology,Electroencephalography,Medical Supplies Charged to Patients,Impl. Dev. Charged to Patients ,ASC (Non Distinct Part),Observation Beds (Distinct Unit),Other Reimbursable,Whole Blood & Packed Red Blood Cells,Blood Clotting Factors for Hemoph.,Durable Medical Equipment Rented,Durable Medical Equipment Sold,Other Reimbursable,Recovery Room,Delivery Room and Labor Room,Radiology-Therapeutic,Radioisotope,CT Scan,MRI,Whole Blood & Packed Red Blood Cells,"Blood Storing, Processing, Trans",Intravenous Therapy,Physical Therapy,Occupational Therapy,Speech Pathology,Electroencephalography,Medical Supplies Charged to Patients,Impl. Dev. Charged to Patients ,ASC (Non Distinct Part),Observation Beds (Distinct Unit),Durable Medical Equipment Sold,Other Reimbursable,Operating Room,Anesthesiology,Drugs Charged to Patients,Other Ancillary,Emergency,Recovery Room,Anesthesiology,Radiology-Diagnostic,Radiology-Therapeutic,Radioisotope,CT Scan,MRI,Cardiac Catheterization,Laboratory,Whole Blood & Packed Red Blood Cells,"Blood Storing, Processing, Trans",Intravenous Therapy,Respiratory Therapy,Physical Therapy,Occupational Therapy,Speech Pathology,Electrocardiology,Electroencephalography,Medical Supplies Charged to Patients,Impl. Dev. Charged to Patients ,Drugs Charged to Patients,ASC (Non Distinct Part),Other Ancillary,RHC,Clinic,Observation Beds (Distinct Unit),Other Outpatient Services,Durable Medical Equipment Sold,Other Reimbursable,Recovery Room,Delivery Room and Labor Room,Radiology-Therapeutic,Radioisotope,CT Scan,MRI,Whole Blood & Packed Red Blood Cells,Blood Clotting Factors for Hemoph.,"Blood Storing, Processing, Trans",Intravenous Therapy,Physical Therapy,Occupational Therapy,Speech Pathology,Electroencephalography,Medical Supplies Charged to Patients,Impl. Dev. Charged to Patients ,ASC (Non Distinct Part),RHC,FQHC,Observation Beds (Distinct Unit),Durable Medical Equipment Sold,Other Reimbursable,Operating Room,Recovery Room,Delivery Room and Labor Room,Anesthesiology,Radiology-Diagnostic,Radiology-Therapeutic,Radioisotope,CT Scan,MRI,Cardiac Catheterization,Laboratory,Intravenous Therapy,Respiratory Therapy,Physical Therapy,Occupational Therapy,Speech Pathology,Electrocardiology,Electroencephalography,Medical Supplies Charged to Patients,Impl. Dev. Charged to Patients ,Drugs Charged to Patients,ASC (Non Distinct Part),Other Ancillary,RHC,FQHC,Clinic,Emergency,Other Outpatient Services,Operating Room,Recovery Room,Delivery Room and Labor Room,Radiology-Diagnostic,Radiology-Therapeutic,Radioisotope,CT Scan,MRI,Cardiac Catheterization,Laboratory,Whole Blood & Packed Red Blood Cells,"Blood Storing, Processing, Trans",Intravenous Therapy,Respiratory Therapy,Physical Therapy,Occupational Therapy,Speech Pathology,Electroencephalography,Medical Supplies Charged to Patients,Impl. Dev. Charged to Patients ,ASC (Non Distinct Part),Other Ancillary,Clinic,Observation Beds (Distinct Unit),Other Outpatient Services,Operating Room,Recovery Room,Delivery Room and Labor Room,Anesthesiology,Radiology-Diagnostic,Radiology-Therapeutic,Radioisotope,CT Scan,MRI,Cardiac Catheterization,Laboratory,Whole Blood & Packed Red Blood Cells,"Blood Storing, Processing, Trans",Intravenous Therapy,Respiratory Therapy,Physical Therapy,Occupational Therapy,Speech Pathology,Electrocardiology,Electroencephalography,Medical Supplies Charged to Patients,Impl. Dev. Charged to Patients ,Drugs Charged to Patients,ASC (Non Distinct Part),Other Ancillary,Clinic,Emergency,Observation Beds (Distinct Unit),Other Outpatient Services,Recovery Room,Delivery Room and Labor Room,Radiology-Therapeutic,Radioisotope,CT Scan,MRI,Cardiac Catheterization,Whole Blood & Packed Red Blood Cells,"Blood Storing, Processing, Trans",Intravenous Therapy,Physical Therapy,Occupational Therapy,Speech Pathology,Electroencephalography,Medical Supplies Charged to Patients,Impl. Dev. Charged to Patients ,ASC (Non Distinct Part),Other Ancillary,Clinic,Emergency,Observation Beds (Distinct Unit),Other Outpatient Services,Other Reimbursable,Operating Room,Recovery Room,Anesthesiology,Radiology-Diagnostic,Radiology-Therapeutic,Radioisotope,CT Scan,MRI,Cardiac Catheterization,Laboratory,Whole Blood & Packed Red Blood Cells,"Blood Storing, Processing, Trans",Respiratory Therapy,Physical Therapy,Speech Pathology,Electrocardiology,Electroencephalography,Medical Supplies Charged to Patients,Impl. Dev. Charged to Patients ,Drugs Charged to Patients,ASC (Non Distinct Part),Other Ancillary,Clinic,Emergency,Operating Room,Recovery Room,Delivery Room and Labor Room,Anesthesiology,Radiology-Diagnostic,Radiology-Therapeutic,Radioisotope,CT Scan,MRI,Cardiac Catheterization,Laboratory,Whole Blood & Packed Red Blood Cells,"Blood Storing, Processing, Trans",Intravenous Therapy,Respiratory Therapy,Physical Therapy,Occupational Therapy,Speech Pathology,Electrocardiology,Electroencephalography,Medical Supplies Charged to Patients,Impl. Dev. Charged to Patients ,Drugs Charged to Patients,ASC (Non Distinct Part),Other Ancillary,Clinic,Emergency,Observation Beds (Distinct Unit),Other Outpatient Services,Drugs Charged to Patients,Whole Blood & Packed Red Blood Cells,Blood Clotting Factors for Hemoph.,Durable Medical Equipment Rented,Durable Medical Equipment Sold,Other Reimbursable,Recovery Room,Delivery Room and Labor Room,Radioisotope,Cardiac Catheterization,Whole Blood & Packed Red Blood Cells,Blood Clotting Factors for Hemoph.,Intravenous Therapy,Electroencephalography,ASC (Non Distinct Part),Observation Beds (Distinct Unit),Other Outpatient Services,Durable Medical Equipment Rented,Durable Medical Equipment Sold,Other Reimbursable,Delivery Room and Labor Room,Anesthesiology,Radiology-Diagnostic,Radiology-Therapeutic,Radioisotope,CT Scan,MRI,Whole Blood & Packed Red Blood Cells,"Blood Storing, Processing, Trans",Intravenous Therapy,Respiratory Therapy,Physical Therapy,Occupational Therapy,Speech Pathology,Electrocardiology,Electroencephalography,Medical Supplies Charged to Patients,Impl. Dev. Charged to Patients ,ASC (Non Distinct Part),Other Reimbursable,Whole Blood & Packed Red Blood Cells,Blood Clotting Factors for Hemoph.,Durable Medical Equipment Rented,Durable Medical Equipment Sold,Other Reimbursable,Recovery Room,Delivery Room and Labor Room,Radioisotope,Cardiac Catheterization,Whole Blood & Packed Red Blood Cells,Blood Clotting Factors for Hemoph.,Intravenous Therapy,Electroencephalography,ASC (Non Distinct Part),Observation Beds (Distinct Unit),Other Outpatient Services,Durable Medical Equipment Rented,Durable Medical Equipment Sold,Other Reimbursable,Delivery Room and Labor Room,Anesthesiology,Radiology-Diagnostic,Radiology-Therapeutic,Radioisotope,CT Scan,MRI,Whole Blood & Packed Red Blood Cells,"Blood Storing, Processing, Trans",Intravenous Therapy,Respiratory Therapy,Physical Therapy,Occupational Therapy,Speech Pathology,Electrocardiology,Electroencephalography,Medical Supplies Charged to Patients,Impl. Dev. Charged to Patients ,ASC (Non Distinct Part),Other Reimbursable,Other adjustments,Outpatient Rehab Provider,HHA,Hospice,Outpatient Rehab Provider,RHC/FQHC Combined,Burn Intensive Care Unit,Hospice,Burn Intensive Care Unit,Hospice,Burn Intensive Care Unit,Surgical Intensive Care Unit,Other Special Care,Intensive Care Unit,Coronary Care Unit,Burn Intensive Care Unit,Surgical Intensive Care Unit,Other Special Care,Intensive Care Unit,Coronary Care Unit,Burn Intensive Care Unit,Other Special Care,Hospice,CMHC,Burn Intensive Care Unit,HHA,Hospice,Outpatient Rehab Provider,Burn Intensive Care Unit,Outpatient Rehab Provider,HHA,Hospice,RHC/FQHC Combined,New Cap Related Csts Bldg & Fixtures,New Cap Related Csts Movable Equipment,New Cap Related Csts Bldg & Fixtures,New Cap Related Csts Movable Equipment,New Cap Related Csts Bldg & Fixtures,New Cap Related Csts Movable Equipment,Other Adjustments (Summed),Dietary,Nursing Administration,Central Services and Supply,Pharmacy,Medical Records and Medical Rec. Library,Physicians' Private Office,Administrative and General,Operating Room,Radiology-Diagnostic,Laboratory,Respiratory Therapy,Physical Therapy,Occupational Therapy,Electrocardiology,Operation of Plant,Housekeeping,Emergency,New Capital Buildings and Fixtures,Dietary,Nursing Administration,Central Services and Supply,Pharmacy,Medical Records and Medical Rec. Library,Physicians' Private Office,New Capital Equipment,Employee Benefits,Administrative and General,Operating Room,Anesthesiology,Radiology-Diagnostic,CT Scan,Laboratory,Respiratory Therapy,Physical Therapy,Electrocardiology,Operation of Plant,Housekeeping,Emergency,Cafeteria,Medical Records and Medical Rec. Library,New Capital Equipment,Administrative and General,Operating Room,Emergency,New Capital Buildings and Fixtures,Dietary,Cafeteria,Nursing Administration,Central Services and Supply,Pharmacy,Medical Records and Medical Rec. Library,Physicians' Private Office,Other Nonreimbursable,New Capital Equipment,Employee Benefits,Administrative and General,Operating Room,Anesthesiology,Radiology-Diagnostic,CT Scan,Laboratory,Respiratory Therapy,Physical Therapy,Occupational Therapy,Electrocardiology,Operation of Plant,Medical Supplies Charged to Patients,Drugs Charged to Patients,Housekeeping,Emergency,"Gift, Flower, Coffee Shop, Canteen",Physicians' Private Office,Other Nonreimbursable,Operating Room,Anesthesiology,Radiology-Diagnostic,CT Scan,Laboratory,Respiratory Therapy,Physical Therapy,Occupational Therapy,Electrocardiology,Medical Supplies Charged to Patients,Drugs Charged to Patients,Emergency,"Gift, Flower, Coffee Shop, Canteen",Physicians' Private Office,Other Nonreimbursable,Operating Room,Anesthesiology,Radiology-Diagnostic,CT Scan,Laboratory,Respiratory Therapy,Physical Therapy,Occupational Therapy,Electrocardiology,Medical Supplies Charged to Patients,Drugs Charged to Patients,Emergency,Operating Room,Anesthesiology,Radiology-Diagnostic,CT Scan,Laboratory,Respiratory Therapy,Physical Therapy,Occupational Therapy,Electrocardiology,Medical Supplies Charged to Patients,Drugs Charged to Patients,Emergency,Operating Room,Anesthesiology,Radiology-Diagnostic,CT Scan,Laboratory,Respiratory Therapy,Physical Therapy,Occupational Therapy,Electrocardiology,Medical Supplies Charged to Patients,Drugs Charged to Patients,Emergency,Operating Room,Anesthesiology,Radiology-Diagnostic,CT Scan,Laboratory,Respiratory Therapy,Physical Therapy,Occupational Therapy,Electrocardiology,Medical Supplies Charged to Patients,Drugs Charged to Patients,Emergency,Operating Room,Anesthesiology,Radiology-Diagnostic,CT Scan,Laboratory,Respiratory Therapy,Physical Therapy,Occupational Therapy,Electrocardiology,Medical Supplies Charged to Patients,Drugs Charged to Patients,Emergency,Operating Room,Anesthesiology,Radiology-Diagnostic,CT Scan,Laboratory,Respiratory Therapy,Physical Therapy,Occupational Therapy,Electrocardiology,Medical Supplies Charged to Patients,Drugs Charged to Patients,Emergency,Operating Room,Anesthesiology,Radiology-Diagnostic,CT Scan,Laboratory,Respiratory Therapy,Physical Therapy,Occupational Therapy,Electrocardiology,Medical Supplies Charged to Patients,Drugs Charged to Patients,Emergency,Operating Room,Anesthesiology,Radiology-Diagnostic,CT Scan,Laboratory,Respiratory Therapy,Physical Therapy,Occupational Therapy,Electrocardiology,Medical Supplies Charged to Patients,Drugs Charged to Patients,Emergency,New Cap Related Csts Bldg & Fixtures,New Cap Related Csts Movable Equipment,New Cap Related Csts Bldg & Fixtures,New Cap Related Csts Movable Equipment,New Cap Related Csts Bldg & Fixtures,New Cap Related Csts Movable Equipment,New Cap Related Csts Bldg & Fixtures,New Cap Related Csts Movable Equipment,Social Service,"Gift, Flower, Coffee Shop, Canteen",Research,Other Nonreimbursable,Paramedical Education,Intensive Care Unit,Surgical Intensive Care Unit,Employee Benefits,Recovery Room,Delivery Room and Labor Room,Anesthesiology,Radiology-Therapeutic,CT Scan,MRI,Cardiac Catheterization,"Blood Storing, Processing, Trans",Clinic,Observation Beds (Distinct Unit),Social Service,"Gift, Flower, Coffee Shop, Canteen",Research,Other Nonreimbursable,Paramedical Education,Intensive Care Unit,Surgical Intensive Care Unit,Recovery Room,Delivery Room and Labor Room,Radiology-Therapeutic,MRI,Cardiac Catheterization,"Blood Storing, Processing, Trans",Medical Supplies Charged to Patients,Clinic,New Capital Buildings and Fixtures,Social Service,Intensive Care Unit,Employee Benefits,Delivery Room and Labor Room,Anesthesiology,Radiology-Diagnostic,Radiology-Therapeutic,Cardiac Catheterization,Laboratory,Respiratory Therapy,Electrocardiology,Operation of Plant,Medical Supplies Charged to Patients,Housekeeping,Observation Beds (Distinct Unit),Social Service,"Gift, Flower, Coffee Shop, Canteen",Research,Paramedical Education,Intensive Care Unit,Surgical Intensive Care Unit,Recovery Room,Delivery Room and Labor Room,Radiology-Therapeutic,MRI,Cardiac Catheterization,"Blood Storing, Processing, Trans",Impl. Dev. Charged to Patients ,Laundry and Linen Service,Clinic,Observation Beds (Distinct Unit),Research,Intensive Care Unit,Surgical Intensive Care Unit,Recovery Room,Delivery Room and Labor Room,Radiology-Therapeutic,MRI,Cardiac Catheterization,"Blood Storing, Processing, Trans",Impl. Dev. Charged to Patients ,Clinic,Observation Beds (Distinct Unit),Research,Intensive Care Unit,Surgical Intensive Care Unit,Recovery Room,Delivery Room and Labor Room,Radiology-Therapeutic,MRI,Cardiac Catheterization,"Blood Storing, Processing, Trans",Impl. Dev. Charged to Patients ,Clinic,Observation Beds (Distinct Unit),Intensive Care Unit,Surgical Intensive Care Unit,Operating Room,Recovery Room,Delivery Room and Labor Room,Anesthesiology,Radiology-Diagnostic,Radiology-Therapeutic,CT Scan,MRI,Cardiac Catheterization,Laboratory,"Blood Storing, Processing, Trans",Respiratory Therapy,Physical Therapy,Electrocardiology,Medical Supplies Charged to Patients,Impl. Dev. Charged to Patients ,Drugs Charged to Patients,Clinic,Emergency,Observation Beds (Distinct Unit),Intensive Care Unit,Surgical Intensive Care Unit,Recovery Room,Delivery Room and Labor Room,Radiology-Therapeutic,MRI,Cardiac Catheterization,"Blood Storing, Processing, Trans",Impl. Dev. Charged to Patients ,Clinic,Observation Beds (Distinct Unit),Recovery Room,Delivery Room and Labor Room,Radiology-Therapeutic,MRI,Cardiac Catheterization,"Blood Storing, Processing, Trans",Impl. Dev. Charged to Patients ,Clinic,Observation Beds (Distinct Unit),Intensive Care Unit Program Cost,Intensive Care Unit,Surgical Intensive Care Unit,Recovery Room,Delivery Room and Labor Room,Radiology-Therapeutic,MRI,Cardiac Catheterization,"Blood Storing, Processing, Trans",Impl. Dev. Charged to Patients ,Clinic,Observation Beds (Distinct Unit),Recovery Room,Delivery Room and Labor Room,Radiology-Therapeutic,MRI,Cardiac Catheterization,"Blood Storing, Processing, Trans",Impl. Dev. Charged to Patients ,Clinic,Observation Beds (Distinct Unit),Intensive Care Unit,Surgical Intensive Care Unit,Intensive Care Unit,Surgical Intensive Care Unit,Intensive Care Unit,Surgical Intensive Care Unit,Recovery Room,Delivery Room and Labor Room,Radiology-Therapeutic,MRI,Cardiac Catheterization,"Blood Storing, Processing, Trans",Impl. Dev. Charged to Patients ,Clinic,Observation Beds (Distinct Unit),Laboratory,Operating Room,Recovery Room,Delivery Room and Labor Room,Anesthesiology,Radiology-Diagnostic,Radiology-Therapeutic,CT Scan,MRI,Cardiac Catheterization,Laboratory,"Blood Storing, Processing, Trans",Respiratory Therapy,Physical Therapy,Electrocardiology,Medical Supplies Charged to Patients,Impl. Dev. Charged to Patients ,Drugs Charged to Patients,Clinic,Emergency,Observation Beds (Distinct Unit),Laboratory,Laboratory,Operating Room,Recovery Room,Delivery Room and Labor Room,Anesthesiology,Radiology-Diagnostic,Radiology-Therapeutic,CT Scan,MRI,Cardiac Catheterization,Laboratory,"Blood Storing, Processing, Trans",Respiratory Therapy,Physical Therapy,Electrocardiology,Medical Supplies Charged to Patients,Impl. Dev. Charged to Patients ,Drugs Charged to Patients,Clinic,Emergency,Observation Beds (Distinct Unit),Drugs Charged to Patients,Operating Room,Recovery Room,Delivery Room and Labor Room,Anesthesiology,Radiology-Diagnostic,Radiology-Therapeutic,CT Scan,MRI,Cardiac Catheterization,Laboratory,"Blood Storing, Processing, Trans",Respiratory Therapy,Physical Therapy,Electrocardiology,Medical Supplies Charged to Patients,Impl. Dev. Charged to Patients ,Drugs Charged to Patients,Clinic,Emergency,Observation Beds (Distinct Unit),Drugs Charged to Patients,Surgical Intensive Care Unit,Intensive Care Unit,Surgical Intensive Care Unit,Intensive Care Unit,Surgical Intensive Care Unit,Intensive Care Unit,Surgical Intensive Care Unit,Intensive Care Unit,Surgical Intensive Care Unit,Intensive Care Unit,Speech Pathology,Occupational Therapy,Speech Pathology,Drugs Charged to Patients,Laundry and Linen Service,Speech Pathology,Speech Pathology,Speech Pathology,Occupational Therapy,Speech Pathology,Speech Pathology,Speech Pathology,Speech Pathology,Speech Pathology,Medical Supplies Charged to Patients,RHC,RHC,Other Nonreimbursable,RHC,RHC,RHC,RHC,RHC,Operating Room,Operating Room,Radiology-Diagnostic,Laboratory,Physical Therapy,Drugs Charged to Patients,Radiology-Diagnostic,Laboratory,Physical Therapy,Drugs Charged to Patients,RHC/FQHC Combined,RHC/FQHC Combined,RHC/FQHC Combined,Laundry and Linen Service,Dietary,Clinic,Impl. Dev. Charged to Patients ,Clinic,Impl. Dev. Charged to Patients ,Clinic,HHA,Hospice,Nonpaid Workers,Drugs Charged to Patients,Other Ancillary,HHA,Hospice,Other General Service,Nonpaid Workers,Impl. Dev. Charged to Patients ,Other Ancillary,Central Services and Supply,Physical Therapy,Drugs Charged to Patients,HHA,Hospice,Other General Service,Nonpaid Workers,Other Ancillary,HHA,Hospice,Nonpaid Workers,Other Ancillary,HHA,Hospice,Nonpaid Workers,Other Ancillary,HHA,Hospice,Other Ancillary,HHA,Hospice,Speech Pathology,Other Ancillary,Occupational Therapy,Speech Pathology,Other Ancillary,Occupational Therapy,Speech Pathology,Other Ancillary,Clinic,Occupational Therapy,Speech Pathology,Other Ancillary,Clinic,HHA,Hospice,HHA,HHA,Hospice,Nursing School,Coronary Care Unit,Other Special Care Unit,Maintenance and Repairs,Intravenous Therapy,Nursing School,Coronary Care Unit,Other Special Care Unit,Maintenance and Repairs,Pharmacy,Nursing School,Paramedical Education,Coronary Care Unit,Surgical Intensive Care Unit,Other Special Care Unit,Maintenance and Repairs,Other Ancillary,Laundry and Linen Service,Nursing School,Interns & Res Salary and Fringe Benefits,Coronary Care Unit,Other Special Care Unit,Maintenance and Repairs,Intravenous Therapy,Interns & Res Salary and Fringe Benefits,Coronary Care Unit,Surgical Intensive Care Unit,Other Special Care Unit,Operating Room,Clinic,Emergency,Coronary Care Unit,Other Special Care Unit,Intravenous Therapy,Coronary Care Unit,Other Special Care Unit,Intravenous Therapy,Coronary Care Unit,Other Special Care Unit,Intravenous Therapy,Coronary Care Unit,Other Special Care Unit,Intravenous Therapy,Other Ancillary,Intravenous Therapy,Coronary Care Unit,Intravenous Therapy,Other Ancillary,Intravenous Therapy,Other Ancillary,Radiology-Diagnostic,CT Scan,Laboratory,Intravenous Therapy,Respiratory Therapy,Physical Therapy,Occupational Therapy,Speech Pathology,Electrocardiology,Drugs Charged to Patients,Other Ancillary,Clinic,Radiology-Diagnostic,CT Scan,Laboratory,Intravenous Therapy,Respiratory Therapy,Physical Therapy,Occupational Therapy,Speech Pathology,Electrocardiology,Drugs Charged to Patients,Other Ancillary,Clinic,Coronary Intensive Care Unit,Other Special Care Unit,Coronary Intensive Care Unit,Coronary Intensive Care Unit,Coronary Care Unit,Surgical Intensive Care Unit,Intravenous Therapy,Other Ancillary,Operating Room,Radiology-Diagnostic,Drugs Charged to Patients,Emergency,Intravenous Therapy,Operating Room,Radiology-Diagnostic,Drugs Charged to Patients,Emergency,Operating Room,Delivery Room and Labor Room,Emergency,Radiology-Diagnostic,Drugs Charged to Patients,Radiology-Diagnostic,Laboratory,Drugs Charged to Patients,Intravenous Therapy,Intravenous Therapy,Coronary Care Unit,Coronary Care Unit,Coronary Care Unit,Coronary Care Unit,Coronary Care Unit,Radioisotope,Electroencephalography,Radioisotope,Electroencephalography,Nursing Administration,Recovery Room,Radioisotope,CT Scan,MRI,Radioisotope,Electroencephalography,Radioisotope,Electroencephalography,Radioisotope,Electroencephalography,Radioisotope,Electroencephalography,Radioisotope,Electroencephalography,Radioisotope,Electroencephalography,Radioisotope,Electroencephalography,Radioisotope,Electroencephalography,Radioisotope,Electroencephalography,Radiology-Therapeutic,MRI,Speech Pathology,Emergency,Radiology-Therapeutic,MRI,Speech Pathology,Emergency,ASC (Non Distinct Part),ASC (Non Distinct Part),ASC (Non Distinct Part),ASC (Non Distinct Part),ASC (Non Distinct Part),ASC (Non Distinct Part),ASC (Non Distinct Part),ASC (Non Distinct Part),ASC (Non Distinct Part),ASC (Non Distinct Part),ASC (Non Distinct Part),Radioisotope,ASC (Non Distinct Part),Radioisotope,ASC (Non Distinct Part),Radioisotope,ASC (Non Distinct Part),Interns & Res Salary and Fringe Benefits,Other Outpatient Services,Interns & Res Salary and Fringe Benefits,Other Outpatient Services,Nonphysician Anesthetists,"Gift, Flower, Coffee Shop, Canteen",Interns & Res Salary and Fringe Benefits,Interns & Res Other Program Costs,Interns & Res Other Program Costs,Other Outpatient Services,"Gift, Flower, Coffee Shop, Canteen",Intensive Care Unit,Delivery Room and Labor Room,Other Outpatient Services,"Gift, Flower, Coffee Shop, Canteen",Intensive Care Unit,Operating Room,Delivery Room and Labor Room,Clinic,Emergency,Other Outpatient Services,Other Outpatient Services,Other Outpatient Services,Other Outpatient Services,Other Outpatient Services,Other Outpatient Services,Other Outpatient Services,Other Outpatient Services,Recovery Room,Anesthesiology,Radiology-Diagnostic,CT Scan,MRI,Laboratory,Respiratory Therapy,Physical Therapy,Electrocardiology,Medical Supplies Charged to Patients,Impl. Dev. Charged to Patients ,Drugs Charged to Patients,Emergency,Recovery Room,Anesthesiology,Radiology-Diagnostic,CT Scan,MRI,Laboratory,Respiratory Therapy,Physical Therapy,Electrocardiology,Medical Supplies Charged to Patients,Impl. Dev. Charged to Patients ,Drugs Charged to Patients,Emergency,Operating Room,Recovery Room,Anesthesiology,Radiology-Therapeutic,MRI,Medical Supplies Charged to Patients,Impl. Dev. Charged to Patients ,Operating Room,Recovery Room,Anesthesiology,Radiology-Therapeutic,MRI,Medical Supplies Charged to Patients,Impl. Dev. Charged to Patients ,Intensive Care Unit,Other Outpatient Services,Anesthesiology,Cardiac Catheterization,Respiratory Therapy,Electrocardiology,Other Ancillary,Clinic,Other Outpatient Services,Other Outpatient Services,Anesthesiology,Cardiac Catheterization,Respiratory Therapy,Electrocardiology,Other Ancillary,Clinic,Other Outpatient Services,Operating Room,Anesthesiology,Cardiac Catheterization,Respiratory Therapy,Electrocardiology,Other Ancillary,Clinic,Emergency,Other Outpatient Services,Anesthesiology,Electrocardiology,Drugs Charged to Patients,Emergency,Operating Room,Anesthesiology,Respiratory Therapy,Electrocardiology,Other Outpatient Services,Operating Room,Recovery Room,Cardiac Catheterization,Observation Beds (Distinct Unit),Other Outpatient Services,Other Outpatient Services,Operating Room,Recovery Room,Cardiac Catheterization,Observation Beds (Distinct Unit),Other Outpatient Services,Other Special Care,Other Special Care,Other Special Care,Other Special Care,Electroencephalography,Electroencephalography,Electroencephalography,Other Ancillary,Other Ancillary,Laboratory,Laboratory,Speech Pathology,Speech Pathology,"Blood Storing, Processing, Trans",Other Ancillary,"Blood Storing, Processing, Trans",Other Ancillary,RHC/FQHC Combined,Lat,Lon,"Control type, text","Hospital type, text",Num and Name
,HOSPITAL IDENTIFICATION INFORMATION,HOSPITAL IDENTIFICATION INFORMATION,HOSPITAL IDENTIFICATION INFORMATION,HOSPITAL IDENTIFICATION INFORMATION,HOSPITAL IDENTIFICATION INFORMATION,HOSPITAL IDENTIFICATION INFORMATION,HOSPITAL IDENTIFICATION INFORMATION,HOSPITAL IDENTIFICATION INFORMATION,HOSPITAL IDENTIFICATION INFORMATION,HOSPITAL IDENTIFICATION INFORMATION,HOSPITAL IDENTIFICATION INFORMATION,HOSPITAL IDENTIFICATION INFORMATION,ANALYSIS OF CHANGES IN NEW CAPITAL BALANCES,ANALYSIS OF CHANGES IN NEW CAPITAL BALANCES,ANALYSIS OF CHANGES IN NEW CAPITAL BALANCES,ANALYSIS OF CHANGES IN NEW CAPITAL BALANCES,ANALYSIS OF CHANGES IN NEW CAPITAL BALANCES,ANALYSIS OF CHANGES IN NEW CAPITAL BALANCES,ANALYSIS OF CHANGES IN NEW CAPITAL BALANCES,ANALYSIS OF CHANGES IN NEW CAPITAL BALANCES,ANALYSIS OF CHANGES IN NEW CAPITAL BALANCES,ANALYSIS OF CHANGES IN NEW CAPITAL BALANCES,ANALYSIS OF CHANGES IN NEW CAPITAL BALANCES,ANALYSIS OF CHANGES IN NEW CAPITAL BALANCES,ANALYSIS OF CHANGES IN NEW CAPITAL BALANCES,ANALYSIS OF CHANGES IN NEW CAPITAL BALANCES,ANALYSIS OF CHANGES IN NEW CAPITAL BALANCES,ANALYSIS OF CHANGES IN NEW CAPITAL BALANCES,ANALYSIS OF CHANGES IN NEW CAPITAL BALANCES,ANALYSIS OF CHANGES IN NEW CAPITAL BALANCES,ANALYSIS OF CHANGES IN NEW CAPITAL BALANCES,ANALYSIS OF CHANGES IN NEW CAPITAL BALANCES,ANALYSIS OF CHANGES IN NEW CAPITAL BALANCES,ADJUSTMENTS,ADJUSTMENTS,ADJUSTMENTS,ADJUSTMENTS,ADJUSTMENTS,ADJUSTMENTS,ADJUSTMENTS,ADJUSTMENTS,ADJUSTMENTS,ADJUSTMENTS,ADJUSTMENTS,ADJUSTMENTS,ADJUSTMENTS,ADJUSTMENTS,TRIAL BALANCE OF EXPENSE ACCOUNTS,TRIAL BALANCE OF EXPENSE ACCOUNTS,TRIAL BALANCE OF EXPENSE ACCOUNTS,TRIAL BALANCE OF EXPENSE ACCOUNTS,TRIAL BALANCE OF EXPENSE ACCOUNTS,TRIAL BALANCE OF EXPENSE ACCOUNTS,TRIAL BALANCE OF EXPENSE ACCOUNTS,TRIAL BALANCE OF EXPENSE ACCOUNTS,TRIAL BALANCE OF EXPENSE ACCOUNTS,TRIAL BALANCE OF EXPENSE ACCOUNTS,TRIAL BALANCE OF EXPENSE ACCOUNTS,TRIAL BALANCE OF EXPENSE ACCOUNTS,TRIAL BALANCE OF EXPENSE ACCOUNTS,TRIAL BALANCE OF EXPENSE ACCOUNTS,TRIAL BALANCE OF EXPENSE ACCOUNTS,TRIAL BALANCE OF EXPENSE ACCOUNTS,TRIAL BALANCE OF EXPENSE ACCOUNTS,TRIAL BALANCE OF EXPENSE ACCOUNTS,TRIAL BALANCE OF EXPENSE ACCOUNTS,TRIAL BALANCE OF EXPENSE ACCOUNTS,TRIAL BALANCE OF EXPENSE ACCOUNTS,TRIAL BALANCE OF EXPENSE ACCOUNTS,TRIAL BALANCE OF EXPENSE ACCOUNTS,TRIAL BALANCE OF EXPENSE ACCOUNTS,TRIAL BALANCE OF EXPENSE ACCOUNTS,TRIAL BALANCE OF EXPENSE ACCOUNTS,TRIAL BALANCE OF EXPENSE ACCOUNTS,TRIAL BALANCE OF EXPENSE ACCOUNTS,TRIAL BALANCE OF EXPENSE ACCOUNTS,TRIAL BALANCE OF EXPENSE ACCOUNTS,TRIAL BALANCE OF EXPENSE ACCOUNTS,TRIAL BALANCE OF EXPENSE ACCOUNTS,TRIAL BALANCE OF EXPENSE ACCOUNTS,TRIAL BALANCE OF EXPENSE ACCOUNTS,TRIAL BALANCE OF EXPENSE ACCOUNTS,TRIAL BALANCE OF EXPENSE ACCOUNTS,TRIAL BALANCE OF EXPENSE ACCOUNTS,TRIAL BALANCE OF EXPENSE ACCOUNTS,TRIAL BALANCE OF EXPENSE ACCOUNTS,TRIAL BALANCE OF EXPENSE ACCOUNTS,TRIAL BALANCE OF EXPENSE ACCOUNTS,TRIAL BALANCE OF EXPENSE ACCOUNTS,TRIAL BALANCE OF EXPENSE ACCOUNTS,TRIAL BALANCE OF EXPENSE ACCOUNTS,TRIAL BALANCE OF EXPENSE ACCOUNTS,TRIAL BALANCE OF EXPENSE ACCOUNTS,TRIAL BALANCE OF EXPENSE ACCOUNTS,TRIAL BALANCE OF EXPENSE ACCOUNTS,TRIAL BALANCE OF EXPENSE ACCOUNTS,COST ALLOCATION,COST ALLOCATION,COST ALLOCATION,COST ALLOCATION,COST ALLOCATION,COST ALLOCATION,COST ALLOCATION,COST ALLOCATION,COST ALLOCATION,COST ALLOCATION,COST ALLOCATION,COST ALLOCATION,COST ALLOCATION,COST ALLOCATION,COST ALLOCATION,COST ALLOCATION,COST ALLOCATION,COST ALLOCATION,COST ALLOCATION,COST ALLOCATION,COST ALLOCATION,COST ALLOCATION,COST ALLOCATION,COST ALLOCATION,COST ALLOCATION,COST ALLOCATION,COST ALLOCATION,COST ALLOCATION,COST ALLOCATION,COST ALLOCATION,COST ALLOCATION,COST ALLOCATION,COST ALLOCATION,COST ALLOCATION,COST ALLOCATION,COST ALLOCATION,COST ALLOCATION,COST ALLOCATION,COST ALLOCATION,COST ALLOCATION,COST ALLOCATION,COST ALLOCATION,COST ALLOCATION,COST ALLOCATION,COST ALLOCATION,COST ALLOCATION,COST ALLOCATION,COST ALLOCATION,COST ALLOCATION,COST ALLOCATION,COST ALLOCATION,COST ALLOCATION,COST ALLOCATION,COST ALLOCATION,COST ALLOCATION,COST ALLOCATION,COST ALLOCATION,COST ALLOCATION,COST ALLOCATION,COST ALLOCATION,COST ALLOCATION,ALLOCATION OF NEW CAPITAL COSTS,ALLOCATION OF NEW CAPITAL COSTS,ALLOCATION OF NEW CAPITAL COSTS,ALLOCATION OF NEW CAPITAL COSTS,ALLOCATION OF NEW CAPITAL COSTS,ALLOCATION OF NEW CAPITAL COSTS,ALLOCATION OF NEW CAPITAL COSTS,ALLOCATION OF NEW CAPITAL COSTS,ALLOCATION OF NEW CAPITAL COSTS,ALLOCATION OF NEW CAPITAL COSTS,ALLOCATION OF NEW CAPITAL COSTS,ALLOCATION OF NEW CAPITAL COSTS,ALLOCATION OF NEW CAPITAL COSTS,ALLOCATION OF NEW CAPITAL COSTS,COMPUTATION OF RATIO OF COST TO CHARGES,COMPUTATION OF RATIO OF COST TO CHARGES,COMPUTATION OF RATIO OF COST TO CHARGES,COMPUTATION OF RATIO OF COST TO CHARGES,COMPUTATION OF RATIO OF COST TO CHARGES,COMPUTATION OF RATIO OF COST TO CHARGES,COMPUTATION OF RATIO OF COST TO CHARGES,COMPUTATION OF RATIO OF COST TO CHARGES,COMPUTATION OF RATIO OF COST TO CHARGES,COMPUTATION OF RATIO OF COST TO CHARGES,COMPUTATION OF RATIO OF COST TO CHARGES,COMPUTATION OF RATIO OF COST TO CHARGES,COMPUTATION OF RATIO OF COST TO CHARGES,COMPUTATION OF RATIO OF COST TO CHARGES,COMPUTATION OF RATIO OF COST TO CHARGES,COMPUTATION OF RATIO OF COST TO CHARGES,COMPUTATION OF RATIO OF COST TO CHARGES,COMPUTATION OF RATIO OF COST TO CHARGES,COMPUTATION OF RATIO OF COST TO CHARGES,COMPUTATION OF RATIO OF COST TO CHARGES,COMPUTATION OF RATIO OF COST TO CHARGES,COMPUTATION OF RATIO OF COST TO CHARGES,COMPUTATION OF RATIO OF COST TO CHARGES,COMPUTATION OF RATIO OF COST TO CHARGES,COMPUTATION OF RATIO OF COST TO CHARGES,COMPUTATION OF RATIO OF COST TO CHARGES,COMPUTATION OF RATIO OF COST TO CHARGES,COMPUTATION OF RATIO OF COST TO CHARGES,COMPUTATION OF RATIO OF COST TO CHARGES,COMPUTATION OF RATIO OF COST TO CHARGES,COMPUTATION OF RATIO OF COST TO CHARGES,COMPUTATION OF RATIO OF COST TO CHARGES,COMPUTATION OF RATIO OF COST TO CHARGES,COMPUTATION OF RATIO OF COST TO CHARGES,COMPUTATION OF RATIO OF COST TO CHARGES,COMPUTATION OF RATIO OF COST TO CHARGES,COMPUTATION OF RATIO OF COST TO CHARGES,COMPUTATION OF RATIO OF COST TO CHARGES,COMPUTATION OF RATIO OF COST TO CHARGES,COMPUTATION OF RATIO OF COST TO CHARGES,COMPUTATION OF INPATIENT OPERATING COSTS,COMPUTATION OF INPATIENT OPERATING COSTS,COMPUTATION OF INPATIENT OPERATING COSTS,COMPUTATION OF INPATIENT OPERATING COSTS,COMPUTATION OF INPATIENT OPERATING COSTS,COMPUTATION OF INPATIENT OPERATING COSTS,COMPUTATION OF INPATIENT OPERATING COSTS,COMPUTATION OF INPATIENT OPERATING COSTS,INPATIENT ANCILLARY SERVICE COST APPORTIONMENT,INPATIENT ANCILLARY SERVICE COST APPORTIONMENT,INPATIENT ANCILLARY SERVICE COST APPORTIONMENT,INPATIENT ANCILLARY SERVICE COST APPORTIONMENT,INPATIENT ANCILLARY SERVICE COST APPORTIONMENT,INPATIENT ANCILLARY SERVICE COST APPORTIONMENT,INPATIENT ANCILLARY SERVICE COST APPORTIONMENT,INPATIENT ANCILLARY SERVICE COST APPORTIONMENT,INPATIENT ANCILLARY SERVICE COST APPORTIONMENT,INPATIENT ANCILLARY SERVICE COST APPORTIONMENT,INPATIENT ANCILLARY SERVICE COST APPORTIONMENT,INPATIENT ANCILLARY SERVICE COST APPORTIONMENT,INPATIENT ANCILLARY SERVICE COST APPORTIONMENT,INPATIENT ANCILLARY SERVICE COST APPORTIONMENT,INPATIENT ANCILLARY SERVICE COST APPORTIONMENT,INPATIENT ANCILLARY SERVICE COST APPORTIONMENT,INPATIENT ANCILLARY SERVICE COST APPORTIONMENT,INPATIENT ANCILLARY SERVICE COST APPORTIONMENT,INPATIENT ANCILLARY SERVICE COST APPORTIONMENT,INPATIENT ANCILLARY SERVICE COST APPORTIONMENT,INPATIENT ANCILLARY SERVICE COST APPORTIONMENT,INPATIENT ANCILLARY SERVICE COST APPORTIONMENT,INPATIENT ANCILLARY SERVICE COST APPORTIONMENT,INPATIENT ANCILLARY SERVICE COST APPORTIONMENT,INPATIENT ANCILLARY SERVICE COST APPORTIONMENT,INPATIENT ANCILLARY SERVICE COST APPORTIONMENT,APPORTIONMENT OF INPATIENT ROUTINE SERVICE CAPITAL COSTS,APPORTIONMENT OF INPATIENT ROUTINE SERVICE CAPITAL COSTS,APPORTIONMENT OF INPATIENT ROUTINE SERVICE OTHER PASS THROUGH COSTS,APPORTIONMENT OF INPATIENT ROUTINE SERVICE OTHER PASS THROUGH COSTS,APPORTIONMENT OF INPATIENT ROUTINE SERVICE OTHER PASS THROUGH COSTS,APPORTIONMENT OF INPATIENT/OUTPATIENT ANCILLARY SERVICE OTH PASS THR  CSTS,APPORTIONMENT OF INPATIENT/OUTPATIENT ANCILLARY SERVICE OTH PASS THR  CSTS,APPORTIONMENT OF INPATIENT/OUTPATIENT ANCILLARY SERVICE OTH PASS THR  CSTS,APPORTIONMENT OF INPATIENT/OUTPATIENT ANCILLARY SERVICE OTH PASS THR  CSTS,APPORTIONMENT OF INPATIENT/OUTPATIENT ANCILLARY SERVICE OTH PASS THR  CSTS,APPORTIONMENT OF INPATIENT/OUTPATIENT ANCILLARY SERVICE OTH PASS THR  CSTS,APPORTIONMENT OF INPATIENT/OUTPATIENT ANCILLARY SERVICE OTH PASS THR  CSTS,APPORTIONMENT OF INPATIENT/OUTPATIENT ANCILLARY SERVICE OTH PASS THR  CSTS,APPORTIONMENT OF INPATIENT/OUTPATIENT ANCILLARY SERVICE OTH PASS THR  CSTS,APPORTIONMENT OF INPATIENT/OUTPATIENT ANCILLARY SERVICE OTH PASS THR CSTS ,APPORTIONMENT OF INPATIENT/OUTPATIENT ANCILLARY SERVICE OTH PASS THR  CSTS,APPORTIONMENT OF INPATIENT/OUTPATIENT ANCILLARY SERVICE OTH PASS THR  CSTS,APPORTIONMENT OF INPATIENT/OUTPATIENT ANCILLARY SERVICE OTH PASS THR  CSTS,APPORTIONMENT OF INPATIENT/OUTPATIENT ANCILLARY SERVICE OTH PASS THR  CSTS,APPORTIONMENT OF INPATIENT/OUTPATIENT ANCILLARY SERVICE OTHER PASS THROUGH  ,APPORTIONMENT OF INPATIENT/OUTPATIENT ANCILLARY SERVICE OTHER PASS THROUGH  ,APPORTIONMENT OF INPATIENT/OUTPATIENT ANCILLARY SERVICE OTHER PASS THROUGH  ,APPORTIONMENT OF INPATIENT/OUTPATIENT ANCILLARY SERVICE OTH PASS THR  CSTS,APPORTIONMENT OF INPATIENT/OUTPATIENT ANCILLARY SERVICE OTH PASS THR  CSTS,APPORTIONMENT OF INPATIENT/OUTPATIENT ANCILLARY SERVICE OTH PASS THR  CSTS,APPORTIONMENT OF INPATIENT/OUTPATIENT ANCILLARY SERVICE OTHER PASS THROUGH  ,APPORTIONMENT OF INPATIENT/OUTPATIENT ANCILLARY SERVICE OTH PASS THR  CSTS,APPORTIONMENT OF INPATIENT/OUTPATIENT ANCILLARY SERVICE OTH PASS THR  CSTS,APPORTIONMENT OF INPATIENT/OUTPATIENT ANCILLARY SERVICE OTH PASS THR  CSTS,APPORTIONMENT OF MEDICAL AND OTHER HEALTH SERVICES,APPORTIONMENT OF MEDICAL AND OTHER HEALTH SERVICES,APPORTIONMENT OF MEDICAL AND OTHER HEALTH SERVICES,APPORTIONMENT OF MEDICAL AND OTHER HEALTH SERVICES,APPORTIONMENT OF MEDICAL AND OTHER HEALTH SERVICES,APPORTIONMENT OF MEDICAL AND OTHER HEALTH SERVICES,APPORTIONMENT OF MEDICAL AND OTHER HEALTH SERVICES,APPORTIONMENT OF MEDICAL AND OTHER HEALTH SERVICES,APPORTIONMENT OF MEDICAL AND OTHER HEALTH SERVICES,CALCULATION OF REIMBURSMENT SETTLEMENT,CALCULATION OF REIMBURSMENT SETTLEMENT,CALCULATION OF REIMBURSMENT SETTLEMENT,CALCULATION OF REIMBURSMENT SETTLEMENT,CALCULATION OF REIMBURSMENT SETTLEMENT,CALCULATION OF REIMBURSMENT SETTLEMENT,CALCULATION OF REIMBURSMENT SETTLEMENT,CALCULATION OF REIMBURSMENT SETTLEMENT,CALCULATION OF REIMBURSMENT SETTLEMENT,CALCULATION OF REIMBURSMENT SETTLEMENT,CALCULATION OF REIMBURSMENT SETTLEMENT,CALCULATION OF REIMBURSMENT SETTLEMENT,CALCULATION OF REIMBURSMENT SETTLEMENT,CALCULATION OF REIMBURSMENT SETTLEMENT,CALCULATION OF REIMBURSMENT SETTLEMENT,CALCULATION OF REIMBURSMENT SETTLEMENT,CALCULATION OF REIMBURSMENT SETTLEMENT,CALCULATION OF REIMBURSMENT SETTLEMENT,,Total Inpatient Days/Outpatient Visits,Total Inpatient Days/Outpatient Visits,Total Inpatient Days/Outpatient Visits,Total Inpatient Days/Outpatient Visits,Total Inpatient Days/Outpatient Visits,Total Inpatient Days/Outpatient Visits,Total Inpatient Days/Outpatient Visits,Total Inpatient Days/Outpatient Visits,Total Inpatient Days/Outpatient Visits,NUMBER OF BEDS,NUMBER OF BEDS,NUMBER OF BEDS,NUMBER OF BEDS,NUMBER OF BEDS,BED DAYS AVAILABLE,BED DAYS AVAILABLE,BED DAYS AVAILABLE,BED DAYS AVAILABLE,BED DAYS AVAILABLE,BED DAYS AVAILABLE,BED DAYS AVAILABLE,BED DAYS AVAILABLE,BED DAYS AVAILABLE,BED DAYS AVAILABLE,BED DAYS AVAILABLE,BED DAYS AVAILABLE,BED DAYS AVAILABLE,Medicare Inpatient Days/Outpatient Visits,Medicaid Inpatient Days/Outpatient Visits ,Medicaid Inpatient Days/Outpatient Visits ,Medicaid Inpatient Days/Outpatient Visits ,Medicaid Inpatient Days/Outpatient Visits ,Medicaid Inpatient Days/Outpatient Visits ,Medicaid Inpatient Days/Outpatient Visits ,Total Inpatient Days/Outpatient Visits,Total Inpatient Days/Outpatient Visits,Total Inpatient Days/Outpatient Visits,Total Inpatient Days/Outpatient Visits,Total Inpatient Days/Outpatient Visits,Total Inpatient Days/Outpatient Visits,Total Inpatient Days/Outpatient Visits,Total Inpatient Days/Outpatient Visits,Total Inpatient Days/Outpatient Visits,Total Inpatient Days/Outpatient Visits,HOSPITAL WAGE INDEX DATA,HOSPITAL WAGE INDEX DATA,HOSPITAL WAGE INDEX DATA,HOSPITAL WAGE INDEX DATA,HOSPITAL WAGE INDEX DATA,HOSPITAL WAGE INDEX DATA,HOSPITAL WAGE INDEX DATA,HOSPITAL WAGE INDEX DATA,HOSPITAL WAGE INDEX DATA,HOSPITAL WAGE INDEX DATA,HOSPITAL WAGE INDEX DATA,HOSPITAL WAGE INDEX DATA,HOSPITAL WAGE INDEX DATA,HOSPITAL WAGE INDEX DATA,HOSPITAL WAGE INDEX DATA,HOSPITAL WAGE INDEX DATA,HOSPITAL WAGE INDEX DATA,HOSPITAL WAGE INDEX DATA,HOSPITAL WAGE INDEX DATA,HOSPITAL WAGE INDEX DATA,HOSPITAL WAGE INDEX DATA,HOSPITAL WAGE INDEX DATA,HOSPITAL WAGE INDEX DATA,HOSPITAL WAGE INDEX DATA,HOSPITAL WAGE INDEX DATA,HOSPITAL WAGE INDEX DATA,HOSPITAL WAGE INDEX DATA,HOSPITAL WAGE INDEX DATA,HOSPITAL WAGE INDEX DATA,HOSPITAL WAGE INDEX DATA,HOSPITAL WAGE INDEX DATA,HOSPITAL WAGE INDEX DATA,HOSPITAL WAGE INDEX DATA,HOSPITAL WAGE INDEX DATA,HOSPITAL WAGE INDEX DATA,HOSPITAL WAGE INDEX DATA,HOSPITAL WAGE INDEX DATA,HOSPITAL WAGE INDEX DATA,HOSPITAL WAGE INDEX DATA,HOSPITAL WAGE INDEX DATA,HOSPITAL WAGE INDEX DATA,HOSPITAL WAGE INDEX DATA,HOSPITAL WAGE INDEX DATA,HOSPITAL WAGE INDEX DATA,HOSPITAL WAGE INDEX DATA,HOSPITAL WAGE INDEX DATA,HOSPITAL WAGE INDEX DATA,HOSPITAL WAGE INDEX DATA,HOSPITAL WAGE INDEX DATA,HOSPITAL WAGE INDEX DATA,HOSPITAL WAGE INDEX DATA,HOSPITAL WAGE INDEX DATA,HOSPITAL WAGE INDEX DATA,HOSPITAL WAGE INDEX DATA,HHA STATISTICAL DATA,HHA STATISTICAL DATA,HHA STATISTICAL DATA,HHA STATISTICAL DATA,HHA STATISTICAL DATA,HHA STATISTICAL DATA,HHA STATISTICAL DATA,HHA STATISTICAL DATA,HHA STATISTICAL DATA,HHA STATISTICAL DATA,HHA STATISTICAL DATA,HHA STATISTICAL DATA,HHA STATISTICAL DATA,HHA STATISTICAL DATA,HHA STATISTICAL DATA,HHA STATISTICAL DATA,HHA STATISTICAL DATA,HHA STATISTICAL DATA,HHA STATISTICAL DATA,HHA STATISTICAL DATA,HHA STATISTICAL DATA,HHA STATISTICAL DATA,HHA STATISTICAL DATA,HHA STATISTICAL DATA,HHA STATISTICAL DATA,HHA STATISTICAL DATA,HHA STATISTICAL DATA,HHA STATISTICAL DATA,HHA STATISTICAL DATA,HHA STATISTICAL DATA,HHA STATISTICAL DATA,HHA STATISTICAL DATA,HHA STATISTICAL DATA,HHA STATISTICAL DATA,HHA STATISTICAL DATA,HHA STATISTICAL DATA,HHA STATISTICAL DATA,HHA STATISTICAL DATA,HHA STATISTICAL DATA,HHA STATISTICAL DATA,HHA STATISTICAL DATA,HHA STATISTICAL DATA,HHA STATISTICAL DATA,HHA STATISTICAL DATA,HHA STATISTICAL DATA,HHA STATISTICAL DATA,HHA STATISTICAL DATA,HHA STATISTICAL DATA,HHA STATISTICAL DATA,HHA STATISTICAL DATA,HHA STATISTICAL DATA,HHA STATISTICAL DATA,HHA STATISTICAL DATA,HHA STATISTICAL DATA,HHA STATISTICAL DATA,HHA STATISTICAL DATA,HHA STATISTICAL DATA,HHA STATISTICAL DATA,HHA STATISTICAL DATA,HHA STATISTICAL DATA,HHA STATISTICAL DATA,RENAL STATISTICAL DATA,RENAL STATISTICAL DATA,RENAL STATISTICAL DATA,RENAL STATISTICAL DATA,RENAL STATISTICAL DATA,RENAL STATISTICAL DATA,RENAL STATISTICAL DATA,RENAL STATISTICAL DATA,RENAL STATISTICAL DATA,RENAL STATISTICAL DATA,RENAL STATISTICAL DATA,RENAL STATISTICAL DATA,RENAL STATISTICAL DATA,RENAL STATISTICAL DATA,RENAL STATISTICAL DATA,RENAL STATISTICAL DATA,RENAL STATISTICAL DATA,RENAL STATISTICAL DATA,ANALYSIS OF CHANGES IN NEW CAPITAL BALANCES,ANALYSIS OF CHANGES IN NEW CAPITAL BALANCES,ANALYSIS OF CHANGES IN NEW CAPITAL BALANCES,ANALYSIS OF CHANGES IN NEW CAPITAL BALANCES,ANALYSIS OF CHANGES IN NEW CAPITAL BALANCES,ANALYSIS OF CHANGES IN NEW CAPITAL BALANCES,ANALYSIS OF CHANGES IN NEW CAPITAL BALANCES,ANALYSIS OF CHANGES IN NEW CAPITAL BALANCES,RECONCILIATION OF CAPITAL COST CENTERS,RECONCILIATION OF CAPITAL COST CENTERS,RECONCILIATION OF CAPITAL COST CENTERS,ADJUSTMENTS,ADJUSTMENTS,ADJUSTMENTS,ADJUSTMENTS,ADJUSTMENTS,ADJUSTMENTS,ADJUSTMENTS,ADJUSTMENTS,TRIAL BALANCE OF EXPENSE ACCOUNTS,TRIAL BALANCE OF EXPENSE ACCOUNTS,TRIAL BALANCE OF EXPENSE ACCOUNTS,TRIAL BALANCE OF EXPENSE ACCOUNTS,TRIAL BALANCE OF EXPENSE ACCOUNTS,TRIAL BALANCE OF EXPENSE ACCOUNTS,TRIAL BALANCE OF EXPENSE ACCOUNTS,COST ALLOCATION,COST ALLOCATION,COST ALLOCATION,COST ALLOCATION,ALLOCATION OF NEW CAPITAL COSTS,ALLOCATION OF NEW CAPITAL COSTS,COMPUTATION OF RATIO OF COST TO CHARGES,COMPUTATION OF RATIO OF COST TO CHARGES,COMPUTATION OF RATIO OF COST TO CHARGES,COMPUTATION OF RATIO OF COST TO CHARGES,COMPUTATION OF RATIO OF COST TO CHARGES,COMPUTATION OF INPATIENT OPERATING COSTS,COMPUTATION OF INPATIENT OPERATING COSTS,COMPUTATION OF INPATIENT OPERATING COSTS,COMPUTATION OF INPATIENT OPERATING COSTS,COMPUTATION OF INPATIENT OPERATING COSTS,COMPUTATION OF INPATIENT OPERATING COSTS,INPATIENT ANCILLARY SERVICE COST APPORTIONMENT,INPATIENT ANCILLARY SERVICE COST APPORTIONMENT,APPORTIONMENT OF MEDICAL AND OTHER HEALTH SERVICES,APPORTIONMENT OF MEDICAL AND OTHER HEALTH SERVICES,CALCULATION OF REIMBURSMENT SETTLEMENT,CALCULATION OF REIMBURSMENT SETTLEMENT,CALCULATION OF REIMBURSMENT SETTLEMENT,CALCULATION OF REIMBURSMENT SETTLEMENT,CALCULATION OF REIMBURSMENT SETTLEMENT,CALCULATION OF REIMBURSMENT SETTLEMENT,CALCULATION OF REIMBURSMENT SETTLEMENT,CALCULATION OF REIMBURSMENT SETTLEMENT,CALCULATION OF REIMBURSMENT SETTLEMENT,CALCULATION OF REIMBURSMENT SETTLEMENT,RENAL STATISTICAL DATA,,Total Inpatient Days/Outpatient Visits,Total Inpatient Days/Outpatient Visits,NUMBER OF BEDS,NUMBER OF BEDS,NUMBER OF BEDS,NUMBER OF BEDS,BED DAYS AVAILABLE,BED DAYS AVAILABLE,BED DAYS AVAILABLE,BED DAYS AVAILABLE,BED DAYS AVAILABLE,BED DAYS AVAILABLE,Medicare Inpatient Days/Outpatient Visits,Medicare Inpatient Days/Outpatient Visits,Medicare Inpatient Days/Outpatient Visits,Medicare Inpatient Days/Outpatient Visits,Medicare Inpatient Days/Outpatient Visits,Total Inpatient Days/Outpatient Visits,Total Inpatient Days/Outpatient Visits,Total Inpatient Days/Outpatient Visits,Total Inpatient Days/Outpatient Visits,Total Inpatient Days/Outpatient Visits,Total Inpatient Days/Outpatient Visits,ANALYSIS OF CHANGES IN NEW CAPITAL BALANCES,ANALYSIS OF CHANGES IN NEW CAPITAL BALANCES,ANALYSIS OF CHANGES IN NEW CAPITAL BALANCES,ANALYSIS OF CHANGES IN NEW CAPITAL BALANCES,ANALYSIS OF CHANGES IN NEW CAPITAL BALANCES,ANALYSIS OF CHANGES IN NEW CAPITAL BALANCES,ANALYSIS OF CHANGES IN NEW CAPITAL BALANCES,ANALYSIS OF CHANGES IN NEW CAPITAL BALANCES,ANALYSIS OF CHANGES IN NEW CAPITAL BALANCES,ANALYSIS OF CHANGES IN NEW CAPITAL BALANCES,ANALYSIS OF CHANGES IN NEW CAPITAL BALANCES,ANALYSIS OF CHANGES IN NEW CAPITAL BALANCES,ANALYSIS OF CHANGES IN NEW CAPITAL BALANCES,ANALYSIS OF CHANGES IN NEW CAPITAL BALANCES,RECONCILIATION OF CAPITAL COST CENTERS,RECONCILIATION OF CAPITAL COST CENTERS,RECONCILIATION OF CAPITAL COST CENTERS,RECONCILIATION OF CAPITAL COST CENTERS,ADJUSTMENTS,TRIAL BALANCE OF EXPENSE ACCOUNTS,TRIAL BALANCE OF EXPENSE ACCOUNTS,TRIAL BALANCE OF EXPENSE ACCOUNTS,TRIAL BALANCE OF EXPENSE ACCOUNTS,TRIAL BALANCE OF EXPENSE ACCOUNTS,COST ALLOCATION,COST ALLOCATION,ALLOCATION OF NEW CAPITAL COSTS,ALLOCATION OF NEW CAPITAL COSTS,COMPUTATION OF RATIO OF COST TO CHARGES,COMPUTATION OF RATIO OF COST TO CHARGES,COMPUTATION OF RATIO OF COST TO CHARGES,COMPUTATION OF RATIO OF COST TO CHARGES,COMPUTATION OF RATIO OF COST TO CHARGES,COMPUTATION OF RATIO OF COST TO CHARGES,COMPUTATION OF INPATIENT OPERATING COSTS,COMPUTATION OF INPATIENT OPERATING COSTS,COMPUTATION OF INPATIENT OPERATING COSTS,COMPUTATION OF INPATIENT OPERATING COSTS,APPORTIONMENT OF INPATIENT ROUTINE SERVICE CAPITAL COSTS,APPORTIONMENT OF INPATIENT ROUTINE SERVICE CAPITAL COSTS,APPORTIONMENT OF INPATIENT ROUTINE SERVICE CAPITAL COSTS,APPORTIONMENT OF INPATIENT ROUTINE SERVICE CAPITAL COSTS,APPORTIONMENT OF INPATIENT ROUTINE SERVICE CAPITAL COSTS,APPORTIONMENT OF INPATIENT ROUTINE SERVICE CAPITAL COSTS,APPORTIONMENT OF INPATIENT ROUTINE SERVICE CAPITAL COSTS,APPORTIONMENT OF INPATIENT ROUTINE SERVICE OTHER PASS THROUGH COSTS,APPORTIONMENT OF INPATIENT ROUTINE SERVICE OTHER PASS THROUGH COSTS,APPORTIONMENT OF INPATIENT/OUTPATIENT ANCILLARY SERVICE OTH PASS THR  CSTS,APPORTIONMENT OF INPATIENT/OUTPATIENT ANCILLARY SERVICE OTH PASS THR  CSTS,APPORTIONMENT OF INPATIENT/OUTPATIENT ANCILLARY SERVICE OTH PASS THR  CSTS,APPORTIONMENT OF INPATIENT/OUTPATIENT ANCILLARY SERVICE OTH PASS THR CSTS ,APPORTIONMENT OF INPATIENT/OUTPATIENT ANCILLARY SERVICE OTH PASS THR CSTS ,APPORTIONMENT OF MEDICAL AND OTHER HEALTH SERVICES,APPORTIONMENT OF MEDICAL AND OTHER HEALTH SERVICES,APPORTIONMENT OF MEDICAL AND OTHER HEALTH SERVICES,APPORTIONMENT OF MEDICAL AND OTHER HEALTH SERVICES,CALCULATION OF REIMBURSMENT SETTLEMENT,CALCULATION OF REIMBURSMENT SETTLEMENT,CALCULATION OF REIMBURSMENT SETTLEMENT,CALCULATION OF REIMBURSMENT SETTLEMENT,CALCULATION OF REIMBURSMENT SETTLEMENT,CALCULATION OF REIMBURSMENT SETTLEMENT,CALCULATION OF REIMBURSMENT SETTLEMENT,CALCULATION OF REIMBURSMENT SETTLEMENT,CALCULATION OF REIMBURSMENT SETTLEMENT,CALCULATION OF REIMBURSMENT SETTLEMENT,CALCULATION OF REIMBURSMENT SETTLEMENT,CALCULATION OF REIMBURSMENT SETTLEMENT,,,,NUMBER OF BEDS,BED DAYS AVAILABLE,Medicare Inpatient Days/Outpatient Visits,Medicaid Inpatient Days/Outpatient Visits ,Medicaid Inpatient Days/Outpatient Visits ,Medicaid Inpatient Days/Outpatient Visits ,Medicaid Inpatient Days/Outpatient Visits ,Medicaid Inpatient Days/Outpatient Visits ,Medicaid Inpatient Days/Outpatient Visits ,Total Inpatient Days/Outpatient Visits,Total Inpatient Days/Outpatient Visits,HOSPITAL WAGE INDEX DATA,HOSPITAL WAGE INDEX DATA,HOSPITAL WAGE INDEX DATA,HOSPITAL WAGE INDEX DATA,HOSPITAL WAGE INDEX DATA,HOSPITAL WAGE INDEX DATA,HOSPITAL WAGE INDEX DATA,HOSPITAL WAGE INDEX DATA,HOSPITAL WAGE INDEX DATA,HOSPITAL WAGE INDEX DATA,HOSPITAL WAGE INDEX DATA,HOSPITAL WAGE INDEX DATA,HOSPITAL WAGE INDEX DATA,HOSPITAL WAGE INDEX DATA,HOSPITAL WAGE INDEX DATA,HOSPITAL WAGE INDEX DATA,HOSPITAL WAGE INDEX DATA,HOSPITAL WAGE INDEX DATA,HOSPITAL WAGE INDEX DATA,HOSPITAL WAGE INDEX DATA,HOSPITAL WAGE INDEX DATA,HOSPITAL WAGE INDEX DATA,HOSPITAL WAGE INDEX DATA,HOSPITAL WAGE INDEX DATA,HOSPITAL WAGE INDEX DATA,HOSPITAL WAGE INDEX DATA,HOSPITAL WAGE INDEX DATA,HOSPITAL WAGE INDEX DATA,HOSPITAL WAGE INDEX DATA,HOSPITAL WAGE INDEX DATA,HOSPITAL WAGE INDEX DATA,HOSPITAL WAGE INDEX DATA,HOSPITAL WAGE INDEX DATA,HOSPITAL WAGE INDEX DATA,HOSPITAL WAGE INDEX DATA,HOSPITAL WAGE INDEX DATA,HOSPITAL WAGE INDEX DATA,HOSPITAL WAGE INDEX DATA,HOSPITAL WAGE INDEX DATA,HOSPITAL WAGE INDEX DATA,HOSPITAL WAGE INDEX DATA,HOSPITAL WAGE INDEX DATA,HOSPITAL WAGE INDEX DATA,HOSPITAL WAGE INDEX DATA,HOSPITAL WAGE INDEX DATA,HOSPITAL WAGE INDEX DATA,HOSPITAL WAGE INDEX DATA,HOSPITAL WAGE INDEX DATA,HOSPITAL WAGE INDEX DATA,HOSPITAL WAGE INDEX DATA,HOSPITAL WAGE INDEX DATA,HOSPITAL WAGE INDEX DATA,HOSPITAL WAGE INDEX DATA,HOSPITAL WAGE INDEX DATA,HOSPITAL WAGE INDEX DATA,HOSPITAL WAGE INDEX DATA,HOSPITAL WAGE INDEX DATA,HOSPITAL WAGE INDEX DATA,HOSPITAL WAGE INDEX DATA,HOSPITAL WAGE INDEX DATA,HOSPITAL WAGE INDEX DATA,HOSPITAL WAGE INDEX DATA,HOSPITAL WAGE INDEX DATA,HOSPITAL WAGE INDEX DATA,HOSPITAL WAGE INDEX DATA,HOSPITAL WAGE INDEX DATA,HOSPITAL WAGE INDEX DATA,HOSPITAL WAGE INDEX DATA,HOSPITAL WAGE INDEX DATA,HOSPITAL WAGE INDEX DATA,HOSPITAL WAGE INDEX DATA,HOSPITAL WAGE INDEX DATA,HOSPITAL WAGE INDEX DATA,HOSPITAL WAGE INDEX DATA,HOSPITAL WAGE INDEX DATA,HOSPITAL WAGE INDEX DATA,HOSPITAL WAGE INDEX DATA,HOSPITAL WAGE INDEX DATA,HOSPITAL WAGE INDEX DATA,HOSPITAL WAGE INDEX DATA,HOSPITAL WAGE INDEX DATA,HOSPITAL WAGE INDEX DATA,HOSPITAL WAGE INDEX DATA,HOSPITAL WAGE INDEX DATA,HOSPITAL WAGE INDEX DATA,HOSPITAL WAGE INDEX DATA,HOSPITAL WAGE INDEX DATA,HOSPITAL WAGE INDEX DATA,HOSPITAL WAGE INDEX DATA,HOSPITAL WAGE INDEX DATA,HOSPITAL WAGE INDEX DATA,HOSPITAL WAGE INDEX DATA,HOSPITAL WAGE INDEX DATA,HOSPITAL WAGE INDEX DATA,HOSPITAL WAGE INDEX DATA,HOSPITAL WAGE INDEX DATA,HOSPITAL WAGE INDEX DATA,HOSPITAL WAGE INDEX DATA,HOSPITAL WAGE INDEX DATA,HOSPITAL WAGE INDEX DATA,HOSPITAL WAGE INDEX DATA,HOSPITAL WAGE INDEX DATA,HOSPITAL WAGE INDEX DATA,HOSPITAL WAGE INDEX DATA,HOSPITAL WAGE INDEX DATA,HOSPITAL WAGE INDEX DATA,HOSPITAL WAGE INDEX DATA,HOSPITAL WAGE INDEX DATA,HOSPITAL WAGE INDEX DATA,HOSPITAL WAGE INDEX DATA,HOSPITAL WAGE INDEX DATA,ADJUSTMENTS,TRIAL BALANCE OF EXPENSE ACCOUNTS,TRIAL BALANCE OF EXPENSE ACCOUNTS,TRIAL BALANCE OF EXPENSE ACCOUNTS,TRIAL BALANCE OF EXPENSE ACCOUNTS,TRIAL BALANCE OF EXPENSE ACCOUNTS,COST ALLOCATION,COST ALLOCATION,COST ALLOCATION,COST ALLOCATION,COST ALLOCATION,COST ALLOCATION,ALLOCATION OF NEW CAPITAL COSTS,ALLOCATION OF NEW CAPITAL COSTS,COMPUTATION OF RATIO OF COST TO CHARGES,COMPUTATION OF RATIO OF COST TO CHARGES,COMPUTATION OF RATIO OF COST TO CHARGES,COMPUTATION OF RATIO OF COST TO CHARGES,COMPUTATION OF RATIO OF COST TO CHARGES,COMPUTATION OF RATIO OF COST TO CHARGES,COMPUTATION OF INPATIENT OPERATING COSTS,COMPUTATION OF INPATIENT OPERATING COSTS,COMPUTATION OF INPATIENT OPERATING COSTS,COMPUTATION OF INPATIENT OPERATING COSTS,COMPUTATION OF INPATIENT OPERATING COSTS,COMPUTATION OF INPATIENT OPERATING COSTS,COMPUTATION OF INPATIENT OPERATING COSTS,COMPUTATION OF INPATIENT OPERATING COSTS,INPATIENT ANCILLARY SERVICE COST APPORTIONMENT,INPATIENT ANCILLARY SERVICE COST APPORTIONMENT,INPATIENT ANCILLARY SERVICE COST APPORTIONMENT,INPATIENT ANCILLARY SERVICE COST APPORTIONMENT,Total Inpatient Days/Outpatient Visits,NUMBER OF BEDS,BED DAYS AVAILABLE,Medicare Inpatient Days/Outpatient Visits,Medicaid Inpatient Days/Outpatient Visits ,Total Inpatient Days/Outpatient Visits,TRIAL BALANCE OF EXPENSE ACCOUNTS,ANALYSIS OF CHANGES IN NEW CAPITAL BALANCES,ANALYSIS OF CHANGES IN NEW CAPITAL BALANCES,ADJUSTMENTS,TRIAL BALANCE OF EXPENSE ACCOUNTS,ALLOCATION OF NEW CAPITAL COSTS,TRIAL BALANCE OF EXPENSE ACCOUNTS,TRIAL BALANCE OF EXPENSE ACCOUNTS,COST ALLOCATION,COST ALLOCATION,ALLOCATION OF NEW CAPITAL COSTS,COMPUTATION OF RATIO OF COST TO CHARGES,COMPUTATION OF RATIO OF COST TO CHARGES,COMPUTATION OF RATIO OF COST TO CHARGES,INPATIENT ANCILLARY SERVICE COST APPORTIONMENT,INPATIENT ANCILLARY SERVICE COST APPORTIONMENT,APPORTIONMENT OF INPATIENT/OUTPATIENT ANCILLARY SERVICE OTH PASS THR  CSTS,APPORTIONMENT OF MEDICAL AND OTHER HEALTH SERVICES,APPORTIONMENT OF MEDICAL AND OTHER HEALTH SERVICES,APPORTIONMENT OF MEDICAL AND OTHER HEALTH SERVICES,APPORTIONMENT OF MEDICAL AND OTHER HEALTH SERVICES,APPORTIONMENT OF MEDICAL AND OTHER HEALTH SERVICES,APPORTIONMENT OF MEDICAL AND OTHER HEALTH SERVICES,CALCULATION OF REIMBURSMENT SETTLEMENT,CALCULATION OF REIMBURSMENT SETTLEMENT,,,Medicare Inpatient Days/Outpatient Visits,HOSPITAL WAGE INDEX DATA,HOSPITAL WAGE INDEX DATA,HOSPITAL WAGE INDEX DATA,HOSPITAL WAGE INDEX DATA,HOSPITAL WAGE INDEX DATA,HOSPITAL WAGE INDEX DATA,HOSPITAL WAGE INDEX DATA,HOSPITAL WAGE INDEX DATA,HOSPITAL WAGE INDEX DATA,HOSPITAL WAGE INDEX DATA,HOSPITAL WAGE INDEX DATA,HOSPITAL WAGE INDEX DATA,HOSPITAL WAGE INDEX DATA,HOSPITAL WAGE INDEX DATA,HOSPITAL WAGE INDEX DATA,HOSPITAL WAGE INDEX DATA,HOSPITAL WAGE INDEX DATA,HHA STATISTICAL DATA,HHA STATISTICAL DATA,HHA STATISTICAL DATA,HHA STATISTICAL DATA,HHA STATISTICAL DATA,HHA STATISTICAL DATA,HHA STATISTICAL DATA,HHA STATISTICAL DATA,HHA STATISTICAL DATA,HHA STATISTICAL DATA,HHA STATISTICAL DATA,HHA STATISTICAL DATA,HHA STATISTICAL DATA,HHA STATISTICAL DATA,HHA STATISTICAL DATA,HHA STATISTICAL DATA,HHA STATISTICAL DATA,HHA STATISTICAL DATA,HHA STATISTICAL DATA,HHA STATISTICAL DATA,RENAL STATISTICAL DATA,RENAL STATISTICAL DATA,RENAL STATISTICAL DATA,RENAL STATISTICAL DATA,RENAL STATISTICAL DATA,RENAL STATISTICAL DATA,RENAL STATISTICAL DATA,RENAL STATISTICAL DATA,RENAL STATISTICAL DATA,RENAL STATISTICAL DATA,RENAL STATISTICAL DATA,RENAL STATISTICAL DATA,ANALYSIS OF CHANGES IN NEW CAPITAL BALANCES,ADJUSTMENTS,ADJUSTMENTS,TRIAL BALANCE OF EXPENSE ACCOUNTS,TRIAL BALANCE OF EXPENSE ACCOUNTS,TRIAL BALANCE OF EXPENSE ACCOUNTS,COST ALLOCATION,COST ALLOCATION,COST ALLOCATION,COST ALLOCATION,ALLOCATION OF NEW CAPITAL COSTS,COMPUTATION OF RATIO OF COST TO CHARGES,COMPUTATION OF RATIO OF COST TO CHARGES,COMPUTATION OF INPATIENT OPERATING COSTS,COMPUTATION OF INPATIENT OPERATING COSTS,COMPUTATION OF INPATIENT OPERATING COSTS,COMPUTATION OF INPATIENT OPERATING COSTS,COMPUTATION OF INPATIENT OPERATING COSTS,COMPUTATION OF INPATIENT OPERATING COSTS,COMPUTATION OF INPATIENT OPERATING COSTS,COMPUTATION OF INPATIENT OPERATING COSTS,COMPUTATION OF INPATIENT OPERATING COSTS,INPATIENT ANCILLARY SERVICE COST APPORTIONMENT,INPATIENT ANCILLARY SERVICE COST APPORTIONMENT,INPATIENT ANCILLARY SERVICE COST APPORTIONMENT,APPORTIONMENT OF INPATIENT ROUTINE SERVICE CAPITAL COSTS,APPORTIONMENT OF INPATIENT ROUTINE SERVICE CAPITAL COSTS,APPORTIONMENT OF INPATIENT ROUTINE SERVICE CAPITAL COSTS,APPORTIONMENT OF INPATIENT ROUTINE SERVICE OTHER PASS THROUGH COSTS,APPORTIONMENT OF INPATIENT ROUTINE SERVICE OTHER PASS THROUGH COSTS,APPORTIONMENT OF INPATIENT ROUTINE SERVICE OTHER PASS THROUGH COSTS,APPORTIONMENT OF INPATIENT/OUTPATIENT ANCILLARY SERVICE OTH PASS THR CSTS ,APPORTIONMENT OF INPATIENT/OUTPATIENT ANCILLARY SERVICE OTH PASS THR  CSTS,APPORTIONMENT OF INPATIENT/OUTPATIENT ANCILLARY SERVICE OTHER PASS THROUGH  ,APPORTIONMENT OF INPATIENT/OUTPATIENT ANCILLARY SERVICE OTHER PASS THROUGH  ,APPORTIONMENT OF INPATIENT/OUTPATIENT ANCILLARY SERVICE OTHER PASS THROUGH  ,CALCULATION OF REIMBURSMENT SETTLEMENT,,,NUMBER OF BEDS,BED DAYS AVAILABLE,Medicare Inpatient Days/Outpatient Visits,Medicaid Inpatient Days/Outpatient Visits ,Total Inpatient Days/Outpatient Visits,Total Inpatient Days/Outpatient Visits,Total Inpatient Days/Outpatient Visits,HOSPITAL WAGE INDEX DATA,HOSPITAL WAGE INDEX DATA,HOSPITAL WAGE INDEX DATA,HOSPITAL WAGE INDEX DATA,ANALYSIS OF CHANGES IN NEW CAPITAL BALANCES,ALLOCATION OF NEW CAPITAL COSTS,HOSPITAL WAGE INDEX DATA,HOSPITAL WAGE INDEX DATA,HOSPITAL WAGE INDEX DATA,HOSPITAL WAGE INDEX DATA,HOSPITAL WAGE INDEX DATA,HOSPITAL WAGE INDEX DATA,ADJUSTMENTS,COST ALLOCATION,ADJUSTMENTS,ADJUSTMENTS,TRIAL BALANCE OF EXPENSE ACCOUNTS,COST ALLOCATION,COST ALLOCATION,COST ALLOCATION,ALLOCATION OF NEW CAPITAL COSTS,COMPUTATION OF RATIO OF COST TO CHARGES,COMPUTATION OF INPATIENT OPERATING COSTS,COMPUTATION OF INPATIENT OPERATING COSTS,COMPUTATION OF INPATIENT OPERATING COSTS,COMPUTATION OF INPATIENT OPERATING COSTS,INPATIENT ANCILLARY SERVICE COST APPORTIONMENT,INPATIENT ANCILLARY SERVICE COST APPORTIONMENT,INPATIENT ANCILLARY SERVICE COST APPORTIONMENT,APPORTIONMENT OF INPATIENT ROUTINE SERVICE CAPITAL COSTS,APPORTIONMENT OF INPATIENT ROUTINE SERVICE CAPITAL COSTS,APPORTIONMENT OF INPATIENT ROUTINE SERVICE CAPITAL COSTS,APPORTIONMENT OF INPATIENT ROUTINE SERVICE OTHER PASS THROUGH COSTS,APPORTIONMENT OF INPATIENT ROUTINE SERVICE OTHER PASS THROUGH COSTS,APPORTIONMENT OF INPATIENT/OUTPATIENT ANCILLARY SERVICE OTH PASS THR  CSTS,APPORTIONMENT OF INPATIENT/OUTPATIENT ANCILLARY SERVICE OTHER PASS THROUGH  ,APPORTIONMENT OF INPATIENT/OUTPATIENT ANCILLARY SERVICE OTHER PASS THROUGH  ,CALCULATION OF REIMBURSMENT SETTLEMENT,CALCULATION OF REIMBURSMENT SETTLEMENT,,,NUMBER OF BEDS,BED DAYS AVAILABLE,Medicare Inpatient Days/Outpatient Visits,Total Inpatient Days/Outpatient Visits,HOSPITAL WAGE INDEX DATA,HOSPITAL WAGE INDEX DATA,HOSPITAL WAGE INDEX DATA,HOSPITAL WAGE INDEX DATA,HOSPITAL WAGE INDEX DATA,HOSPITAL WAGE INDEX DATA,HOSPITAL WAGE INDEX DATA,HOSPITAL WAGE INDEX DATA,HOSPITAL WAGE INDEX DATA,HOSPITAL WAGE INDEX DATA,,HOSPITAL WAGE INDEX DATA,HOSPITAL WAGE INDEX DATA,HOSPITAL WAGE INDEX DATA,HOSPITAL WAGE INDEX DATA,HOSPITAL WAGE INDEX DATA,HOSPITAL WAGE INDEX DATA,Medicaid Inpatient Days/Outpatient Visits ,TRIAL BALANCE OF EXPENSE ACCOUNTS,Medicaid Inpatient Days/Outpatient Visits ,,,,,,,,,,,,,,,,,,,,,,,,,,,,,,,,,,,,,,,,,,,,,,,,,,,,,,,,,,,,,,,,,,,,,,,,,,,,,,,,,,,,,,,,,,,,,,,,,,,,TRIAL BALANCE OF EXPENSE ACCOUNTS,TRIAL BALANCE OF EXPENSE ACCOUNTS,TRIAL BALANCE OF EXPENSE ACCOUNTS,TRIAL BALANCE OF EXPENSE ACCOUNTS,TRIAL BALANCE OF EXPENSE ACCOUNTS,TRIAL BALANCE OF EXPENSE ACCOUNTS,TRIAL BALANCE OF EXPENSE ACCOUNTS,TRIAL BALANCE OF EXPENSE ACCOUNTS,TRIAL BALANCE OF EXPENSE ACCOUNTS,TRIAL BALANCE OF EXPENSE ACCOUNTS,TRIAL BALANCE OF EXPENSE ACCOUNTS,TRIAL BALANCE OF EXPENSE ACCOUNTS,TRIAL BALANCE OF EXPENSE ACCOUNTS,TRIAL BALANCE OF EXPENSE ACCOUNTS,TRIAL BALANCE OF EXPENSE ACCOUNTS,TRIAL BALANCE OF EXPENSE ACCOUNTS,TRIAL BALANCE OF EXPENSE ACCOUNTS,TRIAL BALANCE OF EXPENSE ACCOUNTS,TRIAL BALANCE OF EXPENSE ACCOUNTS,TRIAL BALANCE OF EXPENSE ACCOUNTS,TRIAL BALANCE OF EXPENSE ACCOUNTS,TRIAL BALANCE OF EXPENSE ACCOUNTS,TRIAL BALANCE OF EXPENSE ACCOUNTS,TRIAL BALANCE OF EXPENSE ACCOUNTS,TRIAL BALANCE OF EXPENSE ACCOUNTS,TRIAL BALANCE OF EXPENSE ACCOUNTS,TRIAL BALANCE OF EXPENSE ACCOUNTS,TRIAL BALANCE OF EXPENSE ACCOUNTS,TRIAL BALANCE OF EXPENSE ACCOUNTS,TRIAL BALANCE OF EXPENSE ACCOUNTS,TRIAL BALANCE OF EXPENSE ACCOUNTS,TRIAL BALANCE OF EXPENSE ACCOUNTS,TRIAL BALANCE OF EXPENSE ACCOUNTS,TRIAL BALANCE OF EXPENSE ACCOUNTS,TRIAL BALANCE OF EXPENSE ACCOUNTS,TRIAL BALANCE OF EXPENSE ACCOUNTS,TRIAL BALANCE OF EXPENSE ACCOUNTS,TRIAL BALANCE OF EXPENSE ACCOUNTS,TRIAL BALANCE OF EXPENSE ACCOUNTS,TRIAL BALANCE OF EXPENSE ACCOUNTS,TRIAL BALANCE OF EXPENSE ACCOUNTS,TRIAL BALANCE OF EXPENSE ACCOUNTS,TRIAL BALANCE OF EXPENSE ACCOUNTS,TRIAL BALANCE OF EXPENSE ACCOUNTS,TRIAL BALANCE OF EXPENSE ACCOUNTS,TRIAL BALANCE OF EXPENSE ACCOUNTS,TRIAL BALANCE OF EXPENSE ACCOUNTS,TRIAL BALANCE OF EXPENSE ACCOUNTS,TRIAL BALANCE OF EXPENSE ACCOUNTS,TRIAL BALANCE OF EXPENSE ACCOUNTS,TRIAL BALANCE OF EXPENSE ACCOUNTS,TRIAL BALANCE OF EXPENSE ACCOUNTS,TRIAL BALANCE OF EXPENSE ACCOUNTS,TRIAL BALANCE OF EXPENSE ACCOUNTS,TRIAL BALANCE OF EXPENSE ACCOUNTS,TRIAL BALANCE OF EXPENSE ACCOUNTS,TRIAL BALANCE OF EXPENSE ACCOUNTS,TRIAL BALANCE OF EXPENSE ACCOUNTS,TRIAL BALANCE OF EXPENSE ACCOUNTS,TRIAL BALANCE OF EXPENSE ACCOUNTS,TRIAL BALANCE OF EXPENSE ACCOUNTS,TRIAL BALANCE OF EXPENSE ACCOUNTS,TRIAL BALANCE OF EXPENSE ACCOUNTS,TRIAL BALANCE OF EXPENSE ACCOUNTS,TRIAL BALANCE OF EXPENSE ACCOUNTS,TRIAL BALANCE OF EXPENSE ACCOUNTS,TRIAL BALANCE OF EXPENSE ACCOUNTS,TRIAL BALANCE OF EXPENSE ACCOUNTS,TRIAL BALANCE OF EXPENSE ACCOUNTS,TRIAL BALANCE OF EXPENSE ACCOUNTS,TRIAL BALANCE OF EXPENSE ACCOUNTS,COST ALLOCATION,COST ALLOCATION,COST ALLOCATION,COST ALLOCATION,COST ALLOCATION,COST ALLOCATION,COST ALLOCATION,COST ALLOCATION,COST ALLOCATION,COST ALLOCATION,COST ALLOCATION,COST ALLOCATION,COST ALLOCATION,COST ALLOCATION,COST ALLOCATION,COST ALLOCATION,COST ALLOCATION,COST ALLOCATION,COST ALLOCATION,COST ALLOCATION,COST ALLOCATION,COST ALLOCATION,COST ALLOCATION,COST ALLOCATION,COST ALLOCATION,COST ALLOCATION,COST ALLOCATION,COST ALLOCATION,COST ALLOCATION,COST ALLOCATION,COST ALLOCATION,COST ALLOCATION,COST ALLOCATION,COST ALLOCATION,COST ALLOCATION,COST ALLOCATION,COST ALLOCATION,COST ALLOCATION,COST ALLOCATION,COST ALLOCATION,COST ALLOCATION,COST ALLOCATION,COST ALLOCATION,COST ALLOCATION,COST ALLOCATION,COST ALLOCATION,COST ALLOCATION,COST ALLOCATION,COST ALLOCATION,COST ALLOCATION,COST ALLOCATION,COST ALLOCATION,COST ALLOCATION,COST ALLOCATION,COST ALLOCATION,COST ALLOCATION,COST ALLOCATION,COST ALLOCATION,COST ALLOCATION,COST ALLOCATION,COST ALLOCATION,COST ALLOCATION,COST ALLOCATION,COST ALLOCATION,COST ALLOCATION,COST ALLOCATION,COST ALLOCATION,COST ALLOCATION,COST ALLOCATION,COST ALLOCATION,COST ALLOCATION,COST ALLOCATION,COST ALLOCATION,COST ALLOCATION,COST ALLOCATION,COST ALLOCATION,COST ALLOCATION,COST ALLOCATION,COST ALLOCATION,COST ALLOCATION,COST ALLOCATION,COST ALLOCATION,COST ALLOCATION,COST ALLOCATION,COST ALLOCATION,COST ALLOCATION,COST ALLOCATION,COST ALLOCATION,COST ALLOCATION,COST ALLOCATION,COST ALLOCATION,COST ALLOCATION,COST ALLOCATION,COST ALLOCATION,COST ALLOCATION,COST ALLOCATION,COST ALLOCATION,COST ALLOCATION,COST ALLOCATION,COST ALLOCATION,COST ALLOCATION,COST ALLOCATION,COST ALLOCATION,COST ALLOCATION,COST ALLOCATION,COST ALLOCATION,COST ALLOCATION,COST ALLOCATION,COST ALLOCATION,ALLOCATION OF NEW CAPITAL COSTS,ALLOCATION OF NEW CAPITAL COSTS,ALLOCATION OF NEW CAPITAL COSTS,ALLOCATION OF NEW CAPITAL COSTS,ALLOCATION OF NEW CAPITAL COSTS,ALLOCATION OF NEW CAPITAL COSTS,ALLOCATION OF NEW CAPITAL COSTS,ALLOCATION OF NEW CAPITAL COSTS,ALLOCATION OF NEW CAPITAL COSTS,ALLOCATION OF NEW CAPITAL COSTS,ALLOCATION OF NEW CAPITAL COSTS,ALLOCATION OF NEW CAPITAL COSTS,ALLOCATION OF NEW CAPITAL COSTS,ALLOCATION OF NEW CAPITAL COSTS,ALLOCATION OF NEW CAPITAL COSTS,COMPUTATION OF RATIO OF COST TO CHARGES,COMPUTATION OF RATIO OF COST TO CHARGES,COMPUTATION OF RATIO OF COST TO CHARGES,COMPUTATION OF RATIO OF COST TO CHARGES,COMPUTATION OF RATIO OF COST TO CHARGES,COMPUTATION OF RATIO OF COST TO CHARGES,COMPUTATION OF RATIO OF COST TO CHARGES,COMPUTATION OF RATIO OF COST TO CHARGES,COMPUTATION OF RATIO OF COST TO CHARGES,COMPUTATION OF RATIO OF COST TO CHARGES,COMPUTATION OF RATIO OF COST TO CHARGES,COMPUTATION OF RATIO OF COST TO CHARGES,COMPUTATION OF RATIO OF COST TO CHARGES,COMPUTATION OF RATIO OF COST TO CHARGES,COMPUTATION OF RATIO OF COST TO CHARGES,COMPUTATION OF RATIO OF COST TO CHARGES,COMPUTATION OF RATIO OF COST TO CHARGES,COMPUTATION OF RATIO OF COST TO CHARGES,COMPUTATION OF RATIO OF COST TO CHARGES,COMPUTATION OF RATIO OF COST TO CHARGES,COMPUTATION OF RATIO OF COST TO CHARGES,COMPUTATION OF RATIO OF COST TO CHARGES,COMPUTATION OF RATIO OF COST TO CHARGES,COMPUTATION OF RATIO OF COST TO CHARGES,COMPUTATION OF RATIO OF COST TO CHARGES,COMPUTATION OF RATIO OF COST TO CHARGES,COMPUTATION OF RATIO OF COST TO CHARGES,COMPUTATION OF RATIO OF COST TO CHARGES,COMPUTATION OF RATIO OF COST TO CHARGES,COMPUTATION OF RATIO OF COST TO CHARGES,COMPUTATION OF RATIO OF COST TO CHARGES,COMPUTATION OF RATIO OF COST TO CHARGES,COMPUTATION OF RATIO OF COST TO CHARGES,COMPUTATION OF RATIO OF COST TO CHARGES,COMPUTATION OF RATIO OF COST TO CHARGES,COMPUTATION OF RATIO OF COST TO CHARGES,COMPUTATION OF RATIO OF COST TO CHARGES,COMPUTATION OF RATIO OF COST TO CHARGES,COMPUTATION OF RATIO OF COST TO CHARGES,COMPUTATION OF RATIO OF COST TO CHARGES,COMPUTATION OF RATIO OF COST TO CHARGES,COMPUTATION OF RATIO OF COST TO CHARGES,COMPUTATION OF RATIO OF COST TO CHARGES,COMPUTATION OF RATIO OF COST TO CHARGES,COMPUTATION OF RATIO OF COST TO CHARGES,COMPUTATION OF RATIO OF COST TO CHARGES,COMPUTATION OF RATIO OF COST TO CHARGES,COMPUTATION OF RATIO OF COST TO CHARGES,COMPUTATION OF RATIO OF COST TO CHARGES,COMPUTATION OF RATIO OF COST TO CHARGES,COMPUTATION OF RATIO OF COST TO CHARGES,COMPUTATION OF INPATIENT OPERATING COSTS,COMPUTATION OF INPATIENT OPERATING COSTS,COMPUTATION OF INPATIENT OPERATING COSTS,INPATIENT ANCILLARY SERVICE COST APPORTIONMENT,INPATIENT ANCILLARY SERVICE COST APPORTIONMENT,INPATIENT ANCILLARY SERVICE COST APPORTIONMENT,INPATIENT ANCILLARY SERVICE COST APPORTIONMENT,INPATIENT ANCILLARY SERVICE COST APPORTIONMENT,INPATIENT ANCILLARY SERVICE COST APPORTIONMENT,INPATIENT ANCILLARY SERVICE COST APPORTIONMENT,INPATIENT ANCILLARY SERVICE COST APPORTIONMENT,INPATIENT ANCILLARY SERVICE COST APPORTIONMENT,INPATIENT ANCILLARY SERVICE COST APPORTIONMENT,INPATIENT ANCILLARY SERVICE COST APPORTIONMENT,INPATIENT ANCILLARY SERVICE COST APPORTIONMENT,INPATIENT ANCILLARY SERVICE COST APPORTIONMENT,INPATIENT ANCILLARY SERVICE COST APPORTIONMENT,INPATIENT ANCILLARY SERVICE COST APPORTIONMENT,INPATIENT ANCILLARY SERVICE COST APPORTIONMENT,INPATIENT ANCILLARY SERVICE COST APPORTIONMENT,INPATIENT ANCILLARY SERVICE COST APPORTIONMENT,INPATIENT ANCILLARY SERVICE COST APPORTIONMENT,INPATIENT ANCILLARY SERVICE COST APPORTIONMENT,INPATIENT ANCILLARY SERVICE COST APPORTIONMENT,INPATIENT ANCILLARY SERVICE COST APPORTIONMENT,INPATIENT ANCILLARY SERVICE COST APPORTIONMENT,INPATIENT ANCILLARY SERVICE COST APPORTIONMENT,INPATIENT ANCILLARY SERVICE COST APPORTIONMENT,INPATIENT ANCILLARY SERVICE COST APPORTIONMENT,INPATIENT ANCILLARY SERVICE COST APPORTIONMENT,INPATIENT ANCILLARY SERVICE COST APPORTIONMENT,INPATIENT ANCILLARY SERVICE COST APPORTIONMENT,INPATIENT ANCILLARY SERVICE COST APPORTIONMENT,INPATIENT ANCILLARY SERVICE COST APPORTIONMENT,INPATIENT ANCILLARY SERVICE COST APPORTIONMENT,INPATIENT ANCILLARY SERVICE COST APPORTIONMENT,INPATIENT ANCILLARY SERVICE COST APPORTIONMENT,INPATIENT ANCILLARY SERVICE COST APPORTIONMENT,INPATIENT ANCILLARY SERVICE COST APPORTIONMENT,INPATIENT ANCILLARY SERVICE COST APPORTIONMENT,INPATIENT ANCILLARY SERVICE COST APPORTIONMENT,INPATIENT ANCILLARY SERVICE COST APPORTIONMENT,INPATIENT ANCILLARY SERVICE COST APPORTIONMENT,INPATIENT ANCILLARY SERVICE COST APPORTIONMENT,INPATIENT ANCILLARY SERVICE COST APPORTIONMENT,INPATIENT ANCILLARY SERVICE COST APPORTIONMENT,INPATIENT ANCILLARY SERVICE COST APPORTIONMENT,INPATIENT ANCILLARY SERVICE COST APPORTIONMENT,INPATIENT ANCILLARY SERVICE COST APPORTIONMENT,INPATIENT ANCILLARY SERVICE COST APPORTIONMENT,INPATIENT ANCILLARY SERVICE COST APPORTIONMENT,INPATIENT ANCILLARY SERVICE COST APPORTIONMENT,INPATIENT ANCILLARY SERVICE COST APPORTIONMENT,INPATIENT ANCILLARY SERVICE COST APPORTIONMENT,INPATIENT ANCILLARY SERVICE COST APPORTIONMENT,INPATIENT ANCILLARY SERVICE COST APPORTIONMENT,INPATIENT ANCILLARY SERVICE COST APPORTIONMENT,INPATIENT ANCILLARY SERVICE COST APPORTIONMENT,INPATIENT ANCILLARY SERVICE COST APPORTIONMENT,INPATIENT ANCILLARY SERVICE COST APPORTIONMENT,INPATIENT ANCILLARY SERVICE COST APPORTIONMENT,INPATIENT ANCILLARY SERVICE COST APPORTIONMENT,INPATIENT ANCILLARY SERVICE COST APPORTIONMENT,INPATIENT ANCILLARY SERVICE COST APPORTIONMENT,INPATIENT ANCILLARY SERVICE COST APPORTIONMENT,INPATIENT ANCILLARY SERVICE COST APPORTIONMENT,INPATIENT ANCILLARY SERVICE COST APPORTIONMENT,INPATIENT ANCILLARY SERVICE COST APPORTIONMENT,INPATIENT ANCILLARY SERVICE COST APPORTIONMENT,INPATIENT ANCILLARY SERVICE COST APPORTIONMENT,INPATIENT ANCILLARY SERVICE COST APPORTIONMENT,INPATIENT ANCILLARY SERVICE COST APPORTIONMENT,INPATIENT ANCILLARY SERVICE COST APPORTIONMENT,INPATIENT ANCILLARY SERVICE COST APPORTIONMENT,INPATIENT ANCILLARY SERVICE COST APPORTIONMENT,INPATIENT ANCILLARY SERVICE COST APPORTIONMENT,INPATIENT ANCILLARY SERVICE COST APPORTIONMENT,INPATIENT ANCILLARY SERVICE COST APPORTIONMENT,INPATIENT ANCILLARY SERVICE COST APPORTIONMENT,INPATIENT ANCILLARY SERVICE COST APPORTIONMENT,INPATIENT ANCILLARY SERVICE COST APPORTIONMENT,INPATIENT ANCILLARY SERVICE COST APPORTIONMENT,INPATIENT ANCILLARY SERVICE COST APPORTIONMENT,INPATIENT ANCILLARY SERVICE COST APPORTIONMENT,INPATIENT ANCILLARY SERVICE COST APPORTIONMENT,INPATIENT ANCILLARY SERVICE COST APPORTIONMENT,INPATIENT ANCILLARY SERVICE COST APPORTIONMENT,INPATIENT ANCILLARY SERVICE COST APPORTIONMENT,INPATIENT ANCILLARY SERVICE COST APPORTIONMENT,INPATIENT ANCILLARY SERVICE COST APPORTIONMENT,INPATIENT ANCILLARY SERVICE COST APPORTIONMENT,INPATIENT ANCILLARY SERVICE COST APPORTIONMENT,INPATIENT ANCILLARY SERVICE COST APPORTIONMENT,INPATIENT ANCILLARY SERVICE COST APPORTIONMENT,INPATIENT ANCILLARY SERVICE COST APPORTIONMENT,INPATIENT ANCILLARY SERVICE COST APPORTIONMENT,INPATIENT ANCILLARY SERVICE COST APPORTIONMENT,INPATIENT ANCILLARY SERVICE COST APPORTIONMENT,INPATIENT ANCILLARY SERVICE COST APPORTIONMENT,INPATIENT ANCILLARY SERVICE COST APPORTIONMENT,INPATIENT ANCILLARY SERVICE COST APPORTIONMENT,INPATIENT ANCILLARY SERVICE COST APPORTIONMENT,INPATIENT ANCILLARY SERVICE COST APPORTIONMENT,INPATIENT ANCILLARY SERVICE COST APPORTIONMENT,INPATIENT ANCILLARY SERVICE COST APPORTIONMENT,INPATIENT ANCILLARY SERVICE COST APPORTIONMENT,INPATIENT ANCILLARY SERVICE COST APPORTIONMENT,INPATIENT ANCILLARY SERVICE COST APPORTIONMENT,INPATIENT ANCILLARY SERVICE COST APPORTIONMENT,INPATIENT ANCILLARY SERVICE COST APPORTIONMENT,INPATIENT ANCILLARY SERVICE COST APPORTIONMENT,INPATIENT ANCILLARY SERVICE COST APPORTIONMENT,INPATIENT ANCILLARY SERVICE COST APPORTIONMENT,INPATIENT ANCILLARY SERVICE COST APPORTIONMENT,INPATIENT ANCILLARY SERVICE COST APPORTIONMENT,INPATIENT ANCILLARY SERVICE COST APPORTIONMENT,INPATIENT ANCILLARY SERVICE COST APPORTIONMENT,INPATIENT ANCILLARY SERVICE COST APPORTIONMENT,INPATIENT ANCILLARY SERVICE COST APPORTIONMENT,INPATIENT ANCILLARY SERVICE COST APPORTIONMENT,INPATIENT ANCILLARY SERVICE COST APPORTIONMENT,INPATIENT ANCILLARY SERVICE COST APPORTIONMENT,INPATIENT ANCILLARY SERVICE COST APPORTIONMENT,INPATIENT ANCILLARY SERVICE COST APPORTIONMENT,INPATIENT ANCILLARY SERVICE COST APPORTIONMENT,INPATIENT ANCILLARY SERVICE COST APPORTIONMENT,INPATIENT ANCILLARY SERVICE COST APPORTIONMENT,INPATIENT ANCILLARY SERVICE COST APPORTIONMENT,INPATIENT ANCILLARY SERVICE COST APPORTIONMENT,INPATIENT ANCILLARY SERVICE COST APPORTIONMENT,INPATIENT ANCILLARY SERVICE COST APPORTIONMENT,INPATIENT ANCILLARY SERVICE COST APPORTIONMENT,INPATIENT ANCILLARY SERVICE COST APPORTIONMENT,INPATIENT ANCILLARY SERVICE COST APPORTIONMENT,INPATIENT ANCILLARY SERVICE COST APPORTIONMENT,INPATIENT ANCILLARY SERVICE COST APPORTIONMENT,INPATIENT ANCILLARY SERVICE COST APPORTIONMENT,INPATIENT ANCILLARY SERVICE COST APPORTIONMENT,INPATIENT ANCILLARY SERVICE COST APPORTIONMENT,APPORTIONMENT OF INPATIENT ROUTINE SERVICE CAPITAL COSTS,APPORTIONMENT OF INPATIENT ROUTINE SERVICE CAPITAL COSTS,APPORTIONMENT OF INPATIENT ROUTINE SERVICE CAPITAL COSTS,APPORTIONMENT OF INPATIENT ROUTINE SERVICE CAPITAL COSTS,APPORTIONMENT OF INPATIENT ROUTINE SERVICE CAPITAL COSTS,APPORTIONMENT OF INPATIENT ROUTINE SERVICE OTHER PASS THROUGH COSTS,APPORTIONMENT OF INPATIENT ROUTINE SERVICE OTHER PASS THROUGH COSTS,APPORTIONMENT OF INPATIENT/OUTPATIENT ANCILLARY SERVICE OTH PASS THR  CSTS,APPORTIONMENT OF INPATIENT/OUTPATIENT ANCILLARY SERVICE OTH PASS THR  CSTS,APPORTIONMENT OF INPATIENT/OUTPATIENT ANCILLARY SERVICE OTH PASS THR  CSTS,APPORTIONMENT OF INPATIENT/OUTPATIENT ANCILLARY SERVICE OTH PASS THR  CSTS,APPORTIONMENT OF INPATIENT/OUTPATIENT ANCILLARY SERVICE OTH PASS THR  CSTS,APPORTIONMENT OF INPATIENT/OUTPATIENT ANCILLARY SERVICE OTH PASS THR  CSTS,APPORTIONMENT OF INPATIENT/OUTPATIENT ANCILLARY SERVICE OTH PASS THR  CSTS,APPORTIONMENT OF INPATIENT/OUTPATIENT ANCILLARY SERVICE OTH PASS THR  CSTS,APPORTIONMENT OF INPATIENT/OUTPATIENT ANCILLARY SERVICE OTH PASS THR  CSTS,APPORTIONMENT OF INPATIENT/OUTPATIENT ANCILLARY SERVICE OTH PASS THR  CSTS,APPORTIONMENT OF INPATIENT/OUTPATIENT ANCILLARY SERVICE OTH PASS THR  CSTS,APPORTIONMENT OF INPATIENT/OUTPATIENT ANCILLARY SERVICE OTH PASS THR  CSTS,APPORTIONMENT OF INPATIENT/OUTPATIENT ANCILLARY SERVICE OTH PASS THR  CSTS,APPORTIONMENT OF INPATIENT/OUTPATIENT ANCILLARY SERVICE OTH PASS THR  CSTS,APPORTIONMENT OF INPATIENT/OUTPATIENT ANCILLARY SERVICE OTH PASS THR  CSTS,APPORTIONMENT OF INPATIENT/OUTPATIENT ANCILLARY SERVICE OTH PASS THR  CSTS,APPORTIONMENT OF INPATIENT/OUTPATIENT ANCILLARY SERVICE OTH PASS THR  CSTS,APPORTIONMENT OF INPATIENT/OUTPATIENT ANCILLARY SERVICE OTH PASS THR  CSTS,APPORTIONMENT OF INPATIENT/OUTPATIENT ANCILLARY SERVICE OTH PASS THR  CSTS,APPORTIONMENT OF INPATIENT/OUTPATIENT ANCILLARY SERVICE OTH PASS THR  CSTS,APPORTIONMENT OF INPATIENT/OUTPATIENT ANCILLARY SERVICE OTH PASS THR  CSTS,APPORTIONMENT OF INPATIENT/OUTPATIENT ANCILLARY SERVICE OTH PASS THR  CSTS,APPORTIONMENT OF INPATIENT/OUTPATIENT ANCILLARY SERVICE OTH PASS THR  CSTS,APPORTIONMENT OF INPATIENT/OUTPATIENT ANCILLARY SERVICE OTH PASS THR  CSTS,APPORTIONMENT OF INPATIENT/OUTPATIENT ANCILLARY SERVICE OTH PASS THR  CSTS,APPORTIONMENT OF INPATIENT/OUTPATIENT ANCILLARY SERVICE OTH PASS THR  CSTS,APPORTIONMENT OF INPATIENT/OUTPATIENT ANCILLARY SERVICE OTH PASS THR  CSTS,APPORTIONMENT OF INPATIENT/OUTPATIENT ANCILLARY SERVICE OTH PASS THR  CSTS,APPORTIONMENT OF INPATIENT/OUTPATIENT ANCILLARY SERVICE OTH PASS THR  CSTS,APPORTIONMENT OF INPATIENT/OUTPATIENT ANCILLARY SERVICE OTH PASS THR  CSTS,APPORTIONMENT OF INPATIENT/OUTPATIENT ANCILLARY SERVICE OTH PASS THR  CSTS,APPORTIONMENT OF INPATIENT/OUTPATIENT ANCILLARY SERVICE OTH PASS THR  CSTS,APPORTIONMENT OF INPATIENT/OUTPATIENT ANCILLARY SERVICE OTH PASS THR  CSTS,APPORTIONMENT OF INPATIENT/OUTPATIENT ANCILLARY SERVICE OTH PASS THR  CSTS,APPORTIONMENT OF INPATIENT/OUTPATIENT ANCILLARY SERVICE OTH PASS THR  CSTS,APPORTIONMENT OF INPATIENT/OUTPATIENT ANCILLARY SERVICE OTH PASS THR  CSTS,APPORTIONMENT OF INPATIENT/OUTPATIENT ANCILLARY SERVICE OTH PASS THR  CSTS,APPORTIONMENT OF INPATIENT/OUTPATIENT ANCILLARY SERVICE OTH PASS THR  CSTS,APPORTIONMENT OF INPATIENT/OUTPATIENT ANCILLARY SERVICE OTH PASS THR  CSTS,APPORTIONMENT OF INPATIENT/OUTPATIENT ANCILLARY SERVICE OTH PASS THR  CSTS,APPORTIONMENT OF INPATIENT/OUTPATIENT ANCILLARY SERVICE OTH PASS THR  CSTS,APPORTIONMENT OF INPATIENT/OUTPATIENT ANCILLARY SERVICE OTH PASS THR  CSTS,APPORTIONMENT OF INPATIENT/OUTPATIENT ANCILLARY SERVICE OTH PASS THR  CSTS,APPORTIONMENT OF INPATIENT/OUTPATIENT ANCILLARY SERVICE OTH PASS THR  CSTS,APPORTIONMENT OF INPATIENT/OUTPATIENT ANCILLARY SERVICE OTH PASS THR  CSTS,APPORTIONMENT OF INPATIENT/OUTPATIENT ANCILLARY SERVICE OTH PASS THR  CSTS,APPORTIONMENT OF INPATIENT/OUTPATIENT ANCILLARY SERVICE OTH PASS THR  CSTS,APPORTIONMENT OF INPATIENT/OUTPATIENT ANCILLARY SERVICE OTH PASS THR  CSTS,APPORTIONMENT OF INPATIENT/OUTPATIENT ANCILLARY SERVICE OTH PASS THR  CSTS,APPORTIONMENT OF INPATIENT/OUTPATIENT ANCILLARY SERVICE OTH PASS THR  CSTS,APPORTIONMENT OF INPATIENT/OUTPATIENT ANCILLARY SERVICE OTH PASS THR  CSTS,APPORTIONMENT OF INPATIENT/OUTPATIENT ANCILLARY SERVICE OTH PASS THR  CSTS,APPORTIONMENT OF INPATIENT/OUTPATIENT ANCILLARY SERVICE OTH PASS THR  CSTS,APPORTIONMENT OF INPATIENT/OUTPATIENT ANCILLARY SERVICE OTH PASS THR  CSTS,APPORTIONMENT OF INPATIENT/OUTPATIENT ANCILLARY SERVICE OTH PASS THR  CSTS,APPORTIONMENT OF INPATIENT/OUTPATIENT ANCILLARY SERVICE OTH PASS THR  CSTS,APPORTIONMENT OF INPATIENT/OUTPATIENT ANCILLARY SERVICE OTH PASS THR  CSTS,APPORTIONMENT OF INPATIENT/OUTPATIENT ANCILLARY SERVICE OTH PASS THR  CSTS,APPORTIONMENT OF INPATIENT/OUTPATIENT ANCILLARY SERVICE OTH PASS THR  CSTS,APPORTIONMENT OF INPATIENT/OUTPATIENT ANCILLARY SERVICE OTH PASS THR  CSTS,APPORTIONMENT OF INPATIENT/OUTPATIENT ANCILLARY SERVICE OTH PASS THR  CSTS,APPORTIONMENT OF INPATIENT/OUTPATIENT ANCILLARY SERVICE OTH PASS THR  CSTS,APPORTIONMENT OF INPATIENT/OUTPATIENT ANCILLARY SERVICE OTH PASS THR  CSTS,APPORTIONMENT OF INPATIENT/OUTPATIENT ANCILLARY SERVICE OTH PASS THR  CSTS,APPORTIONMENT OF INPATIENT/OUTPATIENT ANCILLARY SERVICE OTH PASS THR  CSTS,APPORTIONMENT OF INPATIENT/OUTPATIENT ANCILLARY SERVICE OTH PASS THR  CSTS,APPORTIONMENT OF INPATIENT/OUTPATIENT ANCILLARY SERVICE OTH PASS THR  CSTS,APPORTIONMENT OF INPATIENT/OUTPATIENT ANCILLARY SERVICE OTH PASS THR  CSTS,APPORTIONMENT OF INPATIENT/OUTPATIENT ANCILLARY SERVICE OTH PASS THR  CSTS,APPORTIONMENT OF INPATIENT/OUTPATIENT ANCILLARY SERVICE OTH PASS THR  CSTS,APPORTIONMENT OF INPATIENT/OUTPATIENT ANCILLARY SERVICE OTH PASS THR  CSTS,APPORTIONMENT OF INPATIENT/OUTPATIENT ANCILLARY SERVICE OTH PASS THR  CSTS,APPORTIONMENT OF INPATIENT/OUTPATIENT ANCILLARY SERVICE OTH PASS THR  CSTS,APPORTIONMENT OF INPATIENT/OUTPATIENT ANCILLARY SERVICE OTH PASS THR  CSTS,APPORTIONMENT OF INPATIENT/OUTPATIENT ANCILLARY SERVICE OTH PASS THR  CSTS,APPORTIONMENT OF INPATIENT/OUTPATIENT ANCILLARY SERVICE OTH PASS THR  CSTS,APPORTIONMENT OF INPATIENT/OUTPATIENT ANCILLARY SERVICE OTH PASS THR  CSTS,APPORTIONMENT OF INPATIENT/OUTPATIENT ANCILLARY SERVICE OTH PASS THR  CSTS,APPORTIONMENT OF INPATIENT/OUTPATIENT ANCILLARY SERVICE OTH PASS THR  CSTS,APPORTIONMENT OF INPATIENT/OUTPATIENT ANCILLARY SERVICE OTH PASS THR  CSTS,APPORTIONMENT OF INPATIENT/OUTPATIENT ANCILLARY SERVICE OTH PASS THR  CSTS,APPORTIONMENT OF INPATIENT/OUTPATIENT ANCILLARY SERVICE OTH PASS THR  CSTS,APPORTIONMENT OF INPATIENT/OUTPATIENT ANCILLARY SERVICE OTH PASS THR  CSTS,APPORTIONMENT OF INPATIENT/OUTPATIENT ANCILLARY SERVICE OTH PASS THR  CSTS,APPORTIONMENT OF INPATIENT/OUTPATIENT ANCILLARY SERVICE OTH PASS THR  CSTS,APPORTIONMENT OF INPATIENT/OUTPATIENT ANCILLARY SERVICE OTH PASS THR  CSTS,APPORTIONMENT OF INPATIENT/OUTPATIENT ANCILLARY SERVICE OTH PASS THR  CSTS,APPORTIONMENT OF INPATIENT/OUTPATIENT ANCILLARY SERVICE OTH PASS THR  CSTS,APPORTIONMENT OF INPATIENT/OUTPATIENT ANCILLARY SERVICE OTH PASS THR  CSTS,APPORTIONMENT OF INPATIENT/OUTPATIENT ANCILLARY SERVICE OTH PASS THR  CSTS,APPORTIONMENT OF INPATIENT/OUTPATIENT ANCILLARY SERVICE OTH PASS THR  CSTS,APPORTIONMENT OF INPATIENT/OUTPATIENT ANCILLARY SERVICE OTH PASS THR  CSTS,APPORTIONMENT OF INPATIENT/OUTPATIENT ANCILLARY SERVICE OTH PASS THR  CSTS,APPORTIONMENT OF INPATIENT/OUTPATIENT ANCILLARY SERVICE OTH PASS THR  CSTS,APPORTIONMENT OF INPATIENT/OUTPATIENT ANCILLARY SERVICE OTH PASS THR  CSTS,APPORTIONMENT OF INPATIENT/OUTPATIENT ANCILLARY SERVICE OTH PASS THR  CSTS,APPORTIONMENT OF INPATIENT/OUTPATIENT ANCILLARY SERVICE OTH PASS THR  CSTS,APPORTIONMENT OF INPATIENT/OUTPATIENT ANCILLARY SERVICE OTH PASS THR  CSTS,APPORTIONMENT OF INPATIENT/OUTPATIENT ANCILLARY SERVICE OTH PASS THR  CSTS,APPORTIONMENT OF INPATIENT/OUTPATIENT ANCILLARY SERVICE OTH PASS THR  CSTS,APPORTIONMENT OF INPATIENT/OUTPATIENT ANCILLARY SERVICE OTH PASS THR  CSTS,APPORTIONMENT OF INPATIENT/OUTPATIENT ANCILLARY SERVICE OTH PASS THR  CSTS,APPORTIONMENT OF INPATIENT/OUTPATIENT ANCILLARY SERVICE OTH PASS THR  CSTS,APPORTIONMENT OF INPATIENT/OUTPATIENT ANCILLARY SERVICE OTH PASS THR  CSTS,APPORTIONMENT OF INPATIENT/OUTPATIENT ANCILLARY SERVICE OTH PASS THR  CSTS,APPORTIONMENT OF INPATIENT/OUTPATIENT ANCILLARY SERVICE OTH PASS THR  CSTS,APPORTIONMENT OF INPATIENT/OUTPATIENT ANCILLARY SERVICE OTH PASS THR  CSTS,APPORTIONMENT OF INPATIENT/OUTPATIENT ANCILLARY SERVICE OTH PASS THR  CSTS,APPORTIONMENT OF INPATIENT/OUTPATIENT ANCILLARY SERVICE OTH PASS THR  CSTS,APPORTIONMENT OF INPATIENT/OUTPATIENT ANCILLARY SERVICE OTH PASS THR  CSTS,APPORTIONMENT OF INPATIENT/OUTPATIENT ANCILLARY SERVICE OTH PASS THR  CSTS,APPORTIONMENT OF INPATIENT/OUTPATIENT ANCILLARY SERVICE OTH PASS THR  CSTS,APPORTIONMENT OF INPATIENT/OUTPATIENT ANCILLARY SERVICE OTH PASS THR  CSTS,APPORTIONMENT OF INPATIENT/OUTPATIENT ANCILLARY SERVICE OTH PASS THR  CSTS,APPORTIONMENT OF INPATIENT/OUTPATIENT ANCILLARY SERVICE OTH PASS THR  CSTS,APPORTIONMENT OF INPATIENT/OUTPATIENT ANCILLARY SERVICE OTH PASS THR  CSTS,APPORTIONMENT OF INPATIENT/OUTPATIENT ANCILLARY SERVICE OTH PASS THR  CSTS,APPORTIONMENT OF INPATIENT/OUTPATIENT ANCILLARY SERVICE OTH PASS THR  CSTS,APPORTIONMENT OF INPATIENT/OUTPATIENT ANCILLARY SERVICE OTH PASS THR  CSTS,APPORTIONMENT OF INPATIENT/OUTPATIENT ANCILLARY SERVICE OTH PASS THR  CSTS,APPORTIONMENT OF INPATIENT/OUTPATIENT ANCILLARY SERVICE OTH PASS THR  CSTS,APPORTIONMENT OF INPATIENT/OUTPATIENT ANCILLARY SERVICE OTH PASS THR  CSTS,APPORTIONMENT OF INPATIENT/OUTPATIENT ANCILLARY SERVICE OTH PASS THR  CSTS,APPORTIONMENT OF INPATIENT/OUTPATIENT ANCILLARY SERVICE OTH PASS THR  CSTS,APPORTIONMENT OF INPATIENT/OUTPATIENT ANCILLARY SERVICE OTH PASS THR  CSTS,APPORTIONMENT OF INPATIENT/OUTPATIENT ANCILLARY SERVICE OTH PASS THR  CSTS,APPORTIONMENT OF INPATIENT/OUTPATIENT ANCILLARY SERVICE OTH PASS THR  CSTS,APPORTIONMENT OF INPATIENT/OUTPATIENT ANCILLARY SERVICE OTH PASS THR  CSTS,APPORTIONMENT OF INPATIENT/OUTPATIENT ANCILLARY SERVICE OTH PASS THR  CSTS,APPORTIONMENT OF INPATIENT/OUTPATIENT ANCILLARY SERVICE OTH PASS THR  CSTS,APPORTIONMENT OF INPATIENT/OUTPATIENT ANCILLARY SERVICE OTH PASS THR  CSTS,APPORTIONMENT OF INPATIENT/OUTPATIENT ANCILLARY SERVICE OTH PASS THR  CSTS,APPORTIONMENT OF INPATIENT/OUTPATIENT ANCILLARY SERVICE OTH PASS THR  CSTS,APPORTIONMENT OF INPATIENT/OUTPATIENT ANCILLARY SERVICE OTH PASS THR  CSTS,APPORTIONMENT OF INPATIENT/OUTPATIENT ANCILLARY SERVICE OTH PASS THR  CSTS,APPORTIONMENT OF INPATIENT/OUTPATIENT ANCILLARY SERVICE OTH PASS THR  CSTS,APPORTIONMENT OF INPATIENT/OUTPATIENT ANCILLARY SERVICE OTH PASS THR  CSTS,APPORTIONMENT OF INPATIENT/OUTPATIENT ANCILLARY SERVICE OTH PASS THR  CSTS,APPORTIONMENT OF INPATIENT/OUTPATIENT ANCILLARY SERVICE OTH PASS THR  CSTS,APPORTIONMENT OF INPATIENT/OUTPATIENT ANCILLARY SERVICE OTH PASS THR  CSTS,APPORTIONMENT OF INPATIENT/OUTPATIENT ANCILLARY SERVICE OTH PASS THR  CSTS,APPORTIONMENT OF INPATIENT/OUTPATIENT ANCILLARY SERVICE OTH PASS THR  CSTS,APPORTIONMENT OF INPATIENT/OUTPATIENT ANCILLARY SERVICE OTH PASS THR  CSTS,APPORTIONMENT OF INPATIENT/OUTPATIENT ANCILLARY SERVICE OTH PASS THR  CSTS,APPORTIONMENT OF INPATIENT/OUTPATIENT ANCILLARY SERVICE OTH PASS THR  CSTS,APPORTIONMENT OF INPATIENT/OUTPATIENT ANCILLARY SERVICE OTH PASS THR  CSTS,APPORTIONMENT OF INPATIENT/OUTPATIENT ANCILLARY SERVICE OTH PASS THR  CSTS,APPORTIONMENT OF INPATIENT/OUTPATIENT ANCILLARY SERVICE OTH PASS THR  CSTS,APPORTIONMENT OF INPATIENT/OUTPATIENT ANCILLARY SERVICE OTH PASS THR  CSTS,APPORTIONMENT OF INPATIENT/OUTPATIENT ANCILLARY SERVICE OTH PASS THR  CSTS,APPORTIONMENT OF INPATIENT/OUTPATIENT ANCILLARY SERVICE OTH PASS THR  CSTS,APPORTIONMENT OF INPATIENT/OUTPATIENT ANCILLARY SERVICE OTH PASS THR  CSTS,APPORTIONMENT OF INPATIENT/OUTPATIENT ANCILLARY SERVICE OTH PASS THR  CSTS,APPORTIONMENT OF INPATIENT/OUTPATIENT ANCILLARY SERVICE OTH PASS THR  CSTS,APPORTIONMENT OF INPATIENT/OUTPATIENT ANCILLARY SERVICE OTH PASS THR  CSTS,APPORTIONMENT OF INPATIENT/OUTPATIENT ANCILLARY SERVICE OTH PASS THR  CSTS,APPORTIONMENT OF INPATIENT/OUTPATIENT ANCILLARY SERVICE OTH PASS THR  CSTS,APPORTIONMENT OF INPATIENT/OUTPATIENT ANCILLARY SERVICE OTH PASS THR  CSTS,APPORTIONMENT OF INPATIENT/OUTPATIENT ANCILLARY SERVICE OTH PASS THR  CSTS,APPORTIONMENT OF INPATIENT/OUTPATIENT ANCILLARY SERVICE OTH PASS THR  CSTS,APPORTIONMENT OF INPATIENT/OUTPATIENT ANCILLARY SERVICE OTH PASS THR  CSTS,APPORTIONMENT OF INPATIENT/OUTPATIENT ANCILLARY SERVICE OTH PASS THR  CSTS,APPORTIONMENT OF INPATIENT/OUTPATIENT ANCILLARY SERVICE OTH PASS THR  CSTS,APPORTIONMENT OF INPATIENT/OUTPATIENT ANCILLARY SERVICE OTH PASS THR  CSTS,APPORTIONMENT OF INPATIENT/OUTPATIENT ANCILLARY SERVICE OTH PASS THR  CSTS,APPORTIONMENT OF INPATIENT/OUTPATIENT ANCILLARY SERVICE OTH PASS THR  CSTS,APPORTIONMENT OF INPATIENT/OUTPATIENT ANCILLARY SERVICE OTH PASS THR  CSTS,APPORTIONMENT OF INPATIENT/OUTPATIENT ANCILLARY SERVICE OTH PASS THR  CSTS,APPORTIONMENT OF INPATIENT/OUTPATIENT ANCILLARY SERVICE OTH PASS THR  CSTS,APPORTIONMENT OF INPATIENT/OUTPATIENT ANCILLARY SERVICE OTH PASS THR  CSTS,APPORTIONMENT OF INPATIENT/OUTPATIENT ANCILLARY SERVICE OTH PASS THR  CSTS,APPORTIONMENT OF INPATIENT/OUTPATIENT ANCILLARY SERVICE OTH PASS THR  CSTS,APPORTIONMENT OF INPATIENT/OUTPATIENT ANCILLARY SERVICE OTH PASS THR  CSTS,APPORTIONMENT OF INPATIENT/OUTPATIENT ANCILLARY SERVICE OTH PASS THR  CSTS,APPORTIONMENT OF INPATIENT/OUTPATIENT ANCILLARY SERVICE OTH PASS THR  CSTS,APPORTIONMENT OF INPATIENT/OUTPATIENT ANCILLARY SERVICE OTH PASS THR  CSTS,APPORTIONMENT OF INPATIENT/OUTPATIENT ANCILLARY SERVICE OTH PASS THR  CSTS,APPORTIONMENT OF INPATIENT/OUTPATIENT ANCILLARY SERVICE OTH PASS THR  CSTS,APPORTIONMENT OF INPATIENT/OUTPATIENT ANCILLARY SERVICE OTH PASS THR  CSTS,APPORTIONMENT OF INPATIENT/OUTPATIENT ANCILLARY SERVICE OTH PASS THR  CSTS,APPORTIONMENT OF INPATIENT/OUTPATIENT ANCILLARY SERVICE OTH PASS THR  CSTS,APPORTIONMENT OF INPATIENT/OUTPATIENT ANCILLARY SERVICE OTH PASS THR  CSTS,APPORTIONMENT OF INPATIENT/OUTPATIENT ANCILLARY SERVICE OTH PASS THR  CSTS,APPORTIONMENT OF INPATIENT/OUTPATIENT ANCILLARY SERVICE OTH PASS THR  CSTS,APPORTIONMENT OF INPATIENT/OUTPATIENT ANCILLARY SERVICE OTH PASS THR  CSTS,APPORTIONMENT OF INPATIENT/OUTPATIENT ANCILLARY SERVICE OTH PASS THR  CSTS,APPORTIONMENT OF INPATIENT/OUTPATIENT ANCILLARY SERVICE OTH PASS THR  CSTS,APPORTIONMENT OF INPATIENT/OUTPATIENT ANCILLARY SERVICE OTH PASS THR  CSTS,APPORTIONMENT OF INPATIENT/OUTPATIENT ANCILLARY SERVICE OTH PASS THR  CSTS,APPORTIONMENT OF INPATIENT/OUTPATIENT ANCILLARY SERVICE OTH PASS THR  CSTS,APPORTIONMENT OF INPATIENT/OUTPATIENT ANCILLARY SERVICE OTH PASS THR  CSTS,APPORTIONMENT OF INPATIENT/OUTPATIENT ANCILLARY SERVICE OTH PASS THR  CSTS,APPORTIONMENT OF INPATIENT/OUTPATIENT ANCILLARY SERVICE OTH PASS THR  CSTS,APPORTIONMENT OF INPATIENT/OUTPATIENT ANCILLARY SERVICE OTH PASS THR  CSTS,APPORTIONMENT OF INPATIENT/OUTPATIENT ANCILLARY SERVICE OTH PASS THR  CSTS,APPORTIONMENT OF INPATIENT/OUTPATIENT ANCILLARY SERVICE OTH PASS THR  CSTS,APPORTIONMENT OF INPATIENT/OUTPATIENT ANCILLARY SERVICE OTH PASS THR  CSTS,APPORTIONMENT OF INPATIENT/OUTPATIENT ANCILLARY SERVICE OTH PASS THR  CSTS,APPORTIONMENT OF INPATIENT/OUTPATIENT ANCILLARY SERVICE OTH PASS THR  CSTS,APPORTIONMENT OF INPATIENT/OUTPATIENT ANCILLARY SERVICE OTH PASS THR  CSTS,APPORTIONMENT OF INPATIENT/OUTPATIENT ANCILLARY SERVICE OTH PASS THR  CSTS,APPORTIONMENT OF INPATIENT/OUTPATIENT ANCILLARY SERVICE OTH PASS THR  CSTS,APPORTIONMENT OF INPATIENT/OUTPATIENT ANCILLARY SERVICE OTH PASS THR  CSTS,APPORTIONMENT OF INPATIENT/OUTPATIENT ANCILLARY SERVICE OTH PASS THR  CSTS,APPORTIONMENT OF INPATIENT/OUTPATIENT ANCILLARY SERVICE OTH PASS THR  CSTS,APPORTIONMENT OF INPATIENT/OUTPATIENT ANCILLARY SERVICE OTH PASS THR  CSTS,APPORTIONMENT OF INPATIENT/OUTPATIENT ANCILLARY SERVICE OTH PASS THR  CSTS,APPORTIONMENT OF INPATIENT/OUTPATIENT ANCILLARY SERVICE OTH PASS THR  CSTS,APPORTIONMENT OF INPATIENT/OUTPATIENT ANCILLARY SERVICE OTH PASS THR  CSTS,APPORTIONMENT OF INPATIENT/OUTPATIENT ANCILLARY SERVICE OTH PASS THR  CSTS,APPORTIONMENT OF INPATIENT/OUTPATIENT ANCILLARY SERVICE OTH PASS THR  CSTS,APPORTIONMENT OF INPATIENT/OUTPATIENT ANCILLARY SERVICE OTH PASS THR  CSTS,APPORTIONMENT OF INPATIENT/OUTPATIENT ANCILLARY SERVICE OTH PASS THR  CSTS,APPORTIONMENT OF INPATIENT/OUTPATIENT ANCILLARY SERVICE OTH PASS THR  CSTS,APPORTIONMENT OF INPATIENT/OUTPATIENT ANCILLARY SERVICE OTH PASS THR  CSTS,APPORTIONMENT OF INPATIENT/OUTPATIENT ANCILLARY SERVICE OTH PASS THR  CSTS,APPORTIONMENT OF INPATIENT/OUTPATIENT ANCILLARY SERVICE OTH PASS THR  CSTS,APPORTIONMENT OF INPATIENT/OUTPATIENT ANCILLARY SERVICE OTH PASS THR  CSTS,APPORTIONMENT OF INPATIENT/OUTPATIENT ANCILLARY SERVICE OTH PASS THR  CSTS,APPORTIONMENT OF INPATIENT/OUTPATIENT ANCILLARY SERVICE OTH PASS THR  CSTS,APPORTIONMENT OF INPATIENT/OUTPATIENT ANCILLARY SERVICE OTH PASS THR  CSTS,APPORTIONMENT OF INPATIENT/OUTPATIENT ANCILLARY SERVICE OTH PASS THR  CSTS,APPORTIONMENT OF INPATIENT/OUTPATIENT ANCILLARY SERVICE OTH PASS THR  CSTS,APPORTIONMENT OF INPATIENT/OUTPATIENT ANCILLARY SERVICE OTH PASS THR  CSTS,APPORTIONMENT OF INPATIENT/OUTPATIENT ANCILLARY SERVICE OTH PASS THR  CSTS,APPORTIONMENT OF INPATIENT/OUTPATIENT ANCILLARY SERVICE OTH PASS THR  CSTS,APPORTIONMENT OF INPATIENT/OUTPATIENT ANCILLARY SERVICE OTH PASS THR  CSTS,APPORTIONMENT OF INPATIENT/OUTPATIENT ANCILLARY SERVICE OTH PASS THR  CSTS,APPORTIONMENT OF INPATIENT/OUTPATIENT ANCILLARY SERVICE OTH PASS THR  CSTS,APPORTIONMENT OF INPATIENT/OUTPATIENT ANCILLARY SERVICE OTH PASS THR  CSTS,APPORTIONMENT OF INPATIENT/OUTPATIENT ANCILLARY SERVICE OTH PASS THR  CSTS,APPORTIONMENT OF INPATIENT/OUTPATIENT ANCILLARY SERVICE OTH PASS THR  CSTS,APPORTIONMENT OF INPATIENT/OUTPATIENT ANCILLARY SERVICE OTH PASS THR  CSTS,APPORTIONMENT OF INPATIENT/OUTPATIENT ANCILLARY SERVICE OTH PASS THR  CSTS,APPORTIONMENT OF INPATIENT/OUTPATIENT ANCILLARY SERVICE OTH PASS THR  CSTS,APPORTIONMENT OF INPATIENT/OUTPATIENT ANCILLARY SERVICE OTH PASS THR  CSTS,APPORTIONMENT OF INPATIENT/OUTPATIENT ANCILLARY SERVICE OTH PASS THR  CSTS,APPORTIONMENT OF INPATIENT/OUTPATIENT ANCILLARY SERVICE OTH PASS THR  CSTS,APPORTIONMENT OF INPATIENT/OUTPATIENT ANCILLARY SERVICE OTH PASS THR  CSTS,APPORTIONMENT OF INPATIENT/OUTPATIENT ANCILLARY SERVICE OTH PASS THR  CSTS,APPORTIONMENT OF INPATIENT/OUTPATIENT ANCILLARY SERVICE OTH PASS THR  CSTS,APPORTIONMENT OF INPATIENT/OUTPATIENT ANCILLARY SERVICE OTH PASS THR  CSTS,APPORTIONMENT OF INPATIENT/OUTPATIENT ANCILLARY SERVICE OTH PASS THR  CSTS,APPORTIONMENT OF INPATIENT/OUTPATIENT ANCILLARY SERVICE OTH PASS THR  CSTS,APPORTIONMENT OF INPATIENT/OUTPATIENT ANCILLARY SERVICE OTH PASS THR  CSTS,APPORTIONMENT OF INPATIENT/OUTPATIENT ANCILLARY SERVICE OTH PASS THR  CSTS,APPORTIONMENT OF INPATIENT/OUTPATIENT ANCILLARY SERVICE OTH PASS THR  CSTS,APPORTIONMENT OF INPATIENT/OUTPATIENT ANCILLARY SERVICE OTH PASS THR  CSTS,APPORTIONMENT OF INPATIENT/OUTPATIENT ANCILLARY SERVICE OTH PASS THR  CSTS,APPORTIONMENT OF INPATIENT/OUTPATIENT ANCILLARY SERVICE OTH PASS THR  CSTS,APPORTIONMENT OF INPATIENT/OUTPATIENT ANCILLARY SERVICE OTH PASS THR  CSTS,APPORTIONMENT OF INPATIENT/OUTPATIENT ANCILLARY SERVICE OTH PASS THR  CSTS,APPORTIONMENT OF INPATIENT/OUTPATIENT ANCILLARY SERVICE OTH PASS THR  CSTS,APPORTIONMENT OF INPATIENT/OUTPATIENT ANCILLARY SERVICE OTH PASS THR  CSTS,APPORTIONMENT OF INPATIENT/OUTPATIENT ANCILLARY SERVICE OTH PASS THR  CSTS,APPORTIONMENT OF INPATIENT/OUTPATIENT ANCILLARY SERVICE OTH PASS THR  CSTS,APPORTIONMENT OF INPATIENT/OUTPATIENT ANCILLARY SERVICE OTH PASS THR  CSTS,APPORTIONMENT OF INPATIENT/OUTPATIENT ANCILLARY SERVICE OTH PASS THR  CSTS,APPORTIONMENT OF INPATIENT/OUTPATIENT ANCILLARY SERVICE OTH PASS THR  CSTS,APPORTIONMENT OF INPATIENT/OUTPATIENT ANCILLARY SERVICE OTH PASS THR  CSTS,APPORTIONMENT OF INPATIENT/OUTPATIENT ANCILLARY SERVICE OTH PASS THR  CSTS,APPORTIONMENT OF INPATIENT/OUTPATIENT ANCILLARY SERVICE OTH PASS THR  CSTS,APPORTIONMENT OF MEDICAL AND OTHER HEALTH SERVICES,APPORTIONMENT OF MEDICAL AND OTHER HEALTH SERVICES,APPORTIONMENT OF MEDICAL AND OTHER HEALTH SERVICES,APPORTIONMENT OF MEDICAL AND OTHER HEALTH SERVICES,APPORTIONMENT OF MEDICAL AND OTHER HEALTH SERVICES,APPORTIONMENT OF MEDICAL AND OTHER HEALTH SERVICES,APPORTIONMENT OF MEDICAL AND OTHER HEALTH SERVICES,APPORTIONMENT OF MEDICAL AND OTHER HEALTH SERVICES,APPORTIONMENT OF MEDICAL AND OTHER HEALTH SERVICES,APPORTIONMENT OF MEDICAL AND OTHER HEALTH SERVICES,APPORTIONMENT OF MEDICAL AND OTHER HEALTH SERVICES,APPORTIONMENT OF MEDICAL AND OTHER HEALTH SERVICES,APPORTIONMENT OF MEDICAL AND OTHER HEALTH SERVICES,APPORTIONMENT OF MEDICAL AND OTHER HEALTH SERVICES,APPORTIONMENT OF MEDICAL AND OTHER HEALTH SERVICES,APPORTIONMENT OF MEDICAL AND OTHER HEALTH SERVICES,APPORTIONMENT OF MEDICAL AND OTHER HEALTH SERVICES,APPORTIONMENT OF MEDICAL AND OTHER HEALTH SERVICES,APPORTIONMENT OF MEDICAL AND OTHER HEALTH SERVICES,APPORTIONMENT OF MEDICAL AND OTHER HEALTH SERVICES,APPORTIONMENT OF MEDICAL AND OTHER HEALTH SERVICES,APPORTIONMENT OF MEDICAL AND OTHER HEALTH SERVICES,APPORTIONMENT OF MEDICAL AND OTHER HEALTH SERVICES,APPORTIONMENT OF MEDICAL AND OTHER HEALTH SERVICES,APPORTIONMENT OF MEDICAL AND OTHER HEALTH SERVICES,APPORTIONMENT OF MEDICAL AND OTHER HEALTH SERVICES,APPORTIONMENT OF MEDICAL AND OTHER HEALTH SERVICES,APPORTIONMENT OF MEDICAL AND OTHER HEALTH SERVICES,APPORTIONMENT OF MEDICAL AND OTHER HEALTH SERVICES,APPORTIONMENT OF MEDICAL AND OTHER HEALTH SERVICES,APPORTIONMENT OF MEDICAL AND OTHER HEALTH SERVICES,APPORTIONMENT OF MEDICAL AND OTHER HEALTH SERVICES,APPORTIONMENT OF MEDICAL AND OTHER HEALTH SERVICES,APPORTIONMENT OF MEDICAL AND OTHER HEALTH SERVICES,APPORTIONMENT OF MEDICAL AND OTHER HEALTH SERVICES,APPORTIONMENT OF MEDICAL AND OTHER HEALTH SERVICES,APPORTIONMENT OF MEDICAL AND OTHER HEALTH SERVICES,APPORTIONMENT OF MEDICAL AND OTHER HEALTH SERVICES,APPORTIONMENT OF MEDICAL AND OTHER HEALTH SERVICES,APPORTIONMENT OF MEDICAL AND OTHER HEALTH SERVICES,APPORTIONMENT OF MEDICAL AND OTHER HEALTH SERVICES,APPORTIONMENT OF MEDICAL AND OTHER HEALTH SERVICES,APPORTIONMENT OF MEDICAL AND OTHER HEALTH SERVICES,APPORTIONMENT OF MEDICAL AND OTHER HEALTH SERVICES,APPORTIONMENT OF MEDICAL AND OTHER HEALTH SERVICES,APPORTIONMENT OF MEDICAL AND OTHER HEALTH SERVICES,APPORTIONMENT OF MEDICAL AND OTHER HEALTH SERVICES,APPORTIONMENT OF MEDICAL AND OTHER HEALTH SERVICES,APPORTIONMENT OF MEDICAL AND OTHER HEALTH SERVICES,APPORTIONMENT OF MEDICAL AND OTHER HEALTH SERVICES,APPORTIONMENT OF MEDICAL AND OTHER HEALTH SERVICES,APPORTIONMENT OF MEDICAL AND OTHER HEALTH SERVICES,APPORTIONMENT OF MEDICAL AND OTHER HEALTH SERVICES,APPORTIONMENT OF MEDICAL AND OTHER HEALTH SERVICES,APPORTIONMENT OF MEDICAL AND OTHER HEALTH SERVICES,APPORTIONMENT OF MEDICAL AND OTHER HEALTH SERVICES,APPORTIONMENT OF MEDICAL AND OTHER HEALTH SERVICES,APPORTIONMENT OF MEDICAL AND OTHER HEALTH SERVICES,APPORTIONMENT OF MEDICAL AND OTHER HEALTH SERVICES,APPORTIONMENT OF MEDICAL AND OTHER HEALTH SERVICES,APPORTIONMENT OF MEDICAL AND OTHER HEALTH SERVICES,APPORTIONMENT OF MEDICAL AND OTHER HEALTH SERVICES,APPORTIONMENT OF MEDICAL AND OTHER HEALTH SERVICES,APPORTIONMENT OF MEDICAL AND OTHER HEALTH SERVICES,APPORTIONMENT OF MEDICAL AND OTHER HEALTH SERVICES,APPORTIONMENT OF MEDICAL AND OTHER HEALTH SERVICES,APPORTIONMENT OF MEDICAL AND OTHER HEALTH SERVICES,APPORTIONMENT OF MEDICAL AND OTHER HEALTH SERVICES,APPORTIONMENT OF MEDICAL AND OTHER HEALTH SERVICES,APPORTIONMENT OF MEDICAL AND OTHER HEALTH SERVICES,APPORTIONMENT OF MEDICAL AND OTHER HEALTH SERVICES,APPORTIONMENT OF MEDICAL AND OTHER HEALTH SERVICES,APPORTIONMENT OF MEDICAL AND OTHER HEALTH SERVICES,APPORTIONMENT OF MEDICAL AND OTHER HEALTH SERVICES,APPORTIONMENT OF MEDICAL AND OTHER HEALTH SERVICES,APPORTIONMENT OF MEDICAL AND OTHER HEALTH SERVICES,APPORTIONMENT OF MEDICAL AND OTHER HEALTH SERVICES,APPORTIONMENT OF MEDICAL AND OTHER HEALTH SERVICES,CALCULATION OF REIMBURSMENT SETTLEMENT,Total Inpatient Days/Outpatient Visits,Total Inpatient Days/Outpatient Visits,Total Inpatient Days/Outpatient Visits,Total Inpatient Days/Outpatient Visits,Total Inpatient Days/Outpatient Visits,NUMBER OF BEDS,NUMBER OF BEDS,BED DAYS AVAILABLE,BED DAYS AVAILABLE,BED DAYS AVAILABLE,BED DAYS AVAILABLE,BED DAYS AVAILABLE,BED DAYS AVAILABLE,BED DAYS AVAILABLE,BED DAYS AVAILABLE,BED DAYS AVAILABLE,BED DAYS AVAILABLE,BED DAYS AVAILABLE,BED DAYS AVAILABLE,Medicare Inpatient Days/Outpatient Visits,Medicare Inpatient Days/Outpatient Visits,Medicare Inpatient Days/Outpatient Visits,Medicare Inpatient Days/Outpatient Visits,Medicaid Inpatient Days/Outpatient Visits ,Medicaid Inpatient Days/Outpatient Visits ,Medicaid Inpatient Days/Outpatient Visits ,Medicaid Inpatient Days/Outpatient Visits ,Total Inpatient Days/Outpatient Visits,Total Inpatient Days/Outpatient Visits,Total Inpatient Days/Outpatient Visits,Total Inpatient Days/Outpatient Visits,Total Inpatient Days/Outpatient Visits,RECONCILIATION OF CAPITAL COST CENTERS,RECONCILIATION OF CAPITAL COST CENTERS,RECONCILIATION OF CAPITAL COST CENTERS,RECONCILIATION OF CAPITAL COST CENTERS,RECONCILIATION OF CAPITAL COST CENTERS,RECONCILIATION OF CAPITAL COST CENTERS,ADJUSTMENTS,TRIAL BALANCE OF EXPENSE ACCOUNTS,TRIAL BALANCE OF EXPENSE ACCOUNTS,TRIAL BALANCE OF EXPENSE ACCOUNTS,TRIAL BALANCE OF EXPENSE ACCOUNTS,TRIAL BALANCE OF EXPENSE ACCOUNTS,TRIAL BALANCE OF EXPENSE ACCOUNTS,TRIAL BALANCE OF EXPENSE ACCOUNTS,TRIAL BALANCE OF EXPENSE ACCOUNTS,TRIAL BALANCE OF EXPENSE ACCOUNTS,TRIAL BALANCE OF EXPENSE ACCOUNTS,TRIAL BALANCE OF EXPENSE ACCOUNTS,TRIAL BALANCE OF EXPENSE ACCOUNTS,TRIAL BALANCE OF EXPENSE ACCOUNTS,TRIAL BALANCE OF EXPENSE ACCOUNTS,TRIAL BALANCE OF EXPENSE ACCOUNTS,TRIAL BALANCE OF EXPENSE ACCOUNTS,TRIAL BALANCE OF EXPENSE ACCOUNTS,TRIAL BALANCE OF EXPENSE ACCOUNTS,TRIAL BALANCE OF EXPENSE ACCOUNTS,TRIAL BALANCE OF EXPENSE ACCOUNTS,TRIAL BALANCE OF EXPENSE ACCOUNTS,TRIAL BALANCE OF EXPENSE ACCOUNTS,TRIAL BALANCE OF EXPENSE ACCOUNTS,TRIAL BALANCE OF EXPENSE ACCOUNTS,TRIAL BALANCE OF EXPENSE ACCOUNTS,TRIAL BALANCE OF EXPENSE ACCOUNTS,TRIAL BALANCE OF EXPENSE ACCOUNTS,TRIAL BALANCE OF EXPENSE ACCOUNTS,TRIAL BALANCE OF EXPENSE ACCOUNTS,TRIAL BALANCE OF EXPENSE ACCOUNTS,TRIAL BALANCE OF EXPENSE ACCOUNTS,TRIAL BALANCE OF EXPENSE ACCOUNTS,TRIAL BALANCE OF EXPENSE ACCOUNTS,TRIAL BALANCE OF EXPENSE ACCOUNTS,TRIAL BALANCE OF EXPENSE ACCOUNTS,TRIAL BALANCE OF EXPENSE ACCOUNTS,TRIAL BALANCE OF EXPENSE ACCOUNTS,TRIAL BALANCE OF EXPENSE ACCOUNTS,TRIAL BALANCE OF EXPENSE ACCOUNTS,TRIAL BALANCE OF EXPENSE ACCOUNTS,TRIAL BALANCE OF EXPENSE ACCOUNTS,TRIAL BALANCE OF EXPENSE ACCOUNTS,TRIAL BALANCE OF EXPENSE ACCOUNTS,TRIAL BALANCE OF EXPENSE ACCOUNTS,COST ALLOCATION,COST ALLOCATION,COST ALLOCATION,COST ALLOCATION,COST ALLOCATION,COST ALLOCATION,COST ALLOCATION,COST ALLOCATION,COST ALLOCATION,COST ALLOCATION,COST ALLOCATION,COST ALLOCATION,COST ALLOCATION,COST ALLOCATION,COST ALLOCATION,COST ALLOCATION,COST ALLOCATION,COST ALLOCATION,COST ALLOCATION,COST ALLOCATION,COST ALLOCATION,COST ALLOCATION,COST ALLOCATION,COST ALLOCATION,COST ALLOCATION,COST ALLOCATION,COST ALLOCATION,COST ALLOCATION,COST ALLOCATION,COST ALLOCATION,COST ALLOCATION,COST ALLOCATION,COST ALLOCATION,COST ALLOCATION,COST ALLOCATION,COST ALLOCATION,COST ALLOCATION,COST ALLOCATION,COST ALLOCATION,COST ALLOCATION,COST ALLOCATION,ALLOCATION OF NEW CAPITAL COSTS,ALLOCATION OF NEW CAPITAL COSTS,ALLOCATION OF NEW CAPITAL COSTS,ALLOCATION OF NEW CAPITAL COSTS,ALLOCATION OF NEW CAPITAL COSTS,ALLOCATION OF NEW CAPITAL COSTS,ALLOCATION OF NEW CAPITAL COSTS,ALLOCATION OF NEW CAPITAL COSTS,ALLOCATION OF NEW CAPITAL COSTS,ALLOCATION OF NEW CAPITAL COSTS,ALLOCATION OF NEW CAPITAL COSTS,ALLOCATION OF NEW CAPITAL COSTS,ALLOCATION OF NEW CAPITAL COSTS,ALLOCATION OF NEW CAPITAL COSTS,ALLOCATION OF NEW CAPITAL COSTS,COMPUTATION OF RATIO OF COST TO CHARGES,COMPUTATION OF RATIO OF COST TO CHARGES,COMPUTATION OF RATIO OF COST TO CHARGES,COMPUTATION OF RATIO OF COST TO CHARGES,COMPUTATION OF RATIO OF COST TO CHARGES,COMPUTATION OF RATIO OF COST TO CHARGES,COMPUTATION OF RATIO OF COST TO CHARGES,COMPUTATION OF RATIO OF COST TO CHARGES,COMPUTATION OF RATIO OF COST TO CHARGES,COMPUTATION OF RATIO OF COST TO CHARGES,COMPUTATION OF RATIO OF COST TO CHARGES,COMPUTATION OF RATIO OF COST TO CHARGES,COMPUTATION OF RATIO OF COST TO CHARGES,COMPUTATION OF RATIO OF COST TO CHARGES,COMPUTATION OF RATIO OF COST TO CHARGES,COMPUTATION OF RATIO OF COST TO CHARGES,COMPUTATION OF RATIO OF COST TO CHARGES,COMPUTATION OF RATIO OF COST TO CHARGES,COMPUTATION OF RATIO OF COST TO CHARGES,COMPUTATION OF RATIO OF COST TO CHARGES,COMPUTATION OF RATIO OF COST TO CHARGES,COMPUTATION OF RATIO OF COST TO CHARGES,COMPUTATION OF RATIO OF COST TO CHARGES,COMPUTATION OF RATIO OF COST TO CHARGES,INPATIENT ANCILLARY SERVICE COST APPORTIONMENT,INPATIENT ANCILLARY SERVICE COST APPORTIONMENT,INPATIENT ANCILLARY SERVICE COST APPORTIONMENT,INPATIENT ANCILLARY SERVICE COST APPORTIONMENT,INPATIENT ANCILLARY SERVICE COST APPORTIONMENT,INPATIENT ANCILLARY SERVICE COST APPORTIONMENT,INPATIENT ANCILLARY SERVICE COST APPORTIONMENT,INPATIENT ANCILLARY SERVICE COST APPORTIONMENT,INPATIENT ANCILLARY SERVICE COST APPORTIONMENT,INPATIENT ANCILLARY SERVICE COST APPORTIONMENT,INPATIENT ANCILLARY SERVICE COST APPORTIONMENT,INPATIENT ANCILLARY SERVICE COST APPORTIONMENT,INPATIENT ANCILLARY SERVICE COST APPORTIONMENT,INPATIENT ANCILLARY SERVICE COST APPORTIONMENT,INPATIENT ANCILLARY SERVICE COST APPORTIONMENT,INPATIENT ANCILLARY SERVICE COST APPORTIONMENT,INPATIENT ANCILLARY SERVICE COST APPORTIONMENT,INPATIENT ANCILLARY SERVICE COST APPORTIONMENT,INPATIENT ANCILLARY SERVICE COST APPORTIONMENT,INPATIENT ANCILLARY SERVICE COST APPORTIONMENT,INPATIENT ANCILLARY SERVICE COST APPORTIONMENT,INPATIENT ANCILLARY SERVICE COST APPORTIONMENT,INPATIENT ANCILLARY SERVICE COST APPORTIONMENT,INPATIENT ANCILLARY SERVICE COST APPORTIONMENT,APPORTIONMENT OF INPATIENT/OUTPATIENT ANCILLARY SERVICE OTH PASS THR  CSTS,APPORTIONMENT OF INPATIENT/OUTPATIENT ANCILLARY SERVICE OTH PASS THR  CSTS,APPORTIONMENT OF INPATIENT/OUTPATIENT ANCILLARY SERVICE OTH PASS THR  CSTS,APPORTIONMENT OF INPATIENT/OUTPATIENT ANCILLARY SERVICE OTH PASS THR  CSTS,APPORTIONMENT OF INPATIENT/OUTPATIENT ANCILLARY SERVICE OTH PASS THR  CSTS,APPORTIONMENT OF INPATIENT/OUTPATIENT ANCILLARY SERVICE OTH PASS THR  CSTS,APPORTIONMENT OF INPATIENT/OUTPATIENT ANCILLARY SERVICE OTH PASS THR  CSTS,APPORTIONMENT OF INPATIENT/OUTPATIENT ANCILLARY SERVICE OTH PASS THR  CSTS,APPORTIONMENT OF INPATIENT/OUTPATIENT ANCILLARY SERVICE OTH PASS THR  CSTS,APPORTIONMENT OF INPATIENT/OUTPATIENT ANCILLARY SERVICE OTH PASS THR  CSTS,APPORTIONMENT OF INPATIENT/OUTPATIENT ANCILLARY SERVICE OTH PASS THR  CSTS,APPORTIONMENT OF INPATIENT/OUTPATIENT ANCILLARY SERVICE OTH PASS THR  CSTS,APPORTIONMENT OF MEDICAL AND OTHER HEALTH SERVICES,APPORTIONMENT OF MEDICAL AND OTHER HEALTH SERVICES,APPORTIONMENT OF MEDICAL AND OTHER HEALTH SERVICES,APPORTIONMENT OF MEDICAL AND OTHER HEALTH SERVICES,APPORTIONMENT OF MEDICAL AND OTHER HEALTH SERVICES,APPORTIONMENT OF MEDICAL AND OTHER HEALTH SERVICES,APPORTIONMENT OF MEDICAL AND OTHER HEALTH SERVICES,APPORTIONMENT OF MEDICAL AND OTHER HEALTH SERVICES,APPORTIONMENT OF MEDICAL AND OTHER HEALTH SERVICES,APPORTIONMENT OF MEDICAL AND OTHER HEALTH SERVICES,APPORTIONMENT OF MEDICAL AND OTHER HEALTH SERVICES,APPORTIONMENT OF MEDICAL AND OTHER HEALTH SERVICES,APPORTIONMENT OF MEDICAL AND OTHER HEALTH SERVICES,APPORTIONMENT OF MEDICAL AND OTHER HEALTH SERVICES,APPORTIONMENT OF MEDICAL AND OTHER HEALTH SERVICES,APPORTIONMENT OF MEDICAL AND OTHER HEALTH SERVICES,APPORTIONMENT OF MEDICAL AND OTHER HEALTH SERVICES,APPORTIONMENT OF MEDICAL AND OTHER HEALTH SERVICES,APPORTIONMENT OF MEDICAL AND OTHER HEALTH SERVICES,APPORTIONMENT OF MEDICAL AND OTHER HEALTH SERVICES,APPORTIONMENT OF MEDICAL AND OTHER HEALTH SERVICES,APPORTIONMENT OF MEDICAL AND OTHER HEALTH SERVICES,APPORTIONMENT OF MEDICAL AND OTHER HEALTH SERVICES,APPORTIONMENT OF MEDICAL AND OTHER HEALTH SERVICES,RECONCILIATION OF CAPITAL COST CENTERS,RECONCILIATION OF CAPITAL COST CENTERS,RECONCILIATION OF CAPITAL COST CENTERS,RECONCILIATION OF CAPITAL COST CENTERS,RECONCILIATION OF CAPITAL COST CENTERS,RECONCILIATION OF CAPITAL COST CENTERS,RECONCILIATION OF CAPITAL COST CENTERS,RECONCILIATION OF CAPITAL COST CENTERS,TRIAL BALANCE OF EXPENSE ACCOUNTS,TRIAL BALANCE OF EXPENSE ACCOUNTS,TRIAL BALANCE OF EXPENSE ACCOUNTS,TRIAL BALANCE OF EXPENSE ACCOUNTS,TRIAL BALANCE OF EXPENSE ACCOUNTS,TRIAL BALANCE OF EXPENSE ACCOUNTS,TRIAL BALANCE OF EXPENSE ACCOUNTS,TRIAL BALANCE OF EXPENSE ACCOUNTS,TRIAL BALANCE OF EXPENSE ACCOUNTS,TRIAL BALANCE OF EXPENSE ACCOUNTS,TRIAL BALANCE OF EXPENSE ACCOUNTS,TRIAL BALANCE OF EXPENSE ACCOUNTS,TRIAL BALANCE OF EXPENSE ACCOUNTS,TRIAL BALANCE OF EXPENSE ACCOUNTS,TRIAL BALANCE OF EXPENSE ACCOUNTS,TRIAL BALANCE OF EXPENSE ACCOUNTS,TRIAL BALANCE OF EXPENSE ACCOUNTS,TRIAL BALANCE OF EXPENSE ACCOUNTS,TRIAL BALANCE OF EXPENSE ACCOUNTS,TRIAL BALANCE OF EXPENSE ACCOUNTS,TRIAL BALANCE OF EXPENSE ACCOUNTS,TRIAL BALANCE OF EXPENSE ACCOUNTS,TRIAL BALANCE OF EXPENSE ACCOUNTS,TRIAL BALANCE OF EXPENSE ACCOUNTS,TRIAL BALANCE OF EXPENSE ACCOUNTS,TRIAL BALANCE OF EXPENSE ACCOUNTS,TRIAL BALANCE OF EXPENSE ACCOUNTS,TRIAL BALANCE OF EXPENSE ACCOUNTS,TRIAL BALANCE OF EXPENSE ACCOUNTS,TRIAL BALANCE OF EXPENSE ACCOUNTS,TRIAL BALANCE OF EXPENSE ACCOUNTS,TRIAL BALANCE OF EXPENSE ACCOUNTS,TRIAL BALANCE OF EXPENSE ACCOUNTS,TRIAL BALANCE OF EXPENSE ACCOUNTS,TRIAL BALANCE OF EXPENSE ACCOUNTS,TRIAL BALANCE OF EXPENSE ACCOUNTS,TRIAL BALANCE OF EXPENSE ACCOUNTS,TRIAL BALANCE OF EXPENSE ACCOUNTS,TRIAL BALANCE OF EXPENSE ACCOUNTS,TRIAL BALANCE OF EXPENSE ACCOUNTS,TRIAL BALANCE OF EXPENSE ACCOUNTS,TRIAL BALANCE OF EXPENSE ACCOUNTS,TRIAL BALANCE OF EXPENSE ACCOUNTS,TRIAL BALANCE OF EXPENSE ACCOUNTS,TRIAL BALANCE OF EXPENSE ACCOUNTS,TRIAL BALANCE OF EXPENSE ACCOUNTS,TRIAL BALANCE OF EXPENSE ACCOUNTS,TRIAL BALANCE OF EXPENSE ACCOUNTS,TRIAL BALANCE OF EXPENSE ACCOUNTS,COST ALLOCATION,COST ALLOCATION,COST ALLOCATION,COST ALLOCATION,COST ALLOCATION,COST ALLOCATION,COST ALLOCATION,COST ALLOCATION,COST ALLOCATION,COST ALLOCATION,COST ALLOCATION,COST ALLOCATION,COST ALLOCATION,COST ALLOCATION,COST ALLOCATION,COST ALLOCATION,COST ALLOCATION,COST ALLOCATION,COST ALLOCATION,COST ALLOCATION,COST ALLOCATION,COST ALLOCATION,COST ALLOCATION,COST ALLOCATION,COST ALLOCATION,COST ALLOCATION,COST ALLOCATION,COST ALLOCATION,ALLOCATION OF NEW CAPITAL COSTS,ALLOCATION OF NEW CAPITAL COSTS,ALLOCATION OF NEW CAPITAL COSTS,ALLOCATION OF NEW CAPITAL COSTS,ALLOCATION OF NEW CAPITAL COSTS,ALLOCATION OF NEW CAPITAL COSTS,ALLOCATION OF NEW CAPITAL COSTS,ALLOCATION OF NEW CAPITAL COSTS,ALLOCATION OF NEW CAPITAL COSTS,ALLOCATION OF NEW CAPITAL COSTS,ALLOCATION OF NEW CAPITAL COSTS,ALLOCATION OF NEW CAPITAL COSTS,COMPUTATION OF RATIO OF COST TO CHARGES,COMPUTATION OF RATIO OF COST TO CHARGES,COMPUTATION OF RATIO OF COST TO CHARGES,COMPUTATION OF RATIO OF COST TO CHARGES,COMPUTATION OF RATIO OF COST TO CHARGES,COMPUTATION OF RATIO OF COST TO CHARGES,COMPUTATION OF RATIO OF COST TO CHARGES,COMPUTATION OF RATIO OF COST TO CHARGES,COMPUTATION OF RATIO OF COST TO CHARGES,COMPUTATION OF RATIO OF COST TO CHARGES,COMPUTATION OF RATIO OF COST TO CHARGES,COMPUTATION OF RATIO OF COST TO CHARGES,COMPUTATION OF RATIO OF COST TO CHARGES,COMPUTATION OF RATIO OF COST TO CHARGES,COMPUTATION OF RATIO OF COST TO CHARGES,COMPUTATION OF RATIO OF COST TO CHARGES,COMPUTATION OF RATIO OF COST TO CHARGES,COMPUTATION OF RATIO OF COST TO CHARGES,COMPUTATION OF RATIO OF COST TO CHARGES,COMPUTATION OF RATIO OF COST TO CHARGES,COMPUTATION OF RATIO OF COST TO CHARGES,COMPUTATION OF RATIO OF COST TO CHARGES,COMPUTATION OF RATIO OF COST TO CHARGES,COMPUTATION OF RATIO OF COST TO CHARGES,COMPUTATION OF RATIO OF COST TO CHARGES,COMPUTATION OF RATIO OF COST TO CHARGES,COMPUTATION OF RATIO OF COST TO CHARGES,COMPUTATION OF RATIO OF COST TO CHARGES,COMPUTATION OF RATIO OF COST TO CHARGES,COMPUTATION OF RATIO OF COST TO CHARGES,COMPUTATION OF RATIO OF COST TO CHARGES,COMPUTATION OF RATIO OF COST TO CHARGES,COMPUTATION OF RATIO OF COST TO CHARGES,COMPUTATION OF RATIO OF COST TO CHARGES,COMPUTATION OF RATIO OF COST TO CHARGES,COMPUTATION OF RATIO OF COST TO CHARGES,COMPUTATION OF RATIO OF COST TO CHARGES,COMPUTATION OF RATIO OF COST TO CHARGES,COMPUTATION OF RATIO OF COST TO CHARGES,COMPUTATION OF RATIO OF COST TO CHARGES,COMPUTATION OF RATIO OF COST TO CHARGES,COMPUTATION OF RATIO OF COST TO CHARGES,COMPUTATION OF INPATIENT OPERATING COSTS,INPATIENT ANCILLARY SERVICE COST APPORTIONMENT,INPATIENT ANCILLARY SERVICE COST APPORTIONMENT,INPATIENT ANCILLARY SERVICE COST APPORTIONMENT,INPATIENT ANCILLARY SERVICE COST APPORTIONMENT,INPATIENT ANCILLARY SERVICE COST APPORTIONMENT,INPATIENT ANCILLARY SERVICE COST APPORTIONMENT,INPATIENT ANCILLARY SERVICE COST APPORTIONMENT,INPATIENT ANCILLARY SERVICE COST APPORTIONMENT,INPATIENT ANCILLARY SERVICE COST APPORTIONMENT,INPATIENT ANCILLARY SERVICE COST APPORTIONMENT,INPATIENT ANCILLARY SERVICE COST APPORTIONMENT,INPATIENT ANCILLARY SERVICE COST APPORTIONMENT,INPATIENT ANCILLARY SERVICE COST APPORTIONMENT,INPATIENT ANCILLARY SERVICE COST APPORTIONMENT,INPATIENT ANCILLARY SERVICE COST APPORTIONMENT,INPATIENT ANCILLARY SERVICE COST APPORTIONMENT,INPATIENT ANCILLARY SERVICE COST APPORTIONMENT,INPATIENT ANCILLARY SERVICE COST APPORTIONMENT,INPATIENT ANCILLARY SERVICE COST APPORTIONMENT,INPATIENT ANCILLARY SERVICE COST APPORTIONMENT,APPORTIONMENT OF INPATIENT ROUTINE SERVICE CAPITAL COSTS,APPORTIONMENT OF INPATIENT ROUTINE SERVICE CAPITAL COSTS,APPORTIONMENT OF INPATIENT ROUTINE SERVICE CAPITAL COSTS,APPORTIONMENT OF INPATIENT ROUTINE SERVICE CAPITAL COSTS,APPORTIONMENT OF INPATIENT ROUTINE SERVICE CAPITAL COSTS,APPORTIONMENT OF INPATIENT ROUTINE SERVICE CAPITAL COSTS,APPORTIONMENT OF INPATIENT/OUTPATIENT ANCILLARY SERVICE OTH PASS THR  CSTS,APPORTIONMENT OF INPATIENT/OUTPATIENT ANCILLARY SERVICE OTH PASS THR  CSTS,APPORTIONMENT OF INPATIENT/OUTPATIENT ANCILLARY SERVICE OTH PASS THR  CSTS,APPORTIONMENT OF INPATIENT/OUTPATIENT ANCILLARY SERVICE OTH PASS THR  CSTS,APPORTIONMENT OF INPATIENT/OUTPATIENT ANCILLARY SERVICE OTH PASS THR  CSTS,APPORTIONMENT OF INPATIENT/OUTPATIENT ANCILLARY SERVICE OTH PASS THR  CSTS,APPORTIONMENT OF INPATIENT/OUTPATIENT ANCILLARY SERVICE OTH PASS THR  CSTS,APPORTIONMENT OF INPATIENT/OUTPATIENT ANCILLARY SERVICE OTH PASS THR  CSTS,APPORTIONMENT OF INPATIENT/OUTPATIENT ANCILLARY SERVICE OTH PASS THR  CSTS,APPORTIONMENT OF INPATIENT/OUTPATIENT ANCILLARY SERVICE OTH PASS THR  CSTS,APPORTIONMENT OF INPATIENT/OUTPATIENT ANCILLARY SERVICE OTH PASS THR  CSTS,APPORTIONMENT OF INPATIENT/OUTPATIENT ANCILLARY SERVICE OTH PASS THR  CSTS,APPORTIONMENT OF INPATIENT/OUTPATIENT ANCILLARY SERVICE OTH PASS THR  CSTS,APPORTIONMENT OF INPATIENT/OUTPATIENT ANCILLARY SERVICE OTH PASS THR  CSTS,APPORTIONMENT OF INPATIENT/OUTPATIENT ANCILLARY SERVICE OTH PASS THR  CSTS,APPORTIONMENT OF INPATIENT/OUTPATIENT ANCILLARY SERVICE OTH PASS THR  CSTS,APPORTIONMENT OF INPATIENT/OUTPATIENT ANCILLARY SERVICE OTH PASS THR  CSTS,APPORTIONMENT OF INPATIENT/OUTPATIENT ANCILLARY SERVICE OTH PASS THR  CSTS,APPORTIONMENT OF INPATIENT/OUTPATIENT ANCILLARY SERVICE OTH PASS THR  CSTS,APPORTIONMENT OF INPATIENT/OUTPATIENT ANCILLARY SERVICE OTH PASS THR  CSTS,APPORTIONMENT OF INPATIENT/OUTPATIENT ANCILLARY SERVICE OTH PASS THR  CSTS,APPORTIONMENT OF INPATIENT/OUTPATIENT ANCILLARY SERVICE OTH PASS THR  CSTS,APPORTIONMENT OF INPATIENT/OUTPATIENT ANCILLARY SERVICE OTH PASS THR  CSTS,APPORTIONMENT OF INPATIENT/OUTPATIENT ANCILLARY SERVICE OTH PASS THR  CSTS,APPORTIONMENT OF INPATIENT/OUTPATIENT ANCILLARY SERVICE OTH PASS THR  CSTS,APPORTIONMENT OF INPATIENT/OUTPATIENT ANCILLARY SERVICE OTH PASS THR  CSTS,APPORTIONMENT OF INPATIENT/OUTPATIENT ANCILLARY SERVICE OTH PASS THR  CSTS,APPORTIONMENT OF INPATIENT/OUTPATIENT ANCILLARY SERVICE OTH PASS THR  CSTS,APPORTIONMENT OF INPATIENT/OUTPATIENT ANCILLARY SERVICE OTH PASS THR  CSTS,APPORTIONMENT OF INPATIENT/OUTPATIENT ANCILLARY SERVICE OTH PASS THR  CSTS,APPORTIONMENT OF INPATIENT/OUTPATIENT ANCILLARY SERVICE OTH PASS THR  CSTS,APPORTIONMENT OF INPATIENT/OUTPATIENT ANCILLARY SERVICE OTH PASS THR  CSTS,APPORTIONMENT OF MEDICAL AND OTHER HEALTH SERVICES,APPORTIONMENT OF MEDICAL AND OTHER HEALTH SERVICES,APPORTIONMENT OF MEDICAL AND OTHER HEALTH SERVICES,APPORTIONMENT OF MEDICAL AND OTHER HEALTH SERVICES,APPORTIONMENT OF MEDICAL AND OTHER HEALTH SERVICES,APPORTIONMENT OF MEDICAL AND OTHER HEALTH SERVICES,APPORTIONMENT OF MEDICAL AND OTHER HEALTH SERVICES,APPORTIONMENT OF MEDICAL AND OTHER HEALTH SERVICES,APPORTIONMENT OF MEDICAL AND OTHER HEALTH SERVICES,APPORTIONMENT OF MEDICAL AND OTHER HEALTH SERVICES,APPORTIONMENT OF MEDICAL AND OTHER HEALTH SERVICES,APPORTIONMENT OF MEDICAL AND OTHER HEALTH SERVICES,APPORTIONMENT OF MEDICAL AND OTHER HEALTH SERVICES,APPORTIONMENT OF MEDICAL AND OTHER HEALTH SERVICES,APPORTIONMENT OF MEDICAL AND OTHER HEALTH SERVICES,APPORTIONMENT OF MEDICAL AND OTHER HEALTH SERVICES,APPORTIONMENT OF MEDICAL AND OTHER HEALTH SERVICES,APPORTIONMENT OF MEDICAL AND OTHER HEALTH SERVICES,APPORTIONMENT OF MEDICAL AND OTHER HEALTH SERVICES,APPORTIONMENT OF MEDICAL AND OTHER HEALTH SERVICES,APPORTIONMENT OF MEDICAL AND OTHER HEALTH SERVICES,APPORTIONMENT OF MEDICAL AND OTHER HEALTH SERVICES,APPORTIONMENT OF MEDICAL AND OTHER HEALTH SERVICES,APPORTIONMENT OF MEDICAL AND OTHER HEALTH SERVICES,APPORTIONMENT OF MEDICAL AND OTHER HEALTH SERVICES,APPORTIONMENT OF MEDICAL AND OTHER HEALTH SERVICES,APPORTIONMENT OF MEDICAL AND OTHER HEALTH SERVICES,APPORTIONMENT OF MEDICAL AND OTHER HEALTH SERVICES,APPORTIONMENT OF MEDICAL AND OTHER HEALTH SERVICES,APPORTIONMENT OF MEDICAL AND OTHER HEALTH SERVICES,APPORTIONMENT OF MEDICAL AND OTHER HEALTH SERVICES,APPORTIONMENT OF MEDICAL AND OTHER HEALTH SERVICES,APPORTIONMENT OF MEDICAL AND OTHER HEALTH SERVICES,APPORTIONMENT OF MEDICAL AND OTHER HEALTH SERVICES,APPORTIONMENT OF MEDICAL AND OTHER HEALTH SERVICES,APPORTIONMENT OF MEDICAL AND OTHER HEALTH SERVICES,APPORTIONMENT OF MEDICAL AND OTHER HEALTH SERVICES,APPORTIONMENT OF MEDICAL AND OTHER HEALTH SERVICES,APPORTIONMENT OF MEDICAL AND OTHER HEALTH SERVICES,APPORTIONMENT OF MEDICAL AND OTHER HEALTH SERVICES,APPORTIONMENT OF MEDICAL AND OTHER HEALTH SERVICES,APPORTIONMENT OF MEDICAL AND OTHER HEALTH SERVICES,NUMBER OF BEDS,NUMBER OF BEDS,BED DAYS AVAILABLE,BED DAYS AVAILABLE,Medicare Inpatient Days/Outpatient Visits,Medicare Inpatient Days/Outpatient Visits,Medicaid Inpatient Days/Outpatient Visits ,Medicaid Inpatient Days/Outpatient Visits ,Total Inpatient Days/Outpatient Visits,Total Inpatient Days/Outpatient Visits,TRIAL BALANCE OF EXPENSE ACCOUNTS,TRIAL BALANCE OF EXPENSE ACCOUNTS,TRIAL BALANCE OF EXPENSE ACCOUNTS,TRIAL BALANCE OF EXPENSE ACCOUNTS,TRIAL BALANCE OF EXPENSE ACCOUNTS,COST ALLOCATION,COST ALLOCATION,ALLOCATION OF NEW CAPITAL COSTS,COMPUTATION OF RATIO OF COST TO CHARGES,COMPUTATION OF RATIO OF COST TO CHARGES,COMPUTATION OF RATIO OF COST TO CHARGES,INPATIENT ANCILLARY SERVICE COST APPORTIONMENT,INPATIENT ANCILLARY SERVICE COST APPORTIONMENT,APPORTIONMENT OF INPATIENT/OUTPATIENT ANCILLARY SERVICE OTH PASS THR  CSTS,TRIAL BALANCE OF EXPENSE ACCOUNTS,TRIAL BALANCE OF EXPENSE ACCOUNTS,TRIAL BALANCE OF EXPENSE ACCOUNTS,TRIAL BALANCE OF EXPENSE ACCOUNTS,COST ALLOCATION,COST ALLOCATION,ALLOCATION OF NEW CAPITAL COSTS,COMPUTATION OF RATIO OF COST TO CHARGES,COMPUTATION OF RATIO OF COST TO CHARGES,INPATIENT ANCILLARY SERVICE COST APPORTIONMENT,INPATIENT ANCILLARY SERVICE COST APPORTIONMENT,INPATIENT ANCILLARY SERVICE COST APPORTIONMENT,INPATIENT ANCILLARY SERVICE COST APPORTIONMENT,INPATIENT ANCILLARY SERVICE COST APPORTIONMENT,INPATIENT ANCILLARY SERVICE COST APPORTIONMENT,INPATIENT ANCILLARY SERVICE COST APPORTIONMENT,INPATIENT ANCILLARY SERVICE COST APPORTIONMENT,INPATIENT ANCILLARY SERVICE COST APPORTIONMENT,INPATIENT ANCILLARY SERVICE COST APPORTIONMENT,Total Inpatient Days/Outpatient Visits,Medicare Inpatient Days/Outpatient Visits,Total Inpatient Days/Outpatient Visits,TRIAL BALANCE OF EXPENSE ACCOUNTS,TRIAL BALANCE OF EXPENSE ACCOUNTS,TRIAL BALANCE OF EXPENSE ACCOUNTS,APPORTIONMENT OF MEDICAL AND OTHER HEALTH SERVICES,APPORTIONMENT OF MEDICAL AND OTHER HEALTH SERVICES,APPORTIONMENT OF MEDICAL AND OTHER HEALTH SERVICES,APPORTIONMENT OF MEDICAL AND OTHER HEALTH SERVICES,TRIAL BALANCE OF EXPENSE ACCOUNTS,TRIAL BALANCE OF EXPENSE ACCOUNTS,TRIAL BALANCE OF EXPENSE ACCOUNTS,TRIAL BALANCE OF EXPENSE ACCOUNTS,TRIAL BALANCE OF EXPENSE ACCOUNTS,TRIAL BALANCE OF EXPENSE ACCOUNTS,TRIAL BALANCE OF EXPENSE ACCOUNTS,TRIAL BALANCE OF EXPENSE ACCOUNTS,TRIAL BALANCE OF EXPENSE ACCOUNTS,TRIAL BALANCE OF EXPENSE ACCOUNTS,TRIAL BALANCE OF EXPENSE ACCOUNTS,TRIAL BALANCE OF EXPENSE ACCOUNTS,TRIAL BALANCE OF EXPENSE ACCOUNTS,TRIAL BALANCE OF EXPENSE ACCOUNTS,COST ALLOCATION,COST ALLOCATION,COST ALLOCATION,COST ALLOCATION,COST ALLOCATION,COST ALLOCATION,COST ALLOCATION,COST ALLOCATION,COST ALLOCATION,ALLOCATION OF NEW CAPITAL COSTS,ALLOCATION OF NEW CAPITAL COSTS,ALLOCATION OF NEW CAPITAL COSTS,ALLOCATION OF NEW CAPITAL COSTS,COMPUTATION OF RATIO OF COST TO CHARGES,COMPUTATION OF RATIO OF COST TO CHARGES,COMPUTATION OF RATIO OF COST TO CHARGES,COMPUTATION OF RATIO OF COST TO CHARGES,COMPUTATION OF RATIO OF COST TO CHARGES,COMPUTATION OF RATIO OF COST TO CHARGES,COMPUTATION OF RATIO OF COST TO CHARGES,APPORTIONMENT OF INPATIENT/OUTPATIENT ANCILLARY SERVICE OTH PASS THR  CSTS,APPORTIONMENT OF INPATIENT/OUTPATIENT ANCILLARY SERVICE OTH PASS THR  CSTS,APPORTIONMENT OF INPATIENT/OUTPATIENT ANCILLARY SERVICE OTH PASS THR  CSTS,APPORTIONMENT OF MEDICAL AND OTHER HEALTH SERVICES,APPORTIONMENT OF MEDICAL AND OTHER HEALTH SERVICES,APPORTIONMENT OF MEDICAL AND OTHER HEALTH SERVICES,APPORTIONMENT OF MEDICAL AND OTHER HEALTH SERVICES,APPORTIONMENT OF MEDICAL AND OTHER HEALTH SERVICES,APPORTIONMENT OF MEDICAL AND OTHER HEALTH SERVICES,APPORTIONMENT OF MEDICAL AND OTHER HEALTH SERVICES,APPORTIONMENT OF MEDICAL AND OTHER HEALTH SERVICES,Total Inpatient Days/Outpatient Visits,Total Inpatient Days/Outpatient Visits,Medicare Inpatient Days/Outpatient Visits,Total Inpatient Days/Outpatient Visits,Total Inpatient Days/Outpatient Visits,TRIAL BALANCE OF EXPENSE ACCOUNTS,TRIAL BALANCE OF EXPENSE ACCOUNTS,TRIAL BALANCE OF EXPENSE ACCOUNTS,TRIAL BALANCE OF EXPENSE ACCOUNTS,TRIAL BALANCE OF EXPENSE ACCOUNTS,TRIAL BALANCE OF EXPENSE ACCOUNTS,TRIAL BALANCE OF EXPENSE ACCOUNTS,TRIAL BALANCE OF EXPENSE ACCOUNTS,TRIAL BALANCE OF EXPENSE ACCOUNTS,TRIAL BALANCE OF EXPENSE ACCOUNTS,TRIAL BALANCE OF EXPENSE ACCOUNTS,TRIAL BALANCE OF EXPENSE ACCOUNTS,TRIAL BALANCE OF EXPENSE ACCOUNTS,TRIAL BALANCE OF EXPENSE ACCOUNTS,TRIAL BALANCE OF EXPENSE ACCOUNTS,TRIAL BALANCE OF EXPENSE ACCOUNTS,TRIAL BALANCE OF EXPENSE ACCOUNTS,TRIAL BALANCE OF EXPENSE ACCOUNTS,COST ALLOCATION,COST ALLOCATION,COST ALLOCATION,COST ALLOCATION,COST ALLOCATION,COST ALLOCATION,COST ALLOCATION,COST ALLOCATION,COST ALLOCATION,COST ALLOCATION,COST ALLOCATION,COST ALLOCATION,COST ALLOCATION,COST ALLOCATION,COST ALLOCATION,COST ALLOCATION,ALLOCATION OF NEW CAPITAL COSTS,ALLOCATION OF NEW CAPITAL COSTS,ALLOCATION OF NEW CAPITAL COSTS,COMPUTATION OF RATIO OF COST TO CHARGES,COMPUTATION OF RATIO OF COST TO CHARGES,COMPUTATION OF RATIO OF COST TO CHARGES,COMPUTATION OF RATIO OF COST TO CHARGES,COMPUTATION OF RATIO OF COST TO CHARGES,COMPUTATION OF RATIO OF COST TO CHARGES,COMPUTATION OF RATIO OF COST TO CHARGES,COMPUTATION OF RATIO OF COST TO CHARGES,INPATIENT ANCILLARY SERVICE COST APPORTIONMENT,INPATIENT ANCILLARY SERVICE COST APPORTIONMENT,INPATIENT ANCILLARY SERVICE COST APPORTIONMENT,INPATIENT ANCILLARY SERVICE COST APPORTIONMENT,INPATIENT ANCILLARY SERVICE COST APPORTIONMENT,INPATIENT ANCILLARY SERVICE COST APPORTIONMENT,INPATIENT ANCILLARY SERVICE COST APPORTIONMENT,INPATIENT ANCILLARY SERVICE COST APPORTIONMENT,INPATIENT ANCILLARY SERVICE COST APPORTIONMENT,INPATIENT ANCILLARY SERVICE COST APPORTIONMENT,INPATIENT ANCILLARY SERVICE COST APPORTIONMENT,INPATIENT ANCILLARY SERVICE COST APPORTIONMENT,INPATIENT ANCILLARY SERVICE COST APPORTIONMENT,INPATIENT ANCILLARY SERVICE COST APPORTIONMENT,INPATIENT ANCILLARY SERVICE COST APPORTIONMENT,INPATIENT ANCILLARY SERVICE COST APPORTIONMENT,INPATIENT ANCILLARY SERVICE COST APPORTIONMENT,INPATIENT ANCILLARY SERVICE COST APPORTIONMENT,INPATIENT ANCILLARY SERVICE COST APPORTIONMENT,INPATIENT ANCILLARY SERVICE COST APPORTIONMENT,INPATIENT ANCILLARY SERVICE COST APPORTIONMENT,INPATIENT ANCILLARY SERVICE COST APPORTIONMENT,INPATIENT ANCILLARY SERVICE COST APPORTIONMENT,INPATIENT ANCILLARY SERVICE COST APPORTIONMENT,INPATIENT ANCILLARY SERVICE COST APPORTIONMENT,INPATIENT ANCILLARY SERVICE COST APPORTIONMENT,INPATIENT ANCILLARY SERVICE COST APPORTIONMENT,INPATIENT ANCILLARY SERVICE COST APPORTIONMENT,INPATIENT ANCILLARY SERVICE COST APPORTIONMENT,APPORTIONMENT OF INPATIENT ROUTINE SERVICE CAPITAL COSTS,APPORTIONMENT OF INPATIENT ROUTINE SERVICE CAPITAL COSTS,APPORTIONMENT OF INPATIENT ROUTINE SERVICE CAPITAL COSTS,APPORTIONMENT OF INPATIENT ROUTINE SERVICE CAPITAL COSTS,APPORTIONMENT OF INPATIENT ROUTINE SERVICE OTHER PASS THROUGH COSTS,APPORTIONMENT OF INPATIENT ROUTINE SERVICE OTHER PASS THROUGH COSTS,APPORTIONMENT OF INPATIENT/OUTPATIENT ANCILLARY SERVICE OTH PASS THR  CSTS,APPORTIONMENT OF INPATIENT/OUTPATIENT ANCILLARY SERVICE OTH PASS THR  CSTS,APPORTIONMENT OF INPATIENT/OUTPATIENT ANCILLARY SERVICE OTH PASS THR  CSTS,APPORTIONMENT OF INPATIENT/OUTPATIENT ANCILLARY SERVICE OTH PASS THR  CSTS,APPORTIONMENT OF INPATIENT/OUTPATIENT ANCILLARY SERVICE OTH PASS THR  CSTS,APPORTIONMENT OF INPATIENT/OUTPATIENT ANCILLARY SERVICE OTH PASS THR  CSTS,APPORTIONMENT OF INPATIENT/OUTPATIENT ANCILLARY SERVICE OTH PASS THR  CSTS,APPORTIONMENT OF INPATIENT/OUTPATIENT ANCILLARY SERVICE OTH PASS THR  CSTS,APPORTIONMENT OF INPATIENT/OUTPATIENT ANCILLARY SERVICE OTH PASS THR  CSTS,APPORTIONMENT OF INPATIENT/OUTPATIENT ANCILLARY SERVICE OTH PASS THR  CSTS,APPORTIONMENT OF INPATIENT/OUTPATIENT ANCILLARY SERVICE OTH PASS THR  CSTS,APPORTIONMENT OF INPATIENT/OUTPATIENT ANCILLARY SERVICE OTH PASS THR  CSTS,APPORTIONMENT OF INPATIENT/OUTPATIENT ANCILLARY SERVICE OTH PASS THR  CSTS,APPORTIONMENT OF INPATIENT/OUTPATIENT ANCILLARY SERVICE OTH PASS THR  CSTS,APPORTIONMENT OF INPATIENT/OUTPATIENT ANCILLARY SERVICE OTH PASS THR  CSTS,APPORTIONMENT OF INPATIENT/OUTPATIENT ANCILLARY SERVICE OTH PASS THR  CSTS,APPORTIONMENT OF INPATIENT/OUTPATIENT ANCILLARY SERVICE OTH PASS THR  CSTS,APPORTIONMENT OF INPATIENT/OUTPATIENT ANCILLARY SERVICE OTH PASS THR  CSTS,APPORTIONMENT OF INPATIENT/OUTPATIENT ANCILLARY SERVICE OTH PASS THR  CSTS,APPORTIONMENT OF MEDICAL AND OTHER HEALTH SERVICES,APPORTIONMENT OF MEDICAL AND OTHER HEALTH SERVICES,NUMBER OF BEDS,BED DAYS AVAILABLE,Medicare Inpatient Days/Outpatient Visits,Medicaid Inpatient Days/Outpatient Visits ,Total Inpatient Days/Outpatient Visits,TRIAL BALANCE OF EXPENSE ACCOUNTS,TRIAL BALANCE OF EXPENSE ACCOUNTS,TRIAL BALANCE OF EXPENSE ACCOUNTS,TRIAL BALANCE OF EXPENSE ACCOUNTS,TRIAL BALANCE OF EXPENSE ACCOUNTS,TRIAL BALANCE OF EXPENSE ACCOUNTS,TRIAL BALANCE OF EXPENSE ACCOUNTS,TRIAL BALANCE OF EXPENSE ACCOUNTS,TRIAL BALANCE OF EXPENSE ACCOUNTS,COST ALLOCATION,COST ALLOCATION,COST ALLOCATION,COST ALLOCATION,ALLOCATION OF NEW CAPITAL COSTS,ALLOCATION OF NEW CAPITAL COSTS,COMPUTATION OF RATIO OF COST TO CHARGES,COMPUTATION OF RATIO OF COST TO CHARGES,COMPUTATION OF RATIO OF COST TO CHARGES,COMPUTATION OF RATIO OF COST TO CHARGES,COMPUTATION OF RATIO OF COST TO CHARGES,COMPUTATION OF RATIO OF COST TO CHARGES,INPATIENT ANCILLARY SERVICE COST APPORTIONMENT,INPATIENT ANCILLARY SERVICE COST APPORTIONMENT,INPATIENT ANCILLARY SERVICE COST APPORTIONMENT,INPATIENT ANCILLARY SERVICE COST APPORTIONMENT,APPORTIONMENT OF INPATIENT/OUTPATIENT ANCILLARY SERVICE OTH PASS THR  CSTS,APPORTIONMENT OF INPATIENT/OUTPATIENT ANCILLARY SERVICE OTH PASS THR  CSTS,APPORTIONMENT OF MEDICAL AND OTHER HEALTH SERVICES,APPORTIONMENT OF MEDICAL AND OTHER HEALTH SERVICES,APPORTIONMENT OF MEDICAL AND OTHER HEALTH SERVICES,APPORTIONMENT OF MEDICAL AND OTHER HEALTH SERVICES,APPORTIONMENT OF MEDICAL AND OTHER HEALTH SERVICES,APPORTIONMENT OF MEDICAL AND OTHER HEALTH SERVICES,APPORTIONMENT OF MEDICAL AND OTHER HEALTH SERVICES,APPORTIONMENT OF MEDICAL AND OTHER HEALTH SERVICES,TRIAL BALANCE OF EXPENSE ACCOUNTS,TRIAL BALANCE OF EXPENSE ACCOUNTS,COST ALLOCATION,COST ALLOCATION,ALLOCATION OF NEW CAPITAL COSTS,COMPUTATION OF RATIO OF COST TO CHARGES,COMPUTATION OF RATIO OF COST TO CHARGES,COMPUTATION OF RATIO OF COST TO CHARGES,INPATIENT ANCILLARY SERVICE COST APPORTIONMENT,INPATIENT ANCILLARY SERVICE COST APPORTIONMENT,APPORTIONMENT OF INPATIENT/OUTPATIENT ANCILLARY SERVICE OTH PASS THR  CSTS,APPORTIONMENT OF INPATIENT/OUTPATIENT ANCILLARY SERVICE OTH PASS THR  CSTS,APPORTIONMENT OF INPATIENT/OUTPATIENT ANCILLARY SERVICE OTH PASS THR  CSTS,APPORTIONMENT OF MEDICAL AND OTHER HEALTH SERVICES,APPORTIONMENT OF MEDICAL AND OTHER HEALTH SERVICES,APPORTIONMENT OF MEDICAL AND OTHER HEALTH SERVICES,APPORTIONMENT OF MEDICAL AND OTHER HEALTH SERVICES,TRIAL BALANCE OF EXPENSE ACCOUNTS,TRIAL BALANCE OF EXPENSE ACCOUNTS,TRIAL BALANCE OF EXPENSE ACCOUNTS,TRIAL BALANCE OF EXPENSE ACCOUNTS,TRIAL BALANCE OF EXPENSE ACCOUNTS,TRIAL BALANCE OF EXPENSE ACCOUNTS,TRIAL BALANCE OF EXPENSE ACCOUNTS,TRIAL BALANCE OF EXPENSE ACCOUNTS,COST ALLOCATION,COST ALLOCATION,COST ALLOCATION,COST ALLOCATION,COST ALLOCATION,COST ALLOCATION,COST ALLOCATION,COST ALLOCATION,COST ALLOCATION,COST ALLOCATION,COST ALLOCATION,COST ALLOCATION,COST ALLOCATION,COST ALLOCATION,ALLOCATION OF NEW CAPITAL COSTS,COMPUTATION OF RATIO OF COST TO CHARGES,COMPUTATION OF RATIO OF COST TO CHARGES,COMPUTATION OF RATIO OF COST TO CHARGES,INPATIENT ANCILLARY SERVICE COST APPORTIONMENT,INPATIENT ANCILLARY SERVICE COST APPORTIONMENT,INPATIENT ANCILLARY SERVICE COST APPORTIONMENT,INPATIENT ANCILLARY SERVICE COST APPORTIONMENT,INPATIENT ANCILLARY SERVICE COST APPORTIONMENT,INPATIENT ANCILLARY SERVICE COST APPORTIONMENT,INPATIENT ANCILLARY SERVICE COST APPORTIONMENT,INPATIENT ANCILLARY SERVICE COST APPORTIONMENT,INPATIENT ANCILLARY SERVICE COST APPORTIONMENT,INPATIENT ANCILLARY SERVICE COST APPORTIONMENT,INPATIENT ANCILLARY SERVICE COST APPORTIONMENT,INPATIENT ANCILLARY SERVICE COST APPORTIONMENT,INPATIENT ANCILLARY SERVICE COST APPORTIONMENT,INPATIENT ANCILLARY SERVICE COST APPORTIONMENT,INPATIENT ANCILLARY SERVICE COST APPORTIONMENT,INPATIENT ANCILLARY SERVICE COST APPORTIONMENT,INPATIENT ANCILLARY SERVICE COST APPORTIONMENT,INPATIENT ANCILLARY SERVICE COST APPORTIONMENT,INPATIENT ANCILLARY SERVICE COST APPORTIONMENT,INPATIENT ANCILLARY SERVICE COST APPORTIONMENT,INPATIENT ANCILLARY SERVICE COST APPORTIONMENT,INPATIENT ANCILLARY SERVICE COST APPORTIONMENT,INPATIENT ANCILLARY SERVICE COST APPORTIONMENT,INPATIENT ANCILLARY SERVICE COST APPORTIONMENT,INPATIENT ANCILLARY SERVICE COST APPORTIONMENT,INPATIENT ANCILLARY SERVICE COST APPORTIONMENT,INPATIENT ANCILLARY SERVICE COST APPORTIONMENT,INPATIENT ANCILLARY SERVICE COST APPORTIONMENT,INPATIENT ANCILLARY SERVICE COST APPORTIONMENT,INPATIENT ANCILLARY SERVICE COST APPORTIONMENT,INPATIENT ANCILLARY SERVICE COST APPORTIONMENT,INPATIENT ANCILLARY SERVICE COST APPORTIONMENT,INPATIENT ANCILLARY SERVICE COST APPORTIONMENT,INPATIENT ANCILLARY SERVICE COST APPORTIONMENT,INPATIENT ANCILLARY SERVICE COST APPORTIONMENT,INPATIENT ANCILLARY SERVICE COST APPORTIONMENT,INPATIENT ANCILLARY SERVICE COST APPORTIONMENT,INPATIENT ANCILLARY SERVICE COST APPORTIONMENT,INPATIENT ANCILLARY SERVICE COST APPORTIONMENT,INPATIENT ANCILLARY SERVICE COST APPORTIONMENT,INPATIENT ANCILLARY SERVICE COST APPORTIONMENT,INPATIENT ANCILLARY SERVICE COST APPORTIONMENT,APPORTIONMENT OF INPATIENT ROUTINE SERVICE OTHER PASS THROUGH COSTS,APPORTIONMENT OF INPATIENT/OUTPATIENT ANCILLARY SERVICE OTH PASS THR  CSTS,APPORTIONMENT OF INPATIENT/OUTPATIENT ANCILLARY SERVICE OTH PASS THR  CSTS,APPORTIONMENT OF INPATIENT/OUTPATIENT ANCILLARY SERVICE OTH PASS THR  CSTS,APPORTIONMENT OF INPATIENT/OUTPATIENT ANCILLARY SERVICE OTH PASS THR  CSTS,APPORTIONMENT OF INPATIENT/OUTPATIENT ANCILLARY SERVICE OTH PASS THR  CSTS,APPORTIONMENT OF INPATIENT/OUTPATIENT ANCILLARY SERVICE OTH PASS THR  CSTS,APPORTIONMENT OF INPATIENT/OUTPATIENT ANCILLARY SERVICE OTH PASS THR  CSTS,APPORTIONMENT OF INPATIENT/OUTPATIENT ANCILLARY SERVICE OTH PASS THR  CSTS,APPORTIONMENT OF INPATIENT/OUTPATIENT ANCILLARY SERVICE OTH PASS THR  CSTS,APPORTIONMENT OF INPATIENT/OUTPATIENT ANCILLARY SERVICE OTH PASS THR  CSTS,APPORTIONMENT OF INPATIENT/OUTPATIENT ANCILLARY SERVICE OTH PASS THR  CSTS,APPORTIONMENT OF INPATIENT/OUTPATIENT ANCILLARY SERVICE OTH PASS THR  CSTS,APPORTIONMENT OF INPATIENT/OUTPATIENT ANCILLARY SERVICE OTH PASS THR  CSTS,APPORTIONMENT OF INPATIENT/OUTPATIENT ANCILLARY SERVICE OTH PASS THR  CSTS,APPORTIONMENT OF INPATIENT/OUTPATIENT ANCILLARY SERVICE OTH PASS THR  CSTS,APPORTIONMENT OF INPATIENT/OUTPATIENT ANCILLARY SERVICE OTH PASS THR  CSTS,APPORTIONMENT OF INPATIENT/OUTPATIENT ANCILLARY SERVICE OTH PASS THR  CSTS,APPORTIONMENT OF INPATIENT/OUTPATIENT ANCILLARY SERVICE OTH PASS THR  CSTS,APPORTIONMENT OF INPATIENT/OUTPATIENT ANCILLARY SERVICE OTH PASS THR  CSTS,APPORTIONMENT OF INPATIENT/OUTPATIENT ANCILLARY SERVICE OTH PASS THR  CSTS,APPORTIONMENT OF INPATIENT/OUTPATIENT ANCILLARY SERVICE OTH PASS THR  CSTS,APPORTIONMENT OF INPATIENT/OUTPATIENT ANCILLARY SERVICE OTH PASS THR  CSTS,APPORTIONMENT OF INPATIENT/OUTPATIENT ANCILLARY SERVICE OTH PASS THR  CSTS,APPORTIONMENT OF INPATIENT/OUTPATIENT ANCILLARY SERVICE OTH PASS THR  CSTS,APPORTIONMENT OF INPATIENT/OUTPATIENT ANCILLARY SERVICE OTH PASS THR  CSTS,APPORTIONMENT OF INPATIENT/OUTPATIENT ANCILLARY SERVICE OTH PASS THR  CSTS,APPORTIONMENT OF INPATIENT/OUTPATIENT ANCILLARY SERVICE OTH PASS THR  CSTS,APPORTIONMENT OF INPATIENT/OUTPATIENT ANCILLARY SERVICE OTH PASS THR  CSTS,APPORTIONMENT OF INPATIENT/OUTPATIENT ANCILLARY SERVICE OTH PASS THR  CSTS,APPORTIONMENT OF INPATIENT/OUTPATIENT ANCILLARY SERVICE OTH PASS THR  CSTS,APPORTIONMENT OF INPATIENT/OUTPATIENT ANCILLARY SERVICE OTH PASS THR  CSTS,APPORTIONMENT OF INPATIENT/OUTPATIENT ANCILLARY SERVICE OTH PASS THR  CSTS,APPORTIONMENT OF INPATIENT/OUTPATIENT ANCILLARY SERVICE OTH PASS THR  CSTS,APPORTIONMENT OF MEDICAL AND OTHER HEALTH SERVICES,APPORTIONMENT OF MEDICAL AND OTHER HEALTH SERVICES,APPORTIONMENT OF MEDICAL AND OTHER HEALTH SERVICES,APPORTIONMENT OF MEDICAL AND OTHER HEALTH SERVICES,APPORTIONMENT OF MEDICAL AND OTHER HEALTH SERVICES,APPORTIONMENT OF MEDICAL AND OTHER HEALTH SERVICES,APPORTIONMENT OF MEDICAL AND OTHER HEALTH SERVICES,APPORTIONMENT OF MEDICAL AND OTHER HEALTH SERVICES,APPORTIONMENT OF MEDICAL AND OTHER HEALTH SERVICES,APPORTIONMENT OF MEDICAL AND OTHER HEALTH SERVICES,APPORTIONMENT OF MEDICAL AND OTHER HEALTH SERVICES,APPORTIONMENT OF MEDICAL AND OTHER HEALTH SERVICES,NUMBER OF BEDS,BED DAYS AVAILABLE,Medicaid Inpatient Days/Outpatient Visits ,Total Inpatient Days/Outpatient Visits,APPORTIONMENT OF INPATIENT/OUTPATIENT ANCILLARY SERVICE OTH PASS THR  CSTS,APPORTIONMENT OF MEDICAL AND OTHER HEALTH SERVICES,APPORTIONMENT OF MEDICAL AND OTHER HEALTH SERVICES,APPORTIONMENT OF MEDICAL AND OTHER HEALTH SERVICES,APPORTIONMENT OF MEDICAL AND OTHER HEALTH SERVICES,APPORTIONMENT OF MEDICAL AND OTHER HEALTH SERVICES,APPORTIONMENT OF MEDICAL AND OTHER HEALTH SERVICES,INPATIENT ANCILLARY SERVICE COST APPORTIONMENT,INPATIENT ANCILLARY SERVICE COST APPORTIONMENT,APPORTIONMENT OF MEDICAL AND OTHER HEALTH SERVICES,APPORTIONMENT OF MEDICAL AND OTHER HEALTH SERVICES,APPORTIONMENT OF MEDICAL AND OTHER HEALTH SERVICES,APPORTIONMENT OF MEDICAL AND OTHER HEALTH SERVICES,Medicaid Inpatient Days/Outpatient Visits ,Lat,Lon,"Control type, text","Hospital type, text",Num and Name
,Report Record Number (RPT_REC_NUM),Hospital Provider Number  (PRVDR_NUM),Fiscal Intermediary Number (FI_NUM),Fiscal Intermediary/MAC Create Date (FI_CREAT_DT),Fiscal Year Begin Date  (FY_BGN_DT),Fiscal Year End Date  (FY_END_DT),Utilization Code (L/N/F) (UTIL_CODE),SSA State Code (STATE),SSA State County Code (ST_CTY_CD),Census Division Code (CENSUS),CMS Region Code (REGION),Geographic MSA (MSA),Column 3 (Donations) Land  (A7_1_C3_1),Column 3 (Donations) Total (A7_1_C3_10),Column 3 (Donations) Land Improvements (A7_1_C3_2),Column 3 (Donations) Buildings and Fixtures (A7_1_C3_3),Column 3 (Donations) Building Improvements (A7_1_C3_4),Column 3 (Donations) Fixed Equipment (A7_1_C3_5),Column 3 (Donations) Movable Equipment (A7_1_C3_6),Column 7 (Fully Depreciated Assets) Donations (A7_1_C3_7),Column 3 (Donations) Subtotal (A7_1_C3_8),Column 5 (Disposals and Retirements) Land Improvements (A7_1_C5_2),Column 5 (Disposals and Retirements) Building Improvements (A7_1_C5_4),Column 7 (Fully Depreciated Assets) Disp. And Retirement (A7_1_C5_7),Column 5 (Disposals and Retirements) Land  (A7_1_C7_1),Column 7 (Fully Depreciated Assets) Total (A7_1_C7_10),Column 5 (Disposals and Retirements) Land Improvements (A7_1_C7_2),Column 5 (Disposals and Retirements) Buildings and Fixtures (A7_1_C7_3),Column 5 (Disposals and Retirements) Building Improvements (A7_1_C7_4),Column 5 (Disposals and Retirements) Fixed Equipment (A7_1_C7_5),Column 5 (Disposals and Retirements) Movable Equipment (A7_1_C7_6),Column 7 (Fully Depreciated Assets) Assets (A7_1_C7_7),Column 7 (Fully Depreciated Assets) Subtotal (A7_1_C7_8),"Sale of scrap, waste, etc.  (A8_C2_11)",Rental of quarters to employee and oths (A8_C2_15),Sale of medical and surgical supplies to  (A8_C2_16),Nursing School (A8_C2_19),Vending Machines (A8_C2_20),Utilization Review-physicians compens (A8_C2_25),Depreciation-New Bldgs & Fixtures (A8_C2_26),Depreciation-New Movable Equipment (A8_C2_27),Physicians' Assistant (A8_C2_29),Investment Income-Other (A8_C2_3),Adj for Occupational therapy in excess of li (A8_C2_30),Adj for Speech therapy in excess of lim (A8_C2_31),Refunds and Rebates of Expenses (A8_C2_5),Parking Lot (A8_C2_9),Int & Res (non approved teaching program (A_C1_100),Kidney Acquisition (A_C1_105),Heart Acquisition (A_C1_106),Liver Acquisition (A_C1_107),Lung  Acquisition (A_C1_108),Pancreas Acquisition (A_C1_109),Intestinal Acquisition (A_C1_110),Islet Acquisition (A_C1_111),Utilization Review SNF (A_C1_114),Subprovider I (A_C1_42),Subprovider II (A_C1_4201),NF (A_C1_45),ICF (A_C1_4501),OLTC (A_C1_46),Home Program Dialysis (A_C1_94),Int & Res (non approved teaching program (A_C2_100),Kidney Acquisition (A_C2_105),Heart Acquisition (A_C2_106),Liver Acquisition (A_C2_107),Lung  Acquisition (A_C2_108),Pancreas Acquisition (A_C2_109),Intestinal Acquisition (A_C2_110),Islet Acquisition (A_C2_111),Utilization Review SNF (A_C2_114),Subprovider I (A_C2_42),Subprovider II (A_C2_4201),NF (A_C2_45),ICF (A_C2_4501),OLTC (A_C2_46),PBP Clinical Lab Services Program Only (A_C2_61),Home Program Dialysis (A_C2_94),Int & Res (non approved teaching program (A_C6_100),Kidney Acquisition (A_C6_105),Heart Acquisition (A_C6_106),Liver Acquisition (A_C6_107),Lung  Acquisition (A_C6_108),Pancreas Acquisition (A_C6_109),Intestinal Acquisition (A_C6_110),Islet Acquisition (A_C6_111),Utilization Review SNF (A_C6_114),Subprovider I (A_C6_42),Subprovider II (A_C6_4201),NF (A_C6_45),ICF (A_C6_4501),OLTC (A_C6_46),PBP Clinical Lab Services Program Only (A_C6_61),Renal Dialysis (A_C6_74),Home Program Dialysis (A_C6_94),Ambulance Services (A_C6_95),Net Expense for Cost Allocation Int & Res (non approved teaching program (B_1_C0_100),Net Expense for Cost Allocation Kidney Acquisition (B_1_C0_105),Net Expense for Cost Allocation Heart Acquisition (B_1_C0_106),Net Expense for Cost Allocation Liver Acquisition (B_1_C0_107),Net Expense for Cost Allocation Lung  Acquisition (B_1_C0_108),Net Expense for Cost Allocation Pancreas Acquisition (B_1_C0_109),Net Expense for Cost Allocation Intestinal Acquisition (B_1_C0_110),Net Expense for Cost Allocation Islet Acquisition (B_1_C0_111),Net Expense for Cost Allocation Subprovider I (B_1_C0_42),Net Expense for Cost Allocation Subprovider II (B_1_C0_4201),Net Expense for Cost Allocation NF (B_1_C0_45),Net Expense for Cost Allocation ICF (B_1_C0_4501),Net Expense for Cost Allocation OLTC (B_1_C0_46),Net Expense for Cost Allocation PBP Clinical Lab Services Program Only (B_1_C0_61),Net Expense for Cost Allocation Home Program Dialysis (B_1_C0_94),Int & Res (non approved teaching program (B_1_C21_100),Kidney Acquisition (B_1_C21_105),Heart Acquisition (B_1_C21_106),Liver Acquisition (B_1_C21_107),Lung  Acquisition (B_1_C21_108),Pancreas Acquisition (B_1_C21_109),Allocation of Interns & Residents Salary and Fringes Subprovider-IPF (B_1_C21_40),Allocation of Interns & Residents Salary and Fringes Subprovider I (B_1_C21_42),Allocation of Interns & Residents Salary and Fringes SNF (B_1_C21_44),Allocation of Interns & Residents Salary and Fringes NF (B_1_C21_45),Allocation of Interns & Residents Salary and Fringes OLTC (B_1_C21_46),Renal Dialysis (B_1_C21_74),Home Program Dialysis (B_1_C21_94),Ambulance Services (B_1_C21_95),Int & Res (non approved teaching program (B_1_C22_100),Kidney Acquisition (B_1_C22_105),Heart Acquisition (B_1_C22_106),Liver Acquisition (B_1_C22_107),Lung  Acquisition (B_1_C22_108),Pancreas Acquisition (B_1_C22_109),Intestinal Acquisition (B_1_C22_110),Islet Acquisition (B_1_C22_111),Allocation of Interns & Residents Program Costs Subprovider-IPF (B_1_C22_40),Allocation of Interns & Residents Program Costs Subprovider I (B_1_C22_42),Allocation of Interns & Residents Program Costs Nursery (B_1_C22_43),Allocation of Interns & Residents Program Costs SNF (B_1_C22_44),Allocation of Interns & Residents Program Costs NF (B_1_C22_45),Allocation of Interns & Residents Program Costs OLTC (B_1_C22_46),Renal Dialysis (B_1_C22_74),Home Program Dialysis (B_1_C22_94),Ambulance Services (B_1_C22_95),Int & Res (non approved teaching program (B_1_C26_100),Kidney Acquisition (B_1_C26_105),Heart Acquisition (B_1_C26_106),Liver Acquisition (B_1_C26_107),Lung  Acquisition (B_1_C26_108),Pancreas Acquisition (B_1_C26_109),Intestinal Acquisition (B_1_C26_110),Islet Acquisition (B_1_C26_111),Subprovider I (B_1_C26_42),Subprovider II (B_1_C26_4201),NF (B_1_C26_45),ICF (B_1_C26_4501),OLTC (B_1_C26_46),PBP Clinical Lab Services Program Only (B_1_C26_61),Home Program Dialysis (B_1_C26_94),Int & Res (non approved teaching program (B_2_C26_100),Kidney Acquisition (B_2_C26_105),Heart Acquisition (B_2_C26_106),Liver Acquisition (B_2_C26_107),Lung  Acquisition (B_2_C26_108),Pancreas Acquisition (B_2_C26_109),Intestinal Acquisition (B_2_C26_110),Islet Acquisition (B_2_C26_111),TOTAL CAPITAL COSTS AFTER COST ALLOCATION Subprovider I (B_2_C26_42),TOTAL CAPITAL COSTS AFTER COST ALLOCATION Subprovider II (B_2_C26_4201),TOTAL CAPITAL COSTS AFTER COST ALLOCATION NF (B_2_C26_45),TOTAL CAPITAL COSTS AFTER COST ALLOCATION ICF (B_2_C26_4501),TOTAL CAPITAL COSTS AFTER COST ALLOCATION OLTC (B_2_C26_46),Home Program Dialysis (B_2_C26_94),Int & Res (non approved teaching program (C_1_C5_100),Kidney Acquisition (C_1_C5_105),Heart Acquisition (C_1_C5_106),Liver Acquisition (C_1_C5_107),Lung  Acquisition (C_1_C5_108),Pancreas Acquisition (C_1_C5_109),Intestinal Acquisition (C_1_C5_110),Islet Acquisition (C_1_C5_111),Subprovider I (C_1_C5_42),Subprovider II (C_1_C5_4201),NF (C_1_C5_45),ICF (C_1_C5_4501),OLTC (C_1_C5_46),PBP Clinical Lab Services Program Only (C_1_C5_61),Home Program Dialysis (C_1_C5_94),Int & Res (non approved teaching program (C_1_C6_100),Kidney Acquisition (C_1_C6_105),Heart Acquisition (C_1_C6_106),Liver Acquisition (C_1_C6_107),Lung  Acquisition (C_1_C6_108),Pancreas Acquisition (C_1_C6_109),Intestinal Acquisition (C_1_C6_110),Islet Acquisition (C_1_C6_111),Total Inpatient Charges Subprovider I (C_1_C6_42),Total Inpatient Charges Subprovider II (C_1_C6_4201),Total Inpatient Charges NF (C_1_C6_45),Total Inpatient Charges ICF (C_1_C6_4501),Total Inpatient Charges OLTC (C_1_C6_46),Total Inpatient Charges PBP Clinical Lab Services Program Only (C_1_C6_61),Home Program Dialysis (C_1_C6_94),Int & Res (non approved teaching program (C_1_C7_100),Kidney Acquisition (C_1_C7_105),Heart Acquisition (C_1_C7_106),Liver Acquisition (C_1_C7_107),Lung  Acquisition (C_1_C7_108),Pancreas Acquisition (C_1_C7_109),Intestinal Acquisition (C_1_C7_110),Islet Acquisition (C_1_C7_111),Total Outpatient Charges PBP Clinical Lab Services Program Only (C_1_C7_61),Home Program Dialysis (C_1_C7_94),Program Discharges (D1_HOS_C1_54),Target Amount per Discharge (D1_HOS_C1_55),Target Amount    (D1_HOS_C1_56),Difference between Adjusted Inpatient  Operating Cost and Target Amount (D1_HOS_C1_57),Bonus Payment (D1_HOS_C1_58),Relief Payment (D1_HOS_C1_62),Allowable Inpatient Cost Plus Incentive Pt (D1_HOS_C1_63),Utilization Review - Physician Compen (D1_SNF_C1_85),Subprovider-IPF (D3_HOS_C2_40),Subprovider-IRF (D3_HOS_C2_41),Subprovider I (D3_HOS_C2_42),Nursery (D3_HOS_C2_43),PBP Clinical Lab Services Program Only (D3_HOS_C2_61),Home Program Dialysis (D3_HOS_C2_94),PBP Clinical Lab Services Program Only (D3_HOS_C3_61),Home Program Dialysis (D3_HOS_C3_94),Subprovider-IRF (D3_IPF_C2_41),Subprovider I (D3_IPF_C2_42),Renal Dialysis (D3_IPF_C2_74),Home Program Dialysis (D3_IPF_C2_94),Renal Dialysis (D3_IPF_C3_74),Home Program Dialysis (D3_IPF_C3_94),Subprovider-IRF (D3_IRF_C2_40),PBP Clinical Lab Services Program Only (D3_IRF_C2_61),Home Program Dialysis (D3_IRF_C2_94),PBP Clinical Lab Services Program Only (D3_IRF_C3_61),Home Program Dialysis (D3_IRF_C3_94),Adults and Pediatrics (D3_SNF_C2_30),Subprovider-IPF (D3_SNF_C2_40),Subprovider-IRF (D3_SNF_C2_41),Renal Dialysis (D3_SNF_C2_74),Home Program Dialysis (D3_SNF_C2_94),Renal Dialysis (D3_SNF_C3_74),Home Program Dialysis (D3_SNF_C3_94),Subprovider I (D_1_HOS_C4_42),Subprovider II (D_1_HOS_C4_4201),Total Other Medical Education Cost (D_3_HOS_C3_200),Subprovider-IRF (D_3_HOS_C9_41),SNF (D_3_HOS_C9_44),Renal Dialysis (D_4_HOS_C11_74),Home Program Dialysis (D_4_HOS_C11_94),Home Program Dialysis (D_4_HOS_C12_94),Renal Dialysis (D_4_HOS_C13_74),Total  (D_4_HOS_C1_200),Renal Dialysis (D_4_HOS_C2_74),Home Program Dialysis (D_4_HOS_C2_94),Renal Dialysis (D_4_HOS_C3_74),Home Program Dialysis (D_4_HOS_C3_94),Total Other Medical Education (D_4_HOS_C4_200),Renal Dialysis (D_4_HOS_C4_74),Renal Dialysis (D_4_IPF_C11_74),Total  (D_4_IPF_C13_200),Renal Dialysis (D_4_IPF_C13_74),Total Nonphysician Anesthetist Cost (D_4_IPF_C1_200),Total Nursing School (D_4_IPF_C2_200),Total Other Medical Education (D_4_IPF_C4_200),Renal Dialysis (D_4_IRF_C11_74),Total  (D_4_IRF_C13_200),Renal Dialysis (D_4_IRF_C13_74),Total Other Medical Education (D_4_IRF_C4_200),Total  (D_4_SNF_C11_200),Renal Dialysis (D_4_SNF_C11_74),Total  (D_4_SNF_C13_200),PPS REIMBURSED SERVICES -  CHARGES Home Program Dialysis (D_5_HOS_C2_94),COST REIMBURSED SERVICES SUBJECT TO DEDUCTIBLES  AND COINSURANCE - CHARGES PBP Clinical Lab Services Program Only (D_5_HOS_C3_61),COST REIMBURSED SERVICES SUBJECT TO DEDUCTIBLES  AND COINSURANCE - CHARGES Home Program Dialysis (D_5_HOS_C3_94),COST REIMBURSED SERVICES SUBJECT TO DEDUCTIBLES  AND COINSURANCE - CHARGES Ambulance Services (D_5_HOS_C3_95),COST REIMBURSED SERVICES NOT SUBJECT TO DEDUCTIBLES AND COINSURANCE - CHARGES Home Program Dialysis (D_5_HOS_C4_94),COST SERVICES SUBJECT TO DEDUCTIBLES AND COINSURANCE - COST PBP Clinical Lab Services Program Only (D_5_HOS_C6_61),COST SERVICES SUBJECT TO DEDUCTIBLES AND COINSURANCE - COST Home Program Dialysis (D_5_HOS_C6_94),COST SERVICES SUBJECT TO DEDUCTIBLES AND COINSURANCE - COST Ambulance Services (D_5_HOS_C6_95),COST SERVICES NOT SUBJECT TO DEDUCTIBLES AND COINSURANCE - COST Home Program Dialysis (D_5_HOS_C7_94),Medical and Other Services reimbursed by OPPS (E_B_HOS_C101_2),OPPS payments (E_B_HOS_C101_3),Outlier payments (E_B_HOS_C101_4),Line 2 times line 5 (E_B_HOS_C101_6),"Sum of lines 3,4 divided by line 6 (E_B_HOS_C101_7)",Transitional corridor payment (E_B_HOS_C101_8),Organ acquisition (E_B_HOS_C1_10),Organ acquisition charges (E_B_HOS_C1_13),Aggregate amount collected from patients (E_B_HOS_C1_15),Amounts expected under 42 CFR  (E_B_HOS_C1_16),Ratio of line 15 to line 16 (E_B_HOS_C1_17),Interns and residents (E_B_HOS_C1_22),Cost of physicians svcs in a teaching hospita (E_B_HOS_C1_23),Component rate ESRD (E_B_HOS_C1_33),Partial or full credits from manufacturers (E_B_HOS_C1_3998),Sequestration adjustment (E_B_HOS_C1_4001),Tentative settlement (E_B_HOS_C1_42),Transitional corridor payment (E_B_HOS_C1_8),Number of periods hospital was in MDH status (S2_1_C1_37),Total Subprovider I Interns & Residents (S3_1_C10_18),Total Subprovider II Interns & Residents (S3_1_C10_1801),NF (S3_1_C10_20),ICF (S3_1_C10_2001),OLTC (S3_1_C10_21),Total Hospital Interns & Residents (S3_1_C11_14),SNF (S3_1_C11_19),OLTC (S3_1_C11_21),Total Facility FTEs  (S3_1_C11_27),Subprovider 1 (S3_1_C2_18),Subprovider 2 (S3_1_C2_1801),NF (S3_1_C2_20),ICF (S3_1_C2_2001),OLTC (S3_1_C2_21),Subprovider 1 (S3_1_C3_18),Subprovider 2 (S3_1_C3_1801),NF (S3_1_C3_20),ICF (S3_1_C3_2001),OLTC (S3_1_C3_21),Hospital Adults & Pediatrics (S3_1_C5_1),Nursery (S3_1_C5_13),Total Hospital (S3_1_C5_14),IPF (S3_1_C5_16),IRF (S3_1_C5_17),SNF (S3_1_C5_19),NF (S3_1_C5_20),Total Hospital (S3_1_C5_7),RPCH/CAH Visits (S3_1_C6_15),RPCH/CAH Visits (S3_1_C7_15),Subprovider 1 (S3_1_C7_18),Subprovider 2 (S3_1_C7_1801),NF (S3_1_C7_20),ICF (S3_1_C7_2001),Hospital Adlts & Ped Swing Bed SNF (S3_1_C7_5),CAH Visits (S3_1_C8_15),Subprovider 1 (S3_1_C8_18),Subprovider 2 (S3_1_C8_1801),NF (S3_1_C8_20),ICF (S3_1_C8_2001),OLTC (S3_1_C8_21),Total Subprovider I Interns & Residents (S3_1_C9_18),SNF (S3_1_C9_19),NF (S3_1_C9_20),OLTC (S3_1_C9_21),AMOUNT REPORTED Home Office Salaries & Wage Related Csts (S3_2_C2_14),AMOUNT REPORTED Related  Salaries  (S3_2_C2_1402),AMOUNT REPORTED Teaching Physician Salaries (S3_2_C2_16),AMOUNT REPORTED Wage Related Costs Other (S3_2_C2_18),AMOUNT REPORTED Non-Physician Anesthetist Part A (S3_2_C2_2),AMOUNT REPORTED Non-Physician Anesthetist Part A (S3_2_C2_20),AMOUNT REPORTED Physician Part A (S3_2_C2_2201),AMOUNT REPORTED Interns & Residents (S3_2_C2_2551),AMOUNT REPORTED Interns & Residents (S3_2_C2_2553),AMOUNT REPORTED Cafeteria (S3_2_C2_36),AMOUNT REPORTED Maintenance of Personnel (S3_2_C2_37),AMOUNT REPORTED Other General Service (S3_2_C2_43),AMOUNT REPORTED Home Office Personnel (S3_2_C2_8),AMOUNT REPORTED SNF (S3_2_C2_9),AMOUNT REPORTED Home Office Salaries & Wage Related Csts (S3_2_C3_14),AMOUNT REPORTED Home Office Salaries (S3_2_C3_1401),AMOUNT REPORTED Related Salaries (S3_2_C3_1402),AMOUNT REPORTED Physician Part A (S3_2_C3_22),AMOUNT REPORTED Physician Part A Teaching (S3_2_C3_2201),AMOUNT REPORTED Physician Part B (S3_2_C3_23),AMOUNT REPORTED Wage Related Costs RHC/FQHC (S3_2_C3_24),AMOUNT REPORTED Interns & Residents (S3_2_C3_25),AMOUNT REPORTED Interns & Residents (S3_2_C3_2550),AMOUNT REPORTED Interns & Residents (S3_2_C3_2551),AMOUNT REPORTED Interns & Residents (S3_2_C3_2552),AMOUNT REPORTED Interns & Residents (S3_2_C3_2553),ADJUSTED SALARIES Home Office Salaries & Wage Related Csts (S3_2_C4_14),ADJUSTED SALARIES Related Salaries (S3_2_C4_1402),ADJUSTED SALARIES Teaching Physician Salaries (S3_2_C4_16),ADJUSTED SALARIES Wage Related Costs Other (S3_2_C4_18),ADJUSTED SALARIES Non-Physician Anesthetist Part A (S3_2_C4_2),ADJUSTED SALARIES Non-Physician Anesthetist Part A (S3_2_C4_20),ADJUSTED SALARIES Physician Part A Teaching (S3_2_C4_2201),ADJUSTED SALARIES Interns & Residents (S3_2_C4_2551),ADJUSTED SALARIES Interns & Residents (S3_2_C4_2553),ADJUSTED SALARIES Maintenance of Personnel (S3_2_C4_37),ADJUSTED SALARIES Other General Service (S3_2_C4_43),ADJUSTED SALARIES Home Office Personnel (S3_2_C4_8),ADJUSTED SALARIES SNF (S3_2_C4_9),PAID HOURS RELATED TO SALARIES Home Office Salaries & Wage Related Csts (S3_2_C5_14),PAID HOURS RELATED TO SALARIES Teaching Physician Salaries (S3_2_C5_16),PAID HOURS RELATED TO SALARIES Non-Physician Anesthetist Part A (S3_2_C5_2),PAID HOURS RELATED TO SALARIES Maintenance of Personnel (S3_2_C5_37),PAID HOURS RELATED TO SALARIES Other General Service (S3_2_C5_43),PAID HOURS RELATED TO SALARIES Home Office Personnel (S3_2_C5_8),PAID HOURS RELATED TO SALARIES SNF (S3_2_C5_9),AVERAGE HOURLY WAGE Home Office Salaries & Wage Related Csts (S3_2_C6_14),AVERAGE HOURLY WAGE Related Salaries  (S3_2_C6_1402),AVERAGE HOURLY WAGE Teaching Physician Salaries (S3_2_C6_16),AVERAGE HOURLY WAGE Non-Physician Anesthetist Part A (S3_2_C6_2),AVERAGE HOURLY WAGE Maintenance of Personnel (S3_2_C6_37),AVERAGE HOURLY WAGE Other General Service (S3_2_C6_43),AVERAGE HOURLY WAGE Home Office Personnel (S3_2_C6_8),AVERAGE HOURLY WAGE SNF (S3_2_C6_9),HHA I Without Outliers:  Other Charges (S4_HHA1_C1_34),HHA I With Outliers:  Other Charges   (S4_HHA1_C2_34),HHA I LUPA Episodes:  Other Charges (S4_HHA1_C3_34),HHA I PEP Episodes:  Other Charges  (S4_HHA1_C4_34),HHA I PEP Episodes:  Total Number of Episodes   (S4_HHA1_C4_36),HHA I PEP:  Total Non Routine Med Supply Chgs (S4_HHA1_C4_38),HHA I Total Other Charges (S4_HHA1_C5_34),HHA II Without Outliers:  Total Visits (S4_HHA2_C1_33),HHA II Without Outliers:  Other Charges (S4_HHA2_C1_34),HHA II Without Outliers:  Total Charges (S4_HHA2_C1_35),HHA II W/Out Outliers:  Number of Episodes (S4_HHA2_C1_36),HHA II Without Outliers:  Non Routine Med Sup Chgs (S4_HHA2_C1_38),HHA II With Outliers:  Total Visits (S4_HHA2_C2_33),HHA II With Outliers:  Other Charges   (S4_HHA2_C2_34),HHA II With Outliers:  Total Charges (S4_HHA2_C2_35),HHA II With Outliers:  Number of Episodes (S4_HHA2_C2_37),HHA II With Outliers:  Non Routine Med Sup Chgs (S4_HHA2_C2_38),HHA II LUPA Episodes:  Total Visits (S4_HHA2_C3_33),HHA II LUPA Episodes:  Other Charges (S4_HHA2_C3_34),HHA II Total Charges:  LUPA Episodes (S4_HHA2_C3_35),HHA II LUPA Episodes:  Total Number of Episodes (S4_HHA2_C3_36),HHA II LUPA:  Total Non Routine Med Sup Chgs (S4_HHA2_C3_38),HHA II PEP Episodes:  Total Visits (S4_HHA2_C4_33),HHA II PEP Episodes:  Other Charges  (S4_HHA2_C4_34),HHA II PEP Episodes:  Total Charges: (S4_HHA2_C4_35),HHA II PEP Episodes:  Total Number of Episodes   (S4_HHA2_C4_36),HHA II PEP:  Total Number of Outlier Episodes (S4_HHA2_C4_37),HHA II PEP:  Total Non Routine Med Supply Chgs (S4_HHA2_C4_38),HHA II Total Visits (S4_HHA2_C5_33),HHA II Total Other Charges (S4_HHA2_C5_34),HHA II Total Charges  (S4_HHA2_C5_35),HHA II Total Number of Episodes (S4_HHA2_C5_36),HHA II Total Number of Outlier Episodes (S4_HHA2_C5_37),HHA II Total Non Routine Medical  Supply Charges (S4_HHA2_C5_38),HHA III Without Outliers:  Total Visits (S4_HHA3_C1_33),HHA III Without Outliers:  Other Charges (S4_HHA3_C1_34),HHA III Without Outliers:  Total Charges (S4_HHA3_C1_35),HHA III W/Out Outliers:  Number of Episodes (S4_HHA3_C1_36),HHA III Without Outliers:  Non Routine Med Sup Chgs (S4_HHA3_C1_38),HHA III With Outliers:  Total Visits (S4_HHA3_C2_33),HHA III With Outliers:  Other Charges   (S4_HHA3_C2_34),HHA III With Outliers:  Total Charges (S4_HHA3_C2_35),HHA III With Outliers:  Number of Episodes (S4_HHA3_C2_37),HHA III With Outliers:  Non Routine Med Sup Chgs (S4_HHA3_C2_38),HHA III LUPA Episodes:  Total Visits (S4_HHA3_C3_33),HHA III LUPA Episodes:  Other Charges (S4_HHA3_C3_34),HHA III Total Charges:  LUPA Episodes (S4_HHA3_C3_35),HHA III LUPA Episodes:  Total Number of Episodes (S4_HHA3_C3_36),HHA III LUPA:  Total Non Routine Med Sup Chgs (S4_HHA3_C3_38),HHA III PEP Episodes:  Total Visits (S4_HHA3_C4_33),HHA III PEP Episodes:  Other Charges  (S4_HHA3_C4_34),HHA III PEP Episodes:  Total Charges: (S4_HHA3_C4_35),HHA III PEP Episodes:  Total Number of Episodes   (S4_HHA3_C4_36),HHA III PEP:  Total Number of Outlier Episodes (S4_HHA3_C4_37),HHA III PEP:  Total Non Routine Med Supply Chgs (S4_HHA3_C4_38),HHA III Total Visits (S4_HHA3_C5_33),HHA III Total Other Charges (S4_HHA3_C5_34),HHA III Total Charges  (S4_HHA3_C5_35),HHA III Total Number of Episodes (S4_HHA3_C5_36),HHA III Total Number of Outlier Episodes (S4_HHA3_C5_37),HHA III Total Non Routine Medical  Supply Charges (S4_HHA3_C5_38),"Percentage of patients re-using
dialyzers (S5_C1_10)","Epoietin amount form worksheet A
for home dialysis program (S5_C1_14)",Number of EPO units furnished for Line 13 (S5_C1_15),Utilization (S5_C1_8),Average times dialyzers re-used (S5_C1_9),"Percentage of patients re-using
dialyzers (S5_C2_10)",Utilization (S5_C2_8),Average times dialyzers re-used (S5_C2_9),"Number of Times per week 
Patient receives Dialysis (S5_C3_2)","Average patient dialysis time 
including setup (S5_C3_3)",Number of stations (S5_C3_6),"Number of Times per week
 Patient receives Dialysis (S5_C4_2)","Average patient dialysis time 
including setup (S5_C4_3)",CAPD exchanges per day (S5_C4_4),Number of stations (S5_C4_6),"Number of days in year dialysis 
furnished (S5_C5_2)","Number of Times per week
 Patient receives Dialysis (S5_C6_2)",CAPD exchanges per day (S5_C6_4),Column 1 (Beginning Balances) Land  (A7_1_C1_1),Column 1 (Beginning Balances) Total (A7_1_C1_10),Column 1 (Beginning Balances) Buildings and Fixtures (A7_1_C1_3),Column 1 (Beginning Balances) Movable Equipment (A7_1_C1_6),Column 1 (Beginning Balances) Subtotal (A7_1_C1_8),Column 2 (Purchases) Total (A7_1_C2_10),Column 2 (Purchases) Movable Equipment (A7_1_C2_6),Column 2 (Purchases) Subtotal (A7_1_C2_8),Column 11 (Interest) Total (A7_3_C11_3),Column 15 (Total) Total (A7_3_C15_3),Column 9 (Depreciation) Total (A7_3_C9_3),Provider-based physician adjustment (A8_C2_10),Cafeteria employees and guests (A8_C2_14),Sale of medical records and abstracts (A8_C2_18),Investment Income-New Movable Equip (A8_C2_2),Interest expense on Medicare Overpaymts (A8_C2_22),Total (A8_C2_50),Telephone Services (A8_C2_7),Television and Radio Service (A8_C2_8),Total Salaries (A_C1_200),Adults and Pediatrics (A_C1_30),Interest Expense (A_C2_113),Total Salaries (A_C2_200),Adults and Pediatrics (A_C2_30),Total Salaries (A_C6_200),Adults and Pediatrics (A_C6_30),Net Expense for Cost Allocation Total (B_1_C0_200),Net Expense for Cost Allocation Adults and Pediatrics (B_1_C0_30),Total   (B_1_C26_202),Adults and Pediatrics (B_1_C26_30),Total   (B_2_C26_202),TOTAL CAPITAL COSTS AFTER COST ALLOCATION Adults & Pediatrics (B_2_C26_30),Total (C_1_C3_202),Total (C_1_C6_202),Total Inpatient Charges Adults & Pediatrics (C_1_C6_30),Total (C_1_C7_202),Total (C_1_C8_202),Total Swing Bed Cost (D1_HOS_C1_26),General Inpatient Routine Service Cost net of Swing Bed Cost (D1_HOS_C1_27),General Inpatient Routine Service Cost net of Swing Bed and Private Room Diff (D1_HOS_C1_37),Total Program General Inpatient Routine  (D1_HOS_C1_41),Program Inpatient Ancillary Service Cost (D1_HOS_C1_48),Total Program Inpatient Costs (D1_HOS_C1_49),Adults and Pediatrics (D3_HOS_C2_30),TOTAL (D3_HOS_C3_200),COST REIMBURSED SERVICES SUBJECT TO DEDUCTIBLES  AND COINSURANCE - CHARGES Total  (D_5_HOS_C3_200),COST SERVICES SUBJECT TO DEDUCTIBLES AND COINSURANCE - COST Total  (D_5_HOS_C6_200),Medical and Other Services (E_B_HOS_C1_1),Deductibles and coinsurance (E_B_HOS_C1_25),Deductibles and coinsurance related to line 24 (E_B_HOS_C1_26),Subtotal (E_B_HOS_C1_27),Subtotal (E_B_HOS_C1_30),Subtotal (E_B_HOS_C1_32),Subtotal (E_B_HOS_C1_37),Subtotal (E_B_HOS_C1_40),Interim payments (E_B_HOS_C1_41),Balance due provider/program (E_B_HOS_C1_43),  (S10_C1_1),Urban (1) or Rural (2) (S2_1_C1_27),Total Hospital Interns & Residents (S3_1_C10_14),Total Facility FTEs  (S3_1_C10_27),Hospital Adults & Pediatrics (S3_1_C2_1),Total Hospital (S3_1_C2_14),Total Facility (S3_1_C2_27),Total (S3_1_C2_7),Hospital Adults & Pediatrics (S3_1_C3_1),Total Hospital (S3_1_C3_14),Total Hospital (S3_1_C3_7),Hospital Adults & Pediatrics (S3_1_C4_1),Total Hospital (S3_1_C4_14),Total Hospital (S3_1_C4_7),Hospital Adults & Pediatrics (S3_1_C6_1),Total Hospital (S3_1_C6_14),HMO (S3_1_C6_2),Hospital Adults & Ped Swing Bed SNF (S3_1_C6_5),Total Adults & Peds (S3_1_C6_7),Hospital Adults & Pediatrics (S3_1_C8_1),Total Hospital (S3_1_C8_14),Medicaid Observation Days (S3_1_C8_28),Hospital Adlts & Ped Swing Bed SNF (S3_1_C8_5),Hospital Adlts & Ped Swing Bed NF (S3_1_C8_6),Total Adults & Pediatrics (S3_1_C8_7),Column 1 (Beginning Balances) Land Improvements (A7_1_C1_2),Column 1 (Beginning Balances) Building Improvements (A7_1_C1_4),Column 1 (Beginning Balances) Fixed Equipment (A7_1_C1_5),Column 7 (Fully Depreciated Assets) Begin Balance (A7_1_C1_7),Column 2 (Purchases) Land  (A7_1_C2_1),Column 2 (Purchases) Land Improvements (A7_1_C2_2),Column 2 (Purchases) Buildings and Fixtures (A7_1_C2_3),Column 2 (Purchases) Building Improvements (A7_1_C2_4),Column 7 (Fully Depreciated Assets) Purchase (A7_1_C2_7),Column 7 (Fully Depreciated Assets) Total (A7_1_C4_7),Column 5 (Disposals and Retirements) Total (A7_1_C5_10),Column 5 (Disposals and Retirements) Movable Equipment (A7_1_C5_6),Column 5 (Disposals and Retirements) Subtotal (A7_1_C5_8),Column 7 (Fully Depreciated Assets) Ending Balance (A7_1_C6_7),Column 10 (Lease) Total (A7_3_C10_3),Column 5 (Insurance) Total (A7_3_C5_3),Column 6 (Taxes) Total (A7_3_C6_3),Column 7 (Other Capital Related Costs) Total (A7_3_C7_3),Investment Income-New Bldgs & Fixtures (A8_C2_1),Nursery (A_C1_43),Other Capital (A_C2_3),Nursery (A_C2_43),Other Capital (A_C6_3),Nursery (A_C6_43),Net Expense for Cost Allocation Nursery (B_1_C0_43),Nursery (B_1_C26_43),Cross Foot Adjustments (B_2_C26_200),TOTAL CAPITAL COSTS AFTER COST ALLOCATION Nursery (B_2_C26_43),Subtotal (C_1_C5_200),Less Observation Beds (C_1_C5_201),Total (C_1_C5_202),Adults & Pediatrics (C_1_C5_30),Nursery (C_1_C5_43),Total Inpatient Charges Nursery (C_1_C6_43),Pass through Cost for Program Inpatient Routine  (D1_HOS_C1_50),Pass Through Cost for  Program Ancillary (D1_HOS_C1_51),Total Program Excludable Costs (D1_HOS_C1_52),"Total Program Inpatient Operating Cost excluding Capital Related, Nonphysician Anesthetist, and Medical Education Costs (D1_HOS_C1_53)",Total (D_1_HOS_C4_200),Adults & Pediatrics (D_1_HOS_C4_30),Nursery (D_1_HOS_C4_43),Total (D_1_HOS_C6_200),Adults & Pediatrics (D_1_HOS_C6_30),Total (D_1_HOS_C7_200),Adults & Pediatrics (D_1_HOS_C7_30),Total Patient Days (D_3_HOS_C6_200),Total Inpatient Program Days (D_3_HOS_C8_200),Total  (D_4_HOS_C11_200),Total  (D_4_HOS_C12_200),Total  (D_4_HOS_C13_200),Total Allied Health (D_4_HOS_C3_200),Total Outpatient Program Pass Thru Cost (D_4_HOS_C6_200),PPS REIMBURSED SERVICES -  CHARGES Total  (D_5_HOS_C2_200),COST REIMBURSED SERVICES NOT SUBJECT TO DEDUCTIBLES AND COINSURANCE - CHARGES Total  (D_5_HOS_C4_200),PPS SERVICES COST Total  (D_5_HOS_C5_200),COST SERVICES NOT SUBJECT TO DEDUCTIBLES AND COINSURANCE - COST Total  (D_5_HOS_C7_200),Ancillary service charges (E_B_HOS_C1_12),Total reasonable charges (E_B_HOS_C1_14),Total customary charges (E_B_HOS_C1_18),Excess of customary charges (E_B_HOS_C1_19),Medical and Other Services reimbursed by OPPS (E_B_HOS_C1_2),Total prospective payment (E_B_HOS_C1_24),OPPS payments (E_B_HOS_C1_3),Primary payer payments (E_B_HOS_C1_31),Allowable bad debts (E_B_HOS_C1_34),Adjusted reimburseable bad debts (E_B_HOS_C1_35),Allowable bad debts for dual eligibles beneficiaries (E_B_HOS_C1_36),Outlier payments (E_B_HOS_C1_4),Premiums (S2_1_C1_11801),In State Medicaid paid days (S2_1_C1_24),Medicaid HMO Days (S2_1_C5_24),Labor and Delivery (S3_1_C2_32),Labor and Delivery (S3_1_C3_32),Labor and Delivery Days Title 18 (S3_1_C6_32),Hospital Adults & Pediatrics (S3_1_C7_1),Nursery (S3_1_C7_13),Total Hospital (S3_1_C7_14),HMO (S3_1_C7_2),Labor and Delivery Days -  Title XIX (S3_1_C7_32),Total Adults & Peds (S3_1_C7_7),Nursery (S3_1_C8_13),Labor and Delivery Days -  Title XIX (S3_1_C8_32),AMOUNT REPORTED Total Salaries (S3_2_C2_1),AMOUNT REPORTED Excluded Area Salaries (S3_2_C2_10),AMOUNT REPORTED Contract Labor (S3_2_C2_11),AMOUNT REPORTED Contract Labor: Pysician Part A (S3_2_C2_13),AMOUNT REPORTED Wage Related Costs Core (S3_2_C2_17),AMOUNT REPORTED Excluded Areas  (S3_2_C2_19),AMOUNT REPORTED Non-Physician Anesthetist Part B (S3_2_C2_21),AMOUNT REPORTED Physician Part A (S3_2_C2_22),AMOUNT REPORTED Physician Part B (S3_2_C2_23),AMOUNT REPORTED Employee Benefits (S3_2_C2_26),AMOUNT REPORTED Administrative and General (S3_2_C2_27),AMOUNT REPORTED Administrative & General under contract  (S3_2_C2_28),AMOUNT REPORTED Non-Physician Anesthetist Part B (S3_2_C2_3),AMOUNT REPORTED Operation of Plant (S3_2_C2_30),AMOUNT REPORTED Housekeeping (S3_2_C2_32),AMOUNT REPORTED Dietary (S3_2_C2_34),AMOUNT REPORTED Nursing Administration (S3_2_C2_38),AMOUNT REPORTED Central Services and Supply (S3_2_C2_39),AMOUNT REPORTED Physician-Part A (S3_2_C2_4),AMOUNT REPORTED Pharmacy    (S3_2_C2_40),AMOUNT REPORTED Medical Records & Med Records Library (S3_2_C2_41),AMOUNT REPORTED Social Service (S3_2_C2_42),AMOUNT REPORTED Physician-Part B (S3_2_C2_5),ADJUSTED SALARIES Total Salaries (S3_2_C4_1),ADJUSTED SALARIES Excluded Area Salaries (S3_2_C4_10),ADJUSTED SALARIES Contract Labor (S3_2_C4_11),ADJUSTED SALARIES Contract Labor:  Physician Part A (S3_2_C4_13),ADJUSTED SALARIES Wage Related Costs Core (S3_2_C4_17),ADJUSTED SALARIES Excluded Areas  (S3_2_C4_19),ADJUSTED SALARIES Non-Physician Anesthetist Part B (S3_2_C4_21),ADJUSTED SALARIES Physician Part A (S3_2_C4_22),ADJUSTED SALARIES Physician Part B (S3_2_C4_23),ADJUSTED SALARIES Employee Benefits (S3_2_C4_26),ADJUSTED SALARIES Administrative and General (S3_2_C4_27),ADJUSTED SALARIES Administrative & General under contract  (S3_2_C4_28),ADJUSTED SALARIES Non-Physician Anesthetist Part B (S3_2_C4_3),ADJUSTED SALARIES Operation of Plant (S3_2_C4_30),ADJUSTED SALARIES Housekeeping (S3_2_C4_32),ADJUSTED SALARIES Dietary (S3_2_C4_34),ADJUSTED SALARIES Cafeteria (S3_2_C4_36),ADJUSTED SALARIES Nursing Administration (S3_2_C4_38),ADJUSTED SALARIES Central Services and Supply (S3_2_C4_39),ADJUSTED SALARIES Physician-Part A (S3_2_C4_4),ADJUSTED SALARIES Pharmacy    (S3_2_C4_40),ADJUSTED SALARIES Medical Records & Med Records Library (S3_2_C4_41),ADJUSTED SALARIES Social Service (S3_2_C4_42),ADJUSTED SALARIES Physician-Part B (S3_2_C4_5),PAID HOURS RELATED TO SALARIES Total Salaries (S3_2_C5_1),PAID HOURS RELATED TO SALARIES Excluded Area Salaries (S3_2_C5_10),PAID HOURS RELATED TO SALARIES Contract Labor (S3_2_C5_11),PAID HOURS RELATED TO SALARIES Contract Labor:  Physician Part A (S3_2_C5_13),PAID HOURS RELATED TO SALARIES Employee Benefits (S3_2_C5_26),PAID HOURS RELATED TO SALARIES Administrative and General (S3_2_C5_27),PAID HOURS RELATED TO SALARIES Administrative and General under Contract (S3_2_C5_28),PAID HOURS RELATED TO SALARIES Non-Physician Anesthetist Part B (S3_2_C5_3),PAID HOURS RELATED TO SALARIES Operation of Plant (S3_2_C5_30),PAID HOURS RELATED TO SALARIES Housekeeping (S3_2_C5_32),PAID HOURS RELATED TO SALARIES Dietary    (S3_2_C5_34),PAID HOURS RELATED TO SALARIES Cafeteria (S3_2_C5_36),PAID HOURS RELATED TO SALARIES Nursing Administration (S3_2_C5_38),PAID HOURS RELATED TO SALARIES Central Services and Supply (S3_2_C5_39),PAID HOURS RELATED TO SALARIES Physician-Part A (S3_2_C5_4),PAID HOURS RELATED TO SALARIES Pharmacy    (S3_2_C5_40),PAID HOURS RELATED TO SALARIES Medical Records & Med Records Library (S3_2_C5_41),PAID HOURS RELATED TO SALARIES Social Service (S3_2_C5_42),PAID HOURS RELATED TO SALARIES Physician-Part B (S3_2_C5_5),AVERAGE HOURLY WAGE Total Salaries (S3_2_C6_1),AVERAGE HOURLY WAGE Excluded Area Salaries (S3_2_C6_10),AVERAGE HOURLY WAGE Contract Labor (S3_2_C6_11),AVERAGE HOURLY WAGE Contract Labor:  Physician Part A (S3_2_C6_13),AVERAGE HOURLY WAGE Employee Benefits (S3_2_C6_26),AVERAGE HOURLY WAGE Administrative and General (S3_2_C6_27),AVERAGE HOURLY WAGE Administrative and General under Contract (S3_2_C6_28),AVERAGE HOURLY WAGE Non-Physician Anesthetist Part B (S3_2_C6_3),AVERAGE HOURLY WAGE Operation of Plant (S3_2_C6_30),AVERAGE HOURLY WAGE Housekeeping (S3_2_C6_32),AVERAGE HOURLY WAGE Dietary (S3_2_C6_34),AVERAGE HOURLY WAGE Cafeteria (S3_2_C6_36),AVERAGE HOURLY WAGE Nursing Administration (S3_2_C6_38),AVERAGE HOURLY WAGE Central Services and Supply (S3_2_C6_39),AVERAGE HOURLY WAGE Physician-Part A (S3_2_C6_4),AVERAGE HOURLY WAGE Pharmacy    (S3_2_C6_40),AVERAGE HOURLY WAGE Medical Records & Med Records Library (S3_2_C6_41),AVERAGE HOURLY WAGE Social Service (S3_2_C6_42),AVERAGE HOURLY WAGE Physician-Part B (S3_2_C6_5),AMOUNT REPORTED Net Salaries (S3_3_C2_1),AMOUNT REPORTED Excluded Area Salaries (S3_3_C2_2),AMOUNT REPORTED Subtotal Salaries (S3_3_C2_3),AMOUNT REPORTED Subtotal Other Wages and Related Csts (S3_3_C2_4),AMOUNT REPORTED Subtotal Wage Related Csts (S3_3_C2_5),AMOUNT REPORTED Total (S3_3_C2_6),ADJUSTED SALARIES Net Salaries (S3_3_C4_1),ADJUSTED SALARIES Excluded Area Salaries (S3_3_C4_2),ADJUSTED SALARIES Subtotal Salaries (S3_3_C4_3),ADJUSTED SALARIES Subtotal Other Wages and Related Csts (S3_3_C4_4),ADJUSTED SALARIES Subtotal Wage Related Csts (S3_3_C4_5),ADJUSTED SALARIES Total (S3_3_C4_6),ADJUSTED SALARIES Total Overhead Costs (S3_3_C4_7),PAID HOURS RELATED TO SALARIES Net Salaries (S3_3_C5_1),PAID HOURS RELATED TO SALARIES Excluded Area Salaries (S3_3_C5_2),PAID HOURS RELATED TO SALARIES Subtotal Salaries (S3_3_C5_3),PAID HOURS RELATED TO SALARIES Subtotal Other Wages and Related Csts (S3_3_C5_4),PAID HOURS RELATED TO SALARIES Total (S3_3_C5_6),PAID HOURS RELATED TO SALARIES Total Overhead Costs (S3_3_C5_7),AVERAGE HOURLY WAGE Net Salaries (S3_3_C6_1),AVERAGE HOURLY WAGE Excluded Area Salaries (S3_3_C6_2),AVERAGE HOURLY WAGE Subtotal Salaries (S3_3_C6_3),AVERAGE HOURLY WAGE Subtotal Other Wages and Related Csts (S3_3_C6_4),AVERAGE HOURLY WAGE Subtotal Wage Related Csts (S3_3_C6_5),AVERAGE HOURLY WAGE Total (S3_3_C6_6),AVERAGE HOURLY WAGE Total Overhead Costs (S3_3_C6_7),Related Organization Transactions (A8_C2_12),SNF (A_C1_44),Ambulance Services (A_C1_95),Subprovider-IPF (A_C2_40),SNF (A_C2_44),Ambulance Services (A_C2_95),Net Expense for Cost Allocation Subprovider-IPF (B_1_C0_40),Net Expense for Cost Allocation SNF (B_1_C0_44),Net Expense for Cost Allocation Ambulance Services (B_1_C0_95),Subprovider-IPF (B_1_C26_40),SNF (B_1_C26_44),Ambulance Services (B_1_C26_95),TOTAL CAPITAL COSTS AFTER COST ALLOCATION SNF (B_2_C26_44),Ambulance Services (B_2_C26_95),Subprovider-IPF (C_1_C5_40),SNF (C_1_C5_44),Ambulance Services (C_1_C5_95),Total Inpatient Charges Subprovider-IPF (C_1_C6_40),Total Inpatient Charges SNF (C_1_C6_44),Ambulance Services (C_1_C7_95),General Inpatient Routine Service Cost net of Swing Bed Cost (D1_IPF_C1_27),General Inpatient Routine Service Cost net of Swing Bed and Private Room Diff (D1_IPF_C1_37),Program Inpatient Ancillary Service Cost (D1_IPF_C1_48),Total Program Inpatient Costs (D1_IPF_C1_49),"Total Program Inpatient Operating Cost excluding Capital Related, Nonphysician Anesthetist, and Medical Education Costs (D1_IPF_C1_53)",General Inpatient Routine Service Cost net of Swing Bed and Private Room Diff (D1_SNF_C1_37),Total Program General Inp. Rtn Service  (D1_SNF_C1_74),Program Ancillary Services  (D1_SNF_C1_84),TOTAL (D3_IPF_C2_200),TOTAL (D3_IPF_C3_200),TOTAL (D3_SNF_C2_202),TOTAL (D3_SNF_C3_200),SNF (S3_1_C10_19),SNF (S3_1_C2_19),SNF (S3_1_C3_19),SNF (S3_1_C6_19),SNF (S3_1_C7_19),SNF (S3_1_C8_19),SNF (A_C6_44),Column 5 (Disposals and Retirements) Buildings and Fixtures (A7_1_C5_3),Column 5 (Disposals and Retirements) Fixed Equipment (A7_1_C5_5),"Trade, Quantity, and Time Discounts (A8_C2_4)",Interest Expense (A_C6_113),Negative Cost Centers (B_2_C26_201),Renal Dialysis (A_C1_74),Renal Dialysis (A_C2_74),Net Expense for Cost Allocation Renal Dialysis (B_1_C0_74),Renal Dialysis (B_1_C26_74),Renal Dialysis (B_2_C26_74),Renal Dialysis (C_1_C5_74),Renal Dialysis (C_1_C6_74),Renal Dialysis (C_1_C7_74),Renal Dialysis (D3_HOS_C2_74),Renal Dialysis (D3_HOS_C3_74),Renal Dialysis (D_4_HOS_C12_74),PPS REIMBURSED SERVICES -  CHARGES Renal Dialysis (D_5_HOS_C2_74),COST REIMBURSED SERVICES SUBJECT TO DEDUCTIBLES  AND COINSURANCE - CHARGES Renal Dialysis (D_5_HOS_C3_74),COST REIMBURSED SERVICES NOT SUBJECT TO DEDUCTIBLES AND COINSURANCE - CHARGES Renal Dialysis (D_5_HOS_C4_74),PPS SERVICES COST Renal Dialysis (D_5_HOS_C5_74),COST SERVICES SUBJECT TO DEDUCTIBLES AND COINSURANCE - COST Renal Dialysis (D_5_HOS_C6_74),COST SERVICES NOT SUBJECT TO DEDUCTIBLES AND COINSURANCE - COST Renal Dialysis (D_5_HOS_C7_74),Line 2 times line 5 (E_B_HOS_C1_6),"Sum of lines 3,4 divided by line 6 (E_B_HOS_C1_7)","If (SCH), enter the # of periods. (S2_1_C1_35)",Other Medicaid Days (S2_1_C6_24),Ambulance Trips (S3_1_C6_29),AMOUNT REPORTED Management and Administrative Services (S3_2_C2_12),AMOUNT REPORTED Home Office Salaries (S3_2_C2_1401),AMOUNT REPORTED Interns & Residents (S3_2_C2_2550),AMOUNT REPORTED Laundry and Linen Service (S3_2_C2_31),AMOUNT REPORTED Housekeeping under contract   (S3_2_C2_33),ADJUSTED SALARIES Management and Administrative Services (S3_2_C4_12),ADJUSTED SALARIES Home Office Salaries (S3_2_C4_1401),ADJUSTED SALARIES Interns & Residents (S3_2_C4_2550),ADJUSTED SALARIES Laundry and Linen Service (S3_2_C4_31),ADJUSTED SALARIES Housekeeping under contract   (S3_2_C4_33),PAID HOURS RELATED TO SALARIES Management and Administrative Services (S3_2_C5_12),PAID HOURS RELATED TO SALARIES Laundry and Linen Service (S3_2_C5_31),PAID HOURS RELATED TO SALARIES Housekeeping under Contract (S3_2_C5_33),AVERAGE HOURLY WAGE Management and Administrative Services (S3_2_C6_12),AVERAGE HOURLY WAGE Home Office Salaries (S3_2_C6_1401),AVERAGE HOURLY WAGE Laundry and Linen Service (S3_2_C6_31),AVERAGE HOURLY WAGE Housekeeping under Contract (S3_2_C6_33),HHA I Without Outliers:  Total Visits (S4_HHA1_C1_33),HHA I Without Outliers:  Total Charges (S4_HHA1_C1_35),HHA I W/Out Outliers:  Number of Episodes (S4_HHA1_C1_36),HHA I Without Outliers:  Non Routine Med Sup Chgs (S4_HHA1_C1_38),HHA I With Outliers:  Total Visits (S4_HHA1_C2_33),HHA I With Outliers:  Total Charges (S4_HHA1_C2_35),HHA I With Outliers:  Number of Episodes (S4_HHA1_C2_37),HHA I With Outliers:  Non Routine Med Sup Chgs (S4_HHA1_C2_38),HHA I LUPA Episodes:  Total Visits (S4_HHA1_C3_33),HHA I Total Charges:  LUPA Episodes (S4_HHA1_C3_35),HHA I LUPA Episodes:  Total Number of Episodes (S4_HHA1_C3_36),HHA I LUPA:  Total Non Routine Med Sup Chgs (S4_HHA1_C3_38),HHA I PEP Episodes:  Total Visits (S4_HHA1_C4_33),HHA I PEP Episodes:  Total Charges: (S4_HHA1_C4_35),HHA I PEP:  Total Number of Outlier Episodes (S4_HHA1_C4_37),HHA I Total Visits (S4_HHA1_C5_33),HHA I Total Charges  (S4_HHA1_C5_35),HHA I Total Number of Episodes (S4_HHA1_C5_36),HHA I Total Number of Outlier Episodes (S4_HHA1_C5_37),HHA I Total Non Routine Medical  Supply Charges (S4_HHA1_C5_38),"Number of patients on transplant 
list (S5_C1_11)","Number of patients transplanted 
during fiscal year (S5_C1_12)",Number of Times per week Patient receives Dialysis (S5_C1_2),"Average patient dialysis time 
including setup (S5_C1_3)","Number of days in year dialysis 
furnished (S5_C1_5)",Number of stations (S5_C1_6),"Treatment capacity per day per
station (S5_C1_7)","Number of Times per week
 Patient receives Dialysis (S5_C2_2)","Average patient dialysis time 
including setup (S5_C2_3)","Number of days in year dialysis 
furnished (S5_C2_5)",Number of stations (S5_C2_6),"Treatment capacity per day per
station (S5_C2_7)",Column 5 (Disposals and Retirements) Land  (A7_1_C5_1),Laundry and Linen Service (A8_C2_13),Rental of Provider space by suppliers (A8_C2_6),Subprovider-IRF (A_C1_41),Subprovider-IRF (A_C2_41),Subprovider-IRF (A_C6_41),Net Expense for Cost Allocation Subprovider-IRF (B_1_C0_41),Allocation of Interns & Residents Salary and Fringes Adults and Pediatrics (B_1_C21_30),Allocation of Interns & Residents Salary and Fringes Nursery (B_1_C21_43),Subprovider-IRF (B_1_C26_41),TOTAL CAPITAL COSTS AFTER COST ALLOCATION Subprovider-IRF (B_2_C26_41),Subprovider-IRF (C_1_C5_41),Total Inpatient Charges Subprovider-IRF (C_1_C6_41),General Inpatient Routine Service Cost net of Swing Bed Cost (D1_IRF_C1_27),General Inpatient Routine Service Cost net of Swing Bed and Private Room Diff (D1_IRF_C1_37),Total Program General Inpatient Routine  (D1_IRF_C1_41),Program Inpatient Ancillary Service Cost (D1_IRF_C1_48),Total Program Inpatient Costs (D1_IRF_C1_49),Pass through Cost for Program Inpatient  (D1_IRF_C1_50),Pass Through Cost for  Program Ancillary (D1_IRF_C1_51),Total Program Excludable Costs (D1_IRF_C1_52),"Total Program Inpatient Operating Cost excluding Capital Related, Nonphysician Anesthetist, and Medical Education Costs (D1_IRF_C1_53)",TOTAL (D3_IRF_C2_200),Subprovider-IRF (D3_IRF_C2_41),TOTAL (D3_IRF_C3_200),Subprovider-IRF (D_1_HOS_C4_41),Subprovider-IRF (D_1_HOS_C6_41),Subprovider-IRF (D_1_HOS_C7_41),Total Costs (D_3_HOS_C5_200),Total (D_3_HOS_C9_200),Adults & Pediatrics (D_3_HOS_C9_30),Total Nursing School (D_4_HOS_C2_200),Total  (D_4_IRF_C11_200),Total Nursing School (D_4_IRF_C2_200),Total Allied Health (D_4_IRF_C3_200),Total Outpatient Program Pass Thru Cost (D_4_IRF_C6_200),interns and residents (E_B_HOS_C1_28),In State Medicaid eligible days (S2_1_C2_24),Out of State Medicaid paid days (S2_1_C3_24),IRF (S3_1_C2_17),IRF (S3_1_C3_17),IRF (S3_1_C6_17),IRF (S3_1_C7_17),IRF (S3_1_C8_17),Total Hospital Interns & Residents (S3_1_C9_14),Total Facility FTEs  (S3_1_C9_27),AMOUNT REPORTED Maintenance and Repairs (S3_2_C2_29),ADJUSTED SALARIES Admin & Gen Under Contract (S3_2_C4_29),PAID HOURS RELATED TO SALARIES Admin & Gen Under Contract (S3_2_C5_29),AVERAGE HOURLY WAGE Admin & Gen Under Contract (S3_2_C6_29),Column 2 (Purchases) Fixed Equipment (A7_1_C2_5),TOTAL CAPITAL COSTS AFTER COST ALLOCATION Total Directly Assigned New Cap Rel Csts  (B_2_C0_202),AMOUNT REPORTED Home Office:  Physician Part A (S3_2_C2_15),AMOUNT REPORTED Interns & Residents (S3_2_C2_2552),ADJUSTED SALARIES Home Office:  Physician Part A (S3_2_C4_15),ADJUSTED SALARIES Interns & Residents (S3_2_C4_2552),PAID HOURS RELATED TO SALARIES Home Office:  Physician Part A (S3_2_C5_15),AVERAGE HOURLY WAGE Home Office:  Physician Part A (S3_2_C6_15),Sale of drugs to other than patients (A8_C2_17),Negative Cost Centers (B_1_C26_201),"Income from imposition of interest, finance (A8_C2_21)",Non-physician Anesthetist (A8_C2_28),Subprovider-IPF (A_C1_40),Allocation of Interns & Residents Salary and Fringes Subprovider-IRF (B_1_C21_41),Allocation of Interns & Residents Program Costs Adults and Pediatrics (B_1_C22_30),Allocation of Interns & Residents Program Costs Subprovider-IRF (B_1_C22_41),TOTAL CAPITAL COSTS AFTER COST ALLOCATION Subprovider-IPF (B_2_C26_40),Ambulance Services (C_1_C6_95),Total Program General Inpatient Routine  (D1_IPF_C1_41),Pass through Cost for Program Inpatient  (D1_IPF_C1_50),Pass Through Cost for  Program Ancillary (D1_IPF_C1_51),Total Program Excludable Costs (D1_IPF_C1_52),Subprovider-IPF (D3_IPF_C2_40),Renal Dialysis (D3_IRF_C2_74),Renal Dialysis (D3_IRF_C3_74),Subprovider-IPF (D_1_HOS_C4_40),Subprovider-IPF (D_1_HOS_C6_40),Subprovider-IPF (D_1_HOS_C7_40),Total Allied Health Cost (D_3_HOS_C2_200),Subprovider-IPF (D_3_HOS_C9_40),Total  (D_4_IPF_C11_200),Total Allied Health (D_4_IPF_C3_200),Total Outpatient Program Pass Thru Cost (D_4_IPF_C6_200),MSP-LCC reconciliation amount (E_B_HOS_C1_38),Protested amounts (E_B_HOS_C1_44),Paid Losses (S2_1_C2_11801),Self Insurance (S2_1_C3_11801),IPF (S3_1_C2_16),IPF (S3_1_C3_16),IPF (S3_1_C6_16),IPF (S3_1_C8_16),AMOUNT REPORTED Interns & Residents (S3_2_C2_25),AMOUNT REPORTED Dietary under contract  (S3_2_C2_35),AMOUNT REPORTED Interns & Residents (S3_2_C2_7),ADJUSTED SALARIES Interns & Residents (S3_2_C4_25),ADJUSTED SALARIES Dietary under contract  (S3_2_C4_35),ADJUSTED SALARIES Interns & Residents (S3_2_C4_7),PAID HOURS RELATED TO SALARIES Dietary under Contract (S3_2_C5_35),PAID HOURS RELATED TO SALARIES Interns & Residents (S3_2_C5_7),AVERAGE HOURLY WAGE Dietary under Contract (S3_2_C6_35),AVERAGE HOURLY WAGE Interns & Residents (S3_2_C6_7),Out of State Medicaid eligible days (S2_1_C4_24),AMOUNT REPORTED Wage Related Costs RHC/FQHC (S3_2_C2_24),AMOUNT REPORTED Non-Physician Part B (S3_2_C2_6),ADJUSTED SALARIES Wage Related Costs RHC/FQHC (S3_2_C4_24),ADJUSTED SALARIES Non-Physician Part B (S3_2_C4_6),PAID HOURS RELATED TO SALARIES Non-Physician Part B (S3_2_C5_6),AVERAGE HOURLY WAGE Non-Physician Part B (S3_2_C6_6),Hospital Adlts & Ped Swing Bed NF (S3_1_C7_6),Subprovider-IPF (A_C6_40),IPF (S3_1_C7_16),NF Provider Number (S2_1_C2_10),ICF Provider Number (S2_1_C2_1001),HHA 2 Provider Number (S2_1_C2_1201),HHA 3 Provider Number (S2_1_C2_1202),ASC 1 Provider Number (S2_1_C2_13),Hospice 2 Provider Number (S2_1_C2_1401),RHC 3 Provider Number (S2_1_C2_1502),RHC 4 Provider Number (S2_1_C2_1503),RHC 5 Provider Number (S2_1_C2_1504),RHC 6 Provider Number (S2_1_C2_1505),RHC 7 Provider Number (S2_1_C2_1506),RHC 8 Provider Number (S2_1_C2_1507),RHC 9 Provider Number (S2_1_C2_1508),RHC 10 Provider Number (S2_1_C2_1509),RHC 11 Provider Number (S2_1_C2_1510),RHC 12 Provider Number (S2_1_C2_1511),RHC 13 Provider Number (S2_1_C2_1512),RHC 14 Provider Number (S2_1_C2_1513),RHC 15 Provider Number (S2_1_C2_1514),RHC 16 Provider Number (S2_1_C2_1515),RHC 17 Provider Number (S2_1_C2_1516),RHC 18 Provider Number (S2_1_C2_1517),RHC 19 Provider Number (S2_1_C2_1518),RHC 20 Provider Number (S2_1_C2_1519),RHC 21 Provider Number (S2_1_C2_1520),RHC 22 Provider Number (S2_1_C2_1521),RHC 23 Provider Number (S2_1_C2_1522),RHC 24 Provider Number (S2_1_C2_1523),RHC 25 Provider Number (S2_1_C2_1524),FQHC 1 Provider Number (S2_1_C2_16),FQHC 2 Provider Number (S2_1_C2_1601),FQHC 3 Provider Number (S2_1_C2_1602),FQHC 4 Provider Number (S2_1_C2_1603),FQHC 5 Provider Number (S2_1_C2_1604),FQHC 6 Provider Number (S2_1_C2_1605),FQHC 7 Provider Number (S2_1_C2_1606),FQHC 8 Provider Number (S2_1_C2_1607),FQHC 9 Provider Number (S2_1_C2_1608),CMHC 1 Provider Number (S2_1_C2_17),Renal 2 Provider Number (S2_1_C2_1801),Renal 3 Provider Number (S2_1_C2_1802),Renal 4 Provider Number (S2_1_C2_1803),Renal 5 Provider Number (S2_1_C2_1804),Renal 6 Provider Number (S2_1_C2_1805),Renal 7 Provider Number (S2_1_C2_1806),Renal 8 Provider Number (S2_1_C2_1807),Renal 9 Provider Number (S2_1_C2_1808),Renal 10 Provider Number (S2_1_C2_1809),Beginning Date of SCH status  (S2_1_C1_3601),Ending Date of SCH status   (S2_1_C2_3601),MDH status beginning date (MM/DD/YY) (S2_1_C1_38),MDH status ending date (MM/DD/YY) (S2_1_C2_38),MDH status beginning date  (MM/DD/YY) (S2_1_C1_3801),MDH status ending date (MM/DD/YY) (S2_1_C2_3801),"Medicare certified kidney 
transplant center cert date  (S2_1_C1_126)",Medicare Certified Kidney TC term date (S2_1_C2_126),"Medicare certified heart
transplant center cert date   (S2_1_C1_127)",Medicare Certified Heart TC term date (S2_1_C2_127),"Medical certified liver 
transplant center cert date   (S2_1_C1_128)",Medicare Certified Liver TC term date (S2_1_C2_128),"Medical certified lung
transplant center cert date   (S2_1_C1_129)",Medicare Certified Lung TC term date (S2_1_C2_129),Medicare Certified Pancreas TC term date (S2_1_C2_130),certification date (S2_1_C1_131),certification date (S2_1_C1_132),Medicare Certified Islet TC term date (S2_1_C2_132),"If an Organ Procurement Organization, enter the OPO number (S2_1_C1_134)",Hospital Street Address (S2_1_C1_1),Hospital City (S2_1_C1_2),Hospital State (S2_1_C2_2),Hospital Zip Code (S2_1_C3_2),Hospital County (S2_1_C4_2),Hospital Name  (S2_1_C1_3),Provider's actual MSA or CBSA (S2_1_C3_3),Hospital Title 18 Payment System (P/T/O) (S2_1_C7_3),Swing Bed SNF Provider Number (S2_1_C2_7),Type of Control of Hospital (See Table I) (S2_1_C1_21),FI/Contractor's Name (S2_1_C2_140),Home Office Name (S2_1_C1_141),Home Office Street (S2_1_C1_142),City  (S2_1_C1_143),State (S2_1_C2_143),Zip Code (S2_1_C3_143),IPF Provider Number (S2_1_C1_4),IPF Provider Number (S2_1_C2_4),SNF Provider Number (S2_1_C2_9),RHC 1 Provider Number (S2_1_C2_15),RHC 2 Provider Number (S2_1_C2_1501),Hospital PO Box (S2_1_C2_1),Home Office PO Box (S2_1_C2_142),HHA 1 Provider Number (S2_1_C2_12),Hospice 1 Provider Number (S2_1_C2_14),Renal 1 Provider Number (S2_1_C2_18),Beginning Date of SCH status   (S2_1_C1_36),Ending Date of SCH status   (S2_1_C2_36),IRF Provider Number (S2_1_C1_5),IRF Provider Number (S2_1_C2_5),Swing Bed NF Provider Number (S2_1_C2_8),"If Line 32, Col 1 is yes, enter the method used: (A, B, or E only) (S2_1_C2_115)",Cafeteria (A_C1_11),Other Organ Acquisition (A_C1_112),ASC (Distinct Part) (A_C1_115),Other Special Purpose (A_C1_117),Maintenance of Personnel (A_C1_12),Other General Service (A_C1_18),Nonphysician Anesthetists (A_C1_19),Interns & Res Other Program Costs (A_C1_22),Burn Intensive Care Unit (A_C1_33),Whole Blood & Packed Red Blood Cells (A_C1_62),Blood Clotting Factors for Hemoph. (A_C1_6250),Impl. Dev. Charged to Patients  (A_C1_72),FQHC (A_C1_89),Durable Medical Equipment Rented (A_C1_96),Durable Medical Equipment Sold (A_C1_97),Other Reimbursable (A_C1_98),CMHC (A_C1_99),CORF (A_C1_9910),OPT (A_C1_9920),OOT (A_C1_9930),OSP (A_C1_9940),Cafeteria (A_C2_11),Other Organ Acquisition (A_C2_112),ASC (Distinct Part) (A_C2_115),Other Special Purpose (A_C2_117),Maintenance of Personnel (A_C2_12),Nonphysician Anesthetists (A_C2_19),Interns & Res Other Program Costs (A_C2_22),Burn Intensive Care Unit (A_C2_33),Whole Blood & Packed Red Blood Cells (A_C2_62),Blood Clotting Factors for Hemoph. (A_C2_6250),Intravenous Therapy (A_C2_64),FQHC (A_C2_89),Durable Medical Equipment Rented (A_C2_96),Durable Medical Equipment Sold (A_C2_97),Other Reimbursable (A_C2_98),CMHC (A_C2_99),CORF (A_C2_9910),OPT (A_C2_9920),OOT (A_C2_9930),OSP (A_C2_9940),HHA (A_C6_101),Other Organ Acquisition (A_C6_112),ASC (Distinct Part) (A_C6_115),Hospice (A_C6_116),Other Special Purpose (A_C6_117),Maintenance of Personnel (A_C6_12),Other General Service (A_C6_18),Research (A_C6_191),Physicians' Private Office (A_C6_192),Nonpaid Workers (A_C6_193),Burn Intensive Care Unit (A_C6_33),Whole Blood & Packed Red Blood Cells (A_C6_62),"Blood Storing, Processing, Trans (A_C6_63)",Intravenous Therapy (A_C6_64),Occupational Therapy (A_C6_67),Speech Pathology (A_C6_68),Electroencephalography (A_C6_70),Impl. Dev. Charged to Patients  (A_C6_72),ASC (Non Distinct Part) (A_C6_75),RHC (A_C6_88),FQHC (A_C6_89),Other Outpatient Services (A_C6_93),Durable Medical Equipment Rented (A_C6_96),Durable Medical Equipment Sold (A_C6_97),Other Reimbursable (A_C6_98),CMHC (A_C6_99),CORF (A_C6_9910),OPT (A_C6_9920),OOT (A_C6_9930),OSP (A_C6_9940),Net Expense for Cost Allocation Other Organ Acquisition (B_1_C0_112),Net Expense for Cost Allocation ASC (Distinct Part) (B_1_C0_115),Net Expense for Cost Allocation Other Special Purpose (B_1_C0_117),Net Expense for Cost Allocation Maintenance of Personnel (B_1_C0_12),Net Expense for Cost Allocation Nonphysician Anesthetists (B_1_C0_19),Net Expense for Cost Allocation Burn Intensive Care Unit (B_1_C0_33),Net Expense for Cost Allocation Whole Blood & Packed Red Blood Cells (B_1_C0_62),Net Expense for Cost Allocation Blood Clotting Factors for Hemoph. (B_1_C0_6250),Net Expense for Cost Allocation FQHC (B_1_C0_89),Net Expense for Cost Allocation Durable Medical Equipment Rented (B_1_C0_96),Net Expense for Cost Allocation Durable Medical Equipment Sold (B_1_C0_97),Net Expense for Cost Allocation Other Reimbursable (B_1_C0_98),Net Expense for Cost Allocation CMHC (B_1_C0_99),Net Expense for Cost Allocation CORF (B_1_C0_9910),Net Expense for Cost Allocation OPT (B_1_C0_9920),Net Expense for Cost Allocation OOT (B_1_C0_9930),Net Expense for Cost Allocation OSP (B_1_C0_9940),HHA (B_1_C21_101),Other Organ Acquisition (B_1_C21_112),ASC (Distinct Part) (B_1_C21_115),Hospice (B_1_C21_116),Research (B_1_C21_191),Physicians' Private Office (B_1_C21_192),Nonpaid Workers (B_1_C21_193),Other Nonreimbursable (B_1_C21_194),Allocation of Interns & Residents Salary and Fringes Burn Intensive Care Unit (B_1_C21_33),Allocation of Interns & Residents Salary and Fringes Recovery Room (B_1_C21_51),Allocation of Interns & Residents Salary and Fringes Anesthesiology (B_1_C21_53),Allocation of Interns & Residents Salary and Fringes Radiology-Diagnostic (B_1_C21_54),Allocation of Interns & Residents Salary and Fringes Radiology-Therapeutic (B_1_C21_55),Allocation of Interns & Residents Salary and Fringes Radioisotope (B_1_C21_56),Allocation of Interns & Residents Salary and Fringes CT Scan (B_1_C21_57),Allocation of Interns & Residents Salary and Fringes MRI (B_1_C21_58),Allocation of Interns & Residents Salary and Fringes Cardiac Catheterization (B_1_C21_59),Allocation of Interns & Residents Salary and Fringes Laboratory (B_1_C21_60),Allocation of Interns & Residents Salary and Fringes Whole Blood & Packed Red Blood Cells (B_1_C21_62),"Allocation of Interns & Residents Salary and Fringes Blood Storing, Processing, Trans (B_1_C21_63)",Allocation of Interns & Residents Salary and Fringes Intravenous Therapy (B_1_C21_64),Allocation of Interns & Residents Salary and Fringes Respiratory Therapy (B_1_C21_65),Allocation of Interns & Residents Salary and Fringes Physical Therapy (B_1_C21_66),Allocation of Interns & Residents Salary and Fringes Occupational Therapy (B_1_C21_67),Allocation of Interns & Residents Salary and Fringes Speech Pathology (B_1_C21_68),Allocation of Interns & Residents Salary and Fringes Electrocardiology (B_1_C21_69),Allocation of Interns & Residents Salary and Fringes Electroencephalography (B_1_C21_70),Allocation of Interns & Residents Salary and Fringes Medical Supplies Charged to Patients (B_1_C21_71),Allocation of Interns & Residents Salary and Fringes Impl. Dev. Charged to Patients  (B_1_C21_72),Drugs Charged to Patients (B_1_C21_73),ASC (Non Distinct Part) (B_1_C21_75),Other Ancillary (B_1_C21_76),RHC (B_1_C21_88),FQHC (B_1_C21_89),Observation Beds (Distinct Unit) (B_1_C21_9201),Other Reimbursable (B_1_C21_98),CMHC (B_1_C21_99),HHA (B_1_C22_101),Other Organ Acquisition (B_1_C22_112),ASC (Distinct Part) (B_1_C22_115),Hospice (B_1_C22_116),Research (B_1_C22_191),Physicians' Private Office (B_1_C22_192),Nonpaid Workers (B_1_C22_193),Other Nonreimbursable (B_1_C22_194),Allocation of Interns & Residents Program Costs Coronary Care Unit (B_1_C22_32),Allocation of Interns & Residents Program Costs Burn Intensive Care Unit (B_1_C22_33),Allocation of Interns & Residents Program Costs Surgical Intensive Care Unit (B_1_C22_34),Allocation of Interns & Residents Program Costs Other Special Care Unit (B_1_C22_35),Allocation of Interns & Residents Program Costs Recovery Room (B_1_C22_51),Allocation of Interns & Residents Program Costs Anesthesiology (B_1_C22_53),Allocation of Interns & Residents Program Costs Radiology-Diagnostic (B_1_C22_54),Allocation of Interns & Residents Program Costs Radiology-Therapeutic (B_1_C22_55),Allocation of Interns & Residents Program Costs Radioisotope (B_1_C22_56),Allocation of Interns & Residents Program Costs CT Scan (B_1_C22_57),Allocation of Interns & Residents Program Costs MRI (B_1_C22_58),Allocation of Interns & Residents Program Costs Cardiac Catheterization (B_1_C22_59),Allocation of Interns & Residents Program Costs Laboratory (B_1_C22_60),Allocation of Interns & Residents Program Costs Whole Blood & Packed Red Blood Cells (B_1_C22_62),"Allocation of Interns & Residents Program Costs Blood Storing, Processing, Trans (B_1_C22_63)",Allocation of Interns & Residents Program Costs Intravenous Therapy (B_1_C22_64),Allocation of Interns & Residents Program Costs Respiratory Therapy (B_1_C22_65),Allocation of Interns & Residents Program Costs Physical Therapy (B_1_C22_66),Allocation of Interns & Residents Program Costs Occupational Therapy (B_1_C22_67),Allocation of Interns & Residents Program Costs Speech Pathology (B_1_C22_68),Allocation of Interns & Residents Program Costs Electrocardiology (B_1_C22_69),Allocation of Interns & Residents Program Costs Electroencephalography (B_1_C22_70),Allocation of Interns & Residents Program Costs Medical Supplies Charged to Patients (B_1_C22_71),Allocation of Interns & Residents Program Costs Impl. Dev. Charged to Patients  (B_1_C22_72),Drugs Charged to Patients (B_1_C22_73),ASC (Non Distinct Part) (B_1_C22_75),Other Ancillary (B_1_C22_76),RHC (B_1_C22_88),FQHC (B_1_C22_89),Observation Beds (Distinct Unit) (B_1_C22_9201),Other Reimbursable (B_1_C22_98),CMHC (B_1_C22_99),Other Organ Acquisition (B_1_C26_112),ASC (Distinct Part) (B_1_C26_115),Other Special Purpose (B_1_C26_117),Burn Intensive Care Unit (B_1_C26_33),Whole Blood & Packed Red Blood Cells (B_1_C26_62),Blood Clotting Factors for Hemoph. (B_1_C26_6250),FQHC (B_1_C26_89),Durable Medical Equipment Rented (B_1_C26_96),Durable Medical Equipment Sold (B_1_C26_97),Other Reimbursable (B_1_C26_98),CMHC (B_1_C26_99),CORF (B_1_C26_9910),OPT (B_1_C26_9920),OOT (B_1_C26_9930),OSP (B_1_C26_9940),Other Organ Acquisition (B_2_C26_112),ASC (Distinct Part) (B_2_C26_115),Other Special Purpose (B_2_C26_117),TOTAL CAPITAL COSTS AFTER COST ALLOCATION Burn Intensive Care Unit (B_2_C26_33),TOTAL CAPITAL COSTS AFTER COST ALLOCATION Whole Blood & Packed Red Blood Cells (B_2_C26_62),TOTAL CAPITAL COSTS AFTER COST ALLOCATION Blood Clotting Factors for Hemoph. (B_2_C26_6250),FQHC (B_2_C26_89),Durable Medical Equipment Rented (B_2_C26_96),Durable Medical Equipment Sold (B_2_C26_97),Other Reimbursable (B_2_C26_98),CMHC (B_2_C26_99),CORF (B_2_C26_9910),OPT (B_2_C26_9920),OOT (B_2_C26_9930),OSP (B_2_C26_9940),Respiratory Therapy (C_1_C2_65),Physical Therapy (C_1_C2_66),Occupational Therapy (C_1_C2_67),Speech Pathology (C_1_C2_68),Other Organ Acquisition (C_1_C5_112),ASC (Distinct Part) (C_1_C5_115),Other Special Purpose (C_1_C5_117),Burn Intensive Care Unit (C_1_C5_33),Whole Blood & Packed Red Blood Cells (C_1_C5_62),Blood Clotting Factors for Hemoph. (C_1_C5_6250),FQHC (C_1_C5_89),Durable Medical Equipment Rented (C_1_C5_96),Durable Medical Equipment Sold (C_1_C5_97),Other Reimbursable (C_1_C5_98),CMHC (C_1_C5_99),CORF (C_1_C5_9910),OPT (C_1_C5_9920),OOT (C_1_C5_9930),OSP (C_1_C5_9940),HHA (C_1_C6_101),Other Organ Acquisition (C_1_C6_112),ASC (Distinct Part) (C_1_C6_115),Hospice (C_1_C6_116),Other Special Purpose (C_1_C6_117),Total Inpatient Charges Burn Intensive Care Unit (C_1_C6_33),Total Inpatient Charges Whole Blood & Packed Red Blood Cells (C_1_C6_62),Total Inpatient Charges Blood Clotting Factors for Hemoph. (C_1_C6_6250),RHC (C_1_C6_88),FQHC (C_1_C6_89),Durable Medical Equipment Rented (C_1_C6_96),Durable Medical Equipment Sold (C_1_C6_97),Other Reimbursable (C_1_C6_98),CMHC (C_1_C6_99),CORF (C_1_C6_9910),OPT (C_1_C6_9920),OOT (C_1_C6_9930),OSP (C_1_C6_9940),Other Organ Acquisition (C_1_C7_112),ASC (Distinct Part) (C_1_C7_115),Other Special Purpose (C_1_C7_117),Total Outpatient Charges Whole Blood & Packed Red Blood Cells (C_1_C7_62),Total Outpatient Charges Blood Clotting Factors for Hemoph. (C_1_C7_6250),FQHC (C_1_C7_89),Durable Medical Equipment Rented (C_1_C7_96),Durable Medical Equipment Sold (C_1_C7_97),Other Reimbursable (C_1_C7_98),CMHC (C_1_C7_99),CORF (C_1_C7_9910),OPT (C_1_C7_9920),OOT (C_1_C7_9930),OSP (C_1_C7_9940),Coronary Care Unit Program Cost (D1_HOS_C5_44),Burn Intensive Care Unit Program Cost (D1_HOS_C5_45),Surgical Intensive Care Unit Program Cost (D1_HOS_C5_46),Burn Intensive Care Unit (D3_HOS_C2_33),Other Special Care Unit (D3_HOS_C2_35),Whole Blood & Packed Red Blood Cells (D3_HOS_C2_62),Blood Clotting Factors for Hemoph. (D3_HOS_C2_6250),Durable Medical Equipment Rented (D3_HOS_C2_96),Durable Medical Equipment Sold (D3_HOS_C2_97),Other Reimbursable (D3_HOS_C2_98),Whole Blood & Packed Red Blood Cells (D3_HOS_C3_62),Blood Clotting Factors for Hemoph. (D3_HOS_C3_6250),Durable Medical Equipment Rented (D3_HOS_C3_96),Durable Medical Equipment Sold (D3_HOS_C3_97),Other Reimbursable (D3_HOS_C3_98),Intensive Care Unit (D3_IPF_C2_31),Coronary Care Unit (D3_IPF_C2_32),Burn Intensive Care Unit (D3_IPF_C2_33),Surgical Intensive Care Unit (D3_IPF_C2_34),Other Special Care Unit (D3_IPF_C2_35),Delivery Room and Labor Room (D3_IPF_C2_52),Radiology-Therapeutic (D3_IPF_C2_55),Radioisotope (D3_IPF_C2_56),Cardiac Catheterization (D3_IPF_C2_59),Whole Blood & Packed Red Blood Cells (D3_IPF_C2_62),"Blood Storing, Processing, Trans (D3_IPF_C2_63)",Intravenous Therapy (D3_IPF_C2_64),Occupational Therapy (D3_IPF_C2_67),Electroencephalography (D3_IPF_C2_70),ASC (Non Distinct Part) (D3_IPF_C2_75),Other Ancillary (D3_IPF_C2_76),Clinic (D3_IPF_C2_90),Observation Beds (Distinct Unit) (D3_IPF_C2_9201),Other Outpatient Services (D3_IPF_C2_93),Durable Medical Equipment Rented (D3_IPF_C2_96),Other Reimbursable (D3_IPF_C2_98),Delivery Room and Labor Room (D3_IPF_C3_52),Radiology-Therapeutic (D3_IPF_C3_55),Radioisotope (D3_IPF_C3_56),Cardiac Catheterization (D3_IPF_C3_59),Whole Blood & Packed Red Blood Cells (D3_IPF_C3_62),"Blood Storing, Processing, Trans (D3_IPF_C3_63)",Intravenous Therapy (D3_IPF_C3_64),Occupational Therapy (D3_IPF_C3_67),Electroencephalography (D3_IPF_C3_70),ASC (Non Distinct Part) (D3_IPF_C3_75),Other Ancillary (D3_IPF_C3_76),Clinic (D3_IPF_C3_90),Observation Beds (Distinct Unit) (D3_IPF_C3_9201),Other Outpatient Services (D3_IPF_C3_93),Durable Medical Equipment Rented (D3_IPF_C3_96),Other Reimbursable (D3_IPF_C3_98),Intensive Care Unit (D3_IRF_C2_31),Coronary Care Unit (D3_IRF_C2_32),Burn Intensive Care Unit (D3_IRF_C2_33),Surgical Intensive Care Unit (D3_IRF_C2_34),Other Special Care Unit (D3_IRF_C2_35),Delivery Room and Labor Room (D3_IRF_C2_52),Radioisotope (D3_IRF_C2_56),Cardiac Catheterization (D3_IRF_C2_59),Whole Blood & Packed Red Blood Cells (D3_IRF_C2_62),"Blood Storing, Processing, Trans (D3_IRF_C2_63)",Electroencephalography (D3_IRF_C2_70),ASC (Non Distinct Part) (D3_IRF_C2_75),Emergency (D3_IRF_C2_91),Observation Beds (Distinct Unit) (D3_IRF_C2_9201),Other Outpatient Services (D3_IRF_C2_93),Durable Medical Equipment Rented (D3_IRF_C2_96),Other Reimbursable (D3_IRF_C2_98),Delivery Room and Labor Room (D3_IRF_C3_52),Radioisotope (D3_IRF_C3_56),Cardiac Catheterization (D3_IRF_C3_59),Whole Blood & Packed Red Blood Cells (D3_IRF_C3_62),"Blood Storing, Processing, Trans (D3_IRF_C3_63)",Electroencephalography (D3_IRF_C3_70),ASC (Non Distinct Part) (D3_IRF_C3_75),Emergency (D3_IRF_C3_91),Observation Beds (Distinct Unit) (D3_IRF_C3_9201),Other Outpatient Services (D3_IRF_C3_93),Durable Medical Equipment Rented (D3_IRF_C3_96),Other Reimbursable (D3_IRF_C3_98),Intensive Care Unit (D3_SNF_C2_31),Coronary Care Unit (D3_SNF_C2_32),Surgical Intensive Care Unit (D3_SNF_C2_34),Other Special Care Unit (D3_SNF_C2_35),Operating Room (D3_SNF_C2_50),Recovery Room (D3_SNF_C2_51),Delivery Room and Labor Room (D3_SNF_C2_52),Anesthesiology (D3_SNF_C2_53),Radiology-Therapeutic (D3_SNF_C2_55),Radioisotope (D3_SNF_C2_56),CT Scan (D3_SNF_C2_57),MRI (D3_SNF_C2_58),Cardiac Catheterization (D3_SNF_C2_59),Whole Blood & Packed Red Blood Cells (D3_SNF_C2_62),"Blood Storing, Processing, Trans (D3_SNF_C2_63)",Intravenous Therapy (D3_SNF_C2_64),Respiratory Therapy (D3_SNF_C2_65),Occupational Therapy (D3_SNF_C2_67),Speech Pathology (D3_SNF_C2_68),Electrocardiology (D3_SNF_C2_69),Electroencephalography (D3_SNF_C2_70),Medical Supplies Charged to Patients (D3_SNF_C2_71),Impl. Dev. Charged to Patients  (D3_SNF_C2_72),ASC (Non Distinct Part) (D3_SNF_C2_75),Other Ancillary (D3_SNF_C2_76),Clinic (D3_SNF_C2_90),Emergency (D3_SNF_C2_91),Observation Beds (Distinct Unit) (D3_SNF_C2_9201),Other Outpatient Services (D3_SNF_C2_93),Durable Medical Equipment Rented (D3_SNF_C2_96),Other Reimbursable (D3_SNF_C2_98),Operating Room (D3_SNF_C3_50),Recovery Room (D3_SNF_C3_51),Delivery Room and Labor Room (D3_SNF_C3_52),Anesthesiology (D3_SNF_C3_53),Radiology-Therapeutic (D3_SNF_C3_55),Radioisotope (D3_SNF_C3_56),CT Scan (D3_SNF_C3_57),MRI (D3_SNF_C3_58),Cardiac Catheterization (D3_SNF_C3_59),Whole Blood & Packed Red Blood Cells (D3_SNF_C3_62),"Blood Storing, Processing, Trans (D3_SNF_C3_63)",Intravenous Therapy (D3_SNF_C3_64),Respiratory Therapy (D3_SNF_C3_65),Occupational Therapy (D3_SNF_C3_67),Speech Pathology (D3_SNF_C3_68),Electrocardiology (D3_SNF_C3_69),Electroencephalography (D3_SNF_C3_70),Medical Supplies Charged to Patients (D3_SNF_C3_71),Impl. Dev. Charged to Patients  (D3_SNF_C3_72),ASC (Non Distinct Part) (D3_SNF_C3_75),Other Ancillary (D3_SNF_C3_76),Clinic (D3_SNF_C3_90),Emergency (D3_SNF_C3_91),Observation Beds (Distinct Unit) (D3_SNF_C3_9201),Other Outpatient Services (D3_SNF_C3_93),Durable Medical Equipment Rented (D3_SNF_C3_96),Other Reimbursable (D3_SNF_C3_98),Burn Intensive Care Unit (D_1_HOS_C4_33),Burn Intensive Care Unit (D_1_HOS_C6_33),Other Special Care Unit (D_1_HOS_C6_35),Burn Intensive Care Unit (D_1_HOS_C7_33),Other Special Care Unit (D_1_HOS_C7_35),Burn Intensive Care Unit (D_3_HOS_C9_33),Other Special Care Unit (D_3_HOS_C9_35),Whole Blood & Packed Red Blood Cells (D_4_HOS_C10_62),Blood Clotting Factors for Hemoph. (D_4_HOS_C10_6250),Durable Medical Equipment Rented (D_4_HOS_C10_96),Durable Medical Equipment Sold (D_4_HOS_C10_97),Other Reimbursable (D_4_HOS_C10_98),Recovery Room (D_4_HOS_C11_51),Delivery Room and Labor Room (D_4_HOS_C11_52),Radiology-Therapeutic (D_4_HOS_C11_55),Radioisotope (D_4_HOS_C11_56),CT Scan (D_4_HOS_C11_57),MRI (D_4_HOS_C11_58),Whole Blood & Packed Red Blood Cells (D_4_HOS_C11_62),"Blood Storing, Processing, Trans (D_4_HOS_C11_63)",Intravenous Therapy (D_4_HOS_C11_64),Physical Therapy (D_4_HOS_C11_66),Occupational Therapy (D_4_HOS_C11_67),Speech Pathology (D_4_HOS_C11_68),Electroencephalography (D_4_HOS_C11_70),Medical Supplies Charged to Patients (D_4_HOS_C11_71),Impl. Dev. Charged to Patients  (D_4_HOS_C11_72),ASC (Non Distinct Part) (D_4_HOS_C11_75),Observation Beds (Distinct Unit) (D_4_HOS_C11_9201),Other Reimbursable (D_4_HOS_C11_98),Whole Blood & Packed Red Blood Cells (D_4_HOS_C12_62),Blood Clotting Factors for Hemoph. (D_4_HOS_C12_6250),Durable Medical Equipment Rented (D_4_HOS_C12_96),Durable Medical Equipment Sold (D_4_HOS_C12_97),Other Reimbursable (D_4_HOS_C12_98),Recovery Room (D_4_HOS_C13_51),Delivery Room and Labor Room (D_4_HOS_C13_52),Radiology-Therapeutic (D_4_HOS_C13_55),Radioisotope (D_4_HOS_C13_56),CT Scan (D_4_HOS_C13_57),MRI (D_4_HOS_C13_58),Whole Blood & Packed Red Blood Cells (D_4_HOS_C13_62),"Blood Storing, Processing, Trans (D_4_HOS_C13_63)",Intravenous Therapy (D_4_HOS_C13_64),Physical Therapy (D_4_HOS_C13_66),Occupational Therapy (D_4_HOS_C13_67),Speech Pathology (D_4_HOS_C13_68),Electroencephalography (D_4_HOS_C13_70),Medical Supplies Charged to Patients (D_4_HOS_C13_71),Impl. Dev. Charged to Patients  (D_4_HOS_C13_72),ASC (Non Distinct Part) (D_4_HOS_C13_75),Observation Beds (Distinct Unit) (D_4_HOS_C13_9201),Durable Medical Equipment Sold (D_4_HOS_C13_97),Other Reimbursable (D_4_HOS_C13_98),Operating Room (D_4_HOS_C1_50),Anesthesiology (D_4_HOS_C1_53),Drugs Charged to Patients (D_4_HOS_C1_73),Other Ancillary (D_4_HOS_C1_76),Emergency (D_4_HOS_C1_91),Recovery Room (D_4_HOS_C2_51),Anesthesiology (D_4_HOS_C2_53),Radiology-Diagnostic (D_4_HOS_C2_54),Radiology-Therapeutic (D_4_HOS_C2_55),Radioisotope (D_4_HOS_C2_56),CT Scan (D_4_HOS_C2_57),MRI (D_4_HOS_C2_58),Cardiac Catheterization (D_4_HOS_C2_59),Laboratory (D_4_HOS_C2_60),Whole Blood & Packed Red Blood Cells (D_4_HOS_C2_62),"Blood Storing, Processing, Trans (D_4_HOS_C2_63)",Intravenous Therapy (D_4_HOS_C2_64),Respiratory Therapy (D_4_HOS_C2_65),Physical Therapy (D_4_HOS_C2_66),Occupational Therapy (D_4_HOS_C2_67),Speech Pathology (D_4_HOS_C2_68),Electrocardiology (D_4_HOS_C2_69),Electroencephalography (D_4_HOS_C2_70),Medical Supplies Charged to Patients (D_4_HOS_C2_71),Impl. Dev. Charged to Patients  (D_4_HOS_C2_72),Drugs Charged to Patients (D_4_HOS_C2_73),ASC (Non Distinct Part) (D_4_HOS_C2_75),Other Ancillary (D_4_HOS_C2_76),RHC (D_4_HOS_C2_88),Clinic (D_4_HOS_C2_90),Observation Beds (Distinct Unit) (D_4_HOS_C2_9201),Other Outpatient Services (D_4_HOS_C2_93),Durable Medical Equipment Sold (D_4_HOS_C2_97),Other Reimbursable (D_4_HOS_C2_98),Recovery Room (D_4_HOS_C3_51),Delivery Room and Labor Room (D_4_HOS_C3_52),Radiology-Therapeutic (D_4_HOS_C3_55),Radioisotope (D_4_HOS_C3_56),CT Scan (D_4_HOS_C3_57),MRI (D_4_HOS_C3_58),Whole Blood & Packed Red Blood Cells (D_4_HOS_C3_62),Blood Clotting Factors for Hemoph. (D_4_HOS_C3_6250),"Blood Storing, Processing, Trans (D_4_HOS_C3_63)",Intravenous Therapy (D_4_HOS_C3_64),Physical Therapy (D_4_HOS_C3_66),Occupational Therapy (D_4_HOS_C3_67),Speech Pathology (D_4_HOS_C3_68),Electroencephalography (D_4_HOS_C3_70),Medical Supplies Charged to Patients (D_4_HOS_C3_71),Impl. Dev. Charged to Patients  (D_4_HOS_C3_72),ASC (Non Distinct Part) (D_4_HOS_C3_75),RHC (D_4_HOS_C3_88),FQHC (D_4_HOS_C3_89),Observation Beds (Distinct Unit) (D_4_HOS_C3_9201),Durable Medical Equipment Sold (D_4_HOS_C3_97),Other Reimbursable (D_4_HOS_C3_98),Operating Room (D_4_HOS_C4_50),Recovery Room (D_4_HOS_C4_51),Delivery Room and Labor Room (D_4_HOS_C4_52),Anesthesiology (D_4_HOS_C4_53),Radiology-Diagnostic (D_4_HOS_C4_54),Radiology-Therapeutic (D_4_HOS_C4_55),Radioisotope (D_4_HOS_C4_56),CT Scan (D_4_HOS_C4_57),MRI (D_4_HOS_C4_58),Cardiac Catheterization (D_4_HOS_C4_59),Laboratory (D_4_HOS_C4_60),Intravenous Therapy (D_4_HOS_C4_64),Respiratory Therapy (D_4_HOS_C4_65),Physical Therapy (D_4_HOS_C4_66),Occupational Therapy (D_4_HOS_C4_67),Speech Pathology (D_4_HOS_C4_68),Electrocardiology (D_4_HOS_C4_69),Electroencephalography (D_4_HOS_C4_70),Medical Supplies Charged to Patients (D_4_HOS_C4_71),Impl. Dev. Charged to Patients  (D_4_HOS_C4_72),Drugs Charged to Patients (D_4_HOS_C4_73),ASC (Non Distinct Part) (D_4_HOS_C4_75),Other Ancillary (D_4_HOS_C4_76),RHC (D_4_HOS_C4_88),FQHC (D_4_HOS_C4_89),Clinic (D_4_HOS_C4_90),Emergency (D_4_HOS_C4_91),Other Outpatient Services (D_4_HOS_C4_93),Operating Room (D_4_IPF_C11_50),Recovery Room (D_4_IPF_C11_51),Delivery Room and Labor Room (D_4_IPF_C11_52),Radiology-Diagnostic (D_4_IPF_C11_54),Radiology-Therapeutic (D_4_IPF_C11_55),Radioisotope (D_4_IPF_C11_56),CT Scan (D_4_IPF_C11_57),MRI (D_4_IPF_C11_58),Cardiac Catheterization (D_4_IPF_C11_59),Laboratory (D_4_IPF_C11_60),Whole Blood & Packed Red Blood Cells (D_4_IPF_C11_62),"Blood Storing, Processing, Trans (D_4_IPF_C11_63)",Intravenous Therapy (D_4_IPF_C11_64),Respiratory Therapy (D_4_IPF_C11_65),Physical Therapy (D_4_IPF_C11_66),Occupational Therapy (D_4_IPF_C11_67),Speech Pathology (D_4_IPF_C11_68),Electroencephalography (D_4_IPF_C11_70),Medical Supplies Charged to Patients (D_4_IPF_C11_71),Impl. Dev. Charged to Patients  (D_4_IPF_C11_72),ASC (Non Distinct Part) (D_4_IPF_C11_75),Other Ancillary (D_4_IPF_C11_76),Clinic (D_4_IPF_C11_90),Observation Beds (Distinct Unit) (D_4_IPF_C11_9201),Other Outpatient Services (D_4_IPF_C11_93),Operating Room (D_4_IPF_C13_50),Recovery Room (D_4_IPF_C13_51),Delivery Room and Labor Room (D_4_IPF_C13_52),Anesthesiology (D_4_IPF_C13_53),Radiology-Diagnostic (D_4_IPF_C13_54),Radiology-Therapeutic (D_4_IPF_C13_55),Radioisotope (D_4_IPF_C13_56),CT Scan (D_4_IPF_C13_57),MRI (D_4_IPF_C13_58),Cardiac Catheterization (D_4_IPF_C13_59),Laboratory (D_4_IPF_C13_60),Whole Blood & Packed Red Blood Cells (D_4_IPF_C13_62),"Blood Storing, Processing, Trans (D_4_IPF_C13_63)",Intravenous Therapy (D_4_IPF_C13_64),Respiratory Therapy (D_4_IPF_C13_65),Physical Therapy (D_4_IPF_C13_66),Occupational Therapy (D_4_IPF_C13_67),Speech Pathology (D_4_IPF_C13_68),Electrocardiology (D_4_IPF_C13_69),Electroencephalography (D_4_IPF_C13_70),Medical Supplies Charged to Patients (D_4_IPF_C13_71),Impl. Dev. Charged to Patients  (D_4_IPF_C13_72),Drugs Charged to Patients (D_4_IPF_C13_73),ASC (Non Distinct Part) (D_4_IPF_C13_75),Other Ancillary (D_4_IPF_C13_76),Clinic (D_4_IPF_C13_90),Emergency (D_4_IPF_C13_91),Observation Beds (Distinct Unit) (D_4_IPF_C13_9201),Other Outpatient Services (D_4_IPF_C13_93),Recovery Room (D_4_IRF_C11_51),Delivery Room and Labor Room (D_4_IRF_C11_52),Radiology-Therapeutic (D_4_IRF_C11_55),Radioisotope (D_4_IRF_C11_56),CT Scan (D_4_IRF_C11_57),MRI (D_4_IRF_C11_58),Cardiac Catheterization (D_4_IRF_C11_59),Whole Blood & Packed Red Blood Cells (D_4_IRF_C11_62),"Blood Storing, Processing, Trans (D_4_IRF_C11_63)",Intravenous Therapy (D_4_IRF_C11_64),Physical Therapy (D_4_IRF_C11_66),Occupational Therapy (D_4_IRF_C11_67),Speech Pathology (D_4_IRF_C11_68),Electroencephalography (D_4_IRF_C11_70),Medical Supplies Charged to Patients (D_4_IRF_C11_71),Impl. Dev. Charged to Patients  (D_4_IRF_C11_72),ASC (Non Distinct Part) (D_4_IRF_C11_75),Other Ancillary (D_4_IRF_C11_76),Clinic (D_4_IRF_C11_90),Emergency (D_4_IRF_C11_91),Observation Beds (Distinct Unit) (D_4_IRF_C11_9201),Other Outpatient Services (D_4_IRF_C11_93),Other Reimbursable (D_4_IRF_C11_98),Operating Room (D_4_IRF_C13_50),Recovery Room (D_4_IRF_C13_51),Anesthesiology (D_4_IRF_C13_53),Radiology-Diagnostic (D_4_IRF_C13_54),Radiology-Therapeutic (D_4_IRF_C13_55),Radioisotope (D_4_IRF_C13_56),CT Scan (D_4_IRF_C13_57),MRI (D_4_IRF_C13_58),Cardiac Catheterization (D_4_IRF_C13_59),Laboratory (D_4_IRF_C13_60),Whole Blood & Packed Red Blood Cells (D_4_IRF_C13_62),"Blood Storing, Processing, Trans (D_4_IRF_C13_63)",Respiratory Therapy (D_4_IRF_C13_65),Physical Therapy (D_4_IRF_C13_66),Speech Pathology (D_4_IRF_C13_68),Electrocardiology (D_4_IRF_C13_69),Electroencephalography (D_4_IRF_C13_70),Medical Supplies Charged to Patients (D_4_IRF_C13_71),Impl. Dev. Charged to Patients  (D_4_IRF_C13_72),Drugs Charged to Patients (D_4_IRF_C13_73),ASC (Non Distinct Part) (D_4_IRF_C13_75),Other Ancillary (D_4_IRF_C13_76),Clinic (D_4_IRF_C13_90),Emergency (D_4_IRF_C13_91),Operating Room (D_4_SNF_C11_50),Recovery Room (D_4_SNF_C11_51),Delivery Room and Labor Room (D_4_SNF_C11_52),Anesthesiology (D_4_SNF_C11_53),Radiology-Diagnostic (D_4_SNF_C11_54),Radiology-Therapeutic (D_4_SNF_C11_55),Radioisotope (D_4_SNF_C11_56),CT Scan (D_4_SNF_C11_57),MRI (D_4_SNF_C11_58),Cardiac Catheterization (D_4_SNF_C11_59),Laboratory (D_4_SNF_C11_60),Whole Blood & Packed Red Blood Cells (D_4_SNF_C11_62),"Blood Storing, Processing, Trans (D_4_SNF_C11_63)",Intravenous Therapy (D_4_SNF_C11_64),Respiratory Therapy (D_4_SNF_C11_65),Physical Therapy (D_4_SNF_C11_66),Occupational Therapy (D_4_SNF_C11_67),Speech Pathology (D_4_SNF_C11_68),Electrocardiology (D_4_SNF_C11_69),Electroencephalography (D_4_SNF_C11_70),Medical Supplies Charged to Patients (D_4_SNF_C11_71),Impl. Dev. Charged to Patients  (D_4_SNF_C11_72),Drugs Charged to Patients (D_4_SNF_C11_73),ASC (Non Distinct Part) (D_4_SNF_C11_75),Other Ancillary (D_4_SNF_C11_76),Clinic (D_4_SNF_C11_90),Emergency (D_4_SNF_C11_91),Observation Beds (Distinct Unit) (D_4_SNF_C11_9201),Other Outpatient Services (D_4_SNF_C11_93),Drugs Charged to Patients (D_4_SNF_C13_73),PPS REIMBURSED SERVICES -  CHARGES Whole Blood & Packed Red Blood Cells (D_5_HOS_C2_62),PPS REIMBURSED SERVICES -  CHARGES Blood Clotting Factors for Hemoph. (D_5_HOS_C2_6250),PPS REIMBURSED SERVICES -  CHARGES Durable Medical Equipment Rented (D_5_HOS_C2_96),PPS REIMBURSED SERVICES -  CHARGES Durable Medical Equipment Sold (D_5_HOS_C2_97),PPS REIMBURSED SERVICES -  CHARGES Other Reimbursable (D_5_HOS_C2_98),COST REIMBURSED SERVICES SUBJECT TO DEDUCTIBLES  AND COINSURANCE - CHARGES Recovery Room (D_5_HOS_C3_51),COST REIMBURSED SERVICES SUBJECT TO DEDUCTIBLES  AND COINSURANCE - CHARGES Delivery Room and Labor Room (D_5_HOS_C3_52),COST REIMBURSED SERVICES SUBJECT TO DEDUCTIBLES  AND COINSURANCE - CHARGES Radioisotope (D_5_HOS_C3_56),COST REIMBURSED SERVICES SUBJECT TO DEDUCTIBLES  AND COINSURANCE - CHARGES Cardiac Catheterization (D_5_HOS_C3_59),COST REIMBURSED SERVICES SUBJECT TO DEDUCTIBLES  AND COINSURANCE - CHARGES Whole Blood & Packed Red Blood Cells (D_5_HOS_C3_62),COST REIMBURSED SERVICES SUBJECT TO DEDUCTIBLES  AND COINSURANCE - CHARGES Blood Clotting Factors for Hemoph. (D_5_HOS_C3_6250),COST REIMBURSED SERVICES SUBJECT TO DEDUCTIBLES  AND COINSURANCE - CHARGES Intravenous Therapy (D_5_HOS_C3_64),COST REIMBURSED SERVICES SUBJECT TO DEDUCTIBLES  AND COINSURANCE - CHARGES Electroencephalography (D_5_HOS_C3_70),COST REIMBURSED SERVICES SUBJECT TO DEDUCTIBLES  AND COINSURANCE - CHARGES ASC (Non Distinct Part) (D_5_HOS_C3_75),COST REIMBURSED SERVICES SUBJECT TO DEDUCTIBLES  AND COINSURANCE - CHARGES Observation Beds (Distinct Unit) (D_5_HOS_C3_9201),COST REIMBURSED SERVICES SUBJECT TO DEDUCTIBLES  AND COINSURANCE - CHARGES Other Outpatient Services (D_5_HOS_C3_93),COST REIMBURSED SERVICES SUBJECT TO DEDUCTIBLES  AND COINSURANCE - CHARGES Durable Medical Equipment Rented (D_5_HOS_C3_96),COST REIMBURSED SERVICES SUBJECT TO DEDUCTIBLES  AND COINSURANCE - CHARGES Durable Medical Equipment Sold (D_5_HOS_C3_97),COST REIMBURSED SERVICES SUBJECT TO DEDUCTIBLES  AND COINSURANCE - CHARGES Other Reimbursable (D_5_HOS_C3_98),COST REIMBURSED SERVICES NOT SUBJECT TO DEDUCTIBLES AND COINSURANCE - CHARGES Delivery Room and Labor Room (D_5_HOS_C4_52),COST REIMBURSED SERVICES NOT SUBJECT TO DEDUCTIBLES AND COINSURANCE - CHARGES Anesthesiology (D_5_HOS_C4_53),COST REIMBURSED SERVICES NOT SUBJECT TO DEDUCTIBLES AND COINSURANCE - CHARGES Radiology-Diagnostic (D_5_HOS_C4_54),COST REIMBURSED SERVICES NOT SUBJECT TO DEDUCTIBLES AND COINSURANCE - CHARGES Radiology-Therapeutic (D_5_HOS_C4_55),COST REIMBURSED SERVICES NOT SUBJECT TO DEDUCTIBLES AND COINSURANCE - CHARGES Radioisotope (D_5_HOS_C4_56),COST REIMBURSED SERVICES NOT SUBJECT TO DEDUCTIBLES AND COINSURANCE - CHARGES CT Scan (D_5_HOS_C4_57),COST REIMBURSED SERVICES NOT SUBJECT TO DEDUCTIBLES AND COINSURANCE - CHARGES MRI (D_5_HOS_C4_58),COST REIMBURSED SERVICES NOT SUBJECT TO DEDUCTIBLES AND COINSURANCE - CHARGES Whole Blood & Packed Red Blood Cells (D_5_HOS_C4_62),"COST REIMBURSED SERVICES NOT SUBJECT TO DEDUCTIBLES AND COINSURANCE - CHARGES Blood Storing, Processing, Trans (D_5_HOS_C4_63)",COST REIMBURSED SERVICES NOT SUBJECT TO DEDUCTIBLES AND COINSURANCE - CHARGES Intravenous Therapy (D_5_HOS_C4_64),COST REIMBURSED SERVICES NOT SUBJECT TO DEDUCTIBLES AND COINSURANCE - CHARGES Respiratory Therapy (D_5_HOS_C4_65),COST REIMBURSED SERVICES NOT SUBJECT TO DEDUCTIBLES AND COINSURANCE - CHARGES Physical Therapy (D_5_HOS_C4_66),COST REIMBURSED SERVICES NOT SUBJECT TO DEDUCTIBLES AND COINSURANCE - CHARGES Occupational Therapy (D_5_HOS_C4_67),COST REIMBURSED SERVICES NOT SUBJECT TO DEDUCTIBLES AND COINSURANCE - CHARGES Speech Pathology (D_5_HOS_C4_68),COST REIMBURSED SERVICES NOT SUBJECT TO DEDUCTIBLES AND COINSURANCE - CHARGES Electrocardiology (D_5_HOS_C4_69),COST REIMBURSED SERVICES NOT SUBJECT TO DEDUCTIBLES AND COINSURANCE - CHARGES Electroencephalography (D_5_HOS_C4_70),COST REIMBURSED SERVICES NOT SUBJECT TO DEDUCTIBLES AND COINSURANCE - CHARGES Medical Supplies Charged to Patients (D_5_HOS_C4_71),COST REIMBURSED SERVICES NOT SUBJECT TO DEDUCTIBLES AND COINSURANCE - CHARGES Impl. Dev. Charged to Patients  (D_5_HOS_C4_72),COST REIMBURSED SERVICES NOT SUBJECT TO DEDUCTIBLES AND COINSURANCE - CHARGES ASC (Non Distinct Part) (D_5_HOS_C4_75),COST REIMBURSED SERVICES NOT SUBJECT TO DEDUCTIBLES AND COINSURANCE - CHARGES Other Reimbursable (D_5_HOS_C4_98),PPS SERVICES COST Whole Blood & Packed Red Blood Cells (D_5_HOS_C5_62),PPS SERVICES COST Blood Clotting Factors for Hemoph. (D_5_HOS_C5_6250),PPS SERVICES COST Durable Medical Equipment Rented (D_5_HOS_C5_96),PPS SERVICES COST Durable Medical Equipment Sold (D_5_HOS_C5_97),PPS SERVICES COST Other Reimbursable (D_5_HOS_C5_98),COST SERVICES SUBJECT TO DEDUCTIBLES AND COINSURANCE - COST Recovery Room (D_5_HOS_C6_51),COST SERVICES SUBJECT TO DEDUCTIBLES AND COINSURANCE - COST Delivery Room and Labor Room (D_5_HOS_C6_52),COST SERVICES SUBJECT TO DEDUCTIBLES AND COINSURANCE - COST Radioisotope (D_5_HOS_C6_56),COST SERVICES SUBJECT TO DEDUCTIBLES AND COINSURANCE - COST Cardiac Catheterization (D_5_HOS_C6_59),COST SERVICES SUBJECT TO DEDUCTIBLES AND COINSURANCE - COST Whole Blood & Packed Red Blood Cells (D_5_HOS_C6_62),COST SERVICES SUBJECT TO DEDUCTIBLES AND COINSURANCE - COST Blood Clotting Factors for Hemoph. (D_5_HOS_C6_6250),COST SERVICES SUBJECT TO DEDUCTIBLES AND COINSURANCE - COST Intravenous Therapy (D_5_HOS_C6_64),COST SERVICES SUBJECT TO DEDUCTIBLES AND COINSURANCE - COST Electroencephalography (D_5_HOS_C6_70),COST SERVICES SUBJECT TO DEDUCTIBLES AND COINSURANCE - COST ASC (Non Distinct Part) (D_5_HOS_C6_75),COST SERVICES SUBJECT TO DEDUCTIBLES AND COINSURANCE - COST Observation Beds (Distinct Unit) (D_5_HOS_C6_9201),COST SERVICES SUBJECT TO DEDUCTIBLES AND COINSURANCE - COST Other Outpatient Services (D_5_HOS_C6_93),COST SERVICES SUBJECT TO DEDUCTIBLES AND COINSURANCE - COST Durable Medical Equipment Rented (D_5_HOS_C6_96),COST SERVICES SUBJECT TO DEDUCTIBLES AND COINSURANCE - COST Durable Medical Equipment Sold (D_5_HOS_C6_97),COST SERVICES SUBJECT TO DEDUCTIBLES AND COINSURANCE - COST Other Reimbursable (D_5_HOS_C6_98),COST SERVICES NOT SUBJECT TO DEDUCTIBLES AND COINSURANCE - COST Delivery Room and Labor Room (D_5_HOS_C7_52),COST SERVICES NOT SUBJECT TO DEDUCTIBLES AND COINSURANCE - COST Anesthesiology (D_5_HOS_C7_53),COST SERVICES NOT SUBJECT TO DEDUCTIBLES AND COINSURANCE - COST Radiology-Diagnostic (D_5_HOS_C7_54),COST SERVICES NOT SUBJECT TO DEDUCTIBLES AND COINSURANCE - COST Radiology-Therapeutic (D_5_HOS_C7_55),COST SERVICES NOT SUBJECT TO DEDUCTIBLES AND COINSURANCE - COST Radioisotope (D_5_HOS_C7_56),COST SERVICES NOT SUBJECT TO DEDUCTIBLES AND COINSURANCE - COST CT Scan (D_5_HOS_C7_57),COST SERVICES NOT SUBJECT TO DEDUCTIBLES AND COINSURANCE - COST MRI (D_5_HOS_C7_58),COST SERVICES NOT SUBJECT TO DEDUCTIBLES AND COINSURANCE - COST Whole Blood & Packed Red Blood Cells (D_5_HOS_C7_62),"COST SERVICES NOT SUBJECT TO DEDUCTIBLES AND COINSURANCE - COST Blood Storing, Processing, Trans (D_5_HOS_C7_63)",COST SERVICES NOT SUBJECT TO DEDUCTIBLES AND COINSURANCE - COST Intravenous Therapy (D_5_HOS_C7_64),COST SERVICES NOT SUBJECT TO DEDUCTIBLES AND COINSURANCE - COST Respiratory Therapy (D_5_HOS_C7_65),COST SERVICES NOT SUBJECT TO DEDUCTIBLES AND COINSURANCE - COST Physical Therapy (D_5_HOS_C7_66),COST SERVICES NOT SUBJECT TO DEDUCTIBLES AND COINSURANCE - COST Occupational Therapy (D_5_HOS_C7_67),COST SERVICES NOT SUBJECT TO DEDUCTIBLES AND COINSURANCE - COST Speech Pathology (D_5_HOS_C7_68),COST SERVICES NOT SUBJECT TO DEDUCTIBLES AND COINSURANCE - COST Electrocardiology (D_5_HOS_C7_69),COST SERVICES NOT SUBJECT TO DEDUCTIBLES AND COINSURANCE - COST Electroencephalography (D_5_HOS_C7_70),COST SERVICES NOT SUBJECT TO DEDUCTIBLES AND COINSURANCE - COST Medical Supplies Charged to Patients (D_5_HOS_C7_71),COST SERVICES NOT SUBJECT TO DEDUCTIBLES AND COINSURANCE - COST Impl. Dev. Charged to Patients  (D_5_HOS_C7_72),COST SERVICES NOT SUBJECT TO DEDUCTIBLES AND COINSURANCE - COST ASC (Non Distinct Part) (D_5_HOS_C7_75),COST SERVICES NOT SUBJECT TO DEDUCTIBLES AND COINSURANCE - COST Other Reimbursable (D_5_HOS_C7_98),Other adjustments (E_B_HOS_C1_39),Outpatient Rehab Provider (S3_1_C10_25),HHA (S3_1_C11_22),Hospice (S3_1_C11_24),Outpatient Rehab Provider (S3_1_C11_25),RHC/FQHC Combined (S3_1_C11_26),Burn Intensive Care Unit (S3_1_C2_10),Hospice (S3_1_C2_24),Burn Intensive Care Unit (S3_1_C3_10),Hospice (S3_1_C3_24),Burn Intensive Care Unit (S3_1_C4_10),Surgical Intensive Care Unit (S3_1_C4_11),Other Special Care (S3_1_C4_12),Intensive Care Unit (S3_1_C4_8),Coronary Care Unit (S3_1_C4_9),Burn Intensive Care Unit (S3_1_C5_10),Surgical Intensive Care Unit (S3_1_C5_11),Other Special Care (S3_1_C5_12),Intensive Care Unit (S3_1_C5_8),Coronary Care Unit (S3_1_C5_9),Burn Intensive Care Unit (S3_1_C6_10),Other Special Care (S3_1_C6_12),Hospice (S3_1_C6_24),CMHC (S3_1_C6_25),Burn Intensive Care Unit (S3_1_C7_10),HHA (S3_1_C7_22),Hospice (S3_1_C7_24),Outpatient Rehab Provider (S3_1_C7_25),Burn Intensive Care Unit (S3_1_C8_10),Outpatient Rehab Provider (S3_1_C8_25),HHA (S3_1_C9_22),Hospice (S3_1_C9_24),RHC/FQHC Combined (S3_1_C9_26),Column 11 (Interest) New Cap Related Csts Bldg & Fixtures (A7_3_C11_1),Column 11 (Interest) New Cap Related Csts Movable Equipment (A7_3_C11_2),Column 15 (Total) New Cap Related Csts Bldg & Fixtures (A7_3_C15_1),Column 15 (Total) New Cap Related Csts Movable Equipment (A7_3_C15_2),Column 9 (Depreciation) New Cap Related Csts Bldg & Fixtures (A7_3_C9_1),Column 9 (Depreciation) New Cap Related Csts Movable Equipment (A7_3_C9_2),Other Adjustments (Summed) (A8_C2_33),Dietary (A_C1_10),Nursing Administration (A_C1_13),Central Services and Supply (A_C1_14),Pharmacy (A_C1_15),Medical Records and Medical Rec. Library (A_C1_16),Physicians' Private Office (A_C1_192),Administrative and General (A_C1_5),Operating Room (A_C1_50),Radiology-Diagnostic (A_C1_54),Laboratory (A_C1_60),Respiratory Therapy (A_C1_65),Physical Therapy (A_C1_66),Occupational Therapy (A_C1_67),Electrocardiology (A_C1_69),Operation of Plant (A_C1_7),Housekeeping (A_C1_9),Emergency (A_C1_91),New Capital Buildings and Fixtures (A_C2_1),Dietary (A_C2_10),Nursing Administration (A_C2_13),Central Services and Supply (A_C2_14),Pharmacy (A_C2_15),Medical Records and Medical Rec. Library (A_C2_16),Physicians' Private Office (A_C2_192),New Capital Equipment (A_C2_2),Employee Benefits (A_C2_4),Administrative and General (A_C2_5),Operating Room (A_C2_50),Anesthesiology (A_C2_53),Radiology-Diagnostic (A_C2_54),CT Scan (A_C2_57),Laboratory (A_C2_60),Respiratory Therapy (A_C2_65),Physical Therapy (A_C2_66),Electrocardiology (A_C2_69),Operation of Plant (A_C2_7),Housekeeping (A_C2_9),Emergency (A_C2_91),Cafeteria (A_C6_11),Medical Records and Medical Rec. Library (A_C6_16),New Capital Equipment (A_C6_2),Administrative and General (A_C6_5),Operating Room (A_C6_50),Emergency (A_C6_91),Net Expense for Cost Allocation New Capital Buildings and Fixtures (B_1_C0_1),Net Expense for Cost Allocation Dietary (B_1_C0_10),Net Expense for Cost Allocation Cafeteria (B_1_C0_11),Net Expense for Cost Allocation Nursing Administration (B_1_C0_13),Net Expense for Cost Allocation Central Services and Supply (B_1_C0_14),Net Expense for Cost Allocation Pharmacy (B_1_C0_15),Net Expense for Cost Allocation Medical Records and Medical Rec. Library (B_1_C0_16),Net Expense for Cost Allocation Physicians' Private Office (B_1_C0_192),Net Expense for Cost Allocation Other Nonreimbursable (B_1_C0_194),Net Expense for Cost Allocation New Capital Equipment (B_1_C0_2),Net Expense for Cost Allocation Employee Benefits (B_1_C0_4),Net Expense for Cost Allocation Administrative and General (B_1_C0_5),Net Expense for Cost Allocation Operating Room (B_1_C0_50),Net Expense for Cost Allocation Anesthesiology (B_1_C0_53),Net Expense for Cost Allocation Radiology-Diagnostic (B_1_C0_54),Net Expense for Cost Allocation CT Scan (B_1_C0_57),Net Expense for Cost Allocation Laboratory (B_1_C0_60),Net Expense for Cost Allocation Respiratory Therapy (B_1_C0_65),Net Expense for Cost Allocation Physical Therapy (B_1_C0_66),Net Expense for Cost Allocation Occupational Therapy (B_1_C0_67),Net Expense for Cost Allocation Electrocardiology (B_1_C0_69),Net Expense for Cost Allocation Operation of Plant (B_1_C0_7),Net Expense for Cost Allocation Medical Supplies Charged to Patients (B_1_C0_71),Net Expense for Cost Allocation Drugs Charged to Patients (B_1_C0_73),Net Expense for Cost Allocation Housekeeping (B_1_C0_9),Net Expense for Cost Allocation Emergency (B_1_C0_91),"Gift, Flower, Coffee Shop, Canteen (B_1_C26_190)",Physicians' Private Office (B_1_C26_192),Other Nonreimbursable (B_1_C26_194),Operating Room (B_1_C26_50),Anesthesiology (B_1_C26_53),Radiology-Diagnostic (B_1_C26_54),CT Scan (B_1_C26_57),Laboratory (B_1_C26_60),Respiratory Therapy (B_1_C26_65),Physical Therapy (B_1_C26_66),Occupational Therapy (B_1_C26_67),Electrocardiology (B_1_C26_69),Medical Supplies Charged to Patients (B_1_C26_71),Drugs Charged to Patients (B_1_C26_73),Emergency (B_1_C26_91),"Gift, Flower, Coffee Shop, Canteen (B_2_C26_190)",Physicians' Private Office (B_2_C26_192),Other Nonreimbursable (B_2_C26_194),TOTAL CAPITAL COSTS AFTER COST ALLOCATION Operating Room (B_2_C26_50),TOTAL CAPITAL COSTS AFTER COST ALLOCATION Anesthesiology (B_2_C26_53),TOTAL CAPITAL COSTS AFTER COST ALLOCATION Radiology-Diagnostic (B_2_C26_54),TOTAL CAPITAL COSTS AFTER COST ALLOCATION CT Scan (B_2_C26_57),TOTAL CAPITAL COSTS AFTER COST ALLOCATION Laboratory (B_2_C26_60),Respiratory Therapy (B_2_C26_65),Physical Therapy (B_2_C26_66),Occupational Therapy (B_2_C26_67),Electrocardiology (B_2_C26_69),Medical Supplies Charged to Patients (B_2_C26_71),Drugs Charged to Patients (B_2_C26_73),Emergency (B_2_C26_91),Total Inpatient Charges Operating Room (C_1_C6_50),Total Inpatient Charges Anesthesiology (C_1_C6_53),Total Inpatient Charges Radiology-Diagnostic (C_1_C6_54),Total Inpatient Charges CT Scan (C_1_C6_57),Total Inpatient Charges Laboratory (C_1_C6_60),Respiratory Therapy (C_1_C6_65),Physical Therapy (C_1_C6_66),Occupational Therapy (C_1_C6_67),Electrocardiology (C_1_C6_69),Medical Supplies Charged to Patients (C_1_C6_71),Drugs Charged to Patients (C_1_C6_73),Emergency (C_1_C6_91),Total Outpatient Charges Operating Room (C_1_C7_50),Total Outpatient Charges Anesthesiology (C_1_C7_53),Total Outpatient Charges Radiology-Diagnostic (C_1_C7_54),Total Outpatient Charges CT Scan (C_1_C7_57),Total Outpatient Charges Laboratory (C_1_C7_60),Respiratory Therapy (C_1_C7_65),Physical Therapy (C_1_C7_66),Occupational Therapy (C_1_C7_67),Electrocardiology (C_1_C7_69),Medical Supplies Charged to Patients (C_1_C7_71),Drugs Charged to Patients (C_1_C7_73),Emergency (C_1_C7_91),Operating Room (D3_HOS_C2_50),Anesthesiology (D3_HOS_C2_53),Radiology-Diagnostic (D3_HOS_C2_54),CT Scan (D3_HOS_C2_57),Laboratory (D3_HOS_C2_60),Respiratory Therapy (D3_HOS_C2_65),Physical Therapy (D3_HOS_C2_66),Occupational Therapy (D3_HOS_C2_67),Electrocardiology (D3_HOS_C2_69),Medical Supplies Charged to Patients (D3_HOS_C2_71),Drugs Charged to Patients (D3_HOS_C2_73),Emergency (D3_HOS_C2_91),Operating Room (D3_HOS_C3_50),Anesthesiology (D3_HOS_C3_53),Radiology-Diagnostic (D3_HOS_C3_54),CT Scan (D3_HOS_C3_57),Laboratory (D3_HOS_C3_60),Respiratory Therapy (D3_HOS_C3_65),Physical Therapy (D3_HOS_C3_66),Occupational Therapy (D3_HOS_C3_67),Electrocardiology (D3_HOS_C3_69),Medical Supplies Charged to Patients (D3_HOS_C3_71),Drugs Charged to Patients (D3_HOS_C3_73),Emergency (D3_HOS_C3_91),Operating Room (D_4_HOS_C10_50),Anesthesiology (D_4_HOS_C10_53),Radiology-Diagnostic (D_4_HOS_C10_54),CT Scan (D_4_HOS_C10_57),Laboratory (D_4_HOS_C10_60),Respiratory Therapy (D_4_HOS_C10_65),Physical Therapy (D_4_HOS_C10_66),Occupational Therapy (D_4_HOS_C10_67),Electrocardiology (D_4_HOS_C10_69),Medical Supplies Charged to Patients (D_4_HOS_C10_71),Drugs Charged to Patients (D_4_HOS_C10_73),Emergency (D_4_HOS_C10_91),COST REIMBURSED SERVICES SUBJECT TO DEDUCTIBLES  AND COINSURANCE - CHARGES Operating Room (D_5_HOS_C3_50),COST REIMBURSED SERVICES SUBJECT TO DEDUCTIBLES  AND COINSURANCE - CHARGES Anesthesiology (D_5_HOS_C3_53),COST REIMBURSED SERVICES SUBJECT TO DEDUCTIBLES  AND COINSURANCE - CHARGES Radiology-Diagnostic (D_5_HOS_C3_54),COST REIMBURSED SERVICES SUBJECT TO DEDUCTIBLES  AND COINSURANCE - CHARGES CT Scan (D_5_HOS_C3_57),COST REIMBURSED SERVICES SUBJECT TO DEDUCTIBLES  AND COINSURANCE - CHARGES Laboratory (D_5_HOS_C3_60),COST REIMBURSED SERVICES SUBJECT TO DEDUCTIBLES  AND COINSURANCE - CHARGES Respiratory Therapy (D_5_HOS_C3_65),COST REIMBURSED SERVICES SUBJECT TO DEDUCTIBLES  AND COINSURANCE - CHARGES Physical Therapy (D_5_HOS_C3_66),COST REIMBURSED SERVICES SUBJECT TO DEDUCTIBLES  AND COINSURANCE - CHARGES Occupational Therapy (D_5_HOS_C3_67),COST REIMBURSED SERVICES SUBJECT TO DEDUCTIBLES  AND COINSURANCE - CHARGES Electrocardiology (D_5_HOS_C3_69),COST REIMBURSED SERVICES SUBJECT TO DEDUCTIBLES  AND COINSURANCE - CHARGES Medical Supplies Charged to Patients (D_5_HOS_C3_71),COST REIMBURSED SERVICES SUBJECT TO DEDUCTIBLES  AND COINSURANCE - CHARGES Drugs Charged to Patients (D_5_HOS_C3_73),COST REIMBURSED SERVICES SUBJECT TO DEDUCTIBLES  AND COINSURANCE - CHARGES Emergency (D_5_HOS_C3_91),COST SERVICES SUBJECT TO DEDUCTIBLES AND COINSURANCE - COST Operating Room (D_5_HOS_C6_50),COST SERVICES SUBJECT TO DEDUCTIBLES AND COINSURANCE - COST Anesthesiology (D_5_HOS_C6_53),COST SERVICES SUBJECT TO DEDUCTIBLES AND COINSURANCE - COST Radiology-Diagnostic (D_5_HOS_C6_54),COST SERVICES SUBJECT TO DEDUCTIBLES AND COINSURANCE - COST CT Scan (D_5_HOS_C6_57),COST SERVICES SUBJECT TO DEDUCTIBLES AND COINSURANCE - COST Laboratory (D_5_HOS_C6_60),COST SERVICES SUBJECT TO DEDUCTIBLES AND COINSURANCE - COST Respiratory Therapy (D_5_HOS_C6_65),COST SERVICES SUBJECT TO DEDUCTIBLES AND COINSURANCE - COST Physical Therapy (D_5_HOS_C6_66),COST SERVICES SUBJECT TO DEDUCTIBLES AND COINSURANCE - COST Occupational Therapy (D_5_HOS_C6_67),COST SERVICES SUBJECT TO DEDUCTIBLES AND COINSURANCE - COST Electrocardiology (D_5_HOS_C6_69),COST SERVICES SUBJECT TO DEDUCTIBLES AND COINSURANCE - COST Medical Supplies Charged to Patients (D_5_HOS_C6_71),COST SERVICES SUBJECT TO DEDUCTIBLES AND COINSURANCE - COST Drugs Charged to Patients (D_5_HOS_C6_73),COST SERVICES SUBJECT TO DEDUCTIBLES AND COINSURANCE - COST Emergency (D_5_HOS_C6_91),Column 10 (Lease) New Cap Related Csts Bldg & Fixtures (A7_3_C10_1),Column 10 (Lease) New Cap Related Csts Movable Equipment (A7_3_C10_2),Column 5 (Insurance) New Cap Related Csts Bldg & Fixtures (A7_3_C5_1),Column 5 (Insurance) New Cap Related Csts Movable Equipment (A7_3_C5_2),Column 6 (Taxes) New Cap Related Csts Bldg & Fixtures (A7_3_C6_1),Column 6 (Taxes) New Cap Related Csts Movable Equipment (A7_3_C6_2),Column 7 (Other Capital Related Costs) New Cap Related Csts Bldg & Fixtures (A7_3_C7_1),Column 7 (Other Capital Related Costs) New Cap Related Csts Movable Equipment (A7_3_C7_2),Social Service (A_C1_17),"Gift, Flower, Coffee Shop, Canteen (A_C1_190)",Research (A_C1_191),Other Nonreimbursable (A_C1_194),Paramedical Education (A_C1_23),Intensive Care Unit (A_C1_31),Surgical Intensive Care Unit (A_C1_34),Employee Benefits (A_C1_4),Recovery Room (A_C1_51),Delivery Room and Labor Room (A_C1_52),Anesthesiology (A_C1_53),Radiology-Therapeutic (A_C1_55),CT Scan (A_C1_57),MRI (A_C1_58),Cardiac Catheterization (A_C1_59),"Blood Storing, Processing, Trans (A_C1_63)",Clinic (A_C1_90),Observation Beds (Distinct Unit) (A_C1_9201),Social Service (A_C2_17),"Gift, Flower, Coffee Shop, Canteen (A_C2_190)",Research (A_C2_191),Other Nonreimbursable (A_C2_194),Paramedical Education (A_C2_23),Intensive Care Unit (A_C2_31),Surgical Intensive Care Unit (A_C2_34),Recovery Room (A_C2_51),Delivery Room and Labor Room (A_C2_52),Radiology-Therapeutic (A_C2_55),MRI (A_C2_58),Cardiac Catheterization (A_C2_59),"Blood Storing, Processing, Trans (A_C2_63)",Medical Supplies Charged to Patients (A_C2_71),Clinic (A_C2_90),New Capital Buildings and Fixtures (A_C6_1),Social Service (A_C6_17),Intensive Care Unit (A_C6_31),Employee Benefits (A_C6_4),Delivery Room and Labor Room (A_C6_52),Anesthesiology (A_C6_53),Radiology-Diagnostic (A_C6_54),Radiology-Therapeutic (A_C6_55),Cardiac Catheterization (A_C6_59),Laboratory (A_C6_60),Respiratory Therapy (A_C6_65),Electrocardiology (A_C6_69),Operation of Plant (A_C6_7),Medical Supplies Charged to Patients (A_C6_71),Housekeeping (A_C6_9),Observation Beds (Distinct Unit) (A_C6_9201),Net Expense for Cost Allocation Social Service (B_1_C0_17),"Net Expense for Cost Allocation Gift, Flower, Coffee Shop, Canteen (B_1_C0_190)",Net Expense for Cost Allocation Research (B_1_C0_191),Net Expense for Cost Allocation Paramedical Education (B_1_C0_23),Net Expense for Cost Allocation Intensive Care Unit (B_1_C0_31),Net Expense for Cost Allocation Surgical Intensive Care Unit (B_1_C0_34),Net Expense for Cost Allocation Recovery Room (B_1_C0_51),Net Expense for Cost Allocation Delivery Room and Labor Room (B_1_C0_52),Net Expense for Cost Allocation Radiology-Therapeutic (B_1_C0_55),Net Expense for Cost Allocation MRI (B_1_C0_58),Net Expense for Cost Allocation Cardiac Catheterization (B_1_C0_59),"Net Expense for Cost Allocation Blood Storing, Processing, Trans (B_1_C0_63)",Net Expense for Cost Allocation Impl. Dev. Charged to Patients  (B_1_C0_72),Net Expense for Cost Allocation Laundry and Linen Service (B_1_C0_8),Net Expense for Cost Allocation Clinic (B_1_C0_90),Net Expense for Cost Allocation Observation Beds (Distinct Unit) (B_1_C0_9201),Research (B_1_C26_191),Intensive Care Unit (B_1_C26_31),Surgical Intensive Care Unit (B_1_C26_34),Recovery Room (B_1_C26_51),Delivery Room and Labor Room (B_1_C26_52),Radiology-Therapeutic (B_1_C26_55),MRI (B_1_C26_58),Cardiac Catheterization (B_1_C26_59),"Blood Storing, Processing, Trans (B_1_C26_63)",Impl. Dev. Charged to Patients  (B_1_C26_72),Clinic (B_1_C26_90),Observation Beds (Distinct Unit) (B_1_C26_9201),Research (B_2_C26_191),TOTAL CAPITAL COSTS AFTER COST ALLOCATION Intensive Care Unit (B_2_C26_31),TOTAL CAPITAL COSTS AFTER COST ALLOCATION Surgical Intensive Care Unit (B_2_C26_34),TOTAL CAPITAL COSTS AFTER COST ALLOCATION Recovery Room (B_2_C26_51),TOTAL CAPITAL COSTS AFTER COST ALLOCATION Delivery Room and Labor Room (B_2_C26_52),TOTAL CAPITAL COSTS AFTER COST ALLOCATION Radiology-Therapeutic (B_2_C26_55),TOTAL CAPITAL COSTS AFTER COST ALLOCATION MRI (B_2_C26_58),TOTAL CAPITAL COSTS AFTER COST ALLOCATION Cardiac Catheterization (B_2_C26_59),"Blood Storing, Processing, Trans (B_2_C26_63)",Impl. Dev. Charged to Patients  (B_2_C26_72),Clinic (B_2_C26_90),Observation Beds (Distinct Unit) (B_2_C26_9201),Intensive Care Unit (C_1_C5_31),Surgical Intensive Care Unit (C_1_C5_34),Operating Room (C_1_C5_50),Recovery Room (C_1_C5_51),Delivery Room and Labor Room (C_1_C5_52),Anesthesiology (C_1_C5_53),Radiology-Diagnostic (C_1_C5_54),Radiology-Therapeutic (C_1_C5_55),CT Scan (C_1_C5_57),MRI (C_1_C5_58),Cardiac Catheterization (C_1_C5_59),Laboratory (C_1_C5_60),"Blood Storing, Processing, Trans (C_1_C5_63)",Respiratory Therapy (C_1_C5_65),Physical Therapy (C_1_C5_66),Electrocardiology (C_1_C5_69),Medical Supplies Charged to Patients (C_1_C5_71),Impl. Dev. Charged to Patients  (C_1_C5_72),Drugs Charged to Patients (C_1_C5_73),Clinic (C_1_C5_90),Emergency (C_1_C5_91),Observation Beds (Distinct Unit) (C_1_C5_9201),Total Inpatient Charges Intensive Care Unit (C_1_C6_31),Total Inpatient Charges Surgical Intensive Care Unit (C_1_C6_34),Total Inpatient Charges Recovery Room (C_1_C6_51),Total Inpatient Charges Delivery Room and Labor Room (C_1_C6_52),Total Inpatient Charges Radiology-Therapeutic (C_1_C6_55),Total Inpatient Charges MRI (C_1_C6_58),Total Inpatient Charges Cardiac Catheterization (C_1_C6_59),"Blood Storing, Processing, Trans (C_1_C6_63)",Impl. Dev. Charged to Patients  (C_1_C6_72),Clinic (C_1_C6_90),Observation Beds (Distinct Unit) (C_1_C6_9201),Total Outpatient Charges Recovery Room (C_1_C7_51),Total Outpatient Charges Delivery Room and Labor Room (C_1_C7_52),Total Outpatient Charges Radiology-Therapeutic (C_1_C7_55),Total Outpatient Charges MRI (C_1_C7_58),Total Outpatient Charges Cardiac Catheterization (C_1_C7_59),"Blood Storing, Processing, Trans (C_1_C7_63)",Impl. Dev. Charged to Patients  (C_1_C7_72),Clinic (C_1_C7_90),Observation Beds (Distinct Unit) (C_1_C7_9201),Intensive Care Unit Program Cost (D1_HOS_C5_43),Intensive Care Unit (D3_HOS_C2_31),Surgical Intensive Care Unit (D3_HOS_C2_34),Recovery Room (D3_HOS_C2_51),Delivery Room and Labor Room (D3_HOS_C2_52),Radiology-Therapeutic (D3_HOS_C2_55),MRI (D3_HOS_C2_58),Cardiac Catheterization (D3_HOS_C2_59),"Blood Storing, Processing, Trans (D3_HOS_C2_63)",Impl. Dev. Charged to Patients  (D3_HOS_C2_72),Clinic (D3_HOS_C2_90),Observation Beds (Distinct Unit) (D3_HOS_C2_9201),Recovery Room (D3_HOS_C3_51),Delivery Room and Labor Room (D3_HOS_C3_52),Radiology-Therapeutic (D3_HOS_C3_55),MRI (D3_HOS_C3_58),Cardiac Catheterization (D3_HOS_C3_59),"Blood Storing, Processing, Trans (D3_HOS_C3_63)",Impl. Dev. Charged to Patients  (D3_HOS_C3_72),Clinic (D3_HOS_C3_90),Observation Beds (Distinct Unit) (D3_HOS_C3_9201),Intensive Care Unit (D_1_HOS_C4_31),Surgical Intensive Care Unit (D_1_HOS_C4_34),Intensive Care Unit (D_1_HOS_C6_31),Surgical Intensive Care Unit (D_1_HOS_C6_34),Intensive Care Unit (D_1_HOS_C7_31),Surgical Intensive Care Unit (D_1_HOS_C7_34),Recovery Room (D_4_HOS_C10_51),Delivery Room and Labor Room (D_4_HOS_C10_52),Radiology-Therapeutic (D_4_HOS_C10_55),MRI (D_4_HOS_C10_58),Cardiac Catheterization (D_4_HOS_C10_59),"Blood Storing, Processing, Trans (D_4_HOS_C10_63)",Impl. Dev. Charged to Patients  (D_4_HOS_C10_72),Clinic (D_4_HOS_C10_90),Observation Beds (Distinct Unit) (D_4_HOS_C10_9201),Laboratory (D_4_HOS_C11_60),Operating Room (D_4_HOS_C12_50),Recovery Room (D_4_HOS_C12_51),Delivery Room and Labor Room (D_4_HOS_C12_52),Anesthesiology (D_4_HOS_C12_53),Radiology-Diagnostic (D_4_HOS_C12_54),Radiology-Therapeutic (D_4_HOS_C12_55),CT Scan (D_4_HOS_C12_57),MRI (D_4_HOS_C12_58),Cardiac Catheterization (D_4_HOS_C12_59),Laboratory (D_4_HOS_C12_60),"Blood Storing, Processing, Trans (D_4_HOS_C12_63)",Respiratory Therapy (D_4_HOS_C12_65),Physical Therapy (D_4_HOS_C12_66),Electrocardiology (D_4_HOS_C12_69),Medical Supplies Charged to Patients (D_4_HOS_C12_71),Impl. Dev. Charged to Patients  (D_4_HOS_C12_72),Drugs Charged to Patients (D_4_HOS_C12_73),Clinic (D_4_HOS_C12_90),Emergency (D_4_HOS_C12_91),Observation Beds (Distinct Unit) (D_4_HOS_C12_9201),Laboratory (D_4_HOS_C13_60),Laboratory (D_4_HOS_C3_60),PPS REIMBURSED SERVICES -  CHARGES Operating Room (D_5_HOS_C2_50),PPS REIMBURSED SERVICES -  CHARGES Recovery Room (D_5_HOS_C2_51),PPS REIMBURSED SERVICES -  CHARGES Delivery Room and Labor Room (D_5_HOS_C2_52),PPS REIMBURSED SERVICES -  CHARGES Anesthesiology (D_5_HOS_C2_53),PPS REIMBURSED SERVICES -  CHARGES Radiology-Diagnostic (D_5_HOS_C2_54),PPS REIMBURSED SERVICES -  CHARGES Radiology-Therapeutic (D_5_HOS_C2_55),PPS REIMBURSED SERVICES -  CHARGES CT Scan (D_5_HOS_C2_57),PPS REIMBURSED SERVICES -  CHARGES MRI (D_5_HOS_C2_58),PPS REIMBURSED SERVICES -  CHARGES Cardiac Catheterization (D_5_HOS_C2_59),PPS REIMBURSED SERVICES -  CHARGES Laboratory (D_5_HOS_C2_60),"PPS REIMBURSED SERVICES -  CHARGES Blood Storing, Processing, Trans (D_5_HOS_C2_63)",PPS REIMBURSED SERVICES -  CHARGES Respiratory Therapy (D_5_HOS_C2_65),PPS REIMBURSED SERVICES -  CHARGES Physical Therapy (D_5_HOS_C2_66),PPS REIMBURSED SERVICES -  CHARGES Electrocardiology (D_5_HOS_C2_69),PPS REIMBURSED SERVICES -  CHARGES Medical Supplies Charged to Patients (D_5_HOS_C2_71),PPS REIMBURSED SERVICES -  CHARGES Impl. Dev. Charged to Patients  (D_5_HOS_C2_72),PPS REIMBURSED SERVICES -  CHARGES Drugs Charged to Patients (D_5_HOS_C2_73),PPS REIMBURSED SERVICES -  CHARGES Clinic (D_5_HOS_C2_90),PPS REIMBURSED SERVICES -  CHARGES Emergency (D_5_HOS_C2_91),PPS REIMBURSED SERVICES -  CHARGES Observation Beds (Distinct Unit) (D_5_HOS_C2_9201),COST REIMBURSED SERVICES NOT SUBJECT TO DEDUCTIBLES AND COINSURANCE - CHARGES Drugs Charged to Patients (D_5_HOS_C4_73),PPS SERVICES COST Operating Room (D_5_HOS_C5_50),PPS SERVICES COST Recovery Room (D_5_HOS_C5_51),PPS SERVICES COST Delivery Room and Labor Room (D_5_HOS_C5_52),PPS SERVICES COST Anesthesiology (D_5_HOS_C5_53),PPS SERVICES COST Radiology-Diagnostic (D_5_HOS_C5_54),PPS SERVICES COST Radiology-Therapeutic (D_5_HOS_C5_55),PPS SERVICES COST CT Scan (D_5_HOS_C5_57),PPS SERVICES COST MRI (D_5_HOS_C5_58),PPS SERVICES COST Cardiac Catheterization (D_5_HOS_C5_59),PPS SERVICES COST Laboratory (D_5_HOS_C5_60),"PPS SERVICES COST Blood Storing, Processing, Trans (D_5_HOS_C5_63)",PPS SERVICES COST Respiratory Therapy (D_5_HOS_C5_65),PPS SERVICES COST Physical Therapy (D_5_HOS_C5_66),PPS SERVICES COST Electrocardiology (D_5_HOS_C5_69),PPS SERVICES COST Medical Supplies Charged to Patients (D_5_HOS_C5_71),PPS SERVICES COST Impl. Dev. Charged to Patients  (D_5_HOS_C5_72),PPS SERVICES COST Drugs Charged to Patients (D_5_HOS_C5_73),PPS SERVICES COST Clinic (D_5_HOS_C5_90),PPS SERVICES COST Emergency (D_5_HOS_C5_91),PPS SERVICES COST Observation Beds (Distinct Unit) (D_5_HOS_C5_9201),COST SERVICES NOT SUBJECT TO DEDUCTIBLES AND COINSURANCE - COST Drugs Charged to Patients (D_5_HOS_C7_73),Surgical Intensive Care Unit (S3_1_C2_11),Intensive Care Unit (S3_1_C2_8),Surgical Intensive Care Unit (S3_1_C3_11),Intensive Care Unit (S3_1_C3_8),Surgical Intensive Care Unit (S3_1_C6_11),Intensive Care Unit (S3_1_C6_8),Surgical Intensive Care Unit (S3_1_C7_11),Intensive Care Unit (S3_1_C7_8),Surgical Intensive Care Unit (S3_1_C8_11),Intensive Care Unit (S3_1_C8_8),Speech Pathology (A_C1_68),Occupational Therapy (A_C2_67),Speech Pathology (A_C2_68),Drugs Charged to Patients (A_C2_73),Laundry and Linen Service (A_C2_8),Net Expense for Cost Allocation Speech Pathology (B_1_C0_68),Speech Pathology (B_1_C26_68),Speech Pathology (B_2_C26_68),Occupational Therapy (C_1_C5_67),Speech Pathology (C_1_C5_68),Speech Pathology (C_1_C6_68),Speech Pathology (D3_HOS_C2_68),Speech Pathology (D3_HOS_C3_68),Speech Pathology (D_4_HOS_C10_68),Medical Supplies Charged to Patients (A_C1_71),RHC (A_C1_88),RHC (A_C2_88),Other Nonreimbursable (A_C6_194),Net Expense for Cost Allocation RHC (B_1_C0_88),RHC (B_1_C26_88),RHC (B_2_C26_88),RHC (C_1_C5_88),RHC (C_1_C7_88),Operating Room (D3_IPF_C2_50),Operating Room (D3_IPF_C3_50),Radiology-Diagnostic (D3_SNF_C2_54),Laboratory (D3_SNF_C2_60),Physical Therapy (D3_SNF_C2_66),Drugs Charged to Patients (D3_SNF_C2_73),Radiology-Diagnostic (D3_SNF_C3_54),Laboratory (D3_SNF_C3_60),Physical Therapy (D3_SNF_C3_66),Drugs Charged to Patients (D3_SNF_C3_73),RHC/FQHC Combined (S3_1_C10_26),RHC/FQHC Combined (S3_1_C6_26),RHC/FQHC Combined (S3_1_C8_26),Laundry and Linen Service (A_C1_8),Dietary (A_C6_10),Clinic (A_C6_90),COST REIMBURSED SERVICES SUBJECT TO DEDUCTIBLES  AND COINSURANCE - CHARGES Impl. Dev. Charged to Patients  (D_5_HOS_C3_72),COST REIMBURSED SERVICES SUBJECT TO DEDUCTIBLES  AND COINSURANCE - CHARGES Clinic (D_5_HOS_C3_90),COST SERVICES SUBJECT TO DEDUCTIBLES AND COINSURANCE - COST Impl. Dev. Charged to Patients  (D_5_HOS_C6_72),COST SERVICES SUBJECT TO DEDUCTIBLES AND COINSURANCE - COST Clinic (D_5_HOS_C6_90),HHA (A_C1_101),Hospice (A_C1_116),Nonpaid Workers (A_C1_193),Drugs Charged to Patients (A_C1_73),Other Ancillary (A_C1_76),HHA (A_C2_101),Hospice (A_C2_116),Other General Service (A_C2_18),Nonpaid Workers (A_C2_193),Impl. Dev. Charged to Patients  (A_C2_72),Other Ancillary (A_C2_76),Central Services and Supply (A_C6_14),Physical Therapy (A_C6_66),Drugs Charged to Patients (A_C6_73),Net Expense for Cost Allocation HHA (B_1_C0_101),Net Expense for Cost Allocation Hospice (B_1_C0_116),Net Expense for Cost Allocation Other General Service (B_1_C0_18),Net Expense for Cost Allocation Nonpaid Workers (B_1_C0_193),Net Expense for Cost Allocation Other Ancillary (B_1_C0_76),HHA (B_1_C26_101),Hospice (B_1_C26_116),Nonpaid Workers (B_1_C26_193),Other Ancillary (B_1_C26_76),HHA (B_2_C26_101),Hospice (B_2_C26_116),Nonpaid Workers (B_2_C26_193),Other Ancillary (B_2_C26_76),HHA (C_1_C5_101),Hospice (C_1_C5_116),Other Ancillary (C_1_C5_76),HHA (C_1_C7_101),Hospice (C_1_C7_116),Speech Pathology (C_1_C7_68),Other Ancillary (C_1_C7_76),Occupational Therapy (D_4_HOS_C12_67),Speech Pathology (D_4_HOS_C12_68),Other Ancillary (D_4_HOS_C12_76),PPS REIMBURSED SERVICES -  CHARGES Occupational Therapy (D_5_HOS_C2_67),PPS REIMBURSED SERVICES -  CHARGES Speech Pathology (D_5_HOS_C2_68),PPS REIMBURSED SERVICES -  CHARGES Other Ancillary (D_5_HOS_C2_76),COST REIMBURSED SERVICES NOT SUBJECT TO DEDUCTIBLES AND COINSURANCE - CHARGES Clinic (D_5_HOS_C4_90),PPS SERVICES COST Occupational Therapy (D_5_HOS_C5_67),PPS SERVICES COST Speech Pathology (D_5_HOS_C5_68),PPS SERVICES COST Other Ancillary (D_5_HOS_C5_76),COST SERVICES NOT SUBJECT TO DEDUCTIBLES AND COINSURANCE - COST Clinic (D_5_HOS_C7_90),HHA (S3_1_C10_22),Hospice (S3_1_C10_24),HHA (S3_1_C6_22),HHA (S3_1_C8_22),Hospice (S3_1_C8_24),Nursing School (A_C1_20),Coronary Care Unit (A_C1_32),Other Special Care Unit (A_C1_35),Maintenance and Repairs (A_C1_6),Intravenous Therapy (A_C1_64),Nursing School (A_C2_20),Coronary Care Unit (A_C2_32),Other Special Care Unit (A_C2_35),Maintenance and Repairs (A_C2_6),Pharmacy (A_C6_15),Nursing School (A_C6_20),Paramedical Education (A_C6_23),Coronary Care Unit (A_C6_32),Surgical Intensive Care Unit (A_C6_34),Other Special Care Unit (A_C6_35),Maintenance and Repairs (A_C6_6),Other Ancillary (A_C6_76),Laundry and Linen Service (A_C6_8),Net Expense for Cost Allocation Nursing School (B_1_C0_20),Net Expense for Cost Allocation Interns & Res Salary and Fringe Benefits (B_1_C0_21),Net Expense for Cost Allocation Coronary Care Unit (B_1_C0_32),Net Expense for Cost Allocation Other Special Care Unit (B_1_C0_35),Net Expense for Cost Allocation Maintenance and Repairs (B_1_C0_6),Net Expense for Cost Allocation Intravenous Therapy (B_1_C0_64),Allocation of Interns & Residents Salary and Fringes Interns & Res Salary and Fringe Benefits (B_1_C21_21),Allocation of Interns & Residents Salary and Fringes Coronary Care Unit (B_1_C21_32),Allocation of Interns & Residents Salary and Fringes Surgical Intensive Care Unit (B_1_C21_34),Allocation of Interns & Residents Salary and Fringes Other Special Care Unit (B_1_C21_35),Allocation of Interns & Residents Salary and Fringes Operating Room (B_1_C21_50),Clinic (B_1_C21_90),Emergency (B_1_C21_91),Coronary Care Unit (B_1_C26_32),Other Special Care Unit (B_1_C26_35),Intravenous Therapy (B_1_C26_64),TOTAL CAPITAL COSTS AFTER COST ALLOCATION Coronary Care Unit (B_2_C26_32),TOTAL CAPITAL COSTS AFTER COST ALLOCATION Other Special Care Unit (B_2_C26_35),Intravenous Therapy (B_2_C26_64),Coronary Care Unit (C_1_C5_32),Other Special Care Unit (C_1_C5_35),Intravenous Therapy (C_1_C5_64),Total Inpatient Charges Coronary Care Unit (C_1_C6_32),Total Inpatient Charges Other Special Care Unit (C_1_C6_35),Intravenous Therapy (C_1_C6_64),Other Ancillary (C_1_C6_76),Intravenous Therapy (C_1_C7_64),Coronary Care Unit (D3_HOS_C2_32),Intravenous Therapy (D3_HOS_C2_64),Other Ancillary (D3_HOS_C2_76),Intravenous Therapy (D3_HOS_C3_64),Other Ancillary (D3_HOS_C3_76),Radiology-Diagnostic (D3_IRF_C2_54),CT Scan (D3_IRF_C2_57),Laboratory (D3_IRF_C2_60),Intravenous Therapy (D3_IRF_C2_64),Respiratory Therapy (D3_IRF_C2_65),Physical Therapy (D3_IRF_C2_66),Occupational Therapy (D3_IRF_C2_67),Speech Pathology (D3_IRF_C2_68),Electrocardiology (D3_IRF_C2_69),Drugs Charged to Patients (D3_IRF_C2_73),Other Ancillary (D3_IRF_C2_76),Clinic (D3_IRF_C2_90),Radiology-Diagnostic (D3_IRF_C3_54),CT Scan (D3_IRF_C3_57),Laboratory (D3_IRF_C3_60),Intravenous Therapy (D3_IRF_C3_64),Respiratory Therapy (D3_IRF_C3_65),Physical Therapy (D3_IRF_C3_66),Occupational Therapy (D3_IRF_C3_67),Speech Pathology (D3_IRF_C3_68),Electrocardiology (D3_IRF_C3_69),Drugs Charged to Patients (D3_IRF_C3_73),Other Ancillary (D3_IRF_C3_76),Clinic (D3_IRF_C3_90),Coronary Intensive Care Unit (D_1_HOS_C4_32),Other Special Care Unit (D_1_HOS_C4_35),Coronary Intensive Care Unit (D_1_HOS_C6_32),Coronary Intensive Care Unit (D_1_HOS_C7_32),Coronary Care Unit (D_3_HOS_C9_32),Surgical Intensive Care Unit (D_3_HOS_C9_34),Intravenous Therapy (D_4_HOS_C10_64),Other Ancillary (D_4_HOS_C10_76),Operating Room (D_4_HOS_C11_50),Radiology-Diagnostic (D_4_HOS_C11_54),Drugs Charged to Patients (D_4_HOS_C11_73),Emergency (D_4_HOS_C11_91),Intravenous Therapy (D_4_HOS_C12_64),Operating Room (D_4_HOS_C13_50),Radiology-Diagnostic (D_4_HOS_C13_54),Drugs Charged to Patients (D_4_HOS_C13_73),Emergency (D_4_HOS_C13_91),Operating Room (D_4_HOS_C2_50),Delivery Room and Labor Room (D_4_HOS_C2_52),Emergency (D_4_HOS_C2_91),Radiology-Diagnostic (D_4_HOS_C3_54),Drugs Charged to Patients (D_4_HOS_C3_73),Radiology-Diagnostic (D_4_IRF_C11_54),Laboratory (D_4_IRF_C11_60),Drugs Charged to Patients (D_4_IRF_C11_73),PPS REIMBURSED SERVICES -  CHARGES Intravenous Therapy (D_5_HOS_C2_64),PPS SERVICES COST Intravenous Therapy (D_5_HOS_C5_64),Coronary Care Unit (S3_1_C2_9),Coronary Care Unit (S3_1_C3_9),Coronary Care Unit (S3_1_C6_9),Coronary Care Unit (S3_1_C7_9),Coronary Care Unit (S3_1_C8_9),Radioisotope (A_C1_56),Electroencephalography (A_C1_70),Radioisotope (A_C2_56),Electroencephalography (A_C2_70),Nursing Administration (A_C6_13),Recovery Room (A_C6_51),Radioisotope (A_C6_56),CT Scan (A_C6_57),MRI (A_C6_58),Net Expense for Cost Allocation Radioisotope (B_1_C0_56),Net Expense for Cost Allocation Electroencephalography (B_1_C0_70),Radioisotope (B_1_C26_56),Electroencephalography (B_1_C26_70),TOTAL CAPITAL COSTS AFTER COST ALLOCATION Radioisotope (B_2_C26_56),Electroencephalography (B_2_C26_70),Radioisotope (C_1_C5_56),Electroencephalography (C_1_C5_70),Total Inpatient Charges Radioisotope (C_1_C6_56),Electroencephalography (C_1_C6_70),Total Outpatient Charges Radioisotope (C_1_C7_56),Electroencephalography (C_1_C7_70),Radioisotope (D3_HOS_C2_56),Electroencephalography (D3_HOS_C2_70),Radioisotope (D3_HOS_C3_56),Electroencephalography (D3_HOS_C3_70),Radioisotope (D_4_HOS_C10_56),Electroencephalography (D_4_HOS_C10_70),COST REIMBURSED SERVICES SUBJECT TO DEDUCTIBLES  AND COINSURANCE - CHARGES Radiology-Therapeutic (D_5_HOS_C3_55),COST REIMBURSED SERVICES SUBJECT TO DEDUCTIBLES  AND COINSURANCE - CHARGES MRI (D_5_HOS_C3_58),COST REIMBURSED SERVICES SUBJECT TO DEDUCTIBLES  AND COINSURANCE - CHARGES Speech Pathology (D_5_HOS_C3_68),COST REIMBURSED SERVICES NOT SUBJECT TO DEDUCTIBLES AND COINSURANCE - CHARGES Emergency (D_5_HOS_C4_91),COST SERVICES SUBJECT TO DEDUCTIBLES AND COINSURANCE - COST Radiology-Therapeutic (D_5_HOS_C6_55),COST SERVICES SUBJECT TO DEDUCTIBLES AND COINSURANCE - COST MRI (D_5_HOS_C6_58),COST SERVICES SUBJECT TO DEDUCTIBLES AND COINSURANCE - COST Speech Pathology (D_5_HOS_C6_68),COST SERVICES NOT SUBJECT TO DEDUCTIBLES AND COINSURANCE - COST Emergency (D_5_HOS_C7_91),ASC (Non Distinct Part) (A_C1_75),ASC (Non Distinct Part) (A_C2_75),Net Expense for Cost Allocation ASC (Non Distinct Part) (B_1_C0_75),ASC (Non Distinct Part) (B_1_C26_75),ASC (Non Distinct Part) (B_2_C26_75),ASC (Non Distinct Part) (C_1_C5_75),ASC (Non Distinct Part) (C_1_C6_75),ASC (Non Distinct Part) (C_1_C7_75),ASC (Non Distinct Part) (D3_HOS_C2_75),ASC (Non Distinct Part) (D3_HOS_C3_75),ASC (Non Distinct Part) (D_4_HOS_C10_75),Radioisotope (D_4_HOS_C12_56),ASC (Non Distinct Part) (D_4_HOS_C12_75),PPS REIMBURSED SERVICES -  CHARGES Radioisotope (D_5_HOS_C2_56),PPS REIMBURSED SERVICES -  CHARGES ASC (Non Distinct Part) (D_5_HOS_C2_75),PPS SERVICES COST Radioisotope (D_5_HOS_C5_56),PPS SERVICES COST ASC (Non Distinct Part) (D_5_HOS_C5_75),Interns & Res Salary and Fringe Benefits (A_C1_21),Other Outpatient Services (A_C1_93),Interns & Res Salary and Fringe Benefits (A_C2_21),Other Outpatient Services (A_C2_93),Nonphysician Anesthetists (A_C6_19),"Gift, Flower, Coffee Shop, Canteen (A_C6_190)",Interns & Res Salary and Fringe Benefits (A_C6_21),Interns & Res Other Program Costs (A_C6_22),Net Expense for Cost Allocation Interns & Res Other Program Costs (B_1_C0_22),Net Expense for Cost Allocation Other Outpatient Services (B_1_C0_93),"Gift, Flower, Coffee Shop, Canteen (B_1_C21_190)",Allocation of Interns & Residents Salary and Fringes Intensive Care Unit (B_1_C21_31),Allocation of Interns & Residents Salary and Fringes Delivery Room and Labor Room (B_1_C21_52),Other Outpatient Services (B_1_C21_93),"Gift, Flower, Coffee Shop, Canteen (B_1_C22_190)",Allocation of Interns & Residents Program Costs Intensive Care Unit (B_1_C22_31),Allocation of Interns & Residents Program Costs Operating Room (B_1_C22_50),Allocation of Interns & Residents Program Costs Delivery Room and Labor Room (B_1_C22_52),Clinic (B_1_C22_90),Emergency (B_1_C22_91),Other Outpatient Services (B_1_C22_93),Other Outpatient Services (B_1_C26_93),Other Outpatient Services (B_2_C26_93),Other Outpatient Services (C_1_C5_93),Other Outpatient Services (C_1_C6_93),Other Outpatient Services (C_1_C7_93),Other Outpatient Services (D3_HOS_C2_93),Other Outpatient Services (D3_HOS_C3_93),Recovery Room (D3_IPF_C2_51),Anesthesiology (D3_IPF_C2_53),Radiology-Diagnostic (D3_IPF_C2_54),CT Scan (D3_IPF_C2_57),MRI (D3_IPF_C2_58),Laboratory (D3_IPF_C2_60),Respiratory Therapy (D3_IPF_C2_65),Physical Therapy (D3_IPF_C2_66),Electrocardiology (D3_IPF_C2_69),Medical Supplies Charged to Patients (D3_IPF_C2_71),Impl. Dev. Charged to Patients  (D3_IPF_C2_72),Drugs Charged to Patients (D3_IPF_C2_73),Emergency (D3_IPF_C2_91),Recovery Room (D3_IPF_C3_51),Anesthesiology (D3_IPF_C3_53),Radiology-Diagnostic (D3_IPF_C3_54),CT Scan (D3_IPF_C3_57),MRI (D3_IPF_C3_58),Laboratory (D3_IPF_C3_60),Respiratory Therapy (D3_IPF_C3_65),Physical Therapy (D3_IPF_C3_66),Electrocardiology (D3_IPF_C3_69),Medical Supplies Charged to Patients (D3_IPF_C3_71),Impl. Dev. Charged to Patients  (D3_IPF_C3_72),Drugs Charged to Patients (D3_IPF_C3_73),Emergency (D3_IPF_C3_91),Operating Room (D3_IRF_C2_50),Recovery Room (D3_IRF_C2_51),Anesthesiology (D3_IRF_C2_53),Radiology-Therapeutic (D3_IRF_C2_55),MRI (D3_IRF_C2_58),Medical Supplies Charged to Patients (D3_IRF_C2_71),Impl. Dev. Charged to Patients  (D3_IRF_C2_72),Operating Room (D3_IRF_C3_50),Recovery Room (D3_IRF_C3_51),Anesthesiology (D3_IRF_C3_53),Radiology-Therapeutic (D3_IRF_C3_55),MRI (D3_IRF_C3_58),Medical Supplies Charged to Patients (D3_IRF_C3_71),Impl. Dev. Charged to Patients  (D3_IRF_C3_72),Intensive Care Unit (D_3_HOS_C9_31),Other Outpatient Services (D_4_HOS_C10_93),Anesthesiology (D_4_HOS_C11_53),Cardiac Catheterization (D_4_HOS_C11_59),Respiratory Therapy (D_4_HOS_C11_65),Electrocardiology (D_4_HOS_C11_69),Other Ancillary (D_4_HOS_C11_76),Clinic (D_4_HOS_C11_90),Other Outpatient Services (D_4_HOS_C11_93),Other Outpatient Services (D_4_HOS_C12_93),Anesthesiology (D_4_HOS_C13_53),Cardiac Catheterization (D_4_HOS_C13_59),Respiratory Therapy (D_4_HOS_C13_65),Electrocardiology (D_4_HOS_C13_69),Other Ancillary (D_4_HOS_C13_76),Clinic (D_4_HOS_C13_90),Other Outpatient Services (D_4_HOS_C13_93),Operating Room (D_4_HOS_C3_50),Anesthesiology (D_4_HOS_C3_53),Cardiac Catheterization (D_4_HOS_C3_59),Respiratory Therapy (D_4_HOS_C3_65),Electrocardiology (D_4_HOS_C3_69),Other Ancillary (D_4_HOS_C3_76),Clinic (D_4_HOS_C3_90),Emergency (D_4_HOS_C3_91),Other Outpatient Services (D_4_HOS_C3_93),Anesthesiology (D_4_IPF_C11_53),Electrocardiology (D_4_IPF_C11_69),Drugs Charged to Patients (D_4_IPF_C11_73),Emergency (D_4_IPF_C11_91),Operating Room (D_4_IRF_C11_50),Anesthesiology (D_4_IRF_C11_53),Respiratory Therapy (D_4_IRF_C11_65),Electrocardiology (D_4_IRF_C11_69),PPS REIMBURSED SERVICES -  CHARGES Other Outpatient Services (D_5_HOS_C2_93),COST REIMBURSED SERVICES NOT SUBJECT TO DEDUCTIBLES AND COINSURANCE - CHARGES Operating Room (D_5_HOS_C4_50),COST REIMBURSED SERVICES NOT SUBJECT TO DEDUCTIBLES AND COINSURANCE - CHARGES Recovery Room (D_5_HOS_C4_51),COST REIMBURSED SERVICES NOT SUBJECT TO DEDUCTIBLES AND COINSURANCE - CHARGES Cardiac Catheterization (D_5_HOS_C4_59),COST REIMBURSED SERVICES NOT SUBJECT TO DEDUCTIBLES AND COINSURANCE - CHARGES Observation Beds (Distinct Unit) (D_5_HOS_C4_9201),COST REIMBURSED SERVICES NOT SUBJECT TO DEDUCTIBLES AND COINSURANCE - CHARGES Other Outpatient Services (D_5_HOS_C4_93),PPS SERVICES COST Other Outpatient Services (D_5_HOS_C5_93),COST SERVICES NOT SUBJECT TO DEDUCTIBLES AND COINSURANCE - COST Operating Room (D_5_HOS_C7_50),COST SERVICES NOT SUBJECT TO DEDUCTIBLES AND COINSURANCE - COST Recovery Room (D_5_HOS_C7_51),COST SERVICES NOT SUBJECT TO DEDUCTIBLES AND COINSURANCE - COST Cardiac Catheterization (D_5_HOS_C7_59),COST SERVICES NOT SUBJECT TO DEDUCTIBLES AND COINSURANCE - COST Observation Beds (Distinct Unit) (D_5_HOS_C7_9201),COST SERVICES NOT SUBJECT TO DEDUCTIBLES AND COINSURANCE - COST Other Outpatient Services (D_5_HOS_C7_93),Other Special Care (S3_1_C2_12),Other Special Care (S3_1_C3_12),Other Special Care (S3_1_C7_12),Other Special Care (S3_1_C8_12),Electroencephalography (D_4_HOS_C12_70),PPS REIMBURSED SERVICES -  CHARGES Electroencephalography (D_5_HOS_C2_70),PPS SERVICES COST Electroencephalography (D_5_HOS_C5_70),COST REIMBURSED SERVICES NOT SUBJECT TO DEDUCTIBLES AND COINSURANCE - CHARGES Other Ancillary (D_5_HOS_C4_76),COST SERVICES NOT SUBJECT TO DEDUCTIBLES AND COINSURANCE - COST Other Ancillary (D_5_HOS_C7_76),COST REIMBURSED SERVICES NOT SUBJECT TO DEDUCTIBLES AND COINSURANCE - CHARGES Laboratory (D_5_HOS_C4_60),COST SERVICES NOT SUBJECT TO DEDUCTIBLES AND COINSURANCE - COST Laboratory (D_5_HOS_C7_60),Speech Pathology (D3_IPF_C2_68),Speech Pathology (D3_IPF_C3_68),"COST REIMBURSED SERVICES SUBJECT TO DEDUCTIBLES  AND COINSURANCE - CHARGES Blood Storing, Processing, Trans (D_5_HOS_C3_63)",COST REIMBURSED SERVICES SUBJECT TO DEDUCTIBLES  AND COINSURANCE - CHARGES Other Ancillary (D_5_HOS_C3_76),"COST SERVICES SUBJECT TO DEDUCTIBLES AND COINSURANCE - COST Blood Storing, Processing, Trans (D_5_HOS_C6_63)",COST SERVICES SUBJECT TO DEDUCTIBLES AND COINSURANCE - COST Other Ancillary (D_5_HOS_C6_76),RHC/FQHC Combined (S3_1_C7_26),Lat,Lon,"Control type, text","Hospital type, text",Num and Name
2931,697025.0,330106,13001,2021-08-25 00:00:00,2020-01-01 00:00:00,2020-12-31,F,33,33400,2.0,2.0,5380,,,,,,,,,,83440.0,,,,,,,,,,,,,,,,,,,,,,,,,-3359570.0,,3080434.0,10270.0,,,,,,,,,,,,,,4159815.0,1389311.0,,,,,,,,,,,,,,,-23299.0,,,,,,,,,,,,,,-4121737.0,,-18450140.0,,7791904.0,1882649.0,,,,,,,,,,,,,,,,,,,,,,,,5439.0,,,,,,,,,,,,,,,,,26531.0,,,,11982127.0,2941301.0,,,,,,,,,,,,,,365582.0,306946.0,,,,,,,,,,,,,11982127.0,2941301.0,,,,,,,,,,,,,,6404978.0,1809486.0,,,,,,,,,,,,,,,,,,,,,,,,,,,,,,,,,,,,,,,,,,,,,,,,,,,,,,,,,,,,,,,,,,,,,,,,,,,,,,,,,,,560.0,,,,,,,,,,,,,,,,,,,,,,,,,,,342703.0,,,,,,,,,,,,,,,,,,,,,,,,,,,,,,,,,,,,,,,,,,,,,,,,,,,,,,4525041.0,,,1621789.0,,,,18619413.0,,,,,,,,,,,,,,,,,,,4525041.0,,,,,,18619413.0,,,,,,,516259.97,,,,,,,,36.07,,,,,439.0,3509.0,,,,,,,,,,,,,,,,,,,,,,,,,,,,,,,,,,,,,,,,,,,,,,,,,,,,,,,,,,,,,,,,,,,,,,,,,,6846241.0,778056844.0,552604379.0,206623437.0,778056844.0,75697093.0,29687056.0,75697093.0,,95499942.0,55407215.0,-482831061.0,-2919557.0,,-1383618.0,,-1222321087.0,-20272.0,,1593870687.0,125565779.0,7996232.0,1303970158.0,12194670.0,-1222321087.0,-4499767.0,1675519758.0,132959990.0,1621283406.0,330719822.0,95499942.0,25638508.0,1543544314.0,5160314337.0,1938968861.0,2190471346.0,7350785683.0,,330889541.0,330889541.0,120489148.0,145687943.0,298614385.0,682790867.0,145687943.0,457886.0,140292.0,145295.0,91230.0,9597814.0,45610111.0,51451819.0,51443136.0,51924577.0,51924693.0,51499676.0,82314.0,0.209984,1.0,13263.1,13263.1,611.0,782.0,802.0,611.0,223626.0,286212.0,223626.0,,,,74036.0,85597.0,51358.0,,74036.0,202537.0,255945.0,782.0,,,202537.0,2765216.0,,9217571.0,,,173752.0,45449345.0,,,,60686579.0,34822388.0,60686579.0,,37077205.0,,,,-6612614.0,8087397.0,,14074.0,,,8101471.0,14892108.0,1287637.0,315306.0,1560951095.0,1272658.0,1559678437.0,330889541.0,14892108.0,67934362.0,11264756.0,6152607.0,17417363.0,281197022.0,258500.0,203319.0,9690.0,86294.0,74036.0,11123047.0,9335940.0,258500.0,86294.0,110013.0,396039487.0,32403.0,326708.0,326708.0,396039487.0,20386.0,77720044.0,5003.0,478272.0,478272.0,478272.0,332977.0,77687641.0,55153860.0,54973973.0,8683.0,740678.0,481441.0,,147484.0,3955410.0,13228.0,28629.0,8.0,2928.0,,8942.0,247.0,13228.0,28865.0,502.0,8942.0,9690.0,3071.0,1593870687.0,118771063.0,7944316.0,,338633179.0,48353480.0,,3923349.0,71550788.0,13901266.0,169568777.0,3991410.0,,16381304.0,15038055.0,14884594.0,25744742.0,909822.0,22093714.0,15140869.0,4238609.0,3578095.0,384479395.0,1593870688.0,129526097.0,7944316.0,,338633179.0,48353480.0,,3923349.0,71550788.0,13901266.0,168785937.0,3991410.0,,16381304.0,15038055.0,14870550.0,1621789.0,25744742.0,909822.0,22093714.0,14683768.0,4238609.0,3574994.0,384479395.0,24077171.67,2175866.55,55219.75,,209972.37,955112.9,18080.36,,497894.4,577567.57,497053.77,58924.08,417892.58,30137.75,96682.39,263360.62,175890.0,91235.09,1935477.19,66.2,59.53,143.87,,66.21,176.72,220.76,,32.9,26.04,29.92,27.52,61.61,30.19,228.52,55.76,24.1,39.18,198.65,1161856273.0,137390476.0,1024465797.0,7944316.0,342556528.0,1374966641.0,1159534420.0,148145510.0,1011388910.0,7944316.0,342556528.0,1361889754.0,287119586.0,21399891.42,2692126.52,18707764.9,55219.75,18762984.65,3888963.46,54.18,55.03,54.06,143.87,33.87,72.58,73.83,,18619413.0,41976170.0,15880.0,859044.0,9321543.0,3024659.0,19423556.0,32847573.0,5854122.0,49158088.0,53316993.0,2582325.0,7888011.0,5854122.0,49158088.0,53316993.0,10611159.0,53134105.0,255287899.0,5854122.0,5854122.0,118790.0,2420159.0,2320629.0,49158088.0,,4443477.0,475745.0,118790.0,12457778.0,4443477.0,,,,,,,-54901.0,25054732.0,726019.0,,,439134.0,7531664.0,553375.0,3963302.0,8322326.0,221955.0,8322326.0,5134601.0,3416.0,1207336.0,1955587.0,676.0,676.0,,,1095.0,,,,,,502.0,17134.0,,,,1529785.0,,,,,1529785.0,,,54853.25,,,,27.89,,124346.0,28906750.0,12593.0,829456.0,21322.0,4550265.0,1185.0,134750.0,4637.0,1065280.0,2301.0,31426.0,1141.0,263550.0,51.0,151446.0,34785845.0,15333.0,1236.0,999141.0,,,,,,,,,,,,,,,,,,,,100456.0,,,,,,,,,,,,,,,,,,,,,632449.0,237310.0,139188.0,,,,,,5841708.0,189.0,21.0,,,,,,357.39,867.92,1847555.0,1847555.0,40988.72,45.07,386940.0,,,,,,,,,,,,3008779.0,,490004.0,,243190.0,,2301369.0,95601.0,3929.0,99530.0,4521745.0,,,1773.0,697.0,95601.0,632449.0,,40.0,325239.0,325239.0,-116.0,,11888541.0,55037994.0,20.0,7320.0,697.0,1773.0,7948565.0,,26514147.0,7948565.0,,28836001.0,,643986.95,,44.78,26.0,,,,,,,,,438.0,,,,,,,,,,,,,,,,,,,,,,,,,,,,,,,,,,,,,,,,,,,,,,,,,,,,,,,04/04/2008,,02/21/2019,,,,,,,,,,,300 COMMUNITY DRIVE,MANHASSET,NY,10030,NASSAU,NORTH SHORE UNIVERSITY HOSPITAL,35004,P,,2,HB2348,NORTHWELL HEALTHCARE INC,972 BRUSH HOLLOW RD,WESTBURY,NY,11590,NSUH PSYCHIATRIC EXEMPT UNIT,33S106,335702,,,,,337148,,,,,,,,,1621789.0,,,,,137890161.0,,3523859.0,,,,,,,,,,,,,,12398.0,,,,,,1441122.0,,,,,,,,,,,,,,,,,,,,-177579863.0,-6255063.0,,,,,-1729919.0,,,,-97714.0,-177694.0,,,,,,,,,,,,,,,,,,,,,,,,,,,,,,,,,,1587.0,,,,,,,23201.0,182.0,7625.0,2576.0,1627.0,,28666.0,,,,,507.0,,,22368.0,,,,,25933.0,,,,,,,,,,,209268.0,,,,1262465.0,,638094.0,526599.0,,,3058389.0,24015.0,1005170.0,339630.0,214413.0,,3778819.0,,,,,66897.0,,,2948611.0,,,,,3418605.0,,,,,,,,,,,,,,,,,,,,,,,,,,,,,,,,,,,,,,,,,,,,,,,,,,,,,,,,,,,,,,,,,,,,,,,,,,,,,,,,,,,,,,,,5035696.0,,,,,,,,,,,,,,,,,,,,,,,,,,,,,,,75924.0,,,,,,,,,,,,,,,,37333.0,,,,,,,,,,,,,,,,,,,,,,,,,,,,,,,,,,,,,,,,,,,,,,,,1241.0,,,,898794.0,3413.0,,,,,,,,,,,,,,,,,,,,,,355.0,,,,436767.0,494.0,,,,,,,,,,,,,,,,,,,,,,,,,,,,,,,,,,,,,,,968.0,,,,,,,,,,,,,,,,,,,,,,,19653.0,,,,,,,,,,,,,,,,,,,,,,,,,,,,,,,,,,,,,,,,,,,,,,,,,,,,,,60717.0,,,,,,,,,,,,,,,,,,,,,,,,,,,,,,,,,,,,,,,,,,,,,,,,,,,,,,,,,,,,,,,,,,,,,,,,,,,,,,,,,,,,,,,,,,,,,,,,,,,,,,,,,,,,,,,,,,,,,,,,,,,,,,,,,,,,,,,,,,,,,,,,,,,,,,,,,,,,,560.0,,,,,,,,,,,,,,,,,,,,,,,,,,,,,,,,,,,,,,,,,,,,,,,,,,,,,,,,,,,,,,,,,,,,,,,,,,,,,,,,,,,,,,,,,,,,,,,,,,,,,,,,,,,,,,,,,,,,510.53,,,,,40385123.0,55114819.0,31265332.0,24141883.0,-725194395.0,14884594.0,25744742.0,909822.0,15140869.0,4238609.0,,169568777.0,198894841.0,74764926.0,48500716.0,8557738.0,11218040.0,,30251449.0,16381304.0,15038055.0,67896340.0,57585341.0,9469375.0,1493892.0,8749020.0,4083763.0,1389065.0,,56550252.0,169551314.0,177953682.0,83974100.0,,30482604.0,2311506.0,82906281.0,2684141.0,230307.0,3717712.0,25803164.0,3388523.0,17246104.0,-2919557.0,,-1782194.0,-65402383.0,-192183918.0,-37386194.0,40385123.0,24339781.0,-1285370.0,27238634.0,9658842.0,18767531.0,5627674.0,,32731713.0,55114819.0,182050069.0,285577489.0,76122273.0,,25660626.0,7710933.0,58667359.0,8989916.0,11448347.0,,26598789.0,38824898.0,,44100146.0,18426578.0,43788488.0,821485.0,6380271.0,46354654.0,136923859.0,,66233721.0,15349937.0,95198139.0,15129274.0,18556184.0,,55431011.0,,55202284.0,77941084.0,295673.0,1680990.0,2471628.0,9457714.0,,12132948.0,404693.0,3611641.0,413435.0,414422.0,,4201671.0,,491805.0,3307614.0,248954738.0,,82203389.0,139767652.0,518768757.0,143928853.0,47171020.0,,282182035.0,,156828416.0,121249972.0,191333713.0,,311910795.0,256151797.0,227370626.0,1656882.0,645585.0,,142193213.0,,68084619.0,141935106.0,69033557.0,,26519752.0,51319645.0,164836719.0,58187267.0,13151288.0,,85502120.0,,52039761.0,35390381.0,21985738.0,,6193360.0,1989663.0,17562633.0,6051068.0,5103620.0,,10879689.0,,12772535.0,10706263.0,69033557.0,,26519752.0,51319645.0,164836719.0,58187267.0,13151288.0,,85502120.0,,52039761.0,35390381.0,,,,,447.0,,,,,,1290.0,,,,,,43.0,,,,,,317.0,,7738152.0,29339053.0,,,,,,,3578095.0,,12832318.0,10331940.0,303149.0,18496339.0,28117466.0,13901266.0,12543431.0,13573089.0,,15911308.0,5502638.0,5166699.0,,3914580.0,283626483.0,750852.0,12233.0,3081.0,4214271.0,43406163.0,11475.0,3993922.0,4866676.0,459121.0,2636546.0,3120981.0,3071944.0,,14240043.0,,172764139.0,-20274505.0,,-9138049.0,-1876961.0,,,-74776297.0,-5891984.0,,-70722352.0,-2136964.0,-5729111.0,-3359570.0,,,-102023.0,3587227.0,3081.0,25104759.0,658429.0,12294054.0,28460548.0,13002552.0,16209635.0,12635423.0,7987522.0,,16424704.0,98080409.0,4610110.0,2404375.0,666028.0,36511083.0,29031189.0,54427262.0,23878917.0,28012190.0,18879385.0,15969219.0,,23345233.0,122365020.0,34739780.0,1835738.0,482241.0,2121765.0,1482462.0,731602.0,1305785.0,191099.0,1690099.0,,501386.0,1093793.0,1769306.0,222176.0,29464960.0,54517746.0,140222483.0,23878917.0,28012190.0,,66269964.0,19052108.0,15349937.0,15969219.0,,95736430.0,23345233.0,15139868.0,18556184.0,55527237.0,,122365020.0,55202284.0,56659432.0,79618358.0,1835738.0,210807841.0,301049053.0,52558714.0,47761824.0,9996984.0,31110999.0,,73735955.0,316867648.0,339833.0,2272200.0,54090364.0,7170551.0,24150819.0,185051564.0,,7807319.0,82016257.0,45455101.0,15296400.0,11427157.0,58275634.0,99632535.0,13070885.0,56502.0,2686722.0,9119111.0,,22224321.0,105450439.0,1215.0,337800.0,2926597.0,28813.0,1499005.0,673683.0,,6362668.0,32348926.0,1217.0,35297.0,12485.0,18378.0,4889.0,5385.0,826828.0,434408.0,13070885.0,56502.0,2686722.0,9119111.0,,22224321.0,105450439.0,1215.0,337800.0,,35963878.0,12336355.0,,,52937644.0,7563749.0,70759480.0,37408904.0,,44061527.0,1295928.0,190012.0,56913.0,49267117.0,,27837042.0,13684265.0,829982.0,24406991.0,2430600.0,,,35963878.0,12336355.0,,,52937644.0,7563749.0,70759480.0,37408904.0,,44061527.0,1295928.0,190012.0,56913.0,49267117.0,,27837042.0,13684265.0,829982.0,24406991.0,2430600.0,20386.0,11184299.0,2762135.0,,,8240381.0,4181793.0,2743345.0,2763620.0,,10118401.0,371015.0,19746.0,22086.0,6659884.0,,8539542.0,3358639.0,614533.0,7228033.0,253973.0,5003.0,40.0,65.0,14640.0,23790.0,5385.0,4889.0,3220.0,211.0,18378.0,12485.0,1004355.0,,476887.0,59932175.0,3080325.0,1481242.0,2352376.0,86235.0,,2352376.0,4829930.0,1341670.0,651982.0,1341670.0,,,,,,,,,,75450.0,24029.0,312774.0,1180167.0,9373227.0,688162.0,85933.0,113559.0,3637468.0,168901.0,,,,1529785.0,-144.0,-451178821.0,456149.0,,139932.0,,47228003.0,,,,333143.0,11210965.0,,82219467.0,,98258103.0,225600.0,,,-15832029.0,58438968.0,,42507230.0,,558743.0,87050341.0,,,883937.0,974034.0,,,24310.0,87050341.0,,883937.0,123242113.0,,10867.0,7839336.0,,300.0,2289792.0,,300.0,2289792.0,,,146.0,257556.0,,,,151446.0,342489.0,303.0,,5871557.0,15820390.0,1847555.0,,,770060.0,4849858.0,3763302.0,,,,,-4149011.0,-8152067.0,,,,,-5736987.0,6641617.0,11597454.0,5610857.0,,408337.0,9577.0,4841.0,3995.0,59453.0,30214.0,35250.0,14089780.0,22541026.0,,1203904.0,778000.0,,14089780.0,22559949.0,,60681154.0,162130235.0,,19296.0,,22558310.0,,19296.0,,2170.0,,,,,,,,,,,,,,,,,,,,,,,,,3601.0,9254.0,1287.0,430270.0,,,,19296.0,,,42360.0,2336.0,,,,11139.0,1611.0,,,,,182986.0,,,,,,15.0,5490.0,1287.0,46.0,3601.0,1787970.0,2425512.0,4602774.0,431354.0,,,,,,6390744.0,2680110.0,11052925.0,4688824.0,879682.0,272644.0,11052925.0,4688824.0,8969013.0,36050203.0,27176551.0,138265.0,3064625.0,9988024.0,937129.0,1294118.0,3064625.0,9988024.0,,,,,,,,,6465805.0,3086917.0,9552722.0,18625651.0,1189133.0,18625651.0,769709.0,14452188.0,242645.0,296903.0,242645.0,7728197.0,4926746.0,7728197.0,4926746.0,2363198.0,6028411.0,26514147.0,1586275.0,12818.0,704149.0,,,-34585806.0,-1751050.0,40838016.0,2290424.0,,26519.0,4242.0,14079.0,,3495793.0,7837233.0,559190.0,3982941.0,4646764.0,1855961.0,4294740.0,327458.0,4294740.0,4061362.0,,2898752.0,3179386.0,70700.0,,9616.0,13443.0,,105250.0,5550.0,19611.0,27697.0,,,48179.0,22141.0,15830.0,,1956.0,521.0,,10127.0,577.0,7610.0,1223.0,,,11825.0,6698.0,,,,,,,,,,,,,,,98122.0,2898752.0,,,,,,,64060.0,,,,,,,,,,,,,,,,17477.0,64059.0,,,39.0,1.0,,,,,,,,,,,,,,,,,51.0,18666.0,562.0,9254.0,63389.0,63389.0,8213.0,,,,,2184.0,1061.0,,,,,,40.779269,-73.703029,Voluntary non-profit - Private,Acute Care Hospitals,NORTH SHORE UNIVERSITY HOSPITAL (330106)
6024,675576.0,330106,13001,2020-09-29 00:00:00,2019-01-01 00:00:00,2019-12-31,F,33,33400,2.0,2.0,5380,,,,,,,,,,23295.0,,,,,,,,,,,,,,,,,,,,,,,,,-2619206.0,,2708995.0,6702.0,,,,,,,,,,,,,,5030832.0,963937.0,,,,,,,,,,,,,,,-180204.0,,,,,,,,,,,,,,-4038716.0,,-14108493.0,,8807541.0,1620660.0,,,,,,,,,,,,,,,,,,,,,,,,549471.0,,,,,,,,,,,,,,,,,35398.0,,,,13414132.0,2821671.0,,,,,,,,,,,,,,366745.0,423217.0,,,,,,,,,,,,,13414132.0,2821671.0,,,,,,,,,,,,,,4948525.0,675216.0,,,,,,,,,,,,,,,,,,,,,,,,,,,,,,,,,,,,,,,,,,,,,,,,,,,,,,,,,,,,,,,,,,,,,,,,,,,,,,,,,,,668.0,,,,,,,,,,,,,,,,,,,,,,,,,,,1177973.0,,,,,,,,,,,,,,,,,,,,,,,,,,,,,,,,,,,,,,,,,,,,,,,,,,,,,,6620226.0,,,1653054.0,,,,19711083.0,,,,,,,,,,,,,,,,,,,6620226.0,,,,,,19711083.0,,,,,,,547740.0,,,,,,,,35.99,,,,,439.0,17109.0,,,,,,,,,,,,,,,,,,,,,,,,,,,,,,,,,,,,,,,,,,,,,,,,,,,,,,,,,,,,,,,,,,,,,,,,,,7421241.0,1584421254.0,505541937.0,998080682.0,1584421254.0,-736727639.0,-802525777.0,-736727639.0,-7315973.0,99660157.0,59730173.0,-414165849.0,-3522689.0,,-14574707.0,,-1125421783.0,-24582.0,,1496282319.0,126584474.0,16995001.0,1357517594.0,11156323.0,-1125421783.0,-6540416.0,1728378130.0,130840809.0,1623300902.0,347171344.0,99660157.0,29185939.0,1555763661.0,5646461290.0,2198595598.0,2524812426.0,8171273716.0,,347424760.0,347424760.0,138605832.0,153842297.0,329818372.0,831193101.0,153842297.0,797195.0,248720.0,254609.0,159172.0,12235982.0,53302212.0,58641683.0,58628457.0,58898743.0,58898662.0,58757604.0,-1036915.0,0.190394,1.0,,,611.0,782.0,802.0,611.0,223015.0,284116.0,223015.0,,,,92976.0,105308.0,54143.0,,92976.0,231588.0,284836.0,1462.0,,,231588.0,2106742.0,,7182008.0,64088644.0,,96816.0,51036728.0,,13257194.0,13257194.0,60642243.0,22076716.0,60642243.0,77345838.0,43277685.0,,,,-9736267.0,6719287.0,,,,,6719287.0,16354690.0,1806228.0,471538.0,1581089370.0,2179506.0,1578909864.0,347424760.0,16354690.0,65635029.0,13983170.0,6572839.0,20556009.0,309262363.0,379498.0,233050.0,12843.0,147771.0,92976.0,14992078.0,11643384.0,379498.0,147771.0,49074.0,477473048.0,25419.0,301862.0,301862.0,477473048.0,18952.0,79345677.0,5889.0,816147.0,816147.0,816147.0,561538.0,79320258.0,65442757.0,65154495.0,13226.0,415824.0,270286.0,,262843.0,3346988.0,14754.0,30353.0,,,,12407.0,284.0,14754.0,34993.0,492.0,12407.0,12843.0,3012.0,1496282319.0,117284809.0,930371.0,69674.0,346388347.0,51892610.0,,5673995.0,53436511.0,17625530.0,138246037.0,6446786.0,,15072022.0,15126820.0,13570523.0,24421554.0,1867212.0,32340361.0,13652479.0,4081476.0,3503115.0,319532806.0,1496282319.0,129774353.0,930371.0,69674.0,346388347.0,51892610.0,,5673995.0,53436511.0,17625530.0,137822429.0,6446786.0,,15072022.0,15126820.0,9367030.0,5856547.0,24421554.0,1867212.0,32340361.0,13449879.0,4081476.0,3503115.0,319532806.0,24751570.0,2801723.0,11130.0,357.0,369779.0,1616593.0,29676.23,,465669.0,551285.0,403154.0,62985.0,376960.0,64955.0,130847.0,242447.0,177375.0,76035.0,1090223.0,60.45,46.32,83.59,195.17,47.67,85.25,217.24,,32.37,27.44,23.23,92.98,64.79,28.75,247.16,55.48,23.01,46.07,293.09,1118874110.0,136995892.0,981878218.0,1000045.0,352062342.0,1334940605.0,1118111979.0,149485436.0,968626543.0,1000045.0,352062342.0,1321688930.0,257981119.0,22822645.23,3349463.0,19473182.23,11487.0,19484669.23,4532706.23,48.99,44.63,49.74,87.06,36.35,67.83,56.92,,19711083.0,39525201.0,59996.0,935512.0,9714767.0,3516170.0,20646595.0,35111861.0,7244297.0,45091559.0,55349953.0,2553018.0,6277181.0,7244297.0,45091559.0,55402467.0,38731956.0,66259864.0,261990772.0,7244297.0,7244297.0,141446.0,1934214.0,1859086.0,45091559.0,21182830.0,6923888.0,1050931.0,141446.0,22269982.0,6923888.0,,,,40994.0,10423.0,87264.0,,37984798.0,557434.0,,,,7251041.0,481726.0,3694051.0,8103157.0,226993.0,8103157.0,5073333.0,4759.0,1278316.0,2039820.0,,,,,,,,,,,492.0,19972.0,,,,1404472.0,,,,,1404472.0,,,51645.0,,,,27.19,,158262.0,36918610.0,12593.0,810193.0,49090.0,10545105.0,1185.0,359793.0,6009.0,1407850.0,2301.0,32866.0,5490.0,1262585.0,51.0,218851.0,50134150.0,15333.0,1236.0,1219961.0,,,,,,,,,,,,,,,,,,,,12697517.0,,,,,,,,,,,,,,,,,,,,,626658.0,259164.0,225002.0,,,,,,5339471.0,4472.0,,,,,,,347.61,347.61,1936247.0,1936247.0,44148.0,43.86,1407400.0,,,,,,,,,,,,3456174.0,,817989.0,,277168.0,,1792768.0,68588.0,6540.0,75128.0,9339605.0,,,5936.0,1469.0,68588.0,626658.0,,35.0,298320.0,298320.0,81.0,,28122333.0,48392208.0,20.0,7300.0,1469.0,5936.0,8258709.0,,27915413.0,8258709.0,,28677544.0,,702922.0,,40.8,168.0,,,,,,,,,1237.0,,,,,,,,,,,,,,,,,,,,,,,,,,,,,,,,,,,,,,,,,,,,,,,,,,,,,,,04/04/2008,,03/11/2019,,,,,,,,,,,300 COMMUNITY DRIVE,MANHASSET,NY,10030,NASSAU,NORTH SHORE UNIVERSITY HOSPITAL,35004,P,,2,HB2348,NORTHWELL HEALTHCARE INC,972 BRUSH HOLLOW RD,WESTBURY,NY,11590,NSUH PSYCHIATRIC EXEMPT UNIT,33S106,335702,,,,,337148,,,,,,,,,1653054.0,,,,,272726749.0,,2141489.0,,,,,,,,,,,,,,12762.0,,,,,,1769687.0,,,,,,,,,,,,,,-30009.0,,,,,,-573052217.0,,,,,,-1537912.0,,,,,,,,,,,,,,,,,,,,,,,,,,,,,,,,,,,,,,,160093.0,,,,,,,2344408.0,18994.0,770616.0,260490.0,164163.0,,2896592.0,,,,,51555.0,,,2260291.0,,,,,2619822.0,,,,,,,,,,,247638.0,,,,1498425.0,,757607.0,623294.0,,,3626439.0,29381.0,1192024.0,402938.0,253935.0,,4480582.0,,,,,79748.0,,,3496322.0,,,,,4052461.0,,,,,,,,,,,,,,,,,,,,,,,,,,,,,,,,,,,,,,,,,,,,,,,,,,,,,,,,,,,,,,,,,,,,,,,,,,,,,,,,,,,,,,,,5204185.0,,,,,,,,,,,,,,,,,,,,,,,,,,,,,,,134589.0,,,,,,,,,,,,,,,,1341.0,,,,,,,,,,,,,,,,,,,,,,,,,,,,,,,,,,,,,,,,,,,,,,,,17181.0,,,,980339.0,2603.0,,,583.0,,,,,,,,,,,,,,,,,,,4752.0,,,,523204.0,327.0,,,182.0,,,,,,,,,,,,,,,,,,,,,,,,,,,,,,,,,,,,401.0,,,,,,,,,,,,,,,,,,,,,,,10971.0,,,,,,,,,,,,,,,,,,,,,,,,,,,,,,,,,,,,,,,,,,,,,,,,,,,,,,79309.0,,,,,,,,,,,,,,,,,,,,,,,,,,,,,,,,,,,,,,,,,,,,,,,,,,,,,,,,,,,,,,,,,,,,,,,,,,,,,,,,,,,,,,,,,,,,,,,,,,,,,,,,,,,,,,,,,,,,,,,,,,,,,,,,,,,,,,,,,,,,,,,,,,,,,,,,,,,,,668.0,,,,,,,,,,,,,,,,,,,,,,,,,,,,,,,,,,,,,,,,,,,,,,,,,,,,,,,,,,,,,,,,,,,,,,,,,,,,,,,,,,,,,,,,,,,,,,,,,,,,,,,,,,,,,,,,,,,,,,,-3597515.0,-3718458.0,54391708.0,45268449.0,34411527.0,25318646.0,-680778483.0,13570523.0,24421554.0,1867212.0,13652479.0,4081476.0,,138246037.0,140024028.0,68778790.0,44089521.0,7940095.0,11196822.0,,27273024.0,15072022.0,15126820.0,55044884.0,98225715.0,9711967.0,1003141.0,5585788.0,3695205.0,1407328.0,,51745378.0,164972383.0,200012278.0,34954677.0,,19688046.0,2102178.0,68738073.0,2017613.0,283484.0,2571261.0,26498542.0,3317211.0,3415821.0,-3522689.0,,-15809409.0,-47200406.0,-99156438.0,-20428376.0,54391708.0,19076692.0,2346620.0,25424695.0,7453000.0,17145084.0,5488804.0,,28011537.0,45268449.0,181515419.0,326993759.0,60293500.0,,46648491.0,7357474.0,48754241.0,8828982.0,11480306.0,,24652486.0,38951358.0,,57709554.0,18444031.0,33770684.0,910520.0,6809180.0,41389434.0,116253982.0,,94989727.0,16609414.0,85227399.0,15265249.0,19310290.0,,55120949.0,,73320357.0,58744890.0,360847.0,1995157.0,2250739.0,9148103.0,,14144331.0,496847.0,3749015.0,348268.0,414949.0,,4472238.0,,531678.0,3251024.0,293459350.0,,107581244.0,169729379.0,474228722.0,146485893.0,59737644.0,,339948194.0,,154556901.0,148916324.0,234266908.0,,375110849.0,298663477.0,231049926.0,2751989.0,366397.0,,138497572.0,,81393403.0,177291026.0,87982419.0,,35400362.0,67234099.0,169378698.0,67681558.0,13064544.0,,115238231.0,,49620476.0,43192878.0,20293409.0,,9816124.0,2384121.0,15930694.0,6942571.0,4197390.0,,13116885.0,,15419315.0,7978372.0,87982419.0,,35400362.0,67234099.0,169378698.0,67681558.0,13064544.0,,115238231.0,,49620476.0,43192878.0,,,,,,,,,,,1337.0,,,,,,,,,,,,415.0,,20992429.0,22285256.0,,,,,,,3503115.0,,8236819.0,10930003.0,315829.0,17559745.0,27991137.0,17625530.0,11929880.0,13101570.0,,9835846.0,5255296.0,4839080.0,,3757219.0,181161891.0,756594.0,20944.0,3790.0,3139645.0,39529405.0,15000.0,1539689.0,4652449.0,460195.0,2252309.0,194834.0,3271658.0,,12949370.0,,2099376.0,-14879421.0,,-7968747.0,-1708712.0,,,-30813371.0,-4761175.0,,-62516524.0,-753890.0,-3993932.0,-2619206.0,,,-102023.0,3524059.0,3790.0,27872978.0,624970.0,10457741.0,29503324.0,12390075.0,15353879.0,4604187.0,8110738.0,,15168677.0,117847003.0,4455658.0,-20498574.0,676836.0,41381545.0,22860391.0,55854194.0,23998163.0,27582984.0,7525993.0,17278904.0,,22247220.0,149360941.0,-3666292.0,2049832.0,487522.0,2200428.0,1393724.0,816252.0,1515874.0,75668.0,1514989.0,,471608.0,1085724.0,1198754.0,273971.0,23390248.0,55889215.0,121721671.0,23998163.0,27582984.0,,97162788.0,7692945.0,16609414.0,17278904.0,,86034179.0,22247220.0,15308302.0,19310290.0,55187555.0,,149360941.0,73320357.0,31259009.0,60255497.0,2049832.0,132420903.0,301923136.0,71053372.0,45035160.0,953565.0,42121406.0,,72321673.0,396830498.0,988397.0,2539875.0,68524954.0,8288860.0,24091975.0,231671034.0,,8121203.0,81894676.0,50427475.0,20475075.0,12816429.0,71278040.0,97307646.0,19027175.0,31991.0,364788.0,12398866.0,,24897461.0,129353084.0,23034.0,400025.0,3271399.0,16548.0,112048.0,782492.0,,6885617.0,40357774.0,2446.0,35628.0,8534.0,18529.0,4699.0,6415.0,1161640.0,482536.0,19027175.0,31991.0,364788.0,12398866.0,,24897461.0,129353084.0,23034.0,400025.0,,54505823.0,18277225.0,,,68391772.0,7149850.0,86932499.0,47892402.0,,49633781.0,1959807.0,234851.0,19619.0,42685352.0,,26465013.0,19110903.0,2428240.0,30552349.0,3700200.0,,,54505823.0,18277225.0,,,68391772.0,7149850.0,86932499.0,47892402.0,,49633781.0,1959807.0,234851.0,19619.0,42685352.0,,26465013.0,19110903.0,2428240.0,30552349.0,3700200.0,18952.0,12007197.0,3142458.0,,,13351035.0,2148473.0,3082626.0,3022489.0,,11142579.0,542002.0,24022.0,6303.0,4954849.0,,8257005.0,5938618.0,,5502020.0,329558.0,5889.0,40.0,65.0,14600.0,22411.0,6415.0,4699.0,330.0,701.0,18529.0,8534.0,969116.0,,406858.0,57709554.0,3051186.0,1375974.0,2244820.0,71716.0,,2244820.0,4188695.0,1130438.0,603311.0,1130438.0,,,,,,,,,,129568.0,29885.0,196851.0,1847752.0,18341528.0,883145.0,63146.0,165060.0,5892784.0,274433.0,,,,1404472.0,-2305.0,-200275884.0,795858.0,,248305.0,,52105086.0,,,,275174.0,12993905.0,,334792794.0,,117847003.0,342467.0,,,,65068982.0,,33793609.0,,617641.0,97802161.0,,,988707.0,906411.0,,,21629.0,97802161.0,,988707.0,160560499.0,,17471.0,8075376.0,,,3878714.0,,,3878714.0,,,,473758.0,,,,,434620.0,639.0,,6827544.0,12931381.0,1936247.0,,,769270.0,1049021.0,2028671.0,,,,,-2469365.0,-3993424.0,,,,,25953924.0,7596814.0,9489746.0,3964918.0,,41257780.0,968696.0,489775.0,402945.0,6004832.0,506056.0,3561384.0,16009907.0,19760870.0,,1342648.0,820450.0,,16009907.0,19829654.0,,60595645.0,150420242.0,,19296.0,,18475559.0,,12864.0,,1571.0,,,,,,,,,,,,,,,,,,,,,,,,,3747.0,9595.0,1218.0,436446.0,,,,12864.0,,,37513.0,,,,,14448.0,,,,,,178460.0,,,,,,15.0,5475.0,1218.0,73.0,3747.0,1843029.0,2351608.0,5155341.0,407526.0,,,,,,6998370.0,2677634.0,11994828.0,4976628.0,865255.0,245005.0,11994828.0,4976628.0,11156912.0,52967050.0,29369969.0,558101.0,4233001.0,14171175.0,1252850.0,1317593.0,4233001.0,14171175.0,,,,,,,,,6815721.0,3273901.0,10089622.0,20105698.0,1287850.0,20105698.0,683937.0,31348680.0,161839.0,101580.0,161839.0,8778191.0,4430990.0,8778191.0,4430990.0,2598099.0,2781168.0,27915413.0,1238438.0,11606.0,460930.0,,,-2735226.0,-223293.0,47992339.0,1699368.0,,2679517.0,428723.0,1421840.0,,4144802.0,9288553.0,663168.0,782790.0,5508914.0,2199368.0,3441214.0,313456.0,3441214.0,2530906.0,,593239.0,724650.0,122005.0,,20463.0,34366.0,,260018.0,107986.0,41621.0,63487.0,,,46245.0,90355.0,20977.0,,5148.0,1219.0,,23227.0,11077.0,13372.0,4018.0,,,14370.0,16690.0,,,,,,,,,,,,,,,34162.0,593239.0,,,,,,,10741.0,,,,,,,,,,,,,,,,,40551.0,,,35.0,,,,,,,,,,,,,,,,,,51.0,18615.0,959.0,9595.0,445467.0,445467.0,41418.0,,,,,228.0,122.0,,,,,,40.779269,-73.703029,Voluntary non-profit - Private,Acute Care Hospitals,NORTH SHORE UNIVERSITY HOSPITAL (330106)
14405,686375.0,330106,13001,2021-02-03 00:00:00,2018-01-01 00:00:00,2018-12-31,F,33,33400,2.0,2.0,5380,,,,,,,,,,20982.0,,,,,,,,,,,,,,,,,,,,,,,,,-2061270.0,,2090708.0,1800.0,,,,,,,,,,,,,,4841829.0,936150.0,,,,,,,,,,,,,,,-31271.0,,,,,,,,,,,,,,-3645335.0,,-12827616.0,,7934331.0,937950.0,,,,,,,,,,,,,,,,,,,,,,,,504094.0,,,,,,,,,,,,,,,,,37083.0,,,,12021646.0,1190481.0,,,,,,,,,,,,,,413547.0,14957.0,,,,,,,,,,,,,12021646.0,1190481.0,,,,,,,,,,,,,,,,,,,,,,,,,,,,,,,,,,,,,,,,,,,,,,,,,,,,,,,,,,,,,,,,,,,,,,,,,,,,,,,,,,,,,,,,,,,,,,,,,,1003.0,,,,,,,,,,,,,,,,,,,,,,,,,,,1316394.0,667561.0,,,,,,,,,,,,,,,,,,,,,,,,,,,,,,,,,,,,,,,,,,,,,,,,,,,,,5576821.0,,,1726246.0,,,,17867459.0,,,,,,,,,,,,,,,,,,,5576821.0,,,,,,17867459.0,,,,,,,547740.0,,,,,,,,32.62,,,,,395.0,17769.0,,,,,,,,,,,,,,,,,,,,,,,,,,,,,,,,,,,,,,,,,,,,,,,,,,,,,,,,,,,,,,,,,,,,,,,,,,6196276.0,734302055.0,541332455.0,176149255.0,734302055.0,37562011.0,18016743.0,37562011.0,,92430116.0,58970223.0,-334140612.0,-3695152.0,,-14574707.0,,-922124488.0,-69061.0,,1356028158.0,114454710.0,24310974.0,1299961660.0,9098955.0,-922124488.0,-420451.0,1733865330.0,123044840.0,1629090620.0,324127255.0,92430116.0,27918309.0,1568721690.0,5151841452.0,2028287819.0,2433107273.0,7584948725.0,,324127255.0,324127255.0,127538932.0,154304857.0,311587211.0,768319143.0,154304857.0,971637.0,308914.0,318897.0,193574.0,12634179.0,58898115.0,64901617.0,64888020.0,65819793.0,65819706.0,63642233.0,193518.0,0.20682,1.0,11054.52,12084.5,611.0,764.0,1040.0,611.0,223015.0,278860.0,223015.0,,,,90233.0,101175.0,51280.0,,90233.0,228308.0,283762.0,1010.0,,,228308.0,1395456.0,,9228613.0,,1224965.0,732267.0,17400882.0,,,,80082322.0,24615277.0,80082322.0,,29643227.0,,,,-9736267.0,6205104.0,,1179.0,,,6206283.0,13709534.0,2325296.0,434909.0,1570149264.0,1427574.0,1568721690.0,324127255.0,13709534.0,74185738.0,12785262.0,5836785.0,18622047.0,292965164.0,376000.0,229318.0,13698.0,143898.0,90233.0,14126105.0,10984965.0,376000.0,143898.0,73912.0,485758938.0,32917.0,400730.0,400730.0,485758938.0,23922.0,94019587.0,9983.0,995559.0,995559.0,995559.0,676662.0,93986670.0,71406971.0,71095094.0,13597.0,1433497.0,931773.0,1154551.0,278960.0,2807862.0,13362.0,27714.0,11.0,4015.0,1.0,15643.0,337.0,19182.0,27714.0,246.0,15643.0,13698.0,3764.0,1356028158.0,105061298.0,750172.0,,213932825.0,47881887.0,,5353511.0,100623625.0,9407831.0,124730204.0,5445158.0,,14075715.0,14270849.0,11034143.0,23213599.0,4055937.0,44615329.0,12818036.0,1236554.0,3464509.0,445668797.0,1356028158.0,118500507.0,750172.0,,213932825.0,47881887.0,,5353511.0,100623625.0,9407831.0,124635975.0,5445158.0,,14075715.0,14270849.0,11034143.0,1726246.0,23213599.0,4055937.0,44615329.0,12548284.0,1236554.0,3332992.0,445668797.0,23674926.0,2706518.0,9352.0,,195724.0,1765320.0,20035.31,,485685.0,576242.0,399459.0,65797.0,387322.0,140799.0,171118.0,234030.0,39728.0,94254.0,5902195.0,57.28,43.78,80.22,,48.07,70.6,271.78,,28.98,24.77,27.62,26.24,59.93,28.81,260.73,53.62,31.13,35.36,75.51,848524667.0,122928757.0,725595910.0,750172.0,219286336.0,945632418.0,848030805.0,136367966.0,711662839.0,750172.0,219286336.0,931699347.0,228306017.0,16900061.31,3254258.0,13645803.31,9352.0,13655155.31,4499894.31,50.18,41.9,52.15,80.22,30.81,68.23,50.74,,17867459.0,34950768.0,71568.0,880779.0,8920255.0,3125152.0,18716919.0,31043407.0,8857754.0,46439093.0,51769849.0,2668090.0,3782095.0,8857754.0,46439093.0,51769849.0,29729089.0,65546846.0,222498516.0,8857754.0,8857754.0,129504.0,3006453.0,2685132.0,46439093.0,22124428.0,7233837.0,888323.0,129504.0,23814612.0,7233837.0,475.81,256.0,93440.0,41138.0,9589.0,86348.0,-31319.0,53212304.0,2233759.0,,,,6428197.0,457799.0,3240661.0,5876593.0,204653.0,5876593.0,4882019.0,22308.0,2054776.0,2462129.0,17576.0,17576.0,,,21060.0,,,,,,246.0,17407.0,,,,1314249.0,,,,,1314249.0,,,52188.0,,,,25.18,,152838.0,35609208.0,11695.0,755627.0,56529.0,12236695.0,1256.0,385489.0,6123.0,1432562.0,2380.0,33787.0,5238.0,1204840.0,39.0,220728.0,50483305.0,14470.0,1295.0,1192672.0,,,,,,,,,,,,,,,,,,,,11649748.0,,,,,,,,,,,,,,,,,,,,,611478.0,246497.0,148884.0,,,,,,6003502.0,5696.0,,,,,,,335.41,335.41,2008485.0,2008485.0,43311.0,46.37,187154.0,,,,,,,,,,,,3053584.0,,857010.0,,973476.0,,2876949.0,316176.0,5145.0,321321.0,9611605.0,,,4880.0,1585.0,316176.0,611478.0,,45.0,399065.0,399065.0,87.0,,8229574.0,46211828.0,20.0,86140.0,1585.0,4880.0,7894410.0,,26971439.0,7894410.0,,27465301.0,,702962.0,,39.07,124.0,,,,,,,,,575.0,,,,,,,,,,,,,,,,,,,,,,,,,,,,,,,,,,,,,,,,,,,,,,,,,,,,,,,04/04/2008,,,,,,,,,,,,,300 COMMUNITY DRIVE,MANHASSET,NY,10030,NASSAU,NORTH SHORE UNIVERSITY HOSPITAL,35004,P,,2,,,,,,,NSUH PSYCHIATRIC EXEMPT UNIT,33S106,335702,,,,,337148,,,,,,,,,1726246.0,,,,,579454103.0,,,,,,,,,,,,,,,,-6501.0,,,,,,1800952.0,,,,,,,,,,,,,,-61661.0,,,,,,-774461384.0,,,,,,-1600538.0,,,,,,,,,,,,,,,,,,,,,,,,,,,,,,,,,,,,,,,147351.0,,,,,,,2150802.0,16803.0,707024.0,239122.0,149936.0,,2657481.0,,,,,46532.0,,,2074541.0,,,,,2404142.0,,,,,,,,,,,260542.0,,,,1570108.0,,793053.0,653641.0,,,3802997.0,29711.0,1250144.0,422809.0,265113.0,,4698896.0,,,,,82276.0,,,3668156.0,,,,,4250947.0,,,,,,,,,,,,,,,,,,,,,,,,,,,,,,,,,,,,,,,,,,,,,,,,,,,,,,,,,,,,,,,,,,,,,,,,,,,,,,,,,,,,,,,,4757497.0,,,,,,,,,,,,,,,,,,,,,,,,,,,,,,,,,,,,,,,,,,,,,,,,,,,,,,,,,,,,,,,,,,,,,,,,,,,,,,,,,,,,,,,,,,,,,,,,,,,731928.0,14476.0,,,3501.0,,,,,,,,,,,,,,,,,,,,,,,428031.0,1956.0,,,1112.0,,,,,,,,,,,,,,,,,,,,,,,,,,,,,,,,,,,,162.0,,,,,,,,,,,,,,,,,,,,,,,1984.0,,,,,,,,,,,,,,,,,,,,,,,,,,,,,,,,,,,,,,,,,,,,,,,,,,,,,,48364.0,,,,,,,,,,,,,,,,,,,,,,,,,,,,,,,,,,,,,,,,,,,,,,,,,,,,,,,,,,,,,,,,,,,,,,,,,,,,,,,,,,,,,,,,,,,,,,,,,,,,,,,,,,,,,,,,,,,,,,,,,,,,,,,,,,,,,,,,,,,,,,,,,,,,,,,,,,,,,1003.0,,,,,,,,,,,,,,,,,,,,,,,,,,,,,,,,,,,,,,,,,,,,,,,,,,,,,,,,,,,,,,,,,,,,,,,,,,,,,,,,,,,,,,,,,,,,,,,,,,,,,,,,,,,,,,,4103.0,,,,,,,,-802674.0,802674.0,55399521.0,37030595.0,33251566.0,25718657.0,-557847419.0,11034143.0,23213599.0,4055937.0,12818036.0,1236554.0,,124730204.0,49936140.0,35748452.0,20227034.0,6547256.0,10505389.0,,22311575.0,14075715.0,14270849.0,24154847.0,71422123.0,8141437.0,1485127.0,1965301.0,3818053.0,4226242.0,,56558706.0,169714351.0,194899138.0,35147334.0,,12837923.0,2053792.0,74496616.0,1832096.0,385240.0,2096009.0,23259129.0,3298665.0,3229862.0,-3695152.0,,-14551835.0,-24482887.0,-256427.0,,55399521.0,15626558.0,1492629.0,24698726.0,6021238.0,16366337.0,5462796.0,,15981419.0,37030595.0,177276347.0,324133459.0,84827047.0,,48507668.0,7180069.0,46849912.0,8379352.0,10890629.0,,24398432.0,35273574.0,,54672058.0,17569514.0,27384709.0,863990.0,4799969.0,23740693.0,149198573.0,,94457590.0,19691143.0,83222941.0,15289385.0,18211427.0,,56450521.0,,84268097.0,55554678.0,348119.0,1579251.0,1378859.0,8316167.0,,10212373.0,704859.0,3302742.0,403322.0,465463.0,,4331639.0,,1537623.0,2279336.0,299834155.0,,85620998.0,150859342.0,403689847.0,129367080.0,58551675.0,,292820495.0,,143021485.0,135362097.0,174945496.0,,362049353.0,274099985.0,209996520.0,2958057.0,352296.0,,158414758.0,,58897863.0,177632389.0,83728004.0,,24169172.0,58890390.0,145310022.0,62131377.0,12044518.0,,83663156.0,,47804425.0,37267776.0,26311358.0,,6487061.0,2728804.0,16812421.0,7178908.0,3723816.0,,10143715.0,,19950460.0,6614807.0,83728004.0,,24169172.0,58890390.0,145310022.0,62131377.0,12044518.0,,83663156.0,,47804425.0,37267776.0,,,,,,,,,,,3768.0,,,,,,,,,,,,1573.0,,20211783.0,9431444.0,,,,,,,3464509.0,,4505053.0,9698294.0,324209.0,8581940.0,22029211.0,9407831.0,11245774.0,12091564.0,,170984.0,5126277.0,4819764.0,,3601224.0,11192798.0,698413.0,22770.0,6462.0,1363371.0,35864526.0,20734.0,1534250.0,3753606.0,444072.0,2040527.0,57325.0,2993467.0,,13068589.0,,1771163.0,-16034394.0,,,-2182526.0,,,-78707.0,,,-47873738.0,,-9152.0,-2061270.0,,,-102023.0,3355762.0,6462.0,23174490.0,683437.0,10157717.0,25829664.0,11689846.0,14132091.0,228309.0,7813231.0,,15069275.0,113775289.0,4035005.0,27205224.0,617366.0,30964278.0,24905558.0,49119575.0,22847438.0,24693869.0,2396187.0,18269752.0,,22398591.0,144407806.0,43278456.0,2080904.0,593943.0,1559891.0,1408175.0,830521.0,1566999.0,870653.0,1054671.0,,509335.0,1814261.0,1999361.0,274557.0,24905558.0,49119575.0,149198573.0,22847438.0,24693869.0,,94457590.0,2396187.0,19691143.0,18269752.0,,83222941.0,22398591.0,15289385.0,18211427.0,56450521.0,,144407806.0,84268097.0,43278456.0,55554678.0,2080904.0,212001379.0,215983080.0,71341682.0,33223782.0,900204.0,43216129.0,,74666551.0,354545285.0,241380.0,2301725.0,47238550.0,3703231.0,1436772.0,224520257.0,,7299378.0,100218920.0,48383822.0,20010000.0,11202661.0,49458705.0,84558431.0,17262113.0,24565.0,81636.0,13304238.0,,26344218.0,114559495.0,12418.0,248075.0,3325978.0,16427.0,83704.0,907855.0,,7199005.0,36377680.0,14933.0,23137.0,10778.0,17423.0,4848.0,4889.0,701651.0,395129.0,17262113.0,24565.0,81636.0,13304238.0,,26344218.0,114559495.0,12418.0,248075.0,,67417143.0,20355892.0,,,60318600.0,878661.0,78579318.0,46211392.0,,45213281.0,2037533.0,377975.0,70103.0,56373560.0,,37479444.0,18420814.0,2252636.0,29453104.0,3685750.0,,,67417143.0,20355892.0,,,60318600.0,878661.0,78579318.0,46211392.0,,45213281.0,2037533.0,377975.0,70103.0,56373560.0,,37479444.0,18420814.0,2252636.0,29453104.0,3685750.0,23922.0,21185702.0,3922071.0,,,12718967.0,900924.0,3641130.0,3153373.0,,9628020.0,556791.0,43673.0,21674.0,7181842.0,,11901373.0,7687650.0,2515427.0,5227749.0,343751.0,9983.0,40.0,47.0,14600.0,17155.0,4889.0,4848.0,1423.0,569.0,17423.0,10778.0,877588.0,,311935.0,54672058.0,2720756.0,1189523.0,1917798.0,60334.0,,1917798.0,3275554.0,898981.0,525724.0,898981.0,,,,,,,,,,37060.0,11646.0,187785.0,2120626.0,19878152.0,878144.0,61669.0,228841.0,6145748.0,366480.0,,,,1314249.0,-80986.0,-1640933.0,967869.0,,307341.0,,50436882.0,,,,95165.0,13798094.0,,316024691.0,,113775289.0,85988.0,,,,64173315.0,,53431211.0,,181153.0,96804956.0,,,693493.0,1702862.0,,,53597.0,96804956.0,,693493.0,158777680.0,,3854.0,8134217.0,,228.0,3063751.0,,228.0,3063751.0,,,133.0,234000.0,,518.54,,220728.0,425561.0,470.0,,6584768.0,9061447.0,2008485.0,,,667736.0,1183104.0,2956975.0,-13368773.0,,,,,,,,,,24839191.0,7252504.0,10244551.0,4965460.0,,37849722.0,887981.0,448515.0,369669.0,5508845.0,1768207.0,3267565.0,14698896.0,21591329.0,,1412023.0,913438.0,,14698896.0,21591329.0,,20371482.0,142852992.0,,56549.0,,19145305.0,,46460.0,,7044.0,,,,,,,,,,,,,,,,,,,,,,,,,3723.0,9832.0,1205.0,457020.0,19172.0,,,46460.0,,,54593.0,12522.0,,,,21037.0,9896.0,,,,,230594.0,,,,,,15.0,5475.0,1205.0,252.0,3723.0,1715293.0,2155556.0,4924610.0,381772.0,,,,,,6639903.0,2456828.0,11285475.0,4644987.0,721542.0,152254.0,11285475.0,4644987.0,10377037.0,40907762.0,25616133.0,713505.0,3493313.0,11246390.0,1095311.0,1255108.0,3493313.0,11246390.0,,,,,,,,,6213213.0,3007683.0,9220896.0,20622695.0,1246407.0,20622695.0,581947.0,145047244.0,487173.0,68989.0,487173.0,7143179.0,5975297.0,7143179.0,5975297.0,2239708.0,846168.0,26971439.0,537819.0,,308048.0,,,-2626110.0,,50979628.0,845867.0,,2458429.0,392935.0,,,4346936.0,9740611.0,694778.0,3126503.0,5777631.0,,1727365.0,90207.0,1727365.0,9335097.0,104544.0,3956116.0,693353.0,81365.0,,21521.0,51200.0,,209287.0,292771.0,39402.0,34206.0,,,5241.0,116270.0,15677.0,,6513.0,2372.0,,22585.0,33828.0,12182.0,1877.0,,,2187.0,20637.0,,,,,,,,,,,,,,,78441.0,3956116.0,,,,,,,6290.0,,,,,,,,,,,,,,,,105102.0,15005.0,,,6.0,39.0,,,,,,,,,,,,,,,,,51.0,18615.0,958.0,9832.0,433701.0,433701.0,48401.0,,,,,,,,,,,,40.779269,-73.703029,Voluntary non-profit - Private,Acute Care Hospitals,NORTH SHORE UNIVERSITY HOSPITAL (330106)
17922,661363.0,330106,13001,2019-12-18 00:00:00,2017-01-01 00:00:00,2017-12-31,F,33,33400,2.0,2.0,5380,,,,,,,,,,35780.0,,,,,,,,,,,,,,,,,,,,,,,,,-1265487.0,,1182160.0,,,,,,,,,,,,,,,4894211.0,,,,,,,,,,,,,,,,-337078.0,,,,,,,,,,,,,,-3097319.0,,-10847915.0,,6366289.0,,,,,,,,,,,,,,,,,,,,,,,,,485581.0,,,,,,,,,,,,,,,,,35536.0,,,,8342384.0,,,,,,,,,,,,,,,33126.0,,,,,,,,,,,,,,8342384.0,,,,,,,,,,,,,,,,,,,,,,,,,,,,,,,,,,,,,,,,,,,,,,,,,,,,,,,,,,,,,,,,,,,,,,,,,,,,,,,,,,,,,,,,,,,,,,,,,,,1731.0,,,,,,,,,,,,,,,,,,,,,,,,,,,1202442.0,,,,,,,,,,,,,,,,,,,,,,,,,,,,,,,,,,,,,,,,,,,,,,,,,,,,,,5411883.0,,,1764479.0,,,,17150893.0,,,,,,,,,,,,,,,,,,,5411883.0,,,,,,17150893.0,,,,,,,532619.0,,,,,,,,32.2,,,,,342.0,8966.0,,,,,,,,,,,,,,,,,,,,,,,,,,,,,,,,,,,,,,,,,,,,,,,,,,,,,,,,,,,,,,,,,,,,,,,,,,6196276.0,815069797.0,576718955.0,174679311.0,815069797.0,55932412.0,21308030.0,55932412.0,,87814523.0,58734771.0,-309645197.0,-3693749.0,,-13335940.0,,-855321255.0,-62659.0,,1292226539.0,112081883.0,22244681.0,1206203233.0,8276482.0,-855321255.0,-839637.0,1643108517.0,118665370.0,1540854149.0,294407792.0,87814523.0,33178464.0,1444100450.0,4811153258.0,1868596233.0,2295531402.0,7106684660.0,,294407792.0,294407792.0,115265890.0,146672337.0,292749714.0,719016259.0,146672337.0,1110943.0,356276.0,367715.0,214238.0,11745125.0,53897507.0,59251809.0,59236119.0,60122107.0,60122103.0,58762593.0,157068.0,0.203203,1.0,10785.67,11739.8,611.0,764.0,1040.0,611.0,223015.0,278860.0,223015.0,,,,90908.0,102138.0,48246.0,,90908.0,230797.0,285442.0,1397.0,,,230797.0,1241333.0,,10420623.0,45813299.0,,189904.0,15610476.0,,18275347.0,18275347.0,72610599.0,19841585.0,72610599.0,64088646.0,26390048.0,,,,-8908741.0,6097659.0,,639.0,,,6098298.0,13068448.0,1297569.0,273682.0,1445871762.0,1771312.0,1444100450.0,294407792.0,13068448.0,65402721.0,14682694.0,4813753.0,19496447.0,273253267.0,378408.0,232194.0,13389.0,145694.0,90908.0,15939705.0,12989844.0,378408.0,145694.0,63773.0,449758214.0,24280.0,343337.0,343337.0,449758214.0,24414.0,84388426.0,11439.0,1135357.0,1135357.0,1135357.0,767642.0,84364146.0,65489155.0,64846915.0,15690.0,1363059.0,885988.0,924906.0,617960.0,12427687.0,11315.0,28187.0,10.0,3650.0,,8319.0,285.0,11315.0,34811.0,244.0,8319.0,13389.0,3421.0,1292226539.0,90420988.0,874626.0,,204513497.0,40884476.0,,5303245.0,87893138.0,10192904.0,136569522.0,7244871.0,,13159752.0,14149434.0,10877614.0,23020910.0,3904060.0,45528721.0,11833066.0,1400093.0,3521494.0,404541264.0,1292226539.0,105497416.0,874626.0,,204513497.0,40884476.0,,5303245.0,87893138.0,10192904.0,136321728.0,7244871.0,,13159752.0,14149434.0,10877614.0,1764479.0,23020910.0,3904060.0,45528721.0,11613179.0,1400093.0,3521494.0,404541264.0,22964533.0,2360288.0,10670.0,,219989.0,1916628.0,23160.0,,450608.0,586847.0,406150.0,70457.0,393242.0,138691.0,171077.0,232561.0,45514.0,98197.0,5380549.0,56.27,44.7,81.97,,46.33,71.13,312.82,,29.2,24.11,26.78,25.04,58.54,28.15,266.13,49.94,30.76,35.86,75.19,828644502.0,107571881.0,721072621.0,874626.0,209816742.0,931763989.0,828259859.0,122648309.0,705611550.0,874626.0,209816742.0,916302918.0,240110190.0,16735674.0,2892907.0,13842767.0,10670.0,13853437.0,4673380.0,49.49,42.4,50.97,81.97,29.74,66.14,51.38,,17150893.0,30491572.0,52662.0,848181.0,7886849.0,2660069.0,17868954.0,27530506.0,9028556.0,47930277.0,45509597.0,2527420.0,2946268.0,9028556.0,47930277.0,45509597.0,34975889.0,62719686.0,198340090.0,9028556.0,9028556.0,196367.0,2971147.0,2660903.0,47930277.0,23385081.0,7252060.0,1173258.0,196367.0,24545236.0,7252060.0,467.65,256.0,93440.0,41649.0,10076.0,85364.0,-130120.0,50992569.0,1740665.0,,,608303.0,6171784.0,486065.0,3560530.0,6380571.0,165420.0,6380571.0,4685036.0,332763.0,1903748.0,2420783.0,4056.0,4056.0,,,5158.0,,,,,,244.0,16301.0,,,,1252296.0,,,,,1252296.0,,,51005.0,,,,24.55,,130276.0,30412740.0,9717.0,506130.0,47341.0,10359585.0,1042.0,275280.0,5049.0,1183380.0,1930.0,27644.0,4652.0,1067800.0,45.0,187318.0,43023505.0,11989.0,1087.0,818020.0,,,,,,,,,,,,,,,,,,,,8958090.0,,,,,,,,,,,,,,,,,,,,,658278.0,278876.0,,,,,,,5354302.0,6535.0,,,,,,,341.45,341.45,1687376.0,1687376.0,40331.0,41.84,548655.0,,,,,,,,-100744.0,,,,2607407.0,,655569.0,,984788.0,,2774780.0,302660.0,7584.0,310244.0,10655875.0,,,6205.0,1907.0,302660.0,658278.0,,13.0,343337.0,343337.0,4.0,,10438996.0,30786180.0,20.0,7898.0,1907.0,6205.0,7190311.0,,25990143.0,7190311.0,,26374786.0,,682692.0,,38.63,89.0,,,,,,,,,606.0,,,,,,,,,,,,,,,,,,,,,,,,,,,,,,,,,,,,,,,,,,,,,,,,,,,,,,,04/04/2008,,,,,,,,,,,,,300 COMMUNITY DRIVE,MANHASSET,NY,10030,NASSAU,NORTH SHORE UNIVERSITY HOSPITAL,35004,P,,2,,,,,,,NSUH PSYCHIATRIC EXEMPT UNIT,33S106,335702,,,,,337148,,,,,,,,,1764479.0,,,,,534696420.0,,,,,,,,,,,,,,,,2586.0,,,,,,1617347.0,,,,,,,,,,,,,,-709534.0,,,,,,-694119673.0,,,,,,-2065755.0,,,,-138378.0,,,,,-3334871.0,,,,,,,,,,,,,,,,,,,,,,,,,,,,,,140894.0,,,,,,,2069380.0,16354.0,679310.0,230211.0,144668.0,,2556220.0,,,,,45287.0,,,1996418.0,,,,,2312171.0,,,,,,,,,,,254756.0,,,,1544459.0,,780191.0,643714.0,,,3741731.0,29570.0,1228288.0,416253.0,261580.0,,4622005.0,,,,,81886.0,,,3609804.0,,,,,4180731.0,,,,,,,,,,,,,,,,,,,,,,,,,,,,,,,,,,,,,,,,,,,,,,,,,,,,,,,,,,,,,,,,,,,,,,,,,,,,,,,,,,,,,,,,4661762.0,,,,,,,,,,,,,,,,,,,,,,1862.0,,,8.0,,,,,,91259.0,,,,,,,566.0,,,2.0,,,,,,11651.0,,,,,,,,,,,,,,,,,,,,,,,,,,,,,,,,,,,,,,,,,,,,,,,,,,,,1091290.0,1741.0,,,8509.0,,,,,,,,,,,,,,,,,,,,,,,586076.0,227.0,,,2771.0,,,,,,,,,,,,,,,,,,,,,,,,,,,,,,,,,,,,93.0,,,,,,,,,,,,,,,,,,,,,,,3148.0,,,,,,,,,,,,,,,,,,,,,,,,,,,,,,,,,,,,,,,,,,,,,,,,,,,,,,59264.0,,,,,,,,,,,,,,,,,,,,,,,,,,,,,,,,,,,,,,,,,,,,,,,,,,,,,,,,,,,,,,,,,,,,,,,,,,,,,,,,,,,,,,,,,,,,,,,,,,,,,,,,,,,,,,,,,,,,,,,,,,,,,,,,,,,,,,,,,,,,,,,,,,,,,,,,,,,,,1731.0,,,,,,,,,,,,,,,,,,,,,,,,,,,,,,,,,,,,,,,,,,,,,,,,,,,,,,,,,,,,,,,,,,,,,,,,,,,,,,,,,,,,,,,,,,,,,,,,,,,,,,,,,,,,,,,,,,,,,,,-156104.0,156104.0,52495358.0,35319165.0,33027513.0,25707258.0,-518308738.0,10877614.0,23020910.0,3904060.0,11833066.0,1400093.0,,136569522.0,48596253.0,33279324.0,18650410.0,6356529.0,10301887.0,,20615143.0,13159752.0,14149434.0,24751522.0,70931671.0,8393016.0,1289450.0,2632140.0,2079740.0,3917354.0,,55694502.0,170994652.0,187706325.0,38068666.0,,13531182.0,2168542.0,65189724.0,1447430.0,385689.0,1983308.0,21704743.0,3260791.0,3328255.0,-3693749.0,,-13350796.0,-39407552.0,-4441321.0,-825.0,52495358.0,19176524.0,-1926684.0,23846452.0,6536200.0,13692919.0,5317447.0,,44452057.0,35319165.0,171055666.0,311728628.0,82223598.0,,45862521.0,6988667.0,41568592.0,7803959.0,10687576.0,,19343220.0,33599008.0,,50461805.0,17410225.0,28078952.0,1057443.0,6117227.0,59861450.0,145024498.0,,89861476.0,17290837.0,74403750.0,13969299.0,17831413.0,,48864581.0,,77046544.0,55743617.0,355500.0,1668342.0,1463445.0,7341844.0,,10017616.0,605742.0,2670793.0,332275.0,325788.0,,4052449.0,,778495.0,1941872.0,280236687.0,,87856941.0,136033998.0,382380116.0,124128402.0,59202778.0,,264227535.0,,123246269.0,105358396.0,151892868.0,,340273583.0,259104933.0,216510867.0,2913215.0,351442.0,,143663414.0,,41191817.0,163689230.0,78617360.0,,26339740.0,52309485.0,135170217.0,59495717.0,12667550.0,,80119799.0,,37704832.0,31479191.0,26384300.0,,6949915.0,2289011.0,15057001.0,6542030.0,3792854.0,,9368676.0,,17666373.0,6522142.0,78617360.0,,26339740.0,52309485.0,135170217.0,59495717.0,12667550.0,,80119799.0,,37704832.0,31479191.0,951.0,,,3930.0,7281.0,,,,14839.0,,1472.0,,319.0,,,172.0,744.0,,,,1799.0,,690.0,,16931009.0,9459039.0,,,,,,,3521494.0,,3906585.0,8430027.0,191157.0,8723825.0,20833716.0,10192904.0,10873014.0,11667487.0,,149581.0,4820125.0,4489023.0,,3627735.0,6705074.0,652193.0,25518.0,9486.0,864491.0,33447916.0,27888.0,1184818.0,2846154.0,408554.0,1834692.0,38898.0,2541347.0,,12387278.0,,1802531.0,-16101705.0,,-6477.0,-10131890.0,,,-688213.0,,,-42271542.0,,-3255231.0,-1265487.0,,,-102022.0,3547012.0,9486.0,22365552.0,724883.0,10755524.0,23679870.0,11281568.0,13502179.0,188479.0,7030370.0,,13949258.0,111422487.0,4420962.0,8221365.0,573295.0,29717579.0,25092540.0,45754352.0,21817719.0,23847666.0,2748541.0,16865041.0,,20568451.0,140538074.0,21183256.0,1875184.0,278838.0,1580854.0,979651.0,668509.0,1311930.0,881152.0,857567.0,,307049.0,409700.0,2104449.0,258628.0,25092540.0,45754352.0,145024498.0,21817719.0,23847666.0,,89861476.0,2748541.0,17290837.0,16865041.0,,74403750.0,20568451.0,13969299.0,17831413.0,48864581.0,,140538074.0,77046544.0,21183256.0,55743617.0,1875184.0,144775790.0,243385711.0,63754546.0,38336502.0,863939.0,44474596.0,,66767173.0,346372043.0,121000.0,1275750.0,39949551.0,6885763.0,1320092.0,256004443.0,,7813274.0,85133420.0,51423776.0,12491500.0,11043233.0,48760080.0,83364007.0,15508967.0,43060.0,107869.0,13768795.0,,23463231.0,110338398.0,12144.0,189000.0,3262839.0,22707.0,135750.0,772801.0,,6470901.0,35936334.0,6939.0,25743.0,10407.0,16413.0,4581.0,5419.0,694159.0,323460.0,15508967.0,43060.0,107869.0,13768795.0,,23463231.0,110338398.0,12144.0,189000.0,,63718771.0,17625096.0,19964.0,,55699611.0,871903.0,71405438.0,45348663.0,,47116733.0,1614507.0,471711.0,47987.0,54740490.0,,32319255.0,12043521.0,131820.0,26207259.0,2172450.0,,,63718771.0,17625096.0,19964.0,,55699611.0,871903.0,71405438.0,45348663.0,,47116733.0,1614507.0,471711.0,47987.0,54740490.0,,32319255.0,12043521.0,131820.0,26207259.0,2172450.0,24414.0,21384274.0,3708038.0,10528.0,,11954324.0,1097266.0,3124631.0,2545284.0,,7746962.0,445263.0,51868.0,14368.0,6732879.0,,10526123.0,5642920.0,16829.0,5429856.0,295901.0,11439.0,40.0,47.0,14600.0,17155.0,5419.0,4581.0,1205.0,482.0,16413.0,10407.0,897006.0,,374930.0,50562549.0,3168666.0,1271936.0,2051862.0,46805.0,,2051862.0,3817302.0,1048302.0,562990.0,1048302.0,,,,,,,,,,116739.0,39178.0,184136.0,2727428.0,19481975.0,1050157.0,59056.0,278689.0,5833196.0,492045.0,,,,1252296.0,-94106.0,-2106669.0,1082470.0,,352552.0,,43612080.0,,,,76880.0,11364094.0,,257197457.0,,111422487.0,69251.0,,,-100744.0,54266640.0,,30729129.0,,400399.0,78769115.0,,,1124263.0,452096.0,,,62319.0,78769115.0,,1124263.0,138132711.0,,3325.0,10335043.0,,,4489266.0,,,4489266.0,,,,392266.0,,454.6,,187318.0,389891.0,811.0,,6418675.0,9155394.0,1687376.0,,,607676.0,1164210.0,2857791.0,,,,-1166.0,,,,-5504.0,,,24162718.0,7025185.0,10319604.0,4545167.0,,36413548.0,854170.0,431488.0,356009.0,5299878.0,2694597.0,3143697.0,15190527.0,21585547.0,,1291535.0,730899.0,,15190527.0,21585547.0,,55160006.0,149520079.0,,72817.0,,18874870.0,,49216.0,,1939.0,,,,,,,,,,,,,,,,,,,,,,,,,4008.0,10428.0,1230.0,396355.0,25043.0,,,49216.0,,,62138.0,1542.0,,,,19848.0,1284.0,,,,,271023.0,,,,,,15.0,5475.0,1230.0,213.0,4008.0,1630818.0,2069355.0,5355723.0,314730.0,-463908.0,,,,,6986541.0,2166457.0,11921694.0,3915591.0,669111.0,117178.0,11921694.0,3915591.0,10256257.0,30983762.0,28997795.0,111277.0,3481071.0,8733981.0,1057222.0,1099809.0,3481071.0,8733981.0,,,,,,,,,6240160.0,3056457.0,9296617.0,20578394.0,1206506.0,20578394.0,431748.0,122479110.0,193170.0,32341.0,193170.0,7122761.0,6530162.0,7122761.0,6530162.0,2163225.0,1093312.0,25990143.0,4702640.0,,227634.0,,,-2212068.0,,50136649.0,1657314.0,,2365006.0,378653.0,1255466.0,,4276265.0,9582926.0,684658.0,4872212.0,5684247.0,2270059.0,3968993.0,30546.0,3968993.0,,16167200.0,,,127759.0,,28080.0,20754.0,,217001.0,299355.0,63748.0,60375.0,,,3481.0,142837.0,26878.0,,7153.0,908.0,,22173.0,32916.0,19087.0,4630.0,,,1631.0,29594.0,,,,,,,,,,,,,,,253833.0,,,,,,,,,,,,,,,,,,,,,,,,13050.0,,,,6.0,7.0,,,,,,,,,,,,,,,,,51.0,18615.0,811.0,10428.0,56790.0,56790.0,7151.0,,,,,,,,,,,,40.779269,-73.703029,Voluntary non-profit - Private,Acute Care Hospitals,NORTH SHORE UNIVERSITY HOSPITAL (330106)
27632,686853.0,330106,13001,2021-02-15 00:00:00,2016-01-01 00:00:00,2016-12-31,F,33,33400,2.0,2.0,5380,,,,,,,,,,264920.0,,,,,,,,,,,,,,,,,,,,,,,,,-1216920.0,,847667.0,,,,,,,,,,,,,268130.0,,2466290.0,,,,,,,,,,,,,,950301.0,,-38160.0,,,,,,,,,,,,,,-3155131.0,,-8587374.0,,3784341.0,,,,,,,,,,,,,2684437.0,,,,,,,,,,,,583624.0,,,,,,,,,,,,,,,,,38728.0,,,,5320900.0,,,,,,,,,,,,,2166550.0,,72853.0,,,,,,,,,,,,70524.0,,5320900.0,,,,,,,,,,,,,2166550.0,,,,,,,,,,,,,,,,,,,,,,,,,8440716.0,,,,,,,,,,,,,,,,,,,,,,,,,,,,,,,,,,,,,,,,,,,,,,,,,,,,,,,,,,,,,2357.0,,,,,,,,,,,,,,,,,,,,,,,,,,,1183902.0,-1849796.0,,,,,,,,,,,,,,,,,,,,,,,,,,,,,,,,,,,,,,,,,,,,,,,,,,,,,5197096.0,,,1676883.0,,,,16346764.0,,,,,,,,,,,,,,,,,,,5197096.0,,,,,,16346764.0,,,,,,,525078.0,,,,,,,,31.13,,,,,341.0,8617.0,,,,,,,,,,,,,,,,,,,,,,,,,,,,,,,,,,,,,,,,,,,,,,,,,,,,,,,,,,,0.77,,,,,,,,,,,,,7.0,5.0,6196276.0,815655501.0,584682609.0,173669009.0,815655501.0,68208907.0,30676773.0,68208907.0,,73067518.0,46443534.0,-274521918.0,-3354551.0,,-11681241.0,,-796315804.0,-64731.0,,1186948976.0,109156494.0,19484602.0,1166281589.0,7927154.0,-796315804.0,-1171794.0,1556914761.0,114965643.0,1448296592.0,294839697.0,73067518.0,20504075.0,1396844406.0,4651898260.0,1813483030.0,2200520834.0,6852419094.0,,294839697.0,294839697.0,115437520.0,144028481.0,287028318.0,683363435.0,144028481.0,951774.0,334175.0,412874.0,188594.0,12475144.0,53430530.0,58545497.0,58530698.0,59195023.0,59195123.0,59713844.0,147173.0,0.203847,1.0,10314.56,11193.4,603.0,756.0,1051.0,603.0,227008.0,283006.0,227008.0,,,,91903.0,102823.0,48132.0,,91903.0,234730.0,290266.0,,,,234730.0,1336015.0,,12391475.0,37380117.0,,170237.0,28362533.0,,8433182.0,8433182.0,68799017.0,29666471.0,68799017.0,45813299.0,22423490.0,,,,-7803361.0,6196431.0,,1104.0,,,6197535.0,13224712.0,2014400.0,323618.0,1396844406.0,,1396844406.0,294839697.0,13224712.0,66486370.0,9357263.0,5075325.0,14432588.0,272595730.0,386815.0,234730.0,14255.0,151042.0,91903.0,10509732.0,8027727.0,386815.0,151042.0,63002.0,438672841.0,20568.0,323250.0,323250.0,438672841.0,162860.0,80487915.0,78699.0,1114634.0,1114634.0,1114634.0,701760.0,80467347.0,65681394.0,64973816.0,14799.0,1022039.0,664325.0,1008537.0,687010.0,16569644.0,11436.0,28491.0,7.0,2562.0,,8408.0,288.0,11436.0,35186.0,247.0,8408.0,14255.0,2349.0,1186948976.0,80350244.0,1109003.0,,189701063.0,37810641.0,,4631985.0,72587127.0,11942765.0,133723206.0,7376433.0,,11336978.0,13674612.0,10195054.0,10970111.0,3348612.0,38429600.0,10572067.0,1387358.0,3397470.0,357852058.0,1186948976.0,93680384.0,1109003.0,,189701063.0,37810641.0,,4631985.0,72587127.0,11942765.0,133723206.0,7376433.0,,11336978.0,13674612.0,10195054.0,1676883.0,10970111.0,3348612.0,38429600.0,10339131.0,1387358.0,3397470.0,357852058.0,21989395.0,2051958.0,13078.0,,221569.0,1993670.0,26346.83,,428954.0,607651.0,407843.0,72094.0,205709.0,130994.0,157693.0,224602.0,46546.0,98848.0,4756661.0,53.98,45.65,84.8,,53.9,67.07,279.97,,26.43,22.5,25.0,23.26,53.33,25.56,243.7,46.03,29.81,34.37,75.23,774699736.0,96697008.0,678002728.0,1109003.0,194333048.0,873444779.0,774087158.0,110027148.0,664060010.0,1109003.0,194333048.0,859502061.0,222179415.0,16401818.83,2577036.0,13824782.83,13078.0,13837860.83,4562243.83,47.2,42.7,48.03,84.8,29.26,62.11,48.7,,16346764.0,28567119.0,71328.0,726483.0,7301914.0,5806136.0,16960076.0,27281659.0,14644737.0,43756548.0,48634361.0,1998523.0,2833190.0,14644737.0,43756548.0,48634361.0,78122171.0,59414497.0,196426870.0,14644737.0,14644737.0,257753.0,4463872.0,4217352.0,43756548.0,23494786.0,7896187.0,1671638.0,257753.0,25962997.0,7896187.0,460.24,249.0,91134.0,44053.0,8790.0,82044.0,-113171.0,36330592.0,2537034.0,,,,9635912.0,4493901.0,12230028.0,21008175.0,459471.0,21008175.0,4852019.0,28350746.0,1793834.0,1135002.0,12003.0,12003.0,,,7595.0,,,,,,247.0,16161.0,,,,1260297.0,,,,,1260297.0,,,56105.0,,,,22.46,,129439.0,29921664.0,9517.0,390348.0,42975.0,9521370.0,904.0,239771.0,5020.0,1177325.0,1926.0,30306.0,4746.0,1089385.0,38.0,182180.0,41709744.0,11784.0,942.0,669042.0,40.0,16.0,3.0,4.0,315.0,34.0,3.0,,,,,,,,,,,,,9571426.0,,,,,,,,,,,,,,,,,,,,,409577.0,157249.0,129583.0,,,,,,5114967.0,6605.0,,,,,,,336.5,336.5,1550505.0,1550505.0,41312.0,37.53,566182.0,,,,,,,,-326617.0,,,,5734808.0,,635134.0,,823763.0,,4206119.0,236587.0,9933.0,246520.0,22403590.0,,,14505.0,4166.0,236587.0,409577.0,,71.0,323250.0,323250.0,-100.0,,10115252.0,28690745.0,46.0,16836.0,4166.0,14505.0,7458813.0,,25218427.0,7458813.0,,25831005.0,,665971.0,,38.79,90.0,,,,,,,,,2462.0,,,,,,,,,,,,,,,,,,,,,,,,,,,,,,,,,,,,,,,,,,,,,,,,,,,,,,,04/04/2008,,,,,,,,,,,,,300 COMMUNITY DRIVE,MANHASSET,NY,10030,NASSAU,NORTH SHORE UNIVERSITY HOSPITAL,35004,P,,2,,,,,,,NSUH PSYCHIATRIC EXEMPT UNIT,33S106,335702,,,,,337148,,333550,,,,,,,1676883.0,,,,,475127160.0,,,,,,,,,,,,,,,,6880.0,,,,,,1733099.0,,,,,,,,,,,,,,-35287.0,,,,,,-608766209.0,,,,,,-2004188.0,,,,-134336.0,,-834.0,,,-3210270.0,,,,,,,,,,,,,,,,,,,,,,,,,,,,,,,,,,,,,2509582.0,14591.0,831664.0,277221.0,175087.0,,3107796.0,,,,,58362.0,,,2422038.0,,,,,2815984.0,,,,,,,,,,,,,,,1724228.0,,874256.0,728547.0,,,4177002.0,24285.0,1384239.0,461413.0,291418.0,,5172683.0,,,,,97140.0,,,4031293.0,,,,,4686985.0,,,,,,,,,,,,,,,,,,,,,,,,,,,,,,,,,,,,,,,,,,,,,,,,,,,,,,,,,,,,,,,,,,,,,,,,,,,,,,,,,,,,,,,,4463172.0,,,,,,,,,,,,,,,,,,,,,,2032.0,,,,,,,,,,,,,,,,503.0,,,,,,,,,,,,,,,,,,,,,,,,,,,,,,,,,,,,,,,,,,,,,,,,,,,,,,,,,,,,,1131706.0,10798.0,,,14932.0,,,,135.0,,,,,,,,,,,,,,,,,,,588689.0,1175.0,,,5239.0,,,,28.0,,,,,,,,,,,,,,,,,,,,,,,,,,,,,,,,,,,,,,,,,,,,,,,,,,,,,,,,,,,,,,,,,,,,,,,,,,,,,,,,,,,,,,,,,,,,,,,,,,,,,,,,,,,,,,,,,,,,,,,,,,,,,,,,,,,,,,,,,,,,,,,,,,,,,,,,,,,,,,,,,,,,,,,,,,,,,,,,,,,,,,,,,,,,,,,,,,,,,,,,,,,,,,,,,,,,,,,,,,,,,,,,,,,,,,,,,,,,,,,,,,,,,,,,,,,,,,,,,,,,,,,,,,2357.0,,,,,,,,,,,,,,,,,,,,,2.0,,,,,,,,,,,,,,,,,,,,,,,,34.0,,,,,,,,,,,,,,,,,,,,,,,,,,,,,,,,,,,,,,,5.0,,,,,,,,,,,,,,,,,,,,,,,,,,,,,,,,,,,-1.0,1.0,36593298.0,36474220.0,18958402.0,27485132.0,-497346465.0,10195054.0,10970111.0,3348612.0,10572067.0,1387358.0,,133723206.0,45602163.0,31364006.0,17458652.0,5913759.0,10156823.0,,18777938.0,11336978.0,13674612.0,24596234.0,71321982.0,8132660.0,836870.0,2298229.0,1450039.0,3910029.0,,57171344.0,170342597.0,199825569.0,36974527.0,,12964282.0,2030658.0,63790462.0,1364978.0,363729.0,1796896.0,22152753.0,3702857.0,3342616.0,-3354551.0,,-11699213.0,-28903056.0,-4144877.0,-1438793.0,36593298.0,14742501.0,1834561.0,11561861.0,5646841.0,11777685.0,5297387.0,,11571952.0,36474220.0,174528237.0,336330262.0,78431813.0,,43537361.0,6110805.0,40037460.0,7278737.0,10520552.0,,17586932.0,32272811.0,,44439045.0,17377469.0,26500057.0,738128.0,4216163.0,19596609.0,141008578.0,,86978736.0,14030220.0,70733647.0,13065229.0,18608023.0,,42909646.0,,70790394.0,52699479.0,235685.0,1083057.0,1332984.0,6858574.0,,9770740.0,603257.0,2574659.0,411933.0,411348.0,,3186102.0,,1275363.0,1801202.0,297579862.0,,96884998.0,134384268.0,352100172.0,88211720.0,60042104.0,,269963685.0,,110114487.0,97039979.0,145669786.0,,305126796.0,234262508.0,215085259.0,1925896.0,370039.0,,157830919.0,,35947080.0,158889527.0,99339316.0,,20111450.0,51357091.0,120910393.0,41361259.0,12277329.0,,80204656.0,,32458717.0,33073967.0,31602320.0,,4889633.0,1954600.0,13624557.0,5995232.0,3781638.0,,7801459.0,,15731474.0,6810393.0,99339316.0,,20111450.0,51357091.0,120910393.0,41361259.0,12277329.0,,80204656.0,,32458717.0,33073967.0,,,,,2444.0,,,,,,6319.0,26.0,,,,,258.0,,,,,,3063.0,5.0,13429361.0,8994129.0,,,,,,,3397470.0,,2882753.0,7217454.0,174765.0,9157033.0,19554952.0,11942765.0,10392227.0,10947306.0,,296552.0,4080147.0,3778210.0,,3695339.0,5902398.0,470669.0,23730.0,9812.0,1074537.0,33454848.0,16351.0,1196812.0,2933202.0,374664.0,1652069.0,229072.0,2210535.0,,13533960.0,,1863251.0,-31165296.0,,-111343.0,-7757125.0,,,-537875.0,,,-41211654.0,,-2912252.0,-1216920.0,,,-102023.0,3421200.0,9812.0,19062850.0,435537.0,11188713.0,22481828.0,10766891.0,12599375.0,525624.0,5988745.0,,15225111.0,99153803.0,3557169.0,5722363.0,379349.0,26901286.0,24155124.0,42877691.0,20909923.0,23048358.0,2544044.0,13310373.0,,23054378.0,131978471.0,16616331.0,1338395.0,584399.0,1208169.0,1106124.0,662940.0,1127964.0,600962.0,555641.0,,467062.0,1654480.0,1536839.0,182179.0,24155124.0,42877691.0,141008578.0,20909923.0,23048358.0,,86978736.0,2544044.0,14030220.0,13310373.0,,70733647.0,23054378.0,13065229.0,18608023.0,42909646.0,,131978471.0,70790394.0,16616331.0,52699479.0,1338395.0,137491745.0,243158546.0,60790353.0,30981156.0,3101715.0,43108125.0,,76897282.0,299208409.0,27902.0,1930250.0,40199224.0,3322617.0,1251989.0,228924366.0,,7032259.0,76953638.0,51714077.0,12722500.0,9517085.0,56100954.0,76063427.0,15774007.0,52517.0,887146.0,13398564.0,,25878443.0,103848098.0,10769.0,225750.0,3266008.0,35286.0,518395.0,655578.0,,7108472.0,36435624.0,2662.0,20620.0,10330.0,17420.0,4070.0,5518.0,476027.0,350393.0,15774007.0,52517.0,887146.0,13398564.0,,25878443.0,103848098.0,10769.0,225750.0,,66343109.0,18403334.0,,,53664502.0,811014.0,66202918.0,40541174.0,,45926777.0,1546720.0,328402.0,42770.0,56315049.0,,32142492.0,10596735.0,2314216.0,25138477.0,2077436.0,,,66343109.0,18403334.0,,,53664502.0,811014.0,66202918.0,40541174.0,,45926777.0,1546720.0,328402.0,42770.0,56315049.0,,32142492.0,10596735.0,2314216.0,25138477.0,2077436.0,161992.0,21105402.0,3810410.0,,,12106448.0,473908.0,2519617.0,1983639.0,,7106505.0,424864.0,47601.0,13174.0,5756936.0,,11277354.0,5135824.0,571975.0,5176364.0,189755.0,78511.0,40.0,47.0,14640.0,17202.0,5518.0,4070.0,1218.0,487.0,17420.0,10330.0,894830.0,,421692.0,47487014.0,2296872.0,1316522.0,2209003.0,51972.0,,2209003.0,4242473.0,1228012.0,638785.0,1228012.0,,,,,,,,,,,,187039.0,2785146.0,20618744.0,1214497.0,67426.0,294067.0,6350944.0,588619.0,,,,1260297.0,-79864.0,-2043007.0,942970.0,13.0,330846.0,3.0,34657548.0,,,,148685.0,9988952.0,,227075712.0,,99153803.0,41643.0,,,-326617.0,44611213.0,,30796491.0,,361581.0,72224592.0,,,968235.0,1247612.0,,,44130.0,72224592.0,,968235.0,123549396.0,,4160.0,9510429.0,,260.0,5657197.0,,260.0,5657197.0,278.0,,135.0,423065.0,69.0,349.63,,182180.0,326279.0,1317.0,,5414642.0,8262786.0,1550505.0,,,642466.0,1077788.0,2842637.0,-29393108.0,,,-54369.0,-6326.0,,,-81799.0,,,23517143.0,6002739.0,9340574.0,4393142.0,,39744770.0,1035932.0,525261.0,437718.0,6434451.0,904617.0,3822735.0,12853415.0,19342179.0,,996050.0,699479.0,,12853415.0,19342179.0,,53938943.0,137012768.0,,47060.0,,18361577.0,,16375.0,,3764.0,,,,,,,,,,,,,,,,,,,,,,,,,3836.0,9695.0,1332.0,345867.0,27666.0,,,16375.0,,,63002.0,,,,,20568.0,,,,,,283457.0,,,,,,15.0,5490.0,1332.0,215.0,3836.0,1534878.0,1967697.0,4916012.0,218260.0,-245120.0,,,,,6450890.0,1966579.0,11096183.0,3624432.0,524639.0,140917.0,11096183.0,3624432.0,10127299.0,19653965.0,34721040.0,110522.0,3439754.0,6231969.0,851050.0,1142825.0,3439754.0,6231969.0,,,,556.0,,,,114.0,5243241.0,2336343.0,7578750.0,16667088.0,965222.0,16667088.0,593707.0,110273605.0,153684.0,23104.0,153684.0,7825900.0,2697388.0,7825900.0,2697388.0,1936253.0,405509.0,25218427.0,4270459.0,,262716.0,,,-2313862.0,,48376160.0,1322905.0,,2217770.0,466899.0,1532012.0,,3691304.0,10709638.0,777116.0,1505664.0,6362642.0,2549913.0,3606559.0,65417.0,3606559.0,,11904520.0,,,118528.0,,61062.0,95796.0,,658073.0,180507.0,73121.0,113948.0,,,36785.0,331569.0,24541.0,,19286.0,3646.0,,69482.0,26164.0,22523.0,5392.0,,,17828.0,68275.0,,,,,,,,,,,,,,,,,,,,,,,,,,,,,,,,,,,,,,,,39793.0,,,71.0,,,,,,,,,,,,,,,,,,51.0,18666.0,820.0,9695.0,84968.0,84968.0,15582.0,,,,,217.0,113.0,,,,,,40.779269,-73.703029,Voluntary non-profit - Private,Acute Care Hospitals,NORTH SHORE UNIVERSITY HOSPITAL (330106)
34041,685016.0,330106,13001,2021-01-12 00:00:00,2015-01-01 00:00:00,2015-12-31,F,33,33400,2.0,2.0,5380,,,,,,,,,,512003.0,,,,,,,,,,,,,,,,,,,,,,,,,-1000734.0,,1052233.0,,,,,,,,,,,,,264361.0,,2911386.0,,,,,,,,,,,,,,864384.0,,-227965.0,,,,,,,,,,,,,,-2516241.0,,-5853551.0,,4021724.0,,,,,,,,,,,,,2470919.0,,,,,,,636261.0,,,,,493427.0,,,,,,,,,,,45281.0,,,,,,35116.0,,,,5584472.0,,,,,,,,,,,,,1710337.0,,143617.0,,,,,,,,,,,,109231.0,,5584472.0,,,,,,,,,,,,,1710337.0,,,,,,,,,,,,,,,,,,,,,,,,,7478634.0,,,,,,,,,,,,,,,,,,,12401.0,,7301.0,,,,,,,,,,,,,,,,,,,,,,,,,,,,,,,,,,,,,,,,2524.0,,,,,,,,,,,,,,,,,,,,,,,,,,625.0,1126716.0,801438.0,,,,,,,,,,,,,,,,,,,,,,,,,,,,,,,,,,,,,,,,,,,,,,,,,,,,,5490353.0,,,1480333.0,,,,16165899.0,,,,,,,,,,,,,,,,,,,5490353.0,,,,,,16165899.0,,,,,,,513258.0,,,,,,,,31.5,,,,,286.0,9864.0,,,,,,,,,,,,,,,,,,,,,,,,,,,,,,,,,,,,,,,,,,,,,,,,,,,,,,,,,,,92.0,,,,,,,,,,,,,7.0,5.0,6196276.0,838117170.0,591629655.0,191435344.0,838117170.0,55139293.0,25713065.0,55139293.0,117224.0,111605020.0,86301908.0,-246474993.0,-2813559.0,,-11740723.0,,-704987439.0,-77752.0,,1081739256.0,103224641.0,7848817.0,1095647421.0,7278407.0,-704987439.0,-1125701.0,1472399238.0,108266432.0,1368002990.0,280252475.0,111605020.0,30992450.0,1300757735.0,4255727832.0,1687555113.0,2043827672.0,6299555504.0,,280252475.0,280252475.0,110049191.0,122369211.0,257912175.0,637946865.0,122369211.0,814256.0,294219.0,426208.0,157647.0,12232427.0,50059439.0,55413500.0,55398371.0,56335706.0,56335788.0,54259172.0,148462.0,0.206484,1.0,9835.37,10638.51,613.0,766.0,1015.0,613.0,220053.0,275898.0,220053.0,,,,88710.0,99991.0,47255.0,,88710.0,225741.0,280503.0,169.0,,,225741.0,1957829.0,,15909575.0,30988491.0,,162956.0,21635089.0,,6391626.0,6391626.0,39157951.0,23092317.0,39157951.0,37380117.0,19289435.0,,,,-7941086.0,5617907.0,,7237.0,,,5625144.0,11953190.0,3430591.0,513888.0,1300967388.0,209653.0,1300757735.0,280252475.0,11953190.0,63754264.0,14175058.0,7260710.0,21435768.0,236476407.0,378055.0,225910.0,13805.0,150012.0,88710.0,16228258.0,12170125.0,378055.0,150012.0,60001.0,413655461.0,17633.0,277521.0,277521.0,413655461.0,323631.0,79620468.0,131989.0,1137887.0,1137887.0,1137887.0,711679.0,79602835.0,62023305.0,61763733.0,15129.0,1442054.0,937335.0,974831.0,241939.0,19446114.0,12348.0,28867.0,6.0,2190.0,,9162.0,206.0,12348.0,35214.0,,9162.0,13805.0,2274.0,1081739256.0,72627903.0,1535845.0,,184336147.0,33075110.0,,4732013.0,68774923.0,10952306.0,132645913.0,10006921.0,,10424261.0,13192431.0,9857543.0,12281765.0,3482295.0,37218783.0,10447728.0,3096136.0,3533058.0,295630305.0,1081739256.0,85503906.0,1535845.0,,184336147.0,33075110.0,,4732013.0,68774923.0,10952306.0,132645913.0,10006921.0,,10424261.0,13192431.0,9857543.0,1480333.0,12281765.0,3482295.0,37218783.0,10304145.0,3096136.0,3533058.0,295630305.0,20798139.0,1860484.0,17316.0,,208177.0,2140380.0,46532.0,,407163.0,576279.0,388180.0,62611.0,227323.0,136650.0,152560.0,214444.0,111379.0,98263.0,4662058.0,52.01,45.96,88.7,,52.61,61.97,215.05,,25.6,22.89,25.39,23.64,54.03,25.48,243.96,48.05,27.8,35.96,63.41,733791619.0,88793802.0,644997817.0,1535845.0,189068160.0,835601822.0,733506026.0,101669805.0,631836221.0,1535845.0,189068160.0,822440226.0,223955019.0,15326671.0,2373742.0,12952929.0,17316.0,12970245.0,4712430.0,47.86,42.83,48.78,88.7,29.92,63.41,47.52,,16165899.0,25442898.0,79209.0,690075.0,6169829.0,6141681.0,16746731.0,25939533.0,15144081.0,43255295.0,45389346.0,3163142.0,4032095.0,15144081.0,43255295.0,45389346.0,79035308.0,54734385.0,165457000.0,15144081.0,15144081.0,323770.0,5423510.0,4961680.0,43255295.0,23572222.0,6115646.0,1870248.0,323770.0,17954511.0,6115646.0,447.86,249.0,90885.0,45091.0,7070.0,82743.0,-109243.0,12092811.0,3460820.0,,-241377.0,,9083697.0,4801679.0,13051011.0,21837916.0,835948.0,21837916.0,4033107.0,33060547.0,1440551.0,848087.0,12012.0,12012.0,,,7072.0,,,,,,221.0,16181.0,,,,1255903.0,,,,,1255903.0,,,55490.0,,,,22.63,,118507.0,26446323.0,8120.0,278548.0,37201.0,8058717.0,747.0,191111.0,4622.0,1056380.0,1765.0,21188.0,3839.0,859350.0,20.0,164169.0,36420770.0,10171.0,767.0,500711.0,40.0,16.0,3.0,4.0,314.0,34.0,3.0,,,,,,,,,,,,,9167348.0,,,,,,,,,,,,,,,,,,,,,293227.0,112209.0,82500.0,,,,,,5354061.0,5919.0,,,,,,,331.82,331.82,1442009.0,1442009.0,39559.0,36.45,1236557.0,,,,,,,,-32120.0,,,,6062472.0,,652412.0,,1311257.0,,5099740.0,441580.0,20250.0,461830.0,26578251.0,,,14640.0,4930.0,441580.0,293227.0,,143.0,277364.0,277364.0,-82.0,,1301736.0,25963566.0,,,4930.0,14640.0,6621080.0,,24871254.0,6621080.0,,25156847.0,,666276.0,,37.76,207.0,,,,,,,,,2332.0,,,,,,,,,,,,,,,,,,,,,,,,,,,,,,,,,,,,,,,,,,,,,,,,,,,,,,,04/04/2008,,,,,,,,,,,,,300 COMMUNITY DRIVE,MANHASSET,NY,10030,NASSAU,NORTH SHORE UNIVERSITY HOSPITAL,35004,P,,2,,,,,,,NSUH PSYCHIATRIC EXEMPT UNIT,33S106,335702,,,,,337148,,333550,,,,,,,1480333.0,,,,,404492091.0,,,,,,,,,,,,,,,,17462.0,,,,,,1708390.0,,,,,,,,,,,,,,-112100.0,,,,,,-522834775.0,,,,,,,,,,-125040.0,,-316.0,,,-2985814.0,,,,,,,,,,,,,,,,,,,,,,,,,,,,,,142834.0,,,,,,,2116540.0,12985.0,701185.0,233728.0,142834.0,,2609967.0,,,,,51940.0,,,2038630.0,,,,,2363254.0,,,,,,,,,,,236396.0,,,,1439866.0,,730678.0,601735.0,,,3502957.0,21490.0,1160489.0,386830.0,236396.0,,4319597.0,,,,,85962.0,,,3374014.0,,,,,3911278.0,,,,,,,,,,,,,,,,,,,,,,,,,,,,,,,,,,,,,,,,,,,,,,,,,,,,,,,,,,,,,,,,,,,,,,,,,,,,,,,,,,,,,,,,3541089.0,,,,,,,,,,,,,,,,,,,,,,,,,6639.0,,,3357.0,,,680.0,,,,,,,,,,1766.0,,,678.0,,,1243.0,,,,,,,,,,,,,,,,,,,,,,,,,,,,,,,,,,,,,,,,,,,,,,,,,,,,600992.0,48528.0,,,10231.0,,,,,,,,,,,,,,,,,,,,,,,423730.0,1324.0,,,3682.0,,,,,,,,,,,,,,,,,,,,,,,,,,,,,,,,,,,,,,,,,,,,,,,,,,,,,,,,,,,,,,,,,,,,,,,,,,,,,,,,,,,,,,,,,,,,,,,,,,,,,,,,,,,,,,,,,,,,,,,,,,,,,,,,,,,,,,,,,,,,,,,,,,,,,,,,,,,,,,,,,,,,,,,,,,,,,,,,,,,,,,,,,,,,,,,,,,,,,,,,,,,,,,,,,,,,,,,,,,,,,,,,,,,,,,,,,,,,,,,,,,,,,,,,,,,,,,,,,,,,,,,,,,,,,,2524.0,,,,,,,,,,,,,,,,,,,,,,,,,,,,,,,,,,,,,,,,,,,,,,,,,,,,,,,,,,,,,,,,,,,,,,,,,,,,,,,,,,,,,,625.0,,,,,,,,,,,,,,,,,,,,,,,,,,,,,,,,,133911.0,-16687.0,54752673.0,56852347.0,38269390.0,48032518.0,-434906472.0,9857543.0,12281765.0,3482295.0,10447728.0,3096136.0,,132645913.0,41611321.0,28379663.0,19597288.0,5732814.0,9838989.0,,16469657.0,10424261.0,13192431.0,22599898.0,62516532.0,8338381.0,1006610.0,1607050.0,12272824.0,2601897.0,,66999768.0,158242802.0,184809962.0,38023191.0,,16227173.0,1870106.0,57106589.0,1360933.0,443891.0,3887865.0,21254334.0,2941132.0,3221377.0,-2813559.0,,-11762678.0,-45120117.0,-2955254.0,-1379123.0,54752673.0,14533053.0,2248102.0,13176862.0,5089345.0,22565484.0,5523017.0,,13502895.0,56852347.0,162334365.0,272975732.0,76591472.0,,42743140.0,5221732.0,42736573.0,7093747.0,10282880.0,,18226290.0,30671032.0,,29582546.0,16133563.0,24442152.0,756079.0,4585440.0,35902097.0,136068520.0,,84207496.0,11692187.0,72351575.0,12083325.0,17596170.0,,42538719.0,,49526406.0,48445181.0,311895.0,1628282.0,2757233.0,10507066.0,,12405762.0,967540.0,4106804.0,599718.0,679743.0,,4955046.0,,1508352.0,2869212.0,305276149.0,,85168144.0,120044572.0,299652518.0,55083627.0,47458229.0,,254711683.0,,91135192.0,94185146.0,175785049.0,,255679380.0,214006731.0,211676699.0,1253151.0,398939.0,,141167508.0,,30300989.0,153319849.0,79920511.0,,22356651.0,46043561.0,100724765.0,25276342.0,11894003.0,,77020716.0,,29836200.0,29281670.0,22605596.0,,5949729.0,1611571.0,12105009.0,5421371.0,4373199.0,,8138530.0,,12168366.0,5731418.0,79920511.0,,22356651.0,46043561.0,100724765.0,25276342.0,11894003.0,,77020716.0,,29836200.0,29281670.0,,,3204.0,,230.0,,,,,,22585.0,,,,1281.0,,26.0,,,,,,9211.0,,10447877.0,8841558.0,,,,,,,3533058.0,,2819630.0,8328414.0,170007.0,8612865.0,16525392.0,10952306.0,10360964.0,10236931.0,,71945.0,3351626.0,3419307.0,,3270481.0,5421088.0,490316.0,28131.0,17918.0,971975.0,46548852.0,27215.0,1238786.0,2643358.0,373505.0,1526638.0,194410.0,2202520.0,,9507663.0,,2722899.0,-14787160.0,,-2002.0,-6860743.0,,,-574739.0,,,-33930448.0,,-1953049.0,-1000734.0,,,-102022.0,3561189.0,17918.0,18862608.0,360834.0,10960564.0,19166818.0,10734469.0,11763569.0,266355.0,5621827.0,,12778144.0,91440563.0,4146001.0,5956844.0,391334.0,26001639.0,23473043.0,37540115.0,20487538.0,21712355.0,2417847.0,11713630.0,,19019795.0,118752122.0,18595052.0,1389778.0,867940.0,1973051.0,1790022.0,1060576.0,1758681.0,930101.0,730140.0,,690807.0,2803659.0,2984748.0,278657.0,23473043.0,37540115.0,136068520.0,20487538.0,21712355.0,,84207496.0,2417847.0,11692187.0,11713630.0,,72351575.0,19019795.0,12083325.0,17596170.0,42538719.0,,118752122.0,49526406.0,18595052.0,48445181.0,1389778.0,126019735.0,220362246.0,59336811.0,29972817.0,4980164.0,41081061.0,,65459357.0,255029701.0,150570.0,1167250.0,45360139.0,426711.0,832613.0,199133569.0,,6047680.0,74912674.0,52630314.0,12270097.0,9518739.0,50050074.0,73711207.0,14856664.0,24168.0,1645402.0,13109670.0,,23843933.0,80868326.0,24271.0,,2907211.0,17262.0,684412.0,639267.0,,6342129.0,29105966.0,6875.0,,10404.0,17327.0,4219.0,5739.0,800091.0,592896.0,14856664.0,24168.0,1645402.0,13109670.0,,23843933.0,80868326.0,24271.0,,,69205939.0,19924633.0,,,48159165.0,606456.0,59575536.0,32647841.0,,41981823.0,2064521.0,239264.0,7597.0,53172244.0,,28783375.0,8772600.0,8248058.0,24315709.0,1958950.0,,,69205939.0,19924633.0,,,48159165.0,606456.0,59575536.0,32647841.0,,41981823.0,2064521.0,239264.0,7597.0,53172244.0,,28783375.0,8772600.0,8248058.0,24315709.0,1958950.0,323631.0,19574969.0,3898932.0,,,12846865.0,252258.0,2085203.0,1592007.0,,7690944.0,549132.0,51318.0,2793.0,5782564.0,,10359655.0,3577808.0,3285893.0,4759411.0,202608.0,131989.0,40.0,47.0,14600.0,17155.0,5739.0,4219.0,1371.0,866.0,17327.0,10404.0,1054434.0,,408737.0,32446253.0,2890098.0,1463171.0,2386841.0,91145.0,,2386841.0,3375571.0,1303145.0,918784.0,1303145.0,,,,,,,,,,60893.0,17224.0,229283.0,2876972.0,12932613.0,1255892.0,91666.0,327966.0,4755076.0,512202.0,,,,1255903.0,-99005.0,-1806628.0,788237.0,,283701.0,,28487888.0,,,,229129.0,8909607.0,,202444229.0,,91440563.0,31415.0,,,-32120.0,37049516.0,,23155188.0,,365313.0,58723254.0,,,972874.0,2165629.0,,,73087.0,58723254.0,,972874.0,94358807.0,,9775.0,9958433.0,,2439.0,3473181.0,,2439.0,3473181.0,,,1720.0,281269.0,,280.57,,164169.0,288989.0,1199.0,,3969770.0,8055983.0,1442009.0,,,399528.0,749344.0,3262078.0,-41667129.0,,,,-1932.0,,,-130856.0,,,23392342.0,4369298.0,8805327.0,4609051.0,,38253546.0,869989.0,441487.0,363577.0,5778285.0,2765786.0,3220258.0,10465334.0,18116183.0,,1476941.0,1120092.0,,10465334.0,18116183.0,,49567968.0,124334213.0,,113955.0,,16689330.0,,47265.0,,9422.0,,,,,,,,,,,,,,,,,,,,,,,,,3910.0,9316.0,1323.0,499737.0,21988.0,,,47265.0,,,59971.0,,,,,17633.0,,,,,,244099.0,,,,,,15.0,5475.0,1323.0,244.0,3910.0,1417372.0,1897688.0,4819763.0,322791.0,-111513.0,,,,,6237135.0,1970651.0,11880703.0,3504352.0,791179.0,212374.0,11880703.0,3504352.0,9804045.0,17274260.0,28745391.0,71833.0,3520267.0,5643699.0,1084925.0,1140168.0,3520267.0,5643699.0,,,,,,,,,4997880.0,2103006.0,7100570.0,16162992.0,1532198.0,16162992.0,5113971.0,114724106.0,3849415.0,519186.0,3849415.0,8059689.0,2378764.0,8059689.0,2378764.0,2483948.0,320833.0,24871254.0,3951382.0,,303807.0,,,-1764505.0,,47057076.0,1253386.0,,2428178.0,389547.0,1285506.0,,4018730.0,9563288.0,644716.0,4577484.0,5329652.0,2127563.0,3383558.0,109943.0,3383558.0,,14761054.0,,,90325.0,,79634.0,136777.0,20535.0,649975.0,135164.0,73413.0,125855.0,,2607.0,71064.0,398116.0,17675.0,,27126.0,4787.0,1001.0,74494.0,28991.0,26993.0,4662.0,,938.0,28983.0,77925.0,,,,,,,,,,,,,,,7721.0,,,,,,,,,,,,,,,,,,,,,,,,,33265.0,,,143.0,,,,,,,,,,,,,,,,,,51.0,18615.0,499.0,9316.0,65665.0,65665.0,13266.0,,,,,2813.0,1983.0,,,,,,40.779269,-73.703029,Voluntary non-profit - Private,Acute Care Hospitals,NORTH SHORE UNIVERSITY HOSPITAL (330106)
40474,685252.0,330106,13001,2021-01-11 00:00:00,2014-01-01 00:00:00,2014-12-31,F,33,33400,2.0,2.0,5380,,,,,,,,,,118272.0,,,,,,,,,,,,,,,,,,,,,,,,,-981634.0,,1093134.0,,,,,,,,,,,,,288896.0,,2182266.0,,,,,,,,,,,,,,756634.0,,-254582.0,,,,,,,,,,,,,,-2303128.0,,-7249533.0,,3400687.0,,,,,,,,,,,,,2184949.0,,,,,,,,,,,,467126.0,,,,,,,,,,,,,,,,,36963.0,,,,4679025.0,,,,,,,,,,,,,2173869.0,,143720.0,,,,,,,,,,,,135245.0,,4679025.0,,,,,,,,,,,,,2173869.0,,,,,,,,,,,,,,,,,,,,,,,,,7987131.0,,,,,,,,,,,,,,,,,,,,,,,,,,,,,,,,,,,,,,,,,,,,,,,,,,,,,,,,,,,,,2700.0,,,,,,,,,,,,,,,,,,,,,,,,,,2468.0,1034840.0,1210255.0,,,,,,,,,,,,,,,,,,,,,,,,,,,,,,,,,,,,,,,,,,,,,,,,,,,,,8330197.0,,,1387839.0,,,,14405196.0,,,,,,,,,,,,,,,,,,,8330197.0,,,,,,14405196.0,,,,,,,513519.0,,,,,,,,28.05,,,,,311.0,8972.0,,,,,,,,,,,,,,,,,,,,,,,,,,,,,,,,,,,,,,,,,,,,,,,,,,,,,,,,,,,,,,,,,,,,,,,,7.0,5.0,6196276.0,812466516.0,555521340.0,183275524.0,781143370.0,56516132.0,23837629.0,127928604.0,18260714.0,104311995.0,77488527.0,-213709504.0,-2614214.0,,-2327941.0,,-608112614.0,,-70977.0,1009628358.0,94632786.0,11549508.0,919621554.0,7342052.0,-608112614.0,-843611.0,1321137298.0,100004277.0,1222690137.0,253952942.0,104311995.0,27073485.0,1175554792.0,3806000694.0,1464500456.0,1922458127.0,5728458821.0,,253952942.0,253952942.0,101912210.0,115170835.0,241265801.0,573469989.0,115170835.0,506335.0,179058.0,270955.0,97016.0,12287189.0,45967452.0,51081140.0,51049799.0,51740949.0,51742006.0,49367776.0,129135.0,0.205213,1.0,9528.73,10310.92,615.0,768.0,1063.0,615.0,213834.0,269679.0,213834.0,,,,84370.0,95471.0,42851.0,,84370.0,210149.0,263914.0,90.0,,,210149.0,1839076.0,,15165360.0,19145794.0,,237026.0,90812507.0,,11842697.0,11842697.0,30865316.0,15677809.0,30865316.0,30988491.0,17639511.0,,,,-8166219.0,5546896.0,,8372.0,,,5555268.0,11487426.0,3337575.0,504744.0,1175663505.0,108713.0,1175554792.0,253952942.0,11487426.0,58645116.0,12689127.0,7401590.0,20090717.0,221175084.0,360713.0,210239.0,14084.0,142735.0,84370.0,14455034.0,10864325.0,360713.0,142735.0,67580.0,386102354.0,20280.0,317255.0,317255.0,386102354.0,212593.0,71168744.0,91897.0,718928.0,718928.0,718928.0,447973.0,71148464.0,58080702.0,57802796.0,31341.0,1063307.0,691150.0,855228.0,257626.0,27156030.0,11185.0,22828.0,7.0,2555.0,,8462.0,290.0,10693.0,28997.0,492.0,8462.0,14084.0,2492.0,1009628358.0,64216606.0,868713.0,,187854708.0,29465502.0,,7464190.0,62078780.0,10413158.0,119742052.0,12531387.0,,10383048.0,12653284.0,9510428.0,9045722.0,3545228.0,34762119.0,9845427.0,5051798.0,3414765.0,234657526.0,1009628358.0,77545542.0,868713.0,,187854708.0,29465502.0,,7464190.0,62078780.0,10413158.0,119734891.0,12531387.0,,10383048.0,12653284.0,9510428.0,1387839.0,9045722.0,3545228.0,34762119.0,9698876.0,5051798.0,3414765.0,234657526.0,20124825.0,1812950.0,12913.0,,240991.0,2091399.0,59620.0,,408207.0,570995.0,388142.0,59615.0,172464.0,143945.0,149048.0,206693.0,179663.0,102561.0,3116195.0,50.17,42.77,67.27,,43.21,57.25,210.19,,25.44,22.16,24.5,23.28,52.45,24.63,233.23,46.92,28.12,33.29,75.3,727691649.0,78621802.0,649069847.0,868713.0,195318898.0,845257458.0,727341339.0,91950738.0,635390601.0,868713.0,195318898.0,831578212.0,211262939.0,16227552.0,2326469.0,13901083.0,12913.0,13913996.0,4761879.0,44.82,39.52,45.71,67.27,30.74,59.77,44.37,,14405196.0,23461555.0,57228.0,625326.0,6408173.0,5520217.0,14914217.0,22439989.0,13686900.0,38845383.0,39418020.0,2879030.0,4239573.0,13686900.0,38845383.0,39418020.0,82170971.0,54121941.0,157022582.0,13686900.0,13686900.0,285844.0,4123261.0,3764239.0,38845383.0,20479972.0,4873568.0,1431621.0,285844.0,12950947.0,4873568.0,457.65,249.0,90885.0,43036.0,8995.0,81629.0,-116305.0,14614866.0,454369.0,,-1179397.0,,8697600.0,3939060.0,11703888.0,20394338.0,887687.0,20394338.0,3193840.0,31822433.0,1011468.0,589104.0,1824.0,1824.0,,,1062.0,,,,,,259.0,16319.0,,,,2495063.0,,,,,2495063.0,,,99047.0,,,,25.19,,110146.0,21655040.0,7491.0,308758.0,29590.0,5699000.0,571.0,153672.0,3677.0,733195.0,1377.0,15228.0,4184.0,819905.0,24.0,147597.0,28907140.0,9179.0,595.0,486630.0,60.0,14.0,3.0,4.5,313.0,34.0,3.0,,,,,,,,,,,,,9207296.0,,,,,,,,,,,,,,,,,,,,,215376.0,83152.0,48091.0,,,,,,5113688.0,5719.0,,,,,,,327.82,327.82,1397452.0,1397452.0,38537.0,36.26,1198745.0,,,,,,,,-456248.0,,,,5462989.0,,728546.0,,1181155.0,,3837417.0,331179.0,27843.0,359022.0,22364055.0,,,15080.0,4228.0,331179.0,215376.0,,29.0,317204.0,317204.0,-1057.0,,4701354.0,11002696.0,46.0,16790.0,4228.0,15080.0,5964315.0,,23716128.0,5964315.0,,24066438.0,,655636.0,,36.71,191.0,,,,,,,,,3589.0,,,,,,,,,,,,,,,,,,,,,,,,,,,,,,,,,,,,,,,,,,,,,,,,,,,,,,,04/04/2008,,,,,,,,,,,,,300 COMMUNITY DRIVE,MANHASSET,NY,10030,NASSAU,NORTH SHORE UNIVERSITY HOSPITAL,35004,P,,2,,,,,,,NSUH PSYCHIATRIC EXEMPT UNIT,33S106,335702,,,,,337148,,333550,,,,,,,1387839.0,,,,,386678113.0,,,,,,,,838543.0,,,,,,,,33271.0,,,,,,1887288.0,,,,,,2653955.0,,,,,,,,,,,,,,-486382599.0,,,,,,,,,,-119617.0,,,,,-2977096.0,,,,,,,,,,,,,,,,,,3492498.0,,,,,,,,,,,,135221.0,,,,,,,1991431.0,12293.0,651518.0,221270.0,135221.0,,2458557.0,,,,,49171.0,,,1917674.0,,,,,2224994.0,,,,,,,,,,,227084.0,,,,1383149.0,,701897.0,578033.0,,,3344331.0,20644.0,1094133.0,371593.0,227084.0,,4128803.0,,,,,82576.0,,,3220465.0,,,,,3736566.0,,,,,,,,,,,,,,5037488.0,,,,,,,,,,,,,,,419582.0,,,,,,,,,,,,,,,,,,,5037488.0,,,,,,,,,,,,,,,,,,,,,,,,,,,,,,,,13673433.0,,,,,,,,3464168.0,,,,,,,,,,,,,,,,,,,,,29327.0,,,,4.0,,,16532.0,7.0,,39813.0,,,,,,13284.0,,,,1.0,,,3841.0,1.0,,55891.0,,,,,,,,,,,,,,,,,,,,,,,,,,,,,,,,,,,,,,,,,,,,162.0,,,,,,,,408057.0,,483.0,,5468.0,,,,61744.0,,,,,,,,,,,5.0,,,,,,,,280373.0,,112.0,,1919.0,,,,10363.0,,,,,,,,,,,,,,,,,,,,,,,,,,,,,,,,,,,,,,,,,,,,,,,,,,,,,,,,,,,,,,,,,,,,,,,,,,,,,,,,,,,,,,,,,,,,,,,,,,,,,,,,,,,,,,,,,,,,,,,,,,,,,,,,,,,,,,,,,,,,,,,,,,,,,,,,,,,,,,,,,,,,,,,,,,,,,,,,,,,,,,,,,,,,,,,,,,,,,,,,,,,,,,,,,,,,,,,,,,,,,,,,,,,,,,,,,,,,,,,,,,,,,,,,,,,,,,,,,,,,,,,,,,2700.0,,,,,,,,,,,,,,,,,,,,,,,,,,,,,,,,,,,,,,,,,,,,,,,,,,,,,,,,,,,,,,,,,,,,,,,,,,,,,,,,,,,,,,2468.0,,,,,,,,,,,,,,,,,,,,,,,,,6964.0,,,,,,,,9233616.0,9027098.0,44066803.0,60245192.0,33034500.0,44454027.0,-379785877.0,9510428.0,9045722.0,3545228.0,9845427.0,5051798.0,,119742052.0,37477801.0,24697016.0,18787328.0,5563930.0,9400829.0,,13458994.0,10383048.0,12653284.0,20596206.0,50294454.0,7676564.0,703591.0,2830243.0,11492389.0,5160947.0,,60332651.0,139842983.0,121484786.0,32301659.0,,12413705.0,1850897.0,56067765.0,1459601.0,460821.0,4122879.0,20439491.0,3128823.0,2530332.0,-2614214.0,,-2393132.0,-21328130.0,-2776298.0,-1378636.0,44066803.0,13837635.0,2042211.0,9655145.0,6375306.0,21179780.0,10212745.0,,11604044.0,60245192.0,144216931.0,218955769.0,67003162.0,,36310974.0,4677650.0,42395444.0,7023531.0,9861485.0,,16117905.0,29840905.0,,25043419.0,15781934.0,21747902.0,655051.0,4232730.0,19189459.0,119006432.0,,71887490.0,10619167.0,69032362.0,11442736.0,16115370.0,,36447089.0,,49225626.0,43193272.0,259013.0,1479727.0,2256297.0,10396888.0,,11739059.0,919681.0,3796229.0,529121.0,611844.0,,4440565.0,,1950558.0,2828386.0,277666873.0,,82911015.0,122092089.0,236533038.0,44319879.0,41068266.0,,210209807.0,,87448492.0,95413049.0,162427709.0,,242118785.0,210050240.0,199964509.0,1110675.0,333815.0,,112228522.0,,26429154.0,161942927.0,76773794.0,,20489050.0,48261404.0,80862881.0,21769945.0,11693550.0,,68554293.0,,28030036.0,32887880.0,20760478.0,,5425068.0,1543014.0,11309799.0,5483261.0,4551609.0,,7673126.0,,12116488.0,5519737.0,76773794.0,,20489050.0,48261404.0,80862881.0,21769945.0,11693550.0,,68554293.0,,28030036.0,32887880.0,,,,,1360.0,,,,,,19894.0,,,,,,182.0,,,,,,8600.0,,8498737.0,9140774.0,,,,,,,3414765.0,,1999264.0,7012523.0,166354.0,7650627.0,15700183.0,10413158.0,10231590.0,9923309.0,,50030.0,2826753.0,2803027.0,,3120912.0,5433476.0,508944.0,27622.0,10032.0,241558.0,20446356.0,13789.0,990883.0,2345550.0,426427.0,1676217.0,367934.0,2348954.0,,9091971.0,,2772676.0,-14790621.0,,-10102.0,-6039210.0,,,-379252.0,,,-32453018.0,,-1355593.0,-981634.0,,-173.0,-102023.0,3442387.0,10032.0,17279411.0,345340.0,9758358.0,18045134.0,10658017.0,11599526.0,417964.0,5151981.0,,12212883.0,78748733.0,3893557.0,6498897.0,420674.0,23058105.0,20723709.0,34933200.0,19557935.0,20469063.0,2392044.0,10768235.0,,17868385.0,99909148.0,18863917.0,1359811.0,803334.0,1647629.0,1773632.0,1037911.0,1564651.0,827734.0,845665.0,,685024.0,2576029.0,2694266.0,239914.0,20723709.0,34933200.0,119006432.0,19557935.0,20469063.0,,71887490.0,2392044.0,10619167.0,10768235.0,,69032362.0,17868385.0,11442736.0,16115370.0,36447089.0,,99909148.0,49225626.0,18863917.0,43193272.0,1359811.0,119722478.0,198821041.0,57615012.0,30434401.0,4870572.0,43961711.0,,59549253.0,221487949.0,267585.0,1167250.0,42844238.0,884948.0,410355.0,180443172.0,,5893068.0,63133124.0,46521468.0,13917973.0,7500693.0,43922754.0,72260015.0,14643056.0,37243.0,1542970.0,14367876.0,,24955649.0,72435545.0,55255.0,105700.0,2850783.0,24341.0,698902.0,689457.0,,6813890.0,25426687.0,18334.0,9528.0,10115.0,15918.0,3661.0,6023.0,596340.0,671083.0,14643056.0,37243.0,1542970.0,14367876.0,,24955649.0,72435545.0,55255.0,105700.0,,63084973.0,19070354.0,713.0,,47394386.0,702803.0,58670611.0,30588231.0,,40261852.0,1909278.0,178004.0,,42501328.0,,26306879.0,8411573.0,2798408.0,24866932.0,2224250.0,,,63084973.0,19070354.0,713.0,,47394386.0,702803.0,58670611.0,30588231.0,,40261852.0,1909278.0,178004.0,,42501328.0,,26306879.0,8411573.0,2798408.0,24866932.0,2224250.0,212593.0,17058871.0,3712712.0,466.0,,11393927.0,318341.0,1875817.0,1467807.0,,7782477.0,521309.0,44834.0,,4849590.0,,9234372.0,3636054.0,1083461.0,4173542.0,200498.0,91897.0,40.0,47.0,14600.0,17155.0,6023.0,3661.0,229.0,657.0,15918.0,10115.0,946613.0,,406001.0,27639634.0,1398494.0,1352614.0,2203487.0,134566.0,,2203487.0,3192981.0,1413865.0,971455.0,1413865.0,,,,,,,,,,24932.0,6742.0,120670.0,1240386.0,9994001.0,1119976.0,40858.0,165733.0,3890075.0,484130.0,,,,2495063.0,-114042.0,-1681930.0,485081.0,,170276.0,,23893348.0,,,,428597.0,7051241.0,,179760266.0,,78748733.0,59462.0,-165.0,-165.0,-456248.0,30936680.0,,20326337.0,,560068.0,47420186.0,,,1302463.0,2146963.0,,,116253.0,47420186.0,,1302463.0,84142291.0,,13993.0,10861632.0,,1620.0,2962391.0,,1620.0,2962391.0,,,1113.0,336962.0,,255.9,,147597.0,251732.0,1151.0,,3581342.0,7862032.0,1397452.0,,,345409.0,906222.0,3481927.0,-16343733.0,,,,-599.0,,,-107427.0,,,22780205.0,3926751.0,8768254.0,4875868.0,,35944108.0,823617.0,417955.0,344198.0,5421119.0,2593778.0,3024026.0,9253276.0,17642786.0,,1266728.0,1041753.0,,9253276.0,17642786.0,,45701011.0,129465106.0,,62538.0,,17002357.0,,10223.0,,3389.0,,,,,,,,,,,,,,,,,,,,,,,,,3785.0,9863.0,1417.0,474227.0,15658.0,,,10223.0,,,67580.0,,,,,20280.0,,,,,,274598.0,,,,,,15.0,5475.0,1417.0,50.0,3785.0,1366388.0,1728193.0,4338474.0,333047.0,-94168.0,,,,,5704862.0,1867961.0,12079585.0,3214478.0,819723.0,226347.0,12079585.0,3214478.0,10066656.0,13731448.0,25626113.0,105274.0,3457650.0,4194917.0,1170179.0,974542.0,3457650.0,4194917.0,,,,,,,,,4933184.0,2051446.0,6984630.0,15969485.0,1747594.0,15969485.0,4832170.0,104839397.0,3761117.0,547664.0,3761117.0,6944541.0,2337049.0,6944541.0,2337049.0,2350255.0,340302.0,23716128.0,3772465.0,,289762.0,,,-1286233.0,,46073181.0,1085131.0,,2274166.0,368784.0,1204693.0,,3819142.0,9104009.0,619320.0,4355887.0,5078427.0,2023113.0,2978664.0,107115.0,2978664.0,,15709166.0,,,37375.0,,63333.0,104262.0,13756.0,452514.0,77646.0,44967.0,110138.0,,,11997.0,404866.0,7276.0,,18609.0,3333.0,660.0,60467.0,19557.0,17503.0,5438.0,,,5186.0,67951.0,,,,,,,,,,,,,,,19403.0,,,,,,,,,4746630.0,,,,,,,,,,,,,,,,42606.0,,,29.0,,,,,,4746630.0,,,,,,752977.0,,,,,,51.0,18615.0,1005.0,9863.0,137724.0,137724.0,31995.0,,,,,152.0,104.0,,,,,,40.779269,-73.703029,Voluntary non-profit - Private,Acute Care Hospitals,NORTH SHORE UNIVERSITY HOSPITAL (330106)
43315,572883.0,330106,10001,2016-03-24 00:00:00,2013-01-01 00:00:00,2013-12-31,F,33,33400,2.0,2.0,5380,,,,,,,,,,694906.0,,,,,,,,,,,,,,,,-38874.0,,,,,,,,,-1188033.0,,915022.0,,,,,,,,,,,,,,,1301046.0,,,,,,,,,,,,,,,,-224805.0,,,,,,,,,,,,,,-2295850.0,,-5158835.0,,2218974.0,,,,,,,,,,,,,2340875.0,,,,,,,595858.0,,,,,462094.0,,,,,,,,,,,54315.0,,,,,,42122.0,,,,3060611.0,,,,,,,,,,,,,1716560.0,,87119.0,,,,,,,,,,,,73861.0,,3060611.0,,,,,,,,,,,,,1716560.0,,,,,,,,,,,,,,,,,4219369.0,,,,,,,,5116580.0,,,,,,,,,,,,,,,,,,,,,,,,,,,,,,,,,,,,,,,,,,,,,,,,,,,,,,,,,,,,,,,,,,,,,,,,,,,,,,,,,,,,,,,,621652.0,521349.0,,,,,,,,,,,,,,,,,,,,,,,,,,,,,,,,,,,,,,,,,,,,,,,,,,,,,8233775.0,,,1378031.0,,,,13622124.0,,,,,,,,,,,,,,,,,,,8233775.0,,,,,,13794411.0,,,,,,,516117.0,,,,,,,,26.73,,,,,258.0,5866.0,,,,,,,,,,,,,,,,,,,,,,,,,,,,,,,,,,,,,,,,,,,,,,,,,,,,,,,,,,,,,,,,,4.3,,7.0,,,,,7.0,,6196276.0,844186315.0,643305248.0,172025135.0,850569384.0,150472018.0,26070758.0,150700891.0,13136788.0,91282113.0,76355315.0,-206108619.0,-2419238.0,,-3211803.0,,-491292140.0,,,928843331.0,91696734.0,10974864.0,855296840.0,7768737.0,-491292140.0,-1158134.0,1292848031.0,98968183.0,1209926194.0,256154872.0,91282113.0,23307667.0,1159441822.0,3544932145.0,1336706837.0,1757896992.0,5302829137.0,,256154872.0,256154872.0,97424914.0,110949351.0,239932318.0,507789512.0,110949351.0,813607.0,304409.0,319336.0,158351.0,10974406.0,36517123.0,40698488.0,40678339.0,41168414.0,41169037.0,39887439.0,138597.0,0.218646,1.0,9079.4,9837.6,576.0,729.0,1024.0,576.0,211869.0,270052.0,211869.0,,,,80316.0,92787.0,39895.0,,80316.0,211171.0,259577.0,,,,211171.0,2378183.0,,14756679.0,11907863.0,,140740.0,116244149.0,,7237931.0,7237931.0,44216026.0,19922259.0,44774868.0,19145794.0,14596063.0,,,,-11266735.0,4268520.0,,1012.0,,,4269532.0,9433562.0,2367204.0,377507.0,1159441822.0,,1159441822.0,256154872.0,9433562.0,55500221.0,10743235.0,6375392.0,17118627.0,222813691.0,356810.0,211171.0,14322.0,141441.0,80316.0,12222856.0,8864477.0,356810.0,141441.0,4.0,306641167.0,118.0,1466.0,1466.0,306641167.0,27594.0,58430858.0,14927.0,,841201.0,841201.0,521865.0,58430740.0,47330544.0,47065209.0,20149.0,753961.0,490075.0,617303.0,265217.0,18896076.0,10034.0,23602.0,6.0,1901.0,,7763.0,320.0,10034.0,35587.0,,7763.0,14322.0,1901.0,928843331.0,61676279.0,1256830.0,61704.0,194447893.0,24098373.0,,6873419.0,38546138.0,9943430.0,96178008.0,13626711.0,,10461551.0,12690768.0,9589696.0,7860722.0,3246536.0,30294665.0,9307616.0,6521737.0,3218129.0,166575586.0,934733685.0,73129705.0,1256830.0,61704.0,194447893.0,24098373.0,,6873419.0,38546138.0,9943430.0,97459751.0,13626711.0,,10727407.0,12765770.0,10055950.0,1403712.0,8218445.0,3382613.0,30294665.0,9103722.0,6876879.0,3229536.0,166575586.0,19245818.0,1537542.0,18284.0,344.0,206238.0,1659502.0,60430.37,,389744.0,529868.0,346743.0,61010.0,124317.0,186074.0,129410.0,189214.0,225954.0,80849.0,790413.0,48.57,47.56,68.74,179.37,48.21,58.73,225.49,,27.52,24.09,29.0,23.01,66.11,18.18,234.1,48.11,30.43,39.95,210.74,717162805.0,75298403.0,641864402.0,1318534.0,201321312.0,844504248.0,722795722.0,86924116.0,635871606.0,1318534.0,201321312.0,838511452.0,190511254.0,17676308.37,2053659.0,15622649.37,18628.0,15641277.37,4198411.37,40.89,42.33,40.7,70.78,31.66,53.61,45.38,,13622124.0,20485709.0,55418.0,616554.0,6389243.0,4601537.0,14204093.0,21529402.0,12354375.0,37647833.0,35747504.0,2419308.0,3412233.0,12354375.0,37647833.0,35747504.0,69014884.0,55474897.0,151573099.0,12354375.0,12354375.0,355960.0,4440110.0,4097118.0,37647833.0,19996714.0,4741316.0,2016320.0,355960.0,13141492.0,4741316.0,459.3,249.0,90885.0,43723.0,9802.0,82317.0,-206872.0,23505146.0,652557.0,,-1494588.0,,7770955.0,2836883.0,7914262.0,13520862.0,490384.0,13520862.0,7364680.0,21860043.0,536004.0,247983.0,1112732.0,1112732.0,,,514808.0,,,,,,,15408.0,,,,2399207.0,,,,,2430251.0,,,101093.0,,,,24.04,,100989.0,19189856.0,6871.0,227400.0,31070.0,5918421.0,621.0,135450.0,4155.0,712871.0,1315.0,10743.0,3320.0,630611.0,22.0,139534.0,26451759.0,8444.0,643.0,379459.0,60.0,11.0,3.0,4.5,313.0,34.0,3.0,,,,,,,,,,,-1188033.0,-1188033.0,8585227.0,,-1188033.0,,,,,,,,,,,,,,,,,,,334403.0,126899.0,126899.0,,,,,,4181365.0,11875.0,,,,,,,331.43,332.9,1287077.0,1287077.0,37375.0,34.44,1007313.0,,,,,,,,-307932.0,,,,4522173.0,,782585.0,,972528.0,,4084150.0,321501.0,21491.0,342992.0,22051475.0,,,14916.0,4931.0,321501.0,334403.0,,,1466.0,1466.0,-623.0,,775747.0,26248207.0,46.0,16790.0,4931.0,14916.0,5810038.0,,23544940.0,5810038.0,,23802377.0,,662981.0,,35.9,110.0,,,,,,,,,3260.0,,,,,,,,,,,,,,,,,,,,,,,,,,,,,,,,,,,,,,,,,,,,,,,,,,,,,,,04/04/2008,,,,,,,,,,,,,300 COMMUNITY DRIVE,MANHASSET,NY,10030,NASSAU,NORTH SHORE UNIVERSITY HOSPITAL,35004,P,,2,,,,,,,NSUH PSYCHIATRIC EXEMPT UNIT,33S106,335702,,,,,337148,,333550,,,,,,,1378031.0,,,,,351097129.0,,,,,,,,,,5626285.0,,,,,,68624.0,,,,,,2252117.0,,,,,,,,16537752.0,,,,,,,,,,,,-389898107.0,,,,,,,,,,-102588.0,,-105935.0,,,-2215814.0,,,,,,,,,,,,,,,,,,,,22237671.0,,,,,,,,,,133764.0,,,,,,,1982142.0,12160.0,656660.0,218887.0,133764.0,,2444236.0,,,,,48642.0,,,1909179.0,,,,,2213189.0,,,,,,,,,,,171788.0,,,,1046348.0,,530983.0,437280.0,,,2545593.0,15617.0,843326.0,281109.0,171788.0,,3139045.0,,,,,62469.0,,,2451891.0,,,,,2842320.0,,,,,,,,,,,,,,,,29719001.0,,,,,,,,,,,,,,,1000728.0,,,,,,,,,,,,,,,,,,,29719001.0,,,,,,,,,,,,,,,,,,,,,,,,,,,,,,,,61927791.0,,,,,,4148553.0,,,,,,,,,,,,,,,,,,,,,,4917.0,,,6.0,,,9080.0,22.0,,,,,,,,,1504.0,,,2.0,,,3041.0,5.0,,,,,,,,,,,,,,,,,,,,,,,,,,,,,,,,,,,,,,,,,,,,,,,,,,,,,,332103.0,100845.0,16483.0,,10350.0,,,,1224.0,,,,,,,,,,,,,,,,,,,255502.0,13198.0,5521.0,,3895.0,,,,207.0,,,,,,,,,,,,,,,,,,,,,,,,,,,,,,,,,,,,,,,,,,,,,,,,,,,,,,,,,,,,,,,,,,,,,,,,,,,,,,,,,,,,,,,,,,,,,,,,,,,,,,,,,,,,,,,,,,,,,,,,,,,,,,,,,,,,,,,,,,,,,,,,,,,,,,,,,,,,,,,,,,,,,,,,,,,,,,,,,,,,,,,,,,,,,,,,,,,,,,,,,,,,,,,,,,,,,,,,,,,,,,,,,,,,,,,,,,,,,,,,,,,,,,,,,,,,,,,,,,,,,,,,,,,,,,,,,,,,,,,,,,,,,,,,,,,,,,,,,,,,,,,,,,,,,,,,,,,,,,,,,,,,,,,,,,,,,,,,,,,,,,,,,,,,,,,,,,,,,,,,,,,,,,,,,,,,,,,,,,,,,,,,,8145242.0,4991546.0,38660179.0,52621934.0,35174531.0,41180784.0,-266750906.0,9589696.0,7860722.0,3246536.0,9307616.0,6521737.0,,96178008.0,32951489.0,22461765.0,15543906.0,5596250.0,8316552.0,,12384786.0,10461551.0,12690768.0,18499998.0,52030680.0,7154573.0,643975.0,3027387.0,871867.0,5113693.0,,53488908.0,119067697.0,128290942.0,29372406.0,,11973607.0,1319428.0,48710658.0,1114656.0,1141192.0,4487815.0,22989983.0,2635621.0,2262652.0,-2419238.0,,-3397237.0,-9656031.0,-1150975.0,-1393319.0,38660179.0,14151634.0,2046455.0,8862420.0,6410000.0,9955576.0,11990572.0,,15004611.0,52621934.0,126138402.0,210023549.0,61470652.0,,34324882.0,4009894.0,35580945.0,6748837.0,9457744.0,,15763640.0,33644029.0,,37770371.0,15401391.0,19380851.0,611043.0,6470312.0,24259327.0,110553859.0,,67700234.0,11487279.0,60662342.0,11842013.0,15188719.0,,36767855.0,,56948056.0,39987132.0,224529.0,3252147.0,2191330.0,9057032.0,,10253334.0,975681.0,3145429.0,539382.0,469589.0,,3849444.0,,1814602.0,2242388.0,246802286.0,,76254503.0,106552410.0,227983050.0,77592452.0,39011671.0,,197880342.0,,79424774.0,93642823.0,154275173.0,,185882999.0,167221978.0,187400650.0,1777667.0,215822.0,,103934381.0,,25850788.0,143370707.0,66720173.0,,26055754.0,41306915.0,80587548.0,40139770.0,11292418.0,,68682256.0,,21543011.0,29996172.0,18390882.0,,7551487.0,1733197.0,10852251.0,5988854.0,4372379.0,,8335824.0,,11653541.0,5060714.0,66720173.0,,26055754.0,41306915.0,80587548.0,40139770.0,11292418.0,,68682256.0,,21543011.0,29996172.0,,,,,13114.0,,,,,,8219.0,250.0,,,,,1864.0,,,,,,4446.0,42.0,4963390.0,9632673.0,,,,,,,3218129.0,,2297486.0,5580425.0,,8465873.0,15773241.0,9943430.0,8485843.0,8812445.0,,2212938.0,2690466.0,2620993.0,,2989325.0,6800855.0,472412.0,23436.0,,527954.0,9245948.0,,1060245.0,2421717.0,450017.0,1670925.0,440883.0,2022267.0,,8514824.0,,2403309.0,-18987706.0,,-212051.0,-4808012.0,,,-179034.0,,,-28689514.0,,-1179496.0,,,,-102022.0,3252972.0,,15537509.0,223907.0,9127680.0,18242393.0,8935860.0,10483370.0,2653821.0,4643260.0,,11532977.0,72224312.0,3963068.0,8113526.0,389143.0,20331723.0,19856786.0,36391958.0,16876084.0,18015622.0,6425317.0,10846314.0,,16616788.0,90039089.0,21201939.0,1408478.0,516507.0,1356733.0,1593355.0,808325.0,1277289.0,840374.0,826512.0,,495278.0,1802791.0,2422717.0,220967.0,19856786.0,36391958.0,110553859.0,16876084.0,18015622.0,,67700234.0,6425317.0,11487279.0,10846314.0,,60662342.0,16616788.0,11842013.0,15188719.0,36767855.0,,90039089.0,56948056.0,21201939.0,39987132.0,1408478.0,118117448.0,205972929.0,49113782.0,29820756.0,6314212.0,34823426.0,,41796849.0,198179297.0,175754.0,351890.0,36752246.0,3599426.0,39037325.0,129761687.0,,5219560.0,41075222.0,54974348.0,14724242.0,7894668.0,42167852.0,71372796.0,12968646.0,43028.0,2202658.0,10614456.0,,14565467.0,66423015.0,83230.0,319900.0,2548858.0,23195.0,312068.0,699503.0,,5147800.0,24997106.0,29587.0,29886.0,5165.0,15590.0,2317.0,8360.0,386823.0,854392.0,12968646.0,43028.0,2202658.0,10614456.0,,14565467.0,66423015.0,83230.0,319900.0,,35012257.0,9331754.0,1388.0,,41453448.0,9973917.0,48957919.0,24765017.0,,25189480.0,1507773.0,242009.0,,23113436.0,,14566005.0,6568022.0,3291373.0,21682124.0,2391200.0,,,35012257.0,9331754.0,1388.0,,41453448.0,9973917.0,48957919.0,24765017.0,,25189480.0,1507773.0,242009.0,,23113436.0,,14566005.0,6568022.0,3291373.0,21682124.0,2391200.0,27594.0,9650849.0,1834063.0,748.0,,10708072.0,1413085.0,2054225.0,1632039.0,,4063849.0,532885.0,36108.0,,2714223.0,,5481654.0,3552926.0,1168833.0,3658035.0,223395.0,14927.0,40.0,47.0,14600.0,19493.0,8360.0,2317.0,561.0,699.0,15590.0,5165.0,993169.0,,137707.0,39973129.0,1532817.0,1223486.0,2023035.0,110825.0,,2023035.0,2626975.0,1091521.0,839756.0,1091521.0,,,,,,,,,,106743.0,29423.0,205201.0,2264003.0,9418915.0,792368.0,65578.0,321823.0,3646966.0,428626.0,,,,2399207.0,-65532.0,-1543070.0,791754.0,270.0,297962.0,95.0,22249179.0,,,,559053.0,5783683.0,,149602309.0,,72224312.0,163246.0,,,-307932.0,28315214.0,,54224387.0,,904831.0,42504249.0,,,1819416.0,1763539.0,,,175941.0,42504249.0,,1819416.0,75137010.0,,2580.0,4419591.0,,,2714954.0,,,2714954.0,,,,1073395.0,,237.9,,139534.0,232104.0,,,3257013.0,7178089.0,1287077.0,,,327211.0,680410.0,3215728.0,,,,,,,,,,,23241155.0,3593982.0,7872760.0,4502805.0,,35471819.0,814745.0,413453.0,340491.0,5070877.0,2578000.0,3015773.0,8782738.0,16900025.0,,1081054.0,936474.0,,8782738.0,16900025.0,,44883624.0,121953322.0,,182287.0,,18835321.0,,44105.0,,17438.0,,,,,,,,,,,,,,,,,,,,,,,,,3798.0,9531.0,1794.0,510644.0,,,,44105.0,,,,,,,,,,,,,,,,,,,,15.0,5475.0,1794.0,68.0,3798.0,1327886.0,1620891.0,3647093.0,368351.0,,,,,,4974979.0,1800197.0,9370629.0,3041872.0,593063.0,191400.0,9370629.0,3041872.0,8266342.0,9039606.0,22370138.0,42759.0,2965718.0,2582409.0,907109.0,864903.0,2965718.0,2582409.0,,,,,,,,,8019598.0,3952780.0,11866443.0,23952916.0,1660535.0,23952916.0,4107816.0,102770377.0,1539530.0,345030.0,1539530.0,6155473.0,25035536.0,6155473.0,25035536.0,1882744.0,5610814.0,23544940.0,3049306.0,,387796.0,,,-561222.0,-12590188.0,33259953.0,1228977.0,,2273990.0,364811.0,1203877.0,,2920403.0,6512346.0,468514.0,3310833.0,3873050.0,1546097.0,2875898.0,85008.0,2875898.0,,13383434.0,,,207498.0,,103708.0,150267.0,18669.0,570601.0,181439.0,114123.0,120572.0,,1985.0,23215.0,400667.0,40782.0,,30422.0,6305.0,1230.0,81110.0,27071.0,44188.0,7815.0,,747.0,12558.0,67597.0,,,,,,,,,,,,,,,,,,,,,,4.0,,3534717.0,,,,,,118.0,,,,,,,,1466.0,,,,,,,,,,,3534717.0,,,,,,610499.0,,,,,,51.0,18615.0,623.0,9531.0,40633.0,40633.0,13609.0,,,,,2808.0,2160.0,,,,,,40.779269,-73.703029,Voluntary non-profit - Private,Acute Care Hospitals,NORTH SHORE UNIVERSITY HOSPITAL (330106)
48543,545904.0,330106,13001,2014-12-15 00:00:00,2012-01-01 00:00:00,2012-12-31,F,33,33400,2.0,2.0,5380,,,,,,,,,,240587.0,,,,,,,,,,,,,,,,-33256.0,,,,,,,,,-1188016.0,,699495.0,,,,,,,,,,,,,,,1467011.0,,,,,,,,,,,,,,,,30394.0,,,,,,,,,,,,,,-2527144.0,,-5244445.0,,2365876.0,,,,,,,,,,,,,664410.0,,,,,,,650016.0,,,,,504094.0,,,,,,,,,,,41817.0,,,,,,32430.0,,,,3281623.0,,,,,,,,,,,,,208912.0,,83560.0,,,,,,,,,,,,29129.0,,3281623.0,,,,,,,,,,,,,208912.0,,,,,,,,,,,,,,,,,,,,,,,,,4697869.0,,,,,,,,,,,,,,,,,,,,,,,,,,,,,,,,,,,,,,,,,,,,,,,,,,,,,,,,,,,,,,,,,,,,,,,,,,,,,,,,,,,,,,,,,,,,,,,,,,,,,,,,,,,,,,,,,,,,,,,,,,,,,,,,,,,,,,,,,,,,,,8344171.0,,,1375867.0,,,,13812208.0,,,,,,,,233040.0,,,,,,,,,,,8344171.0,,,,,,13812208.0,,,,,,,488935.0,,,,,,,,28.25,,,,,266.0,2083.0,,,,,,,,,,,,,,,,,,,,,,,,,,,,,,,,,,,,,,,,,,,,,,,,,,,,,,,,,214142.0,4655.0,,,,,,,4.3,,7.0,,,,,7.0,,5206276.0,728667218.0,557045220.0,148884957.0,728667218.0,94654971.0,31994973.0,94654971.0,11303280.0,88562759.0,72866366.0,-173385919.0,-2499004.0,,-2696989.0,,-453627887.0,,,864011752.0,95529789.0,12803456.0,866119374.0,7097461.0,-453627887.0,-1173799.0,1276503239.0,99984581.0,1187120984.0,257889268.0,88562759.0,23824670.0,1138466652.0,3341117301.0,1374903844.0,1531101447.0,4872218748.0,,257889268.0,257889268.0,100630025.0,112529263.0,242023120.0,528475110.0,112529263.0,833526.0,312394.0,326920.0,164224.0,10339657.0,32958087.0,36866632.0,36837319.0,36972522.0,36973713.0,36949916.0,23797.0,0.233665,1.0,8432.93,9235.5,621.0,781.0,1076.0,621.0,227106.0,285666.0,227106.0,,,,87496.0,99917.0,40777.0,,87496.0,224230.0,273309.0,,,,224230.0,2300710.0,,15230055.0,,990000.0,318060.0,49103889.0,,11907863.0,11907863.0,52758869.0,12599705.0,52758869.0,11907863.0,15238268.0,,,,-9572942.0,4166479.0,,3947.0,,,4170426.0,9147798.0,2394664.0,360649.0,1138466652.0,,1138466652.0,257889268.0,9147798.0,53612420.0,11003263.0,6470758.0,17474021.0,224549099.0,373125.0,224230.0,13830.0,147092.0,87496.0,12426413.0,9296450.0,373125.0,147092.0,10.0,255165452.0,198.0,1297.0,1297.0,255165452.0,24687.0,54681594.0,14526.0,,858213.0,858213.0,531293.0,54681396.0,43135048.0,43134850.0,29313.0,193147.0,135203.0,,,34537743.0,11116.0,22156.0,,,,8592.0,353.0,11116.0,33198.0,,8592.0,13830.0,1799.0,864011752.0,59944851.0,1417931.0,,179880601.0,25167515.0,,7588999.0,38968997.0,8853993.0,91656893.0,9166018.0,,10878401.0,13039170.0,9646527.0,8087120.0,3258933.0,24538651.0,8977610.0,6465767.0,3153624.0,207667365.0,864011752.0,68260458.0,1417931.0,,179880601.0,25167515.0,,7588999.0,38968997.0,8853993.0,89613869.0,9166018.0,,10878401.0,13039170.0,9646527.0,1375867.0,8087120.0,4416539.0,24538651.0,8842122.0,6465767.0,3153624.0,207667365.0,18139965.0,1657403.0,24195.0,,182094.0,1550871.0,34520.0,,425050.0,588804.0,380263.0,61278.0,151996.0,177884.0,113750.0,182282.0,220241.0,97976.0,3086494.0,47.63,41.19,58.6,,48.62,57.78,265.53,,25.59,22.15,25.37,22.45,53.21,24.83,215.72,48.51,29.36,32.19,67.28,617899408.0,73757059.0,544142349.0,1417931.0,187469600.0,733029880.0,617666368.0,82072666.0,535593702.0,1417931.0,187469600.0,724481233.0,177137910.0,14305661.0,2146338.0,12159323.0,24195.0,12183518.0,4187559.0,43.18,38.24,44.05,58.6,35.0,59.46,42.3,,13812208.0,18524211.0,73829.0,611537.0,6150652.0,4787473.0,14219849.0,19244589.0,12397661.0,38683593.0,33493612.0,2444238.0,2855560.0,12397661.0,38683593.0,33493612.0,54059507.0,52739719.0,139695430.0,12397661.0,12397661.0,382716.0,3816030.0,3520235.0,38683593.0,19664307.0,5146751.0,1986354.0,382716.0,12737598.0,5146751.0,450.71,249.0,91134.0,42908.0,10433.0,84408.0,-203896.0,39105015.0,813562.0,,-1500176.0,,8074165.0,2510345.0,9275994.0,14531086.0,540047.0,14531086.0,3968900.0,30083917.0,160234.0,68375.0,14394.0,14394.0,,,6142.0,,,,,,178.0,15603.0,,,,2517882.0,,,,,2517882.0,,,103505.0,,,,24.33,,108029.0,20827715.0,7384.0,118008.0,26909.0,5164035.0,490.0,56472.0,3764.0,735745.0,1393.0,4986.0,3567.0,693690.0,,142269.0,27421185.0,9043.0,490.0,181549.0,60.0,19.0,3.0,4.3,314.0,36.0,3.0,,,,,,,,,,,,,9339000.0,,,,,,,,,,,,,,,,,,,,,235372.0,91871.0,91871.0,,,,,,3908545.0,10662.0,,,,,,,330.9,333.5,1081011.0,1081011.0,30795.0,35.1,340186.0,,,,,,,,-2438837.0,,,,4713644.0,,600804.0,,983714.0,,3433314.0,272405.0,23390.0,295795.0,14751790.0,,,15408.0,4267.0,272405.0,235372.0,,,1297.0,1297.0,-1191.0,,1185180.0,17343436.0,46.0,16836.0,4267.0,15408.0,5678848.0,,23672522.0,5911888.0,,23905562.0,,650604.0,,36.74,202.0,,,,,,,,,3723.0,,,,,,,,,,,,,,,,,,,,,,,,,,,,,,,,,,,,,,,,,,,,,,,,,,,,,,,04/04/2008,,,,,,,,,,,,,300 COMMUNITY DRIVE,MANHASSET,NY,10030,NASSAU,NORTH SHORE UNIVERSITY HOSPITAL,35004,P,,2,,,,,,,NSUH PSYCHIATRIC EXEMPT UNIT,33S106,335702,,,,,337148,,333550,,,,,,,1375867.0,,,,,285450960.0,,7773814.0,,,,,,,,5678288.0,,,,,,106600.0,,,,,,1708356.0,,,,,,,,14746149.0,,,,,,,,,,,,-341209885.0,,,,,,,,,,-27462.0,,-70158.0,,,-2403833.0,,,,,,,,,,,,,,,,,,,,20424437.0,,,,,,,,,,145922.0,,,,,,,2162298.0,13266.0,703078.0,238781.0,145922.0,,2666391.0,,,,,53063.0,,,2069438.0,,,,,2414344.0,,,,,,,,,,,181247.0,,,,1103957.0,,560217.0,461356.0,,,2685747.0,16477.0,873280.0,296585.0,181247.0,,3311872.0,,,,,65908.0,,,2570408.0,,,,,2998809.0,,,,,,,,,,,,,,,,27594731.0,,,,,,,,,,,,,,,777157.0,,,,,,,,,,,,,,,,,,,27594731.0,,,,,,,,,,,,,,,,,,,,,,,,,,,,,,,,55583667.0,,,,,,3701629.0,,,,,,,,,,,,,,,,,,,,,,5888.0,,,117.0,,,2808.0,204.0,,,,,,,,,1755.0,,,50.0,,,1012.0,52.0,,,,,,,,,,,,,,,,,,,,,,,,,,,,,,,,,,,,,,,,,,,,,,,,,,,,,,166857.0,4304.0,13482.0,,5574.0,,,,4455.0,,,,,,,,,,,,,,,,,,,146699.0,947.0,4857.0,,2073.0,,,,757.0,,,,,,,,,,,,,,,,,,,,,,,,,,,,,,,,,,,,,,,,,,,,,,,,,,,,,,,,,,,,,,,,,,,,,,,,,,,,,,,,,,,,,,,,,,,,,,,,,,,,,,,,,,,,,,,,,,,,,,,,,,,,,,,,,,,,,,,,,,,,,,,,,,,,,,,,,,,,,,,,,,,,,,,,,,,,,,,,,,,,,,,,,,,,,,,,,,,,,,,,,,,,,,,,,,,,,,,,,,,,,,,,,,,,,,,,,,,,,,,,,,,,,,,,,,,,,,,,,,,,,,,,,,,,,,,,,,,,,,,,,,,,,,,,,,,,,,,,,,,,,,,,,,,,,,,,,,,,,,,,,,,,,,,,,,,,,,,,,,,,,,,,,,,,,,,,,,,,,,,,,,,,,,,,,,,,,,,,,18546.0,,,,,,,,8227517.0,3075763.0,41479731.0,47083028.0,35457710.0,37408656.0,-261812924.0,9646527.0,8087120.0,3258933.0,8977610.0,6465767.0,,91656893.0,34050289.0,20340628.0,16301315.0,6089574.0,8391567.0,,13669526.0,10878401.0,13039170.0,17328861.0,51233692.0,7421448.0,482522.0,2371344.0,864416.0,6021392.0,,47278649.0,178387635.0,121423840.0,32734193.0,,10676788.0,1783926.0,50896080.0,1244871.0,1123484.0,4323011.0,21351547.0,2429534.0,2429883.0,-2499004.0,,-3271384.0,-25542997.0,-1170237.0,-605332.0,41479731.0,13857852.0,2097670.0,8569642.0,6857839.0,9706267.0,12471934.0,,16571549.0,47083028.0,180689512.0,186696618.0,65494378.0,,29640669.0,4424630.0,38287393.0,7334445.0,9515051.0,,16682708.0,30819756.0,,36679574.0,15468704.0,19153412.0,614939.0,5570871.0,25497528.0,114239834.0,,60431671.0,9202769.0,62545754.0,12546248.0,15684575.0,,36143181.0,,56262673.0,38973075.0,237338.0,2593569.0,1913903.0,8459247.0,,10083889.0,789653.0,3365501.0,599566.0,456095.0,,3943442.0,,1744849.0,2247070.0,219462016.0,,81878813.0,88367507.0,259261315.0,59357030.0,33271429.0,,113847107.0,,75952325.0,90078479.0,133303902.0,,158751032.0,124303032.0,164934683.0,1027797.0,276016.0,,71963672.0,,19663309.0,139319459.0,61786515.0,,26937767.0,33779181.0,90842013.0,29223765.0,10476424.0,,40552204.0,,23891283.0,30198576.0,20008945.0,,7615872.0,1461693.0,12186120.0,6071880.0,4898084.0,,7734371.0,,14058228.0,5130527.0,61786515.0,,26937767.0,33779181.0,90842013.0,29223765.0,10476424.0,,40552204.0,,23891283.0,30198576.0,,,,,,,,,,,11578.0,448.0,,,,,,,,,,,6813.0,76.0,5944825.0,9293443.0,,,,,,,3153624.0,,2335072.0,5078078.0,,7323411.0,14375578.0,8853993.0,8411527.0,8043997.0,,2179427.0,2640704.0,2554865.0,,3065677.0,6121257.0,393109.0,17327.0,,955101.0,10393226.0,,962862.0,2081711.0,460326.0,1384618.0,435253.0,1781508.0,,8287186.0,,1911180.0,-17424220.0,,-210756.0,-6552116.0,,,-260919.0,,,-28896450.0,,-1309829.0,-1188016.0,,,,3170951.0,,12793355.0,148657.0,9525272.0,16457289.0,8871853.0,9428615.0,2614680.0,4336373.0,,11352863.0,66626168.0,4267076.0,7498773.0,404599.0,16970994.0,20298748.0,32558685.0,16733524.0,17250525.0,6281200.0,9177186.0,,16289686.0,81928933.0,20573201.0,1258780.0,429221.0,1368899.0,1416675.0,755193.0,1304087.0,884120.0,953767.0,,468433.0,1511015.0,2354735.0,218970.0,20298748.0,32558685.0,114239834.0,16733524.0,17250525.0,,60431671.0,6281200.0,9202769.0,9177186.0,,62545754.0,16289686.0,12546248.0,15684575.0,36143181.0,,81928933.0,56262673.0,20573201.0,38973075.0,1258780.0,112188442.0,161576331.0,44692587.0,31178302.0,6023688.0,36743901.0,,34575263.0,185865987.0,213802.0,,35294463.0,4798651.0,47931123.0,103792964.0,,3504604.0,34452824.0,39993604.0,9893891.0,7266098.0,43850439.0,63154394.0,11601915.0,20393.0,2436866.0,11943573.0,,12764280.0,59789357.0,201806.0,,2427155.0,9778.0,283690.0,779927.0,,5460265.0,22233569.0,85201.0,,5851.0,15345.0,2303.0,8429.0,350767.0,778165.0,11601915.0,20393.0,2436866.0,11943573.0,,12764280.0,59789357.0,201806.0,,,31275120.0,8094348.0,,,33354645.0,12534767.0,35382422.0,19766631.0,,21395299.0,994114.0,138510.0,,17401721.0,,10929562.0,6202872.0,4620723.0,19497370.0,1489250.0,,,31275120.0,8094348.0,,,33354645.0,12534767.0,35382422.0,19766631.0,,21395299.0,994114.0,138510.0,,17401721.0,,10929562.0,6202872.0,4620723.0,19497370.0,1489250.0,24687.0,10128135.0,1693362.0,,,8359255.0,1459247.0,1531068.0,1290781.0,,4145769.0,425259.0,28778.0,,3347960.0,,4064322.0,3649925.0,2294106.0,3312467.0,189474.0,14526.0,40.0,54.0,14640.0,19764.0,8429.0,2303.0,106.0,215.0,15345.0,5851.0,946552.0,,139997.0,41064503.0,1749194.0,1086549.0,1882741.0,90008.0,,1882741.0,2133379.0,409571.0,360091.0,409571.0,,,,,,,,,,71251.0,23074.0,250098.0,2946990.0,8235840.0,1109998.0,74140.0,413592.0,3850535.0,653151.0,,,,2517882.0,-95916.0,-402818.0,821118.0,382.0,305345.0,160.0,22916063.0,,,,556546.0,7462000.0,,116490858.0,,66626168.0,163112.0,,,-2470286.0,29941195.0,,19088563.0,,922802.0,46463254.0,,,1991368.0,1490096.0,,,263840.0,46463254.0,,1991368.0,78991391.0,,8068.0,4047328.0,,,1563235.0,,,1563235.0,,,,709498.0,,286.83,,142269.0,248999.0,,,3191096.0,7118408.0,1081011.0,,,270241.0,601361.0,2925746.0,,,,-1774.0,,,,,,,23862112.0,3459563.0,7719769.0,4006757.0,,38602976.0,888797.0,451031.0,371438.0,5518501.0,2812313.0,3276610.0,8501267.0,16199046.0,,1116186.0,918570.0,,8501267.0,16199046.0,,42640085.0,106281337.0,,340250.0,,16666480.0,,122731.0,,55703.0,,,,,,,,,,,,,,,,,,,,,,,,,3879.0,10174.0,1689.0,486010.0,,,,122731.0,,,,,,,,,,,,,,,,,,,,15.0,5490.0,1689.0,81.0,3879.0,1179367.0,1472899.0,3669745.0,309598.0,,,,,,4849112.0,1681008.0,9075381.0,2840938.0,587768.0,141804.0,9075381.0,2840938.0,9405362.0,3851972.0,21051021.0,4034650.0,3070122.0,1214997.0,914835.0,437669.0,3070122.0,1214997.0,,,,,,,,,7745523.0,3999894.0,11675259.0,23183113.0,1480770.0,23183113.0,2646202.0,88425735.0,971429.0,247285.0,971429.0,5811388.0,20539975.0,5811388.0,20539975.0,1731677.0,5228615.0,23672522.0,3102463.0,,207571.0,,,-43450.0,-7351979.0,35087828.0,906201.0,,2467407.0,397969.0,1313297.0,,3064717.0,6854420.0,494309.0,3493118.0,4069812.0,1631220.0,2721012.0,81092.0,2721012.0,,11277345.0,,,203086.0,,122847.0,114409.0,19554.0,694052.0,160332.0,123168.0,80098.0,,,28353.0,360085.0,42486.0,,36376.0,4951.0,1277.0,97372.0,33313.0,57585.0,5463.0,,,16684.0,61176.0,,,,,,,,,,,,,,,,,,,,,,10.0,,3015424.0,,,,,,198.0,,,,,,,,1297.0,,,,,,,,,,,3015424.0,,,,,,673775.0,,,,,,51.0,18666.0,1769.0,10174.0,1143682.0,1143682.0,411979.0,,,,,102.0,90.0,,,,,,40.779269,-73.703029,Voluntary non-profit - Private,Acute Care Hospitals,NORTH SHORE UNIVERSITY HOSPITAL (330106)
55621,533354.0,330106,13201,2014-04-25 00:00:00,2011-01-01 00:00:00,2011-12-31,F,33,33400,2.0,2.0,5380,,,,,,,,,,212029.0,168.0,,,,,,,,,,,,,,,-30114.0,,,,,,,,,-1959503.0,,779835.0,,,,,,,,,,,,,,,1317738.0,,,,,,,,,,,,,,,,30394.0,,,,,,,,,,,,,,-1731521.0,,-5746854.0,,2165649.0,,,,,,,,,,,,,681279.0,,,,,,,463206.0,,,,,625955.0,,,,,,,,,,,28981.0,,,,,,39164.0,,,,3002876.0,,,,,,,,,,,,,443259.0,,78506.0,,,,,,,,,,,,21319.0,,3002876.0,,,,,,,,,,,,,443259.0,,,,,,,,,,,,,,,,,,,,,,,,,4180437.0,,,,,,,,,,,,,,,,,,,,,,,,,,,,,,,,,,,,,,,,,,,,,,,,,,,,,,,,,,,,,,,,,,,,,,,,,,,,,,,,,,,,,,,,,,,,,,,,,,,,,,,,,,,,,,,,,,,,,,,,,,,,,,,,,,,,,,,,,,,,,,,,,1692420.0,,,,13011538.0,,,,,,,,,,,,,,,,,,,,,,,,,13011538.0,,,,,3531067.0,,471941.0,,,,,,,,27.57,,,,,,,,,,,,,,,,,,,,,,,,,,,,,,,,,,,,,,,,,,,,,,,,,,,,,,,,,,,,,,,116308.0,42613.0,,,,,,,4.3,,7.0,,,,,7.0,,4631276.0,655545899.0,429829687.0,137545919.0,655545899.0,104690749.0,40127910.0,104690749.0,12946170.0,86123443.0,64804673.0,-163567334.0,-4033228.0,,-2806478.0,,-445757910.0,,,801550870.0,103017016.0,13446517.0,859218796.0,8321918.0,-445757910.0,-1340337.0,1215011756.0,108947697.0,1130173170.0,267113593.0,86123443.0,26114745.0,1082804569.0,3084726268.0,1291366580.0,1188743633.0,4273469901.0,,267113593.0,267113593.0,109674110.0,121150750.0,253966556.0,501984245.0,121150750.0,,,,,9768630.0,32309866.0,35798336.0,35784649.0,35980818.0,35980399.0,35877070.0,103329.0,0.253378,1.0,8096.1,8902.8,617.0,777.0,1072.0,617.0,225427.0,285267.0,225427.0,,,,95190.0,109356.0,40271.0,,95190.0,231838.0,283917.0,,,,231838.0,2175913.0,8456506.0,72906598.0,,,29842.0,44367840.0,,,,26636246.0,15866072.0,26636246.0,,20063536.0,,,,-10146424.0,3773238.0,,75388.0,,,3848626.0,8167019.0,2363189.0,352109.0,1082804569.0,,1082804569.0,267113593.0,8167019.0,49699556.0,12705193.0,6796334.0,19501527.0,234465029.0,380421.0,231838.0,13173.0,154786.0,95190.0,13895219.0,10722202.0,380421.0,154786.0,,205214743.0,3521.0,15889.0,15889.0,205214743.0,,47569720.0,,,,,,47566199.0,42078496.0,42074975.0,13687.0,280242.0,196169.0,,,,13878.0,12514.0,,,,10245.0,334.0,13878.0,24367.0,,10245.0,13173.0,2370.0,801550870.0,59560605.0,1629359.0,,159701540.0,16885882.0,,25746940.0,47108902.0,6558637.0,70879973.0,4457707.0,,10905815.0,11976974.0,8648170.0,8109694.0,2891554.0,24034164.0,8233946.0,6017303.0,2657381.0,119282407.0,801550870.0,67296087.0,1629359.0,,159701540.0,16885882.0,,25746940.0,47108902.0,6558637.0,69155087.0,4457707.0,,10905815.0,11976974.0,8648170.0,1692420.0,8109694.0,3543092.0,24034164.0,8098449.0,6017303.0,2657381.0,119282407.0,17369138.0,1560254.0,23736.0,,165358.0,1335156.0,20292.0,,420323.0,508111.0,292762.0,74517.0,129943.0,150596.0,110108.0,183658.0,211782.0,68330.0,598796.0,46.15,43.13,68.65,,39.66,51.8,219.68,,25.95,23.57,29.54,22.71,62.41,23.53,218.28,44.1,28.41,38.89,199.2,633930786.0,72572143.0,561358643.0,1629359.0,185448480.0,748436482.0,633844456.0,80307625.0,553536831.0,1629359.0,185448480.0,740614670.0,145044020.0,15986176.0,2032195.0,13953981.0,23736.0,13977717.0,7217227.0,39.65,39.52,39.67,68.65,33.5,52.99,20.1,,13011538.0,16565042.0,61583.0,532471.0,5246195.0,4806517.0,13423669.0,15873176.0,12053738.0,35634830.0,27908206.0,2454049.0,2577321.0,12053738.0,35634830.0,27908206.0,50927436.0,49127226.0,131660348.0,12053738.0,12053738.0,363388.0,4135273.0,3792915.0,35634830.0,17857989.0,5096393.0,1655197.0,363388.0,9664415.0,5096393.0,428.0,249.0,90885.0,40555.0,11135.0,80925.0,-120340.0,9412833.0,1145144.0,,-500347.0,,8290183.0,2523572.0,10875767.0,16305574.0,592844.0,16305574.0,5941763.0,30516448.0,548442.0,245285.0,1418.0,1418.0,,,634.0,,,36388142.0,,,104.0,13403.0,,,,2374809.0,,,,,2374809.0,,,99849.0,,,,23.78,,110439.0,21511435.0,,,26035.0,5032535.0,,,3711.0,737320.0,,,4039.0,789115.0,,144224.0,28070405.0,,,,60.0,19.0,3.0,4.3,314.0,36.0,3.0,,,,,,,,,,,,,9201530.0,,,,,,,,,,,,,,,,,,,,,873884.0,358866.0,358866.0,,,,,,3488470.0,11665.0,,,,,,,325.1,328.34,848482.0,848482.0,25483.0,33.3,20165157.0,,,,,,,,-51226.0,,,,4805258.0,,575706.0,,1020261.0,,3771885.0,319264.0,23094.0,342358.0,15462162.0,,,15579.0,4875.0,319264.0,873884.0,,,15889.0,15889.0,419.0,,,,46.0,16790.0,4875.0,15579.0,3597032.0,,22847315.0,3597032.0,,22933645.0,,648455.0,,35.37,84.0,,,,,,,,-60324.0,4038.0,,,,,,,,,,,,,,,,,,,,,,,,,,,,,,,,,,,,,,,,,,,,,,,,,,,,,,,04/04/2008,,,,,,,,,,,,,300 COMMUNITY DRIVE,MANHASSET,NY,10030,NASSAU,NORTH SHORE UNIVERSITY HOSPITAL,35004,P,,2,,,,,,,NSUH PSYCHIATRIC EXEMPT UNIT,33S106,335702,,,,,337148,,333550,,,,,,,1692420.0,,,,,267053244.0,,5326722.0,,,,,,,,5388553.0,,,,,,907528.0,,,,,,1542109.0,,,,,,,,11372393.0,,,,,,-502236.0,,,,,,-326300453.0,,,,,,,,,,,,-99722.0,,,-2334051.0,,,,,,,,,,,,,,,,,,,,16760946.0,,,,,,,,,,112672.0,,,,,,,2153284.0,25038.0,663512.0,250382.0,162748.0,,2053131.0,,,,,225344.0,,,2140765.0,87634.0,,,,2253436.0,,,,,,,,,,,144828.0,,,,1078169.0,,547131.0,498854.0,,,2767839.0,32185.0,852880.0,321841.0,209198.0,,2639102.0,,,,,289658.0,,,2751747.0,112645.0,,,,2896575.0,,,,,,,,,,,,,,,,22636758.0,,,,,,,,,,,,,,,693501.0,,,,,,,,,,,,,,,,,,,22636758.0,,,,,,,,,,,,,,,,,,,,,,,,,,,,,,,,,,,,,,9381911.0,,,,,,,,,,,,,,,,,,,,,,819.0,,,,,,2493.0,,,,,,,,,,140.0,,,,,,1773.0,,,,,,,,,,,,,,,,,,,,,,,,,,,,,,,,,,,,,,,,,,,,,,,,,,,,,184.0,,83635.0,,9951.0,,18485.0,,,,,,,,,,,,,,,,,,,,,120.0,,48779.0,,7075.0,,6699.0,,,,,,,,,,,,,,,,,,,,,,,,,,,,,,,,,,,,,,,,,,,,,,,,,,,,,,,,,,,,,,,,,,,,,,,,,,,,,,,,,,,,,,,,,,,,,,,,,,,,,,,,,,,,,,,,,,,,,,,,,,,,,,,,,,,,,,,,,,,,,,,,,,,,,,,,,,,,,,,,,,,,,,,,,,,,,,,,,,,,,,,,,,,,,,,,,,,,,,,,,,,,,,,,,,,,,,,,,,,,,,,,,,,,,,,,,,,,,,,,,,,,,,,,,,,,,,,,,,,,,,,,,,,,,,,,,,,,,,,,,,,,,,,,,,,,,,,,,,,,,,,,,,,,,,,,,,,,,,,,,,,,,,,,,,,,,,,,,,,,,,,,,,,,,,,,,,,,,,,,,,,,,,,,,,,,,,,,,,,,,32158.0,,,,,,,,10032742.0,2913428.0,43612717.0,42510726.0,32038933.0,32765740.0,-263163603.0,8648170.0,8109694.0,2891554.0,8233946.0,6017303.0,,70879973.0,30842820.0,17785281.0,15523733.0,5857912.0,7292268.0,,13796284.0,10905815.0,11976974.0,16078953.0,47217092.0,7373995.0,457941.0,2520899.0,970987.0,5748097.0,,43759612.0,165120974.0,137642726.0,73640609.0,,13639904.0,1612626.0,51937030.0,1375189.0,847962.0,26805950.0,24079576.0,2479271.0,2681262.0,-4033228.0,,-4162314.0,-39778217.0,-1069004.0,-337422.0,43612717.0,12850795.0,1702826.0,8567601.0,6082243.0,9053313.0,11748974.0,,18942839.0,42510726.0,164713385.0,168020962.0,58588902.0,,26423354.0,3883811.0,38907996.0,7233101.0,8140230.0,,16580302.0,32804886.0,,37033541.0,14456245.0,18421408.0,219101.0,4943951.0,26533730.0,101282312.0,,51558026.0,7361155.0,60993698.0,11789637.0,13208504.0,,35285715.0,,55269185.0,36259314.0,91559.0,2127440.0,699912.0,7932389.0,,8032857.0,807557.0,3492447.0,618050.0,410718.0,,4158997.0,,1757333.0,2340794.0,222610311.0,,98282590.0,58319545.0,221322786.0,18068673.0,21951214.0,,100678585.0,,54677203.0,88568766.0,122407565.0,,115516768.0,68290856.0,150536678.0,68044.0,304111.0,,57181526.0,,7028814.0,122358538.0,63977879.0,,20587708.0,22319285.0,90914806.0,7269809.0,7562163.0,,38398132.0,,24517585.0,37762013.0,18781154.0,,6084535.0,1297643.0,14689514.0,4725688.0,4488136.0,,8282217.0,,21960058.0,6491441.0,63977879.0,,20587708.0,22319285.0,90914806.0,7269809.0,7562163.0,,38398132.0,,24517585.0,37762013.0,,,,,,,,,,,,,,,,,,,,,,,,,10436292.0,9627244.0,,,,,,,2657381.0,,2394426.0,5792626.0,,5226989.0,5147043.0,6558637.0,7681125.0,7622799.0,,2045229.0,2271185.0,1876060.0,,2742271.0,5780182.0,,22447.0,,1424512.0,11945395.0,,873186.0,919897.0,477496.0,1253170.0,566359.0,1420678.0,,8367099.0,,2133806.0,-12590154.0,,-199701.0,-6966226.0,,,-260876.0,,,-28536600.0,,-1177154.0,-1959963.0,,,,2679828.0,,11788643.0,823318.0,6941241.0,6064526.0,8158621.0,8875969.0,2611588.0,3282290.0,,11109370.0,72804265.0,4107596.0,7268862.0,,15671819.0,14928819.0,14646902.0,14904791.0,16120219.0,6065866.0,7220776.0,,15715083.0,88159340.0,19249921.0,,405429.0,1235111.0,892762.0,679047.0,1321793.0,929753.0,1165904.0,,482205.0,1617492.0,2391925.0,,14928819.0,14646902.0,101282312.0,14904791.0,16120219.0,,51558026.0,6065866.0,7361155.0,7220776.0,,60993698.0,15715083.0,11789637.0,13208504.0,35285715.0,,88159340.0,55269185.0,19249921.0,36259314.0,,64342384.0,165898946.0,34532450.0,30733342.0,5290971.0,34907210.0,,58436412.0,200260628.0,,,19073964.0,4865765.0,46153515.0,64523098.0,,12885997.0,42995681.0,35707028.0,,5793023.0,25419737.0,86962259.0,14116258.0,22872.0,3431146.0,11068270.0,,14350331.0,68056104.0,,,3924898.0,10357.0,404570.0,803789.0,,3161938.0,24664417.0,,,6913.0,16929.0,2691.0,9208.0,324642.0,485630.0,14116258.0,22872.0,3431146.0,11068270.0,,14350331.0,68056104.0,,,,13304723.0,,,,24897441.0,10298790.0,18458297.0,12010924.0,,13182809.0,137055.0,7752.0,76291.0,10705717.0,,14389765.0,6759299.0,3746134.0,14495641.0,,,,13304723.0,,,,24897441.0,10298790.0,18458297.0,12010924.0,,13182809.0,137055.0,7752.0,76291.0,10705717.0,,14389765.0,6759299.0,3746134.0,14495641.0,,,3905695.0,,,,7149584.0,1214341.0,1073165.0,872245.0,,1458681.0,30199.0,5039.0,45279.0,2300802.0,,5215038.0,6054209.0,2396876.0,2491859.0,,,40.0,54.0,14600.0,21150.0,9208.0,2691.0,95.0,447.0,16929.0,6913.0,928478.0,,99487.0,40252083.0,1732787.0,1027965.0,1732933.0,69551.0,,1732933.0,2969439.0,,,,,,,,,,,,,51798.0,15206.0,221007.0,2192490.0,5970913.0,1167750.0,75431.0,368621.0,3543731.0,1045937.0,,,,2374809.0,-35182.0,-380710.0,,,,,23834865.0,,,,554705.0,8967732.0,,109766462.0,,,304000.0,,,-51226.0,32300361.0,,11019154.0,,1056665.0,48552917.0,,,2121736.0,1307422.0,,,274815.0,48552917.0,,2121736.0,,,1787.0,3956390.0,,,920410.0,,,920410.0,,,,475932.0,,312.9,,,259845.0,,,7731219.0,7217327.0,848482.0,,,569456.0,757561.0,2873360.0,,,,,,,,,,,22579727.0,8296557.0,7974888.0,3721842.0,,36029944.0,838779.0,425649.0,388092.0,5333133.0,2466262.0,3355116.0,16322136.0,16171942.0,,1415908.0,994405.0,,16322136.0,16171942.0,,42776116.0,105928719.0,,146858.0,,21406094.0,,46789.0,,24194.0,,,,,,,,,,,,,,,,,,,,,,,,,3944.0,11120.0,2267.0,813853.0,,,,46789.0,,,,,,,,,,,,,,,,,,,,15.0,5475.0,2267.0,53.0,3944.0,1043732.0,1412445.0,3357251.0,260128.0,-34.0,,,,,4397983.0,1635607.0,8172783.0,2646743.0,587783.0,108046.0,8172783.0,2646743.0,3227456.0,3548576.0,44647060.0,173855.0,2084578.0,1061919.0,355865.0,755051.0,2084578.0,1061919.0,,,,,,,,,7433831.0,5466236.0,10922576.0,21414145.0,1436140.0,21414145.0,,101362777.0,,,,5522433.0,56213055.0,5522433.0,56213055.0,942751.0,11875682.0,22847315.0,2983980.0,5078.0,144016.0,,,-357196.0,-5156912.0,35104886.0,793945.0,,2441222.0,363054.0,,,3137957.0,6855229.0,466671.0,3170140.0,4312679.0,,2384118.0,70055.0,2384118.0,184527.0,2346583.0,,,73576.0,,109445.0,97680.0,27682.0,610780.0,7030.0,69712.0,85484.0,,,47796.0,470902.0,20457.0,,34460.0,5679.0,2010.0,100752.0,4570.0,41374.0,13207.0,,,42810.0,80950.0,,,,,,,,,,,,,,,,,,,,,,,,,,,,,,3521.0,,,,,,,,15889.0,,,,,,,,,,,,,,,,,,,,,,,51.0,18615.0,2704.0,11120.0,86789.0,86789.0,61709.0,,,,,,,,,,,,40.779269,-73.703029,Voluntary non-profit - Private,Acute Care Hospitals,NORTH SHORE UNIVERSITY HOSPITAL (330106)
