,RPT_REC_NUM,PRVDR_NUM,FI_NUM,RPT_STUS_CD,FI_CREAT_DT,FY_BGN_DT,FY_END_DT,UTIL_CODE,TRNSMTL_NUM,STATE,ST_CTY_CD,CENSUS,REGION,MSA,A_C1_114,A_C2_114,A_C2_61,B_1_C21_100,B_1_C21_94,B_1_C22_100,B_1_C22_42,B_1_C22_94,B_1_C26_200,C_1_C6_100,C_1_C7_100,C_1_C7_111,D3_HOS_C1_77,D3_HOS_C2_201,D3_HOS_C2_42,D3_HOS_C2_43,D3_HOS_C2_61,D3_HOS_C2_77,D3_HOS_C3_61,D3_HOS_C3_77,D3_IPF_C2_42,D3_IPF_C2_94,D3_IPF_C3_94,D3_IRF_C2_61,D3_IRF_C2_94,D3_IRF_C3_61,D3_IRF_C3_94,D3_SNF_C2_40,D3_SNF_C2_41,D_1_HOS_C4_4201,D_2_IPF_C5_94,D_2_IRF_C5_94,D_4_HOS_C12_94,D_4_HOS_C4_74,D_4_SNF_C13_200,D_5_HOS_C2_94,D_5_HOS_C3_61,D_5_HOS_C4_94,D_5_HOS_C6_61,D_5_HOS_C7_94,E1_2_HOS_C1_31,E1_2_HOS_C1_7,E1_2_HOS_C1_8,E2_SWSNF_C1_7,E3_1_HOS_C1_22,E3_2_HOS_C1_13,E3_2_HOS_C1_29,E3_2_HOS_C1_3101,E3_2_HOS_C1_35,E3_2_HOS_C1_5,E3_2_HOS_C1_7,E3_2_IPF_C1_13,E3_2_IPF_C1_27,E3_2_IPF_C1_3101,E3_2_IPF_C1_5,E3_3_HOS_C1_14,E3_3_HOS_C1_16,E3_3_HOS_C1_3201,E3_3_HOS_C1_36,E3_3_HOS_C1_8,E3_3_IRF_C1_3201,E3_3_IRF_C1_6,E3_3_IRF_C1_8,E3_4_HOS_C1_19,E3_4_HOS_C1_2201,E3_4_HOS_C1_4,E3_5_C1_10,E3_5_C1_14,E3_5_C1_15,E3_5_C1_16,E3_5_C1_2,E3_5_C1_21,E3_5_C1_7,E3_5_C1_8,E3_6_SNF_C1_1501,E_A_HOS_C101_101,E_A_HOS_C101_102,E_A_HOS_C101_202,E_A_HOS_C101_28,E_A_HOS_C1_101,E_A_HOS_C1_102,E_A_HOS_C1_202,E_A_HOS_C1_2901,E_A_HOS_C1_35,E_A_HOS_C1_3501,E_A_HOS_C1_3502,E_A_HOS_C1_3503,E_A_HOS_C1_36,E_A_HOS_C1_4101,E_A_HOS_C1_7089,E_A_HOS_C1_7092,E_A_HOS_C1_7095,E_A_HOS_C1_7101,E_A_HOS_C2_35,E_A_HOS_C2_3501,E_A_HOS_C2_3502,E_A_HOS_C2_3503,E_B_HOS_C101_3,E_B_HOS_C101_4,E_B_HOS_C101_6,E_B_HOS_C101_7,E_B_HOS_C101_8,E_B_HOS_C1_3998,E_B_HOS_C1_4001,E_B_IPF_C1_15,E_B_IPF_C1_16,E_B_IPF_C1_4001,E_B_IPF_C1_44,E_B_IRF_C1_15,E_B_IRF_C1_16,E_B_IRF_C1_38,E_B_IRF_C1_44,E_B_IRF_C1_8,E_B_SNF_C1_15,E_B_SNF_C1_16,E_B_SNF_C1_24,E_B_SNF_C1_31,E_B_SNF_C1_44,E_B_SNF_C1_9,G2_C1_401,G3_C1_2450,H3_1_HHA1_C11_15,H3_1_HHA1_C9_15,H3_1_HHA2_C11_15,H3_1_HHA2_C9_15,H3_1_HHA3_C10_15,H3_1_HHA3_C5_1,H3_1_HHA3_C5_2,H3_1_HHA3_C5_3,H3_1_HHA3_C5_4,H3_1_HHA3_C5_5,H3_1_HHA3_C5_6,H3_1_HHA3_C6_1,H3_1_HHA3_C6_2,H3_1_HHA3_C6_3,H3_1_HHA3_C6_4,H3_1_HHA3_C6_5,H3_1_HHA3_C6_6,H3_1_HHA3_C6_7,H3_1_HHA3_C7_1,H3_1_HHA3_C7_2,H3_1_HHA3_C7_3,H3_1_HHA3_C7_4,H3_1_HHA3_C7_5,H3_1_HHA3_C7_6,H3_1_HHA3_C7_7,H3_1_HHA3_C9_15,H4_2_HHA1_C1_18,H4_2_HHA1_C1_3101,H4_2_HHA1_C1_35,H4_2_HHA1_C2_18,H4_2_HHA1_C2_27,H4_2_HHA1_C2_3101,H4_2_HHA1_C2_35,H4_2_HHA2_C1_10,H4_2_HHA2_C1_12,H4_2_HHA2_C1_15,H4_2_HHA2_C1_16,H4_2_HHA2_C1_30,H4_2_HHA2_C1_3101,H4_2_HHA2_C1_33,H4_2_HHA2_C1_34,H4_2_HHA2_C2_16,H4_2_HHA2_C2_17,H4_2_HHA2_C2_25,H4_2_HHA2_C2_30,H4_2_HHA2_C2_3101,H4_2_HHA3_C1_11,H4_2_HHA3_C1_12,H4_2_HHA3_C1_13,H4_2_HHA3_C1_14,H4_2_HHA3_C1_15,H4_2_HHA3_C1_16,H4_2_HHA3_C1_22,H4_2_HHA3_C1_24,H4_2_HHA3_C1_26,H4_2_HHA3_C1_29,H4_2_HHA3_C1_31,H4_2_HHA3_C1_32,H4_2_HHA3_C1_33,H4_2_HHA3_C1_34,H4_2_HHA3_C2_10,H4_2_HHA3_C2_11,H4_2_HHA3_C2_12,H4_2_HHA3_C2_13,H4_2_HHA3_C2_14,H4_2_HHA3_C2_15,H4_2_HHA3_C2_16,H4_2_HHA3_C2_22,H4_2_HHA3_C2_24,H4_2_HHA3_C2_26,H4_2_HHA3_C2_29,H4_2_HHA3_C2_30,H4_2_HHA3_C2_31,H4_2_HHA3_C2_3101,H4_2_HHA3_C2_32,H4_2_HHA3_C2_33,H4_2_HHA3_C2_34,L_1_HOS_C101_1,L_1_HOS_C1_101,L_1_HOS_C1_201,S3_1_C10_1801,S3_1_C11_23,S3_1_C14_1801,S3_1_C15_1801,S3_1_C2_1801,S3_1_C2_32,S3_1_C3_1801,S3_1_C3_32,S3_1_C5_19,S3_1_C5_20,S3_1_C5_6,S3_1_C7_1801,S3_1_C8_1801,S3_1_C9_18,S3_1_C9_23,S3_2_C2_1401,S3_2_C2_1402,S3_2_C2_2550,S3_2_C2_2551,S3_2_C2_2552,S3_2_C2_2553,S3_2_C3_1401,S3_2_C3_1402,S3_2_C3_24,S3_2_C3_2550,S3_2_C3_2551,S3_2_C3_2552,S3_2_C3_2553,S3_2_C4_1401,S3_2_C4_1402,S3_2_C4_1601,S3_2_C4_1602,S3_2_C4_2550,S3_2_C4_2551,S3_2_C4_2552,S3_2_C4_2553,S3_2_C6_1401,S3_2_C6_1402,S3_5_C1_15,S3_5_C1_5,S3_5_C1_7,S3_5_C2_12,S3_5_C2_15,S3_5_C2_7,S4_HHA2_C1_34,S4_HHA2_C2_34,S4_HHA2_C2_38,S4_HHA2_C3_34,S4_HHA2_C4_34,S4_HHA2_C4_37,S4_HHA2_C5_34,S4_HHA3_C1_33,S4_HHA3_C1_34,S4_HHA3_C1_35,S4_HHA3_C1_36,S4_HHA3_C1_38,S4_HHA3_C2_33,S4_HHA3_C2_34,S4_HHA3_C2_35,S4_HHA3_C2_37,S4_HHA3_C2_38,S4_HHA3_C3_33,S4_HHA3_C3_34,S4_HHA3_C3_35,S4_HHA3_C3_36,S4_HHA3_C3_38,S4_HHA3_C4_33,S4_HHA3_C4_34,S4_HHA3_C4_35,S4_HHA3_C4_36,S4_HHA3_C4_37,S4_HHA3_C4_38,S4_HHA3_C5_33,S4_HHA3_C5_34,S4_HHA3_C5_35,S4_HHA3_C5_36,S4_HHA3_C5_37,S4_HHA3_C5_38,A7_1_C1_10,A7_1_C1_4,A7_1_C1_5,A7_1_C1_6,A7_1_C1_8,A7_1_C2_10,A7_1_C2_5,A7_1_C2_6,A7_1_C2_8,A7_1_C7_10,A7_1_C7_5,A7_1_C7_6,A7_1_C7_8,A7_3_C10_3,A7_3_C15_3,A7_3_C9_3,A8_C2_14,A8_C2_18,A8_C2_4,A8_C2_5,A8_C2_50,A_C1_200,A_C1_30,A_C2_200,A_C2_30,A_C2_74,A_C6_200,A_C6_30,B_1_C0_200,B_1_C0_30,B_1_C0_74,B_1_C26_202,B_1_C26_30,B_1_C26_74,B_2_C26_202,B_2_C26_30,B_2_C26_74,C_1_C3_202,C_1_C5_200,C_1_C5_202,C_1_C5_30,C_1_C5_74,C_1_C6_200,C_1_C6_202,C_1_C6_30,C_1_C6_74,C_1_C8_202,D1_HOS_C1_27,D1_HOS_C1_37,D1_HOS_C1_41,D1_HOS_C1_48,D1_HOS_C1_49,D1_HOS_C1_50,D1_HOS_C1_51,D1_HOS_C1_52,D1_HOS_C1_53,D3_HOS_C2_200,D3_HOS_C2_202,D3_HOS_C2_30,D3_HOS_C2_74,D3_HOS_C3_200,D3_HOS_C3_74,D_1_HOS_C4_200,D_1_HOS_C4_30,D_1_HOS_C6_200,D_1_HOS_C6_30,D_1_HOS_C7_200,D_1_HOS_C7_30,D_2_HOS_C5_200,D_2_HOS_C5_74,D_3_HOS_C6_200,D_3_HOS_C8_200,E3_4_HOS_C1_1,E3_4_HOS_C1_10,E3_4_HOS_C1_11,E3_4_HOS_C1_12,E3_4_HOS_C1_13,E3_4_HOS_C1_14,E3_4_HOS_C1_15,E3_4_HOS_C1_16,E3_4_HOS_C1_17,E3_4_HOS_C1_2,E3_4_HOS_C1_22,E3_4_HOS_C1_23,E3_4_HOS_C1_24,E3_4_HOS_C1_25,E3_4_HOS_C1_3,E3_4_HOS_C1_7,E3_4_HOS_C1_9,G2_C1_1,G2_C1_10,G2_C1_17,G2_C1_28,G2_C1_30,G2_C2_36,G2_C2_43,G3_C1_1,G3_C1_11,G3_C1_18,G3_C1_2,G3_C1_25,G3_C1_26,G3_C1_29,G3_C1_3,G3_C1_4,G3_C1_5,G3_C1_7,S10_C1_1,S10_C1_26,S10_C1_27,S10_C1_28,S10_C1_29,S10_C1_30,S10_C1_31,S10_C2_20,S10_C2_21,S10_C2_23,S10_C3_20,S10_C3_21,S10_C3_23,S2_1_C1_26,S2_1_C1_27,S2_1_C4_3,S3_1_C10_14,S3_1_C10_27,S3_1_C13_1,S3_1_C13_14,S3_1_C15_1,S3_1_C15_14,S3_1_C2_1,S3_1_C2_14,S3_1_C2_27,S3_1_C2_7,S3_1_C3_1,S3_1_C3_14,S3_1_C3_7,S3_1_C6_1,S3_1_C6_14,S3_1_C6_7,S3_1_C8_1,S3_1_C8_14,S3_1_C8_7,A7_1_C1_1,A7_1_C1_3,A7_1_C2_3,A7_3_C11_3,A7_3_C7_3,A8_C2_1,A8_C2_10,A8_C2_12,A8_C2_3,A_C1_40,A_C2_113,A_C2_3,A_C2_40,B_1_C0_40,B_1_C26_40,B_2_C26_40,C_1_C5_40,C_1_C6_40,C_1_C7_200,C_1_C7_202,D1_IPF_C1_27,D1_IPF_C1_37,D1_IPF_C1_41,D1_IPF_C1_49,D1_IPF_C1_50,D1_IPF_C1_52,D1_IPF_C1_53,D3_IPF_C2_40,D_1_HOS_C4_40,D_1_HOS_C6_40,D_1_HOS_C7_40,E3_2_HOS_C1_1,E3_2_HOS_C1_12,E3_2_HOS_C1_16,E3_2_HOS_C1_18,E3_2_HOS_C1_20,E3_2_HOS_C1_22,E3_2_HOS_C1_26,E3_2_HOS_C1_31,E3_2_HOS_C1_34,E3_2_HOS_C1_9,E3_2_IPF_C1_1,E3_2_IPF_C1_12,E3_2_IPF_C1_16,E3_2_IPF_C1_18,E3_2_IPF_C1_20,E3_2_IPF_C1_22,E3_2_IPF_C1_26,E3_2_IPF_C1_31,E3_2_IPF_C1_34,E3_2_IPF_C1_9,E_B_HOS_C1_17,E_B_IPF_C1_17,G2_C1_18,G2_C1_2,G2_C2_19,G2_C2_28,G3_C1_14,S3_1_C10_16,S3_1_C14_1,S3_1_C14_14,S3_1_C14_16,S3_1_C15_16,S3_1_C2_16,S3_1_C3_16,S3_1_C6_16,S3_1_C7_1,S3_1_C7_14,S3_1_C7_16,S3_1_C7_7,S3_1_C8_16,S3_2_C2_1,S3_2_C2_10,S3_2_C2_27,S3_2_C2_30,S3_2_C2_32,S3_2_C2_34,S3_2_C2_38,S3_2_C2_41,S3_2_C2_43,S3_3_C2_1,S3_3_C2_2,S3_3_C2_3,S3_3_C2_6,S3_3_C4_1,S3_3_C4_2,S3_3_C4_3,S3_3_C4_6,S3_3_C4_7,B_1_C26_201,D_4_HOS_C12_200,D_5_HOS_C2_200,D_5_HOS_C5_200,E3_3_HOS_C1_1,E3_3_HOS_C1_10,E3_3_HOS_C1_13,E3_3_HOS_C1_17,E3_3_HOS_C1_19,E3_3_HOS_C1_2,E3_3_HOS_C1_20,E3_3_HOS_C1_21,E3_3_HOS_C1_22,E3_3_HOS_C1_23,E3_3_HOS_C1_24,E3_3_HOS_C1_25,E3_3_HOS_C1_26,E3_3_HOS_C1_27,E3_3_HOS_C1_3,E3_3_HOS_C1_32,E3_3_HOS_C1_33,E3_3_HOS_C1_35,E3_3_HOS_C1_4,E_B_HOS_C1_2,E_B_HOS_C1_24,E_B_HOS_C1_26,E_B_HOS_C1_27,E_B_HOS_C1_3,E_B_HOS_C1_30,E_B_HOS_C1_32,E_B_HOS_C1_34,E_B_HOS_C1_35,E_B_HOS_C1_36,E_B_HOS_C1_37,E_B_HOS_C1_40,E_B_HOS_C1_41,E_B_HOS_C1_43,G2_C2_18,A7_1_C1_2,A7_1_C5_10,A7_1_C5_6,A7_1_C5_8,A7_1_C7_2,A7_1_C7_3,A7_1_C7_4,A8_C2_26,A8_C2_27,B_2_C0_202,E1_2_HOS_C1_1,E1_2_HOS_C1_2,E1_2_HOS_C1_4,E1_2_HOS_C1_5,S3_1_C11_14,S3_1_C11_27,S3_2_C2_26,S3_2_C2_29,S3_2_C2_31,S3_2_C2_40,S3_2_C2_42,S3_2_C4_1,S3_2_C4_10,S3_2_C4_26,S3_2_C4_27,S3_2_C4_29,S3_2_C4_30,S3_2_C4_31,S3_2_C4_32,S3_2_C4_34,S3_2_C4_38,S3_2_C4_40,S3_2_C4_41,S3_2_C4_42,S3_2_C5_1,S3_2_C6_1,S3_3_C5_1,S3_3_C5_3,S3_3_C6_1,S3_3_C6_3,S3_3_C6_6,E3_2_HOS_C1_19,E3_2_HOS_C1_2,E3_2_HOS_C1_21,E3_2_HOS_C1_32,B_1_C21_30,B_1_C22_30,B_2_C26_200,E3_2_HOS_C1_10,E3_2_HOS_C1_11,E3_2_HOS_C1_27,E3_2_HOS_C1_33,E3_2_HOS_C1_4,E3_2_HOS_C1_6,E3_2_HOS_C1_8,E4_C1_1,E4_C1_23,E4_C1_25,E4_C1_26,E4_C1_27,E4_C1_28,E4_C1_29,E4_C1_3,E4_C1_301,E4_C1_37,E4_C1_41,E4_C1_42,E4_C1_44,E4_C1_45,E4_C1_46,E4_C1_47,E4_C1_48,E4_C1_49,E4_C1_5,E4_C1_50,E4_C1_6,E4_C1_7,E4_C2_11,E4_C2_12,E4_C2_13,E4_C2_14,E4_C2_17,E4_C2_18,E4_C2_19,E4_C2_27,E4_C2_8,E4_C2_9,E4_C3_19,E4_C3_31,E4_C3_8,E4_C3_9,E_B_HOS_C1_28,E_B_HOS_C1_42,S3_1_C9_14,S3_1_C9_27,A7_1_C2_4,A7_1_C5_4,B_1_C0_43,B_1_C26_43,B_2_C26_43,C_1_C5_201,C_1_C5_43,C_1_C6_43,D_1_HOS_C4_43,E1_2_HOS_C1_6,E_A_HOS_C1_4,S10_C1_19,S10_C1_2,S10_C1_20,S10_C1_21,S10_C1_23,S10_C1_6,S10_C1_7,S10_C1_8,S3_1_C7_13,S3_1_C8_13,S3_1_C8_28,S3_2_C2_17,S3_2_C2_18,S3_2_C2_21,S3_2_C4_17,S3_2_C4_18,S3_2_C4_21,S3_2_C5_27,S3_2_C6_27,S3_3_C2_5,S3_3_C4_5,S3_3_C5_7,S3_3_C6_5,S3_3_C6_7,A8_C2_9,E3_4_HOS_C1_8,E_A_HOS_C1_74,G3_C1_10,G3_C1_16,G3_C1_22,G3_C1_6,A7_3_C5_3,A8_C2_15,A_C2_45,A_C6_45,B_1_C0_45,B_1_C26_45,B_2_C26_45,C_1_C5_45,C_1_C6_45,E3_2_HOS_C1_23,E3_2_HOS_C1_24,G2_C1_19,G2_C1_31,G2_C1_32,G2_C1_33,G2_C1_8,G3_C1_15,G3_C1_23,A7_3_C6_3,A8_C2_20,A8_C2_7,A8_C2_8,C_1_C7_74,D_5_HOS_C3_200,D_5_HOS_C3_74,D_5_HOS_C6_200,D_5_HOS_C6_74,E_B_HOS_C1_1,E_B_HOS_C1_11,E_B_HOS_C1_12,E_B_HOS_C1_14,E_B_HOS_C1_18,E_B_HOS_C1_19,E_B_HOS_C1_21,E_B_HOS_C1_25,G2_C1_16,G3_C1_21,S3_1_C7_2,S3_2_C2_11,S3_2_C2_13,S3_2_C2_14,S3_2_C2_19,S3_2_C2_39,S3_2_C4_11,S3_2_C4_13,S3_2_C4_14,S3_2_C4_19,S3_2_C4_39,S3_2_C5_10,S3_2_C5_11,S3_2_C5_13,S3_2_C5_14,S3_2_C5_26,S3_2_C5_30,S3_2_C5_32,S3_2_C5_34,S3_2_C5_38,S3_2_C5_39,S3_2_C5_41,S3_2_C5_42,S3_2_C6_10,S3_2_C6_11,S3_2_C6_13,S3_2_C6_14,S3_2_C6_26,S3_2_C6_30,S3_2_C6_32,S3_2_C6_34,S3_2_C6_38,S3_2_C6_39,S3_2_C6_41,S3_2_C6_42,S3_3_C2_4,S3_3_C4_4,S3_3_C5_2,S3_3_C5_4,S3_3_C6_2,S3_3_C6_4,A7_1_C2_1,A8_C2_11,A_C1_43,A_C2_43,D_4_HOS_C11_200,D_4_HOS_C12_74,D_4_HOS_C13_200,D_4_HOS_C3_200,D_4_HOS_C6_200,D_5_HOS_C2_74,D_5_HOS_C4_200,D_5_HOS_C5_74,D_5_HOS_C7_200,E1_2_HOS_C1_3,E_A_HOS_C1_1,E_A_HOS_C1_2,E_A_HOS_C1_30,E_A_HOS_C1_31,E_A_HOS_C1_32,E_A_HOS_C1_33,E_A_HOS_C1_34,E_A_HOS_C1_58,E_A_HOS_C1_60,E_A_HOS_C1_61,E_A_HOS_C1_62,E_A_HOS_C1_63,E_A_HOS_C1_64,E_A_HOS_C1_65,E_A_HOS_C1_66,E_A_HOS_C1_67,E_A_HOS_C1_71,E_A_HOS_C1_75,E_B_HOS_C1_20,E_B_HOS_C1_31,E_B_HOS_C1_9,G3_C1_27,G3_C1_28,L_1_HOS_C1_1,L_1_HOS_C1_10,L_1_HOS_C1_11,L_1_HOS_C1_2,L_1_HOS_C1_3,L_1_HOS_C1_7,L_1_HOS_C1_8,L_1_HOS_C1_9,S10_C1_10,S10_C1_11,S10_C1_5,S10_C1_9,S2_1_C2_24,S2_1_C4_24,S3_1_C6_2,S3_2_C2_22,S3_2_C2_23,S3_2_C2_4,S3_2_C2_5,S3_2_C4_22,S3_2_C4_23,S3_2_C4_3,S3_2_C4_4,S3_2_C4_5,S3_2_C5_3,S3_2_C5_4,S3_2_C5_40,S3_2_C5_5,S3_2_C6_3,S3_2_C6_4,S3_2_C6_40,S3_2_C6_5,S3_3_C5_6,A7_1_C2_2,A_C6_113,E_B_HOS_C1_38,A7_1_C3_10,A7_1_C3_3,A7_1_C3_4,A7_1_C3_6,A7_1_C3_8,A8_C2_16,D_2_HOS_C5_92,S10_C1_22,S10_C2_22,S10_C3_22,S2_1_C1_24,S2_1_C1_37,S2_1_C3_24,S3_1_C7_28,S3_2_C2_2,S3_2_C2_20,S3_2_C4_2,S3_2_C4_20,S3_2_C5_2,S3_2_C6_2,S3_5_C1_1,S3_5_C1_2,A7_1_C5_3,A_C1_41,A_C1_44,A_C2_41,A_C2_44,A_C6_40,A_C6_41,B_1_C0_41,B_1_C26_41,B_2_C26_41,C_1_C5_41,C_1_C6_41,D1_IPF_C1_48,D1_IPF_C1_51,D1_IRF_C1_27,D1_IRF_C1_37,D1_IRF_C1_41,D1_IRF_C1_48,D1_IRF_C1_49,D1_IRF_C1_50,D1_IRF_C1_51,D1_IRF_C1_52,D1_IRF_C1_53,D3_IPF_C2_200,D3_IPF_C2_74,D3_IPF_C3_200,D3_IPF_C3_74,D3_IRF_C2_200,D3_IRF_C2_41,D3_IRF_C2_74,D3_IRF_C3_200,D3_IRF_C3_74,D_1_HOS_C4_41,D_1_HOS_C6_41,D_1_HOS_C7_41,D_2_IPF_C5_200,D_2_IPF_C5_74,D_2_IRF_C5_200,D_2_IRF_C5_74,E3_2_IPF_C1_19,E3_2_IPF_C1_2,E3_2_IPF_C1_21,E3_2_IPF_C1_23,E3_2_IPF_C1_24,E3_2_IPF_C1_25,E3_2_IPF_C1_32,E3_3_IRF_C1_1,E3_3_IRF_C1_10,E3_3_IRF_C1_13,E3_3_IRF_C1_17,E3_3_IRF_C1_19,E3_3_IRF_C1_20,E3_3_IRF_C1_21,E3_3_IRF_C1_22,E3_3_IRF_C1_23,E3_3_IRF_C1_24,E3_3_IRF_C1_25,E3_3_IRF_C1_26,E3_3_IRF_C1_27,E3_3_IRF_C1_3,E3_3_IRF_C1_32,E3_3_IRF_C1_33,E3_3_IRF_C1_35,E3_3_IRF_C1_4,E4_C1_11,E4_C1_12,E4_C1_13,E4_C1_14,E4_C1_17,E4_C1_18,E4_C1_19,E4_C1_33,E4_C1_40,E4_C1_43,E4_C1_8,E4_C1_9,E4_C2_26,E4_C2_28,E4_C2_29,E4_C2_30,E_A_HOS_C1_10,E_A_HOS_C1_12,E_A_HOS_C1_13,E_A_HOS_C1_14,E_A_HOS_C1_15,E_A_HOS_C1_18,E_A_HOS_C1_19,E_A_HOS_C1_20,E_A_HOS_C1_21,E_A_HOS_C1_22,E_A_HOS_C1_24,E_A_HOS_C1_29,E_A_HOS_C1_3,E_A_HOS_C1_5,E_A_HOS_C1_52,E_A_HOS_C1_9,E_B_IRF_C1_17,L_1_HOS_C1_4,L_1_HOS_C1_5,L_1_HOS_C1_6,S10_C1_25,S3_1_C13_16,S3_1_C13_17,S3_1_C14_17,S3_1_C15_17,S3_1_C2_17,S3_1_C3_17,S3_1_C6_17,S3_1_C7_17,S3_1_C8_17,S3_2_C2_9,S3_2_C4_36,S3_2_C5_36,S3_2_C6_36,A8_C2_17,A_C1_95,A_C2_95,B_1_C0_44,B_1_C0_95,B_1_C26_44,B_1_C26_95,B_2_C26_44,B_2_C26_95,C_1_C5_44,C_1_C5_95,C_1_C6_44,C_1_C7_95,D1_SNF_C1_37,D1_SNF_C1_74,D1_SNF_C1_84,D3_SNF_C2_200,D3_SNF_C2_202,D3_SNF_C3_200,E3_6_SNF_C1_1,E3_6_SNF_C1_10,E3_6_SNF_C1_12,E3_6_SNF_C1_15,E3_6_SNF_C1_16,E3_6_SNF_C1_18,E3_6_SNF_C1_4,E3_6_SNF_C1_7,E3_6_SNF_C1_8,E3_6_SNF_C1_9,E_B_HOS_C1_5,E_B_HOS_C1_6,E_B_SNF_C1_17,G2_C1_3,G2_C1_7,G3_C1_17,H3_1_HHA1_C5_1,H3_1_HHA1_C5_2,H3_1_HHA1_C5_3,H3_1_HHA1_C5_4,H3_1_HHA1_C5_5,H3_1_HHA1_C5_6,H3_1_HHA1_C6_1,H3_1_HHA1_C6_2,H3_1_HHA1_C6_3,H3_1_HHA1_C6_4,H3_1_HHA1_C6_5,H3_1_HHA1_C6_6,H3_1_HHA1_C6_7,H3_1_HHA1_C7_1,H3_1_HHA1_C7_2,H3_1_HHA1_C7_3,H3_1_HHA1_C7_4,H3_1_HHA1_C7_5,H3_1_HHA1_C7_6,H3_1_HHA1_C7_7,H4_2_HHA1_C1_11,H4_2_HHA1_C1_12,H4_2_HHA1_C1_13,H4_2_HHA1_C1_14,H4_2_HHA1_C1_15,H4_2_HHA1_C1_16,H4_2_HHA1_C1_22,H4_2_HHA1_C1_24,H4_2_HHA1_C1_26,H4_2_HHA1_C1_29,H4_2_HHA1_C1_31,H4_2_HHA1_C1_32,H4_2_HHA1_C2_11,H4_2_HHA1_C2_12,H4_2_HHA1_C2_13,H4_2_HHA1_C2_14,H4_2_HHA1_C2_15,H4_2_HHA1_C2_22,H4_2_HHA1_C2_24,H4_2_HHA1_C2_26,H4_2_HHA1_C2_29,H4_2_HHA1_C2_31,H4_2_HHA1_C2_32,S2_1_C5_24,S3_1_C10_19,S3_1_C2_19,S3_1_C3_19,S3_1_C6_19,S3_1_C7_19,S3_1_C8_19,S3_2_C4_9,S3_2_C5_31,S3_2_C5_9,S3_2_C6_31,S3_2_C6_9,S4_HHA1_C1_33,S4_HHA1_C1_35,S4_HHA1_C1_36,S4_HHA1_C1_38,S4_HHA1_C2_33,S4_HHA1_C2_35,S4_HHA1_C2_37,S4_HHA1_C2_38,S4_HHA1_C3_33,S4_HHA1_C3_35,S4_HHA1_C3_36,S4_HHA1_C3_38,S4_HHA1_C4_33,S4_HHA1_C4_35,S4_HHA1_C4_36,S4_HHA1_C5_33,S4_HHA1_C5_35,S4_HHA1_C5_36,S4_HHA1_C5_37,S4_HHA1_C5_38,A_C1_105,A_C1_74,A_C2_105,A_C2_109,A_C6_105,B_1_C0_105,B_1_C0_109,B_1_C22_40,B_1_C26_105,B_1_C26_109,B_2_C26_105,B_2_C26_109,C_1_C5_105,C_1_C5_109,C_1_C6_105,D4_KIDNEY_C1_69,D4_PANCREAS_C1_69,D_3_HOS_C2_200,D_3_HOS_C5_200,D_3_HOS_C9_200,D_3_HOS_C9_30,E3_2_IPF_C1_17,E3_3_IRF_C1_2,E4_C1_2,E4_C1_21,E4_C1_38,E4_C1_4,E_A_HOS_C1_23,E_A_HOS_C1_25,E_A_HOS_C1_26,E_A_HOS_C1_27,E_A_HOS_C1_28,E_A_HOS_C1_55,E_A_HOS_C1_57,E_A_HOS_C1_6,E_A_HOS_C1_8,E_B_HOS_C1_4,S3_1_C10_17,S3_1_C13_2,S3_1_C6_3,S3_1_C6_4,S3_1_C7_32,S3_1_C8_32,S3_1_C9_16,S3_2_C2_12,S3_2_C4_12,S3_2_C5_12,S3_2_C6_12,S3_5_C1_3,S3_5_C1_4,B_2_C26_201,D1_HOS_C1_26,E2_SWSNF_C1_1,E2_SWSNF_C1_10,E2_SWSNF_C1_12,E2_SWSNF_C1_13,E2_SWSNF_C1_15,E2_SWSNF_C1_17,E2_SWSNF_C1_18,E2_SWSNF_C1_19,E2_SWSNF_C1_20,E2_SWSNF_C1_22,E2_SWSNF_C1_5,E2_SWSNF_C1_8,E_B_HOS_C1_7,E_B_HOS_C1_8,G2_C2_23,S3_1_C6_5,S3_1_C8_5,S3_1_C8_6,S3_2_C5_29,S3_2_C6_29,G3_C1_20,S4_HHA1_C4_38,A8_C2_2,E2_SWSNF_C1_11,E3_6_SNF_C1_13,G2_C1_5,S10_C1_13,S10_C1_14,S10_C1_15,S10_C1_16,S3_1_C7_4,S3_5_C2_1,S3_5_C2_4,A8_C2_21,A8_C2_6,A_C6_43,G2_C1_37,G2_C2_42,S3_2_C2_28,S3_2_C4_28,S3_2_C5_28,S3_2_C6_28,A8_C2_13,A_C1_45,E2_SWSNF_C1_3,E3_5_C1_1,E3_5_C1_19,E3_5_C1_20,E3_5_C1_22,E3_5_C1_24,E3_5_C1_25,E3_5_C1_26,E3_5_C1_27,E3_5_C1_28,E3_5_C1_30,E3_5_C1_31,E3_5_C1_33,E3_5_C1_4,E3_5_C1_6,G3_C1_13,S3_1_C10_20,S3_1_C2_20,S3_1_C3_20,S3_1_C4_1,S3_1_C4_14,S3_1_C4_7,S3_1_C7_20,S3_1_C8_20,A7_1_C5_5,A8_C2_28,A_C6_44,G2_C1_4,S10_C1_12,S3_2_C2_3,D_4_HOS_C1_200,S3_1_C7_5,S3_2_C2_24,S3_2_C2_6,S3_2_C4_24,S3_2_C4_6,S3_2_C5_6,S3_2_C6_6,E_A_HOS_C101_41,E_A_HOS_C101_45,E_A_HOS_C1_40,E_A_HOS_C1_41,E_A_HOS_C1_42,E_A_HOS_C1_43,E_A_HOS_C1_44,E_A_HOS_C1_45,E_A_HOS_C1_46,A8_C2_22,E3_5_C1_23,S3_1_C6_29,S3_1_C7_6,A_C6_95,S3_1_C6_15,S3_1_C7_15,S3_1_C8_15,S3_1_C8_30,E3_3_HOS_C1_18,S10_C1_18,C_1_C6_95,G2_C1_23,S4_HHA1_C1_34,S4_HHA1_C2_34,S4_HHA1_C3_34,S4_HHA1_C4_34,S4_HHA1_C5_34,S3_2_C2_35,S3_2_C4_35,A7_1_C5_2,E3_2_HOS_C1_3,D_5_HOS_C3_95,D_5_HOS_C6_95,G2_C1_6,S3_5_C1_14,E3_2_HOS_C1_17,H3_1_HHA1_C10_15,A7_1_C1_7,A7_1_C2_7,A7_1_C4_7,A7_1_C5_7,A7_1_C6_7,A7_1_C7_1,A7_1_C7_7,A_C1_106,A_C1_107,A_C2_106,A_C2_107,A_C6_106,A_C6_107,A_C6_74,B_1_C0_106,B_1_C0_107,B_1_C26_100,B_1_C26_106,B_1_C26_107,B_2_C26_100,B_2_C26_106,B_2_C26_107,C_1_C5_100,C_1_C5_106,C_1_C5_107,C_1_C6_106,C_1_C6_107,C_1_C6_109,C_1_C7_105,C_1_C7_106,C_1_C7_107,C_1_C7_109,D4_HEART_C1_69,D4_LIVER_C1_69,E4_C1_20,E4_C1_22,E4_C2_10,E_A_HOS_C1_11,E_A_HOS_C1_53,E_A_HOS_C1_90,E_A_HOS_C1_91,S3_2_C2_16,S3_2_C2_25,S3_2_C2_7,S3_2_C4_16,S3_2_C4_25,S3_2_C4_43,S3_2_C4_7,S3_2_C5_16,S3_2_C5_43,S3_2_C5_7,S3_2_C6_16,S3_2_C6_43,S3_2_C6_7,S3_5_C2_2,G2_C1_38,S5_C1_11,S5_C1_13,S5_C1_15,S5_C1_2,S5_C1_3,S5_C1_5,S5_C1_6,S5_C1_7,S5_C1_8,S5_C2_1,A_C2_94,G2_C1_39,S5_C1_12,S5_C2_3,S5_C4_6,H4_2_HHA1_C2_34,L_3_HOS_C1_1,L_3_HOS_C1_10,L_3_HOS_C1_12,L_3_HOS_C1_14,L_3_HOS_C1_3,L_3_HOS_C1_4,L_3_HOS_C1_5,L_3_HOS_C1_6,L_3_HOS_C1_8,L_3_HOS_C1_9,S4_HHA1_C4_37,E3_2_HOS_C1_25,A_C1_46,A_C2_46,A_C6_46,B_1_C0_46,B_1_C26_46,B_2_C26_46,C_1_C5_46,C_1_C6_46,G2_C1_9,S3_1_C10_21,S3_1_C15_21,S3_1_C2_21,S3_1_C3_21,S3_1_C8_21,E2_SWSNF_C1_21,E3_5_C1_32,G2_C2_25,G3_C1_8,B_1_C22_44,E3_4_HOS_C1_18,E_B_SNF_C1_1,E_B_SNF_C1_11,E_B_SNF_C1_12,E_B_SNF_C1_14,E_B_SNF_C1_18,E_B_SNF_C1_20,E_B_SNF_C1_21,E_B_SNF_C1_27,E_B_SNF_C1_30,E_B_SNF_C1_32,E_B_SNF_C1_37,E_B_SNF_C1_40,E_B_SNF_C1_41,E_B_SNF_C1_43,S3_1_C9_19,A_C2_100,B_1_C0_100,A_C1_42,A_C2_42,A_C6_42,B_1_C0_42,B_1_C26_42,B_2_C26_42,C_1_C5_42,C_1_C6_42,D_1_HOS_C4_42,S3_1_C15_18,S3_1_C2_18,S3_1_C3_18,S3_1_C8_18,E_B_HOS_C1_23,A8_C2_24,H4_2_HHA1_C1_30,S3_1_C12_1,S3_1_C12_14,S3_1_C5_1,S3_1_C5_14,S3_1_C5_7,E3_5_C1_5,A8_C2_29,E_B_SNF_C1_19,A_C1_94,B_1_C0_94,B_1_C26_94,B_2_C26_94,C_1_C5_94,C_1_C6_94,C_1_C7_94,D_5_HOS_C4_74,D_5_HOS_C7_74,E_B_HOS_C1_33,E_B_HOS_C1_44,G3_C1_12,S10_C1_17,S5_C2_2,S5_C2_5,S5_C2_6,S5_C2_7,S5_C4_2,S5_C4_3,S5_C6_1,S5_C6_2,S5_C6_4,H4_2_HHA1_C1_34,H4_2_HHA1_C2_17,S3_1_C5_15,E_B_IPF_C1_2,E_B_IPF_C1_24,E_B_IPF_C1_26,E_B_IPF_C1_27,E_B_IPF_C1_3,E_B_IPF_C1_30,E_B_IPF_C1_32,E_B_IPF_C1_37,E_B_IPF_C1_40,E_B_IPF_C1_41,E_B_IPF_C1_5,E_B_IPF_C1_6,E_B_IPF_C1_7,S3_1_C7_3,G3_C1_19,E3_3_IRF_C1_36,S3_2_C5_35,S3_2_C6_35,E_A_HOS_C1_73,E_B_SNF_C1_25,A_C6_100,A_C1_109,B_1_C21_40,B_1_C21_41,B_1_C21_43,B_1_C22_41,B_1_C22_43,D_3_HOS_C9_40,D_3_HOS_C9_41,D_4_IPF_C11_200,D_4_IPF_C3_200,D_4_IPF_C6_200,D_4_IRF_C11_200,D_4_IRF_C3_200,D_4_IRF_C6_200,E3_2_IPF_C1_10,E3_2_IPF_C1_11,E3_2_IPF_C1_28,E3_2_IPF_C1_3,E3_2_IPF_C1_4,E3_2_IPF_C1_6,E3_2_IPF_C1_8,E3_3_IRF_C1_11,E3_3_IRF_C1_12,E3_3_IRF_C1_29,E3_3_IRF_C1_5,E3_3_IRF_C1_7,E3_3_IRF_C1_9,S3_1_C8_31,S3_1_C9_17,S3_2_C2_36,A_C6_3,D1_HOS_C1_54,D1_HOS_C1_55,D1_HOS_C1_56,D1_HOS_C1_57,D1_HOS_C1_58,D1_HOS_C1_63,E3_1_HOS_C1_1,E3_1_HOS_C1_10,E3_1_HOS_C1_14,E3_1_HOS_C1_15,E3_1_HOS_C1_18,E3_1_HOS_C1_19,E3_1_HOS_C1_20,E3_1_HOS_C1_21,E3_1_HOS_C1_4,E3_1_HOS_C1_6,E3_1_HOS_C1_7,E3_1_HOS_C1_8,E3_1_HOS_C1_9,E3_3_IRF_C1_50,S3_2_C2_8,S3_2_C4_8,S3_2_C5_8,S3_2_C6_8,E3_6_SNF_C1_17,E_B_SNF_C1_42,H4_2_HHA1_C2_16,S3_1_C11_19,G3_C1_9,D3_SNF_C2_30,D_4_HOS_C4_200,D_4_IPF_C4_200,D_4_IRF_C4_200,E_B_IPF_C1_1,E_B_IPF_C1_11,E_B_IPF_C1_12,E_B_IPF_C1_14,E_B_IPF_C1_18,E_B_IPF_C1_19,E_B_IPF_C1_21,E_B_IPF_C1_43,E_B_IRF_C1_1,E_B_IRF_C1_11,E_B_IRF_C1_12,E_B_IRF_C1_14,E_B_IRF_C1_18,E_B_IRF_C1_19,E_B_IRF_C1_2,E_B_IRF_C1_21,E_B_IRF_C1_24,E_B_IRF_C1_26,E_B_IRF_C1_27,E_B_IRF_C1_3,E_B_IRF_C1_30,E_B_IRF_C1_32,E_B_IRF_C1_37,E_B_IRF_C1_40,E_B_IRF_C1_41,E_B_IRF_C1_43,S5_C1_1,S5_C1_10,S5_C1_9,S5_C4_1,D_3_HOS_C9_44,D_4_HOS_C11_74,D_4_HOS_C13_74,D_4_HOS_C2_200,D_4_HOS_C3_74,D_4_IRF_C2_200,D_4_SNF_C11_200,E3_6_SNF_C1_2,E3_6_SNF_C1_3,H3_1_HHA1_C10_16,H4_2_HHA1_C2_10,A8_C2_30,E4_C1_24,S2_1_C6_24,G2_C1_40,D_4_IPF_C1_200,A8_C2_19,E3_4_HOS_C1_6,E4_C1_39,A7_1_C5_1,H4_2_HHA1_C2_23,H4_2_HHA1_C2_33,E2_SWSNF_C1_9,A8_C2_31,H4_2_HHA1_C2_21,H4_2_HHA1_C2_25,A7_1_C3_5,E3_3_HOS_C1_29,E3_3_HOS_C1_34,G2_C1_35,H4_2_HHA1_C1_33,A_C1_4201,A_C2_4201,A_C6_4201,B_1_C0_4201,B_1_C26_4201,B_2_C26_4201,C_1_C5_4201,C_1_C6_4201,E3_4_HOS_C1_20,E3_4_HOS_C1_51,E3_4_HOS_C1_52,E3_4_HOS_C1_53,A8_C2_23,S3_2_C5_37,D3_HOS_C2_40,E4_C2_15,E_A_HOS_C1_16,S3_5_C2_8,A_C1_108,A_C2_108,A_C6_108,A_C6_109,B_1_C0_108,B_1_C21_74,B_1_C26_108,B_2_C26_108,C_1_C5_108,C_1_C6_108,D3_HOS_C2_94,D3_HOS_C3_94,D4_LUNG_C1_69,D_2_HOS_C5_94,D_4_HOS_C11_94,D_4_HOS_C2_74,D_4_HOS_C2_94,D_4_IPF_C2_200,D_4_IRF_C13_200,E3_3_IRF_C1_18,E4_C1_32,E4_C1_34,E4_C1_401,E_A_HOS_C1_801,E_B_IRF_C1_31,E_B_IRF_C1_9,S5_C2_8,B_1_C22_74,S3_2_C2_33,S3_2_C4_33,S3_2_C5_33,S3_2_C6_33,S3_5_C1_8,S3_5_C2_3,C_1_C7_108,E_A_HOS_C1_7,S3_2_C2_2201,S3_2_C4_2201,S3_1_C5_13,E3_6_SNF_C1_19,S3_5_C1_11,S3_5_C2_11,A_C6_94,S5_C1_14,G2_C1_41,H4_2_HHA1_C1_17,E_B_SNF_C1_34,E_B_SNF_C1_35,E_B_SNF_C1_36,E3_2_HOS_C1_15,G2_C1_34,E4_C1_35,E3_2_HOS_C1_28,B_1_C0_61,B_1_C26_61,C_1_C5_61,C_1_C6_61,C_1_C7_61,D3_SNF_C2_74,D3_SNF_C3_74,S5_C4_4,D_5_HOS_C3_94,E3_2_IPF_C1_35,E_B_IPF_C1_25,E_B_IRF_C1_25,G2_C1_25,H4_2_HHA1_C2_30,S3_2_C2_15,S3_2_C4_15,S3_2_C5_15,S3_2_C6_15,E_B_HOS_C1_22,S5_C5_1,S5_C5_2,B_1_C21_44,D_4_IRF_C11_74,D1_HOS_C1_62,E3_1_HOS_C1_2,E3_1_HOS_C1_11,E3_1_HOS_C1_12,E3_1_HOS_C1_13,D_4_IPF_C13_200,E4_C2_16,E_A_HOS_C1_802,E_B_IPF_C1_9,A7_1_C3_1,E_B_SNF_C1_2,E_B_SNF_C1_26,D3_HOS_C2_41,S3_1_C10_18,S3_1_C14_18,S3_1_C7_18,A_C1_110,A_C2_110,B_1_C0_110,B_1_C26_110,B_2_C26_110,C_1_C6_110,B_1_C21_105,B_1_C21_107,B_1_C22_105,B_1_C22_107,L_2_HOS_C1_1,L_2_HOS_C1_2,L_2_HOS_C1_3,L_2_HOS_C1_4,L_2_HOS_C1_5,E3_2_IPF_C1_15,E_A_HOS_C1_56,E_B_IPF_C1_23,S3_2_C2_37,S3_2_C4_37,S3_2_C6_37,H4_2_HHA1_C1_10,E3_2_IPF_C1_33,A_C1_100,E3_3_HOS_C1_50,E_A_HOS_C101_33,E_B_IRF_C1_4,A_C6_110,B_1_C22_106,B_1_C22_108,B_1_C22_109,B_1_C22_110,C_1_C7_110,E_B_IPF_C1_42,E3_5_C1_29,E3_4_HOS_C1_26,E3_6_SNF_C1_6,E3_3_IRF_C1_16,E3_3_IRF_C1_34,E4_C1_402,E_B_IRF_C1_23,E_B_IRF_C1_42,E2_SWSNF_C1_23,E3_5_C1_34,S3_1_C12_16,S3_1_C5_16,E4_C1_16,E_A_HOS_C1_17,S3_2_C3_22,S3_2_C3_23,S3_2_C3_25,D3_SNF_C2_94,D3_SNF_C3_94,D_4_HOS_C3_94,S3_1_C11_21,S3_5_C1_17,E_A_HOS_C1_7098,E_B_HOS_C101_5,E_B_IPF_C1_34,E_B_IPF_C1_35,E_B_IRF_C1_5,E_B_IRF_C1_6,E_A_HOS_C101_1,E_A_HOS_C101_2,E_A_HOS_C101_34,E_A_HOS_C101_47,E_A_HOS_C1_701,E_B_IRF_C1_20,E_B_IRF_C1_7,S3_5_C1_13,S3_5_C2_13,E_B_IPF_C1_8,S3_2_C3_14,H3_1_HHA2_C10_16,H3_1_HHA2_C5_1,H3_1_HHA2_C5_2,H3_1_HHA2_C5_3,H3_1_HHA2_C5_4,H3_1_HHA2_C5_6,H3_1_HHA2_C6_1,H3_1_HHA2_C6_2,H3_1_HHA2_C6_3,H3_1_HHA2_C6_4,H3_1_HHA2_C6_6,H3_1_HHA2_C6_7,H3_1_HHA2_C7_1,H3_1_HHA2_C7_2,H3_1_HHA2_C7_6,H3_1_HHA2_C7_7,H4_2_HHA2_C1_11,H4_2_HHA2_C1_13,H4_2_HHA2_C1_22,H4_2_HHA2_C1_24,H4_2_HHA2_C1_26,H4_2_HHA2_C1_29,H4_2_HHA2_C1_31,H4_2_HHA2_C1_32,H4_2_HHA2_C2_10,H4_2_HHA2_C2_11,H4_2_HHA2_C2_13,H4_2_HHA2_C2_22,H4_2_HHA2_C2_23,H4_2_HHA2_C2_24,H4_2_HHA2_C2_26,H4_2_HHA2_C2_29,H4_2_HHA2_C2_31,H4_2_HHA2_C2_32,S4_HHA2_C1_33,S4_HHA2_C1_35,S4_HHA2_C1_36,S4_HHA2_C1_38,S4_HHA2_C3_33,S4_HHA2_C3_35,S4_HHA2_C3_36,S4_HHA2_C5_33,S4_HHA2_C5_35,S4_HHA2_C5_36,S4_HHA2_C5_38,A7_1_C3_2,E3_3_IRF_C1_14,B_1_C21_45,B_1_C22_45,S3_1_C9_20,S3_5_C1_9,E4_C1_36,E_B_HOS_C1_29,D3_IRF_C2_40,S3_5_C2_17,S3_5_C2_18,E_B_IPF_C1_31,A8_C2_25,A_C6_114,D1_SNF_C1_85,E3_6_SNF_C1_11,A_C1_4501,A_C2_4501,B_1_C0_4501,B_1_C26_4501,B_2_C26_4501,C_1_C5_4501,C_1_C6_4501,S3_1_C10_2001,S3_1_C2_2001,S3_1_C3_2001,S3_1_C8_2001,E_B_IRF_C1_34,E_B_IRF_C1_35,B_1_C21_95,B_1_C22_95,E_A_HOS_C1_51,L_3_HOS_C1_13,L_3_HOS_C1_15,L_3_HOS_C1_16,S3_1_C11_17,E1_2_HOS_C1_30,E1_2_HOS_C1_32,E3_3_HOS_C1_11,E3_3_HOS_C1_12,E3_3_HOS_C1_5,E3_3_HOS_C1_7,E3_3_HOS_C1_9,S3_5_C2_5,B_1_C21_46,B_1_C22_46,S3_1_C9_21,S3_5_C2_14,E_A_HOS_C101_48,D_4_IPF_C11_74,S2_1_C1_11801,S2_1_C2_11801,S2_1_C3_11801,S3_1_C10_23,S5_C2_10,S5_C2_9,L_3_HOS_C1_11,E3_3_HOS_C1_28,E3_3_HOS_C1_30,E3_3_HOS_C1_51,E3_3_HOS_C1_52,E3_3_HOS_C1_53,S3_5_C1_18,S5_C3_1,S5_C3_2,S5_C3_3,S5_C3_6,A7_1_C3_7,C_1_C5_110,S3_1_C7_2001,S3_1_C5_17,H3_1_HHA2_C7_3,H3_1_HHA2_C7_4,H4_2_HHA2_C1_14,H4_2_HHA2_C2_14,H4_2_HHA2_C2_34,S4_HHA2_C3_38,S4_HHA2_C4_33,S4_HHA2_C4_35,S4_HHA2_C4_36,E_B_IPF_C1_36,S3_1_C13_18,A_C6_4501,E4_C1_15,E3_2_IPF_C1_7,D_3_HOS_C3_200,B_1_C21_106,B_1_C21_108,B_1_C21_109,D_4_IRF_C13_74,A_C6_61,A_C1_111,A_C2_111,B_1_C0_111,B_1_C26_111,B_2_C26_111,C_1_C5_111,C_1_C6_111,S3_5_C1_6,S3_5_C2_6,D_5_HOS_C6_94,E_A_HOS_C101_22,E_A_HOS_C101_29,E_A_HOS_C101_3,E3_1_HOS_C1_5,E_B_IPF_C1_22,E_B_IRF_C1_22,D3_IPF_C2_41,E3_3_IRF_C1_30,E3_3_IRF_C1_51,E3_3_IRF_C1_52,E3_3_IRF_C1_53,E_B_IPF_C1_4,S3_5_C2_9,S3_1_C11_16,A_C6_111,B_1_C22_111,D4_ISLET_C1_69,D4_INTESTINE_C1_69,D_4_SNF_C11_74,B_1_C21_42,H3_1_HHA2_C10_15,H3_1_HHA2_C5_5,H3_1_HHA2_C6_5,H3_1_HHA2_C7_5,S4_HHA2_C4_38,H4_2_HHA2_C2_12,H4_2_HHA2_C2_15,H4_2_HHA2_C2_33,S4_HHA2_C2_33,S4_HHA2_C2_35,S4_HHA2_C2_37,S4_HHA2_C5_37,S3_1_C12_17,E_B_IPF_C1_20,E3_2_IPF_C1_29,S3_1_C6_32,E_A_HOS_C1_201,E_A_HOS_C1_69,E_A_HOS_C1_92,E_A_HOS_C1_94,E_A_HOS_C1_95,E_A_HOS_C1_96,E_B_HOS_C1_10,E_B_HOS_C1_13,S10_C1_2701,S3_2_C3_2201,E3_4_HOS_C1_50,E_B_HOS_C1_15,E_B_HOS_C1_16,E_B_HOS_C101_2,D_4_IPF_C13_74,E_B_IPF_C1_38,E_B_IRF_C1_36,G3_C0_2450,S2_1_C2_1202,S2_1_C2_13,S2_1_C2_1510,S2_1_C2_1511,S2_1_C2_1512,S2_1_C2_1513,S2_1_C2_1514,S2_1_C2_1515,S2_1_C2_1516,S2_1_C2_1517,S2_1_C2_1518,S2_1_C2_1519,S2_1_C2_1520,S2_1_C2_1521,S2_1_C2_1522,S2_1_C2_1523,S2_1_C2_1524,S2_1_C2_1601,S2_1_C2_1602,S2_1_C2_1603,S2_1_C2_1604,S2_1_C2_1605,S2_1_C2_1606,S2_1_C2_1607,S2_1_C2_1608,S2_1_C1_3601,S2_1_C2_3601,S2_1_C1_3801,S2_1_C2_3801,S2_1_C2_130,S2_1_C2_132,S2_1_C1_1,S2_1_C1_2,S2_1_C3_2,S2_1_C4_2,S2_1_C1_3,S2_1_C3_3,S2_1_C7_3,S2_1_C1_21,S2_1_C1_22,S2_1_C1_47,S2_1_C1_48,S2_1_C1_56,S2_1_C1_60,S2_1_C1_85,S2_1_C1_86,S2_1_C1_93,S2_1_C1_105,S2_1_C1_106,S2_1_C1_107,S2_1_C1_108,S2_1_C1_115,S2_1_C1_116,S2_1_C1_125,S2_1_C1_140,S2_1_C1_144,S2_1_C1_145,S2_1_C1_4,S2_1_C2_4,S2_1_C2_140,S2_1_C1_141,S2_1_C1_142,S2_1_C1_143,S2_1_C2_143,S2_1_C3_143,S2_1_C2_115,S10_C1_3,S2_1_C2_1,S2_1_C2_10,S10_C1_4,S10_C1_24,S2_1_C2_7,S2_1_C1_38,S2_1_C2_38,S2_1_C1_5,S2_1_C2_5,S2_1_C2_9,S2_1_C2_12,S2_1_C2_14,S2_1_C1_36,S2_1_C2_36,S2_1_C1_126,S2_1_C2_8,S2_1_C2_15,S2_1_C2_1501,S2_1_C2_107,S2_1_C2_142,S2_1_C2_18,S2_1_C2_1502,S2_1_C2_1503,S2_1_C2_1504,S5_C1_21,S2_1_C1_127,S2_1_C1_128,S2_1_C2_1801,S2_1_C2_1401,S5_C2_21,S2_1_C1_129,S2_1_C1_134,S2_1_C2_17,S2_1_C1_131,S2_1_C2_1505,S2_1_C2_1506,S2_1_C2_1507,S2_1_C2_1508,S2_1_C2_1509,S2_1_C2_1802,S2_1_C2_1803,S2_1_C2_1804,S2_1_C2_1201,S2_1_C2_126,S2_1_C2_127,S2_1_C2_128,S2_1_C2_1805,S2_1_C2_16,S2_1_C2_1001,S2_1_C2_1806,S2_1_C2_1807,S2_1_C2_1808,S2_1_C2_1809,S2_1_C1_132,S2_1_C2_129,A_C1_6250,A_C2_6250,B_1_C0_6250,B_1_C21_101,B_1_C21_115,B_1_C21_116,B_1_C21_89,B_1_C21_99,B_1_C22_101,B_1_C22_115,B_1_C22_116,B_1_C22_89,B_1_C22_99,B_1_C26_6250,B_2_C26_6250,C_1_C2_65,C_1_C2_67,C_1_C2_68,C_1_C5_6250,C_1_C6_9920,C_1_C6_9930,C_1_C6_9940,C_1_C7_6250,C_1_C7_89,D3_HOS_C3_6250,D3_SNF_C2_32,D3_SNF_C2_34,D3_SNF_C2_35,D3_SNF_C2_96,D3_SNF_C3_96,D_2_HOS_C5_6250,D_4_HOS_C12_6250,D_4_HOS_C1_73,D_4_HOS_C1_76,D_4_HOS_C1_91,D_4_HOS_C2_56,D_4_HOS_C2_62,D_4_HOS_C2_67,D_4_HOS_C2_68,D_4_HOS_C2_71,D_4_HOS_C2_72,D_4_HOS_C3_6250,D_4_HOS_C3_88,D_4_HOS_C3_89,D_4_HOS_C3_98,D_4_HOS_C4_52,D_4_HOS_C4_53,D_4_HOS_C4_55,D_4_HOS_C4_56,D_4_HOS_C4_59,D_4_HOS_C4_60,D_4_HOS_C4_64,D_4_HOS_C4_66,D_4_HOS_C4_67,D_4_HOS_C4_68,D_4_HOS_C4_69,D_4_HOS_C4_70,D_4_HOS_C4_71,D_4_HOS_C4_72,D_4_HOS_C4_73,D_4_HOS_C4_76,D_4_HOS_C4_88,D_4_HOS_C4_89,D_4_HOS_C4_93,D_4_IPF_C11_71,D_4_IPF_C13_51,D_4_IPF_C13_55,D_4_IPF_C13_56,D_4_IPF_C13_58,D_4_IPF_C13_59,D_4_IPF_C13_62,D_4_IPF_C13_63,D_4_IPF_C13_64,D_4_IPF_C13_65,D_4_IPF_C13_66,D_4_IPF_C13_67,D_4_IPF_C13_68,D_4_IPF_C13_75,D_4_IPF_C13_76,D_4_IPF_C13_9201,D_4_IPF_C13_93,D_4_IRF_C13_51,D_4_IRF_C13_53,D_4_IRF_C13_55,D_4_IRF_C13_57,D_4_IRF_C13_58,D_4_IRF_C13_59,D_4_IRF_C13_62,D_4_IRF_C13_63,D_4_IRF_C13_66,D_4_IRF_C13_68,D_4_IRF_C13_70,D_4_IRF_C13_71,D_4_IRF_C13_72,D_4_IRF_C13_75,D_4_IRF_C13_76,D_4_SNF_C11_52,D_4_SNF_C11_58,D_4_SNF_C11_62,D_4_SNF_C11_64,D_4_SNF_C11_69,D_4_SNF_C11_72,D_4_SNF_C11_75,D_4_SNF_C11_9201,D_4_SNF_C13_73,D_5_HOS_C2_6250,D_5_HOS_C3_6250,D_5_HOS_C4_96,D_5_HOS_C4_98,D_5_HOS_C5_6250,D_5_HOS_C6_6250,D_5_HOS_C7_96,D_5_HOS_C7_98,E_B_SNF_C1_39,S3_1_C11_25,S3_1_C4_10,S3_1_C4_11,S3_1_C5_22,S3_1_C5_26,S3_1_C6_25,S3_1_C7_25,S3_1_C8_25,S3_1_C9_22,A7_3_C10_1,A7_3_C10_2,A7_3_C15_1,A7_3_C15_2,A7_3_C9_1,A7_3_C9_2,A8_C2_33,A_C1_15,A_C1_16,A_C1_17,A_C1_5,A_C1_65,A_C1_66,A_C1_67,A_C1_69,A_C1_9,A_C2_1,A_C2_10,A_C2_15,A_C2_16,A_C2_17,A_C2_2,A_C2_4,A_C2_5,A_C2_50,A_C2_51,A_C2_53,A_C2_54,A_C2_55,A_C2_60,A_C2_63,A_C2_65,A_C2_66,A_C2_67,A_C2_68,A_C2_69,A_C2_7,A_C2_70,A_C2_71,A_C2_73,A_C2_9,A_C6_15,A_C6_16,A_C6_17,A_C6_5,B_1_C0_1,B_1_C0_10,B_1_C0_15,B_1_C0_16,B_1_C0_17,B_1_C0_2,B_1_C0_4,B_1_C0_5,B_1_C0_50,B_1_C0_51,B_1_C0_53,B_1_C0_54,B_1_C0_55,B_1_C0_57,B_1_C0_58,B_1_C0_60,B_1_C0_63,B_1_C0_64,B_1_C0_65,B_1_C0_66,B_1_C0_67,B_1_C0_68,B_1_C0_69,B_1_C0_7,B_1_C0_70,B_1_C0_71,B_1_C0_72,B_1_C0_73,B_1_C0_9,B_1_C0_90,B_1_C0_91,B_1_C26_50,B_1_C26_51,B_1_C26_53,B_1_C26_54,B_1_C26_55,B_1_C26_57,B_1_C26_58,B_1_C26_60,B_1_C26_63,B_1_C26_64,B_1_C26_65,B_1_C26_66,B_1_C26_67,B_1_C26_68,B_1_C26_69,B_1_C26_70,B_1_C26_71,B_1_C26_72,B_1_C26_73,B_1_C26_90,B_1_C26_91,B_2_C26_50,B_2_C26_51,B_2_C26_53,B_2_C26_54,B_2_C26_55,B_2_C26_57,B_2_C26_58,B_2_C26_60,B_2_C26_63,B_2_C26_64,B_2_C26_65,B_2_C26_66,B_2_C26_67,B_2_C26_68,B_2_C26_69,B_2_C26_70,B_2_C26_71,B_2_C26_72,B_2_C26_73,B_2_C26_90,B_2_C26_91,C_1_C5_50,C_1_C5_51,C_1_C5_53,C_1_C5_54,C_1_C5_55,C_1_C5_57,C_1_C5_58,C_1_C5_60,C_1_C5_63,C_1_C5_64,C_1_C5_65,C_1_C5_66,C_1_C5_67,C_1_C5_68,C_1_C5_69,C_1_C5_70,C_1_C5_71,C_1_C5_72,C_1_C5_73,C_1_C5_90,C_1_C5_91,C_1_C6_50,C_1_C6_51,C_1_C6_53,C_1_C6_54,C_1_C6_55,C_1_C6_57,C_1_C6_58,C_1_C6_60,C_1_C6_63,C_1_C6_64,C_1_C6_65,C_1_C6_66,C_1_C6_67,C_1_C6_68,C_1_C6_69,C_1_C6_70,C_1_C6_71,C_1_C6_72,C_1_C6_73,C_1_C6_90,C_1_C6_91,D3_HOS_C2_50,D3_HOS_C2_51,D3_HOS_C2_53,D3_HOS_C2_54,D3_HOS_C2_55,D3_HOS_C2_57,D3_HOS_C2_58,D3_HOS_C2_60,D3_HOS_C2_63,D3_HOS_C2_64,D3_HOS_C2_65,D3_HOS_C2_66,D3_HOS_C2_67,D3_HOS_C2_68,D3_HOS_C2_69,D3_HOS_C2_70,D3_HOS_C2_71,D3_HOS_C2_72,D3_HOS_C2_73,D3_HOS_C2_90,D3_HOS_C2_91,D3_HOS_C3_50,D3_HOS_C3_51,D3_HOS_C3_53,D3_HOS_C3_54,D3_HOS_C3_55,D3_HOS_C3_57,D3_HOS_C3_58,D3_HOS_C3_60,D3_HOS_C3_63,D3_HOS_C3_64,D3_HOS_C3_65,D3_HOS_C3_66,D3_HOS_C3_67,D3_HOS_C3_68,D3_HOS_C3_69,D3_HOS_C3_70,D3_HOS_C3_71,D3_HOS_C3_72,D3_HOS_C3_73,D3_HOS_C3_90,D3_HOS_C3_91,D_2_HOS_C5_50,D_2_HOS_C5_51,D_2_HOS_C5_53,D_2_HOS_C5_54,D_2_HOS_C5_55,D_2_HOS_C5_57,D_2_HOS_C5_58,D_2_HOS_C5_60,D_2_HOS_C5_63,D_2_HOS_C5_64,D_2_HOS_C5_65,D_2_HOS_C5_66,D_2_HOS_C5_67,D_2_HOS_C5_68,D_2_HOS_C5_69,D_2_HOS_C5_70,D_2_HOS_C5_71,D_2_HOS_C5_72,D_2_HOS_C5_73,D_2_HOS_C5_90,D_2_HOS_C5_91,D_4_HOS_C10_50,D_4_HOS_C10_51,D_4_HOS_C10_53,D_4_HOS_C10_54,D_4_HOS_C10_55,D_4_HOS_C10_57,D_4_HOS_C10_58,D_4_HOS_C10_60,D_4_HOS_C10_63,D_4_HOS_C10_64,D_4_HOS_C10_65,D_4_HOS_C10_66,D_4_HOS_C10_67,D_4_HOS_C10_68,D_4_HOS_C10_69,D_4_HOS_C10_70,D_4_HOS_C10_71,D_4_HOS_C10_72,D_4_HOS_C10_73,D_4_HOS_C10_90,D_4_HOS_C10_91,G3_C1_24,G_C1THRU4_1,G_C1THRU4_11,G_C1THRU4_17,G_C1THRU4_18,G_C1THRU4_19,G_C1THRU4_2,G_C1THRU4_20,G_C1THRU4_23,G_C1THRU4_24,G_C1THRU4_30,G_C1THRU4_31,G_C1THRU4_35,G_C1THRU4_36,G_C1THRU4_37,G_C1THRU4_38,G_C1THRU4_4,G_C1THRU4_44,G_C1THRU4_45,G_C1THRU4_5,G_C1THRU4_51,G_C1THRU4_52,G_C1THRU4_59,G_C1THRU4_6,G_C1THRU4_60,G_C1THRU4_7,G_C1THRU4_8,A7_3_C11_1,A7_3_C7_1,A7_3_C7_2,A_C1_10,A_C1_13,A_C1_18,A_C1_194,A_C1_7,A_C1_90,A_C2_13,A_C2_18,A_C2_194,A_C2_8,A_C2_90,A_C6_1,A_C6_11,A_C6_194,A_C6_90,B_1_C0_11,B_1_C0_13,B_1_C0_18,B_1_C0_194,B_1_C0_8,B_1_C26_190,B_1_C26_194,B_2_C26_190,B_2_C26_194,C_1_C7_90,G_C1THRU4_12,G_C1THRU4_15,G_C1THRU4_16,G_C1THRU4_21,G_C1THRU4_34,G_C1THRU4_46,G_C1THRU4_47,G_C1THRU4_50,A_C1_98,A_C2_14,A_C2_6,A_C2_98,A_C6_2,A_C6_4,A_C6_98,B_1_C0_14,B_1_C0_6,B_1_C0_98,B_1_C26_98,B_2_C26_98,C_1_C5_98,C_1_C7_98,D_4_HOS_C12_73,D_4_HOS_C12_98,D_5_HOS_C2_73,D_5_HOS_C2_98,D_5_HOS_C5_73,D_5_HOS_C5_98,G_C1THRU4_10,G_C1THRU4_33,G_C1THRU4_40,A_C1_4,A_C1_54,A_C1_6,A_C1_60,A_C1_8,A_C6_7,B_1_C26_193,B_2_C26_193,A_C6_10,B_1_C26_191,B_2_C26_191,D_4_HOS_C12_90,D_5_HOS_C2_90,D_5_HOS_C5_90,A_C2_191,A_C6_6,B_1_C0_191,B_1_C0_21,B_1_C21_21,B_1_C21_90,B_1_C22_90,A_C1_50,A_C1_52,A_C2_52,A_C6_13,A_C6_14,A_C6_52,A_C6_8,A_C6_9,B_1_C0_52,B_1_C26_52,B_2_C26_52,C_1_C5_52,C_1_C6_52,C_1_C7_50,C_1_C7_52,C_1_C7_54,C_1_C7_60,C_1_C7_71,C_1_C7_73,D_4_HOS_C12_50,D_5_HOS_C2_50,D_5_HOS_C5_50,G_C1THRU4_13,G_C1THRU4_14,G_C1THRU4_9,A_C1_68,A_C1_73,A_C2_57,A_C2_58,A_C6_66,A_C6_67,A_C6_68,A_C6_69,A_C6_73,C_1_C7_65,C_1_C7_69,D_4_HOS_C12_54,D_4_HOS_C12_60,D_4_HOS_C12_65,D_4_HOS_C12_69,D_5_HOS_C2_54,D_5_HOS_C2_60,D_5_HOS_C2_65,D_5_HOS_C2_69,D_5_HOS_C5_54,D_5_HOS_C5_60,D_5_HOS_C5_65,D_5_HOS_C5_69,G_C1THRU4_39,G_C1THRU4_43,A7_3_C5_1,A7_3_C5_2,A_C1_76,A_C2_76,A_C6_54,B_1_C0_76,B_1_C26_76,B_2_C26_76,C_1_C5_76,G2_C1_27,A7_3_C6_1,A7_3_C6_2,A_C1_14,A_C1_31,A_C2_31,A_C6_50,A_C6_60,A_C6_65,B_1_C0_31,B_1_C26_31,B_2_C26_31,C_1_C5_31,C_1_C6_31,C_1_C7_66,D1_HOS_C5_43,D3_HOS_C2_31,D_1_HOS_C4_31,D_1_HOS_C6_31,D_1_HOS_C7_31,D_5_HOS_C3_54,D_5_HOS_C3_65,D_5_HOS_C6_54,D_5_HOS_C6_65,G2_C1_11,G_C1THRU4_49,S3_1_C2_8,S3_1_C3_8,S3_1_C6_8,S3_1_C8_8,A_C1_190,A_C1_32,A_C1_34,A_C1_51,A_C1_53,A_C1_56,A_C1_57,A_C1_58,A_C1_59,A_C1_64,A_C1_70,A_C1_91,A_C2_190,A_C2_32,A_C2_34,A_C2_56,A_C2_59,A_C2_64,A_C2_91,A_C6_19,A_C6_57,A_C6_59,A_C6_70,A_C6_91,B_1_C0_190,B_1_C0_23,B_1_C0_32,B_1_C0_34,B_1_C0_56,B_1_C0_59,B_1_C26_192,B_1_C26_32,B_1_C26_34,B_1_C26_56,B_1_C26_59,B_2_C26_192,B_2_C26_32,B_2_C26_34,B_2_C26_56,B_2_C26_59,C_1_C5_32,C_1_C5_34,C_1_C5_56,C_1_C5_59,C_1_C6_32,C_1_C6_34,C_1_C6_56,C_1_C6_59,C_1_C7_51,C_1_C7_53,C_1_C7_56,C_1_C7_57,C_1_C7_58,C_1_C7_59,C_1_C7_64,C_1_C7_70,C_1_C7_72,C_1_C7_91,D3_HOS_C2_32,D3_HOS_C2_34,D3_HOS_C2_52,D3_HOS_C2_56,D3_HOS_C2_59,D3_HOS_C3_52,D3_HOS_C3_56,D3_HOS_C3_59,D_1_HOS_C4_32,D_1_HOS_C4_34,D_1_HOS_C6_32,D_1_HOS_C6_34,D_1_HOS_C7_32,D_1_HOS_C7_34,D_2_HOS_C5_52,D_2_HOS_C5_56,D_2_HOS_C5_59,D_4_HOS_C10_52,D_4_HOS_C10_56,D_4_HOS_C10_59,D_4_HOS_C11_50,D_4_HOS_C12_51,D_4_HOS_C12_52,D_4_HOS_C12_53,D_4_HOS_C12_56,D_4_HOS_C12_57,D_4_HOS_C12_58,D_4_HOS_C12_59,D_4_HOS_C12_64,D_4_HOS_C12_66,D_4_HOS_C12_70,D_4_HOS_C12_71,D_4_HOS_C12_72,D_4_HOS_C12_91,D_4_HOS_C13_50,D_4_HOS_C3_50,D_5_HOS_C2_51,D_5_HOS_C2_52,D_5_HOS_C2_53,D_5_HOS_C2_56,D_5_HOS_C2_57,D_5_HOS_C2_58,D_5_HOS_C2_59,D_5_HOS_C2_64,D_5_HOS_C2_66,D_5_HOS_C2_70,D_5_HOS_C2_71,D_5_HOS_C2_72,D_5_HOS_C2_91,D_5_HOS_C3_73,D_5_HOS_C4_60,D_5_HOS_C4_72,D_5_HOS_C4_73,D_5_HOS_C5_51,D_5_HOS_C5_52,D_5_HOS_C5_53,D_5_HOS_C5_56,D_5_HOS_C5_57,D_5_HOS_C5_58,D_5_HOS_C5_59,D_5_HOS_C5_64,D_5_HOS_C5_66,D_5_HOS_C5_70,D_5_HOS_C5_71,D_5_HOS_C5_72,D_5_HOS_C5_91,D_5_HOS_C6_73,D_5_HOS_C7_60,D_5_HOS_C7_72,D_5_HOS_C7_73,G2_C1_12,G2_C1_14,G_C1THRU4_22,G_C1THRU4_25,G_C1THRU4_26,S3_1_C2_11,S3_1_C2_9,S3_1_C3_11,S3_1_C3_9,S3_1_C6_11,S3_1_C6_9,S3_1_C7_11,S3_1_C7_8,S3_1_C7_9,S3_1_C8_11,S3_1_C8_9,A_C1_71,A_C6_71,B_1_C0_192,C_1_C6_76,C_1_C7_67,C_1_C7_68,C_1_C7_76,D3_HOS_C2_76,D3_HOS_C3_76,D_2_HOS_C5_76,D_4_HOS_C10_76,D_4_HOS_C12_76,D_5_HOS_C2_76,D_5_HOS_C5_76,A_C2_62,A_C6_53,A_C6_62,B_1_C0_62,B_1_C26_62,B_2_C26_62,C_1_C5_62,C_1_C6_62,C_1_C7_62,D3_HOS_C2_62,D3_HOS_C3_62,D_2_HOS_C5_62,D_4_HOS_C10_62,D_4_HOS_C12_62,D_5_HOS_C2_62,D_5_HOS_C4_54,D_5_HOS_C5_62,D_5_HOS_C7_54,E_A_HOS_C1_70,G2_C2_27,A_C1_101,A_C1_192,A_C2_192,A_C2_22,A_C6_31,B_1_C0_22,D3_IPF_C2_50,D3_IPF_C2_51,D3_IPF_C2_53,D3_IPF_C2_54,D3_IPF_C2_56,D3_IPF_C2_60,D3_IPF_C2_65,D3_IPF_C2_66,D3_IPF_C2_67,D3_IPF_C2_68,D3_IPF_C2_69,D3_IPF_C2_71,D3_IPF_C2_72,D3_IPF_C2_73,D3_IPF_C2_91,D3_IPF_C3_50,D3_IPF_C3_51,D3_IPF_C3_53,D3_IPF_C3_54,D3_IPF_C3_56,D3_IPF_C3_60,D3_IPF_C3_65,D3_IPF_C3_66,D3_IPF_C3_67,D3_IPF_C3_68,D3_IPF_C3_69,D3_IPF_C3_71,D3_IPF_C3_72,D3_IPF_C3_73,D3_IPF_C3_91,D3_IRF_C2_50,D3_IRF_C2_51,D3_IRF_C2_53,D3_IRF_C2_54,D3_IRF_C2_56,D3_IRF_C2_60,D3_IRF_C2_65,D3_IRF_C2_66,D3_IRF_C2_67,D3_IRF_C2_68,D3_IRF_C2_69,D3_IRF_C2_71,D3_IRF_C2_72,D3_IRF_C2_73,D3_IRF_C2_90,D3_IRF_C3_50,D3_IRF_C3_51,D3_IRF_C3_53,D3_IRF_C3_54,D3_IRF_C3_56,D3_IRF_C3_60,D3_IRF_C3_65,D3_IRF_C3_66,D3_IRF_C3_67,D3_IRF_C3_68,D3_IRF_C3_69,D3_IRF_C3_71,D3_IRF_C3_72,D3_IRF_C3_73,D3_IRF_C3_90,D_2_IPF_C5_50,D_2_IPF_C5_51,D_2_IPF_C5_53,D_2_IPF_C5_54,D_2_IPF_C5_56,D_2_IPF_C5_60,D_2_IPF_C5_65,D_2_IPF_C5_66,D_2_IPF_C5_67,D_2_IPF_C5_68,D_2_IPF_C5_69,D_2_IPF_C5_71,D_2_IPF_C5_72,D_2_IPF_C5_73,D_2_IPF_C5_91,D_2_IRF_C5_50,D_2_IRF_C5_51,D_2_IRF_C5_53,D_2_IRF_C5_54,D_2_IRF_C5_56,D_2_IRF_C5_60,D_2_IRF_C5_65,D_2_IRF_C5_66,D_2_IRF_C5_67,D_2_IRF_C5_68,D_2_IRF_C5_69,D_2_IRF_C5_71,D_2_IRF_C5_72,D_2_IRF_C5_73,D_2_IRF_C5_90,D_4_HOS_C12_67,D_5_HOS_C2_67,D_5_HOS_C5_67,G2_C2_22,A_C1_116,A_C2_101,A_C2_116,B_1_C0_101,B_1_C0_116,B_1_C26_101,B_1_C26_116,B_2_C26_101,B_2_C26_116,C_1_C5_101,C_1_C5_116,D3_SNF_C2_54,D3_SNF_C2_60,D3_SNF_C2_66,D3_SNF_C2_67,D3_SNF_C2_68,D3_SNF_C2_71,D3_SNF_C2_73,D3_SNF_C3_54,D3_SNF_C3_60,D3_SNF_C3_66,D3_SNF_C3_67,D3_SNF_C3_68,D3_SNF_C3_71,D3_SNF_C3_73,S3_1_C10_22,S3_1_C10_24,S3_1_C8_22,A7_3_C11_2,A_C1_23,A_C1_35,A_C1_55,A_C1_75,A_C2_23,A_C2_35,A_C2_75,A_C6_22,A_C6_23,A_C6_35,A_C6_55,A_C6_56,A_C6_75,B_1_C0_35,B_1_C0_75,B_1_C22_31,B_1_C22_50,B_1_C22_60,B_1_C26_35,B_1_C26_75,B_2_C26_35,B_2_C26_75,C_1_C5_35,C_1_C5_75,C_1_C6_35,C_1_C6_75,C_1_C7_55,C_1_C7_75,D3_HOS_C2_75,D3_HOS_C3_75,D3_IPF_C2_57,D3_IPF_C2_58,D3_IPF_C2_90,D3_IPF_C3_57,D3_IPF_C3_58,D3_IPF_C3_90,D3_IRF_C2_55,D3_IRF_C2_57,D3_IRF_C2_58,D3_IRF_C2_70,D3_IRF_C2_75,D3_IRF_C2_91,D3_IRF_C3_55,D3_IRF_C3_57,D3_IRF_C3_58,D3_IRF_C3_70,D3_IRF_C3_75,D3_IRF_C3_91,D_1_HOS_C4_35,D_2_HOS_C5_75,D_2_IPF_C5_57,D_2_IPF_C5_58,D_2_IPF_C5_90,D_2_IRF_C5_55,D_2_IRF_C5_57,D_2_IRF_C5_58,D_2_IRF_C5_70,D_2_IRF_C5_75,D_2_IRF_C5_91,D_3_HOS_C9_31,D_4_HOS_C10_75,D_4_HOS_C12_55,D_4_HOS_C12_75,D_5_HOS_C2_55,D_5_HOS_C2_75,D_5_HOS_C3_72,D_5_HOS_C3_91,D_5_HOS_C5_55,D_5_HOS_C5_75,D_5_HOS_C6_72,D_5_HOS_C6_91,G2_C1_15,G_C1THRU4_29,S3_1_C2_12,S3_1_C3_12,S3_1_C7_12,S3_1_C8_12,D_5_HOS_C3_60,D_5_HOS_C6_60,A_C6_192,S3_1_C6_22,A_C1_62,A_C1_97,A_C2_97,B_1_C0_97,B_1_C26_97,B_2_C26_97,C_1_C5_97,C_1_C7_97,D3_SNF_C2_62,D3_SNF_C2_69,D3_SNF_C3_62,D3_SNF_C3_69,A_C1_88,A_C1_93,A_C2_88,A_C2_93,A_C6_88,A_C6_93,B_1_C0_88,B_1_C0_93,B_1_C26_88,B_1_C26_93,B_2_C26_88,B_2_C26_93,C_1_C7_88,C_1_C7_93,D_5_HOS_C3_50,D_5_HOS_C3_66,D_5_HOS_C3_68,D_5_HOS_C3_69,D_5_HOS_C3_71,D_5_HOS_C3_93,D_5_HOS_C6_50,D_5_HOS_C6_66,D_5_HOS_C6_68,D_5_HOS_C6_69,D_5_HOS_C6_71,D_5_HOS_C6_93,G2_C2_20,S3_1_C10_26,S3_1_C6_26,S3_1_C7_26,S3_1_C8_26,A_C1_19,A_C2_19,A_C2_72,B_1_C0_19,C_1_C5_88,C_1_C6_88,D3_SNF_C2_65,D3_SNF_C2_90,D3_SNF_C2_91,D3_SNF_C3_65,D3_SNF_C3_90,D3_SNF_C3_91,D_4_HOS_C11_53,D_4_HOS_C1_53,D_5_HOS_C3_53,D_5_HOS_C3_90,D_5_HOS_C6_53,D_5_HOS_C6_90,G2_C1_20,G_C1THRU4_42,A_C1_9201,A_C2_9201,B_1_C0_9201,B_1_C26_9201,B_2_C26_9201,C_1_C5_9201,C_1_C6_9201,C_1_C7_9201,D3_HOS_C2_9201,D3_HOS_C3_9201,D_2_HOS_C5_9201,D_4_HOS_C10_9201,D_4_HOS_C12_9201,D_5_HOS_C2_9201,D_5_HOS_C5_9201,G_C1THRU4_41,A_C6_101,C_1_C7_101,A_C6_76,S3_1_C7_22,C_1_C7_63,D_4_HOS_C12_63,D_5_HOS_C2_63,D_5_HOS_C5_63,A_C2_193,B_1_C0_193,E_B_HOS_C1_39,A_C6_190,A_C6_58,C_1_C5_93,A_C6_18,D_5_HOS_C3_67,D_5_HOS_C6_67,A_C1_191,C_1_C6_116,C_1_C7_116,D_5_HOS_C3_51,D_5_HOS_C3_63,D_5_HOS_C6_51,D_5_HOS_C6_63,G2_C1_26,G2_C2_26,S3_1_C4_8,A_C1_21,A_C1_63,A_C2_21,A_C6_21,A_C6_51,A_C6_63,A_C6_64,B_1_C21_194,B_1_C21_31,B_1_C21_50,B_1_C21_51,B_1_C21_52,B_1_C21_53,B_1_C21_54,B_1_C21_55,B_1_C21_56,B_1_C21_57,B_1_C21_58,B_1_C21_59,B_1_C21_60,B_1_C21_63,B_1_C21_65,B_1_C21_69,B_1_C21_70,B_1_C21_91,B_1_C22_194,B_1_C22_51,B_1_C22_52,B_1_C22_53,B_1_C22_54,B_1_C22_55,B_1_C22_56,B_1_C22_57,B_1_C22_58,B_1_C22_59,B_1_C22_63,B_1_C22_65,B_1_C22_69,B_1_C22_70,B_1_C22_91,D_4_HOS_C11_51,D_4_HOS_C11_52,D_4_HOS_C11_54,D_4_HOS_C11_55,D_4_HOS_C11_57,D_4_HOS_C11_58,D_4_HOS_C11_59,D_4_HOS_C11_60,D_4_HOS_C11_64,D_4_HOS_C11_70,D_4_HOS_C11_73,D_4_HOS_C11_90,D_4_HOS_C11_91,D_4_HOS_C13_51,D_4_HOS_C13_52,D_4_HOS_C13_53,D_4_HOS_C13_54,D_4_HOS_C13_55,D_4_HOS_C13_57,D_4_HOS_C13_58,D_4_HOS_C13_59,D_4_HOS_C13_60,D_4_HOS_C13_64,D_4_HOS_C13_73,D_4_HOS_C13_90,D_4_HOS_C13_91,D_4_HOS_C3_51,D_4_HOS_C3_52,D_4_HOS_C3_53,D_4_HOS_C3_54,D_4_HOS_C3_55,D_4_HOS_C3_57,D_4_HOS_C3_58,D_4_HOS_C3_59,D_4_HOS_C3_60,D_4_HOS_C3_64,D_4_HOS_C3_70,D_4_HOS_C3_73,D_4_HOS_C3_90,D_4_HOS_C3_91,D_5_HOS_C3_52,D_5_HOS_C3_55,D_5_HOS_C3_56,D_5_HOS_C3_57,D_5_HOS_C3_58,D_5_HOS_C3_59,D_5_HOS_C3_64,D_5_HOS_C3_70,D_5_HOS_C6_52,D_5_HOS_C6_55,D_5_HOS_C6_56,D_5_HOS_C6_57,D_5_HOS_C6_58,D_5_HOS_C6_59,D_5_HOS_C6_64,D_5_HOS_C6_70,G2_C2_21,G_C1THRU4_27,G_C1THRU4_28,S3_1_C6_24,S3_1_C7_24,S3_1_C8_24,B_1_C26_117,B_2_C26_117,C_1_C5_117,G_C1THRU4_54,G_C1THRU4_58,D_5_HOS_C3_62,D_5_HOS_C6_62,D_5_HOS_C3_76,D_5_HOS_C4_91,D_5_HOS_C6_76,D_5_HOS_C7_91,A_C2_12,A_C6_12,B_1_C0_12,A_C1_193,A_C1_33,A_C2_33,B_1_C0_33,B_1_C26_33,B_2_C26_33,C_1_C5_33,C_1_C6_33,D3_HOS_C2_33,D_1_HOS_C4_33,D_1_HOS_C6_33,D_1_HOS_C7_33,G2_C1_13,S3_1_C2_10,S3_1_C3_10,S3_1_C6_10,S3_1_C8_10,A_C6_116,S3_1_C2_24,D_5_HOS_C3_75,D_5_HOS_C6_75,D3_IPF_C2_55,D3_IPF_C2_59,D3_IPF_C2_63,D3_IPF_C2_64,D3_IPF_C2_76,D3_IPF_C3_55,D3_IPF_C3_59,D3_IPF_C3_63,D3_IPF_C3_64,D3_IPF_C3_76,D_2_IPF_C5_55,D_2_IPF_C5_59,D_2_IPF_C5_63,D_2_IPF_C5_64,D_2_IPF_C5_76,D_5_HOS_C4_55,D_5_HOS_C4_57,D_5_HOS_C4_58,D_5_HOS_C4_64,D_5_HOS_C4_69,D_5_HOS_C4_90,D_5_HOS_C7_55,D_5_HOS_C7_57,D_5_HOS_C7_58,D_5_HOS_C7_64,D_5_HOS_C7_69,D_5_HOS_C7_90,D_5_HOS_C4_53,D_5_HOS_C7_53,A_C1_96,A_C2_96,B_1_C0_96,B_1_C26_96,B_2_C26_96,C_1_C6_98,C_1_C7_96,D_5_HOS_C3_98,D_5_HOS_C6_98,G_C1THRU4_3,G_C1THRU4_53,G_C1THRU4_32,A_C2_117,A_C1_11,A_C1_112,A_C2_11,A_C2_112,A_C6_112,A_C6_191,A_C6_32,B_1_C0_112,B_1_C21_191,B_1_C21_32,B_1_C21_34,B_1_C21_35,B_1_C21_66,B_1_C21_75,B_1_C22_191,B_1_C22_32,B_1_C22_34,B_1_C22_35,B_1_C22_66,B_1_C22_75,B_1_C26_112,B_2_C26_112,C_1_C5_112,C_1_C6_112,C_1_C7_112,D1_HOS_C5_44,D3_IPF_C2_52,D3_IPF_C2_70,D3_IPF_C3_52,D3_IPF_C3_70,D3_IRF_C2_59,D3_IRF_C2_63,D3_IRF_C2_76,D3_IRF_C3_59,D3_IRF_C3_63,D3_IRF_C3_76,D_2_IPF_C5_52,D_2_IPF_C5_70,D_2_IRF_C5_59,D_2_IRF_C5_63,D_2_IRF_C5_76,D_3_HOS_C9_32,D_3_HOS_C9_34,D_4_HOS_C11_75,D_4_HOS_C12_68,D_4_HOS_C13_75,D_4_HOS_C3_75,D_4_IPF_C11_50,D_4_IPF_C11_91,D_4_IRF_C11_50,D_4_IRF_C11_55,D_5_HOS_C2_68,D_5_HOS_C5_68,A_C1_22,C_1_C6_97,D_4_HOS_C12_97,D_5_HOS_C2_97,D_5_HOS_C5_97,D_5_HOS_C4_59,D_5_HOS_C7_59,S3_1_C11_22,S3_1_C11_24,S3_1_C11_26,B_1_C21_93,D_4_HOS_C12_93,D_4_HOS_C4_54,D_4_HOS_C4_57,D_4_HOS_C4_58,D_4_IPF_C11_54,D_4_IPF_C11_57,D_4_IPF_C11_58,D_4_IRF_C11_54,D_4_IRF_C11_57,D_4_IRF_C11_58,D_5_HOS_C2_93,D_5_HOS_C4_71,D_5_HOS_C5_93,D_5_HOS_C7_71,S3_1_C3_24,A_C2_20,B_1_C0_20,B_1_C26_89,B_2_C26_89,C_1_C5_89,C_1_C6_101,D3_SNF_C2_72,D3_SNF_C3_72,D_4_HOS_C2_50,D_4_HOS_C2_52,D_4_HOS_C2_91,D_4_IRF_C11_91,D_4_SNF_C11_54,D3_IPF_C2_62,D3_IPF_C3_62,D_2_IPF_C5_62,C_1_C6_93,D3_HOS_C2_93,D3_HOS_C3_93,D_2_HOS_C5_93,D_4_HOS_C10_93,B_1_C0_117,C_1_C6_117,A_C1_117,A_C6_117,A_C6_193,G2_C1_21,D3_SNF_C2_63,D3_SNF_C2_70,D3_SNF_C2_76,D3_SNF_C3_63,D3_SNF_C3_70,D3_SNF_C3_76,G_C1THRU4_57,D_4_HOS_C1_50,G2_C1_24,G2_C2_24,A_C6_96,D3_SNF_C2_50,D3_SNF_C3_50,A_C1_12,G_C1THRU4_48,E3_6_SNF_C1_14,C_1_C5_96,C_1_C7_117,E3_4_HOS_C1_21,C_1_C2_66,D3_SNF_C2_53,D3_SNF_C3_53,D3_IPF_C2_93,D3_IPF_C3_93,D_2_IPF_C5_93,E3_2_HOS_C1_30,D_5_HOS_C4_50,D_5_HOS_C7_50,D3_IRF_C2_31,D3_SNF_C2_55,D3_SNF_C2_57,D3_SNF_C2_58,D3_SNF_C3_55,D3_SNF_C3_57,D3_SNF_C3_58,D_5_HOS_C4_65,D_5_HOS_C7_65,A_C6_20,B_1_C21_64,B_1_C21_71,B_1_C21_73,B_1_C22_68,B_1_C22_73,D1_HOS_C5_45,D1_HOS_C5_46,D3_IPF_C2_75,D3_IPF_C3_75,D_2_IPF_C5_75,D_3_HOS_C9_33,D_4_HOS_C11_56,D_4_HOS_C11_63,D_4_HOS_C11_65,D_4_HOS_C11_66,D_4_HOS_C11_69,D_4_HOS_C11_71,D_4_HOS_C13_56,D_4_HOS_C13_63,D_4_HOS_C13_65,D_4_HOS_C13_66,D_4_HOS_C13_69,D_4_HOS_C13_70,D_4_HOS_C13_71,D_4_HOS_C2_51,D_4_HOS_C2_53,D_4_HOS_C2_54,D_4_HOS_C2_55,D_4_HOS_C2_58,D_4_HOS_C2_65,D_4_HOS_C2_66,D_4_HOS_C2_69,D_4_HOS_C2_70,D_4_HOS_C2_75,D_4_HOS_C2_90,D_4_HOS_C3_56,D_4_HOS_C3_63,D_4_HOS_C3_65,D_4_HOS_C3_66,D_4_HOS_C3_69,D_4_HOS_C3_71,D_4_IPF_C11_75,D_4_IRF_C11_51,D_4_IRF_C11_70,D_4_IRF_C13_56,S3_1_C7_10,A_C1_20,D3_IPF_C2_31,D3_SNF_C2_52,D3_SNF_C2_59,D3_SNF_C3_52,D3_SNF_C3_59,B_1_C21_190,B_1_C21_192,B_1_C21_76,B_1_C22_190,B_1_C22_192,B_1_C22_76,B_1_C22_93,A_C6_33,D3_HOS_C2_35,D_1_HOS_C6_35,D_1_HOS_C7_35,D_3_HOS_C9_35,D_4_HOS_C13_93,D_4_HOS_C3_76,D_4_HOS_C3_93,S3_1_C6_12,D3_IRF_C2_62,D3_IRF_C3_62,D_2_IRF_C5_62,A_C6_34,B_1_C21_33,B_1_C22_33,D3_IRF_C2_64,D3_IRF_C3_64,D_2_IRF_C5_64,D_4_IRF_C11_65,D_4_IRF_C11_90,D_5_HOS_C3_9201,D_5_HOS_C6_9201,B_1_C21_67,B_1_C22_67,D3_SNF_C2_56,D3_SNF_C3_56,D3_HOS_C2_98,D3_HOS_C3_98,D_2_HOS_C5_98,D_4_HOS_C10_98,D_5_HOS_C4_76,D_5_HOS_C7_76,S3_1_C4_9,D_4_SNF_C11_60,D_4_SNF_C11_73,A_C6_9201,D_5_HOS_C4_56,D_5_HOS_C7_56,A_C6_72,D3_IRF_C2_52,D3_IRF_C3_52,D_2_IRF_C5_52,D_4_IRF_C13_90,A_C1_115,A_C2_115,A_C6_115,D3_SNF_C2_51,D3_SNF_C2_75,D3_SNF_C3_51,D3_SNF_C3_75,D_4_HOS_C2_63,D_4_IPF_C11_53,D_4_IPF_C11_60,D_4_IPF_C11_63,D_4_IRF_C11_53,D_4_IRF_C11_60,D_4_IRF_C11_63,D_4_IRF_C11_75,D_4_SNF_C11_50,D_4_SNF_C11_53,D_4_SNF_C11_63,D_4_SNF_C11_91,B_1_C26_115,B_2_C26_115,C_1_C5_115,C_1_C6_115,C_1_C7_115,C_1_C6_96,E3_1_HOS_C1_17,D_4_HOS_C11_68,D_4_HOS_C3_68,D3_SNF_C2_64,D3_SNF_C3_64,B_1_C21_62,B_1_C22_62,D_4_HOS_C13_68,D_4_HOS_C3_62,D_4_IPF_C13_54,A_C6_89,B_1_C0_89,C_1_C6_89,D_4_HOS_C11_76,D_4_HOS_C13_76,D_4_HOS_C11_67,D_4_HOS_C3_67,D_4_IPF_C11_67,A_C2_89,S3_1_C5_8,D_4_IRF_C11_73,D_4_IRF_C13_73,A_C6_97,D3_SNF_C2_93,D3_SNF_C3_93,D_5_HOS_C4_51,D_5_HOS_C4_63,D_5_HOS_C4_66,D_5_HOS_C4_67,D_5_HOS_C4_68,D_5_HOS_C7_51,D_5_HOS_C7_63,D_5_HOS_C7_66,D_5_HOS_C7_67,D_5_HOS_C7_68,D_5_HOS_C4_52,D_5_HOS_C7_52,D_4_HOS_C2_60,D3_SNF_C2_31,D_4_HOS_C11_93,D_4_SNF_C11_65,D_4_SNF_C11_66,D_4_SNF_C11_67,D_4_SNF_C11_68,D3_HOS_C2_97,D3_HOS_C3_97,D_2_HOS_C5_97,D_4_HOS_C10_97,C_1_C6_6250,D3_HOS_C2_6250,D_4_HOS_C10_6250,A_C1_9910,A_C2_9910,A_C6_9910,B_1_C0_9910,B_1_C26_9910,B_2_C26_9910,C_1_C5_9910,C_1_C7_9910,D_5_HOS_C4_93,D_5_HOS_C7_93,S3_1_C10_25,D_4_HOS_C2_76,D_4_IPF_C11_76,D_4_IRF_C11_76,D3_IRF_C2_93,D3_IRF_C3_93,D_2_IRF_C5_93,D_4_HOS_C2_57,D_4_SNF_C11_57,G_C1THRU4_56,B_1_C21_88,B_1_C22_88,S3_1_C9_26,C_1_C6_9910,E3_2_IPF_C1_30,D_4_IRF_C13_54,D_4_IRF_C13_65,D_4_IRF_C13_91,D_4_HOS_C11_62,D_4_HOS_C11_72,D_4_HOS_C13_62,D_4_HOS_C13_72,D_4_HOS_C3_72,D_4_IPF_C11_65,D_4_IPF_C11_69,D_4_IPF_C11_70,D_4_IPF_C11_72,D_4_IPF_C11_73,D_4_IPF_C13_50,D_4_IPF_C13_52,D_4_IPF_C13_57,D_4_IPF_C13_60,D_4_IPF_C13_70,D_4_IPF_C13_71,D_4_IPF_C13_72,D_4_IPF_C13_73,D_4_IPF_C11_56,D_4_IRF_C11_56,D_4_HOS_C2_93,D3_IRF_C2_98,D3_IRF_C3_98,D3_SNF_C2_98,D3_SNF_C3_98,D_2_IRF_C5_98,D_4_HOS_C2_59,D_4_IPF_C11_59,D_4_IRF_C11_59,D_4_SNF_C11_55,D_4_SNF_C11_59,D3_IPF_C2_9201,D3_IPF_C3_9201,D3_IRF_C2_9201,D3_IRF_C3_9201,D_2_IPF_C5_9201,D_2_IRF_C5_9201,D_4_IPF_C11_66,D_4_IRF_C11_66,D_4_IPF_C11_51,B_1_C21_98,B_1_C22_98,S3_1_C5_9,D3_HOS_C2_96,D3_HOS_C3_96,D3_IPF_C2_96,D3_IPF_C3_96,D3_IRF_C2_96,D3_IRF_C3_96,D_2_HOS_C5_96,D_2_IPF_C5_96,D_2_IRF_C5_96,D_4_HOS_C10_96,D_5_HOS_C4_70,D_5_HOS_C7_70,G_C1THRU4_55,B_1_C22_9201,D_4_HOS_C11_9201,D_4_HOS_C13_9201,D_4_HOS_C2_9201,D_4_IPF_C11_9201,D_4_IPF_C13_91,D_4_IRF_C11_9201,D_4_HOS_C13_67,D_4_IRF_C11_67,D_4_IRF_C11_68,D_4_IRF_C11_69,D_4_IRF_C11_71,D_4_IRF_C11_72,D_5_HOS_C3_96,D_5_HOS_C6_96,D_4_SNF_C11_71,A_C1_72,B_1_C21_9201,B_1_C0_115,D_4_IRF_C13_50,D_4_HOS_C2_88,S3_1_C5_12,S3_1_C5_10,D3_IRF_C2_32,E3_3_HOS_C1_31,D3_IPF_C2_35,D_4_IPF_C11_90,A_C1_89,A_C1_99,A_C2_99,A_C6_99,B_1_C0_99,B_1_C26_99,B_2_C26_99,C_1_C5_99,C_1_C6_99,C_1_C7_99,D_4_IPF_C11_93,D_4_SNF_C11_93,D3_IPF_C2_98,D3_IPF_C3_98,D_2_IPF_C5_98,D_4_HOS_C2_64,B_1_C21_68,D_4_HOS_C4_50,D_4_HOS_C4_51,D_4_HOS_C4_65,D_4_HOS_C4_75,D_4_HOS_C4_90,D_4_HOS_C4_91,D_4_IPF_C13_90,D_4_HOS_C13_97,D_4_HOS_C2_73,D_4_HOS_C2_97,D_4_HOS_C3_9201,D_4_HOS_C3_97,D_5_HOS_C3_97,D_5_HOS_C6_97,D_5_HOS_C4_62,D_5_HOS_C7_62,D_5_HOS_C4_9201,D_5_HOS_C7_9201,B_1_C22_71,D_4_IPF_C13_69,D_4_HOS_C12_96,D_5_HOS_C2_96,D_5_HOS_C5_96,D_4_SNF_C11_51,D_4_SNF_C11_70,D_4_SNF_C11_76,B_1_C21_112,B_1_C22_64,D_4_IPF_C11_52,B_1_C22_112,B_1_C22_72,D_4_SNF_C11_90,B_1_C21_193,B_1_C22_193,D3_IPF_C2_32,D3_IPF_C2_33,D3_IPF_C2_34,D3_IRF_C2_33,D3_IRF_C2_34,D3_IRF_C2_35,D_4_IPF_C11_64,D_4_IRF_C11_52,D_4_IRF_C11_64,D_4_SNF_C11_56,D_4_IPF_C11_55,A_C1_9920,A_C1_9930,A_C1_9940,A_C2_9920,A_C2_9930,A_C2_9940,A_C6_9920,A_C6_9930,A_C6_9940,B_1_C0_9920,B_1_C0_9930,B_1_C0_9940,B_1_C26_9920,B_1_C26_9930,B_1_C26_9940,B_2_C26_9920,B_2_C26_9930,B_2_C26_9940,C_1_C5_9920,C_1_C5_9930,C_1_C5_9940,C_1_C7_9920,C_1_C7_9930,C_1_C7_9940,D_4_IRF_C13_60,D_4_IPF_C13_53,D_4_IRF_C11_93,D3_SNF_C2_9201,D3_SNF_C3_9201,B_1_C21_72,S3_1_C4_12,S3_1_C5_11,D_4_IPF_C11_62,D_4_IPF_C11_68,D_4_IRF_C11_62,D_4_IRF_C13_69,E_B_IPF_C1_39,E_B_IRF_C1_39,S3_1_C9_24,D_5_HOS_C4_75,D_5_HOS_C7_75,D_4_HOS_C11_98,D_4_HOS_C13_98,D_4_HOS_C2_98,D_4_IRF_C11_98,File Date,S2_1_C2_2,S2_1_C1_35,S2_1_C1_40,S2_1_C2_40,E_A_HOS_C1_72,E_A_HOS_C1_7096,E_A_HOS_C1_7097,E_A_HOS_C1_7093,E_A_HOS_C1_7090,E_A_HOS_C1_7094,E_A_HOS_C1_7091,E_A_HOS_C1_49,E_A_HOS_C1_50,E_A_HOS_C1_54,E_A_HOS_C1_59,E_A_HOS_C1_68,E_A_HOS_C1_93,E_A_HOS_C1_47,E_A_HOS_C1_48,E_A_HOS_C1_7099,Line 19 Subtotal,Reconstructed IPPS payment (pre HAC penalty),Reconstructed HAC penalty,Reconstructed IPPS payment (post HAC penalty),HAC penalty imputed from E_A_HOS_C1_59,Lat,Lon,"Control type, text","Hospital type, text",Num and Name
,Report Record Number,Hospital Provider Number,Fiscal Intermediary Number,Report Status Code,Fiscal Intermediary/MAC Create Date,Fiscal Year Begin Date,Fiscal Year End Date,Utilization Code (L/N/F),NOT IN THIS FILE,SSA State Code,SSA State County Code,Census Division Code,CMS Region Code,Geographic MSA,Utilization Review SNF,Utilization Review SNF,PBP Clinical Lab Services Program Only,Int & Res (non approved teaching program,Home Program Dialysis,Int & Res (non approved teaching program,Subprovider I,Home Program Dialysis,Cross Foot Adjustments,Int & Res (non approved teaching program,Int & Res (non approved teaching program,Islet Acquisition,No Description,No Description,Subprovider I,Nursery,PBP Clinical Lab Services Program Only,No Description,PBP Clinical Lab Services Program Only,No Description,Subprovider I,Home Program Dialysis,Home Program Dialysis,PBP Clinical Lab Services Program Only,Home Program Dialysis,PBP Clinical Lab Services Program Only,Home Program Dialysis,Subprovider-IPF,Subprovider-IRF,Subprovider II,No Description,No Description,Home Program Dialysis,Renal Dialysis,Total,Home Program Dialysis,PBP Clinical Lab Services Program Only,Home Program Dialysis,PBP Clinical Lab Services Program Only,Home Program Dialysis,No Description,No Description,No Description,No Description,No Description,No Description,No Description,No Description,No Description,No Description,No Description,No Description,No Description,No Description,No Description,No Description,No Description,No Description,No Description,No Description,No Description,No Description,No Description,No Description,No Description,No Description,No Description,No Description,No Description,No Description,No Description,No Description,No Description,No Description,No Description,No Description,No Description,No Description,No Description,No Description,No Description,No Description,No Description,No Description,No Description,No Description,No Description,No Description,No Description,No Description,No Description,No Description,No Description,No Description,No Description,No Description,No Description,OPPS payments,Outlier payments,Line 2 times line 5,"Sum of lines 3,4 divided by line 6",Transitional corridor payment,Partial or full credits from manufacturers,Sequestration adjustment,No Description,No Description,No Description,No Description,No Description,No Description,No Description,No Description,No Description,No Description,No Description,No Description,No Description,No Description,No Description,No Description,No Description,No Description,No Description,No Description,No Description,No Description,No Description,No Description,No Description,No Description,No Description,No Description,No Description,No Description,No Description,No Description,No Description,No Description,No Description,No Description,No Description,No Description,No Description,No Description,No Description,No Description,No Description,No Description,No Description,No Description,No Description,No Description,No Description,No Description,No Description,No Description,No Description,No Description,No Description,No Description,No Description,No Description,No Description,No Description,No Description,No Description,No Description,No Description,No Description,No Description,No Description,No Description,No Description,No Description,No Description,No Description,No Description,No Description,No Description,No Description,No Description,No Description,No Description,No Description,No Description,No Description,No Description,No Description,No Description,No Description,No Description,No Description,No Description,No Description,No Description,No Description,No Description,No Description,No Description,No Description,No Description,Total Subprovider II Interns & Residents,No Description,No Description,No Description,Subprovider 2,Labor and Delivery,Subprovider 2,Labor and Delivery,SNF,NF,No Description,Subprovider 2,Subprovider 2,Total Subprovider I Interns & Residents,No Description,Home Office Salaries,Related  Salaries,Interns & Residents,Interns & Residents,Interns & Residents,Interns & Residents,Home Office Salaries,Related Salaries,Wage Related Costs RHC/FQHC,Interns & Residents,Interns & Residents,Interns & Residents,Interns & Residents,Home Office Salaries,Related Salaries,Teaching Physician Salaries,Teaching Physician Salaries,Interns & Residents,Interns & Residents,Interns & Residents,Interns & Residents,Home Office Salaries,Related Salaries,No Description,No Description,No Description,No Description,No Description,No Description,Without Outliers:  Other Charges,With Outliers:  Other Charges,With Outliers:  Non Routine Med Sup Chgs,LUPA Episodes:  Other Charges,PEP Episodes:  Other Charges,PEP:  Total Number of Outlier Episodes,Total Other Charges,Without Outliers:  Total Visits,Without Outliers:  Other Charges,Without Outliers:  Total Charges,W/Out Outliers:  Number of Episodes,Without Outliers:  Non Routine Med Sup Chgs,With Outliers:  Total Visits,With Outliers:  Other Charges,With Outliers:  Total Charges,With Outliers:  Number of Episodes,With Outliers:  Non Routine Med Sup Chgs,LUPA Episodes:  Total Visits,LUPA Episodes:  Other Charges,Total Charges:  LUPA Episodes,LUPA Episodes:  Total Number of Episodes,LUPA:  Total Non Routine Med Sup Chgs,PEP Episodes:  Total Visits,PEP Episodes:  Other Charges,PEP Episodes:  Total Charges:,PEP Episodes:  Total Number of Episodes,PEP:  Total Number of Outlier Episodes,PEP:  Total Non Routine Med Supply Chgs,Total Visits,Total Other Charges,Total Charges,Total Number of Episodes,Total Number of Outlier Episodes,Total Non Routine Medical  Supply Charges,Total,Building Improvements,Fixed Equipment,Movable Equipment,Subtotal,Total,Fixed Equipment,Movable Equipment,Subtotal,Total,Fixed Equipment,Movable Equipment,Subtotal,Total,Total,Total,Cafeteria employees and guests,Sale of medical records and abstracts,"Trade, Quantity, and Time Discounts",Refunds and Rebates of Expenses,Total,Total Salaries,Adults and Pediatrics,Total Salaries,Adults and Pediatrics,Renal Dialysis,Total Salaries,Adults and Pediatrics,Total,Adults and Pediatrics,Renal Dialysis,Total,Adults and Pediatrics,Renal Dialysis,Total,Adults & Pediatrics,Renal Dialysis,Total,Subtotal,Total,Adults & Pediatrics,Renal Dialysis,No Description,Total,Adults & Pediatrics,Renal Dialysis,Total,net of Swing Bed Cost,net of Swing Bed and Private Room Diff,Total Program General Inpatient Routine,Program Inpatient Ancillary Service Cost,Total Program Inpatient Costs,Pass through Cost for Program Inpatient Routine,Pass Through Cost for  Program Ancillary,Total Program Excludable Costs,"Anesthetist, and Medical Education Costs",No Description,No Description,Adults and Pediatrics,Renal Dialysis,TOTAL,Renal Dialysis,Total,Adults & Pediatrics,Total,Adults & Pediatrics,Total,Adults & Pediatrics,No Description,No Description,Total Patient Days,Total Inpatient Program Days,No Description,No Description,No Description,No Description,No Description,No Description,No Description,No Description,No Description,No Description,No Description,No Description,No Description,No Description,No Description,No Description,No Description,No Description,No Description,No Description,No Description,No Description,No Description,No Description,No Description,No Description,No Description,No Description,No Description,No Description,No Description,No Description,No Description,No Description,No Description,Cost To Charge Ratio,Total Bad Debt expense,No Description,No Description,No Description,Cost of Uncompensated Care,Total unreimbursed and uncompensated care,No Description,No Description,No Description,No Description,No Description,No Description,Urban/Rural Indicator at beginning,Urban (1) or Rural (2),Hospital Type,Total Hospital Interns & Residents,Total Facility FTEs,No Description,No Description,No Description,No Description,Hospital Adults & Pediatrics,Total Hospital,Total Facility,Total,Hospital Adults & Pediatrics,Total Hospital,Total Hospital,Hospital Adults & Pediatrics,Total Hospital,Total Adults & Peds,Hospital Adults & Pediatrics,Total Hospital,Total Adults & Pediatrics,Land,Buildings and Fixtures,Buildings and Fixtures,Total,Total,Investment Income-New Bldgs & Fixtures,Provider-based physician adjustment,Related Organization Transactions,Investment Income-Other,Subprovider-IPF,Interest Expense,Other Capital,Subprovider-IPF,Subprovider-IPF,Subprovider-IPF,Subprovider-IPF,Subprovider-IPF,Subprovider-IPF,No Description,Total,net of Swing Bed Cost,net of Swing Bed and Private Room Diff,Total Program General Inpatient Routine,Total Program Inpatient Costs,Pass through Cost for Program Inpatient,Total Program Excludable Costs,"Anesthetist, and Medical Education Costs",Subprovider-IPF,Subprovider-IPF,Subprovider-IPF,Subprovider-IPF,No Description,No Description,No Description,No Description,No Description,No Description,No Description,No Description,No Description,No Description,No Description,No Description,No Description,No Description,No Description,No Description,No Description,No Description,No Description,No Description,Ratio of line 15 to line 16,No Description,No Description,No Description,No Description,No Description,No Description,No Description,No Description,No Description,No Description,No Description,IPF,IPF,IPF,Hospital Adults & Pediatrics,Total Hospital,IPF,Total Adults & Peds,IPF,Total Salaries,Excluded Area Salaries,Administrative and General,Operation of Plant,Housekeeping,Dietary,Nursing Administration,Medical Records & Med Records Library,Other General Service,Net Salaries,Excluded Area Salaries,Subtotal Salaries,Total,Net Salaries,Excluded Area Salaries,Subtotal Salaries,Total,Total Overhead Costs,Negative Cost Centers,Total,Total,Total,No Description,No Description,No Description,No Description,No Description,No Description,No Description,No Description,No Description,No Description,No Description,No Description,No Description,No Description,No Description,No Description,No Description,No Description,No Description,Medical and Other Services reimbursed by OPPS,Total prospective payment,Deductibles and coinsurance related to line 24,Subtotal,OPPS payments,Subtotal,Subtotal,Allowable bad debts,Adjusted reimburseable bad debts,Allowable bad debts for dual eligibles beneficiaries,Subtotal,Subtotal,Interim payments,Balance due provider/program,No Description,Land Improvements,Total,Movable Equipment,Subtotal,Land Improvements,Buildings and Fixtures,Building Improvements,Depreciation-New Bldgs & Fixtures,Depreciation-New Movable Equipment,Total Directly Assigned New Cap Rel Csts,No Description,No Description,No Description,No Description,Total Hospital Interns & Residents,Total Facility FTEs,Employee Benefits,Maintenance and Repairs,Laundry and Linen Service,Pharmacy,Social Service,Total Salaries,Excluded Area Salaries,Employee Benefits,Administrative and General,Admin & Gen Under Contract,Operation of Plant,Laundry and Linen Service,Housekeeping,Dietary,Nursing Administration,Pharmacy,Medical Records & Med Records Library,Social Service,Total Salaries,Total Salaries,Net Salaries,Subtotal Salaries,Net Salaries,Subtotal Salaries,Total,No Description,No Description,No Description,No Description,Adults and Pediatrics,Adults and Pediatrics,Cross Foot Adjustments,No Description,No Description,No Description,No Description,No Description,No Description,No Description,No Description,No Description,No Description,No Description,No Description,No Description,No Description,No Description,No Description,No Description,No Description,No Description,No Description,No Description,No Description,No Description,No Description,No Description,No Description,No Description,No Description,No Description,No Description,No Description,No Description,No Description,No Description,No Description,No Description,No Description,No Description,No Description,No Description,No Description,No Description,No Description,interns and residents,Tentative settlement,Total Hospital Interns & Residents,Total Facility FTEs,Building Improvements,Building Improvements,Nursery,Nursery,Nursery,Less Observation Beds,Nursery,Nursery,Nursery,No Description,No Description,No Description,Net Revenue from Medicaid,No Description,No Description,Cost of charity care,Medicaid charges,No Description,No Description,Nursery,Nursery,Medicaid Observation Days,Wage Related Costs Core,Wage Related Costs Other,Non-Physician Anesthetist Part B,Wage Related Costs Core,Wage Related Costs Other,Non-Physician Anesthetist Part B,Administrative and General,Administrative and General,Subtotal Wage Related Csts,Subtotal Wage Related Csts,Total Overhead Costs,Subtotal Wage Related Csts,Total Overhead Costs,Parking Lot,No Description,No Description,No Description,No Description,No Description,No Description,Total,Rental of quarters to employee and oths,NF,NF,NF,NF,NF,NF,NF,No Description,No Description,No Description,No Description,No Description,No Description,No Description,No Description,No Description,Total,Vending Machines,Telephone Services,Television and Radio Service,Renal Dialysis,Total,Renal Dialysis,Total,Renal Dialysis,Medical and Other Services,Total cost,Ancillary service charges,Total reasonable charges,Total customary charges,Excess of customary charges,Lesser of cost or charges,Deductibles and coinsurance,No Description,No Description,HMO,Contract Labor,Contract Labor: Pysician Part A,Home Office Salaries & Wage Related Csts,Excluded Areas,Central Services and Supply,Contract Labor,Contract Labor:  Physician Part A,Home Office Salaries & Wage Related Csts,Excluded Areas,Central Services and Supply,Excluded Area Salaries,Contract Labor,Contract Labor:  Physician Part A,Home Office Salaries & Wage Related Csts,Employee Benefits,Operation of Plant,Housekeeping,Dietary,Nursing Administration,Central Services and Supply,Medical Records & Med Records Library,Social Service,Excluded Area Salaries,Contract Labor,Contract Labor:  Physician Part A,Home Office Salaries & Wage Related Csts,Employee Benefits,Operation of Plant,Housekeeping,Dietary,Nursing Administration,Central Services and Supply,Medical Records & Med Records Library,Social Service,Subtotal Other Wages and Related Csts,Subtotal Other Wages and Related Csts,Excluded Area Salaries,Subtotal Other Wages and Related Csts,Excluded Area Salaries,Subtotal Other Wages and Related Csts,Land,"Sale of scrap, waste, etc.",Nursery,Nursery,Total,Renal Dialysis,Total,Total Allied Health,Total Outpatient Program Pass Thru Cost,Renal Dialysis,Total,Renal Dialysis,Total,No Description,No Description,No Description,No Description,No Description,No Description,No Description,No Description,No Description,No Description,No Description,No Description,No Description,No Description,No Description,No Description,No Description,No Description,No Description,Excess of reasonable cost over reasonable charges,Primary payer payments,Ancillary service other pass through costs,No Description,No Description,No Description,No Description,No Description,No Description,No Description,No Description,No Description,No Description,Stand-alone SCHIP Charges,No Description,No Description,Net Revenue from stand-alone SCHIP,In State Medicaid eligible days,Out of State Medicaid eligible days,HMO,Physician Part A,Physician Part B,Physician-Part A,Physician-Part B,Physician Part A,Physician Part B,Non-Physician Anesthetist Part B,Physician-Part A,Physician-Part B,Non-Physician Anesthetist Part B,Physician-Part A,Pharmacy,Physician-Part B,Non-Physician Anesthetist Part B,Physician-Part A,Pharmacy,Physician-Part B,Total,Land Improvements,Interest Expense,MSP-LCC reconciliation amount,Total,Buildings and Fixtures,Building Improvements,Movable Equipment,Subtotal,Sale of medical and surgical supplies to,No Description,No Description,No Description,No Description,In State Medicaid paid days,Number of periods hospital was in MDH status,Out of State Medicaid paid days,No Description,Non-Physician Anesthetist Part A,Non-Physician Anesthetist Part A,Non-Physician Anesthetist Part A,Non-Physician Anesthetist Part A,Non-Physician Anesthetist Part A,Non-Physician Anesthetist Part A,No Description,No Description,Buildings and Fixtures,Subprovider-IRF,SNF,Subprovider-IRF,SNF,Subprovider-IPF,Subprovider-IRF,Subprovider-IRF,Subprovider-IRF,Subprovider-IRF,Subprovider-IRF,Subprovider-IRF,Program Inpatient Ancillary Service Cost,Pass Through Cost for  Program Ancillary,net of Swing Bed Cost,net of Swing Bed and Private Room Diff,Total Program General Inpatient Routine,Program Inpatient Ancillary Service Cost,Total Program Inpatient Costs,Pass through Cost for Program Inpatient,Pass Through Cost for  Program Ancillary,Total Program Excludable Costs,"Anesthetist, and Medical Education Costs",TOTAL,Renal Dialysis,TOTAL,Renal Dialysis,TOTAL,Subprovider-IRF,Renal Dialysis,TOTAL,Renal Dialysis,Subprovider-IRF,Subprovider-IRF,Subprovider-IRF,No Description,No Description,No Description,No Description,No Description,No Description,No Description,No Description,No Description,No Description,No Description,No Description,No Description,No Description,No Description,No Description,No Description,No Description,No Description,No Description,No Description,No Description,No Description,No Description,No Description,No Description,No Description,No Description,No Description,No Description,No Description,No Description,No Description,No Description,No Description,No Description,No Description,No Description,No Description,No Description,No Description,No Description,No Description,No Description,No Description,No Description,No Description,No Description,No Description,No Description,No Description,No Description,No Description,No Description,No Description,No Description,No Description,No Description,No Description,No Description,No Description,No Description,No Description,No Description,No Description,No Description,No Description,No Description,No Description,No Description,IRF,IRF,IRF,IRF,IRF,SNF,Cafeteria,Cafeteria,Cafeteria,Sale of drugs to other than patients,Ambulance Services,Ambulance Services,SNF,Ambulance Services,SNF,Ambulance Services,SNF,Ambulance Services,SNF,Ambulance Services,SNF,Ambulance Services,net of Swing Bed and Private Room Diff,Total Program General Inp. Rtn Service,Program Ancillary Services,No Description,TOTAL,TOTAL,No Description,No Description,No Description,No Description,No Description,No Description,No Description,No Description,No Description,No Description,Payment to cost ratio,Line 2 times line 5,No Description,No Description,No Description,No Description,No Description,No Description,No Description,No Description,No Description,No Description,No Description,No Description,No Description,No Description,No Description,No Description,No Description,No Description,No Description,No Description,No Description,No Description,No Description,No Description,No Description,No Description,No Description,No Description,No Description,No Description,No Description,No Description,No Description,No Description,No Description,No Description,No Description,No Description,No Description,No Description,No Description,No Description,No Description,No Description,No Description,No Description,No Description,Medicaid HMO Days,SNF,SNF,SNF,SNF,SNF,SNF,SNF,Laundry and Linen Service,SNF,Laundry and Linen Service,SNF,Without Outliers:  Total Visits,Without Outliers:  Total Charges,W/Out Outliers:  Number of Episodes,Without Outliers:  Non Routine Med Sup Chgs,With Outliers:  Total Visits,With Outliers:  Total Charges,With Outliers:  Number of Episodes,With Outliers:  Non Routine Med Sup Chgs,LUPA Episodes:  Total Visits,Total Charges:  LUPA Episodes,LUPA Episodes:  Total Number of Episodes,LUPA:  Total Non Routine Med Sup Chgs,PEP Episodes:  Total Visits,PEP Episodes:  Total Charges:,PEP Episodes:  Total Number of Episodes,Total Visits,Total Charges,Total Number of Episodes,Total Number of Outlier Episodes,Total Non Routine Medical  Supply Charges,Kidney Acquisition,Renal Dialysis,Kidney Acquisition,Pancreas Acquisition,Kidney Acquisition,Kidney Acquisition,Pancreas Acquisition,Subprovider-IPF,Kidney Acquisition,Pancreas Acquisition,Kidney Acquisition,Pancreas Acquisition,Kidney Acquisition,Pancreas Acquisition,Kidney Acquisition,Organ Procurement,Organ Procurement,Total Allied Health Cost,Total Costs,Total,Adults & Pediatrics,No Description,No Description,No Description,No Description,No Description,No Description,No Description,No Description,No Description,No Description,No Description,No Description,No Description,No Description,No Description,Outlier payments,No Description,No Description,No Description,No Description,Labor and Delivery Days -  Title XIX,Labor and Delivery Days -  Title XIX,No Description,Management and Administrative Services,Management and Administrative Services,Management and Administrative Services,Management and Administrative Services,No Description,No Description,Negative Cost Centers,Total Swing Bed Cost,No Description,No Description,No Description,No Description,No Description,No Description,No Description,No Description,No Description,No Description,No Description,No Description,"Sum of lines 3,4 divided by line 6",Transitional corridor payment,No Description,Hospital Adults & Ped Swing Bed SNF,Hospital Adlts & Ped Swing Bed SNF,Hospital Adlts & Ped Swing Bed NF,Admin & Gen Under Contract,Admin & Gen Under Contract,No Description,PEP:  Total Non Routine Med Supply Chgs,Investment Income-New Movable Equip,No Description,No Description,No Description,No Description,No Description,No Description,No Description,No Description,No Description,No Description,"Income from imposition of interest, finance",Rental of Provider space by suppliers,Nursery,No Description,No Description,Administrative & General under contract,Administrative & General under contract,Administrative and General under Contract,Administrative and General under Contract,Laundry and Linen Service,NF,No Description,No Description,No Description,No Description,No Description,No Description,No Description,No Description,No Description,No Description,No Description,No Description,No Description,No Description,No Description,No Description,NF,NF,NF,Hospital Adults & Pediatrics,Total Hospital,Total Hospital,NF,NF,Fixed Equipment,Non-physician Anesthetist,SNF,No Description,No Description,Non-Physician Anesthetist Part B,Total,Hospital Adlts & Ped Swing Bed SNF,Wage Related Costs RHC/FQHC,Non-Physician Part B,Wage Related Costs RHC/FQHC,Non-Physician Part B,Non-Physician Part B,Non-Physician Part B,No Description,No Description,No Description,No Description,No Description,No Description,No Description,No Description,No Description,Interest expense on Medicare Overpaymts,No Description,Ambulance Trips,Hospital Adlts & Ped Swing Bed NF,Ambulance Services,RPCH/CAH Visits,RPCH/CAH Visits,CAH Visits,No Description,No Description,No Description,Ambulance Services,No Description,Without Outliers:  Other Charges,With Outliers:  Other Charges,LUPA Episodes:  Other Charges,PEP Episodes:  Other Charges,Total Other Charges,Dietary under contract,Dietary under contract,Land Improvements,No Description,Ambulance Services,Ambulance Services,No Description,No Description,No Description,No Description,Begin Balance,Purchase,Total,Disp. And Retirement,Ending Balance,Land,Assets,Heart Acquisition,Liver Acquisition,Heart Acquisition,Liver Acquisition,Heart Acquisition,Liver Acquisition,Renal Dialysis,Heart Acquisition,Liver Acquisition,Int & Res (non approved teaching program,Heart Acquisition,Liver Acquisition,Int & Res (non approved teaching program,Heart Acquisition,Liver Acquisition,Int & Res (non approved teaching program,Heart Acquisition,Liver Acquisition,Heart Acquisition,Liver Acquisition,Pancreas Acquisition,Kidney Acquisition,Heart Acquisition,Liver Acquisition,Pancreas Acquisition,Organ Procurement,Organ Procurement,No Description,No Description,No Description,No Description,No Description,No Description,No Description,Teaching Physician Salaries,Interns & Residents,Interns & Residents,Teaching Physician Salaries,Interns & Residents,Other General Service,Interns & Residents,Teaching Physician Salaries,Other General Service,Interns & Residents,Teaching Physician Salaries,Other General Service,Interns & Residents,No Description,No Description,"Number of patients on transplant 
list","Net costs of Epoietin furnished to
all maintenance dialysis patients
by the provider",Number of EPO units furnished for Line 13,Number of Times per week Patient receives Dialysis,"Average patient dialysis time 
including setup","Number of days in year dialysis 
furnished",Number of stations,"Treatment capacity per day per
station",Utilization,"Number of patients in program at 
end of cost reporting period",Home Program Dialysis,No Description,"Number of patients transplanted 
during fiscal year","Average patient dialysis time 
including setup",Number of stations,No Description,No Description,No Description,No Description,No Description,No Description,No Description,No Description,No Description,No Description,No Description,PEP:  Total Number of Outlier Episodes,No Description,OLTC,OLTC,OLTC,OLTC,OLTC,OLTC,OLTC,OLTC,No Description,OLTC,No Description,OLTC,OLTC,OLTC,No Description,No Description,No Description,No Description,SNF,No Description,No Description,No Description,No Description,No Description,No Description,No Description,No Description,No Description,No Description,No Description,No Description,No Description,No Description,No Description,SNF,Int & Res (non approved teaching program,Int & Res (non approved teaching program,Subprovider I,Subprovider I,Subprovider I,Subprovider I,Subprovider I,Subprovider I,Subprovider I,Subprovider I,Subprovider I,No Description,Subprovider 1,Subprovider 1,Subprovider 1,Cost of physicians svcs in a teaching hospita,Adj for Physical therapy costs in excess,No Description,No Description,No Description,Hospital Adults & Pediatrics,Total Hospital,Total Hospital,No Description,Physicians' Assistant,No Description,Home Program Dialysis,Home Program Dialysis,Home Program Dialysis,Home Program Dialysis,Home Program Dialysis,Home Program Dialysis,Home Program Dialysis,Renal Dialysis,Renal Dialysis,Component rate ESRD,Protested amounts,No Description,No Description,"Number of Times per week
 Patient receives Dialysis","Number of days in year dialysis 
furnished",Number of stations,"Treatment capacity per day per
station","Number of Times per week
 Patient receives Dialysis","Average patient dialysis time 
including setup","Number of patients in program at 
end of cost reporting period","Number of Times per week
 Patient receives Dialysis",CAPD exchanges per day,No Description,No Description,No Description,No Description,No Description,No Description,No Description,No Description,No Description,No Description,No Description,No Description,No Description,No Description,No Description,No Description,No Description,No Description,No Description,Dietary under Contract,Dietary under Contract,No Description,No Description,Int & Res (non approved teaching program,Pancreas Acquisition,Subprovider-IPF,Subprovider-IRF,Nursery,Subprovider-IRF,Nursery,Subprovider-IPF,Subprovider-IRF,Total,Total Allied Health,Total Outpatient Program Pass Thru Cost,Total,Total Allied Health,Total Outpatient Program Pass Thru Cost,No Description,No Description,No Description,No Description,No Description,No Description,No Description,No Description,No Description,No Description,No Description,No Description,No Description,No Description,No Description,Cafeteria,Other Capital,Program Discharges,Target Amount per Discharge,Target Amount,Operating Cost and Target Amount,Bonus Payment,Allowable Inpatient Cost Plus Incentive Pt,No Description,No Description,No Description,No Description,No Description,No Description,No Description,No Description,No Description,No Description,No Description,No Description,No Description,No Description,Home Office Personnel,Home Office Personnel,Home Office Personnel,Home Office Personnel,No Description,No Description,No Description,SNF,No Description,Adults and Pediatrics,Total Other Medical Education,Total Other Medical Education,Total Other Medical Education,No Description,No Description,No Description,No Description,No Description,No Description,No Description,No Description,No Description,No Description,No Description,No Description,No Description,No Description,No Description,No Description,No Description,No Description,No Description,No Description,No Description,No Description,No Description,No Description,No Description,No Description,"Number of patients in program at 
end of cost reporting period","Percentage of patients re-using
dialyzers",Average times dialyzers re-used,"Number of patients in program at 
end of cost reporting period",SNF,Renal Dialysis,Renal Dialysis,Total Nursing School,Renal Dialysis,Total Nursing School,Total,No Description,No Description,No Description,No Description,Adj for Occupational therapy in excess of li,No Description,Other Medicaid Days,No Description,Total Nonphysician Anesthetist Cost,Nursing School,No Description,No Description,Land,No Description,No Description,No Description,Adj for Speech therapy in excess of lim,No Description,No Description,Fixed Equipment,No Description,No Description,No Description,No Description,Subprovider II,Subprovider II,Subprovider II,Subprovider II,Subprovider II,Subprovider II,Subprovider II,Subprovider II,No Description,No Description,No Description,No Description,Adj for Respiratory therapy costs in excess,Maintenance of Personnel,Subprovider-IPF,No Description,No Description,No Description,Lung  Acquisition,Lung  Acquisition,Lung  Acquisition,Pancreas Acquisition,Lung  Acquisition,Renal Dialysis,Lung  Acquisition,Lung  Acquisition,Lung  Acquisition,Lung  Acquisition,Home Program Dialysis,Home Program Dialysis,Organ Procurement,No Description,Home Program Dialysis,Renal Dialysis,Home Program Dialysis,Total Nursing School,Total,No Description,No Description,No Description,No Description,No Description,No Description,No Description,Utilization,Renal Dialysis,Housekeeping under contract,Housekeeping under contract,Housekeeping under Contract,Housekeeping under Contract,No Description,No Description,Lung  Acquisition,No Description,Physician Part A,Physician Part A Teaching,Nursery,No Description,No Description,No Description,Home Program Dialysis,"Epoietin amount form worksheet A
for home dialysis program",No Description,No Description,No Description,No Description,No Description,No Description,No Description,No Description,No Description,PBP Clinical Lab Services Program Only,PBP Clinical Lab Services Program Only,PBP Clinical Lab Services Program Only,PBP Clinical Lab Services Program Only,PBP Clinical Lab Services Program Only,Renal Dialysis,Renal Dialysis,CAPD exchanges per day,Home Program Dialysis,No Description,No Description,No Description,No Description,No Description,Home Office:  Physician Part A,Home Office:  Physician Part A,Home Office:  Physician Part A,Home Office:  Physician Part A,Interns and residents,"Number of patients in program at 
end of cost reporting period","Number of days in year dialysis 
furnished",SNF,Renal Dialysis,Relief Payment,No Description,No Description,No Description,No Description,Total,No Description,No Description,No Description,Land,No Description,No Description,Subprovider-IRF,Total Subprovider I Interns & Residents,No Description,Subprovider 1,Intestinal Acquisition,Intestinal Acquisition,Intestinal Acquisition,Intestinal Acquisition,Intestinal Acquisition,Intestinal Acquisition,Kidney Acquisition,Liver Acquisition,Kidney Acquisition,Liver Acquisition,No Description,No Description,No Description,No Description,No Description,No Description,No Description,No Description,Maintenance of Personnel,Maintenance of Personnel,Maintenance of Personnel,No Description,No Description,Int & Res (non approved teaching program,No Description,No Description,No Description,Intestinal Acquisition,Heart Acquisition,Lung  Acquisition,Pancreas Acquisition,Intestinal Acquisition,Intestinal Acquisition,No Description,No Description,No Description,No Description,No Description,No Description,No Description,No Description,No Description,No Description,No Description,No Description,IPF,No Description,No Description,Physician Part A,Physician Part B,Interns & Residents,Home Program Dialysis,Home Program Dialysis,Home Program Dialysis,OLTC,No Description,No Description,Payment to cost ratio,No Description,No Description,No Description,No Description,No Description,No Description,No Description,No Description,No Description,No Description,No Description,No Description,No Description,No Description,Home Office Salaries & Wage Related Csts,No Description,No Description,No Description,No Description,No Description,No Description,No Description,No Description,No Description,No Description,No Description,No Description,No Description,No Description,No Description,No Description,No Description,No Description,No Description,No Description,No Description,No Description,No Description,No Description,No Description,No Description,No Description,No Description,No Description,No Description,No Description,No Description,No Description,No Description,Without Outliers:  Total Visits,Without Outliers:  Total Charges,W/Out Outliers:  Number of Episodes,Without Outliers:  Non Routine Med Sup Chgs,LUPA Episodes:  Total Visits,Total Charges:  LUPA Episodes,LUPA Episodes:  Total Number of Episodes,Total Visits,Total Charges,Total Number of Episodes,Total Non Routine Medical  Supply Charges,Land Improvements,No Description,NF,NF,NF,No Description,No Description,ESRD DME costs,Subprovider-IRF,No Description,No Description,No Description,Utilization Review-physicians compens,Utilization Review SNF,Utilization Review - Physician Compen,No Description,ICF,ICF,ICF,ICF,ICF,ICF,ICF,ICF,ICF,ICF,ICF,No Description,No Description,Ambulance Services,Ambulance Services,No Description,No Description,No Description,No Description,No Description,No Description,No Description,No Description,No Description,No Description,No Description,No Description,No Description,OLTC,OLTC,OLTC,No Description,No Description,Renal Dialysis,Premiums,Paid Losses,Self Insurance,No Description,"Percentage of patients re-using
dialyzers",Average times dialyzers re-used,No Description,No Description,No Description,No Description,No Description,No Description,No Description,"Number of patients in program at 
end of cost reporting period","Number of Times per week 
Patient receives Dialysis","Average patient dialysis time 
including setup",Number of stations,Donations,Intestinal Acquisition,ICF,IRF,No Description,No Description,No Description,No Description,No Description,LUPA:  Total Non Routine Med Sup Chgs,PEP Episodes:  Total Visits,PEP Episodes:  Total Charges:,PEP Episodes:  Total Number of Episodes,No Description,No Description,ICF,No Description,No Description,Total Other Medical Education Cost,Heart Acquisition,Lung  Acquisition,Pancreas Acquisition,Renal Dialysis,PBP Clinical Lab Services Program Only,Islet Acquisition,Islet Acquisition,Islet Acquisition,Islet Acquisition,Islet Acquisition,Islet Acquisition,Islet Acquisition,No Description,No Description,Home Program Dialysis,No Description,No Description,No Description,No Description,No Description,No Description,Subprovider-IRF,No Description,No Description,No Description,No Description,No Description,No Description,No Description,Islet Acquisition,Islet Acquisition,Organ Procurement,Organ Procurement,Renal Dialysis,Subprovider I,No Description,No Description,No Description,No Description,PEP:  Total Non Routine Med Supply Chgs,No Description,No Description,No Description,With Outliers:  Total Visits,With Outliers:  Total Charges,With Outliers:  Number of Episodes,Total Number of Outlier Episodes,No Description,No Description,No Description,Labor and Delivery Days Title 18,No Description,No Description,No Description,No Description,No Description,No Description,Organ acquisition,Organ acquisition charges,No Description,Physician Part A Teaching,No Description,Aggregate amount collected from patients,Amounts expected under 42 CFR,Medical and Other Services reimbursed by OPPS,Renal Dialysis,No Description,No Description,No Description,HHA 3 Provider Number,ASC 1 Provider Number,RHC 11 Provider Number,RHC 12 Provider Number,RHC 13 Provider Number,RHC 14 Provider Number,RHC 15 Provider Number,RHC 16 Provider Number,RHC 17 Provider Number,RHC 18 Provider Number,RHC 19 Provider Number,RHC 20 Provider Number,RHC 21 Provider Number,RHC 22 Provider Number,RHC 23 Provider Number,RHC 24 Provider Number,RHC 25 Provider Number,FQHC 2 Provider Number,FQHC 3 Provider Number,FQHC 4 Provider Number,FQHC 5 Provider Number,FQHC 6 Provider Number,FQHC 7 Provider Number,FQHC 8 Provider Number,FQHC 9 Provider Number,Beginning Date of SCH status,Ending Date of SCH status,MDH status beginning date  (MM/DD/YY),MDH status ending date (MM/DD/YY),Medicare Certified Pancreas TC term date,Medicare Certified Islet TC term date,Hospital Street Address,Hospital City,Hospital Zip Code,Hospital County,Hospital Name,Provider's actual MSA or CBSA,Hospital Title 18 Payment System (P/T/O),Type of Control of Hospital (See Table I),"Does the facility qualify and is it receiving payments for 
disproportionate share? (Y/N)","Is this a New Hospital under
42 CFR 412.300 PPS capital
(Y/N)",Does the hospital elect a fully prospective payment method for capital costs? (Y/N),"Is this a teaching hospital or
affiliated with a teaching hospital? (Y/N)",or allied health costs?,Is this a New Hospital under 42 CFR 413.40(f)(1)(I) (TEFRA)? (Y/N),Have you established a new subprovider excluded unit under 42 CFR 413.40(f)(1)(I)?(Y/N),Does the facility operate an ICF/MR facility for purposes of Title XIX? (Y/N),Does the hospital qualify as RPCH/CAH? (Y/N),"If this facility qualifies as a RPCH/CAH, has it elected the all inclusive payment for outpatient service? (Y/N)",No Description,Is this a rural hospital qualifying for an exception to the certified registered nurse anesthetist the CRNA fee schedule? (Y/N),Is this hospital an All-Inclusive rate provider? (Y/N),Is this hospital classified as a referral center? (Y/N),"Does this facility operate 
transplant center? (Y/N)","Are there any related organization or how office costs as defined in HCFA Pub. 15-I, chapter 10? (Y/N)",Are provider based physicians' costs included in Worksheet A? (Y/N),"If this Hospital is claiming cost for renal services on Worksheet A, are they inpatient services only? (Y/N)",IPF Provider Number,IPF Provider Number,FI/Contractor's Name,Home Office Name,Home Office Street,City,State,Zip Code,"If Line 32, Col 1 is yes, enter the method used: (A, B, or E only)",No Description,Hospital PO Box,NF Provider Number,No Description,No Description,Swing Bed SNF Provider Number,MDH status beginning date (MM/DD/YY),MDH status ending date (MM/DD/YY),IRF Provider Number,IRF Provider Number,SNF Provider Number,HHA 1 Provider Number,Hospice 1 Provider Number,Beginning Date of SCH status,Ending Date of SCH status,"Medicare certified kidney 
transplant center cert date",Swing Bed NF Provider Number,RHC 1 Provider Number,RHC 2 Provider Number,No Description,Home Office PO Box,Renal 1 Provider Number,RHC 3 Provider Number,RHC 4 Provider Number,RHC 5 Provider Number,MCP Physician Payment Method (Y/N),"Medicare certified heart
transplant center cert date","Medical certified liver 
transplant center cert date",Renal 2 Provider Number,Hospice 2 Provider Number,Initial Physician Payment Method (Y/N),"Medical certified lung
transplant center cert date","If an Organ Procurement Organization, enter the OPO number",CMHC 1 Provider Number,certification date,RHC 6 Provider Number,RHC 7 Provider Number,RHC 8 Provider Number,RHC 9 Provider Number,RHC 10 Provider Number,Renal 3 Provider Number,Renal 4 Provider Number,Renal 5 Provider Number,HHA 2 Provider Number,Medicare Certified Kidney TC term date,Medicare Certified Heart TC term date,Medicare Certified Liver TC term date,Renal 6 Provider Number,FQHC 1 Provider Number,ICF Provider Number,Renal 7 Provider Number,Renal 8 Provider Number,Renal 9 Provider Number,Renal 10 Provider Number,certification date,Medicare Certified Lung TC term date,Blood Clotting Factors for Hemoph.,Blood Clotting Factors for Hemoph.,Blood Clotting Factors for Hemoph.,HHA,ASC (Distinct Part),Hospice,FQHC,CMHC,HHA,ASC (Distinct Part),Hospice,FQHC,CMHC,Blood Clotting Factors for Hemoph.,Blood Clotting Factors for Hemoph.,Respiratory Therapy,Occupational Therapy,Speech Pathology,Blood Clotting Factors for Hemoph.,OPT,OOT,OSP,Blood Clotting Factors for Hemoph.,FQHC,Blood Clotting Factors for Hemoph.,Coronary Care Unit,Surgical Intensive Care Unit,Other Special Care Unit,Durable Medical Equipment Rented,Durable Medical Equipment Rented,No Description,Blood Clotting Factors for Hemoph.,Drugs Charged to Patients,Other Ancillary,Emergency,Radioisotope,Whole Blood & Packed Red Blood Cells,Occupational Therapy,Speech Pathology,Medical Supplies Charged to Patients,Impl. Dev. Charged to Patients,Blood Clotting Factors for Hemoph.,RHC,FQHC,Other Reimbursable,Delivery Room and Labor Room,Anesthesiology,Radiology-Therapeutic,Radioisotope,Cardiac Catheterization,Laboratory,Intravenous Therapy,Physical Therapy,Occupational Therapy,Speech Pathology,Electrocardiology,Electroencephalography,Medical Supplies Charged to Patients,Impl. Dev. Charged to Patients,Drugs Charged to Patients,Other Ancillary,RHC,FQHC,Other Outpatient Services,Medical Supplies Charged to Patients,Recovery Room,Radiology-Therapeutic,Radioisotope,MRI,Cardiac Catheterization,Whole Blood & Packed Red Blood Cells,"Blood Storing, Processing, Trans",Intravenous Therapy,Respiratory Therapy,Physical Therapy,Occupational Therapy,Speech Pathology,ASC (Non Distinct Part),Other Ancillary,Observation Beds (Distinct Unit),Other Outpatient Services,Recovery Room,Anesthesiology,Radiology-Therapeutic,CT Scan,MRI,Cardiac Catheterization,Whole Blood & Packed Red Blood Cells,"Blood Storing, Processing, Trans",Physical Therapy,Speech Pathology,Electroencephalography,Medical Supplies Charged to Patients,Impl. Dev. Charged to Patients,ASC (Non Distinct Part),Other Ancillary,Delivery Room and Labor Room,MRI,Whole Blood & Packed Red Blood Cells,Intravenous Therapy,Electrocardiology,Impl. Dev. Charged to Patients,ASC (Non Distinct Part),Observation Beds (Distinct Unit),Drugs Charged to Patients,Blood Clotting Factors for Hemoph.,Blood Clotting Factors for Hemoph.,Durable Medical Equipment Rented,Other Reimbursable,Blood Clotting Factors for Hemoph.,Blood Clotting Factors for Hemoph.,Durable Medical Equipment Rented,Other Reimbursable,No Description,Outpatient Rehab Provider,Burn Intensive Care Unit,Surgical Intensive Care Unit,No Description,No Description,CMHC,Outpatient Rehab Provider,Outpatient Rehab Provider,HHA,New Cap Related Csts Bldg & Fixtures,New Cap Related Csts Movable Equipment,New Cap Related Csts Bldg & Fixtures,New Cap Related Csts Movable Equipment,New Cap Related Csts Bldg & Fixtures,New Cap Related Csts Movable Equipment,Other Adjustments (Summed),Pharmacy,Medical Records and Medical Rec. Library,Social Service,Administrative and General,Respiratory Therapy,Physical Therapy,Occupational Therapy,Electrocardiology,Housekeeping,New Capital Buildings and Fixtures,Dietary,Pharmacy,Medical Records and Medical Rec. Library,Social Service,New Capital Equipment,Employee Benefits,Administrative and General,Operating Room,Recovery Room,Anesthesiology,Radiology-Diagnostic,Radiology-Therapeutic,Laboratory,"Blood Storing, Processing, Trans",Respiratory Therapy,Physical Therapy,Occupational Therapy,Speech Pathology,Electrocardiology,Operation of Plant,Electroencephalography,Medical Supplies Charged to Patients,Drugs Charged to Patients,Housekeeping,Pharmacy,Medical Records and Medical Rec. Library,Social Service,Administrative and General,New Capital Buildings and Fixtures,Dietary,Pharmacy,Medical Records and Medical Rec. Library,Social Service,New Capital Equipment,Employee Benefits,Administrative and General,Operating Room,Recovery Room,Anesthesiology,Radiology-Diagnostic,Radiology-Therapeutic,CT Scan,MRI,Laboratory,"Blood Storing, Processing, Trans",Intravenous Therapy,Respiratory Therapy,Physical Therapy,Occupational Therapy,Speech Pathology,Electrocardiology,Operation of Plant,Electroencephalography,Medical Supplies Charged to Patients,Impl. Dev. Charged to Patients,Drugs Charged to Patients,Housekeeping,Clinic,Emergency,Operating Room,Recovery Room,Anesthesiology,Radiology-Diagnostic,Radiology-Therapeutic,CT Scan,MRI,Laboratory,"Blood Storing, Processing, Trans",Intravenous Therapy,Respiratory Therapy,Physical Therapy,Occupational Therapy,Speech Pathology,Electrocardiology,Electroencephalography,Medical Supplies Charged to Patients,Impl. Dev. Charged to Patients,Drugs Charged to Patients,Clinic,Emergency,Operating Room,Recovery Room,Anesthesiology,Radiology-Diagnostic,Radiology-Therapeutic,CT Scan,MRI,Laboratory,"Blood Storing, Processing, Trans",Intravenous Therapy,Respiratory Therapy,Physical Therapy,Occupational Therapy,Speech Pathology,Electrocardiology,Electroencephalography,Medical Supplies Charged to Patients,Impl. Dev. Charged to Patients,Drugs Charged to Patients,Clinic,Emergency,Operating Room,Recovery Room,Anesthesiology,Radiology-Diagnostic,Radiology-Therapeutic,CT Scan,MRI,Laboratory,"Blood Storing, Processing, Trans",Intravenous Therapy,Respiratory Therapy,Physical Therapy,Occupational Therapy,Speech Pathology,Electrocardiology,Electroencephalography,Medical Supplies Charged to Patients,Impl. Dev. Charged to Patients,Drugs Charged to Patients,Clinic,Emergency,Operating Room,Recovery Room,Anesthesiology,Radiology-Diagnostic,Radiology-Therapeutic,CT Scan,MRI,Laboratory,"Blood Storing, Processing, Trans",Intravenous Therapy,Respiratory Therapy,Physical Therapy,Occupational Therapy,Speech Pathology,Electrocardiology,Electroencephalography,Medical Supplies Charged to Patients,Impl. Dev. Charged to Patients,Drugs Charged to Patients,Clinic,Emergency,Operating Room,Recovery Room,Anesthesiology,Radiology-Diagnostic,Radiology-Therapeutic,CT Scan,MRI,Laboratory,"Blood Storing, Processing, Trans",Intravenous Therapy,Respiratory Therapy,Physical Therapy,Occupational Therapy,Speech Pathology,Electrocardiology,Electroencephalography,Medical Supplies Charged to Patients,Impl. Dev. Charged to Patients,Drugs Charged to Patients,Clinic,Emergency,Operating Room,Recovery Room,Anesthesiology,Radiology-Diagnostic,Radiology-Therapeutic,CT Scan,MRI,Laboratory,"Blood Storing, Processing, Trans",Intravenous Therapy,Respiratory Therapy,Physical Therapy,Occupational Therapy,Speech Pathology,Electrocardiology,Electroencephalography,Medical Supplies Charged to Patients,Impl. Dev. Charged to Patients,Drugs Charged to Patients,Clinic,Emergency,No Description,No Description,No Description,No Description,No Description,No Description,No Description,No Description,No Description,No Description,No Description,No Description,No Description,No Description,No Description,No Description,No Description,No Description,No Description,No Description,No Description,Operating Room,Recovery Room,Anesthesiology,Radiology-Diagnostic,Radiology-Therapeutic,CT Scan,MRI,Laboratory,"Blood Storing, Processing, Trans",Intravenous Therapy,Respiratory Therapy,Physical Therapy,Occupational Therapy,Speech Pathology,Electrocardiology,Electroencephalography,Medical Supplies Charged to Patients,Impl. Dev. Charged to Patients,Drugs Charged to Patients,Clinic,Emergency,No Description,No Description,No Description,No Description,No Description,No Description,No Description,No Description,No Description,No Description,No Description,No Description,No Description,No Description,No Description,No Description,No Description,No Description,No Description,No Description,No Description,No Description,No Description,No Description,No Description,No Description,No Description,New Cap Related Csts Bldg & Fixtures,New Cap Related Csts Bldg & Fixtures,New Cap Related Csts Movable Equipment,Dietary,Nursing Administration,Other General Service,Other Nonreimbursable,Operation of Plant,Clinic,Nursing Administration,Other General Service,Other Nonreimbursable,Laundry and Linen Service,Clinic,New Capital Buildings and Fixtures,Cafeteria,Other Nonreimbursable,Clinic,Cafeteria,Nursing Administration,Other General Service,Other Nonreimbursable,Laundry and Linen Service,"Gift, Flower, Coffee Shop, Canteen",Other Nonreimbursable,"Gift, Flower, Coffee Shop, Canteen",Other Nonreimbursable,Clinic,No Description,No Description,No Description,No Description,No Description,No Description,No Description,No Description,Other Reimbursable,Central Services and Supply,Maintenance and Repairs,Other Reimbursable,New Capital Equipment,Employee Benefits,Other Reimbursable,Central Services and Supply,Maintenance and Repairs,Other Reimbursable,Other Reimbursable,Other Reimbursable,Other Reimbursable,Other Reimbursable,Drugs Charged to Patients,Other Reimbursable,Drugs Charged to Patients,Other Reimbursable,Drugs Charged to Patients,Other Reimbursable,No Description,No Description,No Description,Employee Benefits,Radiology-Diagnostic,Maintenance and Repairs,Laboratory,Laundry and Linen Service,Operation of Plant,Nonpaid Workers,Nonpaid Workers,Dietary,Research,Research,Clinic,Clinic,Clinic,Research,Maintenance and Repairs,Research,Interns & Res Salary and Fringe Benefits,Interns & Res Salary and Fringe Benefits,Clinic,Clinic,Operating Room,Delivery Room and Labor Room,Delivery Room and Labor Room,Nursing Administration,Central Services and Supply,Delivery Room and Labor Room,Laundry and Linen Service,Housekeeping,Delivery Room and Labor Room,Delivery Room and Labor Room,Delivery Room and Labor Room,Delivery Room and Labor Room,Delivery Room and Labor Room,Operating Room,Delivery Room and Labor Room,Radiology-Diagnostic,Laboratory,Medical Supplies Charged to Patients,Drugs Charged to Patients,Operating Room,Operating Room,Operating Room,No Description,No Description,No Description,Speech Pathology,Drugs Charged to Patients,CT Scan,MRI,Physical Therapy,Occupational Therapy,Speech Pathology,Electrocardiology,Drugs Charged to Patients,Respiratory Therapy,Electrocardiology,Radiology-Diagnostic,Laboratory,Respiratory Therapy,Electrocardiology,Radiology-Diagnostic,Laboratory,Respiratory Therapy,Electrocardiology,Radiology-Diagnostic,Laboratory,Respiratory Therapy,Electrocardiology,No Description,No Description,New Cap Related Csts Bldg & Fixtures,New Cap Related Csts Movable Equipment,Other Ancillary,Other Ancillary,Radiology-Diagnostic,Other Ancillary,Other Ancillary,Other Ancillary,Other Ancillary,No Description,New Cap Related Csts Bldg & Fixtures,New Cap Related Csts Movable Equipment,Central Services and Supply,Intensive Care Unit,Intensive Care Unit,Operating Room,Laboratory,Respiratory Therapy,Intensive Care Unit,Intensive Care Unit,Intensive Care Unit,Intensive Care Unit,Intensive Care Unit,Physical Therapy,Intensive Care Unit Program Cost,Intensive Care Unit,Intensive Care Unit,Intensive Care Unit,Intensive Care Unit,Radiology-Diagnostic,Respiratory Therapy,Radiology-Diagnostic,Respiratory Therapy,No Description,No Description,Intensive Care Unit,Intensive Care Unit,Intensive Care Unit,Intensive Care Unit,"Gift, Flower, Coffee Shop, Canteen",Coronary Care Unit,Surgical Intensive Care Unit,Recovery Room,Anesthesiology,Radioisotope,CT Scan,MRI,Cardiac Catheterization,Intravenous Therapy,Electroencephalography,Emergency,"Gift, Flower, Coffee Shop, Canteen",Coronary Care Unit,Surgical Intensive Care Unit,Radioisotope,Cardiac Catheterization,Intravenous Therapy,Emergency,Nonphysician Anesthetists,CT Scan,Cardiac Catheterization,Electroencephalography,Emergency,"Gift, Flower, Coffee Shop, Canteen",Paramedical Education,Coronary Care Unit,Surgical Intensive Care Unit,Radioisotope,Cardiac Catheterization,Physicians' Private Office,Coronary Care Unit,Surgical Intensive Care Unit,Radioisotope,Cardiac Catheterization,Physicians' Private Office,Coronary Care Unit,Surgical Intensive Care Unit,Radioisotope,Cardiac Catheterization,Coronary Care Unit,Surgical Intensive Care Unit,Radioisotope,Cardiac Catheterization,Coronary Care Unit,Surgical Intensive Care Unit,Radioisotope,Cardiac Catheterization,Recovery Room,Anesthesiology,Radioisotope,CT Scan,MRI,Cardiac Catheterization,Intravenous Therapy,Electroencephalography,Impl. Dev. Charged to Patients,Emergency,Coronary Care Unit,Surgical Intensive Care Unit,Delivery Room and Labor Room,Radioisotope,Cardiac Catheterization,Delivery Room and Labor Room,Radioisotope,Cardiac Catheterization,Coronary Intensive Care Unit,Surgical Intensive Care Unit,Coronary Intensive Care Unit,Surgical Intensive Care Unit,Coronary Intensive Care Unit,Surgical Intensive Care Unit,No Description,No Description,No Description,Delivery Room and Labor Room,Radioisotope,Cardiac Catheterization,Operating Room,Recovery Room,Delivery Room and Labor Room,Anesthesiology,Radioisotope,CT Scan,MRI,Cardiac Catheterization,Intravenous Therapy,Physical Therapy,Electroencephalography,Medical Supplies Charged to Patients,Impl. Dev. Charged to Patients,Emergency,Operating Room,Operating Room,Recovery Room,Delivery Room and Labor Room,Anesthesiology,Radioisotope,CT Scan,MRI,Cardiac Catheterization,Intravenous Therapy,Physical Therapy,Electroencephalography,Medical Supplies Charged to Patients,Impl. Dev. Charged to Patients,Emergency,Drugs Charged to Patients,Laboratory,Impl. Dev. Charged to Patients,Drugs Charged to Patients,Recovery Room,Delivery Room and Labor Room,Anesthesiology,Radioisotope,CT Scan,MRI,Cardiac Catheterization,Intravenous Therapy,Physical Therapy,Electroencephalography,Medical Supplies Charged to Patients,Impl. Dev. Charged to Patients,Emergency,Drugs Charged to Patients,Laboratory,Impl. Dev. Charged to Patients,Drugs Charged to Patients,No Description,No Description,No Description,No Description,No Description,Surgical Intensive Care Unit,Coronary Care Unit,Surgical Intensive Care Unit,Coronary Care Unit,Surgical Intensive Care Unit,Coronary Care Unit,Surgical Intensive Care Unit,Intensive Care Unit,Coronary Care Unit,Surgical Intensive Care Unit,Coronary Care Unit,Medical Supplies Charged to Patients,Medical Supplies Charged to Patients,Physicians' Private Office,Other Ancillary,Occupational Therapy,Speech Pathology,Other Ancillary,Other Ancillary,Other Ancillary,No Description,Other Ancillary,Other Ancillary,Other Ancillary,Other Ancillary,Whole Blood & Packed Red Blood Cells,Anesthesiology,Whole Blood & Packed Red Blood Cells,Whole Blood & Packed Red Blood Cells,Whole Blood & Packed Red Blood Cells,Whole Blood & Packed Red Blood Cells,Whole Blood & Packed Red Blood Cells,Whole Blood & Packed Red Blood Cells,Whole Blood & Packed Red Blood Cells,Whole Blood & Packed Red Blood Cells,Whole Blood & Packed Red Blood Cells,No Description,Whole Blood & Packed Red Blood Cells,Whole Blood & Packed Red Blood Cells,Whole Blood & Packed Red Blood Cells,Radiology-Diagnostic,Whole Blood & Packed Red Blood Cells,Radiology-Diagnostic,No Description,No Description,HHA,Physicians' Private Office,Physicians' Private Office,Interns & Res Other Program Costs,Intensive Care Unit,Interns & Res Other Program Costs,Operating Room,Recovery Room,Anesthesiology,Radiology-Diagnostic,Radioisotope,Laboratory,Respiratory Therapy,Physical Therapy,Occupational Therapy,Speech Pathology,Electrocardiology,Medical Supplies Charged to Patients,Impl. Dev. Charged to Patients,Drugs Charged to Patients,Emergency,Operating Room,Recovery Room,Anesthesiology,Radiology-Diagnostic,Radioisotope,Laboratory,Respiratory Therapy,Physical Therapy,Occupational Therapy,Speech Pathology,Electrocardiology,Medical Supplies Charged to Patients,Impl. Dev. Charged to Patients,Drugs Charged to Patients,Emergency,Operating Room,Recovery Room,Anesthesiology,Radiology-Diagnostic,Radioisotope,Laboratory,Respiratory Therapy,Physical Therapy,Occupational Therapy,Speech Pathology,Electrocardiology,Medical Supplies Charged to Patients,Impl. Dev. Charged to Patients,Drugs Charged to Patients,Clinic,Operating Room,Recovery Room,Anesthesiology,Radiology-Diagnostic,Radioisotope,Laboratory,Respiratory Therapy,Physical Therapy,Occupational Therapy,Speech Pathology,Electrocardiology,Medical Supplies Charged to Patients,Impl. Dev. Charged to Patients,Drugs Charged to Patients,Clinic,No Description,No Description,No Description,No Description,No Description,No Description,No Description,No Description,No Description,No Description,No Description,No Description,No Description,No Description,No Description,No Description,No Description,No Description,No Description,No Description,No Description,No Description,No Description,No Description,No Description,No Description,No Description,No Description,No Description,No Description,Occupational Therapy,Occupational Therapy,Occupational Therapy,No Description,Hospice,HHA,Hospice,HHA,Hospice,HHA,Hospice,HHA,Hospice,HHA,Hospice,Radiology-Diagnostic,Laboratory,Physical Therapy,Occupational Therapy,Speech Pathology,Medical Supplies Charged to Patients,Drugs Charged to Patients,Radiology-Diagnostic,Laboratory,Physical Therapy,Occupational Therapy,Speech Pathology,Medical Supplies Charged to Patients,Drugs Charged to Patients,HHA,Hospice,HHA,New Cap Related Csts Movable Equipment,Paramedical Education,Other Special Care Unit,Radiology-Therapeutic,ASC (Non Distinct Part),Paramedical Education,Other Special Care Unit,ASC (Non Distinct Part),Interns & Res Other Program Costs,Paramedical Education,Other Special Care Unit,Radiology-Therapeutic,Radioisotope,ASC (Non Distinct Part),Other Special Care Unit,ASC (Non Distinct Part),Intensive Care Unit,Operating Room,Laboratory,Other Special Care Unit,ASC (Non Distinct Part),Other Special Care Unit,ASC (Non Distinct Part),Other Special Care Unit,ASC (Non Distinct Part),Other Special Care Unit,ASC (Non Distinct Part),Radiology-Therapeutic,ASC (Non Distinct Part),ASC (Non Distinct Part),ASC (Non Distinct Part),CT Scan,MRI,Clinic,CT Scan,MRI,Clinic,Radiology-Therapeutic,CT Scan,MRI,Electroencephalography,ASC (Non Distinct Part),Emergency,Radiology-Therapeutic,CT Scan,MRI,Electroencephalography,ASC (Non Distinct Part),Emergency,Other Special Care Unit,No Description,No Description,No Description,No Description,No Description,No Description,No Description,No Description,No Description,No Description,Intensive Care Unit,ASC (Non Distinct Part),Radiology-Therapeutic,ASC (Non Distinct Part),Radiology-Therapeutic,ASC (Non Distinct Part),Impl. Dev. Charged to Patients,Emergency,Radiology-Therapeutic,ASC (Non Distinct Part),Impl. Dev. Charged to Patients,Emergency,No Description,No Description,Other Special Care,Other Special Care,Other Special Care,Other Special Care,Laboratory,Laboratory,Physicians' Private Office,HHA,Whole Blood & Packed Red Blood Cells,Durable Medical Equipment Sold,Durable Medical Equipment Sold,Durable Medical Equipment Sold,Durable Medical Equipment Sold,Durable Medical Equipment Sold,Durable Medical Equipment Sold,Durable Medical Equipment Sold,Whole Blood & Packed Red Blood Cells,Electrocardiology,Whole Blood & Packed Red Blood Cells,Electrocardiology,RHC,Other Outpatient Services,RHC,Other Outpatient Services,RHC,Other Outpatient Services,RHC,Other Outpatient Services,RHC,Other Outpatient Services,RHC,Other Outpatient Services,RHC,Other Outpatient Services,Operating Room,Physical Therapy,Speech Pathology,Electrocardiology,Medical Supplies Charged to Patients,Other Outpatient Services,Operating Room,Physical Therapy,Speech Pathology,Electrocardiology,Medical Supplies Charged to Patients,Other Outpatient Services,No Description,RHC/FQHC Combined,RHC/FQHC Combined,RHC/FQHC Combined,RHC/FQHC Combined,Nonphysician Anesthetists,Nonphysician Anesthetists,Impl. Dev. Charged to Patients,Nonphysician Anesthetists,RHC,RHC,Respiratory Therapy,Clinic,Emergency,Respiratory Therapy,Clinic,Emergency,Anesthesiology,Anesthesiology,Anesthesiology,Clinic,Anesthesiology,Clinic,No Description,No Description,Observation Beds (Distinct Unit),No Description,Observation Beds (Distinct Unit),Observation Beds (Distinct Unit),Observation Beds (Distinct Unit),Observation Beds (Distinct Unit),Observation Beds (Distinct Unit),Observation Beds (Distinct Unit),Observation Beds (Distinct Unit),Observation Beds (Distinct Unit),No Description,Observation Beds (Distinct Unit),Observation Beds (Distinct Unit),Observation Beds (Distinct Unit),Observation Beds (Distinct Unit),No Description,HHA,HHA,Other Ancillary,HHA,"Blood Storing, Processing, Trans","Blood Storing, Processing, Trans","Blood Storing, Processing, Trans","Blood Storing, Processing, Trans",Nonpaid Workers,Nonpaid Workers,Other adjustments,"Gift, Flower, Coffee Shop, Canteen",MRI,Other Outpatient Services,Other General Service,Occupational Therapy,Occupational Therapy,Research,Hospice,Hospice,Recovery Room,"Blood Storing, Processing, Trans",Recovery Room,"Blood Storing, Processing, Trans",No Description,No Description,Intensive Care Unit,Interns & Res Salary and Fringe Benefits,"Blood Storing, Processing, Trans",Interns & Res Salary and Fringe Benefits,Interns & Res Salary and Fringe Benefits,Recovery Room,"Blood Storing, Processing, Trans",Intravenous Therapy,Other Nonreimbursable,Intensive Care Unit,Operating Room,Recovery Room,Delivery Room and Labor Room,Anesthesiology,Radiology-Diagnostic,Radiology-Therapeutic,Radioisotope,CT Scan,MRI,Cardiac Catheterization,Laboratory,"Blood Storing, Processing, Trans",Respiratory Therapy,Electrocardiology,Electroencephalography,Emergency,Other Nonreimbursable,Recovery Room,Delivery Room and Labor Room,Anesthesiology,Radiology-Diagnostic,Radiology-Therapeutic,Radioisotope,CT Scan,MRI,Cardiac Catheterization,"Blood Storing, Processing, Trans",Respiratory Therapy,Electrocardiology,Electroencephalography,Emergency,Recovery Room,Delivery Room and Labor Room,Radiology-Diagnostic,Radiology-Therapeutic,CT Scan,MRI,Cardiac Catheterization,Laboratory,Intravenous Therapy,Electroencephalography,Drugs Charged to Patients,Clinic,Emergency,Recovery Room,Delivery Room and Labor Room,Anesthesiology,Radiology-Diagnostic,Radiology-Therapeutic,CT Scan,MRI,Cardiac Catheterization,Laboratory,Intravenous Therapy,Drugs Charged to Patients,Clinic,Emergency,Recovery Room,Delivery Room and Labor Room,Anesthesiology,Radiology-Diagnostic,Radiology-Therapeutic,CT Scan,MRI,Cardiac Catheterization,Laboratory,Intravenous Therapy,Electroencephalography,Drugs Charged to Patients,Clinic,Emergency,Delivery Room and Labor Room,Radiology-Therapeutic,Radioisotope,CT Scan,MRI,Cardiac Catheterization,Intravenous Therapy,Electroencephalography,Delivery Room and Labor Room,Radiology-Therapeutic,Radioisotope,CT Scan,MRI,Cardiac Catheterization,Intravenous Therapy,Electroencephalography,No Description,No Description,No Description,Hospice,Hospice,Hospice,Other Special Purpose,Other Special Purpose,Other Special Purpose,No Description,No Description,Whole Blood & Packed Red Blood Cells,Whole Blood & Packed Red Blood Cells,Other Ancillary,Emergency,Other Ancillary,Emergency,Maintenance of Personnel,Maintenance of Personnel,Maintenance of Personnel,Nonpaid Workers,Burn Intensive Care Unit,Burn Intensive Care Unit,Burn Intensive Care Unit,Burn Intensive Care Unit,Burn Intensive Care Unit,Burn Intensive Care Unit,Burn Intensive Care Unit,Burn Intensive Care Unit,Burn Intensive Care Unit,Burn Intensive Care Unit,Burn Intensive Care Unit,No Description,Burn Intensive Care Unit,Burn Intensive Care Unit,Burn Intensive Care Unit,Burn Intensive Care Unit,Hospice,Hospice,ASC (Non Distinct Part),ASC (Non Distinct Part),Radiology-Therapeutic,Cardiac Catheterization,"Blood Storing, Processing, Trans",Intravenous Therapy,Other Ancillary,Radiology-Therapeutic,Cardiac Catheterization,"Blood Storing, Processing, Trans",Intravenous Therapy,Other Ancillary,No Description,No Description,No Description,No Description,No Description,Radiology-Therapeutic,CT Scan,MRI,Intravenous Therapy,Electrocardiology,Clinic,Radiology-Therapeutic,CT Scan,MRI,Intravenous Therapy,Electrocardiology,Clinic,Anesthesiology,Anesthesiology,Durable Medical Equipment Rented,Durable Medical Equipment Rented,Durable Medical Equipment Rented,Durable Medical Equipment Rented,Durable Medical Equipment Rented,Other Reimbursable,Durable Medical Equipment Rented,Other Reimbursable,Other Reimbursable,No Description,No Description,No Description,Other Special Purpose,Cafeteria,Other Organ Acquisition,Cafeteria,Other Organ Acquisition,Other Organ Acquisition,Research,Coronary Care Unit,Other Organ Acquisition,Research,Coronary Care Unit,Surgical Intensive Care Unit,Other Special Care Unit,Physical Therapy,ASC (Non Distinct Part),Research,Coronary Care Unit,Surgical Intensive Care Unit,Other Special Care Unit,Physical Therapy,ASC (Non Distinct Part),Other Organ Acquisition,Other Organ Acquisition,Other Organ Acquisition,Other Organ Acquisition,Other Organ Acquisition,Coronary Care Unit Program Cost,Delivery Room and Labor Room,Electroencephalography,Delivery Room and Labor Room,Electroencephalography,Cardiac Catheterization,"Blood Storing, Processing, Trans",Other Ancillary,Cardiac Catheterization,"Blood Storing, Processing, Trans",Other Ancillary,No Description,No Description,No Description,No Description,No Description,Coronary Care Unit,Surgical Intensive Care Unit,ASC (Non Distinct Part),Speech Pathology,ASC (Non Distinct Part),ASC (Non Distinct Part),Operating Room,Emergency,Operating Room,Radiology-Therapeutic,Speech Pathology,Speech Pathology,Interns & Res Other Program Costs,Durable Medical Equipment Sold,Durable Medical Equipment Sold,Durable Medical Equipment Sold,Durable Medical Equipment Sold,Cardiac Catheterization,Cardiac Catheterization,HHA,Hospice,RHC/FQHC Combined,Other Outpatient Services,Other Outpatient Services,Radiology-Diagnostic,CT Scan,MRI,Radiology-Diagnostic,CT Scan,MRI,Radiology-Diagnostic,CT Scan,MRI,Other Outpatient Services,Medical Supplies Charged to Patients,Other Outpatient Services,Medical Supplies Charged to Patients,Hospice,Nursing School,Nursing School,FQHC,FQHC,FQHC,HHA,Impl. Dev. Charged to Patients,Impl. Dev. Charged to Patients,Operating Room,Delivery Room and Labor Room,Emergency,Emergency,Radiology-Diagnostic,Whole Blood & Packed Red Blood Cells,Whole Blood & Packed Red Blood Cells,No Description,Other Outpatient Services,Other Outpatient Services,Other Outpatient Services,No Description,Other Outpatient Services,Other Special Purpose,Other Special Purpose,Other Special Purpose,Other Special Purpose,Nonpaid Workers,No Description,"Blood Storing, Processing, Trans",Electroencephalography,Other Ancillary,"Blood Storing, Processing, Trans",Electroencephalography,Other Ancillary,No Description,Operating Room,No Description,No Description,Durable Medical Equipment Rented,Operating Room,Operating Room,Maintenance of Personnel,No Description,No Description,Durable Medical Equipment Rented,Other Special Purpose,No Description,Physical Therapy,Anesthesiology,Anesthesiology,Other Outpatient Services,Other Outpatient Services,No Description,No Description,Operating Room,Operating Room,Intensive Care Unit,Radiology-Therapeutic,CT Scan,MRI,Radiology-Therapeutic,CT Scan,MRI,Respiratory Therapy,Respiratory Therapy,Nursing School,Intravenous Therapy,Medical Supplies Charged to Patients,Drugs Charged to Patients,Speech Pathology,Drugs Charged to Patients,Burn Intensive Care Unit Program Cost,Surgical Intensive Care Unit Program Cost,ASC (Non Distinct Part),ASC (Non Distinct Part),No Description,Burn Intensive Care Unit,Radioisotope,"Blood Storing, Processing, Trans",Respiratory Therapy,Physical Therapy,Electrocardiology,Medical Supplies Charged to Patients,Radioisotope,"Blood Storing, Processing, Trans",Respiratory Therapy,Physical Therapy,Electrocardiology,Electroencephalography,Medical Supplies Charged to Patients,Recovery Room,Anesthesiology,Radiology-Diagnostic,Radiology-Therapeutic,MRI,Respiratory Therapy,Physical Therapy,Electrocardiology,Electroencephalography,ASC (Non Distinct Part),Clinic,Radioisotope,"Blood Storing, Processing, Trans",Respiratory Therapy,Physical Therapy,Electrocardiology,Medical Supplies Charged to Patients,ASC (Non Distinct Part),Recovery Room,Electroencephalography,Radioisotope,Burn Intensive Care Unit,Nursing School,Intensive Care Unit,Delivery Room and Labor Room,Cardiac Catheterization,Delivery Room and Labor Room,Cardiac Catheterization,"Gift, Flower, Coffee Shop, Canteen",Physicians' Private Office,Other Ancillary,"Gift, Flower, Coffee Shop, Canteen",Physicians' Private Office,Other Ancillary,Other Outpatient Services,Burn Intensive Care Unit,Other Special Care Unit,Other Special Care Unit,Other Special Care Unit,Other Special Care Unit,Other Outpatient Services,Other Ancillary,Other Outpatient Services,Other Special Care,Whole Blood & Packed Red Blood Cells,Whole Blood & Packed Red Blood Cells,No Description,Surgical Intensive Care Unit,Burn Intensive Care Unit,Burn Intensive Care Unit,Intravenous Therapy,Intravenous Therapy,No Description,Respiratory Therapy,Clinic,Observation Beds (Distinct Unit),Observation Beds (Distinct Unit),Occupational Therapy,Occupational Therapy,Radioisotope,Radioisotope,Other Reimbursable,Other Reimbursable,No Description,Other Reimbursable,Other Ancillary,Other Ancillary,Coronary Care Unit,Laboratory,Drugs Charged to Patients,Observation Beds (Distinct Unit),Radioisotope,Radioisotope,Impl. Dev. Charged to Patients,Delivery Room and Labor Room,Delivery Room and Labor Room,No Description,Clinic,ASC (Distinct Part),ASC (Distinct Part),ASC (Distinct Part),Recovery Room,ASC (Non Distinct Part),Recovery Room,ASC (Non Distinct Part),"Blood Storing, Processing, Trans",Anesthesiology,Laboratory,"Blood Storing, Processing, Trans",Anesthesiology,Laboratory,"Blood Storing, Processing, Trans",ASC (Non Distinct Part),Operating Room,Anesthesiology,"Blood Storing, Processing, Trans",Emergency,ASC (Distinct Part),ASC (Distinct Part),ASC (Distinct Part),ASC (Distinct Part),ASC (Distinct Part),Durable Medical Equipment Rented,No Description,Speech Pathology,Speech Pathology,Intravenous Therapy,Intravenous Therapy,Whole Blood & Packed Red Blood Cells,Whole Blood & Packed Red Blood Cells,Speech Pathology,Whole Blood & Packed Red Blood Cells,Radiology-Diagnostic,FQHC,FQHC,FQHC,Other Ancillary,Other Ancillary,Occupational Therapy,Occupational Therapy,Occupational Therapy,FQHC,Intensive Care Unit,Drugs Charged to Patients,Drugs Charged to Patients,Durable Medical Equipment Sold,Other Outpatient Services,Other Outpatient Services,Recovery Room,"Blood Storing, Processing, Trans",Physical Therapy,Occupational Therapy,Speech Pathology,Recovery Room,"Blood Storing, Processing, Trans",Physical Therapy,Occupational Therapy,Speech Pathology,Delivery Room and Labor Room,Delivery Room and Labor Room,Laboratory,Intensive Care Unit,Other Outpatient Services,Respiratory Therapy,Physical Therapy,Occupational Therapy,Speech Pathology,Durable Medical Equipment Sold,Durable Medical Equipment Sold,No Description,Durable Medical Equipment Sold,Blood Clotting Factors for Hemoph.,Blood Clotting Factors for Hemoph.,Blood Clotting Factors for Hemoph.,CORF,CORF,CORF,CORF,CORF,CORF,CORF,CORF,Other Outpatient Services,Other Outpatient Services,Outpatient Rehab Provider,Other Ancillary,Other Ancillary,Other Ancillary,Other Outpatient Services,Other Outpatient Services,No Description,CT Scan,CT Scan,No Description,RHC,RHC,RHC/FQHC Combined,CORF,No Description,Radiology-Diagnostic,Respiratory Therapy,Emergency,Whole Blood & Packed Red Blood Cells,Impl. Dev. Charged to Patients,Whole Blood & Packed Red Blood Cells,Impl. Dev. Charged to Patients,Impl. Dev. Charged to Patients,Respiratory Therapy,Electrocardiology,Electroencephalography,Impl. Dev. Charged to Patients,Drugs Charged to Patients,Operating Room,Delivery Room and Labor Room,CT Scan,Laboratory,Electroencephalography,Medical Supplies Charged to Patients,Impl. Dev. Charged to Patients,Drugs Charged to Patients,Radioisotope,Radioisotope,Other Outpatient Services,Other Reimbursable,Other Reimbursable,Other Reimbursable,Other Reimbursable,No Description,Cardiac Catheterization,Cardiac Catheterization,Cardiac Catheterization,Radiology-Therapeutic,Cardiac Catheterization,Observation Beds (Distinct Unit),Observation Beds (Distinct Unit),Observation Beds (Distinct Unit),Observation Beds (Distinct Unit),No Description,No Description,Physical Therapy,Physical Therapy,Recovery Room,Other Reimbursable,Other Reimbursable,Coronary Care Unit,Durable Medical Equipment Rented,Durable Medical Equipment Rented,Durable Medical Equipment Rented,Durable Medical Equipment Rented,Durable Medical Equipment Rented,Durable Medical Equipment Rented,No Description,No Description,No Description,Durable Medical Equipment Rented,Electroencephalography,Electroencephalography,No Description,Observation Beds (Distinct Unit),Observation Beds (Distinct Unit),Observation Beds (Distinct Unit),Observation Beds (Distinct Unit),Observation Beds (Distinct Unit),Emergency,Observation Beds (Distinct Unit),Occupational Therapy,Occupational Therapy,Speech Pathology,Electrocardiology,Medical Supplies Charged to Patients,Impl. Dev. Charged to Patients,Durable Medical Equipment Rented,Durable Medical Equipment Rented,Medical Supplies Charged to Patients,Impl. Dev. Charged to Patients,Observation Beds (Distinct Unit),ASC (Distinct Part),Operating Room,RHC,Other Special Care,Burn Intensive Care Unit,Coronary Care Unit,No Description,Other Special Care Unit,Clinic,FQHC,CMHC,CMHC,CMHC,CMHC,CMHC,CMHC,CMHC,CMHC,CMHC,Other Outpatient Services,Other Outpatient Services,Other Reimbursable,Other Reimbursable,No Description,Intravenous Therapy,Speech Pathology,Operating Room,Recovery Room,Respiratory Therapy,ASC (Non Distinct Part),Clinic,Emergency,Clinic,Durable Medical Equipment Sold,Drugs Charged to Patients,Durable Medical Equipment Sold,Observation Beds (Distinct Unit),Durable Medical Equipment Sold,Durable Medical Equipment Sold,Durable Medical Equipment Sold,Whole Blood & Packed Red Blood Cells,Whole Blood & Packed Red Blood Cells,Observation Beds (Distinct Unit),Observation Beds (Distinct Unit),Medical Supplies Charged to Patients,Electrocardiology,Durable Medical Equipment Rented,Durable Medical Equipment Rented,Durable Medical Equipment Rented,Recovery Room,Electroencephalography,Other Ancillary,Other Organ Acquisition,Intravenous Therapy,Delivery Room and Labor Room,Other Organ Acquisition,Impl. Dev. Charged to Patients,Clinic,Nonpaid Workers,Nonpaid Workers,Coronary Care Unit,Burn Intensive Care Unit,Surgical Intensive Care Unit,Burn Intensive Care Unit,Surgical Intensive Care Unit,Other Special Care Unit,Intravenous Therapy,Delivery Room and Labor Room,Intravenous Therapy,Radioisotope,Radiology-Therapeutic,OPT,OOT,OSP,OPT,OOT,OSP,OPT,OOT,OSP,OPT,OOT,OSP,OPT,OOT,OSP,OPT,OOT,OSP,OPT,OOT,OSP,OPT,OOT,OSP,Laboratory,Anesthesiology,Other Outpatient Services,Observation Beds (Distinct Unit),Observation Beds (Distinct Unit),Impl. Dev. Charged to Patients,Other Special Care,Surgical Intensive Care Unit,Whole Blood & Packed Red Blood Cells,Speech Pathology,Whole Blood & Packed Red Blood Cells,Electrocardiology,No Description,No Description,Hospice,ASC (Non Distinct Part),ASC (Non Distinct Part),Other Reimbursable,Other Reimbursable,Other Reimbursable,Other Reimbursable,File Date,Hospital State,"If (SCH), enter the # of periods.",Is this hospital is subject to the HAC reduction adjustment for discharges occurring prior to October 1? (Y/N),Is this hospital is subject to the HAC reduction adjustment for discharges occurring on or after October 1? (Y/N),IPPS Interim payment,No Description,No Description,HVBP payment adjustment amount,No Description,HRR adjustment amount ,No Description,No Description,No Description,No Description,No Description,No Description,No Description,No Description,No Description,HAC reduction adjustment amount,Line 19 Subtotal,Reconstructed IPPS payment (pre HAC penalty),Reconstructed HAC penalty,Reconstructed IPPS payment (post HAC penalty),HAC penalty imputed from E_A_HOS_C1_59,Lat,Lon,"Control type, text","Hospital type, text",Num and Name
,HOSPITAL IDENTIFICATION INFORMATION,HOSPITAL IDENTIFICATION INFORMATION,HOSPITAL IDENTIFICATION INFORMATION,HOSPITAL IDENTIFICATION INFORMATION,HOSPITAL IDENTIFICATION INFORMATION,HOSPITAL IDENTIFICATION INFORMATION,HOSPITAL IDENTIFICATION INFORMATION,HOSPITAL IDENTIFICATION INFORMATION,HOSPITAL IDENTIFICATION INFORMATION,HOSPITAL IDENTIFICATION INFORMATION,HOSPITAL IDENTIFICATION INFORMATION,HOSPITAL IDENTIFICATION INFORMATION,HOSPITAL IDENTIFICATION INFORMATION,HOSPITAL IDENTIFICATION INFORMATION,TRIAL BALANCE OF EXPENSE ACCOUNTS,TRIAL BALANCE OF EXPENSE ACCOUNTS,TRIAL BALANCE OF EXPENSE ACCOUNTS,COST ALLOCATION,COST ALLOCATION,COST ALLOCATION,COST ALLOCATION,COST ALLOCATION,COST ALLOCATION,COMPUTATION OF RATIO OF COST TO CHARGES,COMPUTATION OF RATIO OF COST TO CHARGES,COMPUTATION OF RATIO OF COST TO CHARGES,INPATIENT ANCILLARY SERVICE COST APPORTIONMENT,INPATIENT ANCILLARY SERVICE COST APPORTIONMENT,INPATIENT ANCILLARY SERVICE COST APPORTIONMENT,INPATIENT ANCILLARY SERVICE COST APPORTIONMENT,INPATIENT ANCILLARY SERVICE COST APPORTIONMENT,INPATIENT ANCILLARY SERVICE COST APPORTIONMENT,INPATIENT ANCILLARY SERVICE COST APPORTIONMENT,INPATIENT ANCILLARY SERVICE COST APPORTIONMENT,INPATIENT ANCILLARY SERVICE COST APPORTIONMENT,INPATIENT ANCILLARY SERVICE COST APPORTIONMENT,INPATIENT ANCILLARY SERVICE COST APPORTIONMENT,INPATIENT ANCILLARY SERVICE COST APPORTIONMENT,INPATIENT ANCILLARY SERVICE COST APPORTIONMENT,INPATIENT ANCILLARY SERVICE COST APPORTIONMENT,INPATIENT ANCILLARY SERVICE COST APPORTIONMENT,INPATIENT ANCILLARY SERVICE COST APPORTIONMENT,INPATIENT ANCILLARY SERVICE COST APPORTIONMENT,APPORTIONMENT OF INPATIENT ROUTINE SERVICE CAPITAL COSTS,APPORTIONMENT OF INPATIENT ANCILLARY SERVICE CAPITAL COSTS,APPORTIONMENT OF INPATIENT ANCILLARY SERVICE CAPITAL COSTS,APPORTIONMENT OF INPATIENT/OUTPATIENT ANCILLARY SERVICE OTHER PASS THROUGH COSTS,APPORTIONMENT OF INPATIENT/OUTPATIENT ANCILLARY SERVICE OTHER PASS THROUGH COSTS,APPORTIONMENT OF INPATIENT/OUTPATIENT ANCILLARY SERVICE OTHER PASS THROUGH COSTS,APPORTIONMENT OF MEDICAL AND OTHER HEALTH SERVICES,APPORTIONMENT OF MEDICAL AND OTHER HEALTH SERVICES,APPORTIONMENT OF MEDICAL AND OTHER HEALTH SERVICES,APPORTIONMENT OF MEDICAL AND OTHER HEALTH SERVICES,APPORTIONMENT OF MEDICAL AND OTHER HEALTH SERVICES,CALCULATION OF REIMBURSEMENT SETTLEMENT,CALCULATION OF REIMBURSEMENT SETTLEMENT,CALCULATION OF REIMBURSEMENT SETTLEMENT,CALCULATION OF REIMBURSEMENT SETTLEMENT,CALCULATION OF REIMBURSEMENT SETTLEMENT (TEFRA),CALCULATION OF REIMBURSEMENT SETTLEMENT (PPS),CALCULATION OF REIMBURSEMENT SETTLEMENT (PPS),CALCULATION OF REIMBURSEMENT SETTLEMENT (PPS),CALCULATION OF REIMBURSEMENT SETTLEMENT (PPS),CALCULATION OF REIMBURSEMENT SETTLEMENT (PPS),CALCULATION OF REIMBURSEMENT SETTLEMENT (PPS),CALCULATION OF REIMBURSEMENT SETTLEMENT (PPS),CALCULATION OF REIMBURSEMENT SETTLEMENT (PPS),CALCULATION OF REIMBURSEMENT SETTLEMENT (PPS),CALCULATION OF REIMBURSEMENT SETTLEMENT (PPS),CALCULATION OF REIMBURSEMENT SETTLEMENT (PPS),CALCULATION OF REIMBURSEMENT SETTLEMENT (PPS),CALCULATION OF REIMBURSEMENT SETTLEMENT (PPS),CALCULATION OF REIMBURSEMENT SETTLEMENT (PPS),CALCULATION OF REIMBURSEMENT SETTLEMENT (PPS),CALCULATION OF REIMBURSEMENT SETTLEMENT (PPS),CALCULATION OF REIMBURSEMENT SETTLEMENT (PPS),CALCULATION OF REIMBURSEMENT SETTLEMENT (PPS),LTCH PPS,LTCH PPS,LTCH PPS,No Description,No Description,No Description,No Description,No Description,No Description,No Description,No Description,CALCULATION OF REIMBURSEMENT SETTLEMENT,CALCULATION OF REIMBURSEMENT SETTLEMENT (PPS),CALCULATION OF REIMBURSEMENT SETTLEMENT (PPS),CALCULATION OF REIMBURSEMENT SETTLEMENT (PPS),CALCULATION OF REIMBURSEMENT SETTLEMENT (PPS),CALCULATION OF REIMBURSEMENT SETTLEMENT (PPS),CALCULATION OF REIMBURSEMENT SETTLEMENT (PPS),CALCULATION OF REIMBURSEMENT SETTLEMENT (PPS),CALCULATION OF REIMBURSEMENT SETTLEMENT (PPS),CALCULATION OF REIMBURSEMENT SETTLEMENT (PPS),CALCULATION OF REIMBURSEMENT SETTLEMENT (PPS),CALCULATION OF REIMBURSEMENT SETTLEMENT (PPS),CALCULATION OF REIMBURSEMENT SETTLEMENT (PPS),CALCULATION OF REIMBURSEMENT SETTLEMENT (PPS),CALCULATION OF REIMBURSEMENT SETTLEMENT (PPS),CALCULATION OF REIMBURSEMENT SETTLEMENT (PPS),CALCULATION OF REIMBURSEMENT SETTLEMENT (PPS),CALCULATION OF REIMBURSEMENT SETTLEMENT (PPS),CALCULATION OF REIMBURSEMENT SETTLEMENT (PPS),CALCULATION OF REIMBURSEMENT SETTLEMENT (PPS),CALCULATION OF REIMBURSEMENT SETTLEMENT (PPS),CALCULATION OF REIMBURSEMENT SETTLEMENT (PPS),CALCULATION OF REIMBURSEMENT SETTLEMENT (PPS),CALCULATION OF REIMBURSEMENT SETTLEMENT,CALCULATION OF REIMBURSEMENT SETTLEMENT,CALCULATION OF REIMBURSEMENT SETTLEMENT,CALCULATION OF REIMBURSEMENT SETTLEMENT,CALCULATION OF REIMBURSEMENT SETTLEMENT,CALCULATION OF REIMBURSEMENT SETTLEMENT,CALCULATION OF REIMBURSEMENT SETTLEMENT,CALCULATION OF REIMBURSEMENT SETTLEMENT,CALCULATION OF REIMBURSEMENT SETTLEMENT,CALCULATION OF REIMBURSEMENT SETTLEMENT,CALCULATION OF REIMBURSEMENT SETTLEMENT,CALCULATION OF REIMBURSEMENT SETTLEMENT,CALCULATION OF REIMBURSEMENT SETTLEMENT,CALCULATION OF REIMBURSEMENT SETTLEMENT,CALCULATION OF REIMBURSEMENT SETTLEMENT,CALCULATION OF REIMBURSEMENT SETTLEMENT,CALCULATION OF REIMBURSEMENT SETTLEMENT,CALCULATION OF REIMBURSEMENT SETTLEMENT,CALCULATION OF REIMBURSEMENT SETTLEMENT,CALCULATION OF REIMBURSEMENT SETTLEMENT,CALCULATION OF REIMBURSEMENT SETTLEMENT,CALCULATION OF REIMBURSEMENT SETTLEMENT,STATEMENT OF PATIENT REVENUES AND OPERATING EXPENSES,STATEMENT OF REVENUES AND EXPENSES,STATEMENT OF REVENUES AND EXPENSES,STATEMENT OF REVENUES AND EXPENSES,STATEMENT OF REVENUES AND EXPENSES,STATEMENT OF REVENUES AND EXPENSES,STATEMENT OF REVENUES AND EXPENSES,STATEMENT OF REVENUES AND EXPENSES,STATEMENT OF REVENUES AND EXPENSES,STATEMENT OF REVENUES AND EXPENSES,STATEMENT OF REVENUES AND EXPENSES,STATEMENT OF REVENUES AND EXPENSES,STATEMENT OF REVENUES AND EXPENSES,STATEMENT OF REVENUES AND EXPENSES,STATEMENT OF REVENUES AND EXPENSES,STATEMENT OF REVENUES AND EXPENSES,STATEMENT OF REVENUES AND EXPENSES,STATEMENT OF REVENUES AND EXPENSES,STATEMENT OF REVENUES AND EXPENSES,STATEMENT OF REVENUES AND EXPENSES,STATEMENT OF REVENUES AND EXPENSES,STATEMENT OF REVENUES AND EXPENSES,STATEMENT OF REVENUES AND EXPENSES,STATEMENT OF REVENUES AND EXPENSES,STATEMENT OF REVENUES AND EXPENSES,STATEMENT OF REVENUES AND EXPENSES,STATEMENT OF REVENUES AND EXPENSES,STATEMENT OF REVENUES AND EXPENSES,STATEMENT OF REVENUES AND EXPENSES,STATEMENT OF REVENUES AND EXPENSES,STATEMENT OF REVENUES AND EXPENSES,STATEMENT OF REVENUES AND EXPENSES,STATEMENT OF REVENUES AND EXPENSES,STATEMENT OF REVENUES AND EXPENSES,STATEMENT OF REVENUES AND EXPENSES,STATEMENT OF REVENUES AND EXPENSES,STATEMENT OF REVENUES AND EXPENSES,STATEMENT OF REVENUES AND EXPENSES,STATEMENT OF REVENUES AND EXPENSES,STATEMENT OF REVENUES AND EXPENSES,STATEMENT OF REVENUES AND EXPENSES,STATEMENT OF REVENUES AND EXPENSES,STATEMENT OF REVENUES AND EXPENSES,STATEMENT OF REVENUES AND EXPENSES,STATEMENT OF REVENUES AND EXPENSES,STATEMENT OF REVENUES AND EXPENSES,STATEMENT OF REVENUES AND EXPENSES,STATEMENT OF REVENUES AND EXPENSES,STATEMENT OF REVENUES AND EXPENSES,STATEMENT OF REVENUES AND EXPENSES,STATEMENT OF REVENUES AND EXPENSES,STATEMENT OF REVENUES AND EXPENSES,STATEMENT OF REVENUES AND EXPENSES,STATEMENT OF REVENUES AND EXPENSES,STATEMENT OF REVENUES AND EXPENSES,STATEMENT OF REVENUES AND EXPENSES,STATEMENT OF REVENUES AND EXPENSES,STATEMENT OF REVENUES AND EXPENSES,STATEMENT OF REVENUES AND EXPENSES,STATEMENT OF REVENUES AND EXPENSES,STATEMENT OF REVENUES AND EXPENSES,STATEMENT OF REVENUES AND EXPENSES,STATEMENT OF REVENUES AND EXPENSES,STATEMENT OF REVENUES AND EXPENSES,STATEMENT OF REVENUES AND EXPENSES,STATEMENT OF REVENUES AND EXPENSES,STATEMENT OF REVENUES AND EXPENSES,STATEMENT OF REVENUES AND EXPENSES,STATEMENT OF REVENUES AND EXPENSES,STATEMENT OF REVENUES AND EXPENSES,STATEMENT OF REVENUES AND EXPENSES,STATEMENT OF REVENUES AND EXPENSES,STATEMENT OF REVENUES AND EXPENSES,STATEMENT OF REVENUES AND EXPENSES,STATEMENT OF REVENUES AND EXPENSES,STATEMENT OF REVENUES AND EXPENSES,STATEMENT OF REVENUES AND EXPENSES,STATEMENT OF REVENUES AND EXPENSES,STATEMENT OF REVENUES AND EXPENSES,STATEMENT OF REVENUES AND EXPENSES,STATEMENT OF REVENUES AND EXPENSES,STATEMENT OF REVENUES AND EXPENSES,Total Inpatient Days/Outpatient Visits,Total Inpatient Days/Outpatient Visits,Total Inpatient Days/Outpatient Visits,Total Inpatient Days/Outpatient Visits,NUMBER OF BEDS,NUMBER OF BEDS,BED DAYS AVAILABLE,BED DAYS AVAILABLE,BED DAYS AVAILABLE,BED DAYS AVAILABLE,BED DAYS AVAILABLE,Medicaid Inpatient Days/Outpatient Visits,Total Inpatient Days/Outpatient Visits,Total Inpatient Days/Outpatient Visits,Total Inpatient Days/Outpatient Visits,HOSPITAL WAGE INDEX DATA,HOSPITAL WAGE INDEX DATA,HOSPITAL WAGE INDEX DATA,HOSPITAL WAGE INDEX DATA,HOSPITAL WAGE INDEX DATA,HOSPITAL WAGE INDEX DATA,HOSPITAL WAGE INDEX DATA,HOSPITAL WAGE INDEX DATA,HOSPITAL WAGE INDEX DATA,HOSPITAL WAGE INDEX DATA,HOSPITAL WAGE INDEX DATA,HOSPITAL WAGE INDEX DATA,HOSPITAL WAGE INDEX DATA,HOSPITAL WAGE INDEX DATA,HOSPITAL WAGE INDEX DATA,HOSPITAL WAGE INDEX DATA,HOSPITAL WAGE INDEX DATA,HOSPITAL WAGE INDEX DATA,HOSPITAL WAGE INDEX DATA,HOSPITAL WAGE INDEX DATA,HOSPITAL WAGE INDEX DATA,HOSPITAL WAGE INDEX DATA,HOSPITAL WAGE INDEX DATA,HOSPITAL CONTRACT LABOR AND BENEFIT COST,HOSPITAL CONTRACT LABOR AND BENEFIT COST,HOSPITAL CONTRACT LABOR AND BENEFIT COST,HOSPITAL CONTRACT LABOR AND BENEFIT COST,HOSPITAL CONTRACT LABOR AND BENEFIT COST,HOSPITAL CONTRACT LABOR AND BENEFIT COST,HHA STATISTICAL DATA,HHA STATISTICAL DATA,HHA STATISTICAL DATA,HHA STATISTICAL DATA,HHA STATISTICAL DATA,HHA STATISTICAL DATA,HHA STATISTICAL DATA,HHA STATISTICAL DATA,HHA STATISTICAL DATA,HHA STATISTICAL DATA,HHA STATISTICAL DATA,HHA STATISTICAL DATA,HHA STATISTICAL DATA,HHA STATISTICAL DATA,HHA STATISTICAL DATA,HHA STATISTICAL DATA,HHA STATISTICAL DATA,HHA STATISTICAL DATA,HHA STATISTICAL DATA,HHA STATISTICAL DATA,HHA STATISTICAL DATA,HHA STATISTICAL DATA,HHA STATISTICAL DATA,HHA STATISTICAL DATA,HHA STATISTICAL DATA,HHA STATISTICAL DATA,HHA STATISTICAL DATA,HHA STATISTICAL DATA,HHA STATISTICAL DATA,HHA STATISTICAL DATA,HHA STATISTICAL DATA,HHA STATISTICAL DATA,HHA STATISTICAL DATA,HHA STATISTICAL DATA,ANALYSIS OF CHANGES IN NEW CAPITAL BALANCES,ANALYSIS OF CHANGES IN NEW CAPITAL BALANCES,ANALYSIS OF CHANGES IN NEW CAPITAL BALANCES,ANALYSIS OF CHANGES IN NEW CAPITAL BALANCES,ANALYSIS OF CHANGES IN NEW CAPITAL BALANCES,ANALYSIS OF CHANGES IN NEW CAPITAL BALANCES,ANALYSIS OF CHANGES IN NEW CAPITAL BALANCES,ANALYSIS OF CHANGES IN NEW CAPITAL BALANCES,ANALYSIS OF CHANGES IN NEW CAPITAL BALANCES,ANALYSIS OF CHANGES IN NEW CAPITAL BALANCES,ANALYSIS OF CHANGES IN NEW CAPITAL BALANCES,ANALYSIS OF CHANGES IN NEW CAPITAL BALANCES,ANALYSIS OF CHANGES IN NEW CAPITAL BALANCES,RECONCILIATION OF CAPITAL COST CENTERS,RECONCILIATION OF CAPITAL COST CENTERS,RECONCILIATION OF CAPITAL COST CENTERS,ADJUSTMENTS,ADJUSTMENTS,ADJUSTMENTS,ADJUSTMENTS,ADJUSTMENTS,TRIAL BALANCE OF EXPENSE ACCOUNTS,TRIAL BALANCE OF EXPENSE ACCOUNTS,TRIAL BALANCE OF EXPENSE ACCOUNTS,TRIAL BALANCE OF EXPENSE ACCOUNTS,TRIAL BALANCE OF EXPENSE ACCOUNTS,TRIAL BALANCE OF EXPENSE ACCOUNTS,TRIAL BALANCE OF EXPENSE ACCOUNTS,COST ALLOCATION,COST ALLOCATION,COST ALLOCATION,COST ALLOCATION,COST ALLOCATION,COST ALLOCATION,ALLOCATION OF NEW CAPITAL COSTS,ALLOCATION OF NEW CAPITAL COSTS,ALLOCATION OF NEW CAPITAL COSTS,COMPUTATION OF RATIO OF COST TO CHARGES,COMPUTATION OF RATIO OF COST TO CHARGES,COMPUTATION OF RATIO OF COST TO CHARGES,COMPUTATION OF RATIO OF COST TO CHARGES,COMPUTATION OF RATIO OF COST TO CHARGES,COMPUTATION OF RATIO OF COST TO CHARGES,COMPUTATION OF RATIO OF COST TO CHARGES,COMPUTATION OF RATIO OF COST TO CHARGES,COMPUTATION OF RATIO OF COST TO CHARGES,COMPUTATION OF RATIO OF COST TO CHARGES,COMPUTATION OF INPATIENT OPERATING COSTS,COMPUTATION OF INPATIENT OPERATING COSTS,COMPUTATION OF INPATIENT OPERATING COSTS,COMPUTATION OF INPATIENT OPERATING COSTS,COMPUTATION OF INPATIENT OPERATING COSTS,COMPUTATION OF INPATIENT OPERATING COSTS,COMPUTATION OF INPATIENT OPERATING COSTS,COMPUTATION OF INPATIENT OPERATING COSTS,COMPUTATION OF INPATIENT OPERATING COSTS,INPATIENT ANCILLARY SERVICE COST APPORTIONMENT,INPATIENT ANCILLARY SERVICE COST APPORTIONMENT,INPATIENT ANCILLARY SERVICE COST APPORTIONMENT,INPATIENT ANCILLARY SERVICE COST APPORTIONMENT,INPATIENT ANCILLARY SERVICE COST APPORTIONMENT,INPATIENT ANCILLARY SERVICE COST APPORTIONMENT,APPORTIONMENT OF INPATIENT ROUTINE SERVICE CAPITAL COSTS,APPORTIONMENT OF INPATIENT ROUTINE SERVICE CAPITAL COSTS,APPORTIONMENT OF INPATIENT ROUTINE SERVICE CAPITAL COSTS,APPORTIONMENT OF INPATIENT ROUTINE SERVICE CAPITAL COSTS,APPORTIONMENT OF INPATIENT ROUTINE SERVICE CAPITAL COSTS,APPORTIONMENT OF INPATIENT ROUTINE SERVICE CAPITAL COSTS,APPORTIONMENT OF INPATIENT ANCILLARY SERVICE CAPITAL COSTS,APPORTIONMENT OF INPATIENT ANCILLARY SERVICE CAPITAL COSTS,APPORTIONMENT OF INPATIENT ROUTINE SERVICE OTHER PASS THROUGH COSTS,APPORTIONMENT OF INPATIENT ROUTINE SERVICE OTHER PASS THROUGH COSTS,LTCH PPS,LTCH PPS,LTCH PPS,LTCH PPS,LTCH PPS,LTCH PPS,LTCH PPS,LTCH PPS,LTCH PPS,LTCH PPS,LTCH PPS,LTCH PPS,LTCH PPS,LTCH PPS,LTCH PPS,LTCH PPS,LTCH PPS,STATEMENT OF PATIENT REVENUES AND OPERATING EXPENSES,STATEMENT OF PATIENT REVENUES AND OPERATING EXPENSES,STATEMENT OF PATIENT REVENUES AND OPERATING EXPENSES,STATEMENT OF PATIENT REVENUES AND OPERATING EXPENSES,STATEMENT OF PATIENT REVENUES AND OPERATING EXPENSES,STATEMENT OF PATIENT REVENUES AND OPERATING EXPENSES,STATEMENT OF PATIENT REVENUES AND OPERATING EXPENSES,STATEMENT OF REVENUES AND EXPENSES,STATEMENT OF REVENUES AND EXPENSES,STATEMENT OF REVENUES AND EXPENSES,STATEMENT OF REVENUES AND EXPENSES,STATEMENT OF REVENUES AND EXPENSES,STATEMENT OF REVENUES AND EXPENSES,STATEMENT OF REVENUES AND EXPENSES,STATEMENT OF REVENUES AND EXPENSES,STATEMENT OF REVENUES AND EXPENSES,STATEMENT OF REVENUES AND EXPENSES,STATEMENT OF REVENUES AND EXPENSES,S-10 DATA,S-10 DATA,S-10 DATA,S-10 DATA,S-10 DATA,S-10 DATA,S-10 DATA,S-10 DATA,S-10 DATA,S-10 DATA,S-10 DATA,S-10 DATA,S-10 DATA,No Description,No Description,No Description,Total Inpatient Days/Outpatient Visits,Total Inpatient Days/Outpatient Visits,Total Inpatient Days/Outpatient Visits,Total Inpatient Days/Outpatient Visits,Total Inpatient Days/Outpatient Visits,Total Inpatient Days/Outpatient Visits,NUMBER OF BEDS,NUMBER OF BEDS,NUMBER OF BEDS,NUMBER OF BEDS,BED DAYS AVAILABLE,BED DAYS AVAILABLE,BED DAYS AVAILABLE,Medicare Inpatient Days/Outpatient Visits,Medicare Inpatient Days/Outpatient Visits,Medicare Inpatient Days/Outpatient Visits,Total Inpatient Days/Outpatient Visits,Total Inpatient Days/Outpatient Visits,Total Inpatient Days/Outpatient Visits,ANALYSIS OF CHANGES IN NEW CAPITAL BALANCES,ANALYSIS OF CHANGES IN NEW CAPITAL BALANCES,ANALYSIS OF CHANGES IN NEW CAPITAL BALANCES,RECONCILIATION OF CAPITAL COST CENTERS,RECONCILIATION OF CAPITAL COST CENTERS,ADJUSTMENTS,ADJUSTMENTS,ADJUSTMENTS,ADJUSTMENTS,TRIAL BALANCE OF EXPENSE ACCOUNTS,TRIAL BALANCE OF EXPENSE ACCOUNTS,TRIAL BALANCE OF EXPENSE ACCOUNTS,TRIAL BALANCE OF EXPENSE ACCOUNTS,COST ALLOCATION,COST ALLOCATION,ALLOCATION OF NEW CAPITAL COSTS,COMPUTATION OF RATIO OF COST TO CHARGES,COMPUTATION OF RATIO OF COST TO CHARGES,COMPUTATION OF RATIO OF COST TO CHARGES,COMPUTATION OF RATIO OF COST TO CHARGES,COMPUTATION OF INPATIENT OPERATING COSTS,COMPUTATION OF INPATIENT OPERATING COSTS,COMPUTATION OF INPATIENT OPERATING COSTS,COMPUTATION OF INPATIENT OPERATING COSTS,COMPUTATION OF INPATIENT OPERATING COSTS,COMPUTATION OF INPATIENT OPERATING COSTS,COMPUTATION OF INPATIENT OPERATING COSTS,INPATIENT ANCILLARY SERVICE COST APPORTIONMENT,APPORTIONMENT OF INPATIENT ROUTINE SERVICE CAPITAL COSTS,APPORTIONMENT OF INPATIENT ROUTINE SERVICE CAPITAL COSTS,APPORTIONMENT OF INPATIENT ROUTINE SERVICE CAPITAL COSTS,CALCULATION OF REIMBURSEMENT SETTLEMENT (PPS),CALCULATION OF REIMBURSEMENT SETTLEMENT (PPS),CALCULATION OF REIMBURSEMENT SETTLEMENT (PPS),CALCULATION OF REIMBURSEMENT SETTLEMENT (PPS),CALCULATION OF REIMBURSEMENT SETTLEMENT (PPS),CALCULATION OF REIMBURSEMENT SETTLEMENT (PPS),CALCULATION OF REIMBURSEMENT SETTLEMENT (PPS),CALCULATION OF REIMBURSEMENT SETTLEMENT (PPS),CALCULATION OF REIMBURSEMENT SETTLEMENT (PPS),CALCULATION OF REIMBURSEMENT SETTLEMENT (PPS),CALCULATION OF REIMBURSEMENT SETTLEMENT (PPS),CALCULATION OF REIMBURSEMENT SETTLEMENT (PPS),CALCULATION OF REIMBURSEMENT SETTLEMENT (PPS),CALCULATION OF REIMBURSEMENT SETTLEMENT (PPS),CALCULATION OF REIMBURSEMENT SETTLEMENT (PPS),CALCULATION OF REIMBURSEMENT SETTLEMENT (PPS),CALCULATION OF REIMBURSEMENT SETTLEMENT (PPS),CALCULATION OF REIMBURSEMENT SETTLEMENT (PPS),CALCULATION OF REIMBURSEMENT SETTLEMENT (PPS),CALCULATION OF REIMBURSEMENT SETTLEMENT (PPS),CALCULATION OF REIMBURSEMENT SETTLEMENT,CALCULATION OF REIMBURSEMENT SETTLEMENT,STATEMENT OF PATIENT REVENUES AND OPERATING EXPENSES,STATEMENT OF PATIENT REVENUES AND OPERATING EXPENSES,STATEMENT OF PATIENT REVENUES AND OPERATING EXPENSES,STATEMENT OF PATIENT REVENUES AND OPERATING EXPENSES,STATEMENT OF REVENUES AND EXPENSES,Total Inpatient Days/Outpatient Visits,Total Inpatient Days/Outpatient Visits,Total Inpatient Days/Outpatient Visits,Total Inpatient Days/Outpatient Visits,Total Inpatient Days/Outpatient Visits,NUMBER OF BEDS,BED DAYS AVAILABLE,Medicare Inpatient Days/Outpatient Visits,Medicaid Inpatient Days/Outpatient Visits,Medicaid Inpatient Days/Outpatient Visits,Medicaid Inpatient Days/Outpatient Visits,Medicaid Inpatient Days/Outpatient Visits,Total Inpatient Days/Outpatient Visits,HOSPITAL WAGE INDEX DATA,HOSPITAL WAGE INDEX DATA,HOSPITAL WAGE INDEX DATA,HOSPITAL WAGE INDEX DATA,HOSPITAL WAGE INDEX DATA,HOSPITAL WAGE INDEX DATA,HOSPITAL WAGE INDEX DATA,HOSPITAL WAGE INDEX DATA,HOSPITAL WAGE INDEX DATA,HOSPITAL WAGE INDEX DATA,HOSPITAL WAGE INDEX DATA,HOSPITAL WAGE INDEX DATA,HOSPITAL WAGE INDEX DATA,HOSPITAL WAGE INDEX DATA,HOSPITAL WAGE INDEX DATA,HOSPITAL WAGE INDEX DATA,HOSPITAL WAGE INDEX DATA,HOSPITAL WAGE INDEX DATA,COST ALLOCATION,APPORTIONMENT OF INPATIENT/OUTPATIENT ANCILLARY SERVICE OTHER PASS THROUGH COSTS,APPORTIONMENT OF MEDICAL AND OTHER HEALTH SERVICES,APPORTIONMENT OF MEDICAL AND OTHER HEALTH SERVICES,CALCULATION OF REIMBURSEMENT SETTLEMENT (PPS),CALCULATION OF REIMBURSEMENT SETTLEMENT (PPS),CALCULATION OF REIMBURSEMENT SETTLEMENT (PPS),CALCULATION OF REIMBURSEMENT SETTLEMENT (PPS),CALCULATION OF REIMBURSEMENT SETTLEMENT (PPS),CALCULATION OF REIMBURSEMENT SETTLEMENT (PPS),CALCULATION OF REIMBURSEMENT SETTLEMENT (PPS),CALCULATION OF REIMBURSEMENT SETTLEMENT (PPS),CALCULATION OF REIMBURSEMENT SETTLEMENT (PPS),CALCULATION OF REIMBURSEMENT SETTLEMENT (PPS),CALCULATION OF REIMBURSEMENT SETTLEMENT (PPS),CALCULATION OF REIMBURSEMENT SETTLEMENT (PPS),CALCULATION OF REIMBURSEMENT SETTLEMENT (PPS),CALCULATION OF REIMBURSEMENT SETTLEMENT (PPS),CALCULATION OF REIMBURSEMENT SETTLEMENT (PPS),CALCULATION OF REIMBURSEMENT SETTLEMENT (PPS),CALCULATION OF REIMBURSEMENT SETTLEMENT (PPS),CALCULATION OF REIMBURSEMENT SETTLEMENT (PPS),CALCULATION OF REIMBURSEMENT SETTLEMENT (PPS),CALCULATION OF REIMBURSEMENT SETTLEMENT,CALCULATION OF REIMBURSEMENT SETTLEMENT,CALCULATION OF REIMBURSEMENT SETTLEMENT,CALCULATION OF REIMBURSEMENT SETTLEMENT,CALCULATION OF REIMBURSEMENT SETTLEMENT,CALCULATION OF REIMBURSEMENT SETTLEMENT,CALCULATION OF REIMBURSEMENT SETTLEMENT,CALCULATION OF REIMBURSEMENT SETTLEMENT,CALCULATION OF REIMBURSEMENT SETTLEMENT,CALCULATION OF REIMBURSEMENT SETTLEMENT,CALCULATION OF REIMBURSEMENT SETTLEMENT,CALCULATION OF REIMBURSEMENT SETTLEMENT,CALCULATION OF REIMBURSEMENT SETTLEMENT,CALCULATION OF REIMBURSEMENT SETTLEMENT,STATEMENT OF PATIENT REVENUES AND OPERATING EXPENSES,ANALYSIS OF CHANGES IN NEW CAPITAL BALANCES,ANALYSIS OF CHANGES IN NEW CAPITAL BALANCES,ANALYSIS OF CHANGES IN NEW CAPITAL BALANCES,ANALYSIS OF CHANGES IN NEW CAPITAL BALANCES,ANALYSIS OF CHANGES IN NEW CAPITAL BALANCES,ANALYSIS OF CHANGES IN NEW CAPITAL BALANCES,ANALYSIS OF CHANGES IN NEW CAPITAL BALANCES,ADJUSTMENTS,ADJUSTMENTS,ALLOCATION OF NEW CAPITAL COSTS,CALCULATION OF REIMBURSEMENT SETTLEMENT,CALCULATION OF REIMBURSEMENT SETTLEMENT,CALCULATION OF REIMBURSEMENT SETTLEMENT,CALCULATION OF REIMBURSEMENT SETTLEMENT,Total Inpatient Days/Outpatient Visits,Total Inpatient Days/Outpatient Visits,HOSPITAL WAGE INDEX DATA,HOSPITAL WAGE INDEX DATA,HOSPITAL WAGE INDEX DATA,HOSPITAL WAGE INDEX DATA,HOSPITAL WAGE INDEX DATA,HOSPITAL WAGE INDEX DATA,HOSPITAL WAGE INDEX DATA,HOSPITAL WAGE INDEX DATA,HOSPITAL WAGE INDEX DATA,HOSPITAL WAGE INDEX DATA,HOSPITAL WAGE INDEX DATA,HOSPITAL WAGE INDEX DATA,HOSPITAL WAGE INDEX DATA,HOSPITAL WAGE INDEX DATA,HOSPITAL WAGE INDEX DATA,HOSPITAL WAGE INDEX DATA,HOSPITAL WAGE INDEX DATA,HOSPITAL WAGE INDEX DATA,HOSPITAL WAGE INDEX DATA,HOSPITAL WAGE INDEX DATA,HOSPITAL WAGE INDEX DATA,HOSPITAL WAGE INDEX DATA,HOSPITAL WAGE INDEX DATA,HOSPITAL WAGE INDEX DATA,HOSPITAL WAGE INDEX DATA,CALCULATION OF REIMBURSEMENT SETTLEMENT (PPS),CALCULATION OF REIMBURSEMENT SETTLEMENT (PPS),CALCULATION OF REIMBURSEMENT SETTLEMENT (PPS),CALCULATION OF REIMBURSEMENT SETTLEMENT (PPS),COST ALLOCATION,COST ALLOCATION,ALLOCATION OF NEW CAPITAL COSTS,CALCULATION OF REIMBURSEMENT SETTLEMENT (PPS),CALCULATION OF REIMBURSEMENT SETTLEMENT (PPS),CALCULATION OF REIMBURSEMENT SETTLEMENT (PPS),CALCULATION OF REIMBURSEMENT SETTLEMENT (PPS),CALCULATION OF REIMBURSEMENT SETTLEMENT (PPS),CALCULATION OF REIMBURSEMENT SETTLEMENT (PPS),CALCULATION OF REIMBURSEMENT SETTLEMENT (PPS),CALCULATION OF DIRECT GME,CALCULATION OF DIRECT GME,CALCULATION OF DIRECT GME,CALCULATION OF DIRECT GME,CALCULATION OF DIRECT GME,CALCULATION OF DIRECT GME,CALCULATION OF DIRECT GME,CALCULATION OF DIRECT GME,CALCULATION OF DIRECT GME,CALCULATION OF DIRECT GME,CALCULATION OF DIRECT GME,CALCULATION OF DIRECT GME,CALCULATION OF DIRECT GME,CALCULATION OF DIRECT GME,CALCULATION OF DIRECT GME,CALCULATION OF DIRECT GME,CALCULATION OF DIRECT GME,CALCULATION OF DIRECT GME,CALCULATION OF DIRECT GME,CALCULATION OF DIRECT GME,CALCULATION OF DIRECT GME,CALCULATION OF DIRECT GME,CALCULATION OF DIRECT GME,CALCULATION OF DIRECT GME,CALCULATION OF DIRECT GME,CALCULATION OF DIRECT GME,CALCULATION OF DIRECT GME,CALCULATION OF DIRECT GME,CALCULATION OF DIRECT GME,CALCULATION OF DIRECT GME,CALCULATION OF DIRECT GME,CALCULATION OF DIRECT GME,CALCULATION OF DIRECT GME,CALCULATION OF DIRECT GME,CALCULATION OF DIRECT GME,CALCULATION OF DIRECT GME,CALCULATION OF REIMBURSEMENT SETTLEMENT,CALCULATION OF REIMBURSEMENT SETTLEMENT,Total Inpatient Days/Outpatient Visits,Total Inpatient Days/Outpatient Visits,ANALYSIS OF CHANGES IN NEW CAPITAL BALANCES,ANALYSIS OF CHANGES IN NEW CAPITAL BALANCES,COST ALLOCATION,COST ALLOCATION,ALLOCATION OF NEW CAPITAL COSTS,COMPUTATION OF RATIO OF COST TO CHARGES,COMPUTATION OF RATIO OF COST TO CHARGES,COMPUTATION OF RATIO OF COST TO CHARGES,APPORTIONMENT OF INPATIENT ROUTINE SERVICE CAPITAL COSTS,CALCULATION OF REIMBURSEMENT SETTLEMENT,CALCULATION OF REIMBURSEMENT SETTLEMENT (PPS),S-10 DATA,S-10 DATA,S-10 DATA,S-10 DATA,S-10 DATA,S-10 DATA,S-10 DATA,S-10 DATA,Medicaid Inpatient Days/Outpatient Visits,Total Inpatient Days/Outpatient Visits,Total Inpatient Days/Outpatient Visits,HOSPITAL WAGE INDEX DATA,HOSPITAL WAGE INDEX DATA,HOSPITAL WAGE INDEX DATA,HOSPITAL WAGE INDEX DATA,HOSPITAL WAGE INDEX DATA,HOSPITAL WAGE INDEX DATA,HOSPITAL WAGE INDEX DATA,HOSPITAL WAGE INDEX DATA,HOSPITAL WAGE INDEX DATA,HOSPITAL WAGE INDEX DATA,HOSPITAL WAGE INDEX DATA,HOSPITAL WAGE INDEX DATA,HOSPITAL WAGE INDEX DATA,ADJUSTMENTS,LTCH PPS,CALCULATION OF REIMBURSEMENT SETTLEMENT (PPS),STATEMENT OF REVENUES AND EXPENSES,STATEMENT OF REVENUES AND EXPENSES,STATEMENT OF REVENUES AND EXPENSES,STATEMENT OF REVENUES AND EXPENSES,RECONCILIATION OF CAPITAL COST CENTERS,ADJUSTMENTS,TRIAL BALANCE OF EXPENSE ACCOUNTS,TRIAL BALANCE OF EXPENSE ACCOUNTS,COST ALLOCATION,COST ALLOCATION,ALLOCATION OF NEW CAPITAL COSTS,COMPUTATION OF RATIO OF COST TO CHARGES,COMPUTATION OF RATIO OF COST TO CHARGES,CALCULATION OF REIMBURSEMENT SETTLEMENT (PPS),CALCULATION OF REIMBURSEMENT SETTLEMENT (PPS),STATEMENT OF PATIENT REVENUES AND OPERATING EXPENSES,STATEMENT OF PATIENT REVENUES AND OPERATING EXPENSES,STATEMENT OF PATIENT REVENUES AND OPERATING EXPENSES,STATEMENT OF PATIENT REVENUES AND OPERATING EXPENSES,STATEMENT OF PATIENT REVENUES AND OPERATING EXPENSES,STATEMENT OF REVENUES AND EXPENSES,STATEMENT OF REVENUES AND EXPENSES,RECONCILIATION OF CAPITAL COST CENTERS,ADJUSTMENTS,ADJUSTMENTS,ADJUSTMENTS,COMPUTATION OF RATIO OF COST TO CHARGES,APPORTIONMENT OF MEDICAL AND OTHER HEALTH SERVICES,APPORTIONMENT OF MEDICAL AND OTHER HEALTH SERVICES,APPORTIONMENT OF MEDICAL AND OTHER HEALTH SERVICES,APPORTIONMENT OF MEDICAL AND OTHER HEALTH SERVICES,CALCULATION OF REIMBURSEMENT SETTLEMENT,CALCULATION OF REIMBURSEMENT SETTLEMENT,CALCULATION OF REIMBURSEMENT SETTLEMENT,CALCULATION OF REIMBURSEMENT SETTLEMENT,CALCULATION OF REIMBURSEMENT SETTLEMENT,CALCULATION OF REIMBURSEMENT SETTLEMENT,CALCULATION OF REIMBURSEMENT SETTLEMENT,CALCULATION OF REIMBURSEMENT SETTLEMENT,STATEMENT OF PATIENT REVENUES AND OPERATING EXPENSES,STATEMENT OF REVENUES AND EXPENSES,Medicaid Inpatient Days/Outpatient Visits,HOSPITAL WAGE INDEX DATA,HOSPITAL WAGE INDEX DATA,HOSPITAL WAGE INDEX DATA,HOSPITAL WAGE INDEX DATA,HOSPITAL WAGE INDEX DATA,HOSPITAL WAGE INDEX DATA,HOSPITAL WAGE INDEX DATA,HOSPITAL WAGE INDEX DATA,HOSPITAL WAGE INDEX DATA,HOSPITAL WAGE INDEX DATA,HOSPITAL WAGE INDEX DATA,HOSPITAL WAGE INDEX DATA,HOSPITAL WAGE INDEX DATA,HOSPITAL WAGE INDEX DATA,HOSPITAL WAGE INDEX DATA,HOSPITAL WAGE INDEX DATA,HOSPITAL WAGE INDEX DATA,HOSPITAL WAGE INDEX DATA,HOSPITAL WAGE INDEX DATA,HOSPITAL WAGE INDEX DATA,HOSPITAL WAGE INDEX DATA,HOSPITAL WAGE INDEX DATA,HOSPITAL WAGE INDEX DATA,HOSPITAL WAGE INDEX DATA,HOSPITAL WAGE INDEX DATA,HOSPITAL WAGE INDEX DATA,HOSPITAL WAGE INDEX DATA,HOSPITAL WAGE INDEX DATA,HOSPITAL WAGE INDEX DATA,HOSPITAL WAGE INDEX DATA,HOSPITAL WAGE INDEX DATA,HOSPITAL WAGE INDEX DATA,HOSPITAL WAGE INDEX DATA,HOSPITAL WAGE INDEX DATA,HOSPITAL WAGE INDEX DATA,HOSPITAL WAGE INDEX DATA,HOSPITAL WAGE INDEX DATA,HOSPITAL WAGE INDEX DATA,HOSPITAL WAGE INDEX DATA,HOSPITAL WAGE INDEX DATA,ANALYSIS OF CHANGES IN NEW CAPITAL BALANCES,ADJUSTMENTS,TRIAL BALANCE OF EXPENSE ACCOUNTS,TRIAL BALANCE OF EXPENSE ACCOUNTS,APPORTIONMENT OF INPATIENT/OUTPATIENT ANCILLARY SERVICE OTHER PASS THROUGH COSTS,APPORTIONMENT OF INPATIENT/OUTPATIENT ANCILLARY SERVICE OTHER PASS THROUGH COSTS,APPORTIONMENT OF INPATIENT/OUTPATIENT ANCILLARY SERVICE OTHER PASS THROUGH COSTS,APPORTIONMENT OF INPATIENT/OUTPATIENT ANCILLARY SERVICE OTHER PASS THROUGH COSTS,APPORTIONMENT OF INPATIENT/OUTPATIENT ANCILLARY SERVICE OTHER PASS THROUGH COSTS,APPORTIONMENT OF MEDICAL AND OTHER HEALTH SERVICES,APPORTIONMENT OF MEDICAL AND OTHER HEALTH SERVICES,APPORTIONMENT OF MEDICAL AND OTHER HEALTH SERVICES,APPORTIONMENT OF MEDICAL AND OTHER HEALTH SERVICES,CALCULATION OF REIMBURSEMENT SETTLEMENT,CALCULATION OF REIMBURSEMENT SETTLEMENT (PPS),CALCULATION OF REIMBURSEMENT SETTLEMENT (PPS),CALCULATION OF REIMBURSEMENT SETTLEMENT (PPS),CALCULATION OF REIMBURSEMENT SETTLEMENT (PPS),CALCULATION OF REIMBURSEMENT SETTLEMENT (PPS),CALCULATION OF REIMBURSEMENT SETTLEMENT (PPS),CALCULATION OF REIMBURSEMENT SETTLEMENT (PPS),CALCULATION OF REIMBURSEMENT SETTLEMENT (PPS),CALCULATION OF REIMBURSEMENT SETTLEMENT (PPS),CALCULATION OF REIMBURSEMENT SETTLEMENT (PPS),CALCULATION OF REIMBURSEMENT SETTLEMENT (PPS),CALCULATION OF REIMBURSEMENT SETTLEMENT (PPS),CALCULATION OF REIMBURSEMENT SETTLEMENT (PPS),CALCULATION OF REIMBURSEMENT SETTLEMENT (PPS),CALCULATION OF REIMBURSEMENT SETTLEMENT (PPS),CALCULATION OF REIMBURSEMENT SETTLEMENT (PPS),CALCULATION OF REIMBURSEMENT SETTLEMENT (PPS),CALCULATION OF REIMBURSEMENT SETTLEMENT (PPS),CALCULATION OF REIMBURSEMENT SETTLEMENT,CALCULATION OF REIMBURSEMENT SETTLEMENT,CALCULATION OF REIMBURSEMENT SETTLEMENT,STATEMENT OF REVENUES AND EXPENSES,STATEMENT OF REVENUES AND EXPENSES,STATEMENT OF REVENUES AND EXPENSES,STATEMENT OF REVENUES AND EXPENSES,STATEMENT OF REVENUES AND EXPENSES,STATEMENT OF REVENUES AND EXPENSES,STATEMENT OF REVENUES AND EXPENSES,STATEMENT OF REVENUES AND EXPENSES,STATEMENT OF REVENUES AND EXPENSES,STATEMENT OF REVENUES AND EXPENSES,S-10 DATA,S-10 DATA,S-10 DATA,S-10 DATA,No Description,No Description,Medicare Inpatient Days/Outpatient Visits,HOSPITAL WAGE INDEX DATA,HOSPITAL WAGE INDEX DATA,HOSPITAL WAGE INDEX DATA,HOSPITAL WAGE INDEX DATA,HOSPITAL WAGE INDEX DATA,HOSPITAL WAGE INDEX DATA,HOSPITAL WAGE INDEX DATA,HOSPITAL WAGE INDEX DATA,HOSPITAL WAGE INDEX DATA,HOSPITAL WAGE INDEX DATA,HOSPITAL WAGE INDEX DATA,HOSPITAL WAGE INDEX DATA,HOSPITAL WAGE INDEX DATA,HOSPITAL WAGE INDEX DATA,HOSPITAL WAGE INDEX DATA,HOSPITAL WAGE INDEX DATA,HOSPITAL WAGE INDEX DATA,HOSPITAL WAGE INDEX DATA,ANALYSIS OF CHANGES IN NEW CAPITAL BALANCES,TRIAL BALANCE OF EXPENSE ACCOUNTS,CALCULATION OF REIMBURSEMENT SETTLEMENT,ANALYSIS OF CHANGES IN NEW CAPITAL BALANCES,ANALYSIS OF CHANGES IN NEW CAPITAL BALANCES,ANALYSIS OF CHANGES IN NEW CAPITAL BALANCES,ANALYSIS OF CHANGES IN NEW CAPITAL BALANCES,ANALYSIS OF CHANGES IN NEW CAPITAL BALANCES,ADJUSTMENTS,APPORTIONMENT OF INPATIENT ANCILLARY SERVICE CAPITAL COSTS,S-10 DATA,S-10 DATA,S-10 DATA,No Description,No Description,No Description,Medicaid Inpatient Days/Outpatient Visits,HOSPITAL WAGE INDEX DATA,HOSPITAL WAGE INDEX DATA,HOSPITAL WAGE INDEX DATA,HOSPITAL WAGE INDEX DATA,HOSPITAL WAGE INDEX DATA,HOSPITAL WAGE INDEX DATA,HOSPITAL CONTRACT LABOR AND BENEFIT COST,HOSPITAL CONTRACT LABOR AND BENEFIT COST,ANALYSIS OF CHANGES IN NEW CAPITAL BALANCES,TRIAL BALANCE OF EXPENSE ACCOUNTS,TRIAL BALANCE OF EXPENSE ACCOUNTS,TRIAL BALANCE OF EXPENSE ACCOUNTS,TRIAL BALANCE OF EXPENSE ACCOUNTS,TRIAL BALANCE OF EXPENSE ACCOUNTS,TRIAL BALANCE OF EXPENSE ACCOUNTS,COST ALLOCATION,COST ALLOCATION,ALLOCATION OF NEW CAPITAL COSTS,COMPUTATION OF RATIO OF COST TO CHARGES,COMPUTATION OF RATIO OF COST TO CHARGES,COMPUTATION OF INPATIENT OPERATING COSTS,COMPUTATION OF INPATIENT OPERATING COSTS,COMPUTATION OF INPATIENT OPERATING COSTS,COMPUTATION OF INPATIENT OPERATING COSTS,COMPUTATION OF INPATIENT OPERATING COSTS,COMPUTATION OF INPATIENT OPERATING COSTS,COMPUTATION OF INPATIENT OPERATING COSTS,COMPUTATION OF INPATIENT OPERATING COSTS,COMPUTATION OF INPATIENT OPERATING COSTS,COMPUTATION OF INPATIENT OPERATING COSTS,COMPUTATION OF INPATIENT OPERATING COSTS,INPATIENT ANCILLARY SERVICE COST APPORTIONMENT,INPATIENT ANCILLARY SERVICE COST APPORTIONMENT,INPATIENT ANCILLARY SERVICE COST APPORTIONMENT,INPATIENT ANCILLARY SERVICE COST APPORTIONMENT,INPATIENT ANCILLARY SERVICE COST APPORTIONMENT,INPATIENT ANCILLARY SERVICE COST APPORTIONMENT,INPATIENT ANCILLARY SERVICE COST APPORTIONMENT,INPATIENT ANCILLARY SERVICE COST APPORTIONMENT,INPATIENT ANCILLARY SERVICE COST APPORTIONMENT,APPORTIONMENT OF INPATIENT ROUTINE SERVICE CAPITAL COSTS,APPORTIONMENT OF INPATIENT ROUTINE SERVICE CAPITAL COSTS,APPORTIONMENT OF INPATIENT ROUTINE SERVICE CAPITAL COSTS,APPORTIONMENT OF INPATIENT ANCILLARY SERVICE CAPITAL COSTS,APPORTIONMENT OF INPATIENT ANCILLARY SERVICE CAPITAL COSTS,APPORTIONMENT OF INPATIENT ANCILLARY SERVICE CAPITAL COSTS,APPORTIONMENT OF INPATIENT ANCILLARY SERVICE CAPITAL COSTS,CALCULATION OF REIMBURSEMENT SETTLEMENT (PPS),CALCULATION OF REIMBURSEMENT SETTLEMENT (PPS),CALCULATION OF REIMBURSEMENT SETTLEMENT (PPS),CALCULATION OF REIMBURSEMENT SETTLEMENT (PPS),CALCULATION OF REIMBURSEMENT SETTLEMENT (PPS),CALCULATION OF REIMBURSEMENT SETTLEMENT (PPS),CALCULATION OF REIMBURSEMENT SETTLEMENT (PPS),CALCULATION OF REIMBURSEMENT SETTLEMENT (PPS),CALCULATION OF REIMBURSEMENT SETTLEMENT (PPS),CALCULATION OF REIMBURSEMENT SETTLEMENT (PPS),CALCULATION OF REIMBURSEMENT SETTLEMENT (PPS),CALCULATION OF REIMBURSEMENT SETTLEMENT (PPS),CALCULATION OF REIMBURSEMENT SETTLEMENT (PPS),CALCULATION OF REIMBURSEMENT SETTLEMENT (PPS),CALCULATION OF REIMBURSEMENT SETTLEMENT (PPS),CALCULATION OF REIMBURSEMENT SETTLEMENT (PPS),CALCULATION OF REIMBURSEMENT SETTLEMENT (PPS),CALCULATION OF REIMBURSEMENT SETTLEMENT (PPS),CALCULATION OF REIMBURSEMENT SETTLEMENT (PPS),CALCULATION OF REIMBURSEMENT SETTLEMENT (PPS),CALCULATION OF REIMBURSEMENT SETTLEMENT (PPS),CALCULATION OF REIMBURSEMENT SETTLEMENT (PPS),CALCULATION OF REIMBURSEMENT SETTLEMENT (PPS),CALCULATION OF REIMBURSEMENT SETTLEMENT (PPS),CALCULATION OF REIMBURSEMENT SETTLEMENT (PPS),CALCULATION OF DIRECT GME,CALCULATION OF DIRECT GME,CALCULATION OF DIRECT GME,CALCULATION OF DIRECT GME,CALCULATION OF DIRECT GME,CALCULATION OF DIRECT GME,CALCULATION OF DIRECT GME,CALCULATION OF DIRECT GME,CALCULATION OF DIRECT GME,CALCULATION OF DIRECT GME,CALCULATION OF DIRECT GME,CALCULATION OF DIRECT GME,CALCULATION OF DIRECT GME,CALCULATION OF DIRECT GME,CALCULATION OF DIRECT GME,CALCULATION OF DIRECT GME,CALCULATION OF REIMBURSEMENT SETTLEMENT (PPS),CALCULATION OF REIMBURSEMENT SETTLEMENT (PPS),CALCULATION OF REIMBURSEMENT SETTLEMENT (PPS),CALCULATION OF REIMBURSEMENT SETTLEMENT (PPS),CALCULATION OF REIMBURSEMENT SETTLEMENT (PPS),CALCULATION OF REIMBURSEMENT SETTLEMENT (PPS),CALCULATION OF REIMBURSEMENT SETTLEMENT (PPS),CALCULATION OF REIMBURSEMENT SETTLEMENT (PPS),CALCULATION OF REIMBURSEMENT SETTLEMENT (PPS),CALCULATION OF REIMBURSEMENT SETTLEMENT (PPS),CALCULATION OF REIMBURSEMENT SETTLEMENT (PPS),CALCULATION OF REIMBURSEMENT SETTLEMENT (PPS),CALCULATION OF REIMBURSEMENT SETTLEMENT (PPS),CALCULATION OF REIMBURSEMENT SETTLEMENT (PPS),CALCULATION OF REIMBURSEMENT SETTLEMENT (PPS),CALCULATION OF REIMBURSEMENT SETTLEMENT (PPS),CALCULATION OF REIMBURSEMENT SETTLEMENT,STATEMENT OF REVENUES AND EXPENSES,STATEMENT OF REVENUES AND EXPENSES,STATEMENT OF REVENUES AND EXPENSES,S-10 DATA,Total Inpatient Days/Outpatient Visits,Total Inpatient Days/Outpatient Visits,Total Inpatient Days/Outpatient Visits,Total Inpatient Days/Outpatient Visits,NUMBER OF BEDS,BED DAYS AVAILABLE,Medicare Inpatient Days/Outpatient Visits,Medicaid Inpatient Days/Outpatient Visits,Total Inpatient Days/Outpatient Visits,HOSPITAL WAGE INDEX DATA,HOSPITAL WAGE INDEX DATA,HOSPITAL WAGE INDEX DATA,HOSPITAL WAGE INDEX DATA,ADJUSTMENTS,TRIAL BALANCE OF EXPENSE ACCOUNTS,TRIAL BALANCE OF EXPENSE ACCOUNTS,COST ALLOCATION,COST ALLOCATION,COST ALLOCATION,COST ALLOCATION,ALLOCATION OF NEW CAPITAL COSTS,ALLOCATION OF NEW CAPITAL COSTS,COMPUTATION OF RATIO OF COST TO CHARGES,COMPUTATION OF RATIO OF COST TO CHARGES,COMPUTATION OF RATIO OF COST TO CHARGES,COMPUTATION OF RATIO OF COST TO CHARGES,COMPUTATION OF INPATIENT OPERATING COSTS,COMPUTATION OF INPATIENT OPERATING COSTS,COMPUTATION OF INPATIENT OPERATING COSTS,INPATIENT ANCILLARY SERVICE COST APPORTIONMENT,INPATIENT ANCILLARY SERVICE COST APPORTIONMENT,INPATIENT ANCILLARY SERVICE COST APPORTIONMENT,CALCULATION OF REIMBURSEMENT SETTLEMENT,CALCULATION OF REIMBURSEMENT SETTLEMENT,CALCULATION OF REIMBURSEMENT SETTLEMENT,CALCULATION OF REIMBURSEMENT SETTLEMENT,CALCULATION OF REIMBURSEMENT SETTLEMENT,CALCULATION OF REIMBURSEMENT SETTLEMENT,CALCULATION OF REIMBURSEMENT SETTLEMENT,CALCULATION OF REIMBURSEMENT SETTLEMENT,CALCULATION OF REIMBURSEMENT SETTLEMENT,CALCULATION OF REIMBURSEMENT SETTLEMENT,CALCULATION OF REIMBURSEMENT SETTLEMENT,CALCULATION OF REIMBURSEMENT SETTLEMENT,CALCULATION OF REIMBURSEMENT SETTLEMENT,STATEMENT OF PATIENT REVENUES AND OPERATING EXPENSES,STATEMENT OF PATIENT REVENUES AND OPERATING EXPENSES,STATEMENT OF REVENUES AND EXPENSES,STATEMENT OF REVENUES AND EXPENSES,STATEMENT OF REVENUES AND EXPENSES,STATEMENT OF REVENUES AND EXPENSES,STATEMENT OF REVENUES AND EXPENSES,STATEMENT OF REVENUES AND EXPENSES,STATEMENT OF REVENUES AND EXPENSES,STATEMENT OF REVENUES AND EXPENSES,STATEMENT OF REVENUES AND EXPENSES,STATEMENT OF REVENUES AND EXPENSES,STATEMENT OF REVENUES AND EXPENSES,STATEMENT OF REVENUES AND EXPENSES,STATEMENT OF REVENUES AND EXPENSES,STATEMENT OF REVENUES AND EXPENSES,STATEMENT OF REVENUES AND EXPENSES,STATEMENT OF REVENUES AND EXPENSES,STATEMENT OF REVENUES AND EXPENSES,STATEMENT OF REVENUES AND EXPENSES,STATEMENT OF REVENUES AND EXPENSES,STATEMENT OF REVENUES AND EXPENSES,STATEMENT OF REVENUES AND EXPENSES,STATEMENT OF REVENUES AND EXPENSES,STATEMENT OF REVENUES AND EXPENSES,STATEMENT OF REVENUES AND EXPENSES,STATEMENT OF REVENUES AND EXPENSES,STATEMENT OF REVENUES AND EXPENSES,STATEMENT OF REVENUES AND EXPENSES,STATEMENT OF REVENUES AND EXPENSES,STATEMENT OF REVENUES AND EXPENSES,STATEMENT OF REVENUES AND EXPENSES,STATEMENT OF REVENUES AND EXPENSES,STATEMENT OF REVENUES AND EXPENSES,STATEMENT OF REVENUES AND EXPENSES,STATEMENT OF REVENUES AND EXPENSES,STATEMENT OF REVENUES AND EXPENSES,STATEMENT OF REVENUES AND EXPENSES,STATEMENT OF REVENUES AND EXPENSES,STATEMENT OF REVENUES AND EXPENSES,STATEMENT OF REVENUES AND EXPENSES,STATEMENT OF REVENUES AND EXPENSES,STATEMENT OF REVENUES AND EXPENSES,STATEMENT OF REVENUES AND EXPENSES,STATEMENT OF REVENUES AND EXPENSES,STATEMENT OF REVENUES AND EXPENSES,No Description,Total Inpatient Days/Outpatient Visits,NUMBER OF BEDS,BED DAYS AVAILABLE,Medicare Inpatient Days/Outpatient Visits,Medicaid Inpatient Days/Outpatient Visits,Total Inpatient Days/Outpatient Visits,HOSPITAL WAGE INDEX DATA,HOSPITAL WAGE INDEX DATA,HOSPITAL WAGE INDEX DATA,HOSPITAL WAGE INDEX DATA,HOSPITAL WAGE INDEX DATA,HHA STATISTICAL DATA,HHA STATISTICAL DATA,HHA STATISTICAL DATA,HHA STATISTICAL DATA,HHA STATISTICAL DATA,HHA STATISTICAL DATA,HHA STATISTICAL DATA,HHA STATISTICAL DATA,HHA STATISTICAL DATA,HHA STATISTICAL DATA,HHA STATISTICAL DATA,HHA STATISTICAL DATA,HHA STATISTICAL DATA,HHA STATISTICAL DATA,HHA STATISTICAL DATA,HHA STATISTICAL DATA,HHA STATISTICAL DATA,HHA STATISTICAL DATA,HHA STATISTICAL DATA,HHA STATISTICAL DATA,TRIAL BALANCE OF EXPENSE ACCOUNTS,TRIAL BALANCE OF EXPENSE ACCOUNTS,TRIAL BALANCE OF EXPENSE ACCOUNTS,TRIAL BALANCE OF EXPENSE ACCOUNTS,TRIAL BALANCE OF EXPENSE ACCOUNTS,COST ALLOCATION,COST ALLOCATION,COST ALLOCATION,COST ALLOCATION,COST ALLOCATION,ALLOCATION OF NEW CAPITAL COSTS,ALLOCATION OF NEW CAPITAL COSTS,COMPUTATION OF RATIO OF COST TO CHARGES,COMPUTATION OF RATIO OF COST TO CHARGES,COMPUTATION OF RATIO OF COST TO CHARGES,No Description,No Description,APPORTIONMENT OF INPATIENT ROUTINE SERVICE OTHER PASS THROUGH COSTS,APPORTIONMENT OF INPATIENT ROUTINE SERVICE OTHER PASS THROUGH COSTS,APPORTIONMENT OF INPATIENT ROUTINE SERVICE OTHER PASS THROUGH COSTS,APPORTIONMENT OF INPATIENT ROUTINE SERVICE OTHER PASS THROUGH COSTS,CALCULATION OF REIMBURSEMENT SETTLEMENT (PPS),CALCULATION OF REIMBURSEMENT SETTLEMENT (PPS),CALCULATION OF DIRECT GME,CALCULATION OF DIRECT GME,CALCULATION OF DIRECT GME,CALCULATION OF DIRECT GME,CALCULATION OF REIMBURSEMENT SETTLEMENT (PPS),CALCULATION OF REIMBURSEMENT SETTLEMENT (PPS),CALCULATION OF REIMBURSEMENT SETTLEMENT (PPS),CALCULATION OF REIMBURSEMENT SETTLEMENT (PPS),CALCULATION OF REIMBURSEMENT SETTLEMENT (PPS),CALCULATION OF REIMBURSEMENT SETTLEMENT (PPS),CALCULATION OF REIMBURSEMENT SETTLEMENT (PPS),CALCULATION OF REIMBURSEMENT SETTLEMENT (PPS),CALCULATION OF REIMBURSEMENT SETTLEMENT (PPS),CALCULATION OF REIMBURSEMENT SETTLEMENT,Total Inpatient Days/Outpatient Visits,Total Inpatient Days/Outpatient Visits,Medicare Inpatient Days/Outpatient Visits,Medicare Inpatient Days/Outpatient Visits,Medicaid Inpatient Days/Outpatient Visits,Total Inpatient Days/Outpatient Visits,Total Inpatient Days/Outpatient Visits,HOSPITAL WAGE INDEX DATA,HOSPITAL WAGE INDEX DATA,HOSPITAL WAGE INDEX DATA,HOSPITAL WAGE INDEX DATA,HOSPITAL CONTRACT LABOR AND BENEFIT COST,HOSPITAL CONTRACT LABOR AND BENEFIT COST,ALLOCATION OF NEW CAPITAL COSTS,COMPUTATION OF INPATIENT OPERATING COSTS,CALCULATION OF REIMBURSEMENT SETTLEMENT,CALCULATION OF REIMBURSEMENT SETTLEMENT,CALCULATION OF REIMBURSEMENT SETTLEMENT,CALCULATION OF REIMBURSEMENT SETTLEMENT,CALCULATION OF REIMBURSEMENT SETTLEMENT,CALCULATION OF REIMBURSEMENT SETTLEMENT,CALCULATION OF REIMBURSEMENT SETTLEMENT,CALCULATION OF REIMBURSEMENT SETTLEMENT,CALCULATION OF REIMBURSEMENT SETTLEMENT,CALCULATION OF REIMBURSEMENT SETTLEMENT,CALCULATION OF REIMBURSEMENT SETTLEMENT,CALCULATION OF REIMBURSEMENT SETTLEMENT,CALCULATION OF REIMBURSEMENT SETTLEMENT,CALCULATION OF REIMBURSEMENT SETTLEMENT,STATEMENT OF PATIENT REVENUES AND OPERATING EXPENSES,Medicare Inpatient Days/Outpatient Visits,Total Inpatient Days/Outpatient Visits,Total Inpatient Days/Outpatient Visits,HOSPITAL WAGE INDEX DATA,HOSPITAL WAGE INDEX DATA,STATEMENT OF REVENUES AND EXPENSES,HHA STATISTICAL DATA,ADJUSTMENTS,CALCULATION OF REIMBURSEMENT SETTLEMENT,CALCULATION OF REIMBURSEMENT SETTLEMENT,STATEMENT OF PATIENT REVENUES AND OPERATING EXPENSES,S-10 DATA,S-10 DATA,S-10 DATA,S-10 DATA,Medicaid Inpatient Days/Outpatient Visits,HOSPITAL CONTRACT LABOR AND BENEFIT COST,HOSPITAL CONTRACT LABOR AND BENEFIT COST,ADJUSTMENTS,ADJUSTMENTS,TRIAL BALANCE OF EXPENSE ACCOUNTS,STATEMENT OF PATIENT REVENUES AND OPERATING EXPENSES,STATEMENT OF PATIENT REVENUES AND OPERATING EXPENSES,HOSPITAL WAGE INDEX DATA,HOSPITAL WAGE INDEX DATA,HOSPITAL WAGE INDEX DATA,HOSPITAL WAGE INDEX DATA,ADJUSTMENTS,TRIAL BALANCE OF EXPENSE ACCOUNTS,CALCULATION OF REIMBURSEMENT SETTLEMENT,No Description,No Description,No Description,No Description,No Description,No Description,No Description,No Description,No Description,No Description,No Description,No Description,No Description,No Description,STATEMENT OF REVENUES AND EXPENSES,Total Inpatient Days/Outpatient Visits,NUMBER OF BEDS,BED DAYS AVAILABLE,BED DAYS AVAILABLE,BED DAYS AVAILABLE,BED DAYS AVAILABLE,Medicaid Inpatient Days/Outpatient Visits,Total Inpatient Days/Outpatient Visits,ANALYSIS OF CHANGES IN NEW CAPITAL BALANCES,ADJUSTMENTS,TRIAL BALANCE OF EXPENSE ACCOUNTS,STATEMENT OF PATIENT REVENUES AND OPERATING EXPENSES,S-10 DATA,HOSPITAL WAGE INDEX DATA,APPORTIONMENT OF INPATIENT/OUTPATIENT ANCILLARY SERVICE OTHER PASS THROUGH COSTS,Medicaid Inpatient Days/Outpatient Visits,HOSPITAL WAGE INDEX DATA,HOSPITAL WAGE INDEX DATA,HOSPITAL WAGE INDEX DATA,HOSPITAL WAGE INDEX DATA,HOSPITAL WAGE INDEX DATA,HOSPITAL WAGE INDEX DATA,CALCULATION OF REIMBURSEMENT SETTLEMENT (PPS),CALCULATION OF REIMBURSEMENT SETTLEMENT (PPS),CALCULATION OF REIMBURSEMENT SETTLEMENT (PPS),CALCULATION OF REIMBURSEMENT SETTLEMENT (PPS),CALCULATION OF REIMBURSEMENT SETTLEMENT (PPS),CALCULATION OF REIMBURSEMENT SETTLEMENT (PPS),CALCULATION OF REIMBURSEMENT SETTLEMENT (PPS),CALCULATION OF REIMBURSEMENT SETTLEMENT (PPS),CALCULATION OF REIMBURSEMENT SETTLEMENT (PPS),ADJUSTMENTS,No Description,Medicare Inpatient Days/Outpatient Visits,Medicaid Inpatient Days/Outpatient Visits,TRIAL BALANCE OF EXPENSE ACCOUNTS,Medicare Inpatient Days/Outpatient Visits,Medicaid Inpatient Days/Outpatient Visits,Total Inpatient Days/Outpatient Visits,Total Inpatient Days/Outpatient Visits,CALCULATION OF REIMBURSEMENT SETTLEMENT (PPS),S-10 DATA,COMPUTATION OF RATIO OF COST TO CHARGES,STATEMENT OF PATIENT REVENUES AND OPERATING EXPENSES,HHA STATISTICAL DATA,HHA STATISTICAL DATA,HHA STATISTICAL DATA,HHA STATISTICAL DATA,HHA STATISTICAL DATA,HOSPITAL WAGE INDEX DATA,HOSPITAL WAGE INDEX DATA,ANALYSIS OF CHANGES IN NEW CAPITAL BALANCES,CALCULATION OF REIMBURSEMENT SETTLEMENT (PPS),APPORTIONMENT OF MEDICAL AND OTHER HEALTH SERVICES,APPORTIONMENT OF MEDICAL AND OTHER HEALTH SERVICES,STATEMENT OF PATIENT REVENUES AND OPERATING EXPENSES,HOSPITAL CONTRACT LABOR AND BENEFIT COST,CALCULATION OF REIMBURSEMENT SETTLEMENT (PPS),STATEMENT OF REVENUES AND EXPENSES,ANALYSIS OF CHANGES IN NEW CAPITAL BALANCES,ANALYSIS OF CHANGES IN NEW CAPITAL BALANCES,ANALYSIS OF CHANGES IN NEW CAPITAL BALANCES,ANALYSIS OF CHANGES IN NEW CAPITAL BALANCES,ANALYSIS OF CHANGES IN NEW CAPITAL BALANCES,ANALYSIS OF CHANGES IN NEW CAPITAL BALANCES,ANALYSIS OF CHANGES IN NEW CAPITAL BALANCES,TRIAL BALANCE OF EXPENSE ACCOUNTS,TRIAL BALANCE OF EXPENSE ACCOUNTS,TRIAL BALANCE OF EXPENSE ACCOUNTS,TRIAL BALANCE OF EXPENSE ACCOUNTS,TRIAL BALANCE OF EXPENSE ACCOUNTS,TRIAL BALANCE OF EXPENSE ACCOUNTS,TRIAL BALANCE OF EXPENSE ACCOUNTS,COST ALLOCATION,COST ALLOCATION,COST ALLOCATION,COST ALLOCATION,COST ALLOCATION,ALLOCATION OF NEW CAPITAL COSTS,ALLOCATION OF NEW CAPITAL COSTS,ALLOCATION OF NEW CAPITAL COSTS,COMPUTATION OF RATIO OF COST TO CHARGES,COMPUTATION OF RATIO OF COST TO CHARGES,COMPUTATION OF RATIO OF COST TO CHARGES,COMPUTATION OF RATIO OF COST TO CHARGES,COMPUTATION OF RATIO OF COST TO CHARGES,COMPUTATION OF RATIO OF COST TO CHARGES,COMPUTATION OF RATIO OF COST TO CHARGES,COMPUTATION OF RATIO OF COST TO CHARGES,COMPUTATION OF RATIO OF COST TO CHARGES,COMPUTATION OF RATIO OF COST TO CHARGES,No Description,No Description,CALCULATION OF DIRECT GME,CALCULATION OF DIRECT GME,CALCULATION OF DIRECT GME,CALCULATION OF REIMBURSEMENT SETTLEMENT (PPS),CALCULATION OF REIMBURSEMENT SETTLEMENT (PPS),CALCULATION OF REIMBURSEMENT SETTLEMENT (PPS),CALCULATION OF REIMBURSEMENT SETTLEMENT (PPS),HOSPITAL WAGE INDEX DATA,HOSPITAL WAGE INDEX DATA,HOSPITAL WAGE INDEX DATA,HOSPITAL WAGE INDEX DATA,HOSPITAL WAGE INDEX DATA,HOSPITAL WAGE INDEX DATA,HOSPITAL WAGE INDEX DATA,HOSPITAL WAGE INDEX DATA,HOSPITAL WAGE INDEX DATA,HOSPITAL WAGE INDEX DATA,HOSPITAL WAGE INDEX DATA,HOSPITAL WAGE INDEX DATA,HOSPITAL WAGE INDEX DATA,HOSPITAL CONTRACT LABOR AND BENEFIT COST,STATEMENT OF PATIENT REVENUES AND OPERATING EXPENSES,RENAL STATISTICAL DATA,RENAL STATISTICAL DATA,RENAL STATISTICAL DATA,RENAL STATISTICAL DATA,RENAL STATISTICAL DATA,RENAL STATISTICAL DATA,RENAL STATISTICAL DATA,RENAL STATISTICAL DATA,RENAL STATISTICAL DATA,RENAL STATISTICAL DATA,TRIAL BALANCE OF EXPENSE ACCOUNTS,STATEMENT OF PATIENT REVENUES AND OPERATING EXPENSES,RENAL STATISTICAL DATA,RENAL STATISTICAL DATA,RENAL STATISTICAL DATA,STATEMENT OF REVENUES AND EXPENSES,STATEMENT OF REVENUES AND EXPENSES,STATEMENT OF REVENUES AND EXPENSES,STATEMENT OF REVENUES AND EXPENSES,STATEMENT OF REVENUES AND EXPENSES,STATEMENT OF REVENUES AND EXPENSES,STATEMENT OF REVENUES AND EXPENSES,STATEMENT OF REVENUES AND EXPENSES,STATEMENT OF REVENUES AND EXPENSES,STATEMENT OF REVENUES AND EXPENSES,STATEMENT OF REVENUES AND EXPENSES,HHA STATISTICAL DATA,CALCULATION OF REIMBURSEMENT SETTLEMENT (PPS),TRIAL BALANCE OF EXPENSE ACCOUNTS,TRIAL BALANCE OF EXPENSE ACCOUNTS,TRIAL BALANCE OF EXPENSE ACCOUNTS,COST ALLOCATION,COST ALLOCATION,ALLOCATION OF NEW CAPITAL COSTS,COMPUTATION OF RATIO OF COST TO CHARGES,COMPUTATION OF RATIO OF COST TO CHARGES,STATEMENT OF PATIENT REVENUES AND OPERATING EXPENSES,Total Inpatient Days/Outpatient Visits,Total Inpatient Days/Outpatient Visits,NUMBER OF BEDS,BED DAYS AVAILABLE,Total Inpatient Days/Outpatient Visits,CALCULATION OF REIMBURSEMENT SETTLEMENT,No Description,STATEMENT OF PATIENT REVENUES AND OPERATING EXPENSES,STATEMENT OF REVENUES AND EXPENSES,COST ALLOCATION,LTCH PPS,CALCULATION OF REIMBURSEMENT SETTLEMENT,CALCULATION OF REIMBURSEMENT SETTLEMENT,CALCULATION OF REIMBURSEMENT SETTLEMENT,CALCULATION OF REIMBURSEMENT SETTLEMENT,CALCULATION OF REIMBURSEMENT SETTLEMENT,CALCULATION OF REIMBURSEMENT SETTLEMENT,CALCULATION OF REIMBURSEMENT SETTLEMENT,CALCULATION OF REIMBURSEMENT SETTLEMENT,CALCULATION OF REIMBURSEMENT SETTLEMENT,CALCULATION OF REIMBURSEMENT SETTLEMENT,CALCULATION OF REIMBURSEMENT SETTLEMENT,CALCULATION OF REIMBURSEMENT SETTLEMENT,CALCULATION OF REIMBURSEMENT SETTLEMENT,CALCULATION OF REIMBURSEMENT SETTLEMENT,Total Inpatient Days/Outpatient Visits,TRIAL BALANCE OF EXPENSE ACCOUNTS,COST ALLOCATION,TRIAL BALANCE OF EXPENSE ACCOUNTS,TRIAL BALANCE OF EXPENSE ACCOUNTS,TRIAL BALANCE OF EXPENSE ACCOUNTS,COST ALLOCATION,COST ALLOCATION,ALLOCATION OF NEW CAPITAL COSTS,COMPUTATION OF RATIO OF COST TO CHARGES,COMPUTATION OF RATIO OF COST TO CHARGES,APPORTIONMENT OF INPATIENT ROUTINE SERVICE CAPITAL COSTS,Total Inpatient Days/Outpatient Visits,NUMBER OF BEDS,BED DAYS AVAILABLE,Total Inpatient Days/Outpatient Visits,CALCULATION OF REIMBURSEMENT SETTLEMENT,ADJUSTMENTS,STATEMENT OF REVENUES AND EXPENSES,Total Inpatient Days/Outpatient Visits,Total Inpatient Days/Outpatient Visits,BED DAYS AVAILABLE,BED DAYS AVAILABLE,BED DAYS AVAILABLE,No Description,ADJUSTMENTS,CALCULATION OF REIMBURSEMENT SETTLEMENT,TRIAL BALANCE OF EXPENSE ACCOUNTS,COST ALLOCATION,COST ALLOCATION,ALLOCATION OF NEW CAPITAL COSTS,COMPUTATION OF RATIO OF COST TO CHARGES,COMPUTATION OF RATIO OF COST TO CHARGES,COMPUTATION OF RATIO OF COST TO CHARGES,APPORTIONMENT OF MEDICAL AND OTHER HEALTH SERVICES,APPORTIONMENT OF MEDICAL AND OTHER HEALTH SERVICES,CALCULATION OF REIMBURSEMENT SETTLEMENT,CALCULATION OF REIMBURSEMENT SETTLEMENT,STATEMENT OF REVENUES AND EXPENSES,S-10 DATA,RENAL STATISTICAL DATA,RENAL STATISTICAL DATA,RENAL STATISTICAL DATA,RENAL STATISTICAL DATA,RENAL STATISTICAL DATA,RENAL STATISTICAL DATA,RENAL STATISTICAL DATA,RENAL STATISTICAL DATA,RENAL STATISTICAL DATA,STATEMENT OF REVENUES AND EXPENSES,STATEMENT OF REVENUES AND EXPENSES,BED DAYS AVAILABLE,CALCULATION OF REIMBURSEMENT SETTLEMENT,CALCULATION OF REIMBURSEMENT SETTLEMENT,CALCULATION OF REIMBURSEMENT SETTLEMENT,CALCULATION OF REIMBURSEMENT SETTLEMENT,CALCULATION OF REIMBURSEMENT SETTLEMENT,CALCULATION OF REIMBURSEMENT SETTLEMENT,CALCULATION OF REIMBURSEMENT SETTLEMENT,CALCULATION OF REIMBURSEMENT SETTLEMENT,CALCULATION OF REIMBURSEMENT SETTLEMENT,CALCULATION OF REIMBURSEMENT SETTLEMENT,CALCULATION OF REIMBURSEMENT SETTLEMENT,CALCULATION OF REIMBURSEMENT SETTLEMENT,CALCULATION OF REIMBURSEMENT SETTLEMENT,Medicaid Inpatient Days/Outpatient Visits,STATEMENT OF REVENUES AND EXPENSES,CALCULATION OF REIMBURSEMENT SETTLEMENT (PPS),HOSPITAL WAGE INDEX DATA,HOSPITAL WAGE INDEX DATA,CALCULATION OF REIMBURSEMENT SETTLEMENT (PPS),CALCULATION OF REIMBURSEMENT SETTLEMENT,TRIAL BALANCE OF EXPENSE ACCOUNTS,TRIAL BALANCE OF EXPENSE ACCOUNTS,COST ALLOCATION,COST ALLOCATION,COST ALLOCATION,COST ALLOCATION,COST ALLOCATION,APPORTIONMENT OF INPATIENT ROUTINE SERVICE OTHER PASS THROUGH COSTS,APPORTIONMENT OF INPATIENT ROUTINE SERVICE OTHER PASS THROUGH COSTS,APPORTIONMENT OF INPATIENT/OUTPATIENT ANCILLARY SERVICE OTHER PASS THROUGH COSTS,APPORTIONMENT OF INPATIENT/OUTPATIENT ANCILLARY SERVICE OTHER PASS THROUGH COSTS,APPORTIONMENT OF INPATIENT/OUTPATIENT ANCILLARY SERVICE OTHER PASS THROUGH COSTS,APPORTIONMENT OF INPATIENT/OUTPATIENT ANCILLARY SERVICE OTHER PASS THROUGH COSTS,APPORTIONMENT OF INPATIENT/OUTPATIENT ANCILLARY SERVICE OTHER PASS THROUGH COSTS,APPORTIONMENT OF INPATIENT/OUTPATIENT ANCILLARY SERVICE OTHER PASS THROUGH COSTS,CALCULATION OF REIMBURSEMENT SETTLEMENT (PPS),CALCULATION OF REIMBURSEMENT SETTLEMENT (PPS),CALCULATION OF REIMBURSEMENT SETTLEMENT (PPS),CALCULATION OF REIMBURSEMENT SETTLEMENT (PPS),CALCULATION OF REIMBURSEMENT SETTLEMENT (PPS),CALCULATION OF REIMBURSEMENT SETTLEMENT (PPS),CALCULATION OF REIMBURSEMENT SETTLEMENT (PPS),CALCULATION OF REIMBURSEMENT SETTLEMENT (PPS),CALCULATION OF REIMBURSEMENT SETTLEMENT (PPS),CALCULATION OF REIMBURSEMENT SETTLEMENT (PPS),CALCULATION OF REIMBURSEMENT SETTLEMENT (PPS),CALCULATION OF REIMBURSEMENT SETTLEMENT (PPS),CALCULATION OF REIMBURSEMENT SETTLEMENT (PPS),Total Inpatient Days/Outpatient Visits,Total Inpatient Days/Outpatient Visits,HOSPITAL WAGE INDEX DATA,TRIAL BALANCE OF EXPENSE ACCOUNTS,COMPUTATION OF INPATIENT OPERATING COSTS,COMPUTATION OF INPATIENT OPERATING COSTS,COMPUTATION OF INPATIENT OPERATING COSTS,COMPUTATION OF INPATIENT OPERATING COSTS,COMPUTATION OF INPATIENT OPERATING COSTS,COMPUTATION OF INPATIENT OPERATING COSTS,CALCULATION OF REIMBURSEMENT SETTLEMENT (TEFRA),CALCULATION OF REIMBURSEMENT SETTLEMENT (TEFRA),CALCULATION OF REIMBURSEMENT SETTLEMENT (TEFRA),CALCULATION OF REIMBURSEMENT SETTLEMENT (TEFRA),CALCULATION OF REIMBURSEMENT SETTLEMENT (TEFRA),CALCULATION OF REIMBURSEMENT SETTLEMENT (TEFRA),CALCULATION OF REIMBURSEMENT SETTLEMENT (TEFRA),CALCULATION OF REIMBURSEMENT SETTLEMENT (TEFRA),CALCULATION OF REIMBURSEMENT SETTLEMENT (TEFRA),CALCULATION OF REIMBURSEMENT SETTLEMENT (TEFRA),CALCULATION OF REIMBURSEMENT SETTLEMENT (TEFRA),CALCULATION OF REIMBURSEMENT SETTLEMENT (TEFRA),CALCULATION OF REIMBURSEMENT SETTLEMENT (TEFRA),CALCULATION OF REIMBURSEMENT SETTLEMENT (PPS),HOSPITAL WAGE INDEX DATA,HOSPITAL WAGE INDEX DATA,HOSPITAL WAGE INDEX DATA,HOSPITAL WAGE INDEX DATA,CALCULATION OF REIMBURSEMENT SETTLEMENT,CALCULATION OF REIMBURSEMENT SETTLEMENT,STATEMENT OF REVENUES AND EXPENSES,Total Inpatient Days/Outpatient Visits,STATEMENT OF REVENUES AND EXPENSES,INPATIENT ANCILLARY SERVICE COST APPORTIONMENT,APPORTIONMENT OF INPATIENT/OUTPATIENT ANCILLARY SERVICE OTHER PASS THROUGH COSTS,APPORTIONMENT OF INPATIENT/OUTPATIENT ANCILLARY SERVICE OTHER PASS THROUGH COSTS,APPORTIONMENT OF INPATIENT/OUTPATIENT ANCILLARY SERVICE OTHER PASS THROUGH COSTS,CALCULATION OF REIMBURSEMENT SETTLEMENT,CALCULATION OF REIMBURSEMENT SETTLEMENT,CALCULATION OF REIMBURSEMENT SETTLEMENT,CALCULATION OF REIMBURSEMENT SETTLEMENT,CALCULATION OF REIMBURSEMENT SETTLEMENT,CALCULATION OF REIMBURSEMENT SETTLEMENT,CALCULATION OF REIMBURSEMENT SETTLEMENT,CALCULATION OF REIMBURSEMENT SETTLEMENT,CALCULATION OF REIMBURSEMENT SETTLEMENT,CALCULATION OF REIMBURSEMENT SETTLEMENT,CALCULATION OF REIMBURSEMENT SETTLEMENT,CALCULATION OF REIMBURSEMENT SETTLEMENT,CALCULATION OF REIMBURSEMENT SETTLEMENT,CALCULATION OF REIMBURSEMENT SETTLEMENT,CALCULATION OF REIMBURSEMENT SETTLEMENT,CALCULATION OF REIMBURSEMENT SETTLEMENT,CALCULATION OF REIMBURSEMENT SETTLEMENT,CALCULATION OF REIMBURSEMENT SETTLEMENT,CALCULATION OF REIMBURSEMENT SETTLEMENT,CALCULATION OF REIMBURSEMENT SETTLEMENT,CALCULATION OF REIMBURSEMENT SETTLEMENT,CALCULATION OF REIMBURSEMENT SETTLEMENT,CALCULATION OF REIMBURSEMENT SETTLEMENT,CALCULATION OF REIMBURSEMENT SETTLEMENT,CALCULATION OF REIMBURSEMENT SETTLEMENT,CALCULATION OF REIMBURSEMENT SETTLEMENT,RENAL STATISTICAL DATA,RENAL STATISTICAL DATA,RENAL STATISTICAL DATA,RENAL STATISTICAL DATA,APPORTIONMENT OF INPATIENT ROUTINE SERVICE OTHER PASS THROUGH COSTS,APPORTIONMENT OF INPATIENT/OUTPATIENT ANCILLARY SERVICE OTHER PASS THROUGH COSTS,APPORTIONMENT OF INPATIENT/OUTPATIENT ANCILLARY SERVICE OTHER PASS THROUGH COSTS,APPORTIONMENT OF INPATIENT/OUTPATIENT ANCILLARY SERVICE OTHER PASS THROUGH COSTS,APPORTIONMENT OF INPATIENT/OUTPATIENT ANCILLARY SERVICE OTHER PASS THROUGH COSTS,APPORTIONMENT OF INPATIENT/OUTPATIENT ANCILLARY SERVICE OTHER PASS THROUGH COSTS,APPORTIONMENT OF INPATIENT/OUTPATIENT ANCILLARY SERVICE OTHER PASS THROUGH COSTS,CALCULATION OF REIMBURSEMENT SETTLEMENT,CALCULATION OF REIMBURSEMENT SETTLEMENT,STATEMENT OF REVENUES AND EXPENSES,STATEMENT OF REVENUES AND EXPENSES,ADJUSTMENTS,CALCULATION OF DIRECT GME,No Description,STATEMENT OF PATIENT REVENUES AND OPERATING EXPENSES,APPORTIONMENT OF INPATIENT/OUTPATIENT ANCILLARY SERVICE OTHER PASS THROUGH COSTS,ADJUSTMENTS,LTCH PPS,CALCULATION OF DIRECT GME,ANALYSIS OF CHANGES IN NEW CAPITAL BALANCES,STATEMENT OF REVENUES AND EXPENSES,STATEMENT OF REVENUES AND EXPENSES,CALCULATION OF REIMBURSEMENT SETTLEMENT,ADJUSTMENTS,STATEMENT OF REVENUES AND EXPENSES,STATEMENT OF REVENUES AND EXPENSES,ANALYSIS OF CHANGES IN NEW CAPITAL BALANCES,CALCULATION OF REIMBURSEMENT SETTLEMENT (PPS),CALCULATION OF REIMBURSEMENT SETTLEMENT (PPS),STATEMENT OF PATIENT REVENUES AND OPERATING EXPENSES,STATEMENT OF REVENUES AND EXPENSES,TRIAL BALANCE OF EXPENSE ACCOUNTS,TRIAL BALANCE OF EXPENSE ACCOUNTS,TRIAL BALANCE OF EXPENSE ACCOUNTS,COST ALLOCATION,COST ALLOCATION,ALLOCATION OF NEW CAPITAL COSTS,COMPUTATION OF RATIO OF COST TO CHARGES,COMPUTATION OF RATIO OF COST TO CHARGES,LTCH PPS,LTCH PPS,LTCH PPS,LTCH PPS,ADJUSTMENTS,HOSPITAL WAGE INDEX DATA,INPATIENT ANCILLARY SERVICE COST APPORTIONMENT,CALCULATION OF DIRECT GME,CALCULATION OF REIMBURSEMENT SETTLEMENT (PPS),HOSPITAL CONTRACT LABOR AND BENEFIT COST,TRIAL BALANCE OF EXPENSE ACCOUNTS,TRIAL BALANCE OF EXPENSE ACCOUNTS,TRIAL BALANCE OF EXPENSE ACCOUNTS,TRIAL BALANCE OF EXPENSE ACCOUNTS,COST ALLOCATION,COST ALLOCATION,COST ALLOCATION,ALLOCATION OF NEW CAPITAL COSTS,COMPUTATION OF RATIO OF COST TO CHARGES,COMPUTATION OF RATIO OF COST TO CHARGES,INPATIENT ANCILLARY SERVICE COST APPORTIONMENT,INPATIENT ANCILLARY SERVICE COST APPORTIONMENT,No Description,APPORTIONMENT OF INPATIENT ANCILLARY SERVICE CAPITAL COSTS,APPORTIONMENT OF INPATIENT/OUTPATIENT ANCILLARY SERVICE OTHER PASS THROUGH COSTS,APPORTIONMENT OF INPATIENT/OUTPATIENT ANCILLARY SERVICE OTHER PASS THROUGH COSTS,APPORTIONMENT OF INPATIENT/OUTPATIENT ANCILLARY SERVICE OTHER PASS THROUGH COSTS,APPORTIONMENT OF INPATIENT/OUTPATIENT ANCILLARY SERVICE OTHER PASS THROUGH COSTS,APPORTIONMENT OF INPATIENT/OUTPATIENT ANCILLARY SERVICE OTHER PASS THROUGH COSTS,CALCULATION OF REIMBURSEMENT SETTLEMENT (PPS),CALCULATION OF DIRECT GME,CALCULATION OF DIRECT GME,CALCULATION OF DIRECT GME,CALCULATION OF REIMBURSEMENT SETTLEMENT (PPS),CALCULATION OF REIMBURSEMENT SETTLEMENT,CALCULATION OF REIMBURSEMENT SETTLEMENT,RENAL STATISTICAL DATA,COST ALLOCATION,HOSPITAL WAGE INDEX DATA,HOSPITAL WAGE INDEX DATA,HOSPITAL WAGE INDEX DATA,HOSPITAL WAGE INDEX DATA,HOSPITAL CONTRACT LABOR AND BENEFIT COST,HOSPITAL CONTRACT LABOR AND BENEFIT COST,COMPUTATION OF RATIO OF COST TO CHARGES,CALCULATION OF REIMBURSEMENT SETTLEMENT (PPS),HOSPITAL WAGE INDEX DATA,HOSPITAL WAGE INDEX DATA,BED DAYS AVAILABLE,CALCULATION OF REIMBURSEMENT SETTLEMENT,HOSPITAL CONTRACT LABOR AND BENEFIT COST,HOSPITAL CONTRACT LABOR AND BENEFIT COST,TRIAL BALANCE OF EXPENSE ACCOUNTS,RENAL STATISTICAL DATA,STATEMENT OF PATIENT REVENUES AND OPERATING EXPENSES,STATEMENT OF REVENUES AND EXPENSES,CALCULATION OF REIMBURSEMENT SETTLEMENT,CALCULATION OF REIMBURSEMENT SETTLEMENT,CALCULATION OF REIMBURSEMENT SETTLEMENT,CALCULATION OF REIMBURSEMENT SETTLEMENT (PPS),STATEMENT OF PATIENT REVENUES AND OPERATING EXPENSES,CALCULATION OF DIRECT GME,CALCULATION OF REIMBURSEMENT SETTLEMENT (PPS),COST ALLOCATION,COST ALLOCATION,COMPUTATION OF RATIO OF COST TO CHARGES,COMPUTATION OF RATIO OF COST TO CHARGES,COMPUTATION OF RATIO OF COST TO CHARGES,INPATIENT ANCILLARY SERVICE COST APPORTIONMENT,INPATIENT ANCILLARY SERVICE COST APPORTIONMENT,RENAL STATISTICAL DATA,APPORTIONMENT OF MEDICAL AND OTHER HEALTH SERVICES,CALCULATION OF REIMBURSEMENT SETTLEMENT (PPS),CALCULATION OF REIMBURSEMENT SETTLEMENT,CALCULATION OF REIMBURSEMENT SETTLEMENT,STATEMENT OF PATIENT REVENUES AND OPERATING EXPENSES,STATEMENT OF REVENUES AND EXPENSES,HOSPITAL WAGE INDEX DATA,HOSPITAL WAGE INDEX DATA,HOSPITAL WAGE INDEX DATA,HOSPITAL WAGE INDEX DATA,CALCULATION OF REIMBURSEMENT SETTLEMENT,RENAL STATISTICAL DATA,RENAL STATISTICAL DATA,COST ALLOCATION,APPORTIONMENT OF INPATIENT/OUTPATIENT ANCILLARY SERVICE OTHER PASS THROUGH COSTS,COMPUTATION OF INPATIENT OPERATING COSTS,CALCULATION OF REIMBURSEMENT SETTLEMENT (TEFRA),CALCULATION OF REIMBURSEMENT SETTLEMENT (TEFRA),CALCULATION OF REIMBURSEMENT SETTLEMENT (TEFRA),CALCULATION OF REIMBURSEMENT SETTLEMENT (TEFRA),APPORTIONMENT OF INPATIENT/OUTPATIENT ANCILLARY SERVICE OTHER PASS THROUGH COSTS,CALCULATION OF DIRECT GME,CALCULATION OF REIMBURSEMENT SETTLEMENT (PPS),CALCULATION OF REIMBURSEMENT SETTLEMENT,ANALYSIS OF CHANGES IN NEW CAPITAL BALANCES,CALCULATION OF REIMBURSEMENT SETTLEMENT,CALCULATION OF REIMBURSEMENT SETTLEMENT,INPATIENT ANCILLARY SERVICE COST APPORTIONMENT,Total Inpatient Days/Outpatient Visits,Total Inpatient Days/Outpatient Visits,Medicaid Inpatient Days/Outpatient Visits,TRIAL BALANCE OF EXPENSE ACCOUNTS,TRIAL BALANCE OF EXPENSE ACCOUNTS,COST ALLOCATION,COST ALLOCATION,ALLOCATION OF NEW CAPITAL COSTS,COMPUTATION OF RATIO OF COST TO CHARGES,COST ALLOCATION,COST ALLOCATION,COST ALLOCATION,COST ALLOCATION,STATEMENT OF REVENUES AND EXPENSES,STATEMENT OF REVENUES AND EXPENSES,STATEMENT OF REVENUES AND EXPENSES,STATEMENT OF REVENUES AND EXPENSES,STATEMENT OF REVENUES AND EXPENSES,CALCULATION OF REIMBURSEMENT SETTLEMENT (PPS),CALCULATION OF REIMBURSEMENT SETTLEMENT (PPS),CALCULATION OF REIMBURSEMENT SETTLEMENT,HOSPITAL WAGE INDEX DATA,HOSPITAL WAGE INDEX DATA,HOSPITAL WAGE INDEX DATA,STATEMENT OF REVENUES AND EXPENSES,CALCULATION OF REIMBURSEMENT SETTLEMENT (PPS),TRIAL BALANCE OF EXPENSE ACCOUNTS,CALCULATION OF REIMBURSEMENT SETTLEMENT (PPS),CALCULATION OF REIMBURSEMENT SETTLEMENT (PPS),CALCULATION OF REIMBURSEMENT SETTLEMENT,TRIAL BALANCE OF EXPENSE ACCOUNTS,COST ALLOCATION,COST ALLOCATION,COST ALLOCATION,COST ALLOCATION,COMPUTATION OF RATIO OF COST TO CHARGES,CALCULATION OF REIMBURSEMENT SETTLEMENT,No Description,LTCH PPS,CALCULATION OF REIMBURSEMENT SETTLEMENT,CALCULATION OF REIMBURSEMENT SETTLEMENT (PPS),CALCULATION OF REIMBURSEMENT SETTLEMENT (PPS),CALCULATION OF DIRECT GME,CALCULATION OF REIMBURSEMENT SETTLEMENT,CALCULATION OF REIMBURSEMENT SETTLEMENT,CALCULATION OF REIMBURSEMENT SETTLEMENT,No Description,Total Inpatient Days/Outpatient Visits,BED DAYS AVAILABLE,CALCULATION OF DIRECT GME,CALCULATION OF REIMBURSEMENT SETTLEMENT (PPS),HOSPITAL WAGE INDEX DATA,HOSPITAL WAGE INDEX DATA,HOSPITAL WAGE INDEX DATA,INPATIENT ANCILLARY SERVICE COST APPORTIONMENT,INPATIENT ANCILLARY SERVICE COST APPORTIONMENT,APPORTIONMENT OF INPATIENT/OUTPATIENT ANCILLARY SERVICE OTHER PASS THROUGH COSTS,Total Inpatient Days/Outpatient Visits,HOSPITAL CONTRACT LABOR AND BENEFIT COST,CALCULATION OF REIMBURSEMENT SETTLEMENT (PPS),CALCULATION OF REIMBURSEMENT SETTLEMENT,CALCULATION OF REIMBURSEMENT SETTLEMENT,CALCULATION OF REIMBURSEMENT SETTLEMENT,CALCULATION OF REIMBURSEMENT SETTLEMENT,CALCULATION OF REIMBURSEMENT SETTLEMENT,CALCULATION OF REIMBURSEMENT SETTLEMENT (PPS),CALCULATION OF REIMBURSEMENT SETTLEMENT (PPS),CALCULATION OF REIMBURSEMENT SETTLEMENT (PPS),CALCULATION OF REIMBURSEMENT SETTLEMENT (PPS),CALCULATION OF REIMBURSEMENT SETTLEMENT (PPS),CALCULATION OF REIMBURSEMENT SETTLEMENT,CALCULATION OF REIMBURSEMENT SETTLEMENT,HOSPITAL CONTRACT LABOR AND BENEFIT COST,HOSPITAL CONTRACT LABOR AND BENEFIT COST,CALCULATION OF REIMBURSEMENT SETTLEMENT,HOSPITAL WAGE INDEX DATA,STATEMENT OF REVENUES AND EXPENSES,STATEMENT OF REVENUES AND EXPENSES,STATEMENT OF REVENUES AND EXPENSES,STATEMENT OF REVENUES AND EXPENSES,STATEMENT OF REVENUES AND EXPENSES,STATEMENT OF REVENUES AND EXPENSES,STATEMENT OF REVENUES AND EXPENSES,STATEMENT OF REVENUES AND EXPENSES,STATEMENT OF REVENUES AND EXPENSES,STATEMENT OF REVENUES AND EXPENSES,STATEMENT OF REVENUES AND EXPENSES,STATEMENT OF REVENUES AND EXPENSES,STATEMENT OF REVENUES AND EXPENSES,STATEMENT OF REVENUES AND EXPENSES,STATEMENT OF REVENUES AND EXPENSES,STATEMENT OF REVENUES AND EXPENSES,STATEMENT OF REVENUES AND EXPENSES,STATEMENT OF REVENUES AND EXPENSES,STATEMENT OF REVENUES AND EXPENSES,STATEMENT OF REVENUES AND EXPENSES,STATEMENT OF REVENUES AND EXPENSES,STATEMENT OF REVENUES AND EXPENSES,STATEMENT OF REVENUES AND EXPENSES,STATEMENT OF REVENUES AND EXPENSES,STATEMENT OF REVENUES AND EXPENSES,STATEMENT OF REVENUES AND EXPENSES,STATEMENT OF REVENUES AND EXPENSES,STATEMENT OF REVENUES AND EXPENSES,STATEMENT OF REVENUES AND EXPENSES,STATEMENT OF REVENUES AND EXPENSES,STATEMENT OF REVENUES AND EXPENSES,STATEMENT OF REVENUES AND EXPENSES,STATEMENT OF REVENUES AND EXPENSES,STATEMENT OF REVENUES AND EXPENSES,HHA STATISTICAL DATA,HHA STATISTICAL DATA,HHA STATISTICAL DATA,HHA STATISTICAL DATA,HHA STATISTICAL DATA,HHA STATISTICAL DATA,HHA STATISTICAL DATA,HHA STATISTICAL DATA,HHA STATISTICAL DATA,HHA STATISTICAL DATA,HHA STATISTICAL DATA,ANALYSIS OF CHANGES IN NEW CAPITAL BALANCES,CALCULATION OF REIMBURSEMENT SETTLEMENT (PPS),COST ALLOCATION,COST ALLOCATION,Total Inpatient Days/Outpatient Visits,HOSPITAL CONTRACT LABOR AND BENEFIT COST,CALCULATION OF DIRECT GME,CALCULATION OF REIMBURSEMENT SETTLEMENT,INPATIENT ANCILLARY SERVICE COST APPORTIONMENT,HOSPITAL CONTRACT LABOR AND BENEFIT COST,HOSPITAL CONTRACT LABOR AND BENEFIT COST,CALCULATION OF REIMBURSEMENT SETTLEMENT,ADJUSTMENTS,TRIAL BALANCE OF EXPENSE ACCOUNTS,COMPUTATION OF INPATIENT OPERATING COSTS,CALCULATION OF REIMBURSEMENT SETTLEMENT,TRIAL BALANCE OF EXPENSE ACCOUNTS,TRIAL BALANCE OF EXPENSE ACCOUNTS,COST ALLOCATION,COST ALLOCATION,ALLOCATION OF NEW CAPITAL COSTS,COMPUTATION OF RATIO OF COST TO CHARGES,COMPUTATION OF RATIO OF COST TO CHARGES,Total Inpatient Days/Outpatient Visits,NUMBER OF BEDS,BED DAYS AVAILABLE,Total Inpatient Days/Outpatient Visits,CALCULATION OF REIMBURSEMENT SETTLEMENT,CALCULATION OF REIMBURSEMENT SETTLEMENT,COST ALLOCATION,COST ALLOCATION,CALCULATION OF REIMBURSEMENT SETTLEMENT (PPS),STATEMENT OF REVENUES AND EXPENSES,STATEMENT OF REVENUES AND EXPENSES,STATEMENT OF REVENUES AND EXPENSES,Total Inpatient Days/Outpatient Visits,CALCULATION OF REIMBURSEMENT SETTLEMENT,CALCULATION OF REIMBURSEMENT SETTLEMENT,CALCULATION OF REIMBURSEMENT SETTLEMENT (PPS),CALCULATION OF REIMBURSEMENT SETTLEMENT (PPS),CALCULATION OF REIMBURSEMENT SETTLEMENT (PPS),CALCULATION OF REIMBURSEMENT SETTLEMENT (PPS),CALCULATION OF REIMBURSEMENT SETTLEMENT (PPS),HOSPITAL CONTRACT LABOR AND BENEFIT COST,COST ALLOCATION,COST ALLOCATION,Total Inpatient Days/Outpatient Visits,HOSPITAL CONTRACT LABOR AND BENEFIT COST,CALCULATION OF REIMBURSEMENT SETTLEMENT (PPS),APPORTIONMENT OF INPATIENT/OUTPATIENT ANCILLARY SERVICE OTHER PASS THROUGH COSTS,No Description,No Description,No Description,Total Inpatient Days/Outpatient Visits,RENAL STATISTICAL DATA,RENAL STATISTICAL DATA,STATEMENT OF REVENUES AND EXPENSES,CALCULATION OF REIMBURSEMENT SETTLEMENT (PPS),CALCULATION OF REIMBURSEMENT SETTLEMENT (PPS),CALCULATION OF REIMBURSEMENT SETTLEMENT (PPS),CALCULATION OF REIMBURSEMENT SETTLEMENT (PPS),CALCULATION OF REIMBURSEMENT SETTLEMENT (PPS),HOSPITAL CONTRACT LABOR AND BENEFIT COST,RENAL STATISTICAL DATA,RENAL STATISTICAL DATA,RENAL STATISTICAL DATA,RENAL STATISTICAL DATA,ANALYSIS OF CHANGES IN NEW CAPITAL BALANCES,COMPUTATION OF RATIO OF COST TO CHARGES,Medicaid Inpatient Days/Outpatient Visits,BED DAYS AVAILABLE,STATEMENT OF REVENUES AND EXPENSES,STATEMENT OF REVENUES AND EXPENSES,STATEMENT OF REVENUES AND EXPENSES,STATEMENT OF REVENUES AND EXPENSES,STATEMENT OF REVENUES AND EXPENSES,HHA STATISTICAL DATA,HHA STATISTICAL DATA,HHA STATISTICAL DATA,HHA STATISTICAL DATA,CALCULATION OF REIMBURSEMENT SETTLEMENT,Total Inpatient Days/Outpatient Visits,TRIAL BALANCE OF EXPENSE ACCOUNTS,CALCULATION OF DIRECT GME,CALCULATION OF REIMBURSEMENT SETTLEMENT (PPS),APPORTIONMENT OF INPATIENT ROUTINE SERVICE OTHER PASS THROUGH COSTS,COST ALLOCATION,COST ALLOCATION,COST ALLOCATION,APPORTIONMENT OF INPATIENT/OUTPATIENT ANCILLARY SERVICE OTHER PASS THROUGH COSTS,TRIAL BALANCE OF EXPENSE ACCOUNTS,TRIAL BALANCE OF EXPENSE ACCOUNTS,TRIAL BALANCE OF EXPENSE ACCOUNTS,COST ALLOCATION,COST ALLOCATION,ALLOCATION OF NEW CAPITAL COSTS,COMPUTATION OF RATIO OF COST TO CHARGES,COMPUTATION OF RATIO OF COST TO CHARGES,HOSPITAL CONTRACT LABOR AND BENEFIT COST,HOSPITAL CONTRACT LABOR AND BENEFIT COST,APPORTIONMENT OF MEDICAL AND OTHER HEALTH SERVICES,CALCULATION OF REIMBURSEMENT SETTLEMENT (PPS),CALCULATION OF REIMBURSEMENT SETTLEMENT (PPS),CALCULATION OF REIMBURSEMENT SETTLEMENT (PPS),CALCULATION OF REIMBURSEMENT SETTLEMENT (TEFRA),CALCULATION OF REIMBURSEMENT SETTLEMENT,CALCULATION OF REIMBURSEMENT SETTLEMENT,INPATIENT ANCILLARY SERVICE COST APPORTIONMENT,CALCULATION OF REIMBURSEMENT SETTLEMENT (PPS),CALCULATION OF REIMBURSEMENT SETTLEMENT (PPS),CALCULATION OF REIMBURSEMENT SETTLEMENT (PPS),CALCULATION OF REIMBURSEMENT SETTLEMENT (PPS),CALCULATION OF REIMBURSEMENT SETTLEMENT,HOSPITAL CONTRACT LABOR AND BENEFIT COST,Total Inpatient Days/Outpatient Visits,TRIAL BALANCE OF EXPENSE ACCOUNTS,COST ALLOCATION,No Description,No Description,APPORTIONMENT OF INPATIENT/OUTPATIENT ANCILLARY SERVICE OTHER PASS THROUGH COSTS,COST ALLOCATION,STATEMENT OF REVENUES AND EXPENSES,STATEMENT OF REVENUES AND EXPENSES,STATEMENT OF REVENUES AND EXPENSES,STATEMENT OF REVENUES AND EXPENSES,HHA STATISTICAL DATA,STATEMENT OF REVENUES AND EXPENSES,STATEMENT OF REVENUES AND EXPENSES,STATEMENT OF REVENUES AND EXPENSES,HHA STATISTICAL DATA,HHA STATISTICAL DATA,HHA STATISTICAL DATA,HHA STATISTICAL DATA,Total Inpatient Days/Outpatient Visits,CALCULATION OF REIMBURSEMENT SETTLEMENT,CALCULATION OF REIMBURSEMENT SETTLEMENT (PPS),Medicare Inpatient Days/Outpatient Visits,CALCULATION OF REIMBURSEMENT SETTLEMENT (PPS),CALCULATION OF REIMBURSEMENT SETTLEMENT (PPS),CALCULATION OF REIMBURSEMENT SETTLEMENT (PPS),CALCULATION OF REIMBURSEMENT SETTLEMENT (PPS),CALCULATION OF REIMBURSEMENT SETTLEMENT (PPS),CALCULATION OF REIMBURSEMENT SETTLEMENT (PPS),CALCULATION OF REIMBURSEMENT SETTLEMENT,CALCULATION OF REIMBURSEMENT SETTLEMENT,S-10 DATA,HOSPITAL WAGE INDEX DATA,LTCH PPS,CALCULATION OF REIMBURSEMENT SETTLEMENT,CALCULATION OF REIMBURSEMENT SETTLEMENT,CALCULATION OF REIMBURSEMENT SETTLEMENT,APPORTIONMENT OF INPATIENT/OUTPATIENT ANCILLARY SERVICE OTHER PASS THROUGH COSTS,CALCULATION OF REIMBURSEMENT SETTLEMENT,CALCULATION OF REIMBURSEMENT SETTLEMENT,STATEMENT OF REVENUES AND EXPENSES,No Description,No Description,No Description,No Description,No Description,No Description,No Description,No Description,No Description,No Description,No Description,No Description,No Description,No Description,No Description,No Description,No Description,No Description,No Description,No Description,No Description,No Description,No Description,No Description,No Description,No Description,No Description,No Description,No Description,No Description,No Description,No Description,No Description,No Description,No Description,No Description,No Description,No Description,No Description,No Description,No Description,No Description,No Description,No Description,No Description,No Description,No Description,No Description,No Description,No Description,No Description,No Description,No Description,No Description,No Description,No Description,No Description,No Description,No Description,No Description,No Description,No Description,No Description,No Description,No Description,No Description,S-10 DATA,No Description,No Description,S-10 DATA,S-10 DATA,No Description,No Description,No Description,No Description,No Description,No Description,No Description,No Description,No Description,No Description,No Description,No Description,No Description,No Description,No Description,No Description,No Description,No Description,No Description,No Description,RENAL STATISTICAL DATA,No Description,No Description,No Description,No Description,RENAL STATISTICAL DATA,No Description,No Description,No Description,No Description,No Description,No Description,No Description,No Description,No Description,No Description,No Description,No Description,No Description,No Description,No Description,No Description,No Description,No Description,No Description,No Description,No Description,No Description,No Description,No Description,No Description,TRIAL BALANCE OF EXPENSE ACCOUNTS,TRIAL BALANCE OF EXPENSE ACCOUNTS,COST ALLOCATION,COST ALLOCATION,COST ALLOCATION,COST ALLOCATION,COST ALLOCATION,COST ALLOCATION,COST ALLOCATION,COST ALLOCATION,COST ALLOCATION,COST ALLOCATION,COST ALLOCATION,COST ALLOCATION,ALLOCATION OF NEW CAPITAL COSTS,COMPUTATION OF RATIO OF COST TO CHARGES,COMPUTATION OF RATIO OF COST TO CHARGES,COMPUTATION OF RATIO OF COST TO CHARGES,COMPUTATION OF RATIO OF COST TO CHARGES,COMPUTATION OF RATIO OF COST TO CHARGES,COMPUTATION OF RATIO OF COST TO CHARGES,COMPUTATION OF RATIO OF COST TO CHARGES,COMPUTATION OF RATIO OF COST TO CHARGES,COMPUTATION OF RATIO OF COST TO CHARGES,INPATIENT ANCILLARY SERVICE COST APPORTIONMENT,INPATIENT ANCILLARY SERVICE COST APPORTIONMENT,INPATIENT ANCILLARY SERVICE COST APPORTIONMENT,INPATIENT ANCILLARY SERVICE COST APPORTIONMENT,INPATIENT ANCILLARY SERVICE COST APPORTIONMENT,INPATIENT ANCILLARY SERVICE COST APPORTIONMENT,APPORTIONMENT OF INPATIENT ANCILLARY SERVICE CAPITAL COSTS,APPORTIONMENT OF INPATIENT/OUTPATIENT ANCILLARY SERVICE OTHER PASS THROUGH COSTS,APPORTIONMENT OF INPATIENT/OUTPATIENT ANCILLARY SERVICE OTHER PASS THROUGH COSTS,APPORTIONMENT OF INPATIENT/OUTPATIENT ANCILLARY SERVICE OTHER PASS THROUGH COSTS,APPORTIONMENT OF INPATIENT/OUTPATIENT ANCILLARY SERVICE OTHER PASS THROUGH COSTS,APPORTIONMENT OF INPATIENT/OUTPATIENT ANCILLARY SERVICE OTHER PASS THROUGH COSTS,APPORTIONMENT OF INPATIENT/OUTPATIENT ANCILLARY SERVICE OTHER PASS THROUGH COSTS,APPORTIONMENT OF INPATIENT/OUTPATIENT ANCILLARY SERVICE OTHER PASS THROUGH COSTS,APPORTIONMENT OF INPATIENT/OUTPATIENT ANCILLARY SERVICE OTHER PASS THROUGH COSTS,APPORTIONMENT OF INPATIENT/OUTPATIENT ANCILLARY SERVICE OTHER PASS THROUGH COSTS,APPORTIONMENT OF INPATIENT/OUTPATIENT ANCILLARY SERVICE OTHER PASS THROUGH COSTS,APPORTIONMENT OF INPATIENT/OUTPATIENT ANCILLARY SERVICE OTHER PASS THROUGH COSTS,APPORTIONMENT OF INPATIENT/OUTPATIENT ANCILLARY SERVICE OTHER PASS THROUGH COSTS,APPORTIONMENT OF INPATIENT/OUTPATIENT ANCILLARY SERVICE OTHER PASS THROUGH COSTS,APPORTIONMENT OF INPATIENT/OUTPATIENT ANCILLARY SERVICE OTHER PASS THROUGH COSTS,APPORTIONMENT OF INPATIENT/OUTPATIENT ANCILLARY SERVICE OTHER PASS THROUGH COSTS,APPORTIONMENT OF INPATIENT/OUTPATIENT ANCILLARY SERVICE OTHER PASS THROUGH COSTS,APPORTIONMENT OF INPATIENT/OUTPATIENT ANCILLARY SERVICE OTHER PASS THROUGH COSTS,APPORTIONMENT OF INPATIENT/OUTPATIENT ANCILLARY SERVICE OTHER PASS THROUGH COSTS,APPORTIONMENT OF INPATIENT/OUTPATIENT ANCILLARY SERVICE OTHER PASS THROUGH COSTS,APPORTIONMENT OF INPATIENT/OUTPATIENT ANCILLARY SERVICE OTHER PASS THROUGH COSTS,APPORTIONMENT OF INPATIENT/OUTPATIENT ANCILLARY SERVICE OTHER PASS THROUGH COSTS,APPORTIONMENT OF INPATIENT/OUTPATIENT ANCILLARY SERVICE OTHER PASS THROUGH COSTS,APPORTIONMENT OF INPATIENT/OUTPATIENT ANCILLARY SERVICE OTHER PASS THROUGH COSTS,APPORTIONMENT OF INPATIENT/OUTPATIENT ANCILLARY SERVICE OTHER PASS THROUGH COSTS,APPORTIONMENT OF INPATIENT/OUTPATIENT ANCILLARY SERVICE OTHER PASS THROUGH COSTS,APPORTIONMENT OF INPATIENT/OUTPATIENT ANCILLARY SERVICE OTHER PASS THROUGH COSTS,APPORTIONMENT OF INPATIENT/OUTPATIENT ANCILLARY SERVICE OTHER PASS THROUGH COSTS,APPORTIONMENT OF INPATIENT/OUTPATIENT ANCILLARY SERVICE OTHER PASS THROUGH COSTS,APPORTIONMENT OF INPATIENT/OUTPATIENT ANCILLARY SERVICE OTHER PASS THROUGH COSTS,APPORTIONMENT OF INPATIENT/OUTPATIENT ANCILLARY SERVICE OTHER PASS THROUGH COSTS,APPORTIONMENT OF INPATIENT/OUTPATIENT ANCILLARY SERVICE OTHER PASS THROUGH COSTS,APPORTIONMENT OF INPATIENT/OUTPATIENT ANCILLARY SERVICE OTHER PASS THROUGH COSTS,APPORTIONMENT OF INPATIENT/OUTPATIENT ANCILLARY SERVICE OTHER PASS THROUGH COSTS,APPORTIONMENT OF INPATIENT/OUTPATIENT ANCILLARY SERVICE OTHER PASS THROUGH COSTS,APPORTIONMENT OF INPATIENT/OUTPATIENT ANCILLARY SERVICE OTHER PASS THROUGH COSTS,APPORTIONMENT OF INPATIENT/OUTPATIENT ANCILLARY SERVICE OTHER PASS THROUGH COSTS,APPORTIONMENT OF INPATIENT/OUTPATIENT ANCILLARY SERVICE OTHER PASS THROUGH COSTS,APPORTIONMENT OF INPATIENT/OUTPATIENT ANCILLARY SERVICE OTHER PASS THROUGH COSTS,APPORTIONMENT OF INPATIENT/OUTPATIENT ANCILLARY SERVICE OTHER PASS THROUGH COSTS,APPORTIONMENT OF INPATIENT/OUTPATIENT ANCILLARY SERVICE OTHER PASS THROUGH COSTS,APPORTIONMENT OF INPATIENT/OUTPATIENT ANCILLARY SERVICE OTHER PASS THROUGH COSTS,APPORTIONMENT OF INPATIENT/OUTPATIENT ANCILLARY SERVICE OTHER PASS THROUGH COSTS,APPORTIONMENT OF INPATIENT/OUTPATIENT ANCILLARY SERVICE OTHER PASS THROUGH COSTS,APPORTIONMENT OF INPATIENT/OUTPATIENT ANCILLARY SERVICE OTHER PASS THROUGH COSTS,APPORTIONMENT OF INPATIENT/OUTPATIENT ANCILLARY SERVICE OTHER PASS THROUGH COSTS,APPORTIONMENT OF INPATIENT/OUTPATIENT ANCILLARY SERVICE OTHER PASS THROUGH COSTS,APPORTIONMENT OF INPATIENT/OUTPATIENT ANCILLARY SERVICE OTHER PASS THROUGH COSTS,APPORTIONMENT OF INPATIENT/OUTPATIENT ANCILLARY SERVICE OTHER PASS THROUGH COSTS,APPORTIONMENT OF INPATIENT/OUTPATIENT ANCILLARY SERVICE OTHER PASS THROUGH COSTS,APPORTIONMENT OF INPATIENT/OUTPATIENT ANCILLARY SERVICE OTHER PASS THROUGH COSTS,APPORTIONMENT OF INPATIENT/OUTPATIENT ANCILLARY SERVICE OTHER PASS THROUGH COSTS,APPORTIONMENT OF INPATIENT/OUTPATIENT ANCILLARY SERVICE OTHER PASS THROUGH COSTS,APPORTIONMENT OF INPATIENT/OUTPATIENT ANCILLARY SERVICE OTHER PASS THROUGH COSTS,APPORTIONMENT OF INPATIENT/OUTPATIENT ANCILLARY SERVICE OTHER PASS THROUGH COSTS,APPORTIONMENT OF INPATIENT/OUTPATIENT ANCILLARY SERVICE OTHER PASS THROUGH COSTS,APPORTIONMENT OF INPATIENT/OUTPATIENT ANCILLARY SERVICE OTHER PASS THROUGH COSTS,APPORTIONMENT OF INPATIENT/OUTPATIENT ANCILLARY SERVICE OTHER PASS THROUGH COSTS,APPORTIONMENT OF INPATIENT/OUTPATIENT ANCILLARY SERVICE OTHER PASS THROUGH COSTS,APPORTIONMENT OF INPATIENT/OUTPATIENT ANCILLARY SERVICE OTHER PASS THROUGH COSTS,APPORTIONMENT OF INPATIENT/OUTPATIENT ANCILLARY SERVICE OTHER PASS THROUGH COSTS,APPORTIONMENT OF INPATIENT/OUTPATIENT ANCILLARY SERVICE OTHER PASS THROUGH COSTS,APPORTIONMENT OF INPATIENT/OUTPATIENT ANCILLARY SERVICE OTHER PASS THROUGH COSTS,APPORTIONMENT OF INPATIENT/OUTPATIENT ANCILLARY SERVICE OTHER PASS THROUGH COSTS,APPORTIONMENT OF INPATIENT/OUTPATIENT ANCILLARY SERVICE OTHER PASS THROUGH COSTS,APPORTIONMENT OF INPATIENT/OUTPATIENT ANCILLARY SERVICE OTHER PASS THROUGH COSTS,APPORTIONMENT OF INPATIENT/OUTPATIENT ANCILLARY SERVICE OTHER PASS THROUGH COSTS,APPORTIONMENT OF INPATIENT/OUTPATIENT ANCILLARY SERVICE OTHER PASS THROUGH COSTS,APPORTIONMENT OF INPATIENT/OUTPATIENT ANCILLARY SERVICE OTHER PASS THROUGH COSTS,APPORTIONMENT OF INPATIENT/OUTPATIENT ANCILLARY SERVICE OTHER PASS THROUGH COSTS,APPORTIONMENT OF INPATIENT/OUTPATIENT ANCILLARY SERVICE OTHER PASS THROUGH COSTS,APPORTIONMENT OF INPATIENT/OUTPATIENT ANCILLARY SERVICE OTHER PASS THROUGH COSTS,APPORTIONMENT OF INPATIENT/OUTPATIENT ANCILLARY SERVICE OTHER PASS THROUGH COSTS,APPORTIONMENT OF INPATIENT/OUTPATIENT ANCILLARY SERVICE OTHER PASS THROUGH COSTS,APPORTIONMENT OF INPATIENT/OUTPATIENT ANCILLARY SERVICE OTHER PASS THROUGH COSTS,APPORTIONMENT OF MEDICAL AND OTHER HEALTH SERVICES,APPORTIONMENT OF MEDICAL AND OTHER HEALTH SERVICES,APPORTIONMENT OF MEDICAL AND OTHER HEALTH SERVICES,APPORTIONMENT OF MEDICAL AND OTHER HEALTH SERVICES,APPORTIONMENT OF MEDICAL AND OTHER HEALTH SERVICES,APPORTIONMENT OF MEDICAL AND OTHER HEALTH SERVICES,APPORTIONMENT OF MEDICAL AND OTHER HEALTH SERVICES,APPORTIONMENT OF MEDICAL AND OTHER HEALTH SERVICES,CALCULATION OF REIMBURSEMENT SETTLEMENT,Total Inpatient Days/Outpatient Visits,BED DAYS AVAILABLE,BED DAYS AVAILABLE,BED DAYS AVAILABLE,BED DAYS AVAILABLE,Medicare Inpatient Days/Outpatient Visits,Medicaid Inpatient Days/Outpatient Visits,Total Inpatient Days/Outpatient Visits,Total Inpatient Days/Outpatient Visits,RECONCILIATION OF CAPITAL COST CENTERS,RECONCILIATION OF CAPITAL COST CENTERS,RECONCILIATION OF CAPITAL COST CENTERS,RECONCILIATION OF CAPITAL COST CENTERS,RECONCILIATION OF CAPITAL COST CENTERS,RECONCILIATION OF CAPITAL COST CENTERS,ADJUSTMENTS,TRIAL BALANCE OF EXPENSE ACCOUNTS,TRIAL BALANCE OF EXPENSE ACCOUNTS,TRIAL BALANCE OF EXPENSE ACCOUNTS,TRIAL BALANCE OF EXPENSE ACCOUNTS,TRIAL BALANCE OF EXPENSE ACCOUNTS,TRIAL BALANCE OF EXPENSE ACCOUNTS,TRIAL BALANCE OF EXPENSE ACCOUNTS,TRIAL BALANCE OF EXPENSE ACCOUNTS,TRIAL BALANCE OF EXPENSE ACCOUNTS,TRIAL BALANCE OF EXPENSE ACCOUNTS,TRIAL BALANCE OF EXPENSE ACCOUNTS,TRIAL BALANCE OF EXPENSE ACCOUNTS,TRIAL BALANCE OF EXPENSE ACCOUNTS,TRIAL BALANCE OF EXPENSE ACCOUNTS,TRIAL BALANCE OF EXPENSE ACCOUNTS,TRIAL BALANCE OF EXPENSE ACCOUNTS,TRIAL BALANCE OF EXPENSE ACCOUNTS,TRIAL BALANCE OF EXPENSE ACCOUNTS,TRIAL BALANCE OF EXPENSE ACCOUNTS,TRIAL BALANCE OF EXPENSE ACCOUNTS,TRIAL BALANCE OF EXPENSE ACCOUNTS,TRIAL BALANCE OF EXPENSE ACCOUNTS,TRIAL BALANCE OF EXPENSE ACCOUNTS,TRIAL BALANCE OF EXPENSE ACCOUNTS,TRIAL BALANCE OF EXPENSE ACCOUNTS,TRIAL BALANCE OF EXPENSE ACCOUNTS,TRIAL BALANCE OF EXPENSE ACCOUNTS,TRIAL BALANCE OF EXPENSE ACCOUNTS,TRIAL BALANCE OF EXPENSE ACCOUNTS,TRIAL BALANCE OF EXPENSE ACCOUNTS,TRIAL BALANCE OF EXPENSE ACCOUNTS,TRIAL BALANCE OF EXPENSE ACCOUNTS,TRIAL BALANCE OF EXPENSE ACCOUNTS,TRIAL BALANCE OF EXPENSE ACCOUNTS,TRIAL BALANCE OF EXPENSE ACCOUNTS,TRIAL BALANCE OF EXPENSE ACCOUNTS,TRIAL BALANCE OF EXPENSE ACCOUNTS,TRIAL BALANCE OF EXPENSE ACCOUNTS,COST ALLOCATION,COST ALLOCATION,COST ALLOCATION,COST ALLOCATION,COST ALLOCATION,COST ALLOCATION,COST ALLOCATION,COST ALLOCATION,COST ALLOCATION,COST ALLOCATION,COST ALLOCATION,COST ALLOCATION,COST ALLOCATION,COST ALLOCATION,COST ALLOCATION,COST ALLOCATION,COST ALLOCATION,COST ALLOCATION,COST ALLOCATION,COST ALLOCATION,COST ALLOCATION,COST ALLOCATION,COST ALLOCATION,COST ALLOCATION,COST ALLOCATION,COST ALLOCATION,COST ALLOCATION,COST ALLOCATION,COST ALLOCATION,COST ALLOCATION,COST ALLOCATION,COST ALLOCATION,COST ALLOCATION,COST ALLOCATION,COST ALLOCATION,COST ALLOCATION,COST ALLOCATION,COST ALLOCATION,COST ALLOCATION,COST ALLOCATION,COST ALLOCATION,COST ALLOCATION,COST ALLOCATION,COST ALLOCATION,COST ALLOCATION,COST ALLOCATION,COST ALLOCATION,COST ALLOCATION,COST ALLOCATION,COST ALLOCATION,COST ALLOCATION,COST ALLOCATION,ALLOCATION OF NEW CAPITAL COSTS,ALLOCATION OF NEW CAPITAL COSTS,ALLOCATION OF NEW CAPITAL COSTS,ALLOCATION OF NEW CAPITAL COSTS,ALLOCATION OF NEW CAPITAL COSTS,ALLOCATION OF NEW CAPITAL COSTS,ALLOCATION OF NEW CAPITAL COSTS,ALLOCATION OF NEW CAPITAL COSTS,ALLOCATION OF NEW CAPITAL COSTS,ALLOCATION OF NEW CAPITAL COSTS,ALLOCATION OF NEW CAPITAL COSTS,ALLOCATION OF NEW CAPITAL COSTS,ALLOCATION OF NEW CAPITAL COSTS,ALLOCATION OF NEW CAPITAL COSTS,ALLOCATION OF NEW CAPITAL COSTS,ALLOCATION OF NEW CAPITAL COSTS,ALLOCATION OF NEW CAPITAL COSTS,ALLOCATION OF NEW CAPITAL COSTS,ALLOCATION OF NEW CAPITAL COSTS,ALLOCATION OF NEW CAPITAL COSTS,ALLOCATION OF NEW CAPITAL COSTS,COMPUTATION OF RATIO OF COST TO CHARGES,COMPUTATION OF RATIO OF COST TO CHARGES,COMPUTATION OF RATIO OF COST TO CHARGES,COMPUTATION OF RATIO OF COST TO CHARGES,COMPUTATION OF RATIO OF COST TO CHARGES,COMPUTATION OF RATIO OF COST TO CHARGES,COMPUTATION OF RATIO OF COST TO CHARGES,COMPUTATION OF RATIO OF COST TO CHARGES,COMPUTATION OF RATIO OF COST TO CHARGES,COMPUTATION OF RATIO OF COST TO CHARGES,COMPUTATION OF RATIO OF COST TO CHARGES,COMPUTATION OF RATIO OF COST TO CHARGES,COMPUTATION OF RATIO OF COST TO CHARGES,COMPUTATION OF RATIO OF COST TO CHARGES,COMPUTATION OF RATIO OF COST TO CHARGES,COMPUTATION OF RATIO OF COST TO CHARGES,COMPUTATION OF RATIO OF COST TO CHARGES,COMPUTATION OF RATIO OF COST TO CHARGES,COMPUTATION OF RATIO OF COST TO CHARGES,COMPUTATION OF RATIO OF COST TO CHARGES,COMPUTATION OF RATIO OF COST TO CHARGES,COMPUTATION OF RATIO OF COST TO CHARGES,COMPUTATION OF RATIO OF COST TO CHARGES,COMPUTATION OF RATIO OF COST TO CHARGES,COMPUTATION OF RATIO OF COST TO CHARGES,COMPUTATION OF RATIO OF COST TO CHARGES,COMPUTATION OF RATIO OF COST TO CHARGES,COMPUTATION OF RATIO OF COST TO CHARGES,COMPUTATION OF RATIO OF COST TO CHARGES,COMPUTATION OF RATIO OF COST TO CHARGES,COMPUTATION OF RATIO OF COST TO CHARGES,COMPUTATION OF RATIO OF COST TO CHARGES,COMPUTATION OF RATIO OF COST TO CHARGES,COMPUTATION OF RATIO OF COST TO CHARGES,COMPUTATION OF RATIO OF COST TO CHARGES,COMPUTATION OF RATIO OF COST TO CHARGES,COMPUTATION OF RATIO OF COST TO CHARGES,COMPUTATION OF RATIO OF COST TO CHARGES,COMPUTATION OF RATIO OF COST TO CHARGES,COMPUTATION OF RATIO OF COST TO CHARGES,COMPUTATION OF RATIO OF COST TO CHARGES,COMPUTATION OF RATIO OF COST TO CHARGES,INPATIENT ANCILLARY SERVICE COST APPORTIONMENT,INPATIENT ANCILLARY SERVICE COST APPORTIONMENT,INPATIENT ANCILLARY SERVICE COST APPORTIONMENT,INPATIENT ANCILLARY SERVICE COST APPORTIONMENT,INPATIENT ANCILLARY SERVICE COST APPORTIONMENT,INPATIENT ANCILLARY SERVICE COST APPORTIONMENT,INPATIENT ANCILLARY SERVICE COST APPORTIONMENT,INPATIENT ANCILLARY SERVICE COST APPORTIONMENT,INPATIENT ANCILLARY SERVICE COST APPORTIONMENT,INPATIENT ANCILLARY SERVICE COST APPORTIONMENT,INPATIENT ANCILLARY SERVICE COST APPORTIONMENT,INPATIENT ANCILLARY SERVICE COST APPORTIONMENT,INPATIENT ANCILLARY SERVICE COST APPORTIONMENT,INPATIENT ANCILLARY SERVICE COST APPORTIONMENT,INPATIENT ANCILLARY SERVICE COST APPORTIONMENT,INPATIENT ANCILLARY SERVICE COST APPORTIONMENT,INPATIENT ANCILLARY SERVICE COST APPORTIONMENT,INPATIENT ANCILLARY SERVICE COST APPORTIONMENT,INPATIENT ANCILLARY SERVICE COST APPORTIONMENT,INPATIENT ANCILLARY SERVICE COST APPORTIONMENT,INPATIENT ANCILLARY SERVICE COST APPORTIONMENT,INPATIENT ANCILLARY SERVICE COST APPORTIONMENT,INPATIENT ANCILLARY SERVICE COST APPORTIONMENT,INPATIENT ANCILLARY SERVICE COST APPORTIONMENT,INPATIENT ANCILLARY SERVICE COST APPORTIONMENT,INPATIENT ANCILLARY SERVICE COST APPORTIONMENT,INPATIENT ANCILLARY SERVICE COST APPORTIONMENT,INPATIENT ANCILLARY SERVICE COST APPORTIONMENT,INPATIENT ANCILLARY SERVICE COST APPORTIONMENT,INPATIENT ANCILLARY SERVICE COST APPORTIONMENT,INPATIENT ANCILLARY SERVICE COST APPORTIONMENT,INPATIENT ANCILLARY SERVICE COST APPORTIONMENT,INPATIENT ANCILLARY SERVICE COST APPORTIONMENT,INPATIENT ANCILLARY SERVICE COST APPORTIONMENT,INPATIENT ANCILLARY SERVICE COST APPORTIONMENT,INPATIENT ANCILLARY SERVICE COST APPORTIONMENT,INPATIENT ANCILLARY SERVICE COST APPORTIONMENT,INPATIENT ANCILLARY SERVICE COST APPORTIONMENT,INPATIENT ANCILLARY SERVICE COST APPORTIONMENT,INPATIENT ANCILLARY SERVICE COST APPORTIONMENT,INPATIENT ANCILLARY SERVICE COST APPORTIONMENT,INPATIENT ANCILLARY SERVICE COST APPORTIONMENT,APPORTIONMENT OF INPATIENT ANCILLARY SERVICE CAPITAL COSTS,APPORTIONMENT OF INPATIENT ANCILLARY SERVICE CAPITAL COSTS,APPORTIONMENT OF INPATIENT ANCILLARY SERVICE CAPITAL COSTS,APPORTIONMENT OF INPATIENT ANCILLARY SERVICE CAPITAL COSTS,APPORTIONMENT OF INPATIENT ANCILLARY SERVICE CAPITAL COSTS,APPORTIONMENT OF INPATIENT ANCILLARY SERVICE CAPITAL COSTS,APPORTIONMENT OF INPATIENT ANCILLARY SERVICE CAPITAL COSTS,APPORTIONMENT OF INPATIENT ANCILLARY SERVICE CAPITAL COSTS,APPORTIONMENT OF INPATIENT ANCILLARY SERVICE CAPITAL COSTS,APPORTIONMENT OF INPATIENT ANCILLARY SERVICE CAPITAL COSTS,APPORTIONMENT OF INPATIENT ANCILLARY SERVICE CAPITAL COSTS,APPORTIONMENT OF INPATIENT ANCILLARY SERVICE CAPITAL COSTS,APPORTIONMENT OF INPATIENT ANCILLARY SERVICE CAPITAL COSTS,APPORTIONMENT OF INPATIENT ANCILLARY SERVICE CAPITAL COSTS,APPORTIONMENT OF INPATIENT ANCILLARY SERVICE CAPITAL COSTS,APPORTIONMENT OF INPATIENT ANCILLARY SERVICE CAPITAL COSTS,APPORTIONMENT OF INPATIENT ANCILLARY SERVICE CAPITAL COSTS,APPORTIONMENT OF INPATIENT ANCILLARY SERVICE CAPITAL COSTS,APPORTIONMENT OF INPATIENT ANCILLARY SERVICE CAPITAL COSTS,APPORTIONMENT OF INPATIENT ANCILLARY SERVICE CAPITAL COSTS,APPORTIONMENT OF INPATIENT ANCILLARY SERVICE CAPITAL COSTS,APPORTIONMENT OF INPATIENT/OUTPATIENT ANCILLARY SERVICE OTHER PASS THROUGH COSTS,APPORTIONMENT OF INPATIENT/OUTPATIENT ANCILLARY SERVICE OTHER PASS THROUGH COSTS,APPORTIONMENT OF INPATIENT/OUTPATIENT ANCILLARY SERVICE OTHER PASS THROUGH COSTS,APPORTIONMENT OF INPATIENT/OUTPATIENT ANCILLARY SERVICE OTHER PASS THROUGH COSTS,APPORTIONMENT OF INPATIENT/OUTPATIENT ANCILLARY SERVICE OTHER PASS THROUGH COSTS,APPORTIONMENT OF INPATIENT/OUTPATIENT ANCILLARY SERVICE OTHER PASS THROUGH COSTS,APPORTIONMENT OF INPATIENT/OUTPATIENT ANCILLARY SERVICE OTHER PASS THROUGH COSTS,APPORTIONMENT OF INPATIENT/OUTPATIENT ANCILLARY SERVICE OTHER PASS THROUGH COSTS,APPORTIONMENT OF INPATIENT/OUTPATIENT ANCILLARY SERVICE OTHER PASS THROUGH COSTS,APPORTIONMENT OF INPATIENT/OUTPATIENT ANCILLARY SERVICE OTHER PASS THROUGH COSTS,APPORTIONMENT OF INPATIENT/OUTPATIENT ANCILLARY SERVICE OTHER PASS THROUGH COSTS,APPORTIONMENT OF INPATIENT/OUTPATIENT ANCILLARY SERVICE OTHER PASS THROUGH COSTS,APPORTIONMENT OF INPATIENT/OUTPATIENT ANCILLARY SERVICE OTHER PASS THROUGH COSTS,APPORTIONMENT OF INPATIENT/OUTPATIENT ANCILLARY SERVICE OTHER PASS THROUGH COSTS,APPORTIONMENT OF INPATIENT/OUTPATIENT ANCILLARY SERVICE OTHER PASS THROUGH COSTS,APPORTIONMENT OF INPATIENT/OUTPATIENT ANCILLARY SERVICE OTHER PASS THROUGH COSTS,APPORTIONMENT OF INPATIENT/OUTPATIENT ANCILLARY SERVICE OTHER PASS THROUGH COSTS,APPORTIONMENT OF INPATIENT/OUTPATIENT ANCILLARY SERVICE OTHER PASS THROUGH COSTS,APPORTIONMENT OF INPATIENT/OUTPATIENT ANCILLARY SERVICE OTHER PASS THROUGH COSTS,APPORTIONMENT OF INPATIENT/OUTPATIENT ANCILLARY SERVICE OTHER PASS THROUGH COSTS,APPORTIONMENT OF INPATIENT/OUTPATIENT ANCILLARY SERVICE OTHER PASS THROUGH COSTS,STATEMENT OF REVENUES AND EXPENSES,BALANCE SHEET,BALANCE SHEET,BALANCE SHEET,BALANCE SHEET,BALANCE SHEET,BALANCE SHEET,BALANCE SHEET,BALANCE SHEET,BALANCE SHEET,BALANCE SHEET,BALANCE SHEET,BALANCE SHEET,BALANCE SHEET,BALANCE SHEET,BALANCE SHEET,BALANCE SHEET,BALANCE SHEET,BALANCE SHEET,BALANCE SHEET,BALANCE SHEET,BALANCE SHEET,BALANCE SHEET,BALANCE SHEET,BALANCE SHEET,BALANCE SHEET,BALANCE SHEET,RECONCILIATION OF CAPITAL COST CENTERS,RECONCILIATION OF CAPITAL COST CENTERS,RECONCILIATION OF CAPITAL COST CENTERS,TRIAL BALANCE OF EXPENSE ACCOUNTS,TRIAL BALANCE OF EXPENSE ACCOUNTS,TRIAL BALANCE OF EXPENSE ACCOUNTS,TRIAL BALANCE OF EXPENSE ACCOUNTS,TRIAL BALANCE OF EXPENSE ACCOUNTS,TRIAL BALANCE OF EXPENSE ACCOUNTS,TRIAL BALANCE OF EXPENSE ACCOUNTS,TRIAL BALANCE OF EXPENSE ACCOUNTS,TRIAL BALANCE OF EXPENSE ACCOUNTS,TRIAL BALANCE OF EXPENSE ACCOUNTS,TRIAL BALANCE OF EXPENSE ACCOUNTS,TRIAL BALANCE OF EXPENSE ACCOUNTS,TRIAL BALANCE OF EXPENSE ACCOUNTS,TRIAL BALANCE OF EXPENSE ACCOUNTS,TRIAL BALANCE OF EXPENSE ACCOUNTS,COST ALLOCATION,COST ALLOCATION,COST ALLOCATION,COST ALLOCATION,COST ALLOCATION,COST ALLOCATION,COST ALLOCATION,ALLOCATION OF NEW CAPITAL COSTS,ALLOCATION OF NEW CAPITAL COSTS,COMPUTATION OF RATIO OF COST TO CHARGES,BALANCE SHEET,BALANCE SHEET,BALANCE SHEET,BALANCE SHEET,BALANCE SHEET,BALANCE SHEET,BALANCE SHEET,BALANCE SHEET,TRIAL BALANCE OF EXPENSE ACCOUNTS,TRIAL BALANCE OF EXPENSE ACCOUNTS,TRIAL BALANCE OF EXPENSE ACCOUNTS,TRIAL BALANCE OF EXPENSE ACCOUNTS,TRIAL BALANCE OF EXPENSE ACCOUNTS,TRIAL BALANCE OF EXPENSE ACCOUNTS,TRIAL BALANCE OF EXPENSE ACCOUNTS,COST ALLOCATION,COST ALLOCATION,COST ALLOCATION,COST ALLOCATION,ALLOCATION OF NEW CAPITAL COSTS,COMPUTATION OF RATIO OF COST TO CHARGES,COMPUTATION OF RATIO OF COST TO CHARGES,APPORTIONMENT OF INPATIENT/OUTPATIENT ANCILLARY SERVICE OTHER PASS THROUGH COSTS,APPORTIONMENT OF INPATIENT/OUTPATIENT ANCILLARY SERVICE OTHER PASS THROUGH COSTS,APPORTIONMENT OF MEDICAL AND OTHER HEALTH SERVICES,APPORTIONMENT OF MEDICAL AND OTHER HEALTH SERVICES,APPORTIONMENT OF MEDICAL AND OTHER HEALTH SERVICES,APPORTIONMENT OF MEDICAL AND OTHER HEALTH SERVICES,BALANCE SHEET,BALANCE SHEET,BALANCE SHEET,TRIAL BALANCE OF EXPENSE ACCOUNTS,TRIAL BALANCE OF EXPENSE ACCOUNTS,TRIAL BALANCE OF EXPENSE ACCOUNTS,TRIAL BALANCE OF EXPENSE ACCOUNTS,TRIAL BALANCE OF EXPENSE ACCOUNTS,TRIAL BALANCE OF EXPENSE ACCOUNTS,COST ALLOCATION,ALLOCATION OF NEW CAPITAL COSTS,TRIAL BALANCE OF EXPENSE ACCOUNTS,COST ALLOCATION,ALLOCATION OF NEW CAPITAL COSTS,APPORTIONMENT OF INPATIENT/OUTPATIENT ANCILLARY SERVICE OTHER PASS THROUGH COSTS,APPORTIONMENT OF MEDICAL AND OTHER HEALTH SERVICES,APPORTIONMENT OF MEDICAL AND OTHER HEALTH SERVICES,TRIAL BALANCE OF EXPENSE ACCOUNTS,TRIAL BALANCE OF EXPENSE ACCOUNTS,COST ALLOCATION,COST ALLOCATION,COST ALLOCATION,COST ALLOCATION,COST ALLOCATION,TRIAL BALANCE OF EXPENSE ACCOUNTS,TRIAL BALANCE OF EXPENSE ACCOUNTS,TRIAL BALANCE OF EXPENSE ACCOUNTS,TRIAL BALANCE OF EXPENSE ACCOUNTS,TRIAL BALANCE OF EXPENSE ACCOUNTS,TRIAL BALANCE OF EXPENSE ACCOUNTS,TRIAL BALANCE OF EXPENSE ACCOUNTS,TRIAL BALANCE OF EXPENSE ACCOUNTS,COST ALLOCATION,COST ALLOCATION,ALLOCATION OF NEW CAPITAL COSTS,COMPUTATION OF RATIO OF COST TO CHARGES,COMPUTATION OF RATIO OF COST TO CHARGES,COMPUTATION OF RATIO OF COST TO CHARGES,COMPUTATION OF RATIO OF COST TO CHARGES,COMPUTATION OF RATIO OF COST TO CHARGES,COMPUTATION OF RATIO OF COST TO CHARGES,COMPUTATION OF RATIO OF COST TO CHARGES,COMPUTATION OF RATIO OF COST TO CHARGES,APPORTIONMENT OF INPATIENT/OUTPATIENT ANCILLARY SERVICE OTHER PASS THROUGH COSTS,APPORTIONMENT OF MEDICAL AND OTHER HEALTH SERVICES,APPORTIONMENT OF MEDICAL AND OTHER HEALTH SERVICES,BALANCE SHEET,BALANCE SHEET,BALANCE SHEET,TRIAL BALANCE OF EXPENSE ACCOUNTS,TRIAL BALANCE OF EXPENSE ACCOUNTS,TRIAL BALANCE OF EXPENSE ACCOUNTS,TRIAL BALANCE OF EXPENSE ACCOUNTS,TRIAL BALANCE OF EXPENSE ACCOUNTS,TRIAL BALANCE OF EXPENSE ACCOUNTS,TRIAL BALANCE OF EXPENSE ACCOUNTS,TRIAL BALANCE OF EXPENSE ACCOUNTS,TRIAL BALANCE OF EXPENSE ACCOUNTS,COMPUTATION OF RATIO OF COST TO CHARGES,COMPUTATION OF RATIO OF COST TO CHARGES,APPORTIONMENT OF INPATIENT/OUTPATIENT ANCILLARY SERVICE OTHER PASS THROUGH COSTS,APPORTIONMENT OF INPATIENT/OUTPATIENT ANCILLARY SERVICE OTHER PASS THROUGH COSTS,APPORTIONMENT OF INPATIENT/OUTPATIENT ANCILLARY SERVICE OTHER PASS THROUGH COSTS,APPORTIONMENT OF INPATIENT/OUTPATIENT ANCILLARY SERVICE OTHER PASS THROUGH COSTS,APPORTIONMENT OF MEDICAL AND OTHER HEALTH SERVICES,APPORTIONMENT OF MEDICAL AND OTHER HEALTH SERVICES,APPORTIONMENT OF MEDICAL AND OTHER HEALTH SERVICES,APPORTIONMENT OF MEDICAL AND OTHER HEALTH SERVICES,APPORTIONMENT OF MEDICAL AND OTHER HEALTH SERVICES,APPORTIONMENT OF MEDICAL AND OTHER HEALTH SERVICES,APPORTIONMENT OF MEDICAL AND OTHER HEALTH SERVICES,APPORTIONMENT OF MEDICAL AND OTHER HEALTH SERVICES,BALANCE SHEET,BALANCE SHEET,RECONCILIATION OF CAPITAL COST CENTERS,RECONCILIATION OF CAPITAL COST CENTERS,TRIAL BALANCE OF EXPENSE ACCOUNTS,TRIAL BALANCE OF EXPENSE ACCOUNTS,TRIAL BALANCE OF EXPENSE ACCOUNTS,COST ALLOCATION,COST ALLOCATION,ALLOCATION OF NEW CAPITAL COSTS,COMPUTATION OF RATIO OF COST TO CHARGES,STATEMENT OF PATIENT REVENUES AND OPERATING EXPENSES,RECONCILIATION OF CAPITAL COST CENTERS,RECONCILIATION OF CAPITAL COST CENTERS,TRIAL BALANCE OF EXPENSE ACCOUNTS,TRIAL BALANCE OF EXPENSE ACCOUNTS,TRIAL BALANCE OF EXPENSE ACCOUNTS,TRIAL BALANCE OF EXPENSE ACCOUNTS,TRIAL BALANCE OF EXPENSE ACCOUNTS,TRIAL BALANCE OF EXPENSE ACCOUNTS,COST ALLOCATION,COST ALLOCATION,ALLOCATION OF NEW CAPITAL COSTS,COMPUTATION OF RATIO OF COST TO CHARGES,COMPUTATION OF RATIO OF COST TO CHARGES,COMPUTATION OF RATIO OF COST TO CHARGES,COMPUTATION OF INPATIENT OPERATING COSTS,INPATIENT ANCILLARY SERVICE COST APPORTIONMENT,APPORTIONMENT OF INPATIENT ROUTINE SERVICE CAPITAL COSTS,APPORTIONMENT OF INPATIENT ROUTINE SERVICE CAPITAL COSTS,APPORTIONMENT OF INPATIENT ROUTINE SERVICE CAPITAL COSTS,APPORTIONMENT OF MEDICAL AND OTHER HEALTH SERVICES,APPORTIONMENT OF MEDICAL AND OTHER HEALTH SERVICES,APPORTIONMENT OF MEDICAL AND OTHER HEALTH SERVICES,APPORTIONMENT OF MEDICAL AND OTHER HEALTH SERVICES,STATEMENT OF PATIENT REVENUES AND OPERATING EXPENSES,BALANCE SHEET,NUMBER OF BEDS,BED DAYS AVAILABLE,Medicare Inpatient Days/Outpatient Visits,Total Inpatient Days/Outpatient Visits,TRIAL BALANCE OF EXPENSE ACCOUNTS,TRIAL BALANCE OF EXPENSE ACCOUNTS,TRIAL BALANCE OF EXPENSE ACCOUNTS,TRIAL BALANCE OF EXPENSE ACCOUNTS,TRIAL BALANCE OF EXPENSE ACCOUNTS,TRIAL BALANCE OF EXPENSE ACCOUNTS,TRIAL BALANCE OF EXPENSE ACCOUNTS,TRIAL BALANCE OF EXPENSE ACCOUNTS,TRIAL BALANCE OF EXPENSE ACCOUNTS,TRIAL BALANCE OF EXPENSE ACCOUNTS,TRIAL BALANCE OF EXPENSE ACCOUNTS,TRIAL BALANCE OF EXPENSE ACCOUNTS,TRIAL BALANCE OF EXPENSE ACCOUNTS,TRIAL BALANCE OF EXPENSE ACCOUNTS,TRIAL BALANCE OF EXPENSE ACCOUNTS,TRIAL BALANCE OF EXPENSE ACCOUNTS,TRIAL BALANCE OF EXPENSE ACCOUNTS,TRIAL BALANCE OF EXPENSE ACCOUNTS,TRIAL BALANCE OF EXPENSE ACCOUNTS,TRIAL BALANCE OF EXPENSE ACCOUNTS,TRIAL BALANCE OF EXPENSE ACCOUNTS,TRIAL BALANCE OF EXPENSE ACCOUNTS,TRIAL BALANCE OF EXPENSE ACCOUNTS,TRIAL BALANCE OF EXPENSE ACCOUNTS,COST ALLOCATION,COST ALLOCATION,COST ALLOCATION,COST ALLOCATION,COST ALLOCATION,COST ALLOCATION,COST ALLOCATION,COST ALLOCATION,COST ALLOCATION,COST ALLOCATION,COST ALLOCATION,ALLOCATION OF NEW CAPITAL COSTS,ALLOCATION OF NEW CAPITAL COSTS,ALLOCATION OF NEW CAPITAL COSTS,ALLOCATION OF NEW CAPITAL COSTS,ALLOCATION OF NEW CAPITAL COSTS,COMPUTATION OF RATIO OF COST TO CHARGES,COMPUTATION OF RATIO OF COST TO CHARGES,COMPUTATION OF RATIO OF COST TO CHARGES,COMPUTATION OF RATIO OF COST TO CHARGES,COMPUTATION OF RATIO OF COST TO CHARGES,COMPUTATION OF RATIO OF COST TO CHARGES,COMPUTATION OF RATIO OF COST TO CHARGES,COMPUTATION OF RATIO OF COST TO CHARGES,COMPUTATION OF RATIO OF COST TO CHARGES,COMPUTATION OF RATIO OF COST TO CHARGES,COMPUTATION OF RATIO OF COST TO CHARGES,COMPUTATION OF RATIO OF COST TO CHARGES,COMPUTATION OF RATIO OF COST TO CHARGES,COMPUTATION OF RATIO OF COST TO CHARGES,COMPUTATION OF RATIO OF COST TO CHARGES,COMPUTATION OF RATIO OF COST TO CHARGES,COMPUTATION OF RATIO OF COST TO CHARGES,COMPUTATION OF RATIO OF COST TO CHARGES,INPATIENT ANCILLARY SERVICE COST APPORTIONMENT,INPATIENT ANCILLARY SERVICE COST APPORTIONMENT,INPATIENT ANCILLARY SERVICE COST APPORTIONMENT,INPATIENT ANCILLARY SERVICE COST APPORTIONMENT,INPATIENT ANCILLARY SERVICE COST APPORTIONMENT,INPATIENT ANCILLARY SERVICE COST APPORTIONMENT,INPATIENT ANCILLARY SERVICE COST APPORTIONMENT,INPATIENT ANCILLARY SERVICE COST APPORTIONMENT,APPORTIONMENT OF INPATIENT ROUTINE SERVICE CAPITAL COSTS,APPORTIONMENT OF INPATIENT ROUTINE SERVICE CAPITAL COSTS,APPORTIONMENT OF INPATIENT ROUTINE SERVICE CAPITAL COSTS,APPORTIONMENT OF INPATIENT ROUTINE SERVICE CAPITAL COSTS,APPORTIONMENT OF INPATIENT ROUTINE SERVICE CAPITAL COSTS,APPORTIONMENT OF INPATIENT ROUTINE SERVICE CAPITAL COSTS,APPORTIONMENT OF INPATIENT ANCILLARY SERVICE CAPITAL COSTS,APPORTIONMENT OF INPATIENT ANCILLARY SERVICE CAPITAL COSTS,APPORTIONMENT OF INPATIENT ANCILLARY SERVICE CAPITAL COSTS,APPORTIONMENT OF INPATIENT/OUTPATIENT ANCILLARY SERVICE OTHER PASS THROUGH COSTS,APPORTIONMENT OF INPATIENT/OUTPATIENT ANCILLARY SERVICE OTHER PASS THROUGH COSTS,APPORTIONMENT OF INPATIENT/OUTPATIENT ANCILLARY SERVICE OTHER PASS THROUGH COSTS,APPORTIONMENT OF INPATIENT/OUTPATIENT ANCILLARY SERVICE OTHER PASS THROUGH COSTS,APPORTIONMENT OF INPATIENT/OUTPATIENT ANCILLARY SERVICE OTHER PASS THROUGH COSTS,APPORTIONMENT OF INPATIENT/OUTPATIENT ANCILLARY SERVICE OTHER PASS THROUGH COSTS,APPORTIONMENT OF INPATIENT/OUTPATIENT ANCILLARY SERVICE OTHER PASS THROUGH COSTS,APPORTIONMENT OF INPATIENT/OUTPATIENT ANCILLARY SERVICE OTHER PASS THROUGH COSTS,APPORTIONMENT OF INPATIENT/OUTPATIENT ANCILLARY SERVICE OTHER PASS THROUGH COSTS,APPORTIONMENT OF INPATIENT/OUTPATIENT ANCILLARY SERVICE OTHER PASS THROUGH COSTS,APPORTIONMENT OF INPATIENT/OUTPATIENT ANCILLARY SERVICE OTHER PASS THROUGH COSTS,APPORTIONMENT OF INPATIENT/OUTPATIENT ANCILLARY SERVICE OTHER PASS THROUGH COSTS,APPORTIONMENT OF INPATIENT/OUTPATIENT ANCILLARY SERVICE OTHER PASS THROUGH COSTS,APPORTIONMENT OF INPATIENT/OUTPATIENT ANCILLARY SERVICE OTHER PASS THROUGH COSTS,APPORTIONMENT OF INPATIENT/OUTPATIENT ANCILLARY SERVICE OTHER PASS THROUGH COSTS,APPORTIONMENT OF INPATIENT/OUTPATIENT ANCILLARY SERVICE OTHER PASS THROUGH COSTS,APPORTIONMENT OF INPATIENT/OUTPATIENT ANCILLARY SERVICE OTHER PASS THROUGH COSTS,APPORTIONMENT OF INPATIENT/OUTPATIENT ANCILLARY SERVICE OTHER PASS THROUGH COSTS,APPORTIONMENT OF INPATIENT/OUTPATIENT ANCILLARY SERVICE OTHER PASS THROUGH COSTS,APPORTIONMENT OF MEDICAL AND OTHER HEALTH SERVICES,APPORTIONMENT OF MEDICAL AND OTHER HEALTH SERVICES,APPORTIONMENT OF MEDICAL AND OTHER HEALTH SERVICES,APPORTIONMENT OF MEDICAL AND OTHER HEALTH SERVICES,APPORTIONMENT OF MEDICAL AND OTHER HEALTH SERVICES,APPORTIONMENT OF MEDICAL AND OTHER HEALTH SERVICES,APPORTIONMENT OF MEDICAL AND OTHER HEALTH SERVICES,APPORTIONMENT OF MEDICAL AND OTHER HEALTH SERVICES,APPORTIONMENT OF MEDICAL AND OTHER HEALTH SERVICES,APPORTIONMENT OF MEDICAL AND OTHER HEALTH SERVICES,APPORTIONMENT OF MEDICAL AND OTHER HEALTH SERVICES,APPORTIONMENT OF MEDICAL AND OTHER HEALTH SERVICES,APPORTIONMENT OF MEDICAL AND OTHER HEALTH SERVICES,APPORTIONMENT OF MEDICAL AND OTHER HEALTH SERVICES,APPORTIONMENT OF MEDICAL AND OTHER HEALTH SERVICES,APPORTIONMENT OF MEDICAL AND OTHER HEALTH SERVICES,APPORTIONMENT OF MEDICAL AND OTHER HEALTH SERVICES,APPORTIONMENT OF MEDICAL AND OTHER HEALTH SERVICES,APPORTIONMENT OF MEDICAL AND OTHER HEALTH SERVICES,APPORTIONMENT OF MEDICAL AND OTHER HEALTH SERVICES,APPORTIONMENT OF MEDICAL AND OTHER HEALTH SERVICES,APPORTIONMENT OF MEDICAL AND OTHER HEALTH SERVICES,APPORTIONMENT OF MEDICAL AND OTHER HEALTH SERVICES,APPORTIONMENT OF MEDICAL AND OTHER HEALTH SERVICES,APPORTIONMENT OF MEDICAL AND OTHER HEALTH SERVICES,APPORTIONMENT OF MEDICAL AND OTHER HEALTH SERVICES,APPORTIONMENT OF MEDICAL AND OTHER HEALTH SERVICES,APPORTIONMENT OF MEDICAL AND OTHER HEALTH SERVICES,APPORTIONMENT OF MEDICAL AND OTHER HEALTH SERVICES,APPORTIONMENT OF MEDICAL AND OTHER HEALTH SERVICES,APPORTIONMENT OF MEDICAL AND OTHER HEALTH SERVICES,APPORTIONMENT OF MEDICAL AND OTHER HEALTH SERVICES,APPORTIONMENT OF MEDICAL AND OTHER HEALTH SERVICES,APPORTIONMENT OF MEDICAL AND OTHER HEALTH SERVICES,STATEMENT OF PATIENT REVENUES AND OPERATING EXPENSES,STATEMENT OF PATIENT REVENUES AND OPERATING EXPENSES,BALANCE SHEET,BALANCE SHEET,BALANCE SHEET,NUMBER OF BEDS,NUMBER OF BEDS,BED DAYS AVAILABLE,BED DAYS AVAILABLE,Medicare Inpatient Days/Outpatient Visits,Medicare Inpatient Days/Outpatient Visits,Medicaid Inpatient Days/Outpatient Visits,Medicaid Inpatient Days/Outpatient Visits,Medicaid Inpatient Days/Outpatient Visits,Total Inpatient Days/Outpatient Visits,Total Inpatient Days/Outpatient Visits,TRIAL BALANCE OF EXPENSE ACCOUNTS,TRIAL BALANCE OF EXPENSE ACCOUNTS,COST ALLOCATION,COMPUTATION OF RATIO OF COST TO CHARGES,COMPUTATION OF RATIO OF COST TO CHARGES,COMPUTATION OF RATIO OF COST TO CHARGES,COMPUTATION OF RATIO OF COST TO CHARGES,INPATIENT ANCILLARY SERVICE COST APPORTIONMENT,INPATIENT ANCILLARY SERVICE COST APPORTIONMENT,APPORTIONMENT OF INPATIENT ANCILLARY SERVICE CAPITAL COSTS,APPORTIONMENT OF INPATIENT/OUTPATIENT ANCILLARY SERVICE OTHER PASS THROUGH COSTS,APPORTIONMENT OF INPATIENT/OUTPATIENT ANCILLARY SERVICE OTHER PASS THROUGH COSTS,APPORTIONMENT OF MEDICAL AND OTHER HEALTH SERVICES,APPORTIONMENT OF MEDICAL AND OTHER HEALTH SERVICES,TRIAL BALANCE OF EXPENSE ACCOUNTS,TRIAL BALANCE OF EXPENSE ACCOUNTS,TRIAL BALANCE OF EXPENSE ACCOUNTS,COST ALLOCATION,COST ALLOCATION,ALLOCATION OF NEW CAPITAL COSTS,COMPUTATION OF RATIO OF COST TO CHARGES,COMPUTATION OF RATIO OF COST TO CHARGES,COMPUTATION OF RATIO OF COST TO CHARGES,INPATIENT ANCILLARY SERVICE COST APPORTIONMENT,INPATIENT ANCILLARY SERVICE COST APPORTIONMENT,APPORTIONMENT OF INPATIENT ANCILLARY SERVICE CAPITAL COSTS,APPORTIONMENT OF INPATIENT/OUTPATIENT ANCILLARY SERVICE OTHER PASS THROUGH COSTS,APPORTIONMENT OF INPATIENT/OUTPATIENT ANCILLARY SERVICE OTHER PASS THROUGH COSTS,APPORTIONMENT OF MEDICAL AND OTHER HEALTH SERVICES,APPORTIONMENT OF MEDICAL AND OTHER HEALTH SERVICES,APPORTIONMENT OF MEDICAL AND OTHER HEALTH SERVICES,APPORTIONMENT OF MEDICAL AND OTHER HEALTH SERVICES,CALCULATION OF REIMBURSEMENT SETTLEMENT (PPS),STATEMENT OF PATIENT REVENUES AND OPERATING EXPENSES,TRIAL BALANCE OF EXPENSE ACCOUNTS,TRIAL BALANCE OF EXPENSE ACCOUNTS,TRIAL BALANCE OF EXPENSE ACCOUNTS,TRIAL BALANCE OF EXPENSE ACCOUNTS,TRIAL BALANCE OF EXPENSE ACCOUNTS,COST ALLOCATION,INPATIENT ANCILLARY SERVICE COST APPORTIONMENT,INPATIENT ANCILLARY SERVICE COST APPORTIONMENT,INPATIENT ANCILLARY SERVICE COST APPORTIONMENT,INPATIENT ANCILLARY SERVICE COST APPORTIONMENT,INPATIENT ANCILLARY SERVICE COST APPORTIONMENT,INPATIENT ANCILLARY SERVICE COST APPORTIONMENT,INPATIENT ANCILLARY SERVICE COST APPORTIONMENT,INPATIENT ANCILLARY SERVICE COST APPORTIONMENT,INPATIENT ANCILLARY SERVICE COST APPORTIONMENT,INPATIENT ANCILLARY SERVICE COST APPORTIONMENT,INPATIENT ANCILLARY SERVICE COST APPORTIONMENT,INPATIENT ANCILLARY SERVICE COST APPORTIONMENT,INPATIENT ANCILLARY SERVICE COST APPORTIONMENT,INPATIENT ANCILLARY SERVICE COST APPORTIONMENT,INPATIENT ANCILLARY SERVICE COST APPORTIONMENT,INPATIENT ANCILLARY SERVICE COST APPORTIONMENT,INPATIENT ANCILLARY SERVICE COST APPORTIONMENT,INPATIENT ANCILLARY SERVICE COST APPORTIONMENT,INPATIENT ANCILLARY SERVICE COST APPORTIONMENT,INPATIENT ANCILLARY SERVICE COST APPORTIONMENT,INPATIENT ANCILLARY SERVICE COST APPORTIONMENT,INPATIENT ANCILLARY SERVICE COST APPORTIONMENT,INPATIENT ANCILLARY SERVICE COST APPORTIONMENT,INPATIENT ANCILLARY SERVICE COST APPORTIONMENT,INPATIENT ANCILLARY SERVICE COST APPORTIONMENT,INPATIENT ANCILLARY SERVICE COST APPORTIONMENT,INPATIENT ANCILLARY SERVICE COST APPORTIONMENT,INPATIENT ANCILLARY SERVICE COST APPORTIONMENT,INPATIENT ANCILLARY SERVICE COST APPORTIONMENT,INPATIENT ANCILLARY SERVICE COST APPORTIONMENT,INPATIENT ANCILLARY SERVICE COST APPORTIONMENT,INPATIENT ANCILLARY SERVICE COST APPORTIONMENT,INPATIENT ANCILLARY SERVICE COST APPORTIONMENT,INPATIENT ANCILLARY SERVICE COST APPORTIONMENT,INPATIENT ANCILLARY SERVICE COST APPORTIONMENT,INPATIENT ANCILLARY SERVICE COST APPORTIONMENT,INPATIENT ANCILLARY SERVICE COST APPORTIONMENT,INPATIENT ANCILLARY SERVICE COST APPORTIONMENT,INPATIENT ANCILLARY SERVICE COST APPORTIONMENT,INPATIENT ANCILLARY SERVICE COST APPORTIONMENT,INPATIENT ANCILLARY SERVICE COST APPORTIONMENT,INPATIENT ANCILLARY SERVICE COST APPORTIONMENT,INPATIENT ANCILLARY SERVICE COST APPORTIONMENT,INPATIENT ANCILLARY SERVICE COST APPORTIONMENT,INPATIENT ANCILLARY SERVICE COST APPORTIONMENT,INPATIENT ANCILLARY SERVICE COST APPORTIONMENT,INPATIENT ANCILLARY SERVICE COST APPORTIONMENT,INPATIENT ANCILLARY SERVICE COST APPORTIONMENT,INPATIENT ANCILLARY SERVICE COST APPORTIONMENT,INPATIENT ANCILLARY SERVICE COST APPORTIONMENT,INPATIENT ANCILLARY SERVICE COST APPORTIONMENT,INPATIENT ANCILLARY SERVICE COST APPORTIONMENT,INPATIENT ANCILLARY SERVICE COST APPORTIONMENT,INPATIENT ANCILLARY SERVICE COST APPORTIONMENT,INPATIENT ANCILLARY SERVICE COST APPORTIONMENT,INPATIENT ANCILLARY SERVICE COST APPORTIONMENT,INPATIENT ANCILLARY SERVICE COST APPORTIONMENT,INPATIENT ANCILLARY SERVICE COST APPORTIONMENT,INPATIENT ANCILLARY SERVICE COST APPORTIONMENT,INPATIENT ANCILLARY SERVICE COST APPORTIONMENT,APPORTIONMENT OF INPATIENT ANCILLARY SERVICE CAPITAL COSTS,APPORTIONMENT OF INPATIENT ANCILLARY SERVICE CAPITAL COSTS,APPORTIONMENT OF INPATIENT ANCILLARY SERVICE CAPITAL COSTS,APPORTIONMENT OF INPATIENT ANCILLARY SERVICE CAPITAL COSTS,APPORTIONMENT OF INPATIENT ANCILLARY SERVICE CAPITAL COSTS,APPORTIONMENT OF INPATIENT ANCILLARY SERVICE CAPITAL COSTS,APPORTIONMENT OF INPATIENT ANCILLARY SERVICE CAPITAL COSTS,APPORTIONMENT OF INPATIENT ANCILLARY SERVICE CAPITAL COSTS,APPORTIONMENT OF INPATIENT ANCILLARY SERVICE CAPITAL COSTS,APPORTIONMENT OF INPATIENT ANCILLARY SERVICE CAPITAL COSTS,APPORTIONMENT OF INPATIENT ANCILLARY SERVICE CAPITAL COSTS,APPORTIONMENT OF INPATIENT ANCILLARY SERVICE CAPITAL COSTS,APPORTIONMENT OF INPATIENT ANCILLARY SERVICE CAPITAL COSTS,APPORTIONMENT OF INPATIENT ANCILLARY SERVICE CAPITAL COSTS,APPORTIONMENT OF INPATIENT ANCILLARY SERVICE CAPITAL COSTS,APPORTIONMENT OF INPATIENT ANCILLARY SERVICE CAPITAL COSTS,APPORTIONMENT OF INPATIENT ANCILLARY SERVICE CAPITAL COSTS,APPORTIONMENT OF INPATIENT ANCILLARY SERVICE CAPITAL COSTS,APPORTIONMENT OF INPATIENT ANCILLARY SERVICE CAPITAL COSTS,APPORTIONMENT OF INPATIENT ANCILLARY SERVICE CAPITAL COSTS,APPORTIONMENT OF INPATIENT ANCILLARY SERVICE CAPITAL COSTS,APPORTIONMENT OF INPATIENT ANCILLARY SERVICE CAPITAL COSTS,APPORTIONMENT OF INPATIENT ANCILLARY SERVICE CAPITAL COSTS,APPORTIONMENT OF INPATIENT ANCILLARY SERVICE CAPITAL COSTS,APPORTIONMENT OF INPATIENT ANCILLARY SERVICE CAPITAL COSTS,APPORTIONMENT OF INPATIENT ANCILLARY SERVICE CAPITAL COSTS,APPORTIONMENT OF INPATIENT ANCILLARY SERVICE CAPITAL COSTS,APPORTIONMENT OF INPATIENT ANCILLARY SERVICE CAPITAL COSTS,APPORTIONMENT OF INPATIENT ANCILLARY SERVICE CAPITAL COSTS,APPORTIONMENT OF INPATIENT ANCILLARY SERVICE CAPITAL COSTS,APPORTIONMENT OF INPATIENT/OUTPATIENT ANCILLARY SERVICE OTHER PASS THROUGH COSTS,APPORTIONMENT OF MEDICAL AND OTHER HEALTH SERVICES,APPORTIONMENT OF MEDICAL AND OTHER HEALTH SERVICES,STATEMENT OF PATIENT REVENUES AND OPERATING EXPENSES,TRIAL BALANCE OF EXPENSE ACCOUNTS,TRIAL BALANCE OF EXPENSE ACCOUNTS,TRIAL BALANCE OF EXPENSE ACCOUNTS,COST ALLOCATION,COST ALLOCATION,COST ALLOCATION,COST ALLOCATION,ALLOCATION OF NEW CAPITAL COSTS,ALLOCATION OF NEW CAPITAL COSTS,COMPUTATION OF RATIO OF COST TO CHARGES,COMPUTATION OF RATIO OF COST TO CHARGES,INPATIENT ANCILLARY SERVICE COST APPORTIONMENT,INPATIENT ANCILLARY SERVICE COST APPORTIONMENT,INPATIENT ANCILLARY SERVICE COST APPORTIONMENT,INPATIENT ANCILLARY SERVICE COST APPORTIONMENT,INPATIENT ANCILLARY SERVICE COST APPORTIONMENT,INPATIENT ANCILLARY SERVICE COST APPORTIONMENT,INPATIENT ANCILLARY SERVICE COST APPORTIONMENT,INPATIENT ANCILLARY SERVICE COST APPORTIONMENT,INPATIENT ANCILLARY SERVICE COST APPORTIONMENT,INPATIENT ANCILLARY SERVICE COST APPORTIONMENT,INPATIENT ANCILLARY SERVICE COST APPORTIONMENT,INPATIENT ANCILLARY SERVICE COST APPORTIONMENT,INPATIENT ANCILLARY SERVICE COST APPORTIONMENT,INPATIENT ANCILLARY SERVICE COST APPORTIONMENT,Total Inpatient Days/Outpatient Visits,Total Inpatient Days/Outpatient Visits,Total Inpatient Days/Outpatient Visits,RECONCILIATION OF CAPITAL COST CENTERS,TRIAL BALANCE OF EXPENSE ACCOUNTS,TRIAL BALANCE OF EXPENSE ACCOUNTS,TRIAL BALANCE OF EXPENSE ACCOUNTS,TRIAL BALANCE OF EXPENSE ACCOUNTS,TRIAL BALANCE OF EXPENSE ACCOUNTS,TRIAL BALANCE OF EXPENSE ACCOUNTS,TRIAL BALANCE OF EXPENSE ACCOUNTS,TRIAL BALANCE OF EXPENSE ACCOUNTS,TRIAL BALANCE OF EXPENSE ACCOUNTS,TRIAL BALANCE OF EXPENSE ACCOUNTS,TRIAL BALANCE OF EXPENSE ACCOUNTS,TRIAL BALANCE OF EXPENSE ACCOUNTS,TRIAL BALANCE OF EXPENSE ACCOUNTS,COST ALLOCATION,COST ALLOCATION,COST ALLOCATION,COST ALLOCATION,COST ALLOCATION,COST ALLOCATION,COST ALLOCATION,ALLOCATION OF NEW CAPITAL COSTS,ALLOCATION OF NEW CAPITAL COSTS,COMPUTATION OF RATIO OF COST TO CHARGES,COMPUTATION OF RATIO OF COST TO CHARGES,COMPUTATION OF RATIO OF COST TO CHARGES,COMPUTATION OF RATIO OF COST TO CHARGES,COMPUTATION OF RATIO OF COST TO CHARGES,COMPUTATION OF RATIO OF COST TO CHARGES,INPATIENT ANCILLARY SERVICE COST APPORTIONMENT,INPATIENT ANCILLARY SERVICE COST APPORTIONMENT,INPATIENT ANCILLARY SERVICE COST APPORTIONMENT,INPATIENT ANCILLARY SERVICE COST APPORTIONMENT,INPATIENT ANCILLARY SERVICE COST APPORTIONMENT,INPATIENT ANCILLARY SERVICE COST APPORTIONMENT,INPATIENT ANCILLARY SERVICE COST APPORTIONMENT,INPATIENT ANCILLARY SERVICE COST APPORTIONMENT,INPATIENT ANCILLARY SERVICE COST APPORTIONMENT,INPATIENT ANCILLARY SERVICE COST APPORTIONMENT,INPATIENT ANCILLARY SERVICE COST APPORTIONMENT,INPATIENT ANCILLARY SERVICE COST APPORTIONMENT,INPATIENT ANCILLARY SERVICE COST APPORTIONMENT,INPATIENT ANCILLARY SERVICE COST APPORTIONMENT,INPATIENT ANCILLARY SERVICE COST APPORTIONMENT,INPATIENT ANCILLARY SERVICE COST APPORTIONMENT,INPATIENT ANCILLARY SERVICE COST APPORTIONMENT,INPATIENT ANCILLARY SERVICE COST APPORTIONMENT,INPATIENT ANCILLARY SERVICE COST APPORTIONMENT,INPATIENT ANCILLARY SERVICE COST APPORTIONMENT,APPORTIONMENT OF INPATIENT ROUTINE SERVICE CAPITAL COSTS,APPORTIONMENT OF INPATIENT ANCILLARY SERVICE CAPITAL COSTS,APPORTIONMENT OF INPATIENT ANCILLARY SERVICE CAPITAL COSTS,APPORTIONMENT OF INPATIENT ANCILLARY SERVICE CAPITAL COSTS,APPORTIONMENT OF INPATIENT ANCILLARY SERVICE CAPITAL COSTS,APPORTIONMENT OF INPATIENT ANCILLARY SERVICE CAPITAL COSTS,APPORTIONMENT OF INPATIENT ANCILLARY SERVICE CAPITAL COSTS,APPORTIONMENT OF INPATIENT ANCILLARY SERVICE CAPITAL COSTS,APPORTIONMENT OF INPATIENT ANCILLARY SERVICE CAPITAL COSTS,APPORTIONMENT OF INPATIENT ANCILLARY SERVICE CAPITAL COSTS,APPORTIONMENT OF INPATIENT ANCILLARY SERVICE CAPITAL COSTS,APPORTIONMENT OF INPATIENT ROUTINE SERVICE OTHER PASS THROUGH COSTS,APPORTIONMENT OF INPATIENT/OUTPATIENT ANCILLARY SERVICE OTHER PASS THROUGH COSTS,APPORTIONMENT OF INPATIENT/OUTPATIENT ANCILLARY SERVICE OTHER PASS THROUGH COSTS,APPORTIONMENT OF INPATIENT/OUTPATIENT ANCILLARY SERVICE OTHER PASS THROUGH COSTS,APPORTIONMENT OF MEDICAL AND OTHER HEALTH SERVICES,APPORTIONMENT OF MEDICAL AND OTHER HEALTH SERVICES,APPORTIONMENT OF MEDICAL AND OTHER HEALTH SERVICES,APPORTIONMENT OF MEDICAL AND OTHER HEALTH SERVICES,APPORTIONMENT OF MEDICAL AND OTHER HEALTH SERVICES,APPORTIONMENT OF MEDICAL AND OTHER HEALTH SERVICES,APPORTIONMENT OF MEDICAL AND OTHER HEALTH SERVICES,APPORTIONMENT OF MEDICAL AND OTHER HEALTH SERVICES,STATEMENT OF PATIENT REVENUES AND OPERATING EXPENSES,BALANCE SHEET,NUMBER OF BEDS,BED DAYS AVAILABLE,Medicaid Inpatient Days/Outpatient Visits,Total Inpatient Days/Outpatient Visits,APPORTIONMENT OF MEDICAL AND OTHER HEALTH SERVICES,APPORTIONMENT OF MEDICAL AND OTHER HEALTH SERVICES,TRIAL BALANCE OF EXPENSE ACCOUNTS,Medicare Inpatient Days/Outpatient Visits,TRIAL BALANCE OF EXPENSE ACCOUNTS,TRIAL BALANCE OF EXPENSE ACCOUNTS,TRIAL BALANCE OF EXPENSE ACCOUNTS,COST ALLOCATION,COST ALLOCATION,ALLOCATION OF NEW CAPITAL COSTS,COMPUTATION OF RATIO OF COST TO CHARGES,COMPUTATION OF RATIO OF COST TO CHARGES,INPATIENT ANCILLARY SERVICE COST APPORTIONMENT,INPATIENT ANCILLARY SERVICE COST APPORTIONMENT,INPATIENT ANCILLARY SERVICE COST APPORTIONMENT,INPATIENT ANCILLARY SERVICE COST APPORTIONMENT,TRIAL BALANCE OF EXPENSE ACCOUNTS,TRIAL BALANCE OF EXPENSE ACCOUNTS,TRIAL BALANCE OF EXPENSE ACCOUNTS,TRIAL BALANCE OF EXPENSE ACCOUNTS,TRIAL BALANCE OF EXPENSE ACCOUNTS,TRIAL BALANCE OF EXPENSE ACCOUNTS,COST ALLOCATION,COST ALLOCATION,COST ALLOCATION,COST ALLOCATION,ALLOCATION OF NEW CAPITAL COSTS,ALLOCATION OF NEW CAPITAL COSTS,COMPUTATION OF RATIO OF COST TO CHARGES,COMPUTATION OF RATIO OF COST TO CHARGES,APPORTIONMENT OF MEDICAL AND OTHER HEALTH SERVICES,APPORTIONMENT OF MEDICAL AND OTHER HEALTH SERVICES,APPORTIONMENT OF MEDICAL AND OTHER HEALTH SERVICES,APPORTIONMENT OF MEDICAL AND OTHER HEALTH SERVICES,APPORTIONMENT OF MEDICAL AND OTHER HEALTH SERVICES,APPORTIONMENT OF MEDICAL AND OTHER HEALTH SERVICES,APPORTIONMENT OF MEDICAL AND OTHER HEALTH SERVICES,APPORTIONMENT OF MEDICAL AND OTHER HEALTH SERVICES,APPORTIONMENT OF MEDICAL AND OTHER HEALTH SERVICES,APPORTIONMENT OF MEDICAL AND OTHER HEALTH SERVICES,APPORTIONMENT OF MEDICAL AND OTHER HEALTH SERVICES,APPORTIONMENT OF MEDICAL AND OTHER HEALTH SERVICES,STATEMENT OF PATIENT REVENUES AND OPERATING EXPENSES,Total Inpatient Days/Outpatient Visits,Medicare Inpatient Days/Outpatient Visits,Medicaid Inpatient Days/Outpatient Visits,Total Inpatient Days/Outpatient Visits,TRIAL BALANCE OF EXPENSE ACCOUNTS,TRIAL BALANCE OF EXPENSE ACCOUNTS,TRIAL BALANCE OF EXPENSE ACCOUNTS,COST ALLOCATION,COMPUTATION OF RATIO OF COST TO CHARGES,COMPUTATION OF RATIO OF COST TO CHARGES,INPATIENT ANCILLARY SERVICE COST APPORTIONMENT,INPATIENT ANCILLARY SERVICE COST APPORTIONMENT,INPATIENT ANCILLARY SERVICE COST APPORTIONMENT,INPATIENT ANCILLARY SERVICE COST APPORTIONMENT,INPATIENT ANCILLARY SERVICE COST APPORTIONMENT,INPATIENT ANCILLARY SERVICE COST APPORTIONMENT,APPORTIONMENT OF INPATIENT/OUTPATIENT ANCILLARY SERVICE OTHER PASS THROUGH COSTS,APPORTIONMENT OF INPATIENT/OUTPATIENT ANCILLARY SERVICE OTHER PASS THROUGH COSTS,APPORTIONMENT OF MEDICAL AND OTHER HEALTH SERVICES,APPORTIONMENT OF MEDICAL AND OTHER HEALTH SERVICES,APPORTIONMENT OF MEDICAL AND OTHER HEALTH SERVICES,APPORTIONMENT OF MEDICAL AND OTHER HEALTH SERVICES,STATEMENT OF PATIENT REVENUES AND OPERATING EXPENSES,BALANCE SHEET,TRIAL BALANCE OF EXPENSE ACCOUNTS,TRIAL BALANCE OF EXPENSE ACCOUNTS,COST ALLOCATION,COST ALLOCATION,ALLOCATION OF NEW CAPITAL COSTS,COMPUTATION OF RATIO OF COST TO CHARGES,COMPUTATION OF RATIO OF COST TO CHARGES,COMPUTATION OF RATIO OF COST TO CHARGES,INPATIENT ANCILLARY SERVICE COST APPORTIONMENT,INPATIENT ANCILLARY SERVICE COST APPORTIONMENT,APPORTIONMENT OF INPATIENT ANCILLARY SERVICE CAPITAL COSTS,APPORTIONMENT OF INPATIENT/OUTPATIENT ANCILLARY SERVICE OTHER PASS THROUGH COSTS,APPORTIONMENT OF INPATIENT/OUTPATIENT ANCILLARY SERVICE OTHER PASS THROUGH COSTS,APPORTIONMENT OF MEDICAL AND OTHER HEALTH SERVICES,APPORTIONMENT OF MEDICAL AND OTHER HEALTH SERVICES,BALANCE SHEET,TRIAL BALANCE OF EXPENSE ACCOUNTS,COMPUTATION OF RATIO OF COST TO CHARGES,TRIAL BALANCE OF EXPENSE ACCOUNTS,Medicaid Inpatient Days/Outpatient Visits,COMPUTATION OF RATIO OF COST TO CHARGES,APPORTIONMENT OF INPATIENT/OUTPATIENT ANCILLARY SERVICE OTHER PASS THROUGH COSTS,APPORTIONMENT OF MEDICAL AND OTHER HEALTH SERVICES,APPORTIONMENT OF MEDICAL AND OTHER HEALTH SERVICES,TRIAL BALANCE OF EXPENSE ACCOUNTS,COST ALLOCATION,CALCULATION OF REIMBURSEMENT SETTLEMENT,TRIAL BALANCE OF EXPENSE ACCOUNTS,TRIAL BALANCE OF EXPENSE ACCOUNTS,COMPUTATION OF RATIO OF COST TO CHARGES,TRIAL BALANCE OF EXPENSE ACCOUNTS,APPORTIONMENT OF MEDICAL AND OTHER HEALTH SERVICES,APPORTIONMENT OF MEDICAL AND OTHER HEALTH SERVICES,TRIAL BALANCE OF EXPENSE ACCOUNTS,COMPUTATION OF RATIO OF COST TO CHARGES,COMPUTATION OF RATIO OF COST TO CHARGES,APPORTIONMENT OF MEDICAL AND OTHER HEALTH SERVICES,APPORTIONMENT OF MEDICAL AND OTHER HEALTH SERVICES,APPORTIONMENT OF MEDICAL AND OTHER HEALTH SERVICES,APPORTIONMENT OF MEDICAL AND OTHER HEALTH SERVICES,STATEMENT OF PATIENT REVENUES AND OPERATING EXPENSES,STATEMENT OF PATIENT REVENUES AND OPERATING EXPENSES,BED DAYS AVAILABLE,TRIAL BALANCE OF EXPENSE ACCOUNTS,TRIAL BALANCE OF EXPENSE ACCOUNTS,TRIAL BALANCE OF EXPENSE ACCOUNTS,TRIAL BALANCE OF EXPENSE ACCOUNTS,TRIAL BALANCE OF EXPENSE ACCOUNTS,TRIAL BALANCE OF EXPENSE ACCOUNTS,TRIAL BALANCE OF EXPENSE ACCOUNTS,COST ALLOCATION,COST ALLOCATION,COST ALLOCATION,COST ALLOCATION,COST ALLOCATION,COST ALLOCATION,COST ALLOCATION,COST ALLOCATION,COST ALLOCATION,COST ALLOCATION,COST ALLOCATION,COST ALLOCATION,COST ALLOCATION,COST ALLOCATION,COST ALLOCATION,COST ALLOCATION,COST ALLOCATION,COST ALLOCATION,COST ALLOCATION,COST ALLOCATION,COST ALLOCATION,COST ALLOCATION,COST ALLOCATION,COST ALLOCATION,COST ALLOCATION,COST ALLOCATION,COST ALLOCATION,COST ALLOCATION,COST ALLOCATION,COST ALLOCATION,COST ALLOCATION,COST ALLOCATION,COST ALLOCATION,APPORTIONMENT OF INPATIENT/OUTPATIENT ANCILLARY SERVICE OTHER PASS THROUGH COSTS,APPORTIONMENT OF INPATIENT/OUTPATIENT ANCILLARY SERVICE OTHER PASS THROUGH COSTS,APPORTIONMENT OF INPATIENT/OUTPATIENT ANCILLARY SERVICE OTHER PASS THROUGH COSTS,APPORTIONMENT OF INPATIENT/OUTPATIENT ANCILLARY SERVICE OTHER PASS THROUGH COSTS,APPORTIONMENT OF INPATIENT/OUTPATIENT ANCILLARY SERVICE OTHER PASS THROUGH COSTS,APPORTIONMENT OF INPATIENT/OUTPATIENT ANCILLARY SERVICE OTHER PASS THROUGH COSTS,APPORTIONMENT OF INPATIENT/OUTPATIENT ANCILLARY SERVICE OTHER PASS THROUGH COSTS,APPORTIONMENT OF INPATIENT/OUTPATIENT ANCILLARY SERVICE OTHER PASS THROUGH COSTS,APPORTIONMENT OF INPATIENT/OUTPATIENT ANCILLARY SERVICE OTHER PASS THROUGH COSTS,APPORTIONMENT OF INPATIENT/OUTPATIENT ANCILLARY SERVICE OTHER PASS THROUGH COSTS,APPORTIONMENT OF INPATIENT/OUTPATIENT ANCILLARY SERVICE OTHER PASS THROUGH COSTS,APPORTIONMENT OF INPATIENT/OUTPATIENT ANCILLARY SERVICE OTHER PASS THROUGH COSTS,APPORTIONMENT OF INPATIENT/OUTPATIENT ANCILLARY SERVICE OTHER PASS THROUGH COSTS,APPORTIONMENT OF INPATIENT/OUTPATIENT ANCILLARY SERVICE OTHER PASS THROUGH COSTS,APPORTIONMENT OF INPATIENT/OUTPATIENT ANCILLARY SERVICE OTHER PASS THROUGH COSTS,APPORTIONMENT OF INPATIENT/OUTPATIENT ANCILLARY SERVICE OTHER PASS THROUGH COSTS,APPORTIONMENT OF INPATIENT/OUTPATIENT ANCILLARY SERVICE OTHER PASS THROUGH COSTS,APPORTIONMENT OF INPATIENT/OUTPATIENT ANCILLARY SERVICE OTHER PASS THROUGH COSTS,APPORTIONMENT OF INPATIENT/OUTPATIENT ANCILLARY SERVICE OTHER PASS THROUGH COSTS,APPORTIONMENT OF INPATIENT/OUTPATIENT ANCILLARY SERVICE OTHER PASS THROUGH COSTS,APPORTIONMENT OF INPATIENT/OUTPATIENT ANCILLARY SERVICE OTHER PASS THROUGH COSTS,APPORTIONMENT OF INPATIENT/OUTPATIENT ANCILLARY SERVICE OTHER PASS THROUGH COSTS,APPORTIONMENT OF INPATIENT/OUTPATIENT ANCILLARY SERVICE OTHER PASS THROUGH COSTS,APPORTIONMENT OF INPATIENT/OUTPATIENT ANCILLARY SERVICE OTHER PASS THROUGH COSTS,APPORTIONMENT OF INPATIENT/OUTPATIENT ANCILLARY SERVICE OTHER PASS THROUGH COSTS,APPORTIONMENT OF INPATIENT/OUTPATIENT ANCILLARY SERVICE OTHER PASS THROUGH COSTS,APPORTIONMENT OF INPATIENT/OUTPATIENT ANCILLARY SERVICE OTHER PASS THROUGH COSTS,APPORTIONMENT OF INPATIENT/OUTPATIENT ANCILLARY SERVICE OTHER PASS THROUGH COSTS,APPORTIONMENT OF INPATIENT/OUTPATIENT ANCILLARY SERVICE OTHER PASS THROUGH COSTS,APPORTIONMENT OF INPATIENT/OUTPATIENT ANCILLARY SERVICE OTHER PASS THROUGH COSTS,APPORTIONMENT OF INPATIENT/OUTPATIENT ANCILLARY SERVICE OTHER PASS THROUGH COSTS,APPORTIONMENT OF INPATIENT/OUTPATIENT ANCILLARY SERVICE OTHER PASS THROUGH COSTS,APPORTIONMENT OF INPATIENT/OUTPATIENT ANCILLARY SERVICE OTHER PASS THROUGH COSTS,APPORTIONMENT OF INPATIENT/OUTPATIENT ANCILLARY SERVICE OTHER PASS THROUGH COSTS,APPORTIONMENT OF INPATIENT/OUTPATIENT ANCILLARY SERVICE OTHER PASS THROUGH COSTS,APPORTIONMENT OF INPATIENT/OUTPATIENT ANCILLARY SERVICE OTHER PASS THROUGH COSTS,APPORTIONMENT OF INPATIENT/OUTPATIENT ANCILLARY SERVICE OTHER PASS THROUGH COSTS,APPORTIONMENT OF INPATIENT/OUTPATIENT ANCILLARY SERVICE OTHER PASS THROUGH COSTS,APPORTIONMENT OF INPATIENT/OUTPATIENT ANCILLARY SERVICE OTHER PASS THROUGH COSTS,APPORTIONMENT OF INPATIENT/OUTPATIENT ANCILLARY SERVICE OTHER PASS THROUGH COSTS,APPORTIONMENT OF MEDICAL AND OTHER HEALTH SERVICES,APPORTIONMENT OF MEDICAL AND OTHER HEALTH SERVICES,APPORTIONMENT OF MEDICAL AND OTHER HEALTH SERVICES,APPORTIONMENT OF MEDICAL AND OTHER HEALTH SERVICES,APPORTIONMENT OF MEDICAL AND OTHER HEALTH SERVICES,APPORTIONMENT OF MEDICAL AND OTHER HEALTH SERVICES,APPORTIONMENT OF MEDICAL AND OTHER HEALTH SERVICES,APPORTIONMENT OF MEDICAL AND OTHER HEALTH SERVICES,APPORTIONMENT OF MEDICAL AND OTHER HEALTH SERVICES,APPORTIONMENT OF MEDICAL AND OTHER HEALTH SERVICES,APPORTIONMENT OF MEDICAL AND OTHER HEALTH SERVICES,APPORTIONMENT OF MEDICAL AND OTHER HEALTH SERVICES,APPORTIONMENT OF MEDICAL AND OTHER HEALTH SERVICES,APPORTIONMENT OF MEDICAL AND OTHER HEALTH SERVICES,APPORTIONMENT OF MEDICAL AND OTHER HEALTH SERVICES,APPORTIONMENT OF MEDICAL AND OTHER HEALTH SERVICES,STATEMENT OF PATIENT REVENUES AND OPERATING EXPENSES,BALANCE SHEET,BALANCE SHEET,Medicare Inpatient Days/Outpatient Visits,Medicaid Inpatient Days/Outpatient Visits,Total Inpatient Days/Outpatient Visits,COST ALLOCATION,ALLOCATION OF NEW CAPITAL COSTS,COMPUTATION OF RATIO OF COST TO CHARGES,BALANCE SHEET,BALANCE SHEET,APPORTIONMENT OF MEDICAL AND OTHER HEALTH SERVICES,APPORTIONMENT OF MEDICAL AND OTHER HEALTH SERVICES,APPORTIONMENT OF MEDICAL AND OTHER HEALTH SERVICES,APPORTIONMENT OF MEDICAL AND OTHER HEALTH SERVICES,APPORTIONMENT OF MEDICAL AND OTHER HEALTH SERVICES,APPORTIONMENT OF MEDICAL AND OTHER HEALTH SERVICES,TRIAL BALANCE OF EXPENSE ACCOUNTS,TRIAL BALANCE OF EXPENSE ACCOUNTS,COST ALLOCATION,TRIAL BALANCE OF EXPENSE ACCOUNTS,TRIAL BALANCE OF EXPENSE ACCOUNTS,TRIAL BALANCE OF EXPENSE ACCOUNTS,COST ALLOCATION,COST ALLOCATION,ALLOCATION OF NEW CAPITAL COSTS,COMPUTATION OF RATIO OF COST TO CHARGES,COMPUTATION OF RATIO OF COST TO CHARGES,INPATIENT ANCILLARY SERVICE COST APPORTIONMENT,APPORTIONMENT OF INPATIENT ROUTINE SERVICE CAPITAL COSTS,APPORTIONMENT OF INPATIENT ROUTINE SERVICE CAPITAL COSTS,APPORTIONMENT OF INPATIENT ROUTINE SERVICE CAPITAL COSTS,STATEMENT OF PATIENT REVENUES AND OPERATING EXPENSES,NUMBER OF BEDS,BED DAYS AVAILABLE,Medicare Inpatient Days/Outpatient Visits,Total Inpatient Days/Outpatient Visits,TRIAL BALANCE OF EXPENSE ACCOUNTS,NUMBER OF BEDS,APPORTIONMENT OF MEDICAL AND OTHER HEALTH SERVICES,APPORTIONMENT OF MEDICAL AND OTHER HEALTH SERVICES,INPATIENT ANCILLARY SERVICE COST APPORTIONMENT,INPATIENT ANCILLARY SERVICE COST APPORTIONMENT,INPATIENT ANCILLARY SERVICE COST APPORTIONMENT,INPATIENT ANCILLARY SERVICE COST APPORTIONMENT,INPATIENT ANCILLARY SERVICE COST APPORTIONMENT,INPATIENT ANCILLARY SERVICE COST APPORTIONMENT,INPATIENT ANCILLARY SERVICE COST APPORTIONMENT,INPATIENT ANCILLARY SERVICE COST APPORTIONMENT,INPATIENT ANCILLARY SERVICE COST APPORTIONMENT,INPATIENT ANCILLARY SERVICE COST APPORTIONMENT,APPORTIONMENT OF INPATIENT ANCILLARY SERVICE CAPITAL COSTS,APPORTIONMENT OF INPATIENT ANCILLARY SERVICE CAPITAL COSTS,APPORTIONMENT OF INPATIENT ANCILLARY SERVICE CAPITAL COSTS,APPORTIONMENT OF INPATIENT ANCILLARY SERVICE CAPITAL COSTS,APPORTIONMENT OF INPATIENT ANCILLARY SERVICE CAPITAL COSTS,APPORTIONMENT OF MEDICAL AND OTHER HEALTH SERVICES,APPORTIONMENT OF MEDICAL AND OTHER HEALTH SERVICES,APPORTIONMENT OF MEDICAL AND OTHER HEALTH SERVICES,APPORTIONMENT OF MEDICAL AND OTHER HEALTH SERVICES,APPORTIONMENT OF MEDICAL AND OTHER HEALTH SERVICES,APPORTIONMENT OF MEDICAL AND OTHER HEALTH SERVICES,APPORTIONMENT OF MEDICAL AND OTHER HEALTH SERVICES,APPORTIONMENT OF MEDICAL AND OTHER HEALTH SERVICES,APPORTIONMENT OF MEDICAL AND OTHER HEALTH SERVICES,APPORTIONMENT OF MEDICAL AND OTHER HEALTH SERVICES,APPORTIONMENT OF MEDICAL AND OTHER HEALTH SERVICES,APPORTIONMENT OF MEDICAL AND OTHER HEALTH SERVICES,APPORTIONMENT OF MEDICAL AND OTHER HEALTH SERVICES,APPORTIONMENT OF MEDICAL AND OTHER HEALTH SERVICES,TRIAL BALANCE OF EXPENSE ACCOUNTS,TRIAL BALANCE OF EXPENSE ACCOUNTS,COST ALLOCATION,COST ALLOCATION,ALLOCATION OF NEW CAPITAL COSTS,COMPUTATION OF RATIO OF COST TO CHARGES,COMPUTATION OF RATIO OF COST TO CHARGES,APPORTIONMENT OF MEDICAL AND OTHER HEALTH SERVICES,APPORTIONMENT OF MEDICAL AND OTHER HEALTH SERVICES,BALANCE SHEET,BALANCE SHEET,BALANCE SHEET,TRIAL BALANCE OF EXPENSE ACCOUNTS,TRIAL BALANCE OF EXPENSE ACCOUNTS,TRIAL BALANCE OF EXPENSE ACCOUNTS,TRIAL BALANCE OF EXPENSE ACCOUNTS,TRIAL BALANCE OF EXPENSE ACCOUNTS,TRIAL BALANCE OF EXPENSE ACCOUNTS,TRIAL BALANCE OF EXPENSE ACCOUNTS,TRIAL BALANCE OF EXPENSE ACCOUNTS,COST ALLOCATION,COST ALLOCATION,COST ALLOCATION,COST ALLOCATION,COST ALLOCATION,COST ALLOCATION,COST ALLOCATION,COST ALLOCATION,COST ALLOCATION,COST ALLOCATION,COST ALLOCATION,COST ALLOCATION,COST ALLOCATION,COST ALLOCATION,ALLOCATION OF NEW CAPITAL COSTS,COMPUTATION OF RATIO OF COST TO CHARGES,COMPUTATION OF RATIO OF COST TO CHARGES,COMPUTATION OF RATIO OF COST TO CHARGES,COMPUTATION OF INPATIENT OPERATING COSTS,INPATIENT ANCILLARY SERVICE COST APPORTIONMENT,INPATIENT ANCILLARY SERVICE COST APPORTIONMENT,INPATIENT ANCILLARY SERVICE COST APPORTIONMENT,INPATIENT ANCILLARY SERVICE COST APPORTIONMENT,INPATIENT ANCILLARY SERVICE COST APPORTIONMENT,INPATIENT ANCILLARY SERVICE COST APPORTIONMENT,INPATIENT ANCILLARY SERVICE COST APPORTIONMENT,INPATIENT ANCILLARY SERVICE COST APPORTIONMENT,INPATIENT ANCILLARY SERVICE COST APPORTIONMENT,INPATIENT ANCILLARY SERVICE COST APPORTIONMENT,APPORTIONMENT OF INPATIENT ANCILLARY SERVICE CAPITAL COSTS,APPORTIONMENT OF INPATIENT ANCILLARY SERVICE CAPITAL COSTS,APPORTIONMENT OF INPATIENT ANCILLARY SERVICE CAPITAL COSTS,APPORTIONMENT OF INPATIENT ANCILLARY SERVICE CAPITAL COSTS,APPORTIONMENT OF INPATIENT ANCILLARY SERVICE CAPITAL COSTS,APPORTIONMENT OF INPATIENT ROUTINE SERVICE OTHER PASS THROUGH COSTS,APPORTIONMENT OF INPATIENT ROUTINE SERVICE OTHER PASS THROUGH COSTS,APPORTIONMENT OF INPATIENT/OUTPATIENT ANCILLARY SERVICE OTHER PASS THROUGH COSTS,APPORTIONMENT OF INPATIENT/OUTPATIENT ANCILLARY SERVICE OTHER PASS THROUGH COSTS,APPORTIONMENT OF INPATIENT/OUTPATIENT ANCILLARY SERVICE OTHER PASS THROUGH COSTS,APPORTIONMENT OF INPATIENT/OUTPATIENT ANCILLARY SERVICE OTHER PASS THROUGH COSTS,APPORTIONMENT OF INPATIENT/OUTPATIENT ANCILLARY SERVICE OTHER PASS THROUGH COSTS,APPORTIONMENT OF INPATIENT/OUTPATIENT ANCILLARY SERVICE OTHER PASS THROUGH COSTS,APPORTIONMENT OF INPATIENT/OUTPATIENT ANCILLARY SERVICE OTHER PASS THROUGH COSTS,APPORTIONMENT OF INPATIENT/OUTPATIENT ANCILLARY SERVICE OTHER PASS THROUGH COSTS,APPORTIONMENT OF MEDICAL AND OTHER HEALTH SERVICES,APPORTIONMENT OF MEDICAL AND OTHER HEALTH SERVICES,TRIAL BALANCE OF EXPENSE ACCOUNTS,COMPUTATION OF RATIO OF COST TO CHARGES,APPORTIONMENT OF INPATIENT/OUTPATIENT ANCILLARY SERVICE OTHER PASS THROUGH COSTS,APPORTIONMENT OF MEDICAL AND OTHER HEALTH SERVICES,APPORTIONMENT OF MEDICAL AND OTHER HEALTH SERVICES,APPORTIONMENT OF MEDICAL AND OTHER HEALTH SERVICES,APPORTIONMENT OF MEDICAL AND OTHER HEALTH SERVICES,Total Inpatient Days/Outpatient Visits,Total Inpatient Days/Outpatient Visits,Total Inpatient Days/Outpatient Visits,COST ALLOCATION,APPORTIONMENT OF INPATIENT/OUTPATIENT ANCILLARY SERVICE OTHER PASS THROUGH COSTS,APPORTIONMENT OF INPATIENT/OUTPATIENT ANCILLARY SERVICE OTHER PASS THROUGH COSTS,APPORTIONMENT OF INPATIENT/OUTPATIENT ANCILLARY SERVICE OTHER PASS THROUGH COSTS,APPORTIONMENT OF INPATIENT/OUTPATIENT ANCILLARY SERVICE OTHER PASS THROUGH COSTS,APPORTIONMENT OF INPATIENT/OUTPATIENT ANCILLARY SERVICE OTHER PASS THROUGH COSTS,APPORTIONMENT OF INPATIENT/OUTPATIENT ANCILLARY SERVICE OTHER PASS THROUGH COSTS,APPORTIONMENT OF INPATIENT/OUTPATIENT ANCILLARY SERVICE OTHER PASS THROUGH COSTS,APPORTIONMENT OF INPATIENT/OUTPATIENT ANCILLARY SERVICE OTHER PASS THROUGH COSTS,APPORTIONMENT OF INPATIENT/OUTPATIENT ANCILLARY SERVICE OTHER PASS THROUGH COSTS,APPORTIONMENT OF INPATIENT/OUTPATIENT ANCILLARY SERVICE OTHER PASS THROUGH COSTS,APPORTIONMENT OF MEDICAL AND OTHER HEALTH SERVICES,APPORTIONMENT OF MEDICAL AND OTHER HEALTH SERVICES,APPORTIONMENT OF MEDICAL AND OTHER HEALTH SERVICES,APPORTIONMENT OF MEDICAL AND OTHER HEALTH SERVICES,BED DAYS AVAILABLE,TRIAL BALANCE OF EXPENSE ACCOUNTS,COST ALLOCATION,COST ALLOCATION,ALLOCATION OF NEW CAPITAL COSTS,COMPUTATION OF RATIO OF COST TO CHARGES,COMPUTATION OF RATIO OF COST TO CHARGES,INPATIENT ANCILLARY SERVICE COST APPORTIONMENT,INPATIENT ANCILLARY SERVICE COST APPORTIONMENT,APPORTIONMENT OF INPATIENT/OUTPATIENT ANCILLARY SERVICE OTHER PASS THROUGH COSTS,APPORTIONMENT OF INPATIENT/OUTPATIENT ANCILLARY SERVICE OTHER PASS THROUGH COSTS,APPORTIONMENT OF INPATIENT/OUTPATIENT ANCILLARY SERVICE OTHER PASS THROUGH COSTS,APPORTIONMENT OF INPATIENT/OUTPATIENT ANCILLARY SERVICE OTHER PASS THROUGH COSTS,APPORTIONMENT OF INPATIENT/OUTPATIENT ANCILLARY SERVICE OTHER PASS THROUGH COSTS,INPATIENT ANCILLARY SERVICE COST APPORTIONMENT,INPATIENT ANCILLARY SERVICE COST APPORTIONMENT,APPORTIONMENT OF INPATIENT ANCILLARY SERVICE CAPITAL COSTS,COMPUTATION OF RATIO OF COST TO CHARGES,INPATIENT ANCILLARY SERVICE COST APPORTIONMENT,INPATIENT ANCILLARY SERVICE COST APPORTIONMENT,APPORTIONMENT OF INPATIENT ANCILLARY SERVICE CAPITAL COSTS,APPORTIONMENT OF INPATIENT/OUTPATIENT ANCILLARY SERVICE OTHER PASS THROUGH COSTS,COST ALLOCATION,COMPUTATION OF RATIO OF COST TO CHARGES,TRIAL BALANCE OF EXPENSE ACCOUNTS,TRIAL BALANCE OF EXPENSE ACCOUNTS,TRIAL BALANCE OF EXPENSE ACCOUNTS,STATEMENT OF PATIENT REVENUES AND OPERATING EXPENSES,INPATIENT ANCILLARY SERVICE COST APPORTIONMENT,INPATIENT ANCILLARY SERVICE COST APPORTIONMENT,INPATIENT ANCILLARY SERVICE COST APPORTIONMENT,INPATIENT ANCILLARY SERVICE COST APPORTIONMENT,INPATIENT ANCILLARY SERVICE COST APPORTIONMENT,INPATIENT ANCILLARY SERVICE COST APPORTIONMENT,BALANCE SHEET,APPORTIONMENT OF INPATIENT/OUTPATIENT ANCILLARY SERVICE OTHER PASS THROUGH COSTS,STATEMENT OF PATIENT REVENUES AND OPERATING EXPENSES,STATEMENT OF PATIENT REVENUES AND OPERATING EXPENSES,TRIAL BALANCE OF EXPENSE ACCOUNTS,INPATIENT ANCILLARY SERVICE COST APPORTIONMENT,INPATIENT ANCILLARY SERVICE COST APPORTIONMENT,TRIAL BALANCE OF EXPENSE ACCOUNTS,BALANCE SHEET,CALCULATION OF REIMBURSEMENT SETTLEMENT,COMPUTATION OF RATIO OF COST TO CHARGES,COMPUTATION OF RATIO OF COST TO CHARGES,LTCH PPS,COMPUTATION OF RATIO OF COST TO CHARGES,INPATIENT ANCILLARY SERVICE COST APPORTIONMENT,INPATIENT ANCILLARY SERVICE COST APPORTIONMENT,INPATIENT ANCILLARY SERVICE COST APPORTIONMENT,INPATIENT ANCILLARY SERVICE COST APPORTIONMENT,APPORTIONMENT OF INPATIENT ANCILLARY SERVICE CAPITAL COSTS,CALCULATION OF REIMBURSEMENT SETTLEMENT (PPS),APPORTIONMENT OF MEDICAL AND OTHER HEALTH SERVICES,APPORTIONMENT OF MEDICAL AND OTHER HEALTH SERVICES,INPATIENT ANCILLARY SERVICE COST APPORTIONMENT,INPATIENT ANCILLARY SERVICE COST APPORTIONMENT,INPATIENT ANCILLARY SERVICE COST APPORTIONMENT,INPATIENT ANCILLARY SERVICE COST APPORTIONMENT,INPATIENT ANCILLARY SERVICE COST APPORTIONMENT,INPATIENT ANCILLARY SERVICE COST APPORTIONMENT,INPATIENT ANCILLARY SERVICE COST APPORTIONMENT,APPORTIONMENT OF MEDICAL AND OTHER HEALTH SERVICES,APPORTIONMENT OF MEDICAL AND OTHER HEALTH SERVICES,TRIAL BALANCE OF EXPENSE ACCOUNTS,COST ALLOCATION,COST ALLOCATION,COST ALLOCATION,COST ALLOCATION,COST ALLOCATION,COMPUTATION OF INPATIENT OPERATING COSTS,COMPUTATION OF INPATIENT OPERATING COSTS,INPATIENT ANCILLARY SERVICE COST APPORTIONMENT,INPATIENT ANCILLARY SERVICE COST APPORTIONMENT,APPORTIONMENT OF INPATIENT ANCILLARY SERVICE CAPITAL COSTS,APPORTIONMENT OF INPATIENT ROUTINE SERVICE OTHER PASS THROUGH COSTS,APPORTIONMENT OF INPATIENT/OUTPATIENT ANCILLARY SERVICE OTHER PASS THROUGH COSTS,APPORTIONMENT OF INPATIENT/OUTPATIENT ANCILLARY SERVICE OTHER PASS THROUGH COSTS,APPORTIONMENT OF INPATIENT/OUTPATIENT ANCILLARY SERVICE OTHER PASS THROUGH COSTS,APPORTIONMENT OF INPATIENT/OUTPATIENT ANCILLARY SERVICE OTHER PASS THROUGH COSTS,APPORTIONMENT OF INPATIENT/OUTPATIENT ANCILLARY SERVICE OTHER PASS THROUGH COSTS,APPORTIONMENT OF INPATIENT/OUTPATIENT ANCILLARY SERVICE OTHER PASS THROUGH COSTS,APPORTIONMENT OF INPATIENT/OUTPATIENT ANCILLARY SERVICE OTHER PASS THROUGH COSTS,APPORTIONMENT OF INPATIENT/OUTPATIENT ANCILLARY SERVICE OTHER PASS THROUGH COSTS,APPORTIONMENT OF INPATIENT/OUTPATIENT ANCILLARY SERVICE OTHER PASS THROUGH COSTS,APPORTIONMENT OF INPATIENT/OUTPATIENT ANCILLARY SERVICE OTHER PASS THROUGH COSTS,APPORTIONMENT OF INPATIENT/OUTPATIENT ANCILLARY SERVICE OTHER PASS THROUGH COSTS,APPORTIONMENT OF INPATIENT/OUTPATIENT ANCILLARY SERVICE OTHER PASS THROUGH COSTS,APPORTIONMENT OF INPATIENT/OUTPATIENT ANCILLARY SERVICE OTHER PASS THROUGH COSTS,APPORTIONMENT OF INPATIENT/OUTPATIENT ANCILLARY SERVICE OTHER PASS THROUGH COSTS,APPORTIONMENT OF INPATIENT/OUTPATIENT ANCILLARY SERVICE OTHER PASS THROUGH COSTS,APPORTIONMENT OF INPATIENT/OUTPATIENT ANCILLARY SERVICE OTHER PASS THROUGH COSTS,APPORTIONMENT OF INPATIENT/OUTPATIENT ANCILLARY SERVICE OTHER PASS THROUGH COSTS,APPORTIONMENT OF INPATIENT/OUTPATIENT ANCILLARY SERVICE OTHER PASS THROUGH COSTS,APPORTIONMENT OF INPATIENT/OUTPATIENT ANCILLARY SERVICE OTHER PASS THROUGH COSTS,APPORTIONMENT OF INPATIENT/OUTPATIENT ANCILLARY SERVICE OTHER PASS THROUGH COSTS,APPORTIONMENT OF INPATIENT/OUTPATIENT ANCILLARY SERVICE OTHER PASS THROUGH COSTS,APPORTIONMENT OF INPATIENT/OUTPATIENT ANCILLARY SERVICE OTHER PASS THROUGH COSTS,APPORTIONMENT OF INPATIENT/OUTPATIENT ANCILLARY SERVICE OTHER PASS THROUGH COSTS,APPORTIONMENT OF INPATIENT/OUTPATIENT ANCILLARY SERVICE OTHER PASS THROUGH COSTS,APPORTIONMENT OF INPATIENT/OUTPATIENT ANCILLARY SERVICE OTHER PASS THROUGH COSTS,APPORTIONMENT OF INPATIENT/OUTPATIENT ANCILLARY SERVICE OTHER PASS THROUGH COSTS,APPORTIONMENT OF INPATIENT/OUTPATIENT ANCILLARY SERVICE OTHER PASS THROUGH COSTS,APPORTIONMENT OF INPATIENT/OUTPATIENT ANCILLARY SERVICE OTHER PASS THROUGH COSTS,APPORTIONMENT OF INPATIENT/OUTPATIENT ANCILLARY SERVICE OTHER PASS THROUGH COSTS,APPORTIONMENT OF INPATIENT/OUTPATIENT ANCILLARY SERVICE OTHER PASS THROUGH COSTS,APPORTIONMENT OF INPATIENT/OUTPATIENT ANCILLARY SERVICE OTHER PASS THROUGH COSTS,APPORTIONMENT OF INPATIENT/OUTPATIENT ANCILLARY SERVICE OTHER PASS THROUGH COSTS,APPORTIONMENT OF INPATIENT/OUTPATIENT ANCILLARY SERVICE OTHER PASS THROUGH COSTS,APPORTIONMENT OF INPATIENT/OUTPATIENT ANCILLARY SERVICE OTHER PASS THROUGH COSTS,Medicaid Inpatient Days/Outpatient Visits,TRIAL BALANCE OF EXPENSE ACCOUNTS,INPATIENT ANCILLARY SERVICE COST APPORTIONMENT,INPATIENT ANCILLARY SERVICE COST APPORTIONMENT,INPATIENT ANCILLARY SERVICE COST APPORTIONMENT,INPATIENT ANCILLARY SERVICE COST APPORTIONMENT,INPATIENT ANCILLARY SERVICE COST APPORTIONMENT,COST ALLOCATION,COST ALLOCATION,COST ALLOCATION,COST ALLOCATION,COST ALLOCATION,COST ALLOCATION,COST ALLOCATION,TRIAL BALANCE OF EXPENSE ACCOUNTS,INPATIENT ANCILLARY SERVICE COST APPORTIONMENT,APPORTIONMENT OF INPATIENT ROUTINE SERVICE CAPITAL COSTS,APPORTIONMENT OF INPATIENT ROUTINE SERVICE CAPITAL COSTS,APPORTIONMENT OF INPATIENT ROUTINE SERVICE OTHER PASS THROUGH COSTS,APPORTIONMENT OF INPATIENT/OUTPATIENT ANCILLARY SERVICE OTHER PASS THROUGH COSTS,APPORTIONMENT OF INPATIENT/OUTPATIENT ANCILLARY SERVICE OTHER PASS THROUGH COSTS,APPORTIONMENT OF INPATIENT/OUTPATIENT ANCILLARY SERVICE OTHER PASS THROUGH COSTS,Medicare Inpatient Days/Outpatient Visits,INPATIENT ANCILLARY SERVICE COST APPORTIONMENT,INPATIENT ANCILLARY SERVICE COST APPORTIONMENT,APPORTIONMENT OF INPATIENT ANCILLARY SERVICE CAPITAL COSTS,TRIAL BALANCE OF EXPENSE ACCOUNTS,COST ALLOCATION,COST ALLOCATION,INPATIENT ANCILLARY SERVICE COST APPORTIONMENT,INPATIENT ANCILLARY SERVICE COST APPORTIONMENT,APPORTIONMENT OF INPATIENT ANCILLARY SERVICE CAPITAL COSTS,APPORTIONMENT OF INPATIENT/OUTPATIENT ANCILLARY SERVICE OTHER PASS THROUGH COSTS,APPORTIONMENT OF INPATIENT/OUTPATIENT ANCILLARY SERVICE OTHER PASS THROUGH COSTS,APPORTIONMENT OF MEDICAL AND OTHER HEALTH SERVICES,APPORTIONMENT OF MEDICAL AND OTHER HEALTH SERVICES,COST ALLOCATION,COST ALLOCATION,INPATIENT ANCILLARY SERVICE COST APPORTIONMENT,INPATIENT ANCILLARY SERVICE COST APPORTIONMENT,INPATIENT ANCILLARY SERVICE COST APPORTIONMENT,INPATIENT ANCILLARY SERVICE COST APPORTIONMENT,APPORTIONMENT OF INPATIENT ANCILLARY SERVICE CAPITAL COSTS,APPORTIONMENT OF INPATIENT/OUTPATIENT ANCILLARY SERVICE OTHER PASS THROUGH COSTS,APPORTIONMENT OF MEDICAL AND OTHER HEALTH SERVICES,APPORTIONMENT OF MEDICAL AND OTHER HEALTH SERVICES,BED DAYS AVAILABLE,APPORTIONMENT OF INPATIENT/OUTPATIENT ANCILLARY SERVICE OTHER PASS THROUGH COSTS,APPORTIONMENT OF INPATIENT/OUTPATIENT ANCILLARY SERVICE OTHER PASS THROUGH COSTS,TRIAL BALANCE OF EXPENSE ACCOUNTS,APPORTIONMENT OF MEDICAL AND OTHER HEALTH SERVICES,APPORTIONMENT OF MEDICAL AND OTHER HEALTH SERVICES,TRIAL BALANCE OF EXPENSE ACCOUNTS,INPATIENT ANCILLARY SERVICE COST APPORTIONMENT,INPATIENT ANCILLARY SERVICE COST APPORTIONMENT,APPORTIONMENT OF INPATIENT ANCILLARY SERVICE CAPITAL COSTS,APPORTIONMENT OF INPATIENT/OUTPATIENT ANCILLARY SERVICE OTHER PASS THROUGH COSTS,TRIAL BALANCE OF EXPENSE ACCOUNTS,TRIAL BALANCE OF EXPENSE ACCOUNTS,TRIAL BALANCE OF EXPENSE ACCOUNTS,INPATIENT ANCILLARY SERVICE COST APPORTIONMENT,INPATIENT ANCILLARY SERVICE COST APPORTIONMENT,INPATIENT ANCILLARY SERVICE COST APPORTIONMENT,INPATIENT ANCILLARY SERVICE COST APPORTIONMENT,APPORTIONMENT OF INPATIENT/OUTPATIENT ANCILLARY SERVICE OTHER PASS THROUGH COSTS,APPORTIONMENT OF INPATIENT/OUTPATIENT ANCILLARY SERVICE OTHER PASS THROUGH COSTS,APPORTIONMENT OF INPATIENT/OUTPATIENT ANCILLARY SERVICE OTHER PASS THROUGH COSTS,APPORTIONMENT OF INPATIENT/OUTPATIENT ANCILLARY SERVICE OTHER PASS THROUGH COSTS,APPORTIONMENT OF INPATIENT/OUTPATIENT ANCILLARY SERVICE OTHER PASS THROUGH COSTS,APPORTIONMENT OF INPATIENT/OUTPATIENT ANCILLARY SERVICE OTHER PASS THROUGH COSTS,APPORTIONMENT OF INPATIENT/OUTPATIENT ANCILLARY SERVICE OTHER PASS THROUGH COSTS,APPORTIONMENT OF INPATIENT/OUTPATIENT ANCILLARY SERVICE OTHER PASS THROUGH COSTS,APPORTIONMENT OF INPATIENT/OUTPATIENT ANCILLARY SERVICE OTHER PASS THROUGH COSTS,APPORTIONMENT OF INPATIENT/OUTPATIENT ANCILLARY SERVICE OTHER PASS THROUGH COSTS,APPORTIONMENT OF INPATIENT/OUTPATIENT ANCILLARY SERVICE OTHER PASS THROUGH COSTS,APPORTIONMENT OF INPATIENT/OUTPATIENT ANCILLARY SERVICE OTHER PASS THROUGH COSTS,COST ALLOCATION,ALLOCATION OF NEW CAPITAL COSTS,COMPUTATION OF RATIO OF COST TO CHARGES,COMPUTATION OF RATIO OF COST TO CHARGES,COMPUTATION OF RATIO OF COST TO CHARGES,COMPUTATION OF RATIO OF COST TO CHARGES,CALCULATION OF REIMBURSEMENT SETTLEMENT (TEFRA),APPORTIONMENT OF INPATIENT/OUTPATIENT ANCILLARY SERVICE OTHER PASS THROUGH COSTS,APPORTIONMENT OF INPATIENT/OUTPATIENT ANCILLARY SERVICE OTHER PASS THROUGH COSTS,INPATIENT ANCILLARY SERVICE COST APPORTIONMENT,INPATIENT ANCILLARY SERVICE COST APPORTIONMENT,COST ALLOCATION,COST ALLOCATION,APPORTIONMENT OF INPATIENT/OUTPATIENT ANCILLARY SERVICE OTHER PASS THROUGH COSTS,APPORTIONMENT OF INPATIENT/OUTPATIENT ANCILLARY SERVICE OTHER PASS THROUGH COSTS,APPORTIONMENT OF INPATIENT/OUTPATIENT ANCILLARY SERVICE OTHER PASS THROUGH COSTS,TRIAL BALANCE OF EXPENSE ACCOUNTS,COST ALLOCATION,COMPUTATION OF RATIO OF COST TO CHARGES,APPORTIONMENT OF INPATIENT/OUTPATIENT ANCILLARY SERVICE OTHER PASS THROUGH COSTS,APPORTIONMENT OF INPATIENT/OUTPATIENT ANCILLARY SERVICE OTHER PASS THROUGH COSTS,APPORTIONMENT OF INPATIENT/OUTPATIENT ANCILLARY SERVICE OTHER PASS THROUGH COSTS,APPORTIONMENT OF INPATIENT/OUTPATIENT ANCILLARY SERVICE OTHER PASS THROUGH COSTS,APPORTIONMENT OF INPATIENT/OUTPATIENT ANCILLARY SERVICE OTHER PASS THROUGH COSTS,TRIAL BALANCE OF EXPENSE ACCOUNTS,BED DAYS AVAILABLE,APPORTIONMENT OF INPATIENT/OUTPATIENT ANCILLARY SERVICE OTHER PASS THROUGH COSTS,APPORTIONMENT OF INPATIENT/OUTPATIENT ANCILLARY SERVICE OTHER PASS THROUGH COSTS,TRIAL BALANCE OF EXPENSE ACCOUNTS,INPATIENT ANCILLARY SERVICE COST APPORTIONMENT,INPATIENT ANCILLARY SERVICE COST APPORTIONMENT,APPORTIONMENT OF MEDICAL AND OTHER HEALTH SERVICES,APPORTIONMENT OF MEDICAL AND OTHER HEALTH SERVICES,APPORTIONMENT OF MEDICAL AND OTHER HEALTH SERVICES,APPORTIONMENT OF MEDICAL AND OTHER HEALTH SERVICES,APPORTIONMENT OF MEDICAL AND OTHER HEALTH SERVICES,APPORTIONMENT OF MEDICAL AND OTHER HEALTH SERVICES,APPORTIONMENT OF MEDICAL AND OTHER HEALTH SERVICES,APPORTIONMENT OF MEDICAL AND OTHER HEALTH SERVICES,APPORTIONMENT OF MEDICAL AND OTHER HEALTH SERVICES,APPORTIONMENT OF MEDICAL AND OTHER HEALTH SERVICES,APPORTIONMENT OF MEDICAL AND OTHER HEALTH SERVICES,APPORTIONMENT OF MEDICAL AND OTHER HEALTH SERVICES,APPORTIONMENT OF INPATIENT/OUTPATIENT ANCILLARY SERVICE OTHER PASS THROUGH COSTS,INPATIENT ANCILLARY SERVICE COST APPORTIONMENT,APPORTIONMENT OF INPATIENT/OUTPATIENT ANCILLARY SERVICE OTHER PASS THROUGH COSTS,APPORTIONMENT OF INPATIENT/OUTPATIENT ANCILLARY SERVICE OTHER PASS THROUGH COSTS,APPORTIONMENT OF INPATIENT/OUTPATIENT ANCILLARY SERVICE OTHER PASS THROUGH COSTS,APPORTIONMENT OF INPATIENT/OUTPATIENT ANCILLARY SERVICE OTHER PASS THROUGH COSTS,APPORTIONMENT OF INPATIENT/OUTPATIENT ANCILLARY SERVICE OTHER PASS THROUGH COSTS,INPATIENT ANCILLARY SERVICE COST APPORTIONMENT,INPATIENT ANCILLARY SERVICE COST APPORTIONMENT,APPORTIONMENT OF INPATIENT ANCILLARY SERVICE CAPITAL COSTS,APPORTIONMENT OF INPATIENT/OUTPATIENT ANCILLARY SERVICE OTHER PASS THROUGH COSTS,COMPUTATION OF RATIO OF COST TO CHARGES,INPATIENT ANCILLARY SERVICE COST APPORTIONMENT,APPORTIONMENT OF INPATIENT/OUTPATIENT ANCILLARY SERVICE OTHER PASS THROUGH COSTS,TRIAL BALANCE OF EXPENSE ACCOUNTS,TRIAL BALANCE OF EXPENSE ACCOUNTS,TRIAL BALANCE OF EXPENSE ACCOUNTS,COST ALLOCATION,COST ALLOCATION,ALLOCATION OF NEW CAPITAL COSTS,COMPUTATION OF RATIO OF COST TO CHARGES,COMPUTATION OF RATIO OF COST TO CHARGES,APPORTIONMENT OF MEDICAL AND OTHER HEALTH SERVICES,APPORTIONMENT OF MEDICAL AND OTHER HEALTH SERVICES,Total Inpatient Days/Outpatient Visits,APPORTIONMENT OF INPATIENT/OUTPATIENT ANCILLARY SERVICE OTHER PASS THROUGH COSTS,APPORTIONMENT OF INPATIENT/OUTPATIENT ANCILLARY SERVICE OTHER PASS THROUGH COSTS,APPORTIONMENT OF INPATIENT/OUTPATIENT ANCILLARY SERVICE OTHER PASS THROUGH COSTS,INPATIENT ANCILLARY SERVICE COST APPORTIONMENT,INPATIENT ANCILLARY SERVICE COST APPORTIONMENT,APPORTIONMENT OF INPATIENT ANCILLARY SERVICE CAPITAL COSTS,APPORTIONMENT OF INPATIENT/OUTPATIENT ANCILLARY SERVICE OTHER PASS THROUGH COSTS,APPORTIONMENT OF INPATIENT/OUTPATIENT ANCILLARY SERVICE OTHER PASS THROUGH COSTS,BALANCE SHEET,COST ALLOCATION,COST ALLOCATION,Total Inpatient Days/Outpatient Visits,COMPUTATION OF RATIO OF COST TO CHARGES,CALCULATION OF REIMBURSEMENT SETTLEMENT (PPS),APPORTIONMENT OF INPATIENT/OUTPATIENT ANCILLARY SERVICE OTHER PASS THROUGH COSTS,APPORTIONMENT OF INPATIENT/OUTPATIENT ANCILLARY SERVICE OTHER PASS THROUGH COSTS,APPORTIONMENT OF INPATIENT/OUTPATIENT ANCILLARY SERVICE OTHER PASS THROUGH COSTS,APPORTIONMENT OF INPATIENT/OUTPATIENT ANCILLARY SERVICE OTHER PASS THROUGH COSTS,APPORTIONMENT OF INPATIENT/OUTPATIENT ANCILLARY SERVICE OTHER PASS THROUGH COSTS,APPORTIONMENT OF INPATIENT/OUTPATIENT ANCILLARY SERVICE OTHER PASS THROUGH COSTS,APPORTIONMENT OF INPATIENT/OUTPATIENT ANCILLARY SERVICE OTHER PASS THROUGH COSTS,APPORTIONMENT OF INPATIENT/OUTPATIENT ANCILLARY SERVICE OTHER PASS THROUGH COSTS,APPORTIONMENT OF INPATIENT/OUTPATIENT ANCILLARY SERVICE OTHER PASS THROUGH COSTS,APPORTIONMENT OF INPATIENT/OUTPATIENT ANCILLARY SERVICE OTHER PASS THROUGH COSTS,APPORTIONMENT OF INPATIENT/OUTPATIENT ANCILLARY SERVICE OTHER PASS THROUGH COSTS,APPORTIONMENT OF INPATIENT/OUTPATIENT ANCILLARY SERVICE OTHER PASS THROUGH COSTS,APPORTIONMENT OF INPATIENT/OUTPATIENT ANCILLARY SERVICE OTHER PASS THROUGH COSTS,APPORTIONMENT OF INPATIENT/OUTPATIENT ANCILLARY SERVICE OTHER PASS THROUGH COSTS,APPORTIONMENT OF INPATIENT/OUTPATIENT ANCILLARY SERVICE OTHER PASS THROUGH COSTS,APPORTIONMENT OF INPATIENT/OUTPATIENT ANCILLARY SERVICE OTHER PASS THROUGH COSTS,APPORTIONMENT OF INPATIENT/OUTPATIENT ANCILLARY SERVICE OTHER PASS THROUGH COSTS,APPORTIONMENT OF INPATIENT/OUTPATIENT ANCILLARY SERVICE OTHER PASS THROUGH COSTS,APPORTIONMENT OF INPATIENT/OUTPATIENT ANCILLARY SERVICE OTHER PASS THROUGH COSTS,APPORTIONMENT OF INPATIENT/OUTPATIENT ANCILLARY SERVICE OTHER PASS THROUGH COSTS,APPORTIONMENT OF INPATIENT/OUTPATIENT ANCILLARY SERVICE OTHER PASS THROUGH COSTS,APPORTIONMENT OF INPATIENT/OUTPATIENT ANCILLARY SERVICE OTHER PASS THROUGH COSTS,APPORTIONMENT OF INPATIENT/OUTPATIENT ANCILLARY SERVICE OTHER PASS THROUGH COSTS,APPORTIONMENT OF INPATIENT/OUTPATIENT ANCILLARY SERVICE OTHER PASS THROUGH COSTS,INPATIENT ANCILLARY SERVICE COST APPORTIONMENT,INPATIENT ANCILLARY SERVICE COST APPORTIONMENT,INPATIENT ANCILLARY SERVICE COST APPORTIONMENT,INPATIENT ANCILLARY SERVICE COST APPORTIONMENT,APPORTIONMENT OF INPATIENT ANCILLARY SERVICE CAPITAL COSTS,APPORTIONMENT OF INPATIENT/OUTPATIENT ANCILLARY SERVICE OTHER PASS THROUGH COSTS,APPORTIONMENT OF INPATIENT/OUTPATIENT ANCILLARY SERVICE OTHER PASS THROUGH COSTS,APPORTIONMENT OF INPATIENT/OUTPATIENT ANCILLARY SERVICE OTHER PASS THROUGH COSTS,APPORTIONMENT OF INPATIENT/OUTPATIENT ANCILLARY SERVICE OTHER PASS THROUGH COSTS,APPORTIONMENT OF INPATIENT/OUTPATIENT ANCILLARY SERVICE OTHER PASS THROUGH COSTS,INPATIENT ANCILLARY SERVICE COST APPORTIONMENT,INPATIENT ANCILLARY SERVICE COST APPORTIONMENT,INPATIENT ANCILLARY SERVICE COST APPORTIONMENT,INPATIENT ANCILLARY SERVICE COST APPORTIONMENT,APPORTIONMENT OF INPATIENT ANCILLARY SERVICE CAPITAL COSTS,APPORTIONMENT OF INPATIENT ANCILLARY SERVICE CAPITAL COSTS,APPORTIONMENT OF INPATIENT/OUTPATIENT ANCILLARY SERVICE OTHER PASS THROUGH COSTS,APPORTIONMENT OF INPATIENT/OUTPATIENT ANCILLARY SERVICE OTHER PASS THROUGH COSTS,APPORTIONMENT OF INPATIENT/OUTPATIENT ANCILLARY SERVICE OTHER PASS THROUGH COSTS,COST ALLOCATION,COST ALLOCATION,BED DAYS AVAILABLE,INPATIENT ANCILLARY SERVICE COST APPORTIONMENT,INPATIENT ANCILLARY SERVICE COST APPORTIONMENT,INPATIENT ANCILLARY SERVICE COST APPORTIONMENT,INPATIENT ANCILLARY SERVICE COST APPORTIONMENT,INPATIENT ANCILLARY SERVICE COST APPORTIONMENT,INPATIENT ANCILLARY SERVICE COST APPORTIONMENT,APPORTIONMENT OF INPATIENT ANCILLARY SERVICE CAPITAL COSTS,APPORTIONMENT OF INPATIENT ANCILLARY SERVICE CAPITAL COSTS,APPORTIONMENT OF INPATIENT ANCILLARY SERVICE CAPITAL COSTS,APPORTIONMENT OF INPATIENT/OUTPATIENT ANCILLARY SERVICE OTHER PASS THROUGH COSTS,APPORTIONMENT OF MEDICAL AND OTHER HEALTH SERVICES,APPORTIONMENT OF MEDICAL AND OTHER HEALTH SERVICES,BALANCE SHEET,COST ALLOCATION,APPORTIONMENT OF INPATIENT/OUTPATIENT ANCILLARY SERVICE OTHER PASS THROUGH COSTS,APPORTIONMENT OF INPATIENT/OUTPATIENT ANCILLARY SERVICE OTHER PASS THROUGH COSTS,APPORTIONMENT OF INPATIENT/OUTPATIENT ANCILLARY SERVICE OTHER PASS THROUGH COSTS,APPORTIONMENT OF INPATIENT/OUTPATIENT ANCILLARY SERVICE OTHER PASS THROUGH COSTS,APPORTIONMENT OF INPATIENT/OUTPATIENT ANCILLARY SERVICE OTHER PASS THROUGH COSTS,APPORTIONMENT OF INPATIENT/OUTPATIENT ANCILLARY SERVICE OTHER PASS THROUGH COSTS,APPORTIONMENT OF INPATIENT/OUTPATIENT ANCILLARY SERVICE OTHER PASS THROUGH COSTS,APPORTIONMENT OF INPATIENT/OUTPATIENT ANCILLARY SERVICE OTHER PASS THROUGH COSTS,APPORTIONMENT OF INPATIENT/OUTPATIENT ANCILLARY SERVICE OTHER PASS THROUGH COSTS,APPORTIONMENT OF INPATIENT/OUTPATIENT ANCILLARY SERVICE OTHER PASS THROUGH COSTS,APPORTIONMENT OF INPATIENT/OUTPATIENT ANCILLARY SERVICE OTHER PASS THROUGH COSTS,APPORTIONMENT OF INPATIENT/OUTPATIENT ANCILLARY SERVICE OTHER PASS THROUGH COSTS,APPORTIONMENT OF MEDICAL AND OTHER HEALTH SERVICES,APPORTIONMENT OF MEDICAL AND OTHER HEALTH SERVICES,APPORTIONMENT OF INPATIENT/OUTPATIENT ANCILLARY SERVICE OTHER PASS THROUGH COSTS,TRIAL BALANCE OF EXPENSE ACCOUNTS,COST ALLOCATION,COST ALLOCATION,APPORTIONMENT OF INPATIENT/OUTPATIENT ANCILLARY SERVICE OTHER PASS THROUGH COSTS,APPORTIONMENT OF INPATIENT/OUTPATIENT ANCILLARY SERVICE OTHER PASS THROUGH COSTS,BED DAYS AVAILABLE,BED DAYS AVAILABLE,INPATIENT ANCILLARY SERVICE COST APPORTIONMENT,CALCULATION OF REIMBURSEMENT SETTLEMENT (PPS),INPATIENT ANCILLARY SERVICE COST APPORTIONMENT,APPORTIONMENT OF INPATIENT/OUTPATIENT ANCILLARY SERVICE OTHER PASS THROUGH COSTS,TRIAL BALANCE OF EXPENSE ACCOUNTS,TRIAL BALANCE OF EXPENSE ACCOUNTS,TRIAL BALANCE OF EXPENSE ACCOUNTS,TRIAL BALANCE OF EXPENSE ACCOUNTS,COST ALLOCATION,COST ALLOCATION,ALLOCATION OF NEW CAPITAL COSTS,COMPUTATION OF RATIO OF COST TO CHARGES,COMPUTATION OF RATIO OF COST TO CHARGES,COMPUTATION OF RATIO OF COST TO CHARGES,APPORTIONMENT OF INPATIENT/OUTPATIENT ANCILLARY SERVICE OTHER PASS THROUGH COSTS,APPORTIONMENT OF INPATIENT/OUTPATIENT ANCILLARY SERVICE OTHER PASS THROUGH COSTS,INPATIENT ANCILLARY SERVICE COST APPORTIONMENT,INPATIENT ANCILLARY SERVICE COST APPORTIONMENT,APPORTIONMENT OF INPATIENT ANCILLARY SERVICE CAPITAL COSTS,APPORTIONMENT OF INPATIENT/OUTPATIENT ANCILLARY SERVICE OTHER PASS THROUGH COSTS,COST ALLOCATION,APPORTIONMENT OF INPATIENT/OUTPATIENT ANCILLARY SERVICE OTHER PASS THROUGH COSTS,APPORTIONMENT OF INPATIENT/OUTPATIENT ANCILLARY SERVICE OTHER PASS THROUGH COSTS,APPORTIONMENT OF INPATIENT/OUTPATIENT ANCILLARY SERVICE OTHER PASS THROUGH COSTS,APPORTIONMENT OF INPATIENT/OUTPATIENT ANCILLARY SERVICE OTHER PASS THROUGH COSTS,APPORTIONMENT OF INPATIENT/OUTPATIENT ANCILLARY SERVICE OTHER PASS THROUGH COSTS,APPORTIONMENT OF INPATIENT/OUTPATIENT ANCILLARY SERVICE OTHER PASS THROUGH COSTS,APPORTIONMENT OF INPATIENT/OUTPATIENT ANCILLARY SERVICE OTHER PASS THROUGH COSTS,APPORTIONMENT OF INPATIENT/OUTPATIENT ANCILLARY SERVICE OTHER PASS THROUGH COSTS,APPORTIONMENT OF INPATIENT/OUTPATIENT ANCILLARY SERVICE OTHER PASS THROUGH COSTS,APPORTIONMENT OF INPATIENT/OUTPATIENT ANCILLARY SERVICE OTHER PASS THROUGH COSTS,APPORTIONMENT OF INPATIENT/OUTPATIENT ANCILLARY SERVICE OTHER PASS THROUGH COSTS,APPORTIONMENT OF INPATIENT/OUTPATIENT ANCILLARY SERVICE OTHER PASS THROUGH COSTS,APPORTIONMENT OF MEDICAL AND OTHER HEALTH SERVICES,APPORTIONMENT OF MEDICAL AND OTHER HEALTH SERVICES,APPORTIONMENT OF MEDICAL AND OTHER HEALTH SERVICES,APPORTIONMENT OF MEDICAL AND OTHER HEALTH SERVICES,APPORTIONMENT OF MEDICAL AND OTHER HEALTH SERVICES,APPORTIONMENT OF MEDICAL AND OTHER HEALTH SERVICES,COST ALLOCATION,APPORTIONMENT OF INPATIENT/OUTPATIENT ANCILLARY SERVICE OTHER PASS THROUGH COSTS,APPORTIONMENT OF INPATIENT/OUTPATIENT ANCILLARY SERVICE OTHER PASS THROUGH COSTS,APPORTIONMENT OF MEDICAL AND OTHER HEALTH SERVICES,APPORTIONMENT OF MEDICAL AND OTHER HEALTH SERVICES,APPORTIONMENT OF INPATIENT/OUTPATIENT ANCILLARY SERVICE OTHER PASS THROUGH COSTS,APPORTIONMENT OF INPATIENT/OUTPATIENT ANCILLARY SERVICE OTHER PASS THROUGH COSTS,APPORTIONMENT OF INPATIENT/OUTPATIENT ANCILLARY SERVICE OTHER PASS THROUGH COSTS,COST ALLOCATION,COST ALLOCATION,APPORTIONMENT OF INPATIENT/OUTPATIENT ANCILLARY SERVICE OTHER PASS THROUGH COSTS,COST ALLOCATION,COST ALLOCATION,APPORTIONMENT OF INPATIENT/OUTPATIENT ANCILLARY SERVICE OTHER PASS THROUGH COSTS,COST ALLOCATION,COST ALLOCATION,INPATIENT ANCILLARY SERVICE COST APPORTIONMENT,INPATIENT ANCILLARY SERVICE COST APPORTIONMENT,INPATIENT ANCILLARY SERVICE COST APPORTIONMENT,INPATIENT ANCILLARY SERVICE COST APPORTIONMENT,INPATIENT ANCILLARY SERVICE COST APPORTIONMENT,INPATIENT ANCILLARY SERVICE COST APPORTIONMENT,APPORTIONMENT OF INPATIENT/OUTPATIENT ANCILLARY SERVICE OTHER PASS THROUGH COSTS,APPORTIONMENT OF INPATIENT/OUTPATIENT ANCILLARY SERVICE OTHER PASS THROUGH COSTS,APPORTIONMENT OF INPATIENT/OUTPATIENT ANCILLARY SERVICE OTHER PASS THROUGH COSTS,APPORTIONMENT OF INPATIENT/OUTPATIENT ANCILLARY SERVICE OTHER PASS THROUGH COSTS,APPORTIONMENT OF INPATIENT/OUTPATIENT ANCILLARY SERVICE OTHER PASS THROUGH COSTS,TRIAL BALANCE OF EXPENSE ACCOUNTS,TRIAL BALANCE OF EXPENSE ACCOUNTS,TRIAL BALANCE OF EXPENSE ACCOUNTS,TRIAL BALANCE OF EXPENSE ACCOUNTS,TRIAL BALANCE OF EXPENSE ACCOUNTS,TRIAL BALANCE OF EXPENSE ACCOUNTS,TRIAL BALANCE OF EXPENSE ACCOUNTS,TRIAL BALANCE OF EXPENSE ACCOUNTS,TRIAL BALANCE OF EXPENSE ACCOUNTS,COST ALLOCATION,COST ALLOCATION,COST ALLOCATION,COST ALLOCATION,COST ALLOCATION,COST ALLOCATION,ALLOCATION OF NEW CAPITAL COSTS,ALLOCATION OF NEW CAPITAL COSTS,ALLOCATION OF NEW CAPITAL COSTS,COMPUTATION OF RATIO OF COST TO CHARGES,COMPUTATION OF RATIO OF COST TO CHARGES,COMPUTATION OF RATIO OF COST TO CHARGES,COMPUTATION OF RATIO OF COST TO CHARGES,COMPUTATION OF RATIO OF COST TO CHARGES,COMPUTATION OF RATIO OF COST TO CHARGES,APPORTIONMENT OF INPATIENT/OUTPATIENT ANCILLARY SERVICE OTHER PASS THROUGH COSTS,APPORTIONMENT OF INPATIENT/OUTPATIENT ANCILLARY SERVICE OTHER PASS THROUGH COSTS,APPORTIONMENT OF INPATIENT/OUTPATIENT ANCILLARY SERVICE OTHER PASS THROUGH COSTS,INPATIENT ANCILLARY SERVICE COST APPORTIONMENT,INPATIENT ANCILLARY SERVICE COST APPORTIONMENT,COST ALLOCATION,BED DAYS AVAILABLE,BED DAYS AVAILABLE,APPORTIONMENT OF INPATIENT/OUTPATIENT ANCILLARY SERVICE OTHER PASS THROUGH COSTS,APPORTIONMENT OF INPATIENT/OUTPATIENT ANCILLARY SERVICE OTHER PASS THROUGH COSTS,APPORTIONMENT OF INPATIENT/OUTPATIENT ANCILLARY SERVICE OTHER PASS THROUGH COSTS,APPORTIONMENT OF INPATIENT/OUTPATIENT ANCILLARY SERVICE OTHER PASS THROUGH COSTS,CALCULATION OF REIMBURSEMENT SETTLEMENT,CALCULATION OF REIMBURSEMENT SETTLEMENT,Total Inpatient Days/Outpatient Visits,APPORTIONMENT OF MEDICAL AND OTHER HEALTH SERVICES,APPORTIONMENT OF MEDICAL AND OTHER HEALTH SERVICES,APPORTIONMENT OF INPATIENT/OUTPATIENT ANCILLARY SERVICE OTHER PASS THROUGH COSTS,APPORTIONMENT OF INPATIENT/OUTPATIENT ANCILLARY SERVICE OTHER PASS THROUGH COSTS,APPORTIONMENT OF INPATIENT/OUTPATIENT ANCILLARY SERVICE OTHER PASS THROUGH COSTS,APPORTIONMENT OF INPATIENT/OUTPATIENT ANCILLARY SERVICE OTHER PASS THROUGH COSTS,File Date,No Description,No Description,No Description,No Description,CALCULATION OF REIMBURSEMENT SETTLEMENT (PPS),CALCULATION OF REIMBURSEMENT SETTLEMENT (PPS),CALCULATION OF REIMBURSEMENT SETTLEMENT (PPS),CALCULATION OF REIMBURSEMENT SETTLEMENT (PPS),CALCULATION OF REIMBURSEMENT SETTLEMENT (PPS),CALCULATION OF REIMBURSEMENT SETTLEMENT (PPS),CALCULATION OF REIMBURSEMENT SETTLEMENT (PPS),CALCULATION OF REIMBURSEMENT SETTLEMENT (PPS),CALCULATION OF REIMBURSEMENT SETTLEMENT (PPS),CALCULATION OF REIMBURSEMENT SETTLEMENT (PPS),CALCULATION OF REIMBURSEMENT SETTLEMENT (PPS),CALCULATION OF REIMBURSEMENT SETTLEMENT (PPS),CALCULATION OF REIMBURSEMENT SETTLEMENT (PPS),CALCULATION OF REIMBURSEMENT SETTLEMENT (PPS),CALCULATION OF REIMBURSEMENT SETTLEMENT (PPS),CALCULATION OF REIMBURSEMENT SETTLEMENT (PPS),CALCULATION OF REIMBURSEMENT SETTLEMENT (PPS),CALCULATION OF REIMBURSEMENT SETTLEMENT (PPS),CALCULATION OF REIMBURSEMENT SETTLEMENT (PPS),CALCULATION OF REIMBURSEMENT SETTLEMENT (PPS),CALCULATION OF REIMBURSEMENT SETTLEMENT (PPS),Lat,Lon,"Control type, text","Hospital type, text",Num and Name
,Report Record Number (RPT_REC_NUM),Hospital Provider Number (PRVDR_NUM),Fiscal Intermediary Number (FI_NUM),Report Status Code (RPT_STUS_CD),Fiscal Intermediary/MAC Create Date (FI_CREAT_DT),Fiscal Year Begin Date (FY_BGN_DT),Fiscal Year End Date (FY_END_DT),Utilization Code (L/N/F) (UTIL_CODE),NOT IN THIS FILE (TRNSMTL_NUM),SSA State Code (STATE),SSA State County Code (ST_CTY_CD),Census Division Code (CENSUS),CMS Region Code (REGION),Geographic MSA (MSA),Utilization Review SNF (A_C1_114),Utilization Review SNF (A_C2_114),PBP Clinical Lab Services Program Only (A_C2_61),Int & Res (non approved teaching program (B_1_C21_100),Home Program Dialysis (B_1_C21_94),Int & Res (non approved teaching program (B_1_C22_100),Allocation of Interns & Residents Program Costs Subprovider I (B_1_C22_42),Home Program Dialysis (B_1_C22_94),Cross Foot Adjustments (B_1_C26_200),Int & Res (non approved teaching program (C_1_C6_100),Int & Res (non approved teaching program (C_1_C7_100),Islet Acquisition (C_1_C7_111),No Description (D3_HOS_C1_77),No Description (D3_HOS_C2_201),Subprovider I (D3_HOS_C2_42),Nursery (D3_HOS_C2_43),PBP Clinical Lab Services Program Only (D3_HOS_C2_61),No Description (D3_HOS_C2_77),PBP Clinical Lab Services Program Only (D3_HOS_C3_61),No Description (D3_HOS_C3_77),Subprovider I (D3_IPF_C2_42),Home Program Dialysis (D3_IPF_C2_94),Home Program Dialysis (D3_IPF_C3_94),PBP Clinical Lab Services Program Only (D3_IRF_C2_61),Home Program Dialysis (D3_IRF_C2_94),PBP Clinical Lab Services Program Only (D3_IRF_C3_61),Home Program Dialysis (D3_IRF_C3_94),Subprovider-IPF (D3_SNF_C2_40),Subprovider-IRF (D3_SNF_C2_41),Subprovider II (D_1_HOS_C4_4201),No Description (D_2_IPF_C5_94),No Description (D_2_IRF_C5_94),Home Program Dialysis (D_4_HOS_C12_94),Renal Dialysis (D_4_HOS_C4_74),Total (D_4_SNF_C13_200),PPS REIMBURSED SERVICES -  CHARGES Home Program Dialysis (D_5_HOS_C2_94),COST REIMBURSED SERVICES SUBJECT TO DEDUCTIBLES  AND COINSURANCE - CHARGES PBP Clinical Lab Services Program Only (D_5_HOS_C3_61),COST REIMBURSED SERVICES NOT SUBJECT TO DEDUCTIBLES AND COINSURANCE - CHARGES Home Program Dialysis (D_5_HOS_C4_94),COST SERVICES SUBJECT TO DEDUCTIBLES AND COINSURANCE - COST PBP Clinical Lab Services Program Only (D_5_HOS_C6_61),COST SERVICES NOT SUBJECT TO DEDUCTIBLES AND COINSURANCE - COST Home Program Dialysis (D_5_HOS_C7_94),No Description (E1_2_HOS_C1_31),No Description (E1_2_HOS_C1_7),No Description (E1_2_HOS_C1_8),No Description (E2_SWSNF_C1_7),No Description (E3_1_HOS_C1_22),No Description (E3_2_HOS_C1_13),No Description (E3_2_HOS_C1_29),No Description (E3_2_HOS_C1_3101),No Description (E3_2_HOS_C1_35),No Description (E3_2_HOS_C1_5),No Description (E3_2_HOS_C1_7),No Description (E3_2_IPF_C1_13),No Description (E3_2_IPF_C1_27),No Description (E3_2_IPF_C1_3101),No Description (E3_2_IPF_C1_5),No Description (E3_3_HOS_C1_14),No Description (E3_3_HOS_C1_16),No Description (E3_3_HOS_C1_3201),No Description (E3_3_HOS_C1_36),No Description (E3_3_HOS_C1_8),No Description (E3_3_IRF_C1_3201),No Description (E3_3_IRF_C1_6),No Description (E3_3_IRF_C1_8),No Description (E3_4_HOS_C1_19),No Description (E3_4_HOS_C1_2201),No Description (E3_4_HOS_C1_4),No Description (E3_5_C1_10),No Description (E3_5_C1_14),No Description (E3_5_C1_15),No Description (E3_5_C1_16),No Description (E3_5_C1_2),No Description (E3_5_C1_21),No Description (E3_5_C1_7),No Description (E3_5_C1_8),No Description (E3_6_SNF_C1_1501),No Description (E_A_HOS_C101_101),No Description (E_A_HOS_C101_102),No Description (E_A_HOS_C101_202),No Description (E_A_HOS_C101_28),No Description (E_A_HOS_C1_101),No Description (E_A_HOS_C1_102),No Description (E_A_HOS_C1_202),No Description (E_A_HOS_C1_2901),No Description (E_A_HOS_C1_35),No Description (E_A_HOS_C1_3501),No Description (E_A_HOS_C1_3502),No Description (E_A_HOS_C1_3503),No Description (E_A_HOS_C1_36),No Description (E_A_HOS_C1_4101),No Description (E_A_HOS_C1_7089),No Description (E_A_HOS_C1_7092),No Description (E_A_HOS_C1_7095),No Description (E_A_HOS_C1_7101),No Description (E_A_HOS_C2_35),No Description (E_A_HOS_C2_3501),No Description (E_A_HOS_C2_3502),No Description (E_A_HOS_C2_3503),OPPS payments (E_B_HOS_C101_3),Outlier payments (E_B_HOS_C101_4),Line 2 times line 5 (E_B_HOS_C101_6),"Sum of lines 3,4 divided by line 6 (E_B_HOS_C101_7)",Transitional corridor payment (E_B_HOS_C101_8),Partial or full credits from manufacturers (E_B_HOS_C1_3998),Sequestration adjustment (E_B_HOS_C1_4001),No Description (E_B_IPF_C1_15),No Description (E_B_IPF_C1_16),No Description (E_B_IPF_C1_4001),No Description (E_B_IPF_C1_44),No Description (E_B_IRF_C1_15),No Description (E_B_IRF_C1_16),No Description (E_B_IRF_C1_38),No Description (E_B_IRF_C1_44),No Description (E_B_IRF_C1_8),No Description (E_B_SNF_C1_15),No Description (E_B_SNF_C1_16),No Description (E_B_SNF_C1_24),No Description (E_B_SNF_C1_31),No Description (E_B_SNF_C1_44),No Description (E_B_SNF_C1_9),No Description (G2_C1_401),No Description (G3_C1_2450),No Description (H3_1_HHA1_C11_15),No Description (H3_1_HHA1_C9_15),No Description (H3_1_HHA2_C11_15),No Description (H3_1_HHA2_C9_15),No Description (H3_1_HHA3_C10_15),No Description (H3_1_HHA3_C5_1),No Description (H3_1_HHA3_C5_2),No Description (H3_1_HHA3_C5_3),No Description (H3_1_HHA3_C5_4),No Description (H3_1_HHA3_C5_5),No Description (H3_1_HHA3_C5_6),No Description (H3_1_HHA3_C6_1),No Description (H3_1_HHA3_C6_2),No Description (H3_1_HHA3_C6_3),No Description (H3_1_HHA3_C6_4),No Description (H3_1_HHA3_C6_5),No Description (H3_1_HHA3_C6_6),No Description (H3_1_HHA3_C6_7),No Description (H3_1_HHA3_C7_1),No Description (H3_1_HHA3_C7_2),No Description (H3_1_HHA3_C7_3),No Description (H3_1_HHA3_C7_4),No Description (H3_1_HHA3_C7_5),No Description (H3_1_HHA3_C7_6),No Description (H3_1_HHA3_C7_7),No Description (H3_1_HHA3_C9_15),No Description (H4_2_HHA1_C1_18),No Description (H4_2_HHA1_C1_3101),No Description (H4_2_HHA1_C1_35),No Description (H4_2_HHA1_C2_18),No Description (H4_2_HHA1_C2_27),No Description (H4_2_HHA1_C2_3101),No Description (H4_2_HHA1_C2_35),No Description (H4_2_HHA2_C1_10),No Description (H4_2_HHA2_C1_12),No Description (H4_2_HHA2_C1_15),No Description (H4_2_HHA2_C1_16),No Description (H4_2_HHA2_C1_30),No Description (H4_2_HHA2_C1_3101),No Description (H4_2_HHA2_C1_33),No Description (H4_2_HHA2_C1_34),No Description (H4_2_HHA2_C2_16),No Description (H4_2_HHA2_C2_17),No Description (H4_2_HHA2_C2_25),No Description (H4_2_HHA2_C2_30),No Description (H4_2_HHA2_C2_3101),No Description (H4_2_HHA3_C1_11),No Description (H4_2_HHA3_C1_12),No Description (H4_2_HHA3_C1_13),No Description (H4_2_HHA3_C1_14),No Description (H4_2_HHA3_C1_15),No Description (H4_2_HHA3_C1_16),No Description (H4_2_HHA3_C1_22),No Description (H4_2_HHA3_C1_24),No Description (H4_2_HHA3_C1_26),No Description (H4_2_HHA3_C1_29),No Description (H4_2_HHA3_C1_31),No Description (H4_2_HHA3_C1_32),No Description (H4_2_HHA3_C1_33),No Description (H4_2_HHA3_C1_34),No Description (H4_2_HHA3_C2_10),No Description (H4_2_HHA3_C2_11),No Description (H4_2_HHA3_C2_12),No Description (H4_2_HHA3_C2_13),No Description (H4_2_HHA3_C2_14),No Description (H4_2_HHA3_C2_15),No Description (H4_2_HHA3_C2_16),No Description (H4_2_HHA3_C2_22),No Description (H4_2_HHA3_C2_24),No Description (H4_2_HHA3_C2_26),No Description (H4_2_HHA3_C2_29),No Description (H4_2_HHA3_C2_30),No Description (H4_2_HHA3_C2_31),No Description (H4_2_HHA3_C2_3101),No Description (H4_2_HHA3_C2_32),No Description (H4_2_HHA3_C2_33),No Description (H4_2_HHA3_C2_34),No Description (L_1_HOS_C101_1),No Description (L_1_HOS_C1_101),No Description (L_1_HOS_C1_201),Total Subprovider II Interns & Residents (S3_1_C10_1801),No Description (S3_1_C11_23),No Description (S3_1_C14_1801),No Description (S3_1_C15_1801),Subprovider 2 (S3_1_C2_1801),Labor and Delivery (S3_1_C2_32),Subprovider 2 (S3_1_C3_1801),Labor and Delivery (S3_1_C3_32),SNF (S3_1_C5_19),NF (S3_1_C5_20),No Description (S3_1_C5_6),Subprovider 2 (S3_1_C7_1801),Subprovider 2 (S3_1_C8_1801),Total Subprovider I Interns & Residents (S3_1_C9_18),No Description (S3_1_C9_23),AMOUNT REPORTED Home Office Salaries (S3_2_C2_1401),AMOUNT REPORTED Related  Salaries (S3_2_C2_1402),AMOUNT REPORTED Interns & Residents (S3_2_C2_2550),AMOUNT REPORTED Interns & Residents (S3_2_C2_2551),AMOUNT REPORTED Interns & Residents (S3_2_C2_2552),AMOUNT REPORTED Interns & Residents (S3_2_C2_2553),AMOUNT REPORTED Home Office Salaries (S3_2_C3_1401),AMOUNT REPORTED Related Salaries (S3_2_C3_1402),AMOUNT REPORTED Wage Related Costs RHC/FQHC (S3_2_C3_24),AMOUNT REPORTED Interns & Residents (S3_2_C3_2550),AMOUNT REPORTED Interns & Residents (S3_2_C3_2551),AMOUNT REPORTED Interns & Residents (S3_2_C3_2552),AMOUNT REPORTED Interns & Residents (S3_2_C3_2553),ADJUSTED SALARIES Home Office Salaries (S3_2_C4_1401),ADJUSTED SALARIES Related Salaries (S3_2_C4_1402),ADJUSTED SALARIES Teaching Physician Salaries (S3_2_C4_1601),ADJUSTED SALARIES Teaching Physician Salaries (S3_2_C4_1602),ADJUSTED SALARIES Interns & Residents (S3_2_C4_2550),ADJUSTED SALARIES Interns & Residents (S3_2_C4_2551),ADJUSTED SALARIES Interns & Residents (S3_2_C4_2552),ADJUSTED SALARIES Interns & Residents (S3_2_C4_2553),AVERAGE HOURLY WAGE Home Office Salaries (S3_2_C6_1401),AVERAGE HOURLY WAGE Related Salaries (S3_2_C6_1402),No Description (S3_5_C1_15),No Description (S3_5_C1_5),No Description (S3_5_C1_7),No Description (S3_5_C2_12),No Description (S3_5_C2_15),No Description (S3_5_C2_7),HHA II Without Outliers:  Other Charges (S4_HHA2_C1_34),HHA II With Outliers:  Other Charges (S4_HHA2_C2_34),HHA II With Outliers:  Non Routine Med Sup Chgs (S4_HHA2_C2_38),HHA II LUPA Episodes:  Other Charges (S4_HHA2_C3_34),HHA II PEP Episodes:  Other Charges (S4_HHA2_C4_34),HHA II PEP:  Total Number of Outlier Episodes (S4_HHA2_C4_37),HHA II Total Other Charges (S4_HHA2_C5_34),HHA III Without Outliers:  Total Visits (S4_HHA3_C1_33),HHA III Without Outliers:  Other Charges (S4_HHA3_C1_34),HHA III Without Outliers:  Total Charges (S4_HHA3_C1_35),HHA III W/Out Outliers:  Number of Episodes (S4_HHA3_C1_36),HHA III Without Outliers:  Non Routine Med Sup Chgs (S4_HHA3_C1_38),HHA III With Outliers:  Total Visits (S4_HHA3_C2_33),HHA III With Outliers:  Other Charges (S4_HHA3_C2_34),HHA III With Outliers:  Total Charges (S4_HHA3_C2_35),HHA III With Outliers:  Number of Episodes (S4_HHA3_C2_37),HHA III With Outliers:  Non Routine Med Sup Chgs (S4_HHA3_C2_38),HHA III LUPA Episodes:  Total Visits (S4_HHA3_C3_33),HHA III LUPA Episodes:  Other Charges (S4_HHA3_C3_34),HHA III Total Charges:  LUPA Episodes (S4_HHA3_C3_35),HHA III LUPA Episodes:  Total Number of Episodes (S4_HHA3_C3_36),HHA III LUPA:  Total Non Routine Med Sup Chgs (S4_HHA3_C3_38),HHA III PEP Episodes:  Total Visits (S4_HHA3_C4_33),HHA III PEP Episodes:  Other Charges (S4_HHA3_C4_34),HHA III PEP Episodes:  Total Charges: (S4_HHA3_C4_35),HHA III PEP Episodes:  Total Number of Episodes (S4_HHA3_C4_36),HHA III PEP:  Total Number of Outlier Episodes (S4_HHA3_C4_37),HHA III PEP:  Total Non Routine Med Supply Chgs (S4_HHA3_C4_38),HHA III Total Visits (S4_HHA3_C5_33),HHA III Total Other Charges (S4_HHA3_C5_34),HHA III Total Charges (S4_HHA3_C5_35),HHA III Total Number of Episodes (S4_HHA3_C5_36),HHA III Total Number of Outlier Episodes (S4_HHA3_C5_37),HHA III Total Non Routine Medical  Supply Charges (S4_HHA3_C5_38),Column 1 (Beginning Balances) Total (A7_1_C1_10),Column 1 (Beginning Balances) Building Improvements (A7_1_C1_4),Column 1 (Beginning Balances) Fixed Equipment (A7_1_C1_5),Column 1 (Beginning Balances) Movable Equipment (A7_1_C1_6),Column 1 (Beginning Balances) Subtotal (A7_1_C1_8),Column 2 (Purchases) Total (A7_1_C2_10),Column 2 (Purchases) Fixed Equipment (A7_1_C2_5),Column 2 (Purchases) Movable Equipment (A7_1_C2_6),Column 2 (Purchases) Subtotal (A7_1_C2_8),Column 7 (Fully Depreciated Assets) Total (A7_1_C7_10),Column 5 (Disposals and Retirements) Fixed Equipment (A7_1_C7_5),Column 5 (Disposals and Retirements) Movable Equipment (A7_1_C7_6),Column 7 (Fully Depreciated Assets) Subtotal (A7_1_C7_8),Column 10 (Lease) Total (A7_3_C10_3),Column 15 (Total) Total (A7_3_C15_3),Column 9 (Depreciation) Total (A7_3_C9_3),Cafeteria employees and guests (A8_C2_14),Sale of medical records and abstracts (A8_C2_18),"Trade, Quantity, and Time Discounts (A8_C2_4)",Refunds and Rebates of Expenses (A8_C2_5),Total (A8_C2_50),Total Salaries (A_C1_200),Adults and Pediatrics (A_C1_30),Total Salaries (A_C2_200),Adults and Pediatrics (A_C2_30),Renal Dialysis (A_C2_74),Total Salaries (A_C6_200),Adults and Pediatrics (A_C6_30),Net Expense for Cost Allocation Total (B_1_C0_200),Net Expense for Cost Allocation Adults and Pediatrics (B_1_C0_30),Net Expense for Cost Allocation Renal Dialysis (B_1_C0_74),Total (B_1_C26_202),Adults and Pediatrics (B_1_C26_30),Renal Dialysis (B_1_C26_74),Total (B_2_C26_202),TOTAL CAPITAL COSTS AFTER COST ALLOCATION Adults & Pediatrics (B_2_C26_30),Renal Dialysis (B_2_C26_74),Total (C_1_C3_202),Subtotal (C_1_C5_200),Total (C_1_C5_202),Adults & Pediatrics (C_1_C5_30),Renal Dialysis (C_1_C5_74),No Description (C_1_C6_200),Total (C_1_C6_202),Total Inpatient Charges Adults & Pediatrics (C_1_C6_30),Renal Dialysis (C_1_C6_74),Total (C_1_C8_202),General Inpatient Routine Service Cost net of Swing Bed Cost (D1_HOS_C1_27),General Inpatient Routine Service Cost net of Swing Bed and Private Room Diff (D1_HOS_C1_37),Total Program General Inpatient Routine (D1_HOS_C1_41),Program Inpatient Ancillary Service Cost (D1_HOS_C1_48),Total Program Inpatient Costs (D1_HOS_C1_49),Pass through Cost for Program Inpatient Routine (D1_HOS_C1_50),Pass Through Cost for  Program Ancillary (D1_HOS_C1_51),Total Program Excludable Costs (D1_HOS_C1_52),"Total Program Inpatient Operating Cost excluding Capital Related, Nonphysician Anesthetist, and Medical Education Costs (D1_HOS_C1_53)",No Description (D3_HOS_C2_200),No Description (D3_HOS_C2_202),Adults and Pediatrics (D3_HOS_C2_30),Renal Dialysis (D3_HOS_C2_74),TOTAL (D3_HOS_C3_200),Renal Dialysis (D3_HOS_C3_74),Total (D_1_HOS_C4_200),Adults & Pediatrics (D_1_HOS_C4_30),Total (D_1_HOS_C6_200),Adults & Pediatrics (D_1_HOS_C6_30),Total (D_1_HOS_C7_200),Adults & Pediatrics (D_1_HOS_C7_30),No Description (D_2_HOS_C5_200),No Description (D_2_HOS_C5_74),Total Patient Days (D_3_HOS_C6_200),Total Inpatient Program Days (D_3_HOS_C8_200),No Description (E3_4_HOS_C1_1),No Description (E3_4_HOS_C1_10),No Description (E3_4_HOS_C1_11),No Description (E3_4_HOS_C1_12),No Description (E3_4_HOS_C1_13),No Description (E3_4_HOS_C1_14),No Description (E3_4_HOS_C1_15),No Description (E3_4_HOS_C1_16),No Description (E3_4_HOS_C1_17),No Description (E3_4_HOS_C1_2),No Description (E3_4_HOS_C1_22),No Description (E3_4_HOS_C1_23),No Description (E3_4_HOS_C1_24),No Description (E3_4_HOS_C1_25),No Description (E3_4_HOS_C1_3),No Description (E3_4_HOS_C1_7),No Description (E3_4_HOS_C1_9),No Description (G2_C1_1),No Description (G2_C1_10),No Description (G2_C1_17),No Description (G2_C1_28),No Description (G2_C1_30),No Description (G2_C2_36),No Description (G2_C2_43),No Description (G3_C1_1),No Description (G3_C1_11),No Description (G3_C1_18),No Description (G3_C1_2),No Description (G3_C1_25),No Description (G3_C1_26),No Description (G3_C1_29),No Description (G3_C1_3),No Description (G3_C1_4),No Description (G3_C1_5),No Description (G3_C1_7),Cost To Charge Ratio (S10_C1_1),Total Bad Debt expense (S10_C1_26),No Description (S10_C1_27),No Description (S10_C1_28),No Description (S10_C1_29),Cost of Uncompensated Care (S10_C1_30),Total unreimbursed and uncompensated care (S10_C1_31),No Description (S10_C2_20),No Description (S10_C2_21),No Description (S10_C2_23),No Description (S10_C3_20),No Description (S10_C3_21),No Description (S10_C3_23),Urban/Rural Indicator at beginning (S2_1_C1_26),Urban (1) or Rural (2) (S2_1_C1_27),Hospital Type (S2_1_C4_3),Total Hospital Interns & Residents (S3_1_C10_14),Total Facility FTEs (S3_1_C10_27),No Description (S3_1_C13_1),No Description (S3_1_C13_14),No Description (S3_1_C15_1),No Description (S3_1_C15_14),Hospital Adults & Pediatrics (S3_1_C2_1),Total Hospital (S3_1_C2_14),Total Facility (S3_1_C2_27),Total (S3_1_C2_7),Hospital Adults & Pediatrics (S3_1_C3_1),Total Hospital (S3_1_C3_14),Total Hospital (S3_1_C3_7),Hospital Adults & Pediatrics (S3_1_C6_1),Total Hospital (S3_1_C6_14),Total Adults & Peds (S3_1_C6_7),Hospital Adults & Pediatrics (S3_1_C8_1),Total Hospital (S3_1_C8_14),Total Adults & Pediatrics (S3_1_C8_7),Column 1 (Beginning Balances) Land (A7_1_C1_1),Column 1 (Beginning Balances) Buildings and Fixtures (A7_1_C1_3),Column 2 (Purchases) Buildings and Fixtures (A7_1_C2_3),Column 11 (Interest) Total (A7_3_C11_3),Column 7 (Other Capital Related Costs) Total (A7_3_C7_3),Investment Income-New Bldgs & Fixtures (A8_C2_1),Provider-based physician adjustment (A8_C2_10),Related Organization Transactions (A8_C2_12),Investment Income-Other (A8_C2_3),Subprovider-IPF (A_C1_40),Interest Expense (A_C2_113),Other Capital (A_C2_3),Subprovider-IPF (A_C2_40),Net Expense for Cost Allocation Subprovider-IPF (B_1_C0_40),Subprovider-IPF (B_1_C26_40),TOTAL CAPITAL COSTS AFTER COST ALLOCATION Subprovider-IPF (B_2_C26_40),Subprovider-IPF (C_1_C5_40),Total Inpatient Charges Subprovider-IPF (C_1_C6_40),No Description (C_1_C7_200),Total (C_1_C7_202),General Inpatient Routine Service Cost net of Swing Bed Cost (D1_IPF_C1_27),General Inpatient Routine Service Cost net of Swing Bed and Private Room Diff (D1_IPF_C1_37),Total Program General Inpatient Routine (D1_IPF_C1_41),Total Program Inpatient Costs (D1_IPF_C1_49),Pass through Cost for Program Inpatient (D1_IPF_C1_50),Total Program Excludable Costs (D1_IPF_C1_52),"Total Program Inpatient Operating Cost excluding Capital Related, Nonphysician Anesthetist, and Medical Education Costs (D1_IPF_C1_53)",Subprovider-IPF (D3_IPF_C2_40),Subprovider-IPF (D_1_HOS_C4_40),Subprovider-IPF (D_1_HOS_C6_40),Subprovider-IPF (D_1_HOS_C7_40),No Description (E3_2_HOS_C1_1),No Description (E3_2_HOS_C1_12),No Description (E3_2_HOS_C1_16),No Description (E3_2_HOS_C1_18),No Description (E3_2_HOS_C1_20),No Description (E3_2_HOS_C1_22),No Description (E3_2_HOS_C1_26),No Description (E3_2_HOS_C1_31),No Description (E3_2_HOS_C1_34),No Description (E3_2_HOS_C1_9),No Description (E3_2_IPF_C1_1),No Description (E3_2_IPF_C1_12),No Description (E3_2_IPF_C1_16),No Description (E3_2_IPF_C1_18),No Description (E3_2_IPF_C1_20),No Description (E3_2_IPF_C1_22),No Description (E3_2_IPF_C1_26),No Description (E3_2_IPF_C1_31),No Description (E3_2_IPF_C1_34),No Description (E3_2_IPF_C1_9),Ratio of line 15 to line 16 (E_B_HOS_C1_17),No Description (E_B_IPF_C1_17),No Description (G2_C1_18),No Description (G2_C1_2),No Description (G2_C2_19),No Description (G2_C2_28),No Description (G3_C1_14),No Description (S3_1_C10_16),No Description (S3_1_C14_1),No Description (S3_1_C14_14),No Description (S3_1_C14_16),No Description (S3_1_C15_16),IPF (S3_1_C2_16),IPF (S3_1_C3_16),IPF (S3_1_C6_16),Hospital Adults & Pediatrics (S3_1_C7_1),Total Hospital (S3_1_C7_14),IPF (S3_1_C7_16),Total Adults & Peds (S3_1_C7_7),IPF (S3_1_C8_16),AMOUNT REPORTED Total Salaries (S3_2_C2_1),AMOUNT REPORTED Excluded Area Salaries (S3_2_C2_10),AMOUNT REPORTED Administrative and General (S3_2_C2_27),AMOUNT REPORTED Operation of Plant (S3_2_C2_30),AMOUNT REPORTED Housekeeping (S3_2_C2_32),AMOUNT REPORTED Dietary (S3_2_C2_34),AMOUNT REPORTED Nursing Administration (S3_2_C2_38),AMOUNT REPORTED Medical Records & Med Records Library (S3_2_C2_41),AMOUNT REPORTED Other General Service (S3_2_C2_43),AMOUNT REPORTED Net Salaries (S3_3_C2_1),AMOUNT REPORTED Excluded Area Salaries (S3_3_C2_2),AMOUNT REPORTED Subtotal Salaries (S3_3_C2_3),AMOUNT REPORTED Total (S3_3_C2_6),ADJUSTED SALARIES Net Salaries (S3_3_C4_1),ADJUSTED SALARIES Excluded Area Salaries (S3_3_C4_2),ADJUSTED SALARIES Subtotal Salaries (S3_3_C4_3),ADJUSTED SALARIES Total (S3_3_C4_6),ADJUSTED SALARIES Total Overhead Costs (S3_3_C4_7),Negative Cost Centers (B_1_C26_201),Total (D_4_HOS_C12_200),PPS REIMBURSED SERVICES -  CHARGES Total (D_5_HOS_C2_200),PPS SERVICES COST Total (D_5_HOS_C5_200),No Description (E3_3_HOS_C1_1),No Description (E3_3_HOS_C1_10),No Description (E3_3_HOS_C1_13),No Description (E3_3_HOS_C1_17),No Description (E3_3_HOS_C1_19),No Description (E3_3_HOS_C1_2),No Description (E3_3_HOS_C1_20),No Description (E3_3_HOS_C1_21),No Description (E3_3_HOS_C1_22),No Description (E3_3_HOS_C1_23),No Description (E3_3_HOS_C1_24),No Description (E3_3_HOS_C1_25),No Description (E3_3_HOS_C1_26),No Description (E3_3_HOS_C1_27),No Description (E3_3_HOS_C1_3),No Description (E3_3_HOS_C1_32),No Description (E3_3_HOS_C1_33),No Description (E3_3_HOS_C1_35),No Description (E3_3_HOS_C1_4),Medical and Other Services reimbursed by OPPS (E_B_HOS_C1_2),Total prospective payment (E_B_HOS_C1_24),Deductibles and coinsurance related to line 24 (E_B_HOS_C1_26),Subtotal (E_B_HOS_C1_27),OPPS payments (E_B_HOS_C1_3),Subtotal (E_B_HOS_C1_30),Subtotal (E_B_HOS_C1_32),Allowable bad debts (E_B_HOS_C1_34),Adjusted reimburseable bad debts (E_B_HOS_C1_35),Allowable bad debts for dual eligibles beneficiaries (E_B_HOS_C1_36),Subtotal (E_B_HOS_C1_37),Subtotal (E_B_HOS_C1_40),Interim payments (E_B_HOS_C1_41),Balance due provider/program (E_B_HOS_C1_43),No Description (G2_C2_18),Column 1 (Beginning Balances) Land Improvements (A7_1_C1_2),Column 5 (Disposals and Retirements) Total (A7_1_C5_10),Column 5 (Disposals and Retirements) Movable Equipment (A7_1_C5_6),Column 5 (Disposals and Retirements) Subtotal (A7_1_C5_8),Column 5 (Disposals and Retirements) Land Improvements (A7_1_C7_2),Column 5 (Disposals and Retirements) Buildings and Fixtures (A7_1_C7_3),Column 5 (Disposals and Retirements) Building Improvements (A7_1_C7_4),Depreciation-New Bldgs & Fixtures (A8_C2_26),Depreciation-New Movable Equipment (A8_C2_27),TOTAL CAPITAL COSTS AFTER COST ALLOCATION Total Directly Assigned New Cap Rel Csts (B_2_C0_202),No Description (E1_2_HOS_C1_1),No Description (E1_2_HOS_C1_2),No Description (E1_2_HOS_C1_4),No Description (E1_2_HOS_C1_5),Total Hospital Interns & Residents (S3_1_C11_14),Total Facility FTEs (S3_1_C11_27),AMOUNT REPORTED Employee Benefits (S3_2_C2_26),AMOUNT REPORTED Maintenance and Repairs (S3_2_C2_29),AMOUNT REPORTED Laundry and Linen Service (S3_2_C2_31),AMOUNT REPORTED Pharmacy (S3_2_C2_40),AMOUNT REPORTED Social Service (S3_2_C2_42),ADJUSTED SALARIES Total Salaries (S3_2_C4_1),ADJUSTED SALARIES Excluded Area Salaries (S3_2_C4_10),ADJUSTED SALARIES Employee Benefits (S3_2_C4_26),ADJUSTED SALARIES Administrative and General (S3_2_C4_27),ADJUSTED SALARIES Admin & Gen Under Contract (S3_2_C4_29),ADJUSTED SALARIES Operation of Plant (S3_2_C4_30),ADJUSTED SALARIES Laundry and Linen Service (S3_2_C4_31),ADJUSTED SALARIES Housekeeping (S3_2_C4_32),ADJUSTED SALARIES Dietary (S3_2_C4_34),ADJUSTED SALARIES Nursing Administration (S3_2_C4_38),ADJUSTED SALARIES Pharmacy (S3_2_C4_40),ADJUSTED SALARIES Medical Records & Med Records Library (S3_2_C4_41),ADJUSTED SALARIES Social Service (S3_2_C4_42),PAID HOURS RELATED TO SALARIES Total Salaries (S3_2_C5_1),AVERAGE HOURLY WAGE Total Salaries (S3_2_C6_1),PAID HOURS RELATED TO SALARIES Net Salaries (S3_3_C5_1),PAID HOURS RELATED TO SALARIES Subtotal Salaries (S3_3_C5_3),AVERAGE HOURLY WAGE Net Salaries (S3_3_C6_1),AVERAGE HOURLY WAGE Subtotal Salaries (S3_3_C6_3),AVERAGE HOURLY WAGE Total (S3_3_C6_6),No Description (E3_2_HOS_C1_19),No Description (E3_2_HOS_C1_2),No Description (E3_2_HOS_C1_21),No Description (E3_2_HOS_C1_32),Allocation of Interns & Residents Salary and Fringes Adults and Pediatrics (B_1_C21_30),Allocation of Interns & Residents Program Costs Adults and Pediatrics (B_1_C22_30),Cross Foot Adjustments (B_2_C26_200),No Description (E3_2_HOS_C1_10),No Description (E3_2_HOS_C1_11),No Description (E3_2_HOS_C1_27),No Description (E3_2_HOS_C1_33),No Description (E3_2_HOS_C1_4),No Description (E3_2_HOS_C1_6),No Description (E3_2_HOS_C1_8),No Description (E4_C1_1),No Description (E4_C1_23),No Description (E4_C1_25),No Description (E4_C1_26),No Description (E4_C1_27),No Description (E4_C1_28),No Description (E4_C1_29),No Description (E4_C1_3),No Description (E4_C1_301),No Description (E4_C1_37),No Description (E4_C1_41),No Description (E4_C1_42),No Description (E4_C1_44),No Description (E4_C1_45),No Description (E4_C1_46),No Description (E4_C1_47),No Description (E4_C1_48),No Description (E4_C1_49),No Description (E4_C1_5),No Description (E4_C1_50),No Description (E4_C1_6),No Description (E4_C1_7),No Description (E4_C2_11),No Description (E4_C2_12),No Description (E4_C2_13),No Description (E4_C2_14),No Description (E4_C2_17),No Description (E4_C2_18),No Description (E4_C2_19),No Description (E4_C2_27),No Description (E4_C2_8),No Description (E4_C2_9),No Description (E4_C3_19),No Description (E4_C3_31),No Description (E4_C3_8),No Description (E4_C3_9),interns and residents (E_B_HOS_C1_28),Tentative settlement (E_B_HOS_C1_42),Total Hospital Interns & Residents (S3_1_C9_14),Total Facility FTEs (S3_1_C9_27),Column 2 (Purchases) Building Improvements (A7_1_C2_4),Column 5 (Disposals and Retirements) Building Improvements (A7_1_C5_4),Net Expense for Cost Allocation Nursery (B_1_C0_43),Nursery (B_1_C26_43),TOTAL CAPITAL COSTS AFTER COST ALLOCATION Nursery (B_2_C26_43),Less Observation Beds (C_1_C5_201),Nursery (C_1_C5_43),Total Inpatient Charges Nursery (C_1_C6_43),Nursery (D_1_HOS_C4_43),No Description (E1_2_HOS_C1_6),No Description (E_A_HOS_C1_4),No Description (S10_C1_19),Net Revenue from Medicaid (S10_C1_2),No Description (S10_C1_20),No Description (S10_C1_21),Cost of charity care (S10_C1_23),Medicaid charges (S10_C1_6),No Description (S10_C1_7),No Description (S10_C1_8),Nursery (S3_1_C7_13),Nursery (S3_1_C8_13),Medicaid Observation Days (S3_1_C8_28),AMOUNT REPORTED Wage Related Costs Core (S3_2_C2_17),AMOUNT REPORTED Wage Related Costs Other (S3_2_C2_18),AMOUNT REPORTED Non-Physician Anesthetist Part B (S3_2_C2_21),ADJUSTED SALARIES Wage Related Costs Core (S3_2_C4_17),ADJUSTED SALARIES Wage Related Costs Other (S3_2_C4_18),ADJUSTED SALARIES Non-Physician Anesthetist Part B (S3_2_C4_21),PAID HOURS RELATED TO SALARIES Administrative and General (S3_2_C5_27),AVERAGE HOURLY WAGE Administrative and General (S3_2_C6_27),AMOUNT REPORTED Subtotal Wage Related Csts (S3_3_C2_5),ADJUSTED SALARIES Subtotal Wage Related Csts (S3_3_C4_5),PAID HOURS RELATED TO SALARIES Total Overhead Costs (S3_3_C5_7),AVERAGE HOURLY WAGE Subtotal Wage Related Csts (S3_3_C6_5),AVERAGE HOURLY WAGE Total Overhead Costs (S3_3_C6_7),Parking Lot (A8_C2_9),No Description (E3_4_HOS_C1_8),No Description (E_A_HOS_C1_74),No Description (G3_C1_10),No Description (G3_C1_16),No Description (G3_C1_22),No Description (G3_C1_6),Column 5 (Insurance) Total (A7_3_C5_3),Rental of quarters to employee and oths (A8_C2_15),NF (A_C2_45),NF (A_C6_45),Net Expense for Cost Allocation NF (B_1_C0_45),NF (B_1_C26_45),TOTAL CAPITAL COSTS AFTER COST ALLOCATION NF (B_2_C26_45),NF (C_1_C5_45),Total Inpatient Charges NF (C_1_C6_45),No Description (E3_2_HOS_C1_23),No Description (E3_2_HOS_C1_24),No Description (G2_C1_19),No Description (G2_C1_31),No Description (G2_C1_32),No Description (G2_C1_33),No Description (G2_C1_8),No Description (G3_C1_15),No Description (G3_C1_23),Column 6 (Taxes) Total (A7_3_C6_3),Vending Machines (A8_C2_20),Telephone Services (A8_C2_7),Television and Radio Service (A8_C2_8),Renal Dialysis (C_1_C7_74),COST REIMBURSED SERVICES SUBJECT TO DEDUCTIBLES  AND COINSURANCE - CHARGES Total (D_5_HOS_C3_200),COST REIMBURSED SERVICES SUBJECT TO DEDUCTIBLES  AND COINSURANCE - CHARGES Renal Dialysis (D_5_HOS_C3_74),COST SERVICES SUBJECT TO DEDUCTIBLES AND COINSURANCE - COST Total (D_5_HOS_C6_200),COST SERVICES SUBJECT TO DEDUCTIBLES AND COINSURANCE - COST Renal Dialysis (D_5_HOS_C6_74),Medical and Other Services (E_B_HOS_C1_1),Total cost (E_B_HOS_C1_11),Ancillary service charges (E_B_HOS_C1_12),Total reasonable charges (E_B_HOS_C1_14),Total customary charges (E_B_HOS_C1_18),Excess of customary charges (E_B_HOS_C1_19),Lesser of cost or charges (E_B_HOS_C1_21),Deductibles and coinsurance (E_B_HOS_C1_25),No Description (G2_C1_16),No Description (G3_C1_21),HMO (S3_1_C7_2),AMOUNT REPORTED Contract Labor (S3_2_C2_11),AMOUNT REPORTED Contract Labor: Pysician Part A (S3_2_C2_13),AMOUNT REPORTED Home Office Salaries & Wage Related Csts (S3_2_C2_14),AMOUNT REPORTED Excluded Areas (S3_2_C2_19),AMOUNT REPORTED Central Services and Supply (S3_2_C2_39),ADJUSTED SALARIES Contract Labor (S3_2_C4_11),ADJUSTED SALARIES Contract Labor:  Physician Part A (S3_2_C4_13),ADJUSTED SALARIES Home Office Salaries & Wage Related Csts (S3_2_C4_14),ADJUSTED SALARIES Excluded Areas (S3_2_C4_19),ADJUSTED SALARIES Central Services and Supply (S3_2_C4_39),PAID HOURS RELATED TO SALARIES Excluded Area Salaries (S3_2_C5_10),PAID HOURS RELATED TO SALARIES Contract Labor (S3_2_C5_11),PAID HOURS RELATED TO SALARIES Contract Labor:  Physician Part A (S3_2_C5_13),PAID HOURS RELATED TO SALARIES Home Office Salaries & Wage Related Csts (S3_2_C5_14),PAID HOURS RELATED TO SALARIES Employee Benefits (S3_2_C5_26),PAID HOURS RELATED TO SALARIES Operation of Plant (S3_2_C5_30),PAID HOURS RELATED TO SALARIES Housekeeping (S3_2_C5_32),PAID HOURS RELATED TO SALARIES Dietary (S3_2_C5_34),PAID HOURS RELATED TO SALARIES Nursing Administration (S3_2_C5_38),PAID HOURS RELATED TO SALARIES Central Services and Supply (S3_2_C5_39),PAID HOURS RELATED TO SALARIES Medical Records & Med Records Library (S3_2_C5_41),PAID HOURS RELATED TO SALARIES Social Service (S3_2_C5_42),AVERAGE HOURLY WAGE Excluded Area Salaries (S3_2_C6_10),AVERAGE HOURLY WAGE Contract Labor (S3_2_C6_11),AVERAGE HOURLY WAGE Contract Labor:  Physician Part A (S3_2_C6_13),AVERAGE HOURLY WAGE Home Office Salaries & Wage Related Csts (S3_2_C6_14),AVERAGE HOURLY WAGE Employee Benefits (S3_2_C6_26),AVERAGE HOURLY WAGE Operation of Plant (S3_2_C6_30),AVERAGE HOURLY WAGE Housekeeping (S3_2_C6_32),AVERAGE HOURLY WAGE Dietary (S3_2_C6_34),AVERAGE HOURLY WAGE Nursing Administration (S3_2_C6_38),AVERAGE HOURLY WAGE Central Services and Supply (S3_2_C6_39),AVERAGE HOURLY WAGE Medical Records & Med Records Library (S3_2_C6_41),AVERAGE HOURLY WAGE Social Service (S3_2_C6_42),AMOUNT REPORTED Subtotal Other Wages and Related Csts (S3_3_C2_4),ADJUSTED SALARIES Subtotal Other Wages and Related Csts (S3_3_C4_4),PAID HOURS RELATED TO SALARIES Excluded Area Salaries (S3_3_C5_2),PAID HOURS RELATED TO SALARIES Subtotal Other Wages and Related Csts (S3_3_C5_4),AVERAGE HOURLY WAGE Excluded Area Salaries (S3_3_C6_2),AVERAGE HOURLY WAGE Subtotal Other Wages and Related Csts (S3_3_C6_4),Column 2 (Purchases) Land (A7_1_C2_1),"Sale of scrap, waste, etc. (A8_C2_11)",Nursery (A_C1_43),Nursery (A_C2_43),Total (D_4_HOS_C11_200),Renal Dialysis (D_4_HOS_C12_74),Total (D_4_HOS_C13_200),Total Allied Health (D_4_HOS_C3_200),Total Outpatient Program Pass Thru Cost (D_4_HOS_C6_200),PPS REIMBURSED SERVICES -  CHARGES Renal Dialysis (D_5_HOS_C2_74),COST REIMBURSED SERVICES NOT SUBJECT TO DEDUCTIBLES AND COINSURANCE - CHARGES Total (D_5_HOS_C4_200),PPS SERVICES COST Renal Dialysis (D_5_HOS_C5_74),COST SERVICES NOT SUBJECT TO DEDUCTIBLES AND COINSURANCE - COST Total (D_5_HOS_C7_200),No Description (E1_2_HOS_C1_3),No Description (E_A_HOS_C1_1),No Description (E_A_HOS_C1_2),No Description (E_A_HOS_C1_30),No Description (E_A_HOS_C1_31),No Description (E_A_HOS_C1_32),No Description (E_A_HOS_C1_33),No Description (E_A_HOS_C1_34),No Description (E_A_HOS_C1_58),No Description (E_A_HOS_C1_60),No Description (E_A_HOS_C1_61),No Description (E_A_HOS_C1_62),No Description (E_A_HOS_C1_63),No Description (E_A_HOS_C1_64),No Description (E_A_HOS_C1_65),No Description (E_A_HOS_C1_66),No Description (E_A_HOS_C1_67),No Description (E_A_HOS_C1_71),No Description (E_A_HOS_C1_75),Excess of reasonable cost over reasonable charges (E_B_HOS_C1_20),Primary payer payments (E_B_HOS_C1_31),Ancillary service other pass through costs (E_B_HOS_C1_9),No Description (G3_C1_27),No Description (G3_C1_28),No Description (L_1_HOS_C1_1),No Description (L_1_HOS_C1_10),No Description (L_1_HOS_C1_11),No Description (L_1_HOS_C1_2),No Description (L_1_HOS_C1_3),No Description (L_1_HOS_C1_7),No Description (L_1_HOS_C1_8),No Description (L_1_HOS_C1_9),Stand-alone SCHIP Charges (S10_C1_10),No Description (S10_C1_11),No Description (S10_C1_5),Net Revenue from stand-alone SCHIP (S10_C1_9),In State Medicaid eligible days (S2_1_C2_24),Out of State Medicaid eligible days (S2_1_C4_24),HMO (S3_1_C6_2),AMOUNT REPORTED Physician Part A (S3_2_C2_22),AMOUNT REPORTED Physician Part B (S3_2_C2_23),AMOUNT REPORTED Physician-Part A (S3_2_C2_4),AMOUNT REPORTED Physician-Part B (S3_2_C2_5),ADJUSTED SALARIES Physician Part A (S3_2_C4_22),ADJUSTED SALARIES Physician Part B (S3_2_C4_23),ADJUSTED SALARIES Non-Physician Anesthetist Part B (S3_2_C4_3),ADJUSTED SALARIES Physician-Part A (S3_2_C4_4),ADJUSTED SALARIES Physician-Part B (S3_2_C4_5),PAID HOURS RELATED TO SALARIES Non-Physician Anesthetist Part B (S3_2_C5_3),PAID HOURS RELATED TO SALARIES Physician-Part A (S3_2_C5_4),PAID HOURS RELATED TO SALARIES Pharmacy (S3_2_C5_40),PAID HOURS RELATED TO SALARIES Physician-Part B (S3_2_C5_5),AVERAGE HOURLY WAGE Non-Physician Anesthetist Part B (S3_2_C6_3),AVERAGE HOURLY WAGE Physician-Part A (S3_2_C6_4),AVERAGE HOURLY WAGE Pharmacy (S3_2_C6_40),AVERAGE HOURLY WAGE Physician-Part B (S3_2_C6_5),PAID HOURS RELATED TO SALARIES Total (S3_3_C5_6),Column 2 (Purchases) Land Improvements (A7_1_C2_2),Interest Expense (A_C6_113),MSP-LCC reconciliation amount (E_B_HOS_C1_38),Column 3 (Donations) Total (A7_1_C3_10),Column 3 (Donations) Buildings and Fixtures (A7_1_C3_3),Column 3 (Donations) Building Improvements (A7_1_C3_4),Column 3 (Donations) Movable Equipment (A7_1_C3_6),Column 3 (Donations) Subtotal (A7_1_C3_8),Sale of medical and surgical supplies to (A8_C2_16),No Description (D_2_HOS_C5_92),No Description (S10_C1_22),No Description (S10_C2_22),No Description (S10_C3_22),In State Medicaid paid days (S2_1_C1_24),Number of periods hospital was in MDH status (S2_1_C1_37),Out of State Medicaid paid days (S2_1_C3_24),No Description (S3_1_C7_28),AMOUNT REPORTED Non-Physician Anesthetist Part A (S3_2_C2_2),AMOUNT REPORTED Non-Physician Anesthetist Part A (S3_2_C2_20),ADJUSTED SALARIES Non-Physician Anesthetist Part A (S3_2_C4_2),ADJUSTED SALARIES Non-Physician Anesthetist Part A (S3_2_C4_20),PAID HOURS RELATED TO SALARIES Non-Physician Anesthetist Part A (S3_2_C5_2),AVERAGE HOURLY WAGE Non-Physician Anesthetist Part A (S3_2_C6_2),No Description (S3_5_C1_1),No Description (S3_5_C1_2),Column 5 (Disposals and Retirements) Buildings and Fixtures (A7_1_C5_3),Subprovider-IRF (A_C1_41),SNF (A_C1_44),Subprovider-IRF (A_C2_41),SNF (A_C2_44),Subprovider-IPF (A_C6_40),Subprovider-IRF (A_C6_41),Net Expense for Cost Allocation Subprovider-IRF (B_1_C0_41),Subprovider-IRF (B_1_C26_41),TOTAL CAPITAL COSTS AFTER COST ALLOCATION Subprovider-IRF (B_2_C26_41),Subprovider-IRF (C_1_C5_41),Total Inpatient Charges Subprovider-IRF (C_1_C6_41),Program Inpatient Ancillary Service Cost (D1_IPF_C1_48),Pass Through Cost for  Program Ancillary (D1_IPF_C1_51),General Inpatient Routine Service Cost net of Swing Bed Cost (D1_IRF_C1_27),General Inpatient Routine Service Cost net of Swing Bed and Private Room Diff (D1_IRF_C1_37),Total Program General Inpatient Routine (D1_IRF_C1_41),Program Inpatient Ancillary Service Cost (D1_IRF_C1_48),Total Program Inpatient Costs (D1_IRF_C1_49),Pass through Cost for Program Inpatient (D1_IRF_C1_50),Pass Through Cost for  Program Ancillary (D1_IRF_C1_51),Total Program Excludable Costs (D1_IRF_C1_52),"Total Program Inpatient Operating Cost excluding Capital Related, Nonphysician Anesthetist, and Medical Education Costs (D1_IRF_C1_53)",TOTAL (D3_IPF_C2_200),Renal Dialysis (D3_IPF_C2_74),TOTAL (D3_IPF_C3_200),Renal Dialysis (D3_IPF_C3_74),TOTAL (D3_IRF_C2_200),Subprovider-IRF (D3_IRF_C2_41),Renal Dialysis (D3_IRF_C2_74),TOTAL (D3_IRF_C3_200),Renal Dialysis (D3_IRF_C3_74),Subprovider-IRF (D_1_HOS_C4_41),Subprovider-IRF (D_1_HOS_C6_41),Subprovider-IRF (D_1_HOS_C7_41),No Description (D_2_IPF_C5_200),No Description (D_2_IPF_C5_74),No Description (D_2_IRF_C5_200),No Description (D_2_IRF_C5_74),No Description (E3_2_IPF_C1_19),No Description (E3_2_IPF_C1_2),No Description (E3_2_IPF_C1_21),No Description (E3_2_IPF_C1_23),No Description (E3_2_IPF_C1_24),No Description (E3_2_IPF_C1_25),No Description (E3_2_IPF_C1_32),No Description (E3_3_IRF_C1_1),No Description (E3_3_IRF_C1_10),No Description (E3_3_IRF_C1_13),No Description (E3_3_IRF_C1_17),No Description (E3_3_IRF_C1_19),No Description (E3_3_IRF_C1_20),No Description (E3_3_IRF_C1_21),No Description (E3_3_IRF_C1_22),No Description (E3_3_IRF_C1_23),No Description (E3_3_IRF_C1_24),No Description (E3_3_IRF_C1_25),No Description (E3_3_IRF_C1_26),No Description (E3_3_IRF_C1_27),No Description (E3_3_IRF_C1_3),No Description (E3_3_IRF_C1_32),No Description (E3_3_IRF_C1_33),No Description (E3_3_IRF_C1_35),No Description (E3_3_IRF_C1_4),No Description (E4_C1_11),No Description (E4_C1_12),No Description (E4_C1_13),No Description (E4_C1_14),No Description (E4_C1_17),No Description (E4_C1_18),No Description (E4_C1_19),No Description (E4_C1_33),No Description (E4_C1_40),No Description (E4_C1_43),No Description (E4_C1_8),No Description (E4_C1_9),No Description (E4_C2_26),No Description (E4_C2_28),No Description (E4_C2_29),No Description (E4_C2_30),No Description (E_A_HOS_C1_10),No Description (E_A_HOS_C1_12),No Description (E_A_HOS_C1_13),No Description (E_A_HOS_C1_14),No Description (E_A_HOS_C1_15),No Description (E_A_HOS_C1_18),No Description (E_A_HOS_C1_19),No Description (E_A_HOS_C1_20),No Description (E_A_HOS_C1_21),No Description (E_A_HOS_C1_22),No Description (E_A_HOS_C1_24),No Description (E_A_HOS_C1_29),No Description (E_A_HOS_C1_3),No Description (E_A_HOS_C1_5),No Description (E_A_HOS_C1_52),No Description (E_A_HOS_C1_9),No Description (E_B_IRF_C1_17),No Description (L_1_HOS_C1_4),No Description (L_1_HOS_C1_5),No Description (L_1_HOS_C1_6),No Description (S10_C1_25),No Description (S3_1_C13_16),No Description (S3_1_C13_17),No Description (S3_1_C14_17),No Description (S3_1_C15_17),IRF (S3_1_C2_17),IRF (S3_1_C3_17),IRF (S3_1_C6_17),IRF (S3_1_C7_17),IRF (S3_1_C8_17),AMOUNT REPORTED SNF (S3_2_C2_9),ADJUSTED SALARIES Cafeteria (S3_2_C4_36),PAID HOURS RELATED TO SALARIES Cafeteria (S3_2_C5_36),AVERAGE HOURLY WAGE Cafeteria (S3_2_C6_36),Sale of drugs to other than patients (A8_C2_17),Ambulance Services (A_C1_95),Ambulance Services (A_C2_95),Net Expense for Cost Allocation SNF (B_1_C0_44),Net Expense for Cost Allocation Ambulance Services (B_1_C0_95),SNF (B_1_C26_44),Ambulance Services (B_1_C26_95),TOTAL CAPITAL COSTS AFTER COST ALLOCATION SNF (B_2_C26_44),Ambulance Services (B_2_C26_95),SNF (C_1_C5_44),Ambulance Services (C_1_C5_95),Total Inpatient Charges SNF (C_1_C6_44),Ambulance Services (C_1_C7_95),General Inpatient Routine Service Cost net of Swing Bed and Private Room Diff (D1_SNF_C1_37),Total Program General Inp. Rtn Service (D1_SNF_C1_74),Program Ancillary Services (D1_SNF_C1_84),No Description (D3_SNF_C2_200),TOTAL (D3_SNF_C2_202),TOTAL (D3_SNF_C3_200),No Description (E3_6_SNF_C1_1),No Description (E3_6_SNF_C1_10),No Description (E3_6_SNF_C1_12),No Description (E3_6_SNF_C1_15),No Description (E3_6_SNF_C1_16),No Description (E3_6_SNF_C1_18),No Description (E3_6_SNF_C1_4),No Description (E3_6_SNF_C1_7),No Description (E3_6_SNF_C1_8),No Description (E3_6_SNF_C1_9),Payment to cost ratio (E_B_HOS_C1_5),Line 2 times line 5 (E_B_HOS_C1_6),No Description (E_B_SNF_C1_17),No Description (G2_C1_3),No Description (G2_C1_7),No Description (G3_C1_17),No Description (H3_1_HHA1_C5_1),No Description (H3_1_HHA1_C5_2),No Description (H3_1_HHA1_C5_3),No Description (H3_1_HHA1_C5_4),No Description (H3_1_HHA1_C5_5),No Description (H3_1_HHA1_C5_6),No Description (H3_1_HHA1_C6_1),No Description (H3_1_HHA1_C6_2),No Description (H3_1_HHA1_C6_3),No Description (H3_1_HHA1_C6_4),No Description (H3_1_HHA1_C6_5),No Description (H3_1_HHA1_C6_6),No Description (H3_1_HHA1_C6_7),No Description (H3_1_HHA1_C7_1),No Description (H3_1_HHA1_C7_2),No Description (H3_1_HHA1_C7_3),No Description (H3_1_HHA1_C7_4),No Description (H3_1_HHA1_C7_5),No Description (H3_1_HHA1_C7_6),No Description (H3_1_HHA1_C7_7),No Description (H4_2_HHA1_C1_11),No Description (H4_2_HHA1_C1_12),No Description (H4_2_HHA1_C1_13),No Description (H4_2_HHA1_C1_14),No Description (H4_2_HHA1_C1_15),No Description (H4_2_HHA1_C1_16),No Description (H4_2_HHA1_C1_22),No Description (H4_2_HHA1_C1_24),No Description (H4_2_HHA1_C1_26),No Description (H4_2_HHA1_C1_29),No Description (H4_2_HHA1_C1_31),No Description (H4_2_HHA1_C1_32),No Description (H4_2_HHA1_C2_11),No Description (H4_2_HHA1_C2_12),No Description (H4_2_HHA1_C2_13),No Description (H4_2_HHA1_C2_14),No Description (H4_2_HHA1_C2_15),No Description (H4_2_HHA1_C2_22),No Description (H4_2_HHA1_C2_24),No Description (H4_2_HHA1_C2_26),No Description (H4_2_HHA1_C2_29),No Description (H4_2_HHA1_C2_31),No Description (H4_2_HHA1_C2_32),Medicaid HMO Days (S2_1_C5_24),SNF (S3_1_C10_19),SNF (S3_1_C2_19),SNF (S3_1_C3_19),SNF (S3_1_C6_19),SNF (S3_1_C7_19),SNF (S3_1_C8_19),ADJUSTED SALARIES SNF (S3_2_C4_9),PAID HOURS RELATED TO SALARIES Laundry and Linen Service (S3_2_C5_31),PAID HOURS RELATED TO SALARIES SNF (S3_2_C5_9),AVERAGE HOURLY WAGE Laundry and Linen Service (S3_2_C6_31),AVERAGE HOURLY WAGE SNF (S3_2_C6_9),HHA I Without Outliers:  Total Visits (S4_HHA1_C1_33),HHA I Without Outliers:  Total Charges (S4_HHA1_C1_35),HHA I W/Out Outliers:  Number of Episodes (S4_HHA1_C1_36),HHA I Without Outliers:  Non Routine Med Sup Chgs (S4_HHA1_C1_38),HHA I With Outliers:  Total Visits (S4_HHA1_C2_33),HHA I With Outliers:  Total Charges (S4_HHA1_C2_35),HHA I With Outliers:  Number of Episodes (S4_HHA1_C2_37),HHA I With Outliers:  Non Routine Med Sup Chgs (S4_HHA1_C2_38),HHA I LUPA Episodes:  Total Visits (S4_HHA1_C3_33),HHA I Total Charges:  LUPA Episodes (S4_HHA1_C3_35),HHA I LUPA Episodes:  Total Number of Episodes (S4_HHA1_C3_36),HHA I LUPA:  Total Non Routine Med Sup Chgs (S4_HHA1_C3_38),HHA I PEP Episodes:  Total Visits (S4_HHA1_C4_33),HHA I PEP Episodes:  Total Charges: (S4_HHA1_C4_35),HHA I PEP Episodes:  Total Number of Episodes (S4_HHA1_C4_36),HHA I Total Visits (S4_HHA1_C5_33),HHA I Total Charges (S4_HHA1_C5_35),HHA I Total Number of Episodes (S4_HHA1_C5_36),HHA I Total Number of Outlier Episodes (S4_HHA1_C5_37),HHA I Total Non Routine Medical  Supply Charges (S4_HHA1_C5_38),Kidney Acquisition (A_C1_105),Renal Dialysis (A_C1_74),Kidney Acquisition (A_C2_105),Pancreas Acquisition (A_C2_109),Kidney Acquisition (A_C6_105),Net Expense for Cost Allocation Kidney Acquisition (B_1_C0_105),Net Expense for Cost Allocation Pancreas Acquisition (B_1_C0_109),Allocation of Interns & Residents Program Costs Subprovider-IPF (B_1_C22_40),Kidney Acquisition (B_1_C26_105),Pancreas Acquisition (B_1_C26_109),Kidney Acquisition (B_2_C26_105),Pancreas Acquisition (B_2_C26_109),Kidney Acquisition (C_1_C5_105),Pancreas Acquisition (C_1_C5_109),Kidney Acquisition (C_1_C6_105),Organ Procurement (D4_KIDNEY_C1_69),Organ Procurement (D4_PANCREAS_C1_69),Total Allied Health Cost (D_3_HOS_C2_200),Total Costs (D_3_HOS_C5_200),Total (D_3_HOS_C9_200),Adults & Pediatrics (D_3_HOS_C9_30),No Description (E3_2_IPF_C1_17),No Description (E3_3_IRF_C1_2),No Description (E4_C1_2),No Description (E4_C1_21),No Description (E4_C1_38),No Description (E4_C1_4),No Description (E_A_HOS_C1_23),No Description (E_A_HOS_C1_25),No Description (E_A_HOS_C1_26),No Description (E_A_HOS_C1_27),No Description (E_A_HOS_C1_28),No Description (E_A_HOS_C1_55),No Description (E_A_HOS_C1_57),No Description (E_A_HOS_C1_6),No Description (E_A_HOS_C1_8),Outlier payments (E_B_HOS_C1_4),No Description (S3_1_C10_17),No Description (S3_1_C13_2),No Description (S3_1_C6_3),No Description (S3_1_C6_4),Labor and Delivery Days -  Title XIX (S3_1_C7_32),Labor and Delivery Days -  Title XIX (S3_1_C8_32),No Description (S3_1_C9_16),AMOUNT REPORTED Management and Administrative Services (S3_2_C2_12),ADJUSTED SALARIES Management and Administrative Services (S3_2_C4_12),PAID HOURS RELATED TO SALARIES Management and Administrative Services (S3_2_C5_12),AVERAGE HOURLY WAGE Management and Administrative Services (S3_2_C6_12),No Description (S3_5_C1_3),No Description (S3_5_C1_4),Negative Cost Centers (B_2_C26_201),Total Swing Bed Cost (D1_HOS_C1_26),No Description (E2_SWSNF_C1_1),No Description (E2_SWSNF_C1_10),No Description (E2_SWSNF_C1_12),No Description (E2_SWSNF_C1_13),No Description (E2_SWSNF_C1_15),No Description (E2_SWSNF_C1_17),No Description (E2_SWSNF_C1_18),No Description (E2_SWSNF_C1_19),No Description (E2_SWSNF_C1_20),No Description (E2_SWSNF_C1_22),No Description (E2_SWSNF_C1_5),No Description (E2_SWSNF_C1_8),"Sum of lines 3,4 divided by line 6 (E_B_HOS_C1_7)",Transitional corridor payment (E_B_HOS_C1_8),No Description (G2_C2_23),Hospital Adults & Ped Swing Bed SNF (S3_1_C6_5),Hospital Adlts & Ped Swing Bed SNF (S3_1_C8_5),Hospital Adlts & Ped Swing Bed NF (S3_1_C8_6),PAID HOURS RELATED TO SALARIES Admin & Gen Under Contract (S3_2_C5_29),AVERAGE HOURLY WAGE Admin & Gen Under Contract (S3_2_C6_29),No Description (G3_C1_20),HHA I PEP:  Total Non Routine Med Supply Chgs (S4_HHA1_C4_38),Investment Income-New Movable Equip (A8_C2_2),No Description (E2_SWSNF_C1_11),No Description (E3_6_SNF_C1_13),No Description (G2_C1_5),No Description (S10_C1_13),No Description (S10_C1_14),No Description (S10_C1_15),No Description (S10_C1_16),No Description (S3_1_C7_4),No Description (S3_5_C2_1),No Description (S3_5_C2_4),"Income from imposition of interest, finance (A8_C2_21)",Rental of Provider space by suppliers (A8_C2_6),Nursery (A_C6_43),No Description (G2_C1_37),No Description (G2_C2_42),AMOUNT REPORTED Administrative & General under contract (S3_2_C2_28),ADJUSTED SALARIES Administrative & General under contract (S3_2_C4_28),PAID HOURS RELATED TO SALARIES Administrative and General under Contract (S3_2_C5_28),AVERAGE HOURLY WAGE Administrative and General under Contract (S3_2_C6_28),Laundry and Linen Service (A8_C2_13),NF (A_C1_45),No Description (E2_SWSNF_C1_3),No Description (E3_5_C1_1),No Description (E3_5_C1_19),No Description (E3_5_C1_20),No Description (E3_5_C1_22),No Description (E3_5_C1_24),No Description (E3_5_C1_25),No Description (E3_5_C1_26),No Description (E3_5_C1_27),No Description (E3_5_C1_28),No Description (E3_5_C1_30),No Description (E3_5_C1_31),No Description (E3_5_C1_33),No Description (E3_5_C1_4),No Description (E3_5_C1_6),No Description (G3_C1_13),NF (S3_1_C10_20),NF (S3_1_C2_20),NF (S3_1_C3_20),Hospital Adults & Pediatrics (S3_1_C4_1),Total Hospital (S3_1_C4_14),Total Hospital (S3_1_C4_7),NF (S3_1_C7_20),NF (S3_1_C8_20),Column 5 (Disposals and Retirements) Fixed Equipment (A7_1_C5_5),Non-physician Anesthetist (A8_C2_28),SNF (A_C6_44),No Description (G2_C1_4),No Description (S10_C1_12),AMOUNT REPORTED Non-Physician Anesthetist Part B (S3_2_C2_3),Total (D_4_HOS_C1_200),Hospital Adlts & Ped Swing Bed SNF (S3_1_C7_5),AMOUNT REPORTED Wage Related Costs RHC/FQHC (S3_2_C2_24),AMOUNT REPORTED Non-Physician Part B (S3_2_C2_6),ADJUSTED SALARIES Wage Related Costs RHC/FQHC (S3_2_C4_24),ADJUSTED SALARIES Non-Physician Part B (S3_2_C4_6),PAID HOURS RELATED TO SALARIES Non-Physician Part B (S3_2_C5_6),AVERAGE HOURLY WAGE Non-Physician Part B (S3_2_C6_6),No Description (E_A_HOS_C101_41),No Description (E_A_HOS_C101_45),No Description (E_A_HOS_C1_40),No Description (E_A_HOS_C1_41),No Description (E_A_HOS_C1_42),No Description (E_A_HOS_C1_43),No Description (E_A_HOS_C1_44),No Description (E_A_HOS_C1_45),No Description (E_A_HOS_C1_46),Interest expense on Medicare Overpaymts (A8_C2_22),No Description (E3_5_C1_23),Ambulance Trips (S3_1_C6_29),Hospital Adlts & Ped Swing Bed NF (S3_1_C7_6),Ambulance Services (A_C6_95),RPCH/CAH Visits (S3_1_C6_15),RPCH/CAH Visits (S3_1_C7_15),CAH Visits (S3_1_C8_15),No Description (S3_1_C8_30),No Description (E3_3_HOS_C1_18),No Description (S10_C1_18),Ambulance Services (C_1_C6_95),No Description (G2_C1_23),HHA I Without Outliers:  Other Charges (S4_HHA1_C1_34),HHA I With Outliers:  Other Charges (S4_HHA1_C2_34),HHA I LUPA Episodes:  Other Charges (S4_HHA1_C3_34),HHA I PEP Episodes:  Other Charges (S4_HHA1_C4_34),HHA I Total Other Charges (S4_HHA1_C5_34),AMOUNT REPORTED Dietary under contract (S3_2_C2_35),ADJUSTED SALARIES Dietary under contract (S3_2_C4_35),Column 5 (Disposals and Retirements) Land Improvements (A7_1_C5_2),No Description (E3_2_HOS_C1_3),COST REIMBURSED SERVICES SUBJECT TO DEDUCTIBLES  AND COINSURANCE - CHARGES Ambulance Services (D_5_HOS_C3_95),COST SERVICES SUBJECT TO DEDUCTIBLES AND COINSURANCE - COST Ambulance Services (D_5_HOS_C6_95),No Description (G2_C1_6),No Description (S3_5_C1_14),No Description (E3_2_HOS_C1_17),No Description (H3_1_HHA1_C10_15),Column 7 (Fully Depreciated Assets) Begin Balance (A7_1_C1_7),Column 7 (Fully Depreciated Assets) Purchase (A7_1_C2_7),Column 7 (Fully Depreciated Assets) Total (A7_1_C4_7),Column 7 (Fully Depreciated Assets) Disp. And Retirement (A7_1_C5_7),Column 7 (Fully Depreciated Assets) Ending Balance (A7_1_C6_7),Column 5 (Disposals and Retirements) Land (A7_1_C7_1),Column 7 (Fully Depreciated Assets) Assets (A7_1_C7_7),Heart Acquisition (A_C1_106),Liver Acquisition (A_C1_107),Heart Acquisition (A_C2_106),Liver Acquisition (A_C2_107),Heart Acquisition (A_C6_106),Liver Acquisition (A_C6_107),Renal Dialysis (A_C6_74),Net Expense for Cost Allocation Heart Acquisition (B_1_C0_106),Net Expense for Cost Allocation Liver Acquisition (B_1_C0_107),Int & Res (non approved teaching program (B_1_C26_100),Heart Acquisition (B_1_C26_106),Liver Acquisition (B_1_C26_107),Int & Res (non approved teaching program (B_2_C26_100),Heart Acquisition (B_2_C26_106),Liver Acquisition (B_2_C26_107),Int & Res (non approved teaching program (C_1_C5_100),Heart Acquisition (C_1_C5_106),Liver Acquisition (C_1_C5_107),Heart Acquisition (C_1_C6_106),Liver Acquisition (C_1_C6_107),Pancreas Acquisition (C_1_C6_109),Kidney Acquisition (C_1_C7_105),Heart Acquisition (C_1_C7_106),Liver Acquisition (C_1_C7_107),Pancreas Acquisition (C_1_C7_109),Organ Procurement (D4_HEART_C1_69),Organ Procurement (D4_LIVER_C1_69),No Description (E4_C1_20),No Description (E4_C1_22),No Description (E4_C2_10),No Description (E_A_HOS_C1_11),No Description (E_A_HOS_C1_53),No Description (E_A_HOS_C1_90),No Description (E_A_HOS_C1_91),AMOUNT REPORTED Teaching Physician Salaries (S3_2_C2_16),AMOUNT REPORTED Interns & Residents (S3_2_C2_25),AMOUNT REPORTED Interns & Residents (S3_2_C2_7),ADJUSTED SALARIES Teaching Physician Salaries (S3_2_C4_16),ADJUSTED SALARIES Interns & Residents (S3_2_C4_25),ADJUSTED SALARIES Other General Service (S3_2_C4_43),ADJUSTED SALARIES Interns & Residents (S3_2_C4_7),PAID HOURS RELATED TO SALARIES Teaching Physician Salaries (S3_2_C5_16),PAID HOURS RELATED TO SALARIES Other General Service (S3_2_C5_43),PAID HOURS RELATED TO SALARIES Interns & Residents (S3_2_C5_7),AVERAGE HOURLY WAGE Teaching Physician Salaries (S3_2_C6_16),AVERAGE HOURLY WAGE Other General Service (S3_2_C6_43),AVERAGE HOURLY WAGE Interns & Residents (S3_2_C6_7),No Description (S3_5_C2_2),No Description (G2_C1_38),"Number of patients on transplant 
list (S5_C1_11)","Net costs of Epoietin furnished to
all maintenance dialysis patients
by the provider (S5_C1_13)",Number of EPO units furnished for Line 13 (S5_C1_15),Number of Times per week Patient receives Dialysis (S5_C1_2),"Average patient dialysis time 
including setup (S5_C1_3)","Number of days in year dialysis 
furnished (S5_C1_5)",Number of stations (S5_C1_6),"Treatment capacity per day per
station (S5_C1_7)",Utilization (S5_C1_8),"Number of patients in program at 
end of cost reporting period (S5_C2_1)",Home Program Dialysis (A_C2_94),No Description (G2_C1_39),"Number of patients transplanted 
during fiscal year (S5_C1_12)","Average patient dialysis time 
including setup (S5_C2_3)",Number of stations (S5_C4_6),No Description (H4_2_HHA1_C2_34),No Description (L_3_HOS_C1_1),No Description (L_3_HOS_C1_10),No Description (L_3_HOS_C1_12),No Description (L_3_HOS_C1_14),No Description (L_3_HOS_C1_3),No Description (L_3_HOS_C1_4),No Description (L_3_HOS_C1_5),No Description (L_3_HOS_C1_6),No Description (L_3_HOS_C1_8),No Description (L_3_HOS_C1_9),HHA I PEP:  Total Number of Outlier Episodes (S4_HHA1_C4_37),No Description (E3_2_HOS_C1_25),OLTC (A_C1_46),OLTC (A_C2_46),OLTC (A_C6_46),Net Expense for Cost Allocation OLTC (B_1_C0_46),OLTC (B_1_C26_46),TOTAL CAPITAL COSTS AFTER COST ALLOCATION OLTC (B_2_C26_46),OLTC (C_1_C5_46),Total Inpatient Charges OLTC (C_1_C6_46),No Description (G2_C1_9),OLTC (S3_1_C10_21),No Description (S3_1_C15_21),OLTC (S3_1_C2_21),OLTC (S3_1_C3_21),OLTC (S3_1_C8_21),No Description (E2_SWSNF_C1_21),No Description (E3_5_C1_32),No Description (G2_C2_25),No Description (G3_C1_8),Allocation of Interns & Residents Program Costs SNF (B_1_C22_44),No Description (E3_4_HOS_C1_18),No Description (E_B_SNF_C1_1),No Description (E_B_SNF_C1_11),No Description (E_B_SNF_C1_12),No Description (E_B_SNF_C1_14),No Description (E_B_SNF_C1_18),No Description (E_B_SNF_C1_20),No Description (E_B_SNF_C1_21),No Description (E_B_SNF_C1_27),No Description (E_B_SNF_C1_30),No Description (E_B_SNF_C1_32),No Description (E_B_SNF_C1_37),No Description (E_B_SNF_C1_40),No Description (E_B_SNF_C1_41),No Description (E_B_SNF_C1_43),SNF (S3_1_C9_19),Int & Res (non approved teaching program (A_C2_100),Net Expense for Cost Allocation Int & Res (non approved teaching program (B_1_C0_100),Subprovider I (A_C1_42),Subprovider I (A_C2_42),Subprovider I (A_C6_42),Net Expense for Cost Allocation Subprovider I (B_1_C0_42),Subprovider I (B_1_C26_42),TOTAL CAPITAL COSTS AFTER COST ALLOCATION Subprovider I (B_2_C26_42),Subprovider I (C_1_C5_42),Total Inpatient Charges Subprovider I (C_1_C6_42),Subprovider I (D_1_HOS_C4_42),No Description (S3_1_C15_18),Subprovider 1 (S3_1_C2_18),Subprovider 1 (S3_1_C3_18),Subprovider 1 (S3_1_C8_18),Cost of physicians svcs in a teaching hospita (E_B_HOS_C1_23),Adj for Physical therapy costs in excess (A8_C2_24),No Description (H4_2_HHA1_C1_30),No Description (S3_1_C12_1),No Description (S3_1_C12_14),Hospital Adults & Pediatrics (S3_1_C5_1),Total Hospital (S3_1_C5_14),Total Hospital (S3_1_C5_7),No Description (E3_5_C1_5),Physicians' Assistant (A8_C2_29),No Description (E_B_SNF_C1_19),Home Program Dialysis (A_C1_94),Net Expense for Cost Allocation Home Program Dialysis (B_1_C0_94),Home Program Dialysis (B_1_C26_94),Home Program Dialysis (B_2_C26_94),Home Program Dialysis (C_1_C5_94),Home Program Dialysis (C_1_C6_94),Home Program Dialysis (C_1_C7_94),COST REIMBURSED SERVICES NOT SUBJECT TO DEDUCTIBLES AND COINSURANCE - CHARGES Renal Dialysis (D_5_HOS_C4_74),COST SERVICES NOT SUBJECT TO DEDUCTIBLES AND COINSURANCE - COST Renal Dialysis (D_5_HOS_C7_74),Component rate ESRD (E_B_HOS_C1_33),Protested amounts (E_B_HOS_C1_44),No Description (G3_C1_12),No Description (S10_C1_17),"Number of Times per week
 Patient receives Dialysis (S5_C2_2)","Number of days in year dialysis 
furnished (S5_C2_5)",Number of stations (S5_C2_6),"Treatment capacity per day per
station (S5_C2_7)","Number of Times per week
 Patient receives Dialysis (S5_C4_2)","Average patient dialysis time 
including setup (S5_C4_3)","Number of patients in program at 
end of cost reporting period (S5_C6_1)","Number of Times per week
 Patient receives Dialysis (S5_C6_2)",CAPD exchanges per day (S5_C6_4),No Description (H4_2_HHA1_C1_34),No Description (H4_2_HHA1_C2_17),No Description (S3_1_C5_15),No Description (E_B_IPF_C1_2),No Description (E_B_IPF_C1_24),No Description (E_B_IPF_C1_26),No Description (E_B_IPF_C1_27),No Description (E_B_IPF_C1_3),No Description (E_B_IPF_C1_30),No Description (E_B_IPF_C1_32),No Description (E_B_IPF_C1_37),No Description (E_B_IPF_C1_40),No Description (E_B_IPF_C1_41),No Description (E_B_IPF_C1_5),No Description (E_B_IPF_C1_6),No Description (E_B_IPF_C1_7),No Description (S3_1_C7_3),No Description (G3_C1_19),No Description (E3_3_IRF_C1_36),PAID HOURS RELATED TO SALARIES Dietary under Contract (S3_2_C5_35),AVERAGE HOURLY WAGE Dietary under Contract (S3_2_C6_35),No Description (E_A_HOS_C1_73),No Description (E_B_SNF_C1_25),Int & Res (non approved teaching program (A_C6_100),Pancreas Acquisition (A_C1_109),Allocation of Interns & Residents Salary and Fringes Subprovider-IPF (B_1_C21_40),Allocation of Interns & Residents Salary and Fringes Subprovider-IRF (B_1_C21_41),Allocation of Interns & Residents Salary and Fringes Nursery (B_1_C21_43),Allocation of Interns & Residents Program Costs Subprovider-IRF (B_1_C22_41),Allocation of Interns & Residents Program Costs Nursery (B_1_C22_43),Subprovider-IPF (D_3_HOS_C9_40),Subprovider-IRF (D_3_HOS_C9_41),Total (D_4_IPF_C11_200),Total Allied Health (D_4_IPF_C3_200),Total Outpatient Program Pass Thru Cost (D_4_IPF_C6_200),Total (D_4_IRF_C11_200),Total Allied Health (D_4_IRF_C3_200),Total Outpatient Program Pass Thru Cost (D_4_IRF_C6_200),No Description (E3_2_IPF_C1_10),No Description (E3_2_IPF_C1_11),No Description (E3_2_IPF_C1_28),No Description (E3_2_IPF_C1_3),No Description (E3_2_IPF_C1_4),No Description (E3_2_IPF_C1_6),No Description (E3_2_IPF_C1_8),No Description (E3_3_IRF_C1_11),No Description (E3_3_IRF_C1_12),No Description (E3_3_IRF_C1_29),No Description (E3_3_IRF_C1_5),No Description (E3_3_IRF_C1_7),No Description (E3_3_IRF_C1_9),No Description (S3_1_C8_31),No Description (S3_1_C9_17),AMOUNT REPORTED Cafeteria (S3_2_C2_36),Other Capital (A_C6_3),Program Discharges (D1_HOS_C1_54),Target Amount per Discharge (D1_HOS_C1_55),Target Amount (D1_HOS_C1_56),Difference between Adjusted Inpatient Operating Cost and Target Amount (D1_HOS_C1_57),Bonus Payment (D1_HOS_C1_58),Allowable Inpatient Cost Plus Incentive Pt (D1_HOS_C1_63),No Description (E3_1_HOS_C1_1),No Description (E3_1_HOS_C1_10),No Description (E3_1_HOS_C1_14),No Description (E3_1_HOS_C1_15),No Description (E3_1_HOS_C1_18),No Description (E3_1_HOS_C1_19),No Description (E3_1_HOS_C1_20),No Description (E3_1_HOS_C1_21),No Description (E3_1_HOS_C1_4),No Description (E3_1_HOS_C1_6),No Description (E3_1_HOS_C1_7),No Description (E3_1_HOS_C1_8),No Description (E3_1_HOS_C1_9),No Description (E3_3_IRF_C1_50),AMOUNT REPORTED Home Office Personnel (S3_2_C2_8),ADJUSTED SALARIES Home Office Personnel (S3_2_C4_8),PAID HOURS RELATED TO SALARIES Home Office Personnel (S3_2_C5_8),AVERAGE HOURLY WAGE Home Office Personnel (S3_2_C6_8),No Description (E3_6_SNF_C1_17),No Description (E_B_SNF_C1_42),No Description (H4_2_HHA1_C2_16),SNF (S3_1_C11_19),No Description (G3_C1_9),Adults and Pediatrics (D3_SNF_C2_30),Total Other Medical Education (D_4_HOS_C4_200),Total Other Medical Education (D_4_IPF_C4_200),Total Other Medical Education (D_4_IRF_C4_200),No Description (E_B_IPF_C1_1),No Description (E_B_IPF_C1_11),No Description (E_B_IPF_C1_12),No Description (E_B_IPF_C1_14),No Description (E_B_IPF_C1_18),No Description (E_B_IPF_C1_19),No Description (E_B_IPF_C1_21),No Description (E_B_IPF_C1_43),No Description (E_B_IRF_C1_1),No Description (E_B_IRF_C1_11),No Description (E_B_IRF_C1_12),No Description (E_B_IRF_C1_14),No Description (E_B_IRF_C1_18),No Description (E_B_IRF_C1_19),No Description (E_B_IRF_C1_2),No Description (E_B_IRF_C1_21),No Description (E_B_IRF_C1_24),No Description (E_B_IRF_C1_26),No Description (E_B_IRF_C1_27),No Description (E_B_IRF_C1_3),No Description (E_B_IRF_C1_30),No Description (E_B_IRF_C1_32),No Description (E_B_IRF_C1_37),No Description (E_B_IRF_C1_40),No Description (E_B_IRF_C1_41),No Description (E_B_IRF_C1_43),"Number of patients in program at 
end of cost reporting period (S5_C1_1)","Percentage of patients re-using
dialyzers (S5_C1_10)",Average times dialyzers re-used (S5_C1_9),"Number of patients in program at 
end of cost reporting period (S5_C4_1)",SNF (D_3_HOS_C9_44),Renal Dialysis (D_4_HOS_C11_74),Renal Dialysis (D_4_HOS_C13_74),Total Nursing School (D_4_HOS_C2_200),Renal Dialysis (D_4_HOS_C3_74),Total Nursing School (D_4_IRF_C2_200),Total (D_4_SNF_C11_200),No Description (E3_6_SNF_C1_2),No Description (E3_6_SNF_C1_3),No Description (H3_1_HHA1_C10_16),No Description (H4_2_HHA1_C2_10),Adj for Occupational therapy in excess of li (A8_C2_30),No Description (E4_C1_24),Other Medicaid Days (S2_1_C6_24),No Description (G2_C1_40),Total Nonphysician Anesthetist Cost (D_4_IPF_C1_200),Nursing School (A8_C2_19),No Description (E3_4_HOS_C1_6),No Description (E4_C1_39),Column 5 (Disposals and Retirements) Land (A7_1_C5_1),No Description (H4_2_HHA1_C2_23),No Description (H4_2_HHA1_C2_33),No Description (E2_SWSNF_C1_9),Adj for Speech therapy in excess of lim (A8_C2_31),No Description (H4_2_HHA1_C2_21),No Description (H4_2_HHA1_C2_25),Column 3 (Donations) Fixed Equipment (A7_1_C3_5),No Description (E3_3_HOS_C1_29),No Description (E3_3_HOS_C1_34),No Description (G2_C1_35),No Description (H4_2_HHA1_C1_33),Subprovider II (A_C1_4201),Subprovider II (A_C2_4201),Subprovider II (A_C6_4201),Net Expense for Cost Allocation Subprovider II (B_1_C0_4201),Subprovider II (B_1_C26_4201),TOTAL CAPITAL COSTS AFTER COST ALLOCATION Subprovider II (B_2_C26_4201),Subprovider II (C_1_C5_4201),Total Inpatient Charges Subprovider II (C_1_C6_4201),No Description (E3_4_HOS_C1_20),No Description (E3_4_HOS_C1_51),No Description (E3_4_HOS_C1_52),No Description (E3_4_HOS_C1_53),Adj for Respiratory therapy costs in excess (A8_C2_23),PAID HOURS RELATED TO SALARIES Maintenance of Personnel (S3_2_C5_37),Subprovider-IPF (D3_HOS_C2_40),No Description (E4_C2_15),No Description (E_A_HOS_C1_16),No Description (S3_5_C2_8),Lung  Acquisition (A_C1_108),Lung  Acquisition (A_C2_108),Lung  Acquisition (A_C6_108),Pancreas Acquisition (A_C6_109),Net Expense for Cost Allocation Lung  Acquisition (B_1_C0_108),Renal Dialysis (B_1_C21_74),Lung  Acquisition (B_1_C26_108),Lung  Acquisition (B_2_C26_108),Lung  Acquisition (C_1_C5_108),Lung  Acquisition (C_1_C6_108),Home Program Dialysis (D3_HOS_C2_94),Home Program Dialysis (D3_HOS_C3_94),Organ Procurement (D4_LUNG_C1_69),No Description (D_2_HOS_C5_94),Home Program Dialysis (D_4_HOS_C11_94),Renal Dialysis (D_4_HOS_C2_74),Home Program Dialysis (D_4_HOS_C2_94),Total Nursing School (D_4_IPF_C2_200),Total (D_4_IRF_C13_200),No Description (E3_3_IRF_C1_18),No Description (E4_C1_32),No Description (E4_C1_34),No Description (E4_C1_401),No Description (E_A_HOS_C1_801),No Description (E_B_IRF_C1_31),No Description (E_B_IRF_C1_9),Utilization (S5_C2_8),Renal Dialysis (B_1_C22_74),AMOUNT REPORTED Housekeeping under contract (S3_2_C2_33),ADJUSTED SALARIES Housekeeping under contract (S3_2_C4_33),PAID HOURS RELATED TO SALARIES Housekeeping under Contract (S3_2_C5_33),AVERAGE HOURLY WAGE Housekeeping under Contract (S3_2_C6_33),No Description (S3_5_C1_8),No Description (S3_5_C2_3),Lung  Acquisition (C_1_C7_108),No Description (E_A_HOS_C1_7),AMOUNT REPORTED Physician Part A (S3_2_C2_2201),ADJUSTED SALARIES Physician Part A Teaching (S3_2_C4_2201),Nursery (S3_1_C5_13),No Description (E3_6_SNF_C1_19),No Description (S3_5_C1_11),No Description (S3_5_C2_11),Home Program Dialysis (A_C6_94),"Epoietin amount form worksheet A
for home dialysis program (S5_C1_14)",No Description (G2_C1_41),No Description (H4_2_HHA1_C1_17),No Description (E_B_SNF_C1_34),No Description (E_B_SNF_C1_35),No Description (E_B_SNF_C1_36),No Description (E3_2_HOS_C1_15),No Description (G2_C1_34),No Description (E4_C1_35),No Description (E3_2_HOS_C1_28),Net Expense for Cost Allocation PBP Clinical Lab Services Program Only (B_1_C0_61),PBP Clinical Lab Services Program Only (B_1_C26_61),PBP Clinical Lab Services Program Only (C_1_C5_61),Total Inpatient Charges PBP Clinical Lab Services Program Only (C_1_C6_61),Total Outpatient Charges PBP Clinical Lab Services Program Only (C_1_C7_61),Renal Dialysis (D3_SNF_C2_74),Renal Dialysis (D3_SNF_C3_74),CAPD exchanges per day (S5_C4_4),COST REIMBURSED SERVICES SUBJECT TO DEDUCTIBLES  AND COINSURANCE - CHARGES Home Program Dialysis (D_5_HOS_C3_94),No Description (E3_2_IPF_C1_35),No Description (E_B_IPF_C1_25),No Description (E_B_IRF_C1_25),No Description (G2_C1_25),No Description (H4_2_HHA1_C2_30),AMOUNT REPORTED Home Office:  Physician Part A (S3_2_C2_15),ADJUSTED SALARIES Home Office:  Physician Part A (S3_2_C4_15),PAID HOURS RELATED TO SALARIES Home Office:  Physician Part A (S3_2_C5_15),AVERAGE HOURLY WAGE Home Office:  Physician Part A (S3_2_C6_15),Interns and residents (E_B_HOS_C1_22),"Number of patients in program at 
end of cost reporting period (S5_C5_1)","Number of days in year dialysis 
furnished (S5_C5_2)",Allocation of Interns & Residents Salary and Fringes SNF (B_1_C21_44),Renal Dialysis (D_4_IRF_C11_74),Relief Payment (D1_HOS_C1_62),No Description (E3_1_HOS_C1_2),No Description (E3_1_HOS_C1_11),No Description (E3_1_HOS_C1_12),No Description (E3_1_HOS_C1_13),Total (D_4_IPF_C13_200),No Description (E4_C2_16),No Description (E_A_HOS_C1_802),No Description (E_B_IPF_C1_9),Column 3 (Donations) Land (A7_1_C3_1),No Description (E_B_SNF_C1_2),No Description (E_B_SNF_C1_26),Subprovider-IRF (D3_HOS_C2_41),Total Subprovider I Interns & Residents (S3_1_C10_18),No Description (S3_1_C14_18),Subprovider 1 (S3_1_C7_18),Intestinal Acquisition (A_C1_110),Intestinal Acquisition (A_C2_110),Net Expense for Cost Allocation Intestinal Acquisition (B_1_C0_110),Intestinal Acquisition (B_1_C26_110),Intestinal Acquisition (B_2_C26_110),Intestinal Acquisition (C_1_C6_110),Kidney Acquisition (B_1_C21_105),Liver Acquisition (B_1_C21_107),Kidney Acquisition (B_1_C22_105),Liver Acquisition (B_1_C22_107),No Description (L_2_HOS_C1_1),No Description (L_2_HOS_C1_2),No Description (L_2_HOS_C1_3),No Description (L_2_HOS_C1_4),No Description (L_2_HOS_C1_5),No Description (E3_2_IPF_C1_15),No Description (E_A_HOS_C1_56),No Description (E_B_IPF_C1_23),AMOUNT REPORTED Maintenance of Personnel (S3_2_C2_37),ADJUSTED SALARIES Maintenance of Personnel (S3_2_C4_37),AVERAGE HOURLY WAGE Maintenance of Personnel (S3_2_C6_37),No Description (H4_2_HHA1_C1_10),No Description (E3_2_IPF_C1_33),Int & Res (non approved teaching program (A_C1_100),No Description (E3_3_HOS_C1_50),No Description (E_A_HOS_C101_33),No Description (E_B_IRF_C1_4),Intestinal Acquisition (A_C6_110),Heart Acquisition (B_1_C22_106),Lung  Acquisition (B_1_C22_108),Pancreas Acquisition (B_1_C22_109),Intestinal Acquisition (B_1_C22_110),Intestinal Acquisition (C_1_C7_110),No Description (E_B_IPF_C1_42),No Description (E3_5_C1_29),No Description (E3_4_HOS_C1_26),No Description (E3_6_SNF_C1_6),No Description (E3_3_IRF_C1_16),No Description (E3_3_IRF_C1_34),No Description (E4_C1_402),No Description (E_B_IRF_C1_23),No Description (E_B_IRF_C1_42),No Description (E2_SWSNF_C1_23),No Description (E3_5_C1_34),No Description (S3_1_C12_16),IPF (S3_1_C5_16),No Description (E4_C1_16),No Description (E_A_HOS_C1_17),AMOUNT REPORTED Physician Part A (S3_2_C3_22),AMOUNT REPORTED Physician Part B (S3_2_C3_23),AMOUNT REPORTED Interns & Residents (S3_2_C3_25),Home Program Dialysis (D3_SNF_C2_94),Home Program Dialysis (D3_SNF_C3_94),Home Program Dialysis (D_4_HOS_C3_94),OLTC (S3_1_C11_21),No Description (S3_5_C1_17),No Description (E_A_HOS_C1_7098),Payment to cost ratio (E_B_HOS_C101_5),No Description (E_B_IPF_C1_34),No Description (E_B_IPF_C1_35),No Description (E_B_IRF_C1_5),No Description (E_B_IRF_C1_6),No Description (E_A_HOS_C101_1),No Description (E_A_HOS_C101_2),No Description (E_A_HOS_C101_34),No Description (E_A_HOS_C101_47),No Description (E_A_HOS_C1_701),No Description (E_B_IRF_C1_20),No Description (E_B_IRF_C1_7),No Description (S3_5_C1_13),No Description (S3_5_C2_13),No Description (E_B_IPF_C1_8),AMOUNT REPORTED Home Office Salaries & Wage Related Csts (S3_2_C3_14),No Description (H3_1_HHA2_C10_16),No Description (H3_1_HHA2_C5_1),No Description (H3_1_HHA2_C5_2),No Description (H3_1_HHA2_C5_3),No Description (H3_1_HHA2_C5_4),No Description (H3_1_HHA2_C5_6),No Description (H3_1_HHA2_C6_1),No Description (H3_1_HHA2_C6_2),No Description (H3_1_HHA2_C6_3),No Description (H3_1_HHA2_C6_4),No Description (H3_1_HHA2_C6_6),No Description (H3_1_HHA2_C6_7),No Description (H3_1_HHA2_C7_1),No Description (H3_1_HHA2_C7_2),No Description (H3_1_HHA2_C7_6),No Description (H3_1_HHA2_C7_7),No Description (H4_2_HHA2_C1_11),No Description (H4_2_HHA2_C1_13),No Description (H4_2_HHA2_C1_22),No Description (H4_2_HHA2_C1_24),No Description (H4_2_HHA2_C1_26),No Description (H4_2_HHA2_C1_29),No Description (H4_2_HHA2_C1_31),No Description (H4_2_HHA2_C1_32),No Description (H4_2_HHA2_C2_10),No Description (H4_2_HHA2_C2_11),No Description (H4_2_HHA2_C2_13),No Description (H4_2_HHA2_C2_22),No Description (H4_2_HHA2_C2_23),No Description (H4_2_HHA2_C2_24),No Description (H4_2_HHA2_C2_26),No Description (H4_2_HHA2_C2_29),No Description (H4_2_HHA2_C2_31),No Description (H4_2_HHA2_C2_32),HHA II Without Outliers:  Total Visits (S4_HHA2_C1_33),HHA II Without Outliers:  Total Charges (S4_HHA2_C1_35),HHA II W/Out Outliers:  Number of Episodes (S4_HHA2_C1_36),HHA II Without Outliers:  Non Routine Med Sup Chgs (S4_HHA2_C1_38),HHA II LUPA Episodes:  Total Visits (S4_HHA2_C3_33),HHA II Total Charges:  LUPA Episodes (S4_HHA2_C3_35),HHA II LUPA Episodes:  Total Number of Episodes (S4_HHA2_C3_36),HHA II Total Visits (S4_HHA2_C5_33),HHA II Total Charges (S4_HHA2_C5_35),HHA II Total Number of Episodes (S4_HHA2_C5_36),HHA II Total Non Routine Medical  Supply Charges (S4_HHA2_C5_38),Column 3 (Donations) Land Improvements (A7_1_C3_2),No Description (E3_3_IRF_C1_14),Allocation of Interns & Residents Salary and Fringes NF (B_1_C21_45),Allocation of Interns & Residents Program Costs NF (B_1_C22_45),NF (S3_1_C9_20),No Description (S3_5_C1_9),No Description (E4_C1_36),ESRD DME costs (E_B_HOS_C1_29),Subprovider-IRF (D3_IRF_C2_40),No Description (S3_5_C2_17),No Description (S3_5_C2_18),No Description (E_B_IPF_C1_31),Utilization Review-physicians compens (A8_C2_25),Utilization Review SNF (A_C6_114),Utilization Review - Physician Compen (D1_SNF_C1_85),No Description (E3_6_SNF_C1_11),ICF (A_C1_4501),ICF (A_C2_4501),Net Expense for Cost Allocation ICF (B_1_C0_4501),ICF (B_1_C26_4501),TOTAL CAPITAL COSTS AFTER COST ALLOCATION ICF (B_2_C26_4501),ICF (C_1_C5_4501),Total Inpatient Charges ICF (C_1_C6_4501),ICF (S3_1_C10_2001),ICF (S3_1_C2_2001),ICF (S3_1_C3_2001),ICF (S3_1_C8_2001),No Description (E_B_IRF_C1_34),No Description (E_B_IRF_C1_35),Ambulance Services (B_1_C21_95),Ambulance Services (B_1_C22_95),No Description (E_A_HOS_C1_51),No Description (L_3_HOS_C1_13),No Description (L_3_HOS_C1_15),No Description (L_3_HOS_C1_16),No Description (S3_1_C11_17),No Description (E1_2_HOS_C1_30),No Description (E1_2_HOS_C1_32),No Description (E3_3_HOS_C1_11),No Description (E3_3_HOS_C1_12),No Description (E3_3_HOS_C1_5),No Description (E3_3_HOS_C1_7),No Description (E3_3_HOS_C1_9),No Description (S3_5_C2_5),Allocation of Interns & Residents Salary and Fringes OLTC (B_1_C21_46),Allocation of Interns & Residents Program Costs OLTC (B_1_C22_46),OLTC (S3_1_C9_21),No Description (S3_5_C2_14),No Description (E_A_HOS_C101_48),Renal Dialysis (D_4_IPF_C11_74),Premiums (S2_1_C1_11801),Paid Losses (S2_1_C2_11801),Self Insurance (S2_1_C3_11801),No Description (S3_1_C10_23),"Percentage of patients re-using
dialyzers (S5_C2_10)",Average times dialyzers re-used (S5_C2_9),No Description (L_3_HOS_C1_11),No Description (E3_3_HOS_C1_28),No Description (E3_3_HOS_C1_30),No Description (E3_3_HOS_C1_51),No Description (E3_3_HOS_C1_52),No Description (E3_3_HOS_C1_53),No Description (S3_5_C1_18),"Number of patients in program at 
end of cost reporting period (S5_C3_1)","Number of Times per week 
Patient receives Dialysis (S5_C3_2)","Average patient dialysis time 
including setup (S5_C3_3)",Number of stations (S5_C3_6),Column 7 (Fully Depreciated Assets) Donations (A7_1_C3_7),Intestinal Acquisition (C_1_C5_110),ICF (S3_1_C7_2001),IRF (S3_1_C5_17),No Description (H3_1_HHA2_C7_3),No Description (H3_1_HHA2_C7_4),No Description (H4_2_HHA2_C1_14),No Description (H4_2_HHA2_C2_14),No Description (H4_2_HHA2_C2_34),HHA II LUPA:  Total Non Routine Med Sup Chgs (S4_HHA2_C3_38),HHA II PEP Episodes:  Total Visits (S4_HHA2_C4_33),HHA II PEP Episodes:  Total Charges: (S4_HHA2_C4_35),HHA II PEP Episodes:  Total Number of Episodes (S4_HHA2_C4_36),No Description (E_B_IPF_C1_36),No Description (S3_1_C13_18),ICF (A_C6_4501),No Description (E4_C1_15),No Description (E3_2_IPF_C1_7),Total Other Medical Education Cost (D_3_HOS_C3_200),Heart Acquisition (B_1_C21_106),Lung  Acquisition (B_1_C21_108),Pancreas Acquisition (B_1_C21_109),Renal Dialysis (D_4_IRF_C13_74),PBP Clinical Lab Services Program Only (A_C6_61),Islet Acquisition (A_C1_111),Islet Acquisition (A_C2_111),Net Expense for Cost Allocation Islet Acquisition (B_1_C0_111),Islet Acquisition (B_1_C26_111),Islet Acquisition (B_2_C26_111),Islet Acquisition (C_1_C5_111),Islet Acquisition (C_1_C6_111),No Description (S3_5_C1_6),No Description (S3_5_C2_6),COST SERVICES SUBJECT TO DEDUCTIBLES AND COINSURANCE - COST Home Program Dialysis (D_5_HOS_C6_94),No Description (E_A_HOS_C101_22),No Description (E_A_HOS_C101_29),No Description (E_A_HOS_C101_3),No Description (E3_1_HOS_C1_5),No Description (E_B_IPF_C1_22),No Description (E_B_IRF_C1_22),Subprovider-IRF (D3_IPF_C2_41),No Description (E3_3_IRF_C1_30),No Description (E3_3_IRF_C1_51),No Description (E3_3_IRF_C1_52),No Description (E3_3_IRF_C1_53),No Description (E_B_IPF_C1_4),No Description (S3_5_C2_9),No Description (S3_1_C11_16),Islet Acquisition (A_C6_111),Islet Acquisition (B_1_C22_111),Organ Procurement (D4_ISLET_C1_69),Organ Procurement (D4_INTESTINE_C1_69),Renal Dialysis (D_4_SNF_C11_74),Allocation of Interns & Residents Salary and Fringes Subprovider I (B_1_C21_42),No Description (H3_1_HHA2_C10_15),No Description (H3_1_HHA2_C5_5),No Description (H3_1_HHA2_C6_5),No Description (H3_1_HHA2_C7_5),HHA II PEP:  Total Non Routine Med Supply Chgs (S4_HHA2_C4_38),No Description (H4_2_HHA2_C2_12),No Description (H4_2_HHA2_C2_15),No Description (H4_2_HHA2_C2_33),HHA II With Outliers:  Total Visits (S4_HHA2_C2_33),HHA II With Outliers:  Total Charges (S4_HHA2_C2_35),HHA II With Outliers:  Number of Episodes (S4_HHA2_C2_37),HHA II Total Number of Outlier Episodes (S4_HHA2_C5_37),No Description (S3_1_C12_17),No Description (E_B_IPF_C1_20),No Description (E3_2_IPF_C1_29),Labor and Delivery Days Title 18 (S3_1_C6_32),No Description (E_A_HOS_C1_201),No Description (E_A_HOS_C1_69),No Description (E_A_HOS_C1_92),No Description (E_A_HOS_C1_94),No Description (E_A_HOS_C1_95),No Description (E_A_HOS_C1_96),Organ acquisition (E_B_HOS_C1_10),Organ acquisition charges (E_B_HOS_C1_13),No Description (S10_C1_2701),AMOUNT REPORTED Physician Part A Teaching (S3_2_C3_2201),No Description (E3_4_HOS_C1_50),Aggregate amount collected from patients (E_B_HOS_C1_15),Amounts expected under 42 CFR (E_B_HOS_C1_16),Medical and Other Services reimbursed by OPPS (E_B_HOS_C101_2),Renal Dialysis (D_4_IPF_C13_74),No Description (E_B_IPF_C1_38),No Description (E_B_IRF_C1_36),No Description (G3_C0_2450),HHA 3 Provider Number (S2_1_C2_1202),ASC 1 Provider Number (S2_1_C2_13),RHC 11 Provider Number (S2_1_C2_1510),RHC 12 Provider Number (S2_1_C2_1511),RHC 13 Provider Number (S2_1_C2_1512),RHC 14 Provider Number (S2_1_C2_1513),RHC 15 Provider Number (S2_1_C2_1514),RHC 16 Provider Number (S2_1_C2_1515),RHC 17 Provider Number (S2_1_C2_1516),RHC 18 Provider Number (S2_1_C2_1517),RHC 19 Provider Number (S2_1_C2_1518),RHC 20 Provider Number (S2_1_C2_1519),RHC 21 Provider Number (S2_1_C2_1520),RHC 22 Provider Number (S2_1_C2_1521),RHC 23 Provider Number (S2_1_C2_1522),RHC 24 Provider Number (S2_1_C2_1523),RHC 25 Provider Number (S2_1_C2_1524),FQHC 2 Provider Number (S2_1_C2_1601),FQHC 3 Provider Number (S2_1_C2_1602),FQHC 4 Provider Number (S2_1_C2_1603),FQHC 5 Provider Number (S2_1_C2_1604),FQHC 6 Provider Number (S2_1_C2_1605),FQHC 7 Provider Number (S2_1_C2_1606),FQHC 8 Provider Number (S2_1_C2_1607),FQHC 9 Provider Number (S2_1_C2_1608),Beginning Date of SCH status (S2_1_C1_3601),Ending Date of SCH status (S2_1_C2_3601),MDH status beginning date  (MM/DD/YY) (S2_1_C1_3801),MDH status ending date (MM/DD/YY) (S2_1_C2_3801),Medicare Certified Pancreas TC term date (S2_1_C2_130),Medicare Certified Islet TC term date (S2_1_C2_132),Hospital Street Address (S2_1_C1_1),Hospital City (S2_1_C1_2),Hospital Zip Code (S2_1_C3_2),Hospital County (S2_1_C4_2),Hospital Name (S2_1_C1_3),Provider's actual MSA or CBSA (S2_1_C3_3),Hospital Title 18 Payment System (P/T/O) (S2_1_C7_3),Type of Control of Hospital (See Table I) (S2_1_C1_21),"Does the facility qualify and is it receiving payments for 
disproportionate share? (Y/N) (S2_1_C1_22)","Is this a New Hospital under
42 CFR 412.300 PPS capital
(Y/N) (S2_1_C1_47)",Does the hospital elect a fully prospective payment method for capital costs? (Y/N) (S2_1_C1_48),"Is this a teaching hospital or
affiliated with a teaching hospital? (Y/N) (S2_1_C1_56)",or allied health costs? (S2_1_C1_60),Is this a New Hospital under 42 CFR 413.40(f)(1)(I) (TEFRA)? (Y/N) (S2_1_C1_85),Have you established a new subprovider excluded unit under 42 CFR 413.40(f)(1)(I)?(Y/N) (S2_1_C1_86),Does the facility operate an ICF/MR facility for purposes of Title XIX? (Y/N) (S2_1_C1_93),Does the hospital qualify as RPCH/CAH? (Y/N) (S2_1_C1_105),"If this facility qualifies as a RPCH/CAH, has it elected the all inclusive payment for outpatient service? (Y/N) (S2_1_C1_106)",No Description (S2_1_C1_107),Is this a rural hospital qualifying for an exception to the certified registered nurse anesthetist the CRNA fee schedule? (Y/N) (S2_1_C1_108),Is this hospital an All-Inclusive rate provider? (Y/N) (S2_1_C1_115),Is this hospital classified as a referral center? (Y/N) (S2_1_C1_116),"Does this facility operate 
transplant center? (Y/N) (S2_1_C1_125)","Are there any related organization or how office costs as defined in HCFA Pub. 15-I, chapter 10? (Y/N) (S2_1_C1_140)",Are provider based physicians' costs included in Worksheet A? (Y/N) (S2_1_C1_144),"If this Hospital is claiming cost for renal services on Worksheet A, are they inpatient services only? (Y/N) (S2_1_C1_145)",IPF Provider Number (S2_1_C1_4),IPF Provider Number (S2_1_C2_4),FI/Contractor's Name (S2_1_C2_140),Home Office Name (S2_1_C1_141),Home Office Street (S2_1_C1_142),City (S2_1_C1_143),State (S2_1_C2_143),Zip Code (S2_1_C3_143),"If Line 32, Col 1 is yes, enter the method used: (A, B, or E only) (S2_1_C2_115)",No Description (S10_C1_3),Hospital PO Box (S2_1_C2_1),NF Provider Number (S2_1_C2_10),No Description (S10_C1_4),No Description (S10_C1_24),Swing Bed SNF Provider Number (S2_1_C2_7),MDH status beginning date (MM/DD/YY) (S2_1_C1_38),MDH status ending date (MM/DD/YY) (S2_1_C2_38),IRF Provider Number (S2_1_C1_5),IRF Provider Number (S2_1_C2_5),SNF Provider Number (S2_1_C2_9),HHA 1 Provider Number (S2_1_C2_12),Hospice 1 Provider Number (S2_1_C2_14),Beginning Date of SCH status (S2_1_C1_36),Ending Date of SCH status (S2_1_C2_36),"Medicare certified kidney 
transplant center cert date (S2_1_C1_126)",Swing Bed NF Provider Number (S2_1_C2_8),RHC 1 Provider Number (S2_1_C2_15),RHC 2 Provider Number (S2_1_C2_1501),No Description (S2_1_C2_107),Home Office PO Box (S2_1_C2_142),Renal 1 Provider Number (S2_1_C2_18),RHC 3 Provider Number (S2_1_C2_1502),RHC 4 Provider Number (S2_1_C2_1503),RHC 5 Provider Number (S2_1_C2_1504),MCP Physician Payment Method (Y/N) (S5_C1_21),"Medicare certified heart
transplant center cert date (S2_1_C1_127)","Medical certified liver 
transplant center cert date (S2_1_C1_128)",Renal 2 Provider Number (S2_1_C2_1801),Hospice 2 Provider Number (S2_1_C2_1401),Initial Physician Payment Method (Y/N) (S5_C2_21),"Medical certified lung
transplant center cert date (S2_1_C1_129)","If an Organ Procurement Organization, enter the OPO number (S2_1_C1_134)",CMHC 1 Provider Number (S2_1_C2_17),certification date (S2_1_C1_131),RHC 6 Provider Number (S2_1_C2_1505),RHC 7 Provider Number (S2_1_C2_1506),RHC 8 Provider Number (S2_1_C2_1507),RHC 9 Provider Number (S2_1_C2_1508),RHC 10 Provider Number (S2_1_C2_1509),Renal 3 Provider Number (S2_1_C2_1802),Renal 4 Provider Number (S2_1_C2_1803),Renal 5 Provider Number (S2_1_C2_1804),HHA 2 Provider Number (S2_1_C2_1201),Medicare Certified Kidney TC term date (S2_1_C2_126),Medicare Certified Heart TC term date (S2_1_C2_127),Medicare Certified Liver TC term date (S2_1_C2_128),Renal 6 Provider Number (S2_1_C2_1805),FQHC 1 Provider Number (S2_1_C2_16),ICF Provider Number (S2_1_C2_1001),Renal 7 Provider Number (S2_1_C2_1806),Renal 8 Provider Number (S2_1_C2_1807),Renal 9 Provider Number (S2_1_C2_1808),Renal 10 Provider Number (S2_1_C2_1809),certification date (S2_1_C1_132),Medicare Certified Lung TC term date (S2_1_C2_129),Blood Clotting Factors for Hemoph. (A_C1_6250),Blood Clotting Factors for Hemoph. (A_C2_6250),Net Expense for Cost Allocation Blood Clotting Factors for Hemoph. (B_1_C0_6250),HHA (B_1_C21_101),ASC (Distinct Part) (B_1_C21_115),Hospice (B_1_C21_116),FQHC (B_1_C21_89),CMHC (B_1_C21_99),HHA (B_1_C22_101),ASC (Distinct Part) (B_1_C22_115),Hospice (B_1_C22_116),FQHC (B_1_C22_89),CMHC (B_1_C22_99),Blood Clotting Factors for Hemoph. (B_1_C26_6250),TOTAL CAPITAL COSTS AFTER COST ALLOCATION Blood Clotting Factors for Hemoph. (B_2_C26_6250),Respiratory Therapy (C_1_C2_65),Occupational Therapy (C_1_C2_67),Speech Pathology (C_1_C2_68),Blood Clotting Factors for Hemoph. (C_1_C5_6250),OPT (C_1_C6_9920),OOT (C_1_C6_9930),OSP (C_1_C6_9940),Total Outpatient Charges Blood Clotting Factors for Hemoph. (C_1_C7_6250),FQHC (C_1_C7_89),Blood Clotting Factors for Hemoph. (D3_HOS_C3_6250),Coronary Care Unit (D3_SNF_C2_32),Surgical Intensive Care Unit (D3_SNF_C2_34),Other Special Care Unit (D3_SNF_C2_35),Durable Medical Equipment Rented (D3_SNF_C2_96),Durable Medical Equipment Rented (D3_SNF_C3_96),No Description (D_2_HOS_C5_6250),Blood Clotting Factors for Hemoph. (D_4_HOS_C12_6250),Drugs Charged to Patients (D_4_HOS_C1_73),Other Ancillary (D_4_HOS_C1_76),Emergency (D_4_HOS_C1_91),Radioisotope (D_4_HOS_C2_56),Whole Blood & Packed Red Blood Cells (D_4_HOS_C2_62),Occupational Therapy (D_4_HOS_C2_67),Speech Pathology (D_4_HOS_C2_68),Medical Supplies Charged to Patients (D_4_HOS_C2_71),Impl. Dev. Charged to Patients (D_4_HOS_C2_72),Blood Clotting Factors for Hemoph. (D_4_HOS_C3_6250),RHC (D_4_HOS_C3_88),FQHC (D_4_HOS_C3_89),Other Reimbursable (D_4_HOS_C3_98),Delivery Room and Labor Room (D_4_HOS_C4_52),Anesthesiology (D_4_HOS_C4_53),Radiology-Therapeutic (D_4_HOS_C4_55),Radioisotope (D_4_HOS_C4_56),Cardiac Catheterization (D_4_HOS_C4_59),Laboratory (D_4_HOS_C4_60),Intravenous Therapy (D_4_HOS_C4_64),Physical Therapy (D_4_HOS_C4_66),Occupational Therapy (D_4_HOS_C4_67),Speech Pathology (D_4_HOS_C4_68),Electrocardiology (D_4_HOS_C4_69),Electroencephalography (D_4_HOS_C4_70),Medical Supplies Charged to Patients (D_4_HOS_C4_71),Impl. Dev. Charged to Patients (D_4_HOS_C4_72),Drugs Charged to Patients (D_4_HOS_C4_73),Other Ancillary (D_4_HOS_C4_76),RHC (D_4_HOS_C4_88),FQHC (D_4_HOS_C4_89),Other Outpatient Services (D_4_HOS_C4_93),Medical Supplies Charged to Patients (D_4_IPF_C11_71),Recovery Room (D_4_IPF_C13_51),Radiology-Therapeutic (D_4_IPF_C13_55),Radioisotope (D_4_IPF_C13_56),MRI (D_4_IPF_C13_58),Cardiac Catheterization (D_4_IPF_C13_59),Whole Blood & Packed Red Blood Cells (D_4_IPF_C13_62),"Blood Storing, Processing, Trans (D_4_IPF_C13_63)",Intravenous Therapy (D_4_IPF_C13_64),Respiratory Therapy (D_4_IPF_C13_65),Physical Therapy (D_4_IPF_C13_66),Occupational Therapy (D_4_IPF_C13_67),Speech Pathology (D_4_IPF_C13_68),ASC (Non Distinct Part) (D_4_IPF_C13_75),Other Ancillary (D_4_IPF_C13_76),Observation Beds (Distinct Unit) (D_4_IPF_C13_9201),Other Outpatient Services (D_4_IPF_C13_93),Recovery Room (D_4_IRF_C13_51),Anesthesiology (D_4_IRF_C13_53),Radiology-Therapeutic (D_4_IRF_C13_55),CT Scan (D_4_IRF_C13_57),MRI (D_4_IRF_C13_58),Cardiac Catheterization (D_4_IRF_C13_59),Whole Blood & Packed Red Blood Cells (D_4_IRF_C13_62),"Blood Storing, Processing, Trans (D_4_IRF_C13_63)",Physical Therapy (D_4_IRF_C13_66),Speech Pathology (D_4_IRF_C13_68),Electroencephalography (D_4_IRF_C13_70),Medical Supplies Charged to Patients (D_4_IRF_C13_71),Impl. Dev. Charged to Patients (D_4_IRF_C13_72),ASC (Non Distinct Part) (D_4_IRF_C13_75),Other Ancillary (D_4_IRF_C13_76),Delivery Room and Labor Room (D_4_SNF_C11_52),MRI (D_4_SNF_C11_58),Whole Blood & Packed Red Blood Cells (D_4_SNF_C11_62),Intravenous Therapy (D_4_SNF_C11_64),Electrocardiology (D_4_SNF_C11_69),Impl. Dev. Charged to Patients (D_4_SNF_C11_72),ASC (Non Distinct Part) (D_4_SNF_C11_75),Observation Beds (Distinct Unit) (D_4_SNF_C11_9201),Drugs Charged to Patients (D_4_SNF_C13_73),PPS REIMBURSED SERVICES -  CHARGES Blood Clotting Factors for Hemoph. (D_5_HOS_C2_6250),COST REIMBURSED SERVICES SUBJECT TO DEDUCTIBLES  AND COINSURANCE - CHARGES Blood Clotting Factors for Hemoph. (D_5_HOS_C3_6250),COST REIMBURSED SERVICES NOT SUBJECT TO DEDUCTIBLES AND COINSURANCE - CHARGES Durable Medical Equipment Rented (D_5_HOS_C4_96),COST REIMBURSED SERVICES NOT SUBJECT TO DEDUCTIBLES AND COINSURANCE - CHARGES Other Reimbursable (D_5_HOS_C4_98),PPS SERVICES COST Blood Clotting Factors for Hemoph. (D_5_HOS_C5_6250),COST SERVICES SUBJECT TO DEDUCTIBLES AND COINSURANCE - COST Blood Clotting Factors for Hemoph. (D_5_HOS_C6_6250),COST SERVICES NOT SUBJECT TO DEDUCTIBLES AND COINSURANCE - COST Durable Medical Equipment Rented (D_5_HOS_C7_96),COST SERVICES NOT SUBJECT TO DEDUCTIBLES AND COINSURANCE - COST Other Reimbursable (D_5_HOS_C7_98),No Description (E_B_SNF_C1_39),Outpatient Rehab Provider (S3_1_C11_25),Burn Intensive Care Unit (S3_1_C4_10),Surgical Intensive Care Unit (S3_1_C4_11),No Description (S3_1_C5_22),No Description (S3_1_C5_26),CMHC (S3_1_C6_25),Outpatient Rehab Provider (S3_1_C7_25),Outpatient Rehab Provider (S3_1_C8_25),HHA (S3_1_C9_22),Column 10 (Lease) New Cap Related Csts Bldg & Fixtures (A7_3_C10_1),Column 10 (Lease) New Cap Related Csts Movable Equipment (A7_3_C10_2),Column 15 (Total) New Cap Related Csts Bldg & Fixtures (A7_3_C15_1),Column 15 (Total) New Cap Related Csts Movable Equipment (A7_3_C15_2),Column 9 (Depreciation) New Cap Related Csts Bldg & Fixtures (A7_3_C9_1),Column 9 (Depreciation) New Cap Related Csts Movable Equipment (A7_3_C9_2),Other Adjustments (Summed) (A8_C2_33),Pharmacy (A_C1_15),Medical Records and Medical Rec. Library (A_C1_16),Social Service (A_C1_17),Administrative and General (A_C1_5),Respiratory Therapy (A_C1_65),Physical Therapy (A_C1_66),Occupational Therapy (A_C1_67),Electrocardiology (A_C1_69),Housekeeping (A_C1_9),New Capital Buildings and Fixtures (A_C2_1),Dietary (A_C2_10),Pharmacy (A_C2_15),Medical Records and Medical Rec. Library (A_C2_16),Social Service (A_C2_17),New Capital Equipment (A_C2_2),Employee Benefits (A_C2_4),Administrative and General (A_C2_5),Operating Room (A_C2_50),Recovery Room (A_C2_51),Anesthesiology (A_C2_53),Radiology-Diagnostic (A_C2_54),Radiology-Therapeutic (A_C2_55),Laboratory (A_C2_60),"Blood Storing, Processing, Trans (A_C2_63)",Respiratory Therapy (A_C2_65),Physical Therapy (A_C2_66),Occupational Therapy (A_C2_67),Speech Pathology (A_C2_68),Electrocardiology (A_C2_69),Operation of Plant (A_C2_7),Electroencephalography (A_C2_70),Medical Supplies Charged to Patients (A_C2_71),Drugs Charged to Patients (A_C2_73),Housekeeping (A_C2_9),Pharmacy (A_C6_15),Medical Records and Medical Rec. Library (A_C6_16),Social Service (A_C6_17),Administrative and General (A_C6_5),Net Expense for Cost Allocation New Capital Buildings and Fixtures (B_1_C0_1),Net Expense for Cost Allocation Dietary (B_1_C0_10),Net Expense for Cost Allocation Pharmacy (B_1_C0_15),Net Expense for Cost Allocation Medical Records and Medical Rec. Library (B_1_C0_16),Net Expense for Cost Allocation Social Service (B_1_C0_17),Net Expense for Cost Allocation New Capital Equipment (B_1_C0_2),Net Expense for Cost Allocation Employee Benefits (B_1_C0_4),Net Expense for Cost Allocation Administrative and General (B_1_C0_5),Net Expense for Cost Allocation Operating Room (B_1_C0_50),Net Expense for Cost Allocation Recovery Room (B_1_C0_51),Net Expense for Cost Allocation Anesthesiology (B_1_C0_53),Net Expense for Cost Allocation Radiology-Diagnostic (B_1_C0_54),Net Expense for Cost Allocation Radiology-Therapeutic (B_1_C0_55),Net Expense for Cost Allocation CT Scan (B_1_C0_57),Net Expense for Cost Allocation MRI (B_1_C0_58),Net Expense for Cost Allocation Laboratory (B_1_C0_60),"Net Expense for Cost Allocation Blood Storing, Processing, Trans (B_1_C0_63)",Net Expense for Cost Allocation Intravenous Therapy (B_1_C0_64),Net Expense for Cost Allocation Respiratory Therapy (B_1_C0_65),Net Expense for Cost Allocation Physical Therapy (B_1_C0_66),Net Expense for Cost Allocation Occupational Therapy (B_1_C0_67),Net Expense for Cost Allocation Speech Pathology (B_1_C0_68),Net Expense for Cost Allocation Electrocardiology (B_1_C0_69),Net Expense for Cost Allocation Operation of Plant (B_1_C0_7),Net Expense for Cost Allocation Electroencephalography (B_1_C0_70),Net Expense for Cost Allocation Medical Supplies Charged to Patients (B_1_C0_71),Net Expense for Cost Allocation Impl. Dev. Charged to Patients (B_1_C0_72),Net Expense for Cost Allocation Drugs Charged to Patients (B_1_C0_73),Net Expense for Cost Allocation Housekeeping (B_1_C0_9),Net Expense for Cost Allocation Clinic (B_1_C0_90),Net Expense for Cost Allocation Emergency (B_1_C0_91),Operating Room (B_1_C26_50),Recovery Room (B_1_C26_51),Anesthesiology (B_1_C26_53),Radiology-Diagnostic (B_1_C26_54),Radiology-Therapeutic (B_1_C26_55),CT Scan (B_1_C26_57),MRI (B_1_C26_58),Laboratory (B_1_C26_60),"Blood Storing, Processing, Trans (B_1_C26_63)",Intravenous Therapy (B_1_C26_64),Respiratory Therapy (B_1_C26_65),Physical Therapy (B_1_C26_66),Occupational Therapy (B_1_C26_67),Speech Pathology (B_1_C26_68),Electrocardiology (B_1_C26_69),Electroencephalography (B_1_C26_70),Medical Supplies Charged to Patients (B_1_C26_71),Impl. Dev. Charged to Patients (B_1_C26_72),Drugs Charged to Patients (B_1_C26_73),Clinic (B_1_C26_90),Emergency (B_1_C26_91),TOTAL CAPITAL COSTS AFTER COST ALLOCATION Operating Room (B_2_C26_50),TOTAL CAPITAL COSTS AFTER COST ALLOCATION Recovery Room (B_2_C26_51),TOTAL CAPITAL COSTS AFTER COST ALLOCATION Anesthesiology (B_2_C26_53),TOTAL CAPITAL COSTS AFTER COST ALLOCATION Radiology-Diagnostic (B_2_C26_54),TOTAL CAPITAL COSTS AFTER COST ALLOCATION Radiology-Therapeutic (B_2_C26_55),TOTAL CAPITAL COSTS AFTER COST ALLOCATION CT Scan (B_2_C26_57),TOTAL CAPITAL COSTS AFTER COST ALLOCATION MRI (B_2_C26_58),TOTAL CAPITAL COSTS AFTER COST ALLOCATION Laboratory (B_2_C26_60),"Blood Storing, Processing, Trans (B_2_C26_63)",Intravenous Therapy (B_2_C26_64),Respiratory Therapy (B_2_C26_65),Physical Therapy (B_2_C26_66),Occupational Therapy (B_2_C26_67),Speech Pathology (B_2_C26_68),Electrocardiology (B_2_C26_69),Electroencephalography (B_2_C26_70),Medical Supplies Charged to Patients (B_2_C26_71),Impl. Dev. Charged to Patients (B_2_C26_72),Drugs Charged to Patients (B_2_C26_73),Clinic (B_2_C26_90),Emergency (B_2_C26_91),Operating Room (C_1_C5_50),Recovery Room (C_1_C5_51),Anesthesiology (C_1_C5_53),Radiology-Diagnostic (C_1_C5_54),Radiology-Therapeutic (C_1_C5_55),CT Scan (C_1_C5_57),MRI (C_1_C5_58),Laboratory (C_1_C5_60),"Blood Storing, Processing, Trans (C_1_C5_63)",Intravenous Therapy (C_1_C5_64),Respiratory Therapy (C_1_C5_65),Physical Therapy (C_1_C5_66),Occupational Therapy (C_1_C5_67),Speech Pathology (C_1_C5_68),Electrocardiology (C_1_C5_69),Electroencephalography (C_1_C5_70),Medical Supplies Charged to Patients (C_1_C5_71),Impl. Dev. Charged to Patients (C_1_C5_72),Drugs Charged to Patients (C_1_C5_73),Clinic (C_1_C5_90),Emergency (C_1_C5_91),Total Inpatient Charges Operating Room (C_1_C6_50),Total Inpatient Charges Recovery Room (C_1_C6_51),Total Inpatient Charges Anesthesiology (C_1_C6_53),Total Inpatient Charges Radiology-Diagnostic (C_1_C6_54),Total Inpatient Charges Radiology-Therapeutic (C_1_C6_55),Total Inpatient Charges CT Scan (C_1_C6_57),Total Inpatient Charges MRI (C_1_C6_58),Total Inpatient Charges Laboratory (C_1_C6_60),"Blood Storing, Processing, Trans (C_1_C6_63)",Intravenous Therapy (C_1_C6_64),Respiratory Therapy (C_1_C6_65),Physical Therapy (C_1_C6_66),Occupational Therapy (C_1_C6_67),Speech Pathology (C_1_C6_68),Electrocardiology (C_1_C6_69),Electroencephalography (C_1_C6_70),Medical Supplies Charged to Patients (C_1_C6_71),Impl. Dev. Charged to Patients (C_1_C6_72),Drugs Charged to Patients (C_1_C6_73),Clinic (C_1_C6_90),Emergency (C_1_C6_91),Operating Room (D3_HOS_C2_50),Recovery Room (D3_HOS_C2_51),Anesthesiology (D3_HOS_C2_53),Radiology-Diagnostic (D3_HOS_C2_54),Radiology-Therapeutic (D3_HOS_C2_55),CT Scan (D3_HOS_C2_57),MRI (D3_HOS_C2_58),Laboratory (D3_HOS_C2_60),"Blood Storing, Processing, Trans (D3_HOS_C2_63)",Intravenous Therapy (D3_HOS_C2_64),Respiratory Therapy (D3_HOS_C2_65),Physical Therapy (D3_HOS_C2_66),Occupational Therapy (D3_HOS_C2_67),Speech Pathology (D3_HOS_C2_68),Electrocardiology (D3_HOS_C2_69),Electroencephalography (D3_HOS_C2_70),Medical Supplies Charged to Patients (D3_HOS_C2_71),Impl. Dev. Charged to Patients (D3_HOS_C2_72),Drugs Charged to Patients (D3_HOS_C2_73),Clinic (D3_HOS_C2_90),Emergency (D3_HOS_C2_91),Operating Room (D3_HOS_C3_50),Recovery Room (D3_HOS_C3_51),Anesthesiology (D3_HOS_C3_53),Radiology-Diagnostic (D3_HOS_C3_54),Radiology-Therapeutic (D3_HOS_C3_55),CT Scan (D3_HOS_C3_57),MRI (D3_HOS_C3_58),Laboratory (D3_HOS_C3_60),"Blood Storing, Processing, Trans (D3_HOS_C3_63)",Intravenous Therapy (D3_HOS_C3_64),Respiratory Therapy (D3_HOS_C3_65),Physical Therapy (D3_HOS_C3_66),Occupational Therapy (D3_HOS_C3_67),Speech Pathology (D3_HOS_C3_68),Electrocardiology (D3_HOS_C3_69),Electroencephalography (D3_HOS_C3_70),Medical Supplies Charged to Patients (D3_HOS_C3_71),Impl. Dev. Charged to Patients (D3_HOS_C3_72),Drugs Charged to Patients (D3_HOS_C3_73),Clinic (D3_HOS_C3_90),Emergency (D3_HOS_C3_91),No Description (D_2_HOS_C5_50),No Description (D_2_HOS_C5_51),No Description (D_2_HOS_C5_53),No Description (D_2_HOS_C5_54),No Description (D_2_HOS_C5_55),No Description (D_2_HOS_C5_57),No Description (D_2_HOS_C5_58),No Description (D_2_HOS_C5_60),No Description (D_2_HOS_C5_63),No Description (D_2_HOS_C5_64),No Description (D_2_HOS_C5_65),No Description (D_2_HOS_C5_66),No Description (D_2_HOS_C5_67),No Description (D_2_HOS_C5_68),No Description (D_2_HOS_C5_69),No Description (D_2_HOS_C5_70),No Description (D_2_HOS_C5_71),No Description (D_2_HOS_C5_72),No Description (D_2_HOS_C5_73),No Description (D_2_HOS_C5_90),No Description (D_2_HOS_C5_91),Operating Room (D_4_HOS_C10_50),Recovery Room (D_4_HOS_C10_51),Anesthesiology (D_4_HOS_C10_53),Radiology-Diagnostic (D_4_HOS_C10_54),Radiology-Therapeutic (D_4_HOS_C10_55),CT Scan (D_4_HOS_C10_57),MRI (D_4_HOS_C10_58),Laboratory (D_4_HOS_C10_60),"Blood Storing, Processing, Trans (D_4_HOS_C10_63)",Intravenous Therapy (D_4_HOS_C10_64),Respiratory Therapy (D_4_HOS_C10_65),Physical Therapy (D_4_HOS_C10_66),Occupational Therapy (D_4_HOS_C10_67),Speech Pathology (D_4_HOS_C10_68),Electrocardiology (D_4_HOS_C10_69),Electroencephalography (D_4_HOS_C10_70),Medical Supplies Charged to Patients (D_4_HOS_C10_71),Impl. Dev. Charged to Patients (D_4_HOS_C10_72),Drugs Charged to Patients (D_4_HOS_C10_73),Clinic (D_4_HOS_C10_90),Emergency (D_4_HOS_C10_91),No Description (G3_C1_24),No Description (G_C1THRU4_1),No Description (G_C1THRU4_11),No Description (G_C1THRU4_17),No Description (G_C1THRU4_18),No Description (G_C1THRU4_19),No Description (G_C1THRU4_2),No Description (G_C1THRU4_20),No Description (G_C1THRU4_23),No Description (G_C1THRU4_24),No Description (G_C1THRU4_30),No Description (G_C1THRU4_31),No Description (G_C1THRU4_35),No Description (G_C1THRU4_36),No Description (G_C1THRU4_37),No Description (G_C1THRU4_38),No Description (G_C1THRU4_4),No Description (G_C1THRU4_44),No Description (G_C1THRU4_45),No Description (G_C1THRU4_5),No Description (G_C1THRU4_51),No Description (G_C1THRU4_52),No Description (G_C1THRU4_59),No Description (G_C1THRU4_6),No Description (G_C1THRU4_60),No Description (G_C1THRU4_7),No Description (G_C1THRU4_8),Column 11 (Interest) New Cap Related Csts Bldg & Fixtures (A7_3_C11_1),Column 7 (Other Capital Related Costs) New Cap Related Csts Bldg & Fixtures (A7_3_C7_1),Column 7 (Other Capital Related Costs) New Cap Related Csts Movable Equipment (A7_3_C7_2),Dietary (A_C1_10),Nursing Administration (A_C1_13),Other General Service (A_C1_18),Other Nonreimbursable (A_C1_194),Operation of Plant (A_C1_7),Clinic (A_C1_90),Nursing Administration (A_C2_13),Other General Service (A_C2_18),Other Nonreimbursable (A_C2_194),Laundry and Linen Service (A_C2_8),Clinic (A_C2_90),New Capital Buildings and Fixtures (A_C6_1),Cafeteria (A_C6_11),Other Nonreimbursable (A_C6_194),Clinic (A_C6_90),Net Expense for Cost Allocation Cafeteria (B_1_C0_11),Net Expense for Cost Allocation Nursing Administration (B_1_C0_13),Net Expense for Cost Allocation Other General Service (B_1_C0_18),Net Expense for Cost Allocation Other Nonreimbursable (B_1_C0_194),Net Expense for Cost Allocation Laundry and Linen Service (B_1_C0_8),"Gift, Flower, Coffee Shop, Canteen (B_1_C26_190)",Other Nonreimbursable (B_1_C26_194),"Gift, Flower, Coffee Shop, Canteen (B_2_C26_190)",Other Nonreimbursable (B_2_C26_194),Clinic (C_1_C7_90),No Description (G_C1THRU4_12),No Description (G_C1THRU4_15),No Description (G_C1THRU4_16),No Description (G_C1THRU4_21),No Description (G_C1THRU4_34),No Description (G_C1THRU4_46),No Description (G_C1THRU4_47),No Description (G_C1THRU4_50),Other Reimbursable (A_C1_98),Central Services and Supply (A_C2_14),Maintenance and Repairs (A_C2_6),Other Reimbursable (A_C2_98),New Capital Equipment (A_C6_2),Employee Benefits (A_C6_4),Other Reimbursable (A_C6_98),Net Expense for Cost Allocation Central Services and Supply (B_1_C0_14),Net Expense for Cost Allocation Maintenance and Repairs (B_1_C0_6),Net Expense for Cost Allocation Other Reimbursable (B_1_C0_98),Other Reimbursable (B_1_C26_98),Other Reimbursable (B_2_C26_98),Other Reimbursable (C_1_C5_98),Other Reimbursable (C_1_C7_98),Drugs Charged to Patients (D_4_HOS_C12_73),Other Reimbursable (D_4_HOS_C12_98),PPS REIMBURSED SERVICES -  CHARGES Drugs Charged to Patients (D_5_HOS_C2_73),PPS REIMBURSED SERVICES -  CHARGES Other Reimbursable (D_5_HOS_C2_98),PPS SERVICES COST Drugs Charged to Patients (D_5_HOS_C5_73),PPS SERVICES COST Other Reimbursable (D_5_HOS_C5_98),No Description (G_C1THRU4_10),No Description (G_C1THRU4_33),No Description (G_C1THRU4_40),Employee Benefits (A_C1_4),Radiology-Diagnostic (A_C1_54),Maintenance and Repairs (A_C1_6),Laboratory (A_C1_60),Laundry and Linen Service (A_C1_8),Operation of Plant (A_C6_7),Nonpaid Workers (B_1_C26_193),Nonpaid Workers (B_2_C26_193),Dietary (A_C6_10),Research (B_1_C26_191),Research (B_2_C26_191),Clinic (D_4_HOS_C12_90),PPS REIMBURSED SERVICES -  CHARGES Clinic (D_5_HOS_C2_90),PPS SERVICES COST Clinic (D_5_HOS_C5_90),Research (A_C2_191),Maintenance and Repairs (A_C6_6),Net Expense for Cost Allocation Research (B_1_C0_191),Net Expense for Cost Allocation Interns & Res Salary and Fringe Benefits (B_1_C0_21),Allocation of Interns & Residents Salary and Fringes Interns & Res Salary and Fringe Benefits (B_1_C21_21),Clinic (B_1_C21_90),Clinic (B_1_C22_90),Operating Room (A_C1_50),Delivery Room and Labor Room (A_C1_52),Delivery Room and Labor Room (A_C2_52),Nursing Administration (A_C6_13),Central Services and Supply (A_C6_14),Delivery Room and Labor Room (A_C6_52),Laundry and Linen Service (A_C6_8),Housekeeping (A_C6_9),Net Expense for Cost Allocation Delivery Room and Labor Room (B_1_C0_52),Delivery Room and Labor Room (B_1_C26_52),TOTAL CAPITAL COSTS AFTER COST ALLOCATION Delivery Room and Labor Room (B_2_C26_52),Delivery Room and Labor Room (C_1_C5_52),Total Inpatient Charges Delivery Room and Labor Room (C_1_C6_52),Total Outpatient Charges Operating Room (C_1_C7_50),Total Outpatient Charges Delivery Room and Labor Room (C_1_C7_52),Total Outpatient Charges Radiology-Diagnostic (C_1_C7_54),Total Outpatient Charges Laboratory (C_1_C7_60),Medical Supplies Charged to Patients (C_1_C7_71),Drugs Charged to Patients (C_1_C7_73),Operating Room (D_4_HOS_C12_50),PPS REIMBURSED SERVICES -  CHARGES Operating Room (D_5_HOS_C2_50),PPS SERVICES COST Operating Room (D_5_HOS_C5_50),No Description (G_C1THRU4_13),No Description (G_C1THRU4_14),No Description (G_C1THRU4_9),Speech Pathology (A_C1_68),Drugs Charged to Patients (A_C1_73),CT Scan (A_C2_57),MRI (A_C2_58),Physical Therapy (A_C6_66),Occupational Therapy (A_C6_67),Speech Pathology (A_C6_68),Electrocardiology (A_C6_69),Drugs Charged to Patients (A_C6_73),Respiratory Therapy (C_1_C7_65),Electrocardiology (C_1_C7_69),Radiology-Diagnostic (D_4_HOS_C12_54),Laboratory (D_4_HOS_C12_60),Respiratory Therapy (D_4_HOS_C12_65),Electrocardiology (D_4_HOS_C12_69),PPS REIMBURSED SERVICES -  CHARGES Radiology-Diagnostic (D_5_HOS_C2_54),PPS REIMBURSED SERVICES -  CHARGES Laboratory (D_5_HOS_C2_60),PPS REIMBURSED SERVICES -  CHARGES Respiratory Therapy (D_5_HOS_C2_65),PPS REIMBURSED SERVICES -  CHARGES Electrocardiology (D_5_HOS_C2_69),PPS SERVICES COST Radiology-Diagnostic (D_5_HOS_C5_54),PPS SERVICES COST Laboratory (D_5_HOS_C5_60),PPS SERVICES COST Respiratory Therapy (D_5_HOS_C5_65),PPS SERVICES COST Electrocardiology (D_5_HOS_C5_69),No Description (G_C1THRU4_39),No Description (G_C1THRU4_43),Column 5 (Insurance) New Cap Related Csts Bldg & Fixtures (A7_3_C5_1),Column 5 (Insurance) New Cap Related Csts Movable Equipment (A7_3_C5_2),Other Ancillary (A_C1_76),Other Ancillary (A_C2_76),Radiology-Diagnostic (A_C6_54),Net Expense for Cost Allocation Other Ancillary (B_1_C0_76),Other Ancillary (B_1_C26_76),Other Ancillary (B_2_C26_76),Other Ancillary (C_1_C5_76),No Description (G2_C1_27),Column 6 (Taxes) New Cap Related Csts Bldg & Fixtures (A7_3_C6_1),Column 6 (Taxes) New Cap Related Csts Movable Equipment (A7_3_C6_2),Central Services and Supply (A_C1_14),Intensive Care Unit (A_C1_31),Intensive Care Unit (A_C2_31),Operating Room (A_C6_50),Laboratory (A_C6_60),Respiratory Therapy (A_C6_65),Net Expense for Cost Allocation Intensive Care Unit (B_1_C0_31),Intensive Care Unit (B_1_C26_31),TOTAL CAPITAL COSTS AFTER COST ALLOCATION Intensive Care Unit (B_2_C26_31),Intensive Care Unit (C_1_C5_31),Total Inpatient Charges Intensive Care Unit (C_1_C6_31),Physical Therapy (C_1_C7_66),Intensive Care Unit Program Cost (D1_HOS_C5_43),Intensive Care Unit (D3_HOS_C2_31),Intensive Care Unit (D_1_HOS_C4_31),Intensive Care Unit (D_1_HOS_C6_31),Intensive Care Unit (D_1_HOS_C7_31),COST REIMBURSED SERVICES SUBJECT TO DEDUCTIBLES  AND COINSURANCE - CHARGES Radiology-Diagnostic (D_5_HOS_C3_54),COST REIMBURSED SERVICES SUBJECT TO DEDUCTIBLES  AND COINSURANCE - CHARGES Respiratory Therapy (D_5_HOS_C3_65),COST SERVICES SUBJECT TO DEDUCTIBLES AND COINSURANCE - COST Radiology-Diagnostic (D_5_HOS_C6_54),COST SERVICES SUBJECT TO DEDUCTIBLES AND COINSURANCE - COST Respiratory Therapy (D_5_HOS_C6_65),No Description (G2_C1_11),No Description (G_C1THRU4_49),Intensive Care Unit (S3_1_C2_8),Intensive Care Unit (S3_1_C3_8),Intensive Care Unit (S3_1_C6_8),Intensive Care Unit (S3_1_C8_8),"Gift, Flower, Coffee Shop, Canteen (A_C1_190)",Coronary Care Unit (A_C1_32),Surgical Intensive Care Unit (A_C1_34),Recovery Room (A_C1_51),Anesthesiology (A_C1_53),Radioisotope (A_C1_56),CT Scan (A_C1_57),MRI (A_C1_58),Cardiac Catheterization (A_C1_59),Intravenous Therapy (A_C1_64),Electroencephalography (A_C1_70),Emergency (A_C1_91),"Gift, Flower, Coffee Shop, Canteen (A_C2_190)",Coronary Care Unit (A_C2_32),Surgical Intensive Care Unit (A_C2_34),Radioisotope (A_C2_56),Cardiac Catheterization (A_C2_59),Intravenous Therapy (A_C2_64),Emergency (A_C2_91),Nonphysician Anesthetists (A_C6_19),CT Scan (A_C6_57),Cardiac Catheterization (A_C6_59),Electroencephalography (A_C6_70),Emergency (A_C6_91),"Net Expense for Cost Allocation Gift, Flower, Coffee Shop, Canteen (B_1_C0_190)",Net Expense for Cost Allocation Paramedical Education (B_1_C0_23),Net Expense for Cost Allocation Coronary Care Unit (B_1_C0_32),Net Expense for Cost Allocation Surgical Intensive Care Unit (B_1_C0_34),Net Expense for Cost Allocation Radioisotope (B_1_C0_56),Net Expense for Cost Allocation Cardiac Catheterization (B_1_C0_59),Physicians' Private Office (B_1_C26_192),Coronary Care Unit (B_1_C26_32),Surgical Intensive Care Unit (B_1_C26_34),Radioisotope (B_1_C26_56),Cardiac Catheterization (B_1_C26_59),Physicians' Private Office (B_2_C26_192),TOTAL CAPITAL COSTS AFTER COST ALLOCATION Coronary Care Unit (B_2_C26_32),TOTAL CAPITAL COSTS AFTER COST ALLOCATION Surgical Intensive Care Unit (B_2_C26_34),TOTAL CAPITAL COSTS AFTER COST ALLOCATION Radioisotope (B_2_C26_56),TOTAL CAPITAL COSTS AFTER COST ALLOCATION Cardiac Catheterization (B_2_C26_59),Coronary Care Unit (C_1_C5_32),Surgical Intensive Care Unit (C_1_C5_34),Radioisotope (C_1_C5_56),Cardiac Catheterization (C_1_C5_59),Total Inpatient Charges Coronary Care Unit (C_1_C6_32),Total Inpatient Charges Surgical Intensive Care Unit (C_1_C6_34),Total Inpatient Charges Radioisotope (C_1_C6_56),Total Inpatient Charges Cardiac Catheterization (C_1_C6_59),Total Outpatient Charges Recovery Room (C_1_C7_51),Total Outpatient Charges Anesthesiology (C_1_C7_53),Total Outpatient Charges Radioisotope (C_1_C7_56),Total Outpatient Charges CT Scan (C_1_C7_57),Total Outpatient Charges MRI (C_1_C7_58),Total Outpatient Charges Cardiac Catheterization (C_1_C7_59),Intravenous Therapy (C_1_C7_64),Electroencephalography (C_1_C7_70),Impl. Dev. Charged to Patients (C_1_C7_72),Emergency (C_1_C7_91),Coronary Care Unit (D3_HOS_C2_32),Surgical Intensive Care Unit (D3_HOS_C2_34),Delivery Room and Labor Room (D3_HOS_C2_52),Radioisotope (D3_HOS_C2_56),Cardiac Catheterization (D3_HOS_C2_59),Delivery Room and Labor Room (D3_HOS_C3_52),Radioisotope (D3_HOS_C3_56),Cardiac Catheterization (D3_HOS_C3_59),Coronary Intensive Care Unit (D_1_HOS_C4_32),Surgical Intensive Care Unit (D_1_HOS_C4_34),Coronary Intensive Care Unit (D_1_HOS_C6_32),Surgical Intensive Care Unit (D_1_HOS_C6_34),Coronary Intensive Care Unit (D_1_HOS_C7_32),Surgical Intensive Care Unit (D_1_HOS_C7_34),No Description (D_2_HOS_C5_52),No Description (D_2_HOS_C5_56),No Description (D_2_HOS_C5_59),Delivery Room and Labor Room (D_4_HOS_C10_52),Radioisotope (D_4_HOS_C10_56),Cardiac Catheterization (D_4_HOS_C10_59),Operating Room (D_4_HOS_C11_50),Recovery Room (D_4_HOS_C12_51),Delivery Room and Labor Room (D_4_HOS_C12_52),Anesthesiology (D_4_HOS_C12_53),Radioisotope (D_4_HOS_C12_56),CT Scan (D_4_HOS_C12_57),MRI (D_4_HOS_C12_58),Cardiac Catheterization (D_4_HOS_C12_59),Intravenous Therapy (D_4_HOS_C12_64),Physical Therapy (D_4_HOS_C12_66),Electroencephalography (D_4_HOS_C12_70),Medical Supplies Charged to Patients (D_4_HOS_C12_71),Impl. Dev. Charged to Patients (D_4_HOS_C12_72),Emergency (D_4_HOS_C12_91),Operating Room (D_4_HOS_C13_50),Operating Room (D_4_HOS_C3_50),PPS REIMBURSED SERVICES -  CHARGES Recovery Room (D_5_HOS_C2_51),PPS REIMBURSED SERVICES -  CHARGES Delivery Room and Labor Room (D_5_HOS_C2_52),PPS REIMBURSED SERVICES -  CHARGES Anesthesiology (D_5_HOS_C2_53),PPS REIMBURSED SERVICES -  CHARGES Radioisotope (D_5_HOS_C2_56),PPS REIMBURSED SERVICES -  CHARGES CT Scan (D_5_HOS_C2_57),PPS REIMBURSED SERVICES -  CHARGES MRI (D_5_HOS_C2_58),PPS REIMBURSED SERVICES -  CHARGES Cardiac Catheterization (D_5_HOS_C2_59),PPS REIMBURSED SERVICES -  CHARGES Intravenous Therapy (D_5_HOS_C2_64),PPS REIMBURSED SERVICES -  CHARGES Physical Therapy (D_5_HOS_C2_66),PPS REIMBURSED SERVICES -  CHARGES Electroencephalography (D_5_HOS_C2_70),PPS REIMBURSED SERVICES -  CHARGES Medical Supplies Charged to Patients (D_5_HOS_C2_71),PPS REIMBURSED SERVICES -  CHARGES Impl. Dev. Charged to Patients (D_5_HOS_C2_72),PPS REIMBURSED SERVICES -  CHARGES Emergency (D_5_HOS_C2_91),COST REIMBURSED SERVICES SUBJECT TO DEDUCTIBLES  AND COINSURANCE - CHARGES Drugs Charged to Patients (D_5_HOS_C3_73),COST REIMBURSED SERVICES NOT SUBJECT TO DEDUCTIBLES AND COINSURANCE - CHARGES Laboratory (D_5_HOS_C4_60),COST REIMBURSED SERVICES NOT SUBJECT TO DEDUCTIBLES AND COINSURANCE - CHARGES Impl. Dev. Charged to Patients (D_5_HOS_C4_72),COST REIMBURSED SERVICES NOT SUBJECT TO DEDUCTIBLES AND COINSURANCE - CHARGES Drugs Charged to Patients (D_5_HOS_C4_73),PPS SERVICES COST Recovery Room (D_5_HOS_C5_51),PPS SERVICES COST Delivery Room and Labor Room (D_5_HOS_C5_52),PPS SERVICES COST Anesthesiology (D_5_HOS_C5_53),PPS SERVICES COST Radioisotope (D_5_HOS_C5_56),PPS SERVICES COST CT Scan (D_5_HOS_C5_57),PPS SERVICES COST MRI (D_5_HOS_C5_58),PPS SERVICES COST Cardiac Catheterization (D_5_HOS_C5_59),PPS SERVICES COST Intravenous Therapy (D_5_HOS_C5_64),PPS SERVICES COST Physical Therapy (D_5_HOS_C5_66),PPS SERVICES COST Electroencephalography (D_5_HOS_C5_70),PPS SERVICES COST Medical Supplies Charged to Patients (D_5_HOS_C5_71),PPS SERVICES COST Impl. Dev. Charged to Patients (D_5_HOS_C5_72),PPS SERVICES COST Emergency (D_5_HOS_C5_91),COST SERVICES SUBJECT TO DEDUCTIBLES AND COINSURANCE - COST Drugs Charged to Patients (D_5_HOS_C6_73),COST SERVICES NOT SUBJECT TO DEDUCTIBLES AND COINSURANCE - COST Laboratory (D_5_HOS_C7_60),COST SERVICES NOT SUBJECT TO DEDUCTIBLES AND COINSURANCE - COST Impl. Dev. Charged to Patients (D_5_HOS_C7_72),COST SERVICES NOT SUBJECT TO DEDUCTIBLES AND COINSURANCE - COST Drugs Charged to Patients (D_5_HOS_C7_73),No Description (G2_C1_12),No Description (G2_C1_14),No Description (G_C1THRU4_22),No Description (G_C1THRU4_25),No Description (G_C1THRU4_26),Surgical Intensive Care Unit (S3_1_C2_11),Coronary Care Unit (S3_1_C2_9),Surgical Intensive Care Unit (S3_1_C3_11),Coronary Care Unit (S3_1_C3_9),Surgical Intensive Care Unit (S3_1_C6_11),Coronary Care Unit (S3_1_C6_9),Surgical Intensive Care Unit (S3_1_C7_11),Intensive Care Unit (S3_1_C7_8),Coronary Care Unit (S3_1_C7_9),Surgical Intensive Care Unit (S3_1_C8_11),Coronary Care Unit (S3_1_C8_9),Medical Supplies Charged to Patients (A_C1_71),Medical Supplies Charged to Patients (A_C6_71),Net Expense for Cost Allocation Physicians' Private Office (B_1_C0_192),Other Ancillary (C_1_C6_76),Occupational Therapy (C_1_C7_67),Speech Pathology (C_1_C7_68),Other Ancillary (C_1_C7_76),Other Ancillary (D3_HOS_C2_76),Other Ancillary (D3_HOS_C3_76),No Description (D_2_HOS_C5_76),Other Ancillary (D_4_HOS_C10_76),Other Ancillary (D_4_HOS_C12_76),PPS REIMBURSED SERVICES -  CHARGES Other Ancillary (D_5_HOS_C2_76),PPS SERVICES COST Other Ancillary (D_5_HOS_C5_76),Whole Blood & Packed Red Blood Cells (A_C2_62),Anesthesiology (A_C6_53),Whole Blood & Packed Red Blood Cells (A_C6_62),Net Expense for Cost Allocation Whole Blood & Packed Red Blood Cells (B_1_C0_62),Whole Blood & Packed Red Blood Cells (B_1_C26_62),TOTAL CAPITAL COSTS AFTER COST ALLOCATION Whole Blood & Packed Red Blood Cells (B_2_C26_62),Whole Blood & Packed Red Blood Cells (C_1_C5_62),Total Inpatient Charges Whole Blood & Packed Red Blood Cells (C_1_C6_62),Total Outpatient Charges Whole Blood & Packed Red Blood Cells (C_1_C7_62),Whole Blood & Packed Red Blood Cells (D3_HOS_C2_62),Whole Blood & Packed Red Blood Cells (D3_HOS_C3_62),No Description (D_2_HOS_C5_62),Whole Blood & Packed Red Blood Cells (D_4_HOS_C10_62),Whole Blood & Packed Red Blood Cells (D_4_HOS_C12_62),PPS REIMBURSED SERVICES -  CHARGES Whole Blood & Packed Red Blood Cells (D_5_HOS_C2_62),COST REIMBURSED SERVICES NOT SUBJECT TO DEDUCTIBLES AND COINSURANCE - CHARGES Radiology-Diagnostic (D_5_HOS_C4_54),PPS SERVICES COST Whole Blood & Packed Red Blood Cells (D_5_HOS_C5_62),COST SERVICES NOT SUBJECT TO DEDUCTIBLES AND COINSURANCE - COST Radiology-Diagnostic (D_5_HOS_C7_54),No Description (E_A_HOS_C1_70),No Description (G2_C2_27),HHA (A_C1_101),Physicians' Private Office (A_C1_192),Physicians' Private Office (A_C2_192),Interns & Res Other Program Costs (A_C2_22),Intensive Care Unit (A_C6_31),Net Expense for Cost Allocation Interns & Res Other Program Costs (B_1_C0_22),Operating Room (D3_IPF_C2_50),Recovery Room (D3_IPF_C2_51),Anesthesiology (D3_IPF_C2_53),Radiology-Diagnostic (D3_IPF_C2_54),Radioisotope (D3_IPF_C2_56),Laboratory (D3_IPF_C2_60),Respiratory Therapy (D3_IPF_C2_65),Physical Therapy (D3_IPF_C2_66),Occupational Therapy (D3_IPF_C2_67),Speech Pathology (D3_IPF_C2_68),Electrocardiology (D3_IPF_C2_69),Medical Supplies Charged to Patients (D3_IPF_C2_71),Impl. Dev. Charged to Patients (D3_IPF_C2_72),Drugs Charged to Patients (D3_IPF_C2_73),Emergency (D3_IPF_C2_91),Operating Room (D3_IPF_C3_50),Recovery Room (D3_IPF_C3_51),Anesthesiology (D3_IPF_C3_53),Radiology-Diagnostic (D3_IPF_C3_54),Radioisotope (D3_IPF_C3_56),Laboratory (D3_IPF_C3_60),Respiratory Therapy (D3_IPF_C3_65),Physical Therapy (D3_IPF_C3_66),Occupational Therapy (D3_IPF_C3_67),Speech Pathology (D3_IPF_C3_68),Electrocardiology (D3_IPF_C3_69),Medical Supplies Charged to Patients (D3_IPF_C3_71),Impl. Dev. Charged to Patients (D3_IPF_C3_72),Drugs Charged to Patients (D3_IPF_C3_73),Emergency (D3_IPF_C3_91),Operating Room (D3_IRF_C2_50),Recovery Room (D3_IRF_C2_51),Anesthesiology (D3_IRF_C2_53),Radiology-Diagnostic (D3_IRF_C2_54),Radioisotope (D3_IRF_C2_56),Laboratory (D3_IRF_C2_60),Respiratory Therapy (D3_IRF_C2_65),Physical Therapy (D3_IRF_C2_66),Occupational Therapy (D3_IRF_C2_67),Speech Pathology (D3_IRF_C2_68),Electrocardiology (D3_IRF_C2_69),Medical Supplies Charged to Patients (D3_IRF_C2_71),Impl. Dev. Charged to Patients (D3_IRF_C2_72),Drugs Charged to Patients (D3_IRF_C2_73),Clinic (D3_IRF_C2_90),Operating Room (D3_IRF_C3_50),Recovery Room (D3_IRF_C3_51),Anesthesiology (D3_IRF_C3_53),Radiology-Diagnostic (D3_IRF_C3_54),Radioisotope (D3_IRF_C3_56),Laboratory (D3_IRF_C3_60),Respiratory Therapy (D3_IRF_C3_65),Physical Therapy (D3_IRF_C3_66),Occupational Therapy (D3_IRF_C3_67),Speech Pathology (D3_IRF_C3_68),Electrocardiology (D3_IRF_C3_69),Medical Supplies Charged to Patients (D3_IRF_C3_71),Impl. Dev. Charged to Patients (D3_IRF_C3_72),Drugs Charged to Patients (D3_IRF_C3_73),Clinic (D3_IRF_C3_90),No Description (D_2_IPF_C5_50),No Description (D_2_IPF_C5_51),No Description (D_2_IPF_C5_53),No Description (D_2_IPF_C5_54),No Description (D_2_IPF_C5_56),No Description (D_2_IPF_C5_60),No Description (D_2_IPF_C5_65),No Description (D_2_IPF_C5_66),No Description (D_2_IPF_C5_67),No Description (D_2_IPF_C5_68),No Description (D_2_IPF_C5_69),No Description (D_2_IPF_C5_71),No Description (D_2_IPF_C5_72),No Description (D_2_IPF_C5_73),No Description (D_2_IPF_C5_91),No Description (D_2_IRF_C5_50),No Description (D_2_IRF_C5_51),No Description (D_2_IRF_C5_53),No Description (D_2_IRF_C5_54),No Description (D_2_IRF_C5_56),No Description (D_2_IRF_C5_60),No Description (D_2_IRF_C5_65),No Description (D_2_IRF_C5_66),No Description (D_2_IRF_C5_67),No Description (D_2_IRF_C5_68),No Description (D_2_IRF_C5_69),No Description (D_2_IRF_C5_71),No Description (D_2_IRF_C5_72),No Description (D_2_IRF_C5_73),No Description (D_2_IRF_C5_90),Occupational Therapy (D_4_HOS_C12_67),PPS REIMBURSED SERVICES -  CHARGES Occupational Therapy (D_5_HOS_C2_67),PPS SERVICES COST Occupational Therapy (D_5_HOS_C5_67),No Description (G2_C2_22),Hospice (A_C1_116),HHA (A_C2_101),Hospice (A_C2_116),Net Expense for Cost Allocation HHA (B_1_C0_101),Net Expense for Cost Allocation Hospice (B_1_C0_116),HHA (B_1_C26_101),Hospice (B_1_C26_116),HHA (B_2_C26_101),Hospice (B_2_C26_116),HHA (C_1_C5_101),Hospice (C_1_C5_116),Radiology-Diagnostic (D3_SNF_C2_54),Laboratory (D3_SNF_C2_60),Physical Therapy (D3_SNF_C2_66),Occupational Therapy (D3_SNF_C2_67),Speech Pathology (D3_SNF_C2_68),Medical Supplies Charged to Patients (D3_SNF_C2_71),Drugs Charged to Patients (D3_SNF_C2_73),Radiology-Diagnostic (D3_SNF_C3_54),Laboratory (D3_SNF_C3_60),Physical Therapy (D3_SNF_C3_66),Occupational Therapy (D3_SNF_C3_67),Speech Pathology (D3_SNF_C3_68),Medical Supplies Charged to Patients (D3_SNF_C3_71),Drugs Charged to Patients (D3_SNF_C3_73),HHA (S3_1_C10_22),Hospice (S3_1_C10_24),HHA (S3_1_C8_22),Column 11 (Interest) New Cap Related Csts Movable Equipment (A7_3_C11_2),Paramedical Education (A_C1_23),Other Special Care Unit (A_C1_35),Radiology-Therapeutic (A_C1_55),ASC (Non Distinct Part) (A_C1_75),Paramedical Education (A_C2_23),Other Special Care Unit (A_C2_35),ASC (Non Distinct Part) (A_C2_75),Interns & Res Other Program Costs (A_C6_22),Paramedical Education (A_C6_23),Other Special Care Unit (A_C6_35),Radiology-Therapeutic (A_C6_55),Radioisotope (A_C6_56),ASC (Non Distinct Part) (A_C6_75),Net Expense for Cost Allocation Other Special Care Unit (B_1_C0_35),Net Expense for Cost Allocation ASC (Non Distinct Part) (B_1_C0_75),Allocation of Interns & Residents Program Costs Intensive Care Unit (B_1_C22_31),Allocation of Interns & Residents Program Costs Operating Room (B_1_C22_50),Allocation of Interns & Residents Program Costs Laboratory (B_1_C22_60),Other Special Care Unit (B_1_C26_35),ASC (Non Distinct Part) (B_1_C26_75),TOTAL CAPITAL COSTS AFTER COST ALLOCATION Other Special Care Unit (B_2_C26_35),ASC (Non Distinct Part) (B_2_C26_75),Other Special Care Unit (C_1_C5_35),ASC (Non Distinct Part) (C_1_C5_75),Total Inpatient Charges Other Special Care Unit (C_1_C6_35),ASC (Non Distinct Part) (C_1_C6_75),Total Outpatient Charges Radiology-Therapeutic (C_1_C7_55),ASC (Non Distinct Part) (C_1_C7_75),ASC (Non Distinct Part) (D3_HOS_C2_75),ASC (Non Distinct Part) (D3_HOS_C3_75),CT Scan (D3_IPF_C2_57),MRI (D3_IPF_C2_58),Clinic (D3_IPF_C2_90),CT Scan (D3_IPF_C3_57),MRI (D3_IPF_C3_58),Clinic (D3_IPF_C3_90),Radiology-Therapeutic (D3_IRF_C2_55),CT Scan (D3_IRF_C2_57),MRI (D3_IRF_C2_58),Electroencephalography (D3_IRF_C2_70),ASC (Non Distinct Part) (D3_IRF_C2_75),Emergency (D3_IRF_C2_91),Radiology-Therapeutic (D3_IRF_C3_55),CT Scan (D3_IRF_C3_57),MRI (D3_IRF_C3_58),Electroencephalography (D3_IRF_C3_70),ASC (Non Distinct Part) (D3_IRF_C3_75),Emergency (D3_IRF_C3_91),Other Special Care Unit (D_1_HOS_C4_35),No Description (D_2_HOS_C5_75),No Description (D_2_IPF_C5_57),No Description (D_2_IPF_C5_58),No Description (D_2_IPF_C5_90),No Description (D_2_IRF_C5_55),No Description (D_2_IRF_C5_57),No Description (D_2_IRF_C5_58),No Description (D_2_IRF_C5_70),No Description (D_2_IRF_C5_75),No Description (D_2_IRF_C5_91),Intensive Care Unit (D_3_HOS_C9_31),ASC (Non Distinct Part) (D_4_HOS_C10_75),Radiology-Therapeutic (D_4_HOS_C12_55),ASC (Non Distinct Part) (D_4_HOS_C12_75),PPS REIMBURSED SERVICES -  CHARGES Radiology-Therapeutic (D_5_HOS_C2_55),PPS REIMBURSED SERVICES -  CHARGES ASC (Non Distinct Part) (D_5_HOS_C2_75),COST REIMBURSED SERVICES SUBJECT TO DEDUCTIBLES  AND COINSURANCE - CHARGES Impl. Dev. Charged to Patients (D_5_HOS_C3_72),COST REIMBURSED SERVICES SUBJECT TO DEDUCTIBLES  AND COINSURANCE - CHARGES Emergency (D_5_HOS_C3_91),PPS SERVICES COST Radiology-Therapeutic (D_5_HOS_C5_55),PPS SERVICES COST ASC (Non Distinct Part) (D_5_HOS_C5_75),COST SERVICES SUBJECT TO DEDUCTIBLES AND COINSURANCE - COST Impl. Dev. Charged to Patients (D_5_HOS_C6_72),COST SERVICES SUBJECT TO DEDUCTIBLES AND COINSURANCE - COST Emergency (D_5_HOS_C6_91),No Description (G2_C1_15),No Description (G_C1THRU4_29),Other Special Care (S3_1_C2_12),Other Special Care (S3_1_C3_12),Other Special Care (S3_1_C7_12),Other Special Care (S3_1_C8_12),COST REIMBURSED SERVICES SUBJECT TO DEDUCTIBLES  AND COINSURANCE - CHARGES Laboratory (D_5_HOS_C3_60),COST SERVICES SUBJECT TO DEDUCTIBLES AND COINSURANCE - COST Laboratory (D_5_HOS_C6_60),Physicians' Private Office (A_C6_192),HHA (S3_1_C6_22),Whole Blood & Packed Red Blood Cells (A_C1_62),Durable Medical Equipment Sold (A_C1_97),Durable Medical Equipment Sold (A_C2_97),Net Expense for Cost Allocation Durable Medical Equipment Sold (B_1_C0_97),Durable Medical Equipment Sold (B_1_C26_97),Durable Medical Equipment Sold (B_2_C26_97),Durable Medical Equipment Sold (C_1_C5_97),Durable Medical Equipment Sold (C_1_C7_97),Whole Blood & Packed Red Blood Cells (D3_SNF_C2_62),Electrocardiology (D3_SNF_C2_69),Whole Blood & Packed Red Blood Cells (D3_SNF_C3_62),Electrocardiology (D3_SNF_C3_69),RHC (A_C1_88),Other Outpatient Services (A_C1_93),RHC (A_C2_88),Other Outpatient Services (A_C2_93),RHC (A_C6_88),Other Outpatient Services (A_C6_93),Net Expense for Cost Allocation RHC (B_1_C0_88),Net Expense for Cost Allocation Other Outpatient Services (B_1_C0_93),RHC (B_1_C26_88),Other Outpatient Services (B_1_C26_93),RHC (B_2_C26_88),Other Outpatient Services (B_2_C26_93),RHC (C_1_C7_88),Other Outpatient Services (C_1_C7_93),COST REIMBURSED SERVICES SUBJECT TO DEDUCTIBLES  AND COINSURANCE - CHARGES Operating Room (D_5_HOS_C3_50),COST REIMBURSED SERVICES SUBJECT TO DEDUCTIBLES  AND COINSURANCE - CHARGES Physical Therapy (D_5_HOS_C3_66),COST REIMBURSED SERVICES SUBJECT TO DEDUCTIBLES  AND COINSURANCE - CHARGES Speech Pathology (D_5_HOS_C3_68),COST REIMBURSED SERVICES SUBJECT TO DEDUCTIBLES  AND COINSURANCE - CHARGES Electrocardiology (D_5_HOS_C3_69),COST REIMBURSED SERVICES SUBJECT TO DEDUCTIBLES  AND COINSURANCE - CHARGES Medical Supplies Charged to Patients (D_5_HOS_C3_71),COST REIMBURSED SERVICES SUBJECT TO DEDUCTIBLES  AND COINSURANCE - CHARGES Other Outpatient Services (D_5_HOS_C3_93),COST SERVICES SUBJECT TO DEDUCTIBLES AND COINSURANCE - COST Operating Room (D_5_HOS_C6_50),COST SERVICES SUBJECT TO DEDUCTIBLES AND COINSURANCE - COST Physical Therapy (D_5_HOS_C6_66),COST SERVICES SUBJECT TO DEDUCTIBLES AND COINSURANCE - COST Speech Pathology (D_5_HOS_C6_68),COST SERVICES SUBJECT TO DEDUCTIBLES AND COINSURANCE - COST Electrocardiology (D_5_HOS_C6_69),COST SERVICES SUBJECT TO DEDUCTIBLES AND COINSURANCE - COST Medical Supplies Charged to Patients (D_5_HOS_C6_71),COST SERVICES SUBJECT TO DEDUCTIBLES AND COINSURANCE - COST Other Outpatient Services (D_5_HOS_C6_93),No Description (G2_C2_20),RHC/FQHC Combined (S3_1_C10_26),RHC/FQHC Combined (S3_1_C6_26),RHC/FQHC Combined (S3_1_C7_26),RHC/FQHC Combined (S3_1_C8_26),Nonphysician Anesthetists (A_C1_19),Nonphysician Anesthetists (A_C2_19),Impl. Dev. Charged to Patients (A_C2_72),Net Expense for Cost Allocation Nonphysician Anesthetists (B_1_C0_19),RHC (C_1_C5_88),RHC (C_1_C6_88),Respiratory Therapy (D3_SNF_C2_65),Clinic (D3_SNF_C2_90),Emergency (D3_SNF_C2_91),Respiratory Therapy (D3_SNF_C3_65),Clinic (D3_SNF_C3_90),Emergency (D3_SNF_C3_91),Anesthesiology (D_4_HOS_C11_53),Anesthesiology (D_4_HOS_C1_53),COST REIMBURSED SERVICES SUBJECT TO DEDUCTIBLES  AND COINSURANCE - CHARGES Anesthesiology (D_5_HOS_C3_53),COST REIMBURSED SERVICES SUBJECT TO DEDUCTIBLES  AND COINSURANCE - CHARGES Clinic (D_5_HOS_C3_90),COST SERVICES SUBJECT TO DEDUCTIBLES AND COINSURANCE - COST Anesthesiology (D_5_HOS_C6_53),COST SERVICES SUBJECT TO DEDUCTIBLES AND COINSURANCE - COST Clinic (D_5_HOS_C6_90),No Description (G2_C1_20),No Description (G_C1THRU4_42),Observation Beds (Distinct Unit) (A_C1_9201),No Description (A_C2_9201),Net Expense for Cost Allocation Observation Beds (Distinct Unit) (B_1_C0_9201),Observation Beds (Distinct Unit) (B_1_C26_9201),Observation Beds (Distinct Unit) (B_2_C26_9201),Observation Beds (Distinct Unit) (C_1_C5_9201),Observation Beds (Distinct Unit) (C_1_C6_9201),Observation Beds (Distinct Unit) (C_1_C7_9201),Observation Beds (Distinct Unit) (D3_HOS_C2_9201),Observation Beds (Distinct Unit) (D3_HOS_C3_9201),No Description (D_2_HOS_C5_9201),Observation Beds (Distinct Unit) (D_4_HOS_C10_9201),Observation Beds (Distinct Unit) (D_4_HOS_C12_9201),PPS REIMBURSED SERVICES -  CHARGES Observation Beds (Distinct Unit) (D_5_HOS_C2_9201),PPS SERVICES COST Observation Beds (Distinct Unit) (D_5_HOS_C5_9201),No Description (G_C1THRU4_41),HHA (A_C6_101),HHA (C_1_C7_101),Other Ancillary (A_C6_76),HHA (S3_1_C7_22),"Blood Storing, Processing, Trans (C_1_C7_63)","Blood Storing, Processing, Trans (D_4_HOS_C12_63)","PPS REIMBURSED SERVICES -  CHARGES Blood Storing, Processing, Trans (D_5_HOS_C2_63)","PPS SERVICES COST Blood Storing, Processing, Trans (D_5_HOS_C5_63)",Nonpaid Workers (A_C2_193),Net Expense for Cost Allocation Nonpaid Workers (B_1_C0_193),Other adjustments (E_B_HOS_C1_39),"Gift, Flower, Coffee Shop, Canteen (A_C6_190)",MRI (A_C6_58),Other Outpatient Services (C_1_C5_93),Other General Service (A_C6_18),COST REIMBURSED SERVICES SUBJECT TO DEDUCTIBLES  AND COINSURANCE - CHARGES Occupational Therapy (D_5_HOS_C3_67),COST SERVICES SUBJECT TO DEDUCTIBLES AND COINSURANCE - COST Occupational Therapy (D_5_HOS_C6_67),Research (A_C1_191),Hospice (C_1_C6_116),Hospice (C_1_C7_116),COST REIMBURSED SERVICES SUBJECT TO DEDUCTIBLES  AND COINSURANCE - CHARGES Recovery Room (D_5_HOS_C3_51),"COST REIMBURSED SERVICES SUBJECT TO DEDUCTIBLES  AND COINSURANCE - CHARGES Blood Storing, Processing, Trans (D_5_HOS_C3_63)",COST SERVICES SUBJECT TO DEDUCTIBLES AND COINSURANCE - COST Recovery Room (D_5_HOS_C6_51),"COST SERVICES SUBJECT TO DEDUCTIBLES AND COINSURANCE - COST Blood Storing, Processing, Trans (D_5_HOS_C6_63)",No Description (G2_C1_26),No Description (G2_C2_26),Intensive Care Unit (S3_1_C4_8),Interns & Res Salary and Fringe Benefits (A_C1_21),"Blood Storing, Processing, Trans (A_C1_63)",Interns & Res Salary and Fringe Benefits (A_C2_21),Interns & Res Salary and Fringe Benefits (A_C6_21),Recovery Room (A_C6_51),"Blood Storing, Processing, Trans (A_C6_63)",Intravenous Therapy (A_C6_64),Other Nonreimbursable (B_1_C21_194),Allocation of Interns & Residents Salary and Fringes Intensive Care Unit (B_1_C21_31),Allocation of Interns & Residents Salary and Fringes Operating Room (B_1_C21_50),Allocation of Interns & Residents Salary and Fringes Recovery Room (B_1_C21_51),Allocation of Interns & Residents Salary and Fringes Delivery Room and Labor Room (B_1_C21_52),Allocation of Interns & Residents Salary and Fringes Anesthesiology (B_1_C21_53),Allocation of Interns & Residents Salary and Fringes Radiology-Diagnostic (B_1_C21_54),Allocation of Interns & Residents Salary and Fringes Radiology-Therapeutic (B_1_C21_55),Allocation of Interns & Residents Salary and Fringes Radioisotope (B_1_C21_56),Allocation of Interns & Residents Salary and Fringes CT Scan (B_1_C21_57),Allocation of Interns & Residents Salary and Fringes MRI (B_1_C21_58),Allocation of Interns & Residents Salary and Fringes Cardiac Catheterization (B_1_C21_59),Allocation of Interns & Residents Salary and Fringes Laboratory (B_1_C21_60),"Allocation of Interns & Residents Salary and Fringes Blood Storing, Processing, Trans (B_1_C21_63)",Allocation of Interns & Residents Salary and Fringes Respiratory Therapy (B_1_C21_65),Allocation of Interns & Residents Salary and Fringes Electrocardiology (B_1_C21_69),Allocation of Interns & Residents Salary and Fringes Electroencephalography (B_1_C21_70),Emergency (B_1_C21_91),Other Nonreimbursable (B_1_C22_194),Allocation of Interns & Residents Program Costs Recovery Room (B_1_C22_51),Allocation of Interns & Residents Program Costs Delivery Room and Labor Room (B_1_C22_52),Allocation of Interns & Residents Program Costs Anesthesiology (B_1_C22_53),Allocation of Interns & Residents Program Costs Radiology-Diagnostic (B_1_C22_54),Allocation of Interns & Residents Program Costs Radiology-Therapeutic (B_1_C22_55),Allocation of Interns & Residents Program Costs Radioisotope (B_1_C22_56),Allocation of Interns & Residents Program Costs CT Scan (B_1_C22_57),Allocation of Interns & Residents Program Costs MRI (B_1_C22_58),Allocation of Interns & Residents Program Costs Cardiac Catheterization (B_1_C22_59),"Allocation of Interns & Residents Program Costs Blood Storing, Processing, Trans (B_1_C22_63)",Allocation of Interns & Residents Program Costs Respiratory Therapy (B_1_C22_65),Allocation of Interns & Residents Program Costs Electrocardiology (B_1_C22_69),Allocation of Interns & Residents Program Costs Electroencephalography (B_1_C22_70),Emergency (B_1_C22_91),Recovery Room (D_4_HOS_C11_51),Delivery Room and Labor Room (D_4_HOS_C11_52),Radiology-Diagnostic (D_4_HOS_C11_54),Radiology-Therapeutic (D_4_HOS_C11_55),CT Scan (D_4_HOS_C11_57),MRI (D_4_HOS_C11_58),Cardiac Catheterization (D_4_HOS_C11_59),Laboratory (D_4_HOS_C11_60),Intravenous Therapy (D_4_HOS_C11_64),Electroencephalography (D_4_HOS_C11_70),Drugs Charged to Patients (D_4_HOS_C11_73),Clinic (D_4_HOS_C11_90),Emergency (D_4_HOS_C11_91),Recovery Room (D_4_HOS_C13_51),Delivery Room and Labor Room (D_4_HOS_C13_52),Anesthesiology (D_4_HOS_C13_53),Radiology-Diagnostic (D_4_HOS_C13_54),Radiology-Therapeutic (D_4_HOS_C13_55),CT Scan (D_4_HOS_C13_57),MRI (D_4_HOS_C13_58),Cardiac Catheterization (D_4_HOS_C13_59),Laboratory (D_4_HOS_C13_60),Intravenous Therapy (D_4_HOS_C13_64),Drugs Charged to Patients (D_4_HOS_C13_73),Clinic (D_4_HOS_C13_90),Emergency (D_4_HOS_C13_91),Recovery Room (D_4_HOS_C3_51),Delivery Room and Labor Room (D_4_HOS_C3_52),Anesthesiology (D_4_HOS_C3_53),Radiology-Diagnostic (D_4_HOS_C3_54),Radiology-Therapeutic (D_4_HOS_C3_55),CT Scan (D_4_HOS_C3_57),MRI (D_4_HOS_C3_58),Cardiac Catheterization (D_4_HOS_C3_59),Laboratory (D_4_HOS_C3_60),Intravenous Therapy (D_4_HOS_C3_64),Electroencephalography (D_4_HOS_C3_70),Drugs Charged to Patients (D_4_HOS_C3_73),Clinic (D_4_HOS_C3_90),Emergency (D_4_HOS_C3_91),COST REIMBURSED SERVICES SUBJECT TO DEDUCTIBLES  AND COINSURANCE - CHARGES Delivery Room and Labor Room (D_5_HOS_C3_52),COST REIMBURSED SERVICES SUBJECT TO DEDUCTIBLES  AND COINSURANCE - CHARGES Radiology-Therapeutic (D_5_HOS_C3_55),COST REIMBURSED SERVICES SUBJECT TO DEDUCTIBLES  AND COINSURANCE - CHARGES Radioisotope (D_5_HOS_C3_56),COST REIMBURSED SERVICES SUBJECT TO DEDUCTIBLES  AND COINSURANCE - CHARGES CT Scan (D_5_HOS_C3_57),COST REIMBURSED SERVICES SUBJECT TO DEDUCTIBLES  AND COINSURANCE - CHARGES MRI (D_5_HOS_C3_58),COST REIMBURSED SERVICES SUBJECT TO DEDUCTIBLES  AND COINSURANCE - CHARGES Cardiac Catheterization (D_5_HOS_C3_59),COST REIMBURSED SERVICES SUBJECT TO DEDUCTIBLES  AND COINSURANCE - CHARGES Intravenous Therapy (D_5_HOS_C3_64),COST REIMBURSED SERVICES SUBJECT TO DEDUCTIBLES  AND COINSURANCE - CHARGES Electroencephalography (D_5_HOS_C3_70),COST SERVICES SUBJECT TO DEDUCTIBLES AND COINSURANCE - COST Delivery Room and Labor Room (D_5_HOS_C6_52),COST SERVICES SUBJECT TO DEDUCTIBLES AND COINSURANCE - COST Radiology-Therapeutic (D_5_HOS_C6_55),COST SERVICES SUBJECT TO DEDUCTIBLES AND COINSURANCE - COST Radioisotope (D_5_HOS_C6_56),COST SERVICES SUBJECT TO DEDUCTIBLES AND COINSURANCE - COST CT Scan (D_5_HOS_C6_57),COST SERVICES SUBJECT TO DEDUCTIBLES AND COINSURANCE - COST MRI (D_5_HOS_C6_58),COST SERVICES SUBJECT TO DEDUCTIBLES AND COINSURANCE - COST Cardiac Catheterization (D_5_HOS_C6_59),COST SERVICES SUBJECT TO DEDUCTIBLES AND COINSURANCE - COST Intravenous Therapy (D_5_HOS_C6_64),COST SERVICES SUBJECT TO DEDUCTIBLES AND COINSURANCE - COST Electroencephalography (D_5_HOS_C6_70),No Description (G2_C2_21),No Description (G_C1THRU4_27),No Description (G_C1THRU4_28),Hospice (S3_1_C6_24),Hospice (S3_1_C7_24),Hospice (S3_1_C8_24),Other Special Purpose (B_1_C26_117),Other Special Purpose (B_2_C26_117),Other Special Purpose (C_1_C5_117),No Description (G_C1THRU4_54),No Description (G_C1THRU4_58),COST REIMBURSED SERVICES SUBJECT TO DEDUCTIBLES  AND COINSURANCE - CHARGES Whole Blood & Packed Red Blood Cells (D_5_HOS_C3_62),COST SERVICES SUBJECT TO DEDUCTIBLES AND COINSURANCE - COST Whole Blood & Packed Red Blood Cells (D_5_HOS_C6_62),COST REIMBURSED SERVICES SUBJECT TO DEDUCTIBLES  AND COINSURANCE - CHARGES Other Ancillary (D_5_HOS_C3_76),COST REIMBURSED SERVICES NOT SUBJECT TO DEDUCTIBLES AND COINSURANCE - CHARGES Emergency (D_5_HOS_C4_91),COST SERVICES SUBJECT TO DEDUCTIBLES AND COINSURANCE - COST Other Ancillary (D_5_HOS_C6_76),COST SERVICES NOT SUBJECT TO DEDUCTIBLES AND COINSURANCE - COST Emergency (D_5_HOS_C7_91),Maintenance of Personnel (A_C2_12),Maintenance of Personnel (A_C6_12),Net Expense for Cost Allocation Maintenance of Personnel (B_1_C0_12),Nonpaid Workers (A_C1_193),Burn Intensive Care Unit (A_C1_33),Burn Intensive Care Unit (A_C2_33),Net Expense for Cost Allocation Burn Intensive Care Unit (B_1_C0_33),Burn Intensive Care Unit (B_1_C26_33),TOTAL CAPITAL COSTS AFTER COST ALLOCATION Burn Intensive Care Unit (B_2_C26_33),Burn Intensive Care Unit (C_1_C5_33),Total Inpatient Charges Burn Intensive Care Unit (C_1_C6_33),Burn Intensive Care Unit (D3_HOS_C2_33),Burn Intensive Care Unit (D_1_HOS_C4_33),Burn Intensive Care Unit (D_1_HOS_C6_33),Burn Intensive Care Unit (D_1_HOS_C7_33),No Description (G2_C1_13),Burn Intensive Care Unit (S3_1_C2_10),Burn Intensive Care Unit (S3_1_C3_10),Burn Intensive Care Unit (S3_1_C6_10),Burn Intensive Care Unit (S3_1_C8_10),Hospice (A_C6_116),Hospice (S3_1_C2_24),COST REIMBURSED SERVICES SUBJECT TO DEDUCTIBLES  AND COINSURANCE - CHARGES ASC (Non Distinct Part) (D_5_HOS_C3_75),COST SERVICES SUBJECT TO DEDUCTIBLES AND COINSURANCE - COST ASC (Non Distinct Part) (D_5_HOS_C6_75),Radiology-Therapeutic (D3_IPF_C2_55),Cardiac Catheterization (D3_IPF_C2_59),"Blood Storing, Processing, Trans (D3_IPF_C2_63)",Intravenous Therapy (D3_IPF_C2_64),Other Ancillary (D3_IPF_C2_76),Radiology-Therapeutic (D3_IPF_C3_55),Cardiac Catheterization (D3_IPF_C3_59),"Blood Storing, Processing, Trans (D3_IPF_C3_63)",Intravenous Therapy (D3_IPF_C3_64),Other Ancillary (D3_IPF_C3_76),No Description (D_2_IPF_C5_55),No Description (D_2_IPF_C5_59),No Description (D_2_IPF_C5_63),No Description (D_2_IPF_C5_64),No Description (D_2_IPF_C5_76),COST REIMBURSED SERVICES NOT SUBJECT TO DEDUCTIBLES AND COINSURANCE - CHARGES Radiology-Therapeutic (D_5_HOS_C4_55),COST REIMBURSED SERVICES NOT SUBJECT TO DEDUCTIBLES AND COINSURANCE - CHARGES CT Scan (D_5_HOS_C4_57),COST REIMBURSED SERVICES NOT SUBJECT TO DEDUCTIBLES AND COINSURANCE - CHARGES MRI (D_5_HOS_C4_58),COST REIMBURSED SERVICES NOT SUBJECT TO DEDUCTIBLES AND COINSURANCE - CHARGES Intravenous Therapy (D_5_HOS_C4_64),COST REIMBURSED SERVICES NOT SUBJECT TO DEDUCTIBLES AND COINSURANCE - CHARGES Electrocardiology (D_5_HOS_C4_69),COST REIMBURSED SERVICES NOT SUBJECT TO DEDUCTIBLES AND COINSURANCE - CHARGES Clinic (D_5_HOS_C4_90),COST SERVICES NOT SUBJECT TO DEDUCTIBLES AND COINSURANCE - COST Radiology-Therapeutic (D_5_HOS_C7_55),COST SERVICES NOT SUBJECT TO DEDUCTIBLES AND COINSURANCE - COST CT Scan (D_5_HOS_C7_57),COST SERVICES NOT SUBJECT TO DEDUCTIBLES AND COINSURANCE - COST MRI (D_5_HOS_C7_58),COST SERVICES NOT SUBJECT TO DEDUCTIBLES AND COINSURANCE - COST Intravenous Therapy (D_5_HOS_C7_64),COST SERVICES NOT SUBJECT TO DEDUCTIBLES AND COINSURANCE - COST Electrocardiology (D_5_HOS_C7_69),COST SERVICES NOT SUBJECT TO DEDUCTIBLES AND COINSURANCE - COST Clinic (D_5_HOS_C7_90),COST REIMBURSED SERVICES NOT SUBJECT TO DEDUCTIBLES AND COINSURANCE - CHARGES Anesthesiology (D_5_HOS_C4_53),COST SERVICES NOT SUBJECT TO DEDUCTIBLES AND COINSURANCE - COST Anesthesiology (D_5_HOS_C7_53),Durable Medical Equipment Rented (A_C1_96),Durable Medical Equipment Rented (A_C2_96),Net Expense for Cost Allocation Durable Medical Equipment Rented (B_1_C0_96),Durable Medical Equipment Rented (B_1_C26_96),Durable Medical Equipment Rented (B_2_C26_96),Other Reimbursable (C_1_C6_98),Durable Medical Equipment Rented (C_1_C7_96),COST REIMBURSED SERVICES SUBJECT TO DEDUCTIBLES  AND COINSURANCE - CHARGES Other Reimbursable (D_5_HOS_C3_98),COST SERVICES SUBJECT TO DEDUCTIBLES AND COINSURANCE - COST Other Reimbursable (D_5_HOS_C6_98),No Description (G_C1THRU4_3),No Description (G_C1THRU4_53),No Description (G_C1THRU4_32),Other Special Purpose (A_C2_117),Cafeteria (A_C1_11),Other Organ Acquisition (A_C1_112),Cafeteria (A_C2_11),Other Organ Acquisition (A_C2_112),Other Organ Acquisition (A_C6_112),Research (A_C6_191),Coronary Care Unit (A_C6_32),Net Expense for Cost Allocation Other Organ Acquisition (B_1_C0_112),Research (B_1_C21_191),Allocation of Interns & Residents Salary and Fringes Coronary Care Unit (B_1_C21_32),Allocation of Interns & Residents Salary and Fringes Surgical Intensive Care Unit (B_1_C21_34),Allocation of Interns & Residents Salary and Fringes Other Special Care Unit (B_1_C21_35),Allocation of Interns & Residents Salary and Fringes Physical Therapy (B_1_C21_66),ASC (Non Distinct Part) (B_1_C21_75),Research (B_1_C22_191),Allocation of Interns & Residents Program Costs Coronary Care Unit (B_1_C22_32),Allocation of Interns & Residents Program Costs Surgical Intensive Care Unit (B_1_C22_34),Allocation of Interns & Residents Program Costs Other Special Care Unit (B_1_C22_35),Allocation of Interns & Residents Program Costs Physical Therapy (B_1_C22_66),ASC (Non Distinct Part) (B_1_C22_75),Other Organ Acquisition (B_1_C26_112),Other Organ Acquisition (B_2_C26_112),Other Organ Acquisition (C_1_C5_112),Other Organ Acquisition (C_1_C6_112),Other Organ Acquisition (C_1_C7_112),Coronary Care Unit Program Cost (D1_HOS_C5_44),Delivery Room and Labor Room (D3_IPF_C2_52),Electroencephalography (D3_IPF_C2_70),Delivery Room and Labor Room (D3_IPF_C3_52),Electroencephalography (D3_IPF_C3_70),Cardiac Catheterization (D3_IRF_C2_59),"Blood Storing, Processing, Trans (D3_IRF_C2_63)",Other Ancillary (D3_IRF_C2_76),Cardiac Catheterization (D3_IRF_C3_59),"Blood Storing, Processing, Trans (D3_IRF_C3_63)",Other Ancillary (D3_IRF_C3_76),No Description (D_2_IPF_C5_52),No Description (D_2_IPF_C5_70),No Description (D_2_IRF_C5_59),No Description (D_2_IRF_C5_63),No Description (D_2_IRF_C5_76),Coronary Care Unit (D_3_HOS_C9_32),Surgical Intensive Care Unit (D_3_HOS_C9_34),ASC (Non Distinct Part) (D_4_HOS_C11_75),Speech Pathology (D_4_HOS_C12_68),ASC (Non Distinct Part) (D_4_HOS_C13_75),ASC (Non Distinct Part) (D_4_HOS_C3_75),Operating Room (D_4_IPF_C11_50),Emergency (D_4_IPF_C11_91),Operating Room (D_4_IRF_C11_50),Radiology-Therapeutic (D_4_IRF_C11_55),PPS REIMBURSED SERVICES -  CHARGES Speech Pathology (D_5_HOS_C2_68),PPS SERVICES COST Speech Pathology (D_5_HOS_C5_68),Interns & Res Other Program Costs (A_C1_22),Durable Medical Equipment Sold (C_1_C6_97),Durable Medical Equipment Sold (D_4_HOS_C12_97),PPS REIMBURSED SERVICES -  CHARGES Durable Medical Equipment Sold (D_5_HOS_C2_97),PPS SERVICES COST Durable Medical Equipment Sold (D_5_HOS_C5_97),COST REIMBURSED SERVICES NOT SUBJECT TO DEDUCTIBLES AND COINSURANCE - CHARGES Cardiac Catheterization (D_5_HOS_C4_59),COST SERVICES NOT SUBJECT TO DEDUCTIBLES AND COINSURANCE - COST Cardiac Catheterization (D_5_HOS_C7_59),HHA (S3_1_C11_22),Hospice (S3_1_C11_24),RHC/FQHC Combined (S3_1_C11_26),Other Outpatient Services (B_1_C21_93),Other Outpatient Services (D_4_HOS_C12_93),Radiology-Diagnostic (D_4_HOS_C4_54),CT Scan (D_4_HOS_C4_57),MRI (D_4_HOS_C4_58),Radiology-Diagnostic (D_4_IPF_C11_54),CT Scan (D_4_IPF_C11_57),MRI (D_4_IPF_C11_58),Radiology-Diagnostic (D_4_IRF_C11_54),CT Scan (D_4_IRF_C11_57),MRI (D_4_IRF_C11_58),PPS REIMBURSED SERVICES -  CHARGES Other Outpatient Services (D_5_HOS_C2_93),COST REIMBURSED SERVICES NOT SUBJECT TO DEDUCTIBLES AND COINSURANCE - CHARGES Medical Supplies Charged to Patients (D_5_HOS_C4_71),PPS SERVICES COST Other Outpatient Services (D_5_HOS_C5_93),COST SERVICES NOT SUBJECT TO DEDUCTIBLES AND COINSURANCE - COST Medical Supplies Charged to Patients (D_5_HOS_C7_71),Hospice (S3_1_C3_24),Nursing School (A_C2_20),Net Expense for Cost Allocation Nursing School (B_1_C0_20),FQHC (B_1_C26_89),FQHC (B_2_C26_89),FQHC (C_1_C5_89),HHA (C_1_C6_101),Impl. Dev. Charged to Patients (D3_SNF_C2_72),Impl. Dev. Charged to Patients (D3_SNF_C3_72),Operating Room (D_4_HOS_C2_50),Delivery Room and Labor Room (D_4_HOS_C2_52),Emergency (D_4_HOS_C2_91),Emergency (D_4_IRF_C11_91),Radiology-Diagnostic (D_4_SNF_C11_54),Whole Blood & Packed Red Blood Cells (D3_IPF_C2_62),Whole Blood & Packed Red Blood Cells (D3_IPF_C3_62),No Description (D_2_IPF_C5_62),Other Outpatient Services (C_1_C6_93),Other Outpatient Services (D3_HOS_C2_93),Other Outpatient Services (D3_HOS_C3_93),No Description (D_2_HOS_C5_93),Other Outpatient Services (D_4_HOS_C10_93),Net Expense for Cost Allocation Other Special Purpose (B_1_C0_117),Other Special Purpose (C_1_C6_117),Other Special Purpose (A_C1_117),Other Special Purpose (A_C6_117),Nonpaid Workers (A_C6_193),No Description (G2_C1_21),"Blood Storing, Processing, Trans (D3_SNF_C2_63)",Electroencephalography (D3_SNF_C2_70),Other Ancillary (D3_SNF_C2_76),"Blood Storing, Processing, Trans (D3_SNF_C3_63)",Electroencephalography (D3_SNF_C3_70),Other Ancillary (D3_SNF_C3_76),No Description (G_C1THRU4_57),Operating Room (D_4_HOS_C1_50),No Description (G2_C1_24),No Description (G2_C2_24),Durable Medical Equipment Rented (A_C6_96),Operating Room (D3_SNF_C2_50),Operating Room (D3_SNF_C3_50),Maintenance of Personnel (A_C1_12),No Description (G_C1THRU4_48),No Description (E3_6_SNF_C1_14),Durable Medical Equipment Rented (C_1_C5_96),Other Special Purpose (C_1_C7_117),No Description (E3_4_HOS_C1_21),Physical Therapy (C_1_C2_66),Anesthesiology (D3_SNF_C2_53),Anesthesiology (D3_SNF_C3_53),Other Outpatient Services (D3_IPF_C2_93),Other Outpatient Services (D3_IPF_C3_93),No Description (D_2_IPF_C5_93),No Description (E3_2_HOS_C1_30),COST REIMBURSED SERVICES NOT SUBJECT TO DEDUCTIBLES AND COINSURANCE - CHARGES Operating Room (D_5_HOS_C4_50),COST SERVICES NOT SUBJECT TO DEDUCTIBLES AND COINSURANCE - COST Operating Room (D_5_HOS_C7_50),Intensive Care Unit (D3_IRF_C2_31),Radiology-Therapeutic (D3_SNF_C2_55),CT Scan (D3_SNF_C2_57),MRI (D3_SNF_C2_58),Radiology-Therapeutic (D3_SNF_C3_55),CT Scan (D3_SNF_C3_57),MRI (D3_SNF_C3_58),COST REIMBURSED SERVICES NOT SUBJECT TO DEDUCTIBLES AND COINSURANCE - CHARGES Respiratory Therapy (D_5_HOS_C4_65),COST SERVICES NOT SUBJECT TO DEDUCTIBLES AND COINSURANCE - COST Respiratory Therapy (D_5_HOS_C7_65),Nursing School (A_C6_20),Allocation of Interns & Residents Salary and Fringes Intravenous Therapy (B_1_C21_64),Allocation of Interns & Residents Salary and Fringes Medical Supplies Charged to Patients (B_1_C21_71),Drugs Charged to Patients (B_1_C21_73),Allocation of Interns & Residents Program Costs Speech Pathology (B_1_C22_68),Drugs Charged to Patients (B_1_C22_73),Burn Intensive Care Unit Program Cost (D1_HOS_C5_45),Surgical Intensive Care Unit Program Cost (D1_HOS_C5_46),ASC (Non Distinct Part) (D3_IPF_C2_75),ASC (Non Distinct Part) (D3_IPF_C3_75),No Description (D_2_IPF_C5_75),Burn Intensive Care Unit (D_3_HOS_C9_33),Radioisotope (D_4_HOS_C11_56),"Blood Storing, Processing, Trans (D_4_HOS_C11_63)",Respiratory Therapy (D_4_HOS_C11_65),Physical Therapy (D_4_HOS_C11_66),Electrocardiology (D_4_HOS_C11_69),Medical Supplies Charged to Patients (D_4_HOS_C11_71),Radioisotope (D_4_HOS_C13_56),"Blood Storing, Processing, Trans (D_4_HOS_C13_63)",Respiratory Therapy (D_4_HOS_C13_65),Physical Therapy (D_4_HOS_C13_66),Electrocardiology (D_4_HOS_C13_69),Electroencephalography (D_4_HOS_C13_70),Medical Supplies Charged to Patients (D_4_HOS_C13_71),Recovery Room (D_4_HOS_C2_51),Anesthesiology (D_4_HOS_C2_53),Radiology-Diagnostic (D_4_HOS_C2_54),Radiology-Therapeutic (D_4_HOS_C2_55),MRI (D_4_HOS_C2_58),Respiratory Therapy (D_4_HOS_C2_65),Physical Therapy (D_4_HOS_C2_66),Electrocardiology (D_4_HOS_C2_69),Electroencephalography (D_4_HOS_C2_70),ASC (Non Distinct Part) (D_4_HOS_C2_75),Clinic (D_4_HOS_C2_90),Radioisotope (D_4_HOS_C3_56),"Blood Storing, Processing, Trans (D_4_HOS_C3_63)",Respiratory Therapy (D_4_HOS_C3_65),Physical Therapy (D_4_HOS_C3_66),Electrocardiology (D_4_HOS_C3_69),Medical Supplies Charged to Patients (D_4_HOS_C3_71),ASC (Non Distinct Part) (D_4_IPF_C11_75),Recovery Room (D_4_IRF_C11_51),Electroencephalography (D_4_IRF_C11_70),Radioisotope (D_4_IRF_C13_56),Burn Intensive Care Unit (S3_1_C7_10),Nursing School (A_C1_20),Intensive Care Unit (D3_IPF_C2_31),Delivery Room and Labor Room (D3_SNF_C2_52),Cardiac Catheterization (D3_SNF_C2_59),Delivery Room and Labor Room (D3_SNF_C3_52),Cardiac Catheterization (D3_SNF_C3_59),"Gift, Flower, Coffee Shop, Canteen (B_1_C21_190)",Physicians' Private Office (B_1_C21_192),Other Ancillary (B_1_C21_76),"Gift, Flower, Coffee Shop, Canteen (B_1_C22_190)",Physicians' Private Office (B_1_C22_192),Other Ancillary (B_1_C22_76),Other Outpatient Services (B_1_C22_93),Burn Intensive Care Unit (A_C6_33),Other Special Care Unit (D3_HOS_C2_35),Other Special Care Unit (D_1_HOS_C6_35),Other Special Care Unit (D_1_HOS_C7_35),Other Special Care Unit (D_3_HOS_C9_35),Other Outpatient Services (D_4_HOS_C13_93),Other Ancillary (D_4_HOS_C3_76),Other Outpatient Services (D_4_HOS_C3_93),Other Special Care (S3_1_C6_12),Whole Blood & Packed Red Blood Cells (D3_IRF_C2_62),Whole Blood & Packed Red Blood Cells (D3_IRF_C3_62),No Description (D_2_IRF_C5_62),Surgical Intensive Care Unit (A_C6_34),Allocation of Interns & Residents Salary and Fringes Burn Intensive Care Unit (B_1_C21_33),Allocation of Interns & Residents Program Costs Burn Intensive Care Unit (B_1_C22_33),Intravenous Therapy (D3_IRF_C2_64),Intravenous Therapy (D3_IRF_C3_64),No Description (D_2_IRF_C5_64),Respiratory Therapy (D_4_IRF_C11_65),Clinic (D_4_IRF_C11_90),COST REIMBURSED SERVICES SUBJECT TO DEDUCTIBLES  AND COINSURANCE - CHARGES Observation Beds (Distinct Unit) (D_5_HOS_C3_9201),COST SERVICES SUBJECT TO DEDUCTIBLES AND COINSURANCE - COST Observation Beds (Distinct Unit) (D_5_HOS_C6_9201),Allocation of Interns & Residents Salary and Fringes Occupational Therapy (B_1_C21_67),Allocation of Interns & Residents Program Costs Occupational Therapy (B_1_C22_67),Radioisotope (D3_SNF_C2_56),Radioisotope (D3_SNF_C3_56),Other Reimbursable (D3_HOS_C2_98),Other Reimbursable (D3_HOS_C3_98),No Description (D_2_HOS_C5_98),Other Reimbursable (D_4_HOS_C10_98),COST REIMBURSED SERVICES NOT SUBJECT TO DEDUCTIBLES AND COINSURANCE - CHARGES Other Ancillary (D_5_HOS_C4_76),COST SERVICES NOT SUBJECT TO DEDUCTIBLES AND COINSURANCE - COST Other Ancillary (D_5_HOS_C7_76),Coronary Care Unit (S3_1_C4_9),Laboratory (D_4_SNF_C11_60),Drugs Charged to Patients (D_4_SNF_C11_73),Observation Beds (Distinct Unit) (A_C6_9201),COST REIMBURSED SERVICES NOT SUBJECT TO DEDUCTIBLES AND COINSURANCE - CHARGES Radioisotope (D_5_HOS_C4_56),COST SERVICES NOT SUBJECT TO DEDUCTIBLES AND COINSURANCE - COST Radioisotope (D_5_HOS_C7_56),Impl. Dev. Charged to Patients (A_C6_72),Delivery Room and Labor Room (D3_IRF_C2_52),Delivery Room and Labor Room (D3_IRF_C3_52),No Description (D_2_IRF_C5_52),Clinic (D_4_IRF_C13_90),ASC (Distinct Part) (A_C1_115),ASC (Distinct Part) (A_C2_115),ASC (Distinct Part) (A_C6_115),Recovery Room (D3_SNF_C2_51),ASC (Non Distinct Part) (D3_SNF_C2_75),Recovery Room (D3_SNF_C3_51),ASC (Non Distinct Part) (D3_SNF_C3_75),"Blood Storing, Processing, Trans (D_4_HOS_C2_63)",Anesthesiology (D_4_IPF_C11_53),Laboratory (D_4_IPF_C11_60),"Blood Storing, Processing, Trans (D_4_IPF_C11_63)",Anesthesiology (D_4_IRF_C11_53),Laboratory (D_4_IRF_C11_60),"Blood Storing, Processing, Trans (D_4_IRF_C11_63)",ASC (Non Distinct Part) (D_4_IRF_C11_75),Operating Room (D_4_SNF_C11_50),Anesthesiology (D_4_SNF_C11_53),"Blood Storing, Processing, Trans (D_4_SNF_C11_63)",Emergency (D_4_SNF_C11_91),ASC (Distinct Part) (B_1_C26_115),ASC (Distinct Part) (B_2_C26_115),ASC (Distinct Part) (C_1_C5_115),ASC (Distinct Part) (C_1_C6_115),ASC (Distinct Part) (C_1_C7_115),Durable Medical Equipment Rented (C_1_C6_96),No Description (E3_1_HOS_C1_17),Speech Pathology (D_4_HOS_C11_68),Speech Pathology (D_4_HOS_C3_68),Intravenous Therapy (D3_SNF_C2_64),Intravenous Therapy (D3_SNF_C3_64),Allocation of Interns & Residents Salary and Fringes Whole Blood & Packed Red Blood Cells (B_1_C21_62),Allocation of Interns & Residents Program Costs Whole Blood & Packed Red Blood Cells (B_1_C22_62),Speech Pathology (D_4_HOS_C13_68),Whole Blood & Packed Red Blood Cells (D_4_HOS_C3_62),Radiology-Diagnostic (D_4_IPF_C13_54),FQHC (A_C6_89),Net Expense for Cost Allocation FQHC (B_1_C0_89),FQHC (C_1_C6_89),Other Ancillary (D_4_HOS_C11_76),Other Ancillary (D_4_HOS_C13_76),Occupational Therapy (D_4_HOS_C11_67),Occupational Therapy (D_4_HOS_C3_67),Occupational Therapy (D_4_IPF_C11_67),FQHC (A_C2_89),Intensive Care Unit (S3_1_C5_8),Drugs Charged to Patients (D_4_IRF_C11_73),Drugs Charged to Patients (D_4_IRF_C13_73),Durable Medical Equipment Sold (A_C6_97),Other Outpatient Services (D3_SNF_C2_93),Other Outpatient Services (D3_SNF_C3_93),COST REIMBURSED SERVICES NOT SUBJECT TO DEDUCTIBLES AND COINSURANCE - CHARGES Recovery Room (D_5_HOS_C4_51),"COST REIMBURSED SERVICES NOT SUBJECT TO DEDUCTIBLES AND COINSURANCE - CHARGES Blood Storing, Processing, Trans (D_5_HOS_C4_63)",COST REIMBURSED SERVICES NOT SUBJECT TO DEDUCTIBLES AND COINSURANCE - CHARGES Physical Therapy (D_5_HOS_C4_66),COST REIMBURSED SERVICES NOT SUBJECT TO DEDUCTIBLES AND COINSURANCE - CHARGES Occupational Therapy (D_5_HOS_C4_67),COST REIMBURSED SERVICES NOT SUBJECT TO DEDUCTIBLES AND COINSURANCE - CHARGES Speech Pathology (D_5_HOS_C4_68),COST SERVICES NOT SUBJECT TO DEDUCTIBLES AND COINSURANCE - COST Recovery Room (D_5_HOS_C7_51),"COST SERVICES NOT SUBJECT TO DEDUCTIBLES AND COINSURANCE - COST Blood Storing, Processing, Trans (D_5_HOS_C7_63)",COST SERVICES NOT SUBJECT TO DEDUCTIBLES AND COINSURANCE - COST Physical Therapy (D_5_HOS_C7_66),COST SERVICES NOT SUBJECT TO DEDUCTIBLES AND COINSURANCE - COST Occupational Therapy (D_5_HOS_C7_67),COST SERVICES NOT SUBJECT TO DEDUCTIBLES AND COINSURANCE - COST Speech Pathology (D_5_HOS_C7_68),COST REIMBURSED SERVICES NOT SUBJECT TO DEDUCTIBLES AND COINSURANCE - CHARGES Delivery Room and Labor Room (D_5_HOS_C4_52),COST SERVICES NOT SUBJECT TO DEDUCTIBLES AND COINSURANCE - COST Delivery Room and Labor Room (D_5_HOS_C7_52),Laboratory (D_4_HOS_C2_60),Intensive Care Unit (D3_SNF_C2_31),Other Outpatient Services (D_4_HOS_C11_93),Respiratory Therapy (D_4_SNF_C11_65),Physical Therapy (D_4_SNF_C11_66),Occupational Therapy (D_4_SNF_C11_67),Speech Pathology (D_4_SNF_C11_68),Durable Medical Equipment Sold (D3_HOS_C2_97),Durable Medical Equipment Sold (D3_HOS_C3_97),No Description (D_2_HOS_C5_97),Durable Medical Equipment Sold (D_4_HOS_C10_97),Total Inpatient Charges Blood Clotting Factors for Hemoph. (C_1_C6_6250),Blood Clotting Factors for Hemoph. (D3_HOS_C2_6250),Blood Clotting Factors for Hemoph. (D_4_HOS_C10_6250),CORF (A_C1_9910),CORF (A_C2_9910),CORF (A_C6_9910),Net Expense for Cost Allocation CORF (B_1_C0_9910),CORF (B_1_C26_9910),CORF (B_2_C26_9910),CORF (C_1_C5_9910),CORF (C_1_C7_9910),COST REIMBURSED SERVICES NOT SUBJECT TO DEDUCTIBLES AND COINSURANCE - CHARGES Other Outpatient Services (D_5_HOS_C4_93),COST SERVICES NOT SUBJECT TO DEDUCTIBLES AND COINSURANCE - COST Other Outpatient Services (D_5_HOS_C7_93),Outpatient Rehab Provider (S3_1_C10_25),Other Ancillary (D_4_HOS_C2_76),Other Ancillary (D_4_IPF_C11_76),Other Ancillary (D_4_IRF_C11_76),Other Outpatient Services (D3_IRF_C2_93),Other Outpatient Services (D3_IRF_C3_93),No Description (D_2_IRF_C5_93),CT Scan (D_4_HOS_C2_57),CT Scan (D_4_SNF_C11_57),No Description (G_C1THRU4_56),RHC (B_1_C21_88),RHC (B_1_C22_88),RHC/FQHC Combined (S3_1_C9_26),CORF (C_1_C6_9910),No Description (E3_2_IPF_C1_30),Radiology-Diagnostic (D_4_IRF_C13_54),Respiratory Therapy (D_4_IRF_C13_65),Emergency (D_4_IRF_C13_91),Whole Blood & Packed Red Blood Cells (D_4_HOS_C11_62),Impl. Dev. Charged to Patients (D_4_HOS_C11_72),Whole Blood & Packed Red Blood Cells (D_4_HOS_C13_62),Impl. Dev. Charged to Patients (D_4_HOS_C13_72),Impl. Dev. Charged to Patients (D_4_HOS_C3_72),Respiratory Therapy (D_4_IPF_C11_65),Electrocardiology (D_4_IPF_C11_69),Electroencephalography (D_4_IPF_C11_70),Impl. Dev. Charged to Patients (D_4_IPF_C11_72),Drugs Charged to Patients (D_4_IPF_C11_73),Operating Room (D_4_IPF_C13_50),Delivery Room and Labor Room (D_4_IPF_C13_52),CT Scan (D_4_IPF_C13_57),Laboratory (D_4_IPF_C13_60),Electroencephalography (D_4_IPF_C13_70),Medical Supplies Charged to Patients (D_4_IPF_C13_71),Impl. Dev. Charged to Patients (D_4_IPF_C13_72),Drugs Charged to Patients (D_4_IPF_C13_73),Radioisotope (D_4_IPF_C11_56),Radioisotope (D_4_IRF_C11_56),Other Outpatient Services (D_4_HOS_C2_93),Other Reimbursable (D3_IRF_C2_98),Other Reimbursable (D3_IRF_C3_98),Other Reimbursable (D3_SNF_C2_98),Other Reimbursable (D3_SNF_C3_98),No Description (D_2_IRF_C5_98),Cardiac Catheterization (D_4_HOS_C2_59),Cardiac Catheterization (D_4_IPF_C11_59),Cardiac Catheterization (D_4_IRF_C11_59),Radiology-Therapeutic (D_4_SNF_C11_55),Cardiac Catheterization (D_4_SNF_C11_59),Observation Beds (Distinct Unit) (D3_IPF_C2_9201),Observation Beds (Distinct Unit) (D3_IPF_C3_9201),Observation Beds (Distinct Unit) (D3_IRF_C2_9201),Observation Beds (Distinct Unit) (D3_IRF_C3_9201),No Description (D_2_IPF_C5_9201),No Description (D_2_IRF_C5_9201),Physical Therapy (D_4_IPF_C11_66),Physical Therapy (D_4_IRF_C11_66),Recovery Room (D_4_IPF_C11_51),Other Reimbursable (B_1_C21_98),Other Reimbursable (B_1_C22_98),Coronary Care Unit (S3_1_C5_9),Durable Medical Equipment Rented (D3_HOS_C2_96),Durable Medical Equipment Rented (D3_HOS_C3_96),Durable Medical Equipment Rented (D3_IPF_C2_96),Durable Medical Equipment Rented (D3_IPF_C3_96),Durable Medical Equipment Rented (D3_IRF_C2_96),Durable Medical Equipment Rented (D3_IRF_C3_96),No Description (D_2_HOS_C5_96),No Description (D_2_IPF_C5_96),No Description (D_2_IRF_C5_96),Durable Medical Equipment Rented (D_4_HOS_C10_96),COST REIMBURSED SERVICES NOT SUBJECT TO DEDUCTIBLES AND COINSURANCE - CHARGES Electroencephalography (D_5_HOS_C4_70),COST SERVICES NOT SUBJECT TO DEDUCTIBLES AND COINSURANCE - COST Electroencephalography (D_5_HOS_C7_70),No Description (G_C1THRU4_55),Observation Beds (Distinct Unit) (B_1_C22_9201),Observation Beds (Distinct Unit) (D_4_HOS_C11_9201),Observation Beds (Distinct Unit) (D_4_HOS_C13_9201),Observation Beds (Distinct Unit) (D_4_HOS_C2_9201),Observation Beds (Distinct Unit) (D_4_IPF_C11_9201),Emergency (D_4_IPF_C13_91),Observation Beds (Distinct Unit) (D_4_IRF_C11_9201),Occupational Therapy (D_4_HOS_C13_67),Occupational Therapy (D_4_IRF_C11_67),Speech Pathology (D_4_IRF_C11_68),Electrocardiology (D_4_IRF_C11_69),Medical Supplies Charged to Patients (D_4_IRF_C11_71),Impl. Dev. Charged to Patients (D_4_IRF_C11_72),COST REIMBURSED SERVICES SUBJECT TO DEDUCTIBLES  AND COINSURANCE - CHARGES Durable Medical Equipment Rented (D_5_HOS_C3_96),COST SERVICES SUBJECT TO DEDUCTIBLES AND COINSURANCE - COST Durable Medical Equipment Rented (D_5_HOS_C6_96),Medical Supplies Charged to Patients (D_4_SNF_C11_71),Impl. Dev. Charged to Patients (A_C1_72),Observation Beds (Distinct Unit) (B_1_C21_9201),Net Expense for Cost Allocation ASC (Distinct Part) (B_1_C0_115),Operating Room (D_4_IRF_C13_50),RHC (D_4_HOS_C2_88),Other Special Care (S3_1_C5_12),Burn Intensive Care Unit (S3_1_C5_10),Coronary Care Unit (D3_IRF_C2_32),No Description (E3_3_HOS_C1_31),Other Special Care Unit (D3_IPF_C2_35),Clinic (D_4_IPF_C11_90),FQHC (A_C1_89),CMHC (A_C1_99),CMHC (A_C2_99),CMHC (A_C6_99),Net Expense for Cost Allocation CMHC (B_1_C0_99),CMHC (B_1_C26_99),CMHC (B_2_C26_99),CMHC (C_1_C5_99),CMHC (C_1_C6_99),CMHC (C_1_C7_99),Other Outpatient Services (D_4_IPF_C11_93),Other Outpatient Services (D_4_SNF_C11_93),Other Reimbursable (D3_IPF_C2_98),Other Reimbursable (D3_IPF_C3_98),No Description (D_2_IPF_C5_98),Intravenous Therapy (D_4_HOS_C2_64),Allocation of Interns & Residents Salary and Fringes Speech Pathology (B_1_C21_68),Operating Room (D_4_HOS_C4_50),Recovery Room (D_4_HOS_C4_51),Respiratory Therapy (D_4_HOS_C4_65),ASC (Non Distinct Part) (D_4_HOS_C4_75),Clinic (D_4_HOS_C4_90),Emergency (D_4_HOS_C4_91),Clinic (D_4_IPF_C13_90),Durable Medical Equipment Sold (D_4_HOS_C13_97),Drugs Charged to Patients (D_4_HOS_C2_73),Durable Medical Equipment Sold (D_4_HOS_C2_97),Observation Beds (Distinct Unit) (D_4_HOS_C3_9201),Durable Medical Equipment Sold (D_4_HOS_C3_97),COST REIMBURSED SERVICES SUBJECT TO DEDUCTIBLES  AND COINSURANCE - CHARGES Durable Medical Equipment Sold (D_5_HOS_C3_97),COST SERVICES SUBJECT TO DEDUCTIBLES AND COINSURANCE - COST Durable Medical Equipment Sold (D_5_HOS_C6_97),COST REIMBURSED SERVICES NOT SUBJECT TO DEDUCTIBLES AND COINSURANCE - CHARGES Whole Blood & Packed Red Blood Cells (D_5_HOS_C4_62),COST SERVICES NOT SUBJECT TO DEDUCTIBLES AND COINSURANCE - COST Whole Blood & Packed Red Blood Cells (D_5_HOS_C7_62),COST REIMBURSED SERVICES NOT SUBJECT TO DEDUCTIBLES AND COINSURANCE - CHARGES Observation Beds (Distinct Unit) (D_5_HOS_C4_9201),COST SERVICES NOT SUBJECT TO DEDUCTIBLES AND COINSURANCE - COST Observation Beds (Distinct Unit) (D_5_HOS_C7_9201),Allocation of Interns & Residents Program Costs Medical Supplies Charged to Patients (B_1_C22_71),Electrocardiology (D_4_IPF_C13_69),Durable Medical Equipment Rented (D_4_HOS_C12_96),PPS REIMBURSED SERVICES -  CHARGES Durable Medical Equipment Rented (D_5_HOS_C2_96),PPS SERVICES COST Durable Medical Equipment Rented (D_5_HOS_C5_96),Recovery Room (D_4_SNF_C11_51),Electroencephalography (D_4_SNF_C11_70),Other Ancillary (D_4_SNF_C11_76),Other Organ Acquisition (B_1_C21_112),Allocation of Interns & Residents Program Costs Intravenous Therapy (B_1_C22_64),Delivery Room and Labor Room (D_4_IPF_C11_52),Other Organ Acquisition (B_1_C22_112),Allocation of Interns & Residents Program Costs Impl. Dev. Charged to Patients (B_1_C22_72),Clinic (D_4_SNF_C11_90),Nonpaid Workers (B_1_C21_193),Nonpaid Workers (B_1_C22_193),Coronary Care Unit (D3_IPF_C2_32),Burn Intensive Care Unit (D3_IPF_C2_33),Surgical Intensive Care Unit (D3_IPF_C2_34),Burn Intensive Care Unit (D3_IRF_C2_33),Surgical Intensive Care Unit (D3_IRF_C2_34),Other Special Care Unit (D3_IRF_C2_35),Intravenous Therapy (D_4_IPF_C11_64),Delivery Room and Labor Room (D_4_IRF_C11_52),Intravenous Therapy (D_4_IRF_C11_64),Radioisotope (D_4_SNF_C11_56),Radiology-Therapeutic (D_4_IPF_C11_55),OPT (A_C1_9920),OOT (A_C1_9930),OSP (A_C1_9940),OPT (A_C2_9920),OOT (A_C2_9930),OSP (A_C2_9940),OPT (A_C6_9920),OOT (A_C6_9930),OSP (A_C6_9940),Net Expense for Cost Allocation OPT (B_1_C0_9920),Net Expense for Cost Allocation OOT (B_1_C0_9930),Net Expense for Cost Allocation OSP (B_1_C0_9940),OPT (B_1_C26_9920),OOT (B_1_C26_9930),OSP (B_1_C26_9940),OPT (B_2_C26_9920),OOT (B_2_C26_9930),OSP (B_2_C26_9940),OPT (C_1_C5_9920),OOT (C_1_C5_9930),OSP (C_1_C5_9940),OPT (C_1_C7_9920),OOT (C_1_C7_9930),OSP (C_1_C7_9940),Laboratory (D_4_IRF_C13_60),Anesthesiology (D_4_IPF_C13_53),Other Outpatient Services (D_4_IRF_C11_93),Observation Beds (Distinct Unit) (D3_SNF_C2_9201),Observation Beds (Distinct Unit) (D3_SNF_C3_9201),Allocation of Interns & Residents Salary and Fringes Impl. Dev. Charged to Patients (B_1_C21_72),Other Special Care (S3_1_C4_12),Surgical Intensive Care Unit (S3_1_C5_11),Whole Blood & Packed Red Blood Cells (D_4_IPF_C11_62),Speech Pathology (D_4_IPF_C11_68),Whole Blood & Packed Red Blood Cells (D_4_IRF_C11_62),Electrocardiology (D_4_IRF_C13_69),No Description (E_B_IPF_C1_39),No Description (E_B_IRF_C1_39),Hospice (S3_1_C9_24),COST REIMBURSED SERVICES NOT SUBJECT TO DEDUCTIBLES AND COINSURANCE - CHARGES ASC (Non Distinct Part) (D_5_HOS_C4_75),COST SERVICES NOT SUBJECT TO DEDUCTIBLES AND COINSURANCE - COST ASC (Non Distinct Part) (D_5_HOS_C7_75),Other Reimbursable (D_4_HOS_C11_98),Other Reimbursable (D_4_HOS_C13_98),Other Reimbursable (D_4_HOS_C2_98),Other Reimbursable (D_4_IRF_C11_98),File Date,Hospital State (S2_1_C2_2),"If (SCH), enter the # of periods. (S2_1_C1_35)",Is this hospital is subject to the HAC reduction adjustment for discharges occurring prior to October 1? (Y/N) (S2_1_C1_40),Is this hospital is subject to the HAC reduction adjustment for discharges occurring on or after October 1? (Y/N) (S2_1_C2_40),IPPS Interim payment (E_A_HOS_C1_72),No Description (E_A_HOS_C1_7096),No Description (E_A_HOS_C1_7097),HVBP payment adjustment amount (E_A_HOS_C1_7093),No Description (E_A_HOS_C1_7090),HRR adjustment amount  (E_A_HOS_C1_7094),No Description (E_A_HOS_C1_7091),No Description (E_A_HOS_C1_49),No Description (E_A_HOS_C1_50),No Description (E_A_HOS_C1_54),No Description (E_A_HOS_C1_59),No Description (E_A_HOS_C1_68),No Description (E_A_HOS_C1_93),No Description (E_A_HOS_C1_47),No Description (E_A_HOS_C1_48),HAC reduction adjustment amount (E_A_HOS_C1_7099),Line 19 Subtotal,Reconstructed IPPS payment (pre HAC penalty),Reconstructed HAC penalty,Reconstructed IPPS payment (post HAC penalty),HAC penalty imputed from E_A_HOS_C1_59,Lat,Lon,"Control type, text","Hospital type, text",Num and Name
925,522139,390102,12001,3,2013-09-06 00:00:00,2010-07-01 00:00:00,2011-06-30,F,B,39,39010,2.0,3.0,6280,,,,,,,,,,,,,,,,,,,,,,,,,,,,,,,,,,,,,,,,,,,,,,,,,,,,,,,,,,,,,,,,,,,,,,,,,,,,,,,,,,,,,,,,,,,,,,,,,,,,,,,,,,,,,,,,,,,,,,,,,,,,,,,,,,,,,,,,,,,,,,,,,,,,,,,,,,,,,,,,,,,,,,,,,,,,,,,,,,,,,,,,,,,,,,,,,,,,,,,,,,,,,,,,,,,,,,,,,,,,,,,,,,,,,,,,,,,,,,,,,,,,,,,,,,,,,,,,,,,,,,,,,,,,,,,,,,,,,,,,184147952.0,2831111.0,32135841.0,61925282.0,186326389.0,9019378.0,801649.0,4895586.0,10203411.0,,,,,-166589.0,10700961.0,10792718.0,,,,,-35059655.0,74476290.0,16091370.0,164628482.0,3045191.0,270072.0,-35059655.0,-1037.0,204045117.0,19058499.0,571475.0,191197100.0,40687990.0,817399.0,14041396.0,2007543.0,18365.0,184930524.0,187743085.0,185285742.0,40687990.0,817399.0,562106095.0,562106095.0,102947722.0,1012981.0,1090205618.0,40687990.0,40687990.0,9813508.0,13933694.0,25173000.0,784591.0,973064.0,1757655.0,23415345.0,89165351.0,89165351.0,25167257.0,328101.0,13933694.0,255591.0,77960.0,69244.0,19449.0,16701.0,602179.0,484162.0,879338.0,5742.0,77960.0,19449.0,,,,,,,,,,,,,,,,,,102947722.0,109055673.0,120731295.0,559250285.0,,,239104772.0,1096490156.0,,2225.0,832082110.0,5696637.0,30999911.0,30999911.0,264408046.0,239104772.0,25303274.0,41410.0,0.169629,,376955.0,-376955.0,-63942.0,2358831.0,7207774.0,2925729.0,496288.0,488637.0,15984243.0,2711391.0,2422773.0,1.0,1.0,1.0,1535.8,1555.99,3461.0,3461.0,14623.0,14623.0,220.0,234.0,248.0,220.0,80423.0,85533.0,80423.0,16701.0,17910.0,16701.0,65062.0,69525.0,65062.0,560151.0,67342386.0,3760053.0,,,,-6648027.0,-3890281.0,,,,74832.0,,,,,,,528099523.0,528099523.0,,,,,,,,,,,,,,,,,,,,,,,,,,,,,,,,1.0,,438518990.0,,531482434.0,537239871.0,842906.0,,159.0,159.0,,,,,,789.0,871.0,,789.0,,74476290.0,4215374.0,7839169.0,1550055.0,1723260.0,1818459.0,1443662.0,1639302.0,,65923501.0,4215374.0,61708127.0,101858040.0,65938400.0,4334281.0,61604119.0,101754032.0,20861977.0,,49092605.0,49092605.0,6863089.0,,,,,,,,,,,,,,,,,,,,6827605.0,7980579.0,1938137.0,6039019.0,7940023.0,6979169.0,6968528.0,258032.0,180622.0,,7149150.0,7148840.0,7189031.0,6996.0,,6001680.0,2043300.0,1999824.0,2043300.0,,,,,,3340435.0,14623.0,17910.0,69525.0,1090205618.0,,,432864.0,,118418.0,2673687.0,1839638.0,74491189.0,4334281.0,432864.0,7314767.0,,1550055.0,118418.0,1723260.0,1404085.0,1443662.0,2673687.0,1639302.0,1839638.0,3236462.57,23.02,3048691.77,2868227.48,21.63,21.48,30.9,,,,,2508853.0,3197581.0,355536.0,,,,,,,,40.98,90901.0,7090279.0,19449.0,73778.0,0.263615,1869104.0,,,26710524.0,26576081.0,6879576.0,6868935.0,33445016.0,0.79462,0.20538,4577612.0,3637462.0,46.93,940150.0,68.61,46.93,13.89,13.09,12.81,13.26,13.26,128120.01,1698871.0,73778.0,19.74,13.5,5258634.0,4577612.0,63.77,43.62,940150.0,-47187.0,68.92,68.92,472433.0,,,,,2457343.0,,,,15984243.0,222.88,4848943.0,7344217.0,13058514.0,2215103.0,1934136.0,68383317.0,11599794.0,4163010.0,,,4182.0,19582746.0,,,19582746.0,,,262289.0,27.89,19665479.0,19665479.0,972993.2,31.92,21.44,,,88190.0,,,1180424.0,137262.0,74832.0,,,,,,,,,,,,,,,,,50599.0,,,,,36312.0,87553.0,,11416.0,,16487.0,16487.0,115828.0,115828.0,115828.0,99341.0,16487.0,19910.0,11675622.0,1762.0,3246.0,6757127.0,4248443.0,9478864.0,1238067.0,718782.0,6757127.0,4248443.0,9478864.0,1238067.0,304571.0,180464.29,176076.0,28327.0,220473.0,18045.0,76271.0,153537.0,101791.0,47200.0,19159.0,98140.0,63631.0,24.02,38.38,149.98,42.99,23.99,20.32,11.22,13.79,30.59,15.9,16.7,28.91,20484434.0,20484434.0,180464.29,424876.0,24.02,48.21,,,,,93726.0,7204.0,35484.0,551715.0,702645.0,7204.0,28275.0,5612.0,5071.0,30992.0,23467797.0,234279.0,,,,,,93726.0,134443.0,37645155.0,2637124.0,231430.0,279375.0,195563.0,,34972164.0,34972164.0,,,10641.0,35484.0,,,1890317.0,0.0201,37995.0,8761.0,190.48,0.039,0.0592,0.0982,873558.0,148181.0,92567.0,183162.0,318.0,,30992.0,82733.0,211091.0,516262.0,1237641.0,82733.0,211091.0,,516262.0,1237641.0,,5294.0,89630.0,14617.0,,97.52,29.83,84.67,3293103.48,273690.0,,310.0,,,,,,,,280967.0,7651.0,288618.0,713.0,,76.0,54.0,,,,,,,5568995.0,5568995.0,,905657.0,,233581.0,,,-12962.0,1233195.0,2683608.0,158850.0,2696570.0,6107951.0,,,2696570.0,2696570.0,975788.0,561736.0,1537524.0,64946.0,26104.0,91050.0,1446474.0,,,,,2257976.0,2208460.0,20493.0,561736.0,15964.0,4253.0,1539.0,57482.0,,,22990.0,359.0,,,,,,,,2026317.0,11.652055,2085016.0,2085016.0,2085016.0,18956.0,2066060.0,17194.0,2048866.0,1100.0,770.0,,2049636.0,51416.0,2060214.0,2042507.0,11873.0,7283.0,30.12,25.92,24.13,26.72,26.72,133224.68,3559763.0,1049293.0,134443.0,10641.0,44.03,30.12,32821.0,0.444862,3154196.0,445688.0,68.48,39.58,39.3,38.58,39.15,39.15,0.175655,0.175368,0.175368,5899280.0,29.34,6362828.0,41147152.0,38.57,3637462.0,39.14,1.0,45.18,0.0692,130810.0,,,170.0,4.0,473.0,14.0,5110.0,1539.0,57.0,4253.0,,414374.0,32084.0,12.92,,,,,,,,,,,,,,,,,,,,,,,,,,,,,,0.813,5550843.0,,6107951.0,,21167.0,,,,,,,,,,,,,,,,,,,,,,,,,,,,,,,,,,,,,,,,,,,,2931.0,,,,,,,,11206.0,,10.57,,,,,,,,,,,,,,,,,,,,,,,301403.0,,,,,,,,,,,,,,,,,1005364.0,247358.0,218616.0,,0.0269,,21.68,,5.95,6.03,6.03,0.027055,0.007174,463548.0,,239894.0,,0.57,5072.0,20.19,5760.0,,1829.0,,,,,,,,,,,,,,,,,,,,,,,,,,,,,,,,,,,,,,1465730.0,12684526.0,2151663.0,685933.0,66.0,1188132.0,,,,,,,3294.0,3294.0,10.2,322.94,,,,,,,,,,,,,,,,,,,,,,,,,,,,,,,,,,,,,,,,,,,,,,,,,,,,,,,,,,,,29047.0,,,,,,,,,,,,,,,,,,15529938.0,,,43476.0,15486462.0,,,,,,,,,,,,,,,,,,,,,,,,,,,,,,22.14,20.15,0.39,0.44,1675729.0,,,,,,,,,,,,,,,,1188132.0,,,,,,,,,,,,,,,,,,,,,,,,,,,,,,,,,,,,,,,,,,,,,,,530749.0,,,,,,,,,,,,,,,,,,,,,,,,,,,,,,,,,,,,,,,,,,,,,,,,,,,,,,,1634528.0,44836.0,,,,,,,,,,,,,,,,,,,,,,,,,,,1040415.0,,,,-379337.0,,,,,,,,,,7464.0,,,,3114.0,551715.0,647915.0,,,,,,,,,,10578.0,,,,,,,,,,,,,,,,,,,,,,,,,,,,,,,,,,,,,,,,,,,,,,,,,,,,,,,,,,,,,,,,,,,,,,,,,,150930.0,,96200.0,,,,,,,1831645.0,79.0,,,,,,,,,,,,,,,,,,,,,,,,,,,,,,,,,,,,,,,,,,,,,,,,,,,,,,,,,,,,,,,,,,,,,,,,430151.0,430151.0,,,,,,,,,,,,,,,,,,,,,,,,,,,,,,,,,,,,,,,,,,,,,,,,,,,,,,,,,,,,,,,,,,,,,,,,,,,,,,,,,,,,,,,,,,,,,5834.0,,,,,,,,,,,,,,,,,,,,,,,,,,,,,,,,,,,,,,,,,,,,,,,,,,,,,,,,,,,,,,,,,,,,,,,,,,,,,,,,,,,,,,,,,,,,,,,,,,,,,,,,,,,,,,,,,,,,,,,,,,,,,,,,,,,,,,,,,,,,,,,,,,,,,,,,,,,,,,,,,,,,,,,,,,,,,,,,,,,,,,,,,,,,,,,,,,,,,,,,,,,,,,,,,,,,,,,,,,,,,,,,,,,,,,,,,,,,,,,,,,,,,,,,,,,,,,,,,,,,,,,,,,815 FREEPORT ROAD,PITTSBURGH,15215,ALLEGHENY,UPMC ST MARGARET,38300,P,2,N,N,N,Y,Y,N,N,N,N,,,N,N,N,N,Y,Y,Y,,,HO0164,UNIVERSITY OF PITTSBURGH MEDICAL CEN,200 LOTHROP STREET,PITTSBURGH,PA,15213-2582,,Y,,,N,N,,,,UPMC ST MARGARET REHABILITATION UNIT,39T102,,,,,,,,,,,,,,,,,,,,,,,,,,,,,,,,,,,,,,,,,,,,,,,,,,,,,,,,,,,,,,,,,,,,,,,,,,,,,,,,,,,,,,,,,,,,,,,,,,,,,,,,,,,,,,,,,,,,,,,,,,,,,,,,,,,,,,,,,,,,,,,,,,,,,,,,,,,,,,,,,,,,,,,,,,-166589.0,,4123803.0,6577158.0,4246814.0,6545904.0,-24521347.0,2673687.0,1639302.0,1839638.0,7839169.0,1723297.0,,,1158338.0,1723260.0,,2073408.0,11767540.0,1046362.0,293520.0,,13576236.0,56173244.0,22640448.0,,3410136.0,3189246.0,774848.0,6793021.0,2201534.0,666470.0,1661840.0,1167419.0,,842537.0,4436905.0,16819.0,,,712015.0,-21167.0,-276.0,-3464.0,-23838786.0,4123803.0,2106838.0,3662445.0,2685388.0,2129694.0,6577158.0,15984192.0,28450705.0,14231576.0,,1825116.0,5172730.0,1619320.0,1622911.0,1160228.0,9038895.0,2255566.0,,2361452.0,1698159.0,1057707.0,,2000767.0,5986982.0,121860.0,380975.0,15917232.0,10757615.0,2435275.0,3345457.0,4456766.0,22744342.0,,3276561.0,9775367.0,3133649.0,2896868.0,2128587.0,13333902.0,2739053.0,,3867832.0,2275080.0,1448025.0,,3652678.0,201393.0,584085.0,19364778.0,19176912.0,5267979.0,10868361.0,1885576.0,,290544.0,1319445.0,459147.0,138557.0,138378.0,1103315.0,18836.0,,260705.0,76275.0,65500.0,,399288.0,5837.0,55927.0,116289.0,386178.0,280957.0,2429299.0,22809520.0,,3336609.0,9866323.0,3138574.0,2896868.0,2128587.0,13333902.0,2739053.0,,3888947.0,2275080.0,1448025.0,,3652678.0,201393.0,584085.0,19364778.0,19176912.0,5302816.0,10868361.0,108947579.0,,22097163.0,20291887.0,971041.0,26473152.0,8293518.0,44353457.0,5864100.0,,10170081.0,4912967.0,4762730.0,,6739224.0,385851.0,402613.0,81466993.0,67465083.0,53961.0,24141004.0,15823849.0,,3413450.0,5733197.0,138614.0,6848472.0,1824304.0,11130219.0,1543912.0,,2790196.0,973294.0,1009392.0,,1804268.0,131282.0,71930.0,11287918.0,16773555.0,12263.0,6797566.0,2068383.0,,163851.0,909006.0,24432.0,229301.0,71854.0,1241296.0,501719.0,,566053.0,429740.0,296484.0,,318427.0,38371.0,94562.0,2295477.0,3008069.0,5401.0,1317171.0,170993.0,,17173.0,121386.0,3806.0,10964.0,4672.0,54857.0,3451.0,,37947.0,14408.0,13411.0,,34592.0,1112.0,9054.0,13783.0,60569.0,335.0,294416.0,15823849.0,,3413450.0,5733197.0,138614.0,6848472.0,1824304.0,11130219.0,1543912.0,,2790196.0,973294.0,1009392.0,,1804268.0,131282.0,71930.0,11287918.0,16773555.0,12263.0,6797566.0,213190.0,88716.0,25203944.0,3303544.0,-2071427.0,32937489.0,8452.0,-18390892.0,64821044.0,-50225188.0,69925074.0,20300491.0,20300491.0,115429509.0,3450494.0,,53351991.0,1674140.0,5757511.0,2227170.0,5757511.0,89689646.0,109671998.0,-34948862.0,115429509.0,688873.0,9588.0,,,,1818459.0,1443662.0,,1854187.0,1550055.0,2749073.0,3626935.0,,1994125.0,783975.0,1138267.0,,-844668.0,23570.0,-377427.0,344549.0,1815030.0,,4035023.0,902393.0,,6252620.0,,305205.0,13821162.0,560151.0,71102438.0,-36590800.0,,,,,,,1686580.0,2691542.0,,,1975092.0,,1316985.0,2691542.0,,,,,,6124935.0,,6124935.0,,1098409.0,,,,,432864.0,3704678.0,,3930053.0,118418.0,22.0,,,-595812.0,13956.0,351.0,1754449.0,1754449.0,778532.0,9945.0,,9945.0,4797825.0,5648676.0,264585.0,337219.0,4738672.0,,,-3255567.0,,,,,,,,,,65553487.0,,43022187.0,71261525.0,41680.0,39469194.0,4527241.0,4527241.0,590076.0,6275370.0,-5481769.0,,,,440926.0,264395.0,36319.0,21509.0,,,,8999346.0,19616664.0,4064635.0,6787713.0,681086.0,1946017.0,4064635.0,6787713.0,681086.0,1946017.0,660147.0,789631.0,137423.0,268271.0,,,43578.0,31254.0,,,-363427.0,,,,,,,,718782.0,2176036.0,700943.0,-602944.0,-1653857.0,-28315.0,2840746.0,5209363.0,223478.0,5263298.0,11675622.0,239731.0,,2915335.0,4463.0,1209.0,60535.0,53.0,,11.0,,11675622.0,,14.0,5110.0,1209.0,4463.0,,,,,532959.0,,652894.0,534632.0,268234.0,,105211.0,3644974.0,,,,,438598.0,,969761.0,,,-11262.0,-170.0,,,388345.0,,,,421039.0,,,,,701686.0,,,,,32563.0,,,,712948.0,,,,2202067.0,,35326082.0,,60048238.0,45749304.0,3244888.0,,303183.0,13758692.0,31947624.0,,,,,634966.0,,,83110.0,,,,,,,,,3796.0,,,634966.0,5712.0,,,2824900.0,,6412762.0,3124887.0,617334.0,,,34676.0,3212.0,982791.0,3004904.0,1634.0,,,,2824900.0,,6412762.0,3124887.0,617334.0,,,34676.0,3212.0,982791.0,3004904.0,,,,28275.0,,,210764.0,,214712.0,123080.0,79526.0,,,10135.0,4223.0,199857.0,582263.0,,,,5071.0,,,,,,,,,,,,,82.0,,,,,,,,167142.0,,,,,,,,,,,-1781042.0,,,,,,,,,,,,,,,,,,5757437.0,,,,7469193.0,-53935.0,5029617.0,,,,,,,,,,,,,,,,,,,,,,,,,,,,,,,21453.0,,4701.0,57494.0,,254831.0,61326.0,402695.0,589816.0,,29127.0,2796.0,,601513.0,,2804.0,,225.0,9162.0,,28137.0,12441.0,177803.0,173244.0,,6322.0,3676.0,,107872.0,,,,,,,,,,,,,,,,,232.0,,24.0,1229.0,,913.0,834.0,5961.0,7836.0,,684.0,352.0,,2172.0,,,,,,,,,,,,,,,,,,,,,,,,,,,,,,,,,,,204851.0,,908037.0,1567670.0,39344.0,,4876289.0,-2633482.0,,,-4925.0,,-14.0,,4770165.0,103528.0,1615998.0,151962.0,,8095026.0,,1509452.0,,8095026.0,,298309.0,16339477.0,49442850.0,94603.0,15396.0,,,,,,,59720.0,76816.0,39752.0,2774.0,5309.0,4477.0,9987.0,2572.0,1566.0,811.0,864.0,868.0,,2871.0,,,,1739.0,123.0,102.0,23.0,161.0,194.0,21278.0,94603.0,2087531.0,3773234.0,2087531.0,3773234.0,,,388117.0,614067.0,,,,,,,,,,,,,,,,,,,,,,,,,,,,,,,,,,,,,,,87500.0,,,,,,11405.0,,,,,,,,,,,,,,,,,,,,,,,,,,,,,,,,,,,,,,,,,,,,,,632877.0,,,,,2564632.0,333094.0,333094.0,108244.0,,,,,,,,,,,,,,,,,,,,,54032.0,,,,,,,81229.0,1267929.0,,,634762.0,11769.0,,,,,,119231.0,,,453276.0,,229003.0,,,,809016.0,15000.0,,,,,,,,577708.0,,291868.0,,,,,,,,136.0,,,86535.0,,1312.0,,,,,,,,,441.0,,31599.0,,580.0,,,,,,,,,,,,551715.0,,,,,,,,,,,,,,,,,,,,15486462.0,-11801348.0,,,,,,,104816.0,,,,,,,,,,,,,,,,,,,,,,,,,,,,,,,,,,,,,,,,,,,,,,,,,,,,,,,,,,,,,,,,,,,,,,3778016.0,19877536.0,,,,,,,,,,,,,,,,2640.0,,,,,,3364.0,,,,,,,,,,,94.0,22789.0,,12.0,7406.0,,,,1.0,51.0,,,,31.0,,1230.0,,,,8.0,,,,3622057.0,,,,,,,,,,,,,,,,,,,,,,,,,,430440.0,651932.0,,,,,,,62917.0,,10845.0,1.0,,,,,,,,,,,,,,,,,,,,,,,,,,,,,,,,,,,,,,,,,,,,,,,,,,,,,-1031628.0,,,75124.0,,95747.0,,,,,,,,,,,,,,,,,,,,,,,,,,,,,16205.0,,,,,,,,,,,,,1250679.0,,,,,,,,,,,,,,,,,,,,,,,,,,,,,,,,,,,275.0,350.0,,,,,,,,,,,,,,,,,,,,,,,,,,,,,,,,,,2.0,,,,,,,,,,,,,,,,,,,,,,,,,,,,,,,3103.0,,,,,,,,,,,,,,,,,6233.0,,,,,,,,,,,,,,,,,,,,,,,,,,,,,,,,,,,,,,,,,,,,,,,,,,,,,,,,,,,,,,,,,,,,,,,,,,,,,,,,,,,,,,,,,,,,,,,,,,,,,,,,,,,,,,,,,,,,,,,,,,,,,,,,,,,,,,,,,,,,,,,,,,,,,,,,,,,,,,,,,,,,,,,,,,,,,,,,,,,,,,,,,,,,,,,,,,,,,,,,,,,,,,,,,,,,,,,,,,,,,,,,,,,,,,,,2010,,,,,,,,,,,,,,,,,,,,,,,,,,40.487472,-79.896038,Voluntary non-profit - Private,Acute Care Hospitals,UPMC ST MARGARET (390102)
5863,542002,390102,12001,2,2014-10-22 00:00:00,2011-07-01 00:00:00,2012-06-30,F,A,39,39010,2.0,3.0,6280,,,,,,,,,,,,,,,,,,,,,,,,,,,,,,,,,,,,,,,,,,,3179296.0,,,,,,,,,,,,,,,,,,,,,,,,,,,,,,,,,,,,,,,,,,,,,,,,,,,,,,,,,,,,,,,,,,,,,,,,,,,,,,,,,,,,,,,,,,,,,,,,,,,,,,,,,,,,,,,,,,,,,,,,,,,,,,,,,,,,,,,,,,,,,,,,,,,,,,,,,,,,,,,,,,,,,,,,,,,,,,,,,,,,,,,,,,,,,,,,,,,,,,,,,,,,,,,,,,,,,,,,,,,,,,,,,,,,,,,,,,,,,191124029.0,3303544.0,32937490.0,64821043.0,194486499.0,28688085.0,5733441.0,8151711.0,28688085.0,,,,,-310823.0,10123022.0,10352886.0,,,,,-36370662.0,77147073.0,17086155.0,168809208.0,3304112.0,92918.0,-36370662.0,-2631.0,209585619.0,20311519.0,391574.0,196150383.0,41689233.0,567057.0,13326679.0,1944545.0,18807.0,189265593.0,192631482.0,189588107.0,41689233.0,567057.0,574118604.0,574118604.0,104987282.0,952000.0,1160658269.0,41689233.0,41689233.0,9308969.0,13639889.0,24240740.0,782710.0,827322.0,1610032.0,22630708.0,88622877.0,88622877.0,24458547.0,291585.0,13639889.0,166240.0,77083.0,68766.0,17977.0,15355.0,554676.0,434239.0,740074.0,5514.0,77083.0,17977.0,,,,,,,,,,,,,,,,,,104987782.0,111179802.0,122928453.0,575039736.0,,,245956281.0,1166149464.0,,550.0,912454322.0,12477289.0,20216150.0,20216150.0,253695142.0,245956281.0,7738861.0,20464.0,0.163067,9259262.0,264829.0,8994433.0,1466695.0,3395773.0,8201009.0,2873694.0,468605.0,464453.0,12070825.0,1968354.0,1929078.0,1.0,1.0,1.0,1565.31,1585.34,3181.0,3181.0,13956.0,13956.0,220.0,234.0,248.0,220.0,80558.0,85682.0,80558.0,15355.0,16397.0,15355.0,63746.0,67997.0,63746.0,560151.0,71102439.0,1225983.0,,,,-4987967.0,-7002867.0,,,,80959.0,,,,,,,586539665.0,586539665.0,,,,,,,,,,,,,,,,,,,,,,,,,,,,,,,,,,452111283.0,,585810092.0,591109728.0,835619.0,,132.0,132.0,,,,,,718.0,808.0,,718.0,,77147073.0,4569868.0,6258167.0,1732032.0,1802647.0,1877902.0,1707720.0,1737116.0,,68936344.0,4569868.0,64366476.0,105085413.0,68936344.0,4769135.0,64167209.0,104886146.0,20699766.0,,51170599.0,51170599.0,6827393.0,,,,,,,,,,,,,,,,,,,,6787799.0,8058400.0,1922957.0,6132666.0,8013384.0,7124572.0,7116513.0,183163.0,128214.0,132196.0,7244727.0,7243973.0,7300535.0,7749.0,,6275370.0,7272427.0,7755440.0,8652247.0,,,,,,3203657.0,13956.0,16397.0,67997.0,1160658269.0,,,585265.0,1697.0,123609.0,2776789.0,2011160.0,77147073.0,4769135.0,585265.0,6075727.0,1697.0,1732032.0,123609.0,1802647.0,1483040.0,1707720.0,2776789.0,1737116.0,2011160.0,3318203.0,23.25,3144510.74,2957747.74,21.92,21.69,30.74,,,,,2632889.0,2974610.0,349950.0,,,,,,,,40.98,93572.97,7462585.0,17977.0,72063.0,0.249462,1861631.0,,,25942728.0,25600036.0,6845682.0,6837623.0,32437659.0,0.789207,0.210793,4705594.0,3713688.0,45.42,991906.0,67.82,45.42,13.72,13.89,13.09,13.57,13.57,131886.74,1789703.0,72063.0,19.54,13.09,5554632.0,4705594.0,62.45,41.83,991906.0,-64311.0,68.57,68.57,1220692.0,,,,,3043375.0,,,,12070825.0,220.39,4805236.0,8380367.0,9197131.0,1499749.0,1464625.0,75925542.0,12380950.0,4128901.0,,,5020.0,20641440.0,,,20641440.0,,,220526.0,27.55,20736418.0,20736418.0,986477.5,32.32,20.98,,,-22022.0,,,1683428.0,181973.0,80855.0,,,,,,,,,,,,,,,,,5906887.0,104.0,,,,42615.0,105270.0,,14550.0,,18289.0,18289.0,,126043.0,126043.0,107754.0,18289.0,21066.0,11748651.0,3648.0,3978.0,7003460.0,1348016.0,11610416.0,1352193.0,220434.0,7003460.0,1348016.0,11610416.0,1352193.0,220434.0,186763.0,182398.0,9023.0,262246.0,21329.0,84645.0,160877.0,105886.0,55410.0,17730.0,120380.0,65704.0,25.54,38.4,149.4,44.27,27.44,20.46,11.21,14.01,30.82,12.43,14.43,30.61,19982519.0,19982519.0,186763.0,454026.81,25.54,44.01,,,,,87248.0,8495.0,39594.0,630592.0,800873.0,8495.0,20773.0,4843.0,3739.0,30507.0,21457707.0,180292.0,0.0393,0.0704,0.1097,,,87248.0,342692.0,35060851.0,2567068.0,142250.0,191265.0,133886.0,87997.0,32485419.0,32485419.0,,,8059.0,39594.0,,,1716100.0,0.0224,38441.0,5075.0,185.78,0.0393,0.0704,0.1097,1059067.0,172699.0,-128318.0,210196.0,334.0,,30507.0,94978.0,114013.0,595490.0,741163.0,94978.0,114013.0,,595490.0,741163.0,,5716.0,93195.0,6494.0,,104.18,29.8,114.13,3411774.55,96931.0,,754.0,,,,,,,131.0,35124.0,4152.0,39276.0,734.0,,39.0,52.0,,,,,,,7003460.0,7003460.0,896807.0,973389.0,,260416.0,,,-6481.0,1329389.0,2734510.0,153898.0,2740991.0,6192020.0,,,2740991.0,2740991.0,1065110.0,636878.0,1701988.0,59803.0,25344.0,85147.0,1616841.0,,,,,2695595.0,2404635.0,14254.0,636878.0,8127.0,4066.0,1580.0,59803.0,,,21938.0,270.0,,,,,,,,2165904.0,11.10929,2224365.0,2224365.0,2224365.0,16064.0,2208301.0,3679.0,2204622.0,3898.0,2729.0,2830.0,2207351.0,49383.0,2210757.0,2213839.0,-12987.0,9078.0,28.74,30.12,25.92,28.26,28.26,133224.68,3764929.0,994615.0,342692.0,8059.0,42.91,28.74,31982.0,0.443806,3311940.0,467977.0,67.54,39.34,39.58,39.3,39.41,39.41,0.178819,0.177584,0.177584,5625177.0,28.95,6066856.0,39421489.0,38.57,3713688.0,38.59,,45.44,7.15,122701.0,,,167.0,2.0,431.0,14.0,5091.0,1580.0,24.0,4066.0,,394862.0,28842.0,13.69,,,,,,,,,,,,,,,,,,,,,,,,,,,,,,0.813,5518481.0,,6192020.0,,14368.0,,,,,,,,,,,,,,,,,,,,,,,,,,,,,,,,,,,,,,,,,,,,3644.0,,,,,,,,11582.0,,10.67,,,,,,,,,,,,,,,,,,,,,,,298656.0,,,,,,,,,,,,,,,,,1278049.0,287837.0,259807.0,,0.0137,,22.4,,4.44,6.03,6.03,0.027361,0.007255,441679.0,,287837.0,,0.02,5422.0,20.03,5601.0,,1475.0,,,,20627.0,20627.0,359.81,57.33,,,,,,,,,,,,,,,,,,,,,,,70.5,24.07,23001.0,,,,,,1350289.0,12428168.0,2026624.0,676335.0,124.0,22611337.0,275395.0,,,,,,47668.0,47668.0,301.0,158.37,,,,,,,,,,,,,,,,,,,,,,,,,,,,,,,,,,,,,,,,,,,,,,,,,,,,,,,,,,,,264727.0,,,,,,,,,,,,,,,,,,15486462.0,12259327.0,12259327.0,,27745789.0,,,,,,,,,,,,,,,,,,,,,,,,,,,,,,22.14,20.39,0.63,0.75,1727598.0,215388.0,7139.0,2911072.0,,,2911072.0,,,,19406.0,,,150.01,,,22335942.0,,,,,,,,,,,,,,,,,,,,,,,,,,,,,,,,,,,,,,,,,,,,,,,603188.0,,,,,,,,,,,,,,,,,,,,,,,,,,,,,,,,,,,,,,,,,,,,,,,,,,,,,,,1659403.0,,,,,,,,,,,,,,,,,,,,,,,,,,,,1028594.0,,,,-94798.0,,,,,,,,,,,,,,3406.0,630592.0,715920.0,,,,,,,,,,3406.0,,,,,,,,,,,,,,,,,,,,,,,,,,,9078.0,,,,,,,,,,,,,,,,,,,,,,,,,,,,,,,,,,,,,,,,,,,,,,,170281.0,,85328.0,,,,,,,1907953.0,35.0,,,,,,,,,,,,,,,,,,,,,,,,,,,,,,,,,,,,,,,,,,,,,,,,,,,,,,,,,,,,,,,,,,,,,,,,408713.0,408713.0,,,,,,,,,,,,,,,,,,,,,,,,,,,,,,,,,,,,,,,,,,,,,,,,,,,,,,,,,,,,,,,,,,,,,,,,,,,,,,,,,,,,,,,,,,,,,9905.0,,,,,,,,,,,,,,,,,,,,,,,,,,,,,,,,,,,,,,,,,,,,,,,,,,,,,,,,,,,,,,,,,,,,,,,,,,,,,,,,,,,,,,,,,,,,,,,,,,,,,,,,,,,,,,,,,,,,3432993.0,-253697.0,,,,,,,,,,,,,2241603.0,1197500.0,,,,,,,,,,,,,,,,,,,,,,,,,,,,,,,,,,,,,,,,,,,,,,,,,,,,,,,,,,,,,,,,,,,,,,,,,,,,,,,,,,,,,,,,,,,,,,,,,,,,,,,,,,,,,,,,,,,,,,,,,,,,,,,,,,,,,,,815 FREEPORT ROAD,PITTSBURGH,15215,ALLEGHENY,UPMC ST MARGARET,38300,P,2,N,N,N,Y,Y,N,,N,N,,,N,N,N,N,Y,Y,Y,,,HO0164,UNIVERSITY OF PITTSBURGH MEDICAL CEN,200 LOTHROP STREET,PITTSBURGH,PA,15213-2582,,Y,,,N,N,,,,UPMC ST MARGARET REHABILITATION UNIT,39T102,,,,,,,,,,,,,,,,,,,,,,,,,,,,,,,,,,,,,,,,,,,,,,,,,,,,,,,,,,,,,,,,,,,,,,,,,,,,,,,,,,,,,,,,,,,,,,,,,,,,,,,,,,,,,,,,,,,,,,,,,,,,,,,,,,,,,,,,,,,,,,,,,,,,,,,,,,,,,,,,,,,,,,,,,,-310823.0,,4171059.0,5951963.0,4436006.0,5916880.0,-24379828.0,2776789.0,1737116.0,2011160.0,6258167.0,1804220.0,,,1159313.0,1802647.0,,2263443.0,12363581.0,804847.0,492924.0,,194330.0,43553333.0,22154527.0,,6771415.0,2807954.0,1069251.0,30815712.0,2549502.0,746769.0,1722623.0,1237006.0,,795109.0,4570195.0,13040.0,,,772084.0,-16175.0,-375.0,-2545.0,5829930.0,4171059.0,2723191.0,3770382.0,2541588.0,2501539.0,5951963.0,1686592.0,43542316.0,14216279.0,,1605138.0,5068754.0,1909682.0,1409542.0,1093216.0,9006074.0,2611083.0,,2525994.0,1772491.0,1103281.0,,1954259.0,6279226.0,109591.0,430216.0,14680886.0,11353813.0,2574731.0,4404265.0,4732541.0,23528745.0,,3093469.0,9840081.0,3838494.0,2667178.0,2049656.0,13533526.0,3383607.0,,3936515.0,2537262.0,1590068.0,,3419991.0,177123.0,667110.0,19253278.0,21051111.0,6569784.0,9925878.0,2202993.0,,319399.0,1537702.0,661479.0,154576.0,147149.0,1296050.0,20249.0,,265702.0,76992.0,52218.0,,291394.0,9527.0,41288.0,105314.0,387383.0,387583.0,1347890.0,23544676.0,,3096795.0,9932650.0,3859486.0,2667178.0,2049656.0,13533526.0,3383607.0,,3961510.0,2537262.0,1590068.0,,3419991.0,177123.0,667110.0,19253278.0,21051111.0,6652888.0,9925878.0,106741757.0,,22334711.0,21720972.0,1197277.0,27019561.0,9122735.0,45531491.0,6023495.0,,11721591.0,5228356.0,6576762.0,,6974700.0,408319.0,432340.0,79835946.0,71201230.0,73842.0,25043045.0,15368886.0,,3489521.0,5550161.0,232503.0,6342317.0,2140806.0,10491460.0,1256167.0,,2997874.0,1038693.0,1424595.0,,1970194.0,103265.0,105130.0,13480530.0,15189384.0,22215.0,6542827.0,1989272.0,,149302.0,872068.0,35614.0,185392.0,76446.0,1095933.0,517116.0,,543284.0,476826.0,332657.0,,293428.0,21010.0,150209.0,2804314.0,2734150.0,8138.0,1120544.0,186133.0,,19175.0,134209.0,6326.0,10744.0,5489.0,50345.0,3095.0,,36439.0,14469.0,10925.0,,24411.0,1130.0,9297.0,15341.0,50307.0,677.0,152167.0,15368886.0,,3489521.0,5550161.0,232503.0,6342317.0,2140806.0,10491460.0,1256167.0,,2997874.0,1038693.0,1424595.0,,1970194.0,103265.0,105130.0,13480530.0,15189384.0,22215.0,6542827.0,516166.0,91829.0,28425928.0,4524236.0,-2382249.0,38670931.0,,-19876192.0,65217315.0,-48058997.0,76401308.0,20223391.0,20223391.0,125050627.0,2405661.0,,58285173.0,1963815.0,4756049.0,2909257.0,4756049.0,100346006.0,120294578.0,-37223513.0,125050627.0,545692.0,817.0,,,,1877902.0,1707720.0,,2072857.0,1732032.0,3587683.0,3781364.0,,2133819.0,805369.0,1542455.0,,-839297.0,,-506313.0,397779.0,1936038.0,,4467023.0,928978.0,,6872130.0,,291630.0,24314206.0,560151.0,71431615.0,-39458423.0,,,,,,,1182744.0,3399501.0,,,906997.0,,958176.0,3401198.0,,,,,,5542771.0,,5542771.0,,997721.0,,,,,585265.0,3566540.0,1697.0,4099781.0,123609.0,-23001.0,,,-181078.0,12660.0,56.0,2816992.0,2816992.0,848455.0,9987.0,,9987.0,4976182.0,6308246.0,425721.0,480975.0,5377201.0,,,-3553046.0,,,,,,,,,,75161762.0,,43143161.0,75526788.0,34564.0,45746796.0,4933592.0,4933592.0,638145.0,6372301.0,-5626125.0,,,,433839.0,248481.0,49868.0,38769.0,,,,10138295.0,20734518.0,4460023.0,4347926.0,837366.0,2044345.0,4460023.0,4347926.0,837366.0,2044345.0,719826.0,530665.0,150792.0,249469.0,,,45817.0,35038.0,,,-384132.0,,,,,,59.0,45.0,220434.0,2228950.0,743084.0,-1078906.0,-25895600.0,-24995.0,2909874.0,5206586.0,247371.0,5270440.0,11748651.0,298695.0,,2649062.0,4251.0,1042.0,60634.0,,,,,11748651.0,,14.0,5124.0,1042.0,4251.0,,,,,555537.0,,644579.0,552897.0,242903.0,,96551.0,3928235.0,,,,,384620.0,,1017829.0,,,-11262.0,,,,482861.0,,,,388946.0,,,,,650743.0,,,,,32863.0,,,,662005.0,,,,2619913.0,,37650844.0,,64224496.0,48275762.0,3310189.0,,462239.0,12716018.0,32914021.0,,,,,528486.0,,,58998.0,,,,,,,,,2929.0,,,528486.0,1598.0,,,2954623.0,,6813103.0,3336624.0,389989.0,,,36203.0,4804.0,1077539.0,2944662.0,513.0,,,,2954623.0,,6813103.0,3336624.0,389989.0,,,36203.0,4804.0,1077539.0,2944662.0,,,,20773.0,,,190764.0,,199154.0,119148.0,42796.0,,,7366.0,6864.0,224157.0,504312.0,,,,3739.0,,,,,,,,,,,,,90.0,,,,,,,,232647.0,,,,,,,,,,,-5459679.0,,,,,,,,,,,,,,,,,,5299636.0,,,,8410043.0,-63854.0,5336904.0,,,,,,,,,,,,,,,,,,,,,,,,,,,,,,,6905.0,,1629.0,78190.0,,250059.0,80685.0,445999.0,977380.0,,26486.0,1533.0,,629183.0,,894.0,,70.0,13460.0,,25633.0,14622.0,204742.0,228228.0,,5182.0,2190.0,,113255.0,,,,,,,,,,,,,,,,,84.0,,9.0,2153.0,,806.0,981.0,6213.0,7496.0,,419.0,136.0,,2084.0,,,,,,,,,,,,,,,,,,,,,,,,,,,,,,,,,,,260161.0,,1037829.0,1690428.0,39047.0,,4437239.0,-4091680.0,,,-21276.0,,-50.0,,4593692.0,204451.0,1690659.0,141886.0,,7354588.0,,982671.0,,7354588.0,,272558.0,23613263.0,55123856.0,46306.0,6148.0,,,,,,,7594.0,65883.0,48233.0,1146.0,14030.0,21767.0,1110.0,1926.0,1722.0,233.0,1863.0,3728.0,,821.0,,,,219.0,112.0,124.0,13.0,249.0,506.0,28030.0,46306.0,3037749.0,4663891.0,3037749.0,4663891.0,11864.0,,474586.0,619192.0,2468.0,,,,,,,,,,,,,,,,,,,,,,,,,,,,,,,,,,,,,,93406.0,,,,,,12082.0,,,,,,,,,,,,,,,,,,,,,,,,,,,,,,,,,,,,,,,,,,,,,,386573.0,,,,,2195880.0,311869.0,311869.0,128385.0,,,,,,,,,,,,,,,,,,,,,61581.0,,,,,,,180964.0,1496437.0,,,607155.0,,,,,,,125586.0,,,469740.0,,284010.0,,,,685957.0,,,,,,,,,530708.0,,320871.0,,,163.0,,,,164.0,720.0,,,81901.0,,2624.0,,,,141.0,,,,121.0,2985.0,,29887.0,,1181.0,,,,,,,,,,,,630592.0,,,,,,,,,,,,,,,,,,,,27745789.0,-22719044.0,,,,,,,100277.0,,,,,,,,,,,,,,,,,,,,,,,,,,,,,,,,,,,,,,,,,,,,,,,,,,,,,,,,,,,,,,,,,,,,,,3816673.0,19848295.0,,,,,,,,,,,,,,,,,,,,,,,,,,,,,,,,,833.0,23806.0,,93.0,9800.0,,,,5.0,59.0,,,,,,,,,,1.0,,,,3723628.0,,,,,,,,,,,,,,,,,,3.0,,,,,,,,803737.0,1035807.0,,,,,,,18902.0,,23264.0,9.0,,,,,,,,,,,,,,,,,,,,,,,,,,,,,,,,,,,,,,,,,,,,,,,,,,,,,-1033850.0,,,85038.0,,96075.0,,,,,,,,,,,,,,,,,,,,,,1837.0,,,,,,,,,,,,,,,,,,,,1263461.0,,,,,,,,,,,,,,,,,,,,,,,,,,,,,,,,,,,706.0,798.0,,,,,,,,,,,,,,,,,,,,,,,,,,,,,,,,,,,,,,,,,,,,,,,,,,,,,,,,,,,,,,,,,3393.0,,,,,,,,,,,,,,,,,39488.0,,,,,,,,,,,,,,,,,,,,,,,,,,,,,,,,,,,,,,,,,,,,,,,,,,,,,,,,,,,,,,,,,,,,1837.0,,,,,,,,,,,,,,,,,,,,,,,,,,,,,,,,,,,,,,,,,,,,,,,,,,,,,,,,,,,,,,,,,,,,,,,,,,,,,,,,,,,,,,,,,,,,,,,,,,,,,,,,,,,,,,,,,,,,,,,,,,,,,,,,,,,,,,,,,,,,,,,,,,,,,,,,,,,,,,,,,,,,2011,,,,,,,,,,,,,,,,,,,,,,,,,,40.487472,-79.896038,Voluntary non-profit - Private,Acute Care Hospitals,UPMC ST MARGARET (390102)
12326,570185,390102,12001,3,2016-02-04 00:00:00,2012-07-01 00:00:00,2013-06-30,F,C,39,39010,2.0,3.0,6280,,,,,,,,,,,,,,,,,,,,,,,,,,,,,,,,,,,,,,,,,,,2373671.0,,,,,,,,,,,,,,,,,,11323.0,,,,,,,,,,,,,,,,,,,,,,,,,,,,,,,,162777.0,,,,,,,,,,,36048.0,,,,,,,,,,,,,,,,,,,,,,,,,,,,,,,,,,,,,,,,,,,,,,,,,,,,,,,,,,,,,,,,,,,,,,,,,,,,,,,,,,,,,,,,,,,,,,,,,,,,,,,,,,,,,,,,,,,,,,,,,,,,,,,,,,,,,,,,,,,,,,,,,,,,,,,,,,,,,,,,,,,,,,,,,,,,,,,,212539687.0,4524236.0,38670931.0,65217314.0,214522337.0,7736540.0,2211675.0,614337.0,8146330.0,,,,,-364821.0,9868319.0,9977959.0,,,,,-37071324.0,74727365.0,16141885.0,165067176.0,3233697.0,104393.0,-37071324.0,-92894.0,202723217.0,19202318.0,444361.0,190349874.0,42247031.0,686225.0,13171797.0,2085417.0,19490.0,183653769.0,187372889.0,183752833.0,42247031.0,686225.0,574276030.0,574276030.0,103435704.0,1134715.0,1169196167.0,42247031.0,42247031.0,10034128.0,12718430.0,23433330.0,635104.0,871203.0,1506307.0,21927023.0,89945203.0,89945203.0,25658923.0,403273.0,12718430.0,232514.0,73023.0,64595.0,17442.0,15342.0,588612.0,495240.0,740102.0,6604.0,73023.0,17442.0,,,,,,,,,,,,,,,,,,103435704.0,110844591.0,122667258.0,574108548.0,,,239794541.0,1174454006.0,,1088.0,936933640.0,8791010.0,6516835.0,6516835.0,237520366.0,239794541.0,-2274175.0,28427.0,0.157077,5239817.0,460550.0,4779267.0,750713.0,3415576.0,7874851.0,3107281.0,488082.0,477144.0,17173844.0,2697616.0,2664863.0,1.0,1.0,1.0,1483.66,1504.81,3064.0,3064.0,13006.0,13006.0,221.0,235.0,249.0,221.0,80654.0,85764.0,80654.0,15342.0,15833.0,15342.0,59060.0,62912.0,59060.0,560151.0,71431615.0,4252034.0,,,,-2791356.0,-5745257.0,,,,255181.0,,,,,,,594920137.0,594920137.0,,,,,,,,,,,,,,,,,,,,,,,,,,,,,,,,,,451441290.0,,595017543.0,600345458.0,799948.0,,134.0,134.0,,,,,,976.0,1006.0,,976.0,,74727365.0,4257285.0,5660934.0,1645753.0,2006477.0,1976551.0,1728913.0,1793563.0,,66568790.0,4257285.0,62311505.0,103021313.0,66568790.0,4374969.0,62193821.0,102903629.0,20339812.0,,52181403.0,52181403.0,6800655.0,,,,,,,,,,,,,,,,,,,,6748733.0,7873436.0,1836808.0,6038142.0,7812610.0,7100147.0,7090331.0,170374.0,119262.0,152199.0,7209593.0,7209600.0,7074775.0,4291.0,,6372301.0,13860110.0,,15656667.0,,,,,,3303478.0,13006.0,15833.0,62912.0,1169196167.0,,,380841.0,144.0,135741.0,2810203.0,2437861.0,74727365.0,4374969.0,380841.0,5495352.0,144.0,1645753.0,135741.0,2006477.0,1552677.0,1728913.0,2810203.0,1793563.0,2292219.0,3130023.0,23.87,2964781.6,2795378.6,22.45,22.25,31.63,,,,,2446541.0,2875630.0,341601.0,,,,,,,,40.98,95135.63,7542738.0,17442.0,67488.0,0.258446,1949390.0,,,25057070.0,24935730.0,6814036.0,6804220.0,31739950.0,0.785626,0.214374,4953982.0,3891977.0,40.66,1062005.0,63.77,40.66,14.89,13.72,13.89,14.17,14.17,134089.25,1900045.0,67488.0,22.13,14.11,5574382.0,4953982.0,59.59,37.99,1062005.0,94486.0,64.69,64.69,293462.0,,,,,3620056.0,,,,17173844.0,219.39,4459275.0,8561456.0,14066563.0,2209534.0,2187719.0,77073741.0,12106512.0,3782285.0,,,5535.0,19275221.0,,,19275221.0,,,217969.0,25.21,19362196.0,19362196.0,952618.6,31.13,21.35,,,290275.0,,,2067112.0,309473.0,80549.0,,,,,,,,,,,,,,,,,2029844.0,174632.0,,,,55474.0,76518.0,,8919.0,,13381.0,13381.0,,102695.0,102695.0,89314.0,13381.0,11867.0,11822667.0,1194.0,3316.0,6911091.0,1516653.0,12916059.0,1198955.0,396.0,6911091.0,1516653.0,12916059.0,1198955.0,396.0,169403.0,168277.0,9384.0,280589.0,13638.0,79998.0,163048.0,103677.0,58297.0,40.0,110536.0,72575.0,25.83,41.07,161.62,46.03,27.92,20.57,12.31,14.98,29.66,9.9,16.23,31.58,21347612.0,21347612.0,169403.0,458302.32,25.83,46.58,,,,,131101.0,5172.0,51922.0,979380.0,1042192.0,5172.0,26177.0,2982.0,4462.0,29049.0,21150002.0,202152.0,0.0416,0.0687,0.1103,,,131101.0,121340.0,34907997.0,2470460.0,191491.0,486370.0,340459.0,116946.0,32586505.0,32555425.0,,,9816.0,51922.0,,,1667240.0,0.0226,37680.0,7618.0,172.36,0.0416,0.0687,0.1103,1724031.0,270806.0,-237229.0,205907.0,273.0,,29049.0,86975.0,99274.0,573941.0,705794.0,86975.0,99274.0,,573941.0,705794.0,,5688.0,90690.0,5899.0,,100.9,30.99,119.65,3253680.92,774822.0,,-7.0,,,,,,,111.0,21815.0,10938.0,32753.0,1006.0,,4.0,579.0,,,,,,,6911091.0,6911091.0,1796557.0,1046016.0,,228316.0,,,-3307.0,1314110.0,2971062.0,157856.0,2971062.0,7408887.0,,,2971062.0,2971062.0,1044675.0,579065.0,1623740.0,55511.0,26867.0,82378.0,1541362.0,,,,,2799215.0,2600111.0,18277.0,579065.0,10538.0,4576.0,1609.0,55511.0,,,21834.0,299.0,,,,,,,,2221202.0,12.536986,2298399.0,2298399.0,2298399.0,29264.0,2269135.0,10446.0,2258689.0,1184.0,829.0,1184.0,2259518.0,59972.0,2264551.0,2245282.0,19323.0,17225.0,23.88,28.74,30.12,27.58,27.58,133224.68,3674337.0,1190189.0,121340.0,9816.0,37.46,23.88,31307.0,0.46389,3499001.0,494409.0,63.55,43.67,39.34,39.58,40.86,40.86,0.186244,0.185399,0.185399,5759305.0,20.8,6195310.0,38675121.0,38.57,3891977.0,42.75,,46.89,7.98,133046.0,,,150.0,2.0,442.0,14.0,5110.0,1609.0,44.0,4576.0,,423874.0,30272.0,14.0,,,,,,,,,,,,,,,,,,,,,,,,,,,,,,0.813,5486720.0,,7408887.0,,14992.0,,,,,,,,,,,,,,,,,,,,,,,,,,,,,,,,,,,,,,,,,,,,3039.0,,,,,,,,11569.0,,11.73,,,,,,,,,,,,,,,,,,,,,,,339968.0,,,,,,,,,,,,,,,,,457408.0,102003.0,94353.0,,0.0325,,23.11,,-0.32,6.03,6.03,0.027485,0.007288,436005.0,,102003.0,,4.18,8904.0,21.15,5389.0,,2258.0,,,,3809.0,3809.0,52.32,72.8,,,,,,,,,,,,,,,,,,,,,,,8.0,18.0,37094.0,,,,,,1445632.0,13100094.0,2057723.0,612091.0,79.0,21059414.0,286659.0,,,,,,73659.0,73659.0,301.6,244.23,,,,,,,,,,,,,,,,,,,,,,,,,,,,,,,64899.0,,,,,,,,,,,,,,,,,,,,,,,,,,,,,86556.0,,,,,,,,,,,,,,,,,,27745789.0,,,13860110.0,13885679.0,,,,,,,,,,,,,,,,,,,,,,,,,,,,,,22.14,20.69,0.78,0.92,1511208.0,193203.0,7285.0,490685.0,,,490685.0,,,,3474.0,,,141.24,,,20772755.0,,,,,,,,,,,,,,,,,,,,,,,,,,,,,,,,,,,,,,,,,,,,,,,594497.0,,,,,,,,,,,,,,,,,,,,,,,,,,,,,,,,,,,,,,,,,,,,,,,,,,,,,,,1531659.0,5000.0,,,,,,,,,,,,,,,,,,,,,,,,,,,1202366.0,,,,39632.0,,,,,,,,,,,,,,5033.0,979380.0,1008142.0,,,,,,,,,,5033.0,,,,,,,,,,,,,,,,,,,,,,,,,,,17225.0,,,,,,,,,,,,,,,,,,,,,,,,,,,,,,,,,,,,,,,,,,,,,,,62812.0,,28762.0,,,,,,,1968356.0,,,,,,,,,,,,,,,,,,,,,,,,,,,,,,,,,,,,,,,,,,,,,,,,,,,,,,,,,,,,,,,,,,,,,,,,,398989.0,398989.0,,,,,,,,,,,,,,,,,,,,,,,,,,,,,,,,,,,,,,,,,,,,,,,,,,,,,,,,,,,,,,,,,,,,,,,,,,,,,,,,,,,,,,,,,,,,,-11377.0,,,,,,,,,,,,,,,,,,,,,,,,,,,,,,,,,,,,,,,,,,,,,,,,,,,,,,,,,,,,,,,,,,,,,,,,,,,,,,,,,,,,,,,,,,,,,,,,,,,,,,,,,,,,,,,,,,,,2362851.0,10820.0,,,,,,,,,,,,,2296079.0,235000.0,,,,,,,,,,,,,,,,,,,,,,,,,,,,,,,,,,,,,,,,,,,,,,,,,,,,,,,,,,,,,,,,,,,,,,,,,,,,,,,,,,,,,,,,,,,,,,,,,,,,,,,,,,,,,,,,,,,,,,,,,,,,,,,,,,,,,,,815 FREEPORT ROAD,PITTSBURGH,15215,ALLEGHENY,UPMC ST MARGARET,38300,P,2,N,N,N,Y,Y,N,,N,N,,,N,N,N,N,Y,Y,Y,,,HO0164,UNIVERSITY OF PITTSBURGH MEDICAL CEN,200 LOTHROP STREET,PITTSBURGH,PA,15213-2582,,Y,,,N,N,,,,UPMC ST MARGARET REHABILITATION UNIT,39T102,,,,,,,,,,,,,,,,,,,,,,,,,,,,,,,,,,,,,,,,,,,,,,,,,,,,,,,,,,,,,,,,,,,,,,,,,,,,,,,,,,,,,,,,,,,,,,,,,,,,,,,,,,,,,,,,,,,,,,,,,,,,,,,,,,,,,,,,,,,,,,,,,,,,,,,,,,,,,,,,,,,,,,,,,,-364821.0,,4423259.0,5445060.0,4631165.0,5346794.0,-28534711.0,2810203.0,1793563.0,2437861.0,5660934.0,1681073.0,,,1366362.0,2006477.0,,2159374.0,11984190.0,381479.0,542526.0,,239983.0,68979345.0,23031754.0,,6470172.0,2517673.0,817147.0,4841197.0,2050549.0,705173.0,1729591.0,1264793.0,,668125.0,3864100.0,15246.0,,,769230.0,-15901.0,-294.0,-21115.0,-23251264.0,4423259.0,2873761.0,3774928.0,2174748.0,2695565.0,5445060.0,18105803.0,28163620.0,13937151.0,,1610447.0,4347534.0,1435264.0,1339048.0,1115449.0,9342906.0,2125566.0,,2365131.0,1839103.0,941395.0,,1988110.0,5459213.0,125196.0,367884.0,14676293.0,10987703.0,2775707.0,3852428.0,4700307.0,23268611.0,,3156141.0,8607523.0,2934243.0,2550513.0,2075993.0,14325773.0,2577015.0,,3867962.0,2444400.0,1290697.0,,3749696.0,223181.0,537339.0,17810444.0,20039485.0,6118211.0,9550108.0,2664023.0,,441414.0,1318724.0,626784.0,179023.0,164112.0,1384862.0,14835.0,,294634.0,76920.0,51985.0,,431583.0,18177.0,49008.0,88387.0,261000.0,397188.0,643247.0,23268611.0,,3156141.0,8615087.0,2934243.0,2550513.0,2075993.0,14325773.0,2577015.0,,3889077.0,2444400.0,1290697.0,,3749696.0,223181.0,537339.0,17810444.0,20039485.0,6134661.0,9550108.0,109744126.0,,22959842.0,18744155.0,1585043.0,25916048.0,8598086.0,45894131.0,5187645.0,,11029068.0,5572383.0,7105603.0,,11821700.0,405566.0,373106.0,78934128.0,69772324.0,38654.0,24190820.0,16725964.0,,3775371.0,5518871.0,274817.0,6431437.0,1963272.0,11098237.0,1098765.0,,2878656.0,1065898.0,1162816.0,,3231143.0,125385.0,71779.0,11504861.0,15479090.0,10709.0,6458767.0,2018924.0,,158505.0,923816.0,39617.0,183553.0,70110.0,1124508.0,380695.0,,552299.0,438782.0,202485.0,,373537.0,31175.0,94514.0,2164824.0,2638504.0,4588.0,1009634.0,231153.0,,27851.0,145661.0,8462.0,12882.0,5542.0,62349.0,2192.0,,41841.0,13808.0,8155.0,,45094.0,2539.0,8620.0,10746.0,34364.0,263.0,68004.0,16725964.0,,3775371.0,5518871.0,274817.0,6431437.0,1963272.0,11098237.0,1098765.0,,2878656.0,1065898.0,1162816.0,,3231143.0,125385.0,71779.0,11504861.0,15479090.0,10709.0,6458767.0,173316.0,654487.0,27213312.0,4817698.0,-2747070.0,40882606.0,,-21543218.0,65831651.0,-47223730.0,75277175.0,23070418.0,23070418.0,125560905.0,788013.0,,56749807.0,1881262.0,3166766.0,2911846.0,3394072.0,99381745.0,122166833.0,-37706472.0,125560905.0,637196.0,106668.0,,,,1976551.0,1728913.0,,1919912.0,1645753.0,3008647.0,3859738.0,,1948162.0,696503.0,1452540.0,,-801142.0,,-502371.0,441512.0,1945100.0,,3946238.0,831057.0,,6688801.0,,338637.0,18227176.0,560151.0,73887092.0,-42361634.0,,,,227306.0,227306.0,,1281164.0,3149957.0,,,4150112.0,,906436.0,3150101.0,,,,,,5761112.0,,5761112.0,,982016.0,,,,136597.0,380841.0,3300335.0,144.0,4530081.0,135741.0,-50640.0,,,-19427.0,7304.0,26.0,2368324.0,2368324.0,896506.0,6225.0,,6225.0,4847493.0,5687883.0,343618.0,403884.0,5055182.0,,,-3643551.0,,,-1187.0,,,,,,,83027575.0,,37804800.0,81831059.0,34979.0,47791924.0,5826375.0,5826375.0,703278.0,7147123.0,-5731788.0,,,,369070.0,260813.0,109512.0,-267400.0,,-5965.0,,9241298.0,24741798.0,4339008.0,4284805.0,632256.0,2661581.0,4339008.0,4284805.0,632256.0,2661581.0,679108.0,541141.0,120646.0,267015.0,,,49531.0,31018.0,,,-467626.0,,,,,,107384.0,67248.0,396.0,2067822.0,718871.0,-2054690.0,-1125.0,-21115.0,2740072.0,5286868.0,297040.0,5340803.0,11822667.0,365602.0,,2615396.0,3852.0,491.0,37861.0,,,,,11822667.0,,14.0,5110.0,491.0,3852.0,,,,,556372.0,,604350.0,522201.0,289136.0,,109950.0,3918309.0,,,,,386030.0,,1200651.0,,,-24000.0,,-145705.0,,694101.0,,,,416162.0,,,,,722402.0,,,,,36571.0,,,,722402.0,,,,2498952.0,,39545619.0,,63449121.0,49534786.0,4004588.0,,492065.0,15718536.0,36902308.0,,,,,644725.0,,,71615.0,,,,,,,,,3625.0,,,644725.0,519.0,,,2994795.0,,6918185.0,3471524.0,571208.0,,,34565.0,2240.0,1063059.0,3740487.0,181.0,,,,2994795.0,,6918185.0,3471524.0,571208.0,,,34565.0,2240.0,1063059.0,3740487.0,,,,26177.0,,,186970.0,,197445.0,123972.0,63449.0,,,8594.0,2949.0,200032.0,584713.0,,,,4462.0,,,,,,,,,,,,,30.0,,,,,,,,306543.0,,,,,,,,,,,-5289016.0,,,,,,,,,,,,,,,,,-31080.0,5327915.0,,,,8053243.0,-53935.0,4412978.0,,,,,,,,,,,,,,,,,,,,,,,,,,,,,,,21130.0,,2566.0,62855.0,,276065.0,73281.0,475925.0,1064631.0,,35042.0,3124.0,1004.0,603921.0,,2551.0,,108.0,9957.0,,27185.0,14060.0,195917.0,185387.0,,5422.0,4113.0,189.0,102942.0,,,,,,,,,,,,,,,,,292.0,,19.0,1543.0,,1172.0,1065.0,6165.0,7466.0,,748.0,375.0,1.0,1341.0,,,,,,,,,,,,,,,,,,,,,,,,,,,,,,,,,,,354076.0,,617997.0,1644544.0,59722.0,,4305559.0,-3375725.0,,,120.0,,,,4252613.0,156716.0,1902503.0,,,6612846.0,,789253.0,,6612846.0,,44113.0,18769504.0,51162462.0,15318.0,1978.0,,,,,,,30696.0,60511.0,26935.0,4035.0,,5303.0,4425.0,1727.0,962.0,1003.0,,829.0,,236.0,,,,945.0,121.0,76.0,82.0,,56.0,7650.0,15318.0,2492572.0,4020003.0,2492572.0,4020003.0,969.0,,359322.0,519147.0,182.0,,,,,,,,17184.0,1692.0,,,,,,,,,,,,,,,,,,,,,,,,,,,,,58365.0,,,,,,7045.0,,,,,,,,,,,,,,,,,,,,,,,,,,,,,,,,,,,,,,,,,,,,,,360894.0,,,,,2250173.0,340733.0,340733.0,118055.0,,,,,,,,,,,,,,,,,,,,,75017.0,,,,,,,133332.0,1618619.0,,,360662.0,3534.0,,,,,,,,,462528.0,,251785.0,,,,423917.0,4154.0,,,,,,,,543649.0,,295945.0,,,,,,,,165.0,,,128956.0,,1440.0,,,,,,,,,622.0,,47996.0,,834.0,,,,,,,,,,,,979380.0,,,,,,,,,,,,,,,,,,,,13885679.0,-12127385.0,,,150.0,,,,106667.0,,,,,,,,,,,,,,,,,,,,,,,,,,,,,,,,,,,,,,,,,,,,,,,,,,,,,,,,,,,,,,,,,,,,,,3859780.0,22678421.0,,,,,,,,,,,,,,,,,,,,,,,,,,,,,,,,,,33914.0,,,11750.0,,,,,68.0,,,,,,,,,,1.0,,,,4063472.0,,,,,,,,,,,,,,,,,,,,,,,,,,465694.0,183761.0,,,,,,,6034.0,,13625.0,1.0,,,,,,,,,,,,,,,,,,,,,,,,,,,,,,,,,,,,,,,,,,,,,,,,,,,,,-1221673.0,,,67264.0,,79062.0,,,,,,,,,,,,,,,,,,,,,,,,,,,,,,,,,,,,,,,,,,937281.0,,,,,,,,,,,,,,,,,,,,,,,,,,,,,,,,,,,,,,,,,,,,,,,,,,,,,,,,,,,,,,,,,,,,,,,,,,,,,,,,,,,,,,,,,,,,,,,,,,,,,5031.0,,,,,,,,,,,,,,,,,9103.0,,,,,,,,,,,,,,,,,,,,,,,,,,,,,,,,,,,,,,,,,,,,,,,,,,,,,,,,,,,,,,,,,,,,,,,,,,,,,,,,,,,,,,,,,,,,,,,,,,,,,,,,,,,,,,,,,,,,,,,,,,,,,,,,,,,,,,,,,,,,,,,,,,,,,,,,,,,,,,,,,,,,,,,,,,,,,,,,,,,,,,,,,,,,,,,,,,,,,,,,,,,,,,,,,,,,,,,,,,,,,,,,,,,,,,,,2012,,,,,,,,,,,,,,,,,,,,,,,,,,40.487472,-79.896038,Voluntary non-profit - Private,Acute Care Hospitals,UPMC ST MARGARET (390102)
18625,580729,390102,12001,2,2016-08-11 00:00:00,2013-07-01 00:00:00,2014-06-30,F,E,39,39010,2.0,3.0,6280,,,,,,,,,,,,,,,,,,,,,,,,,,,,,,,,,,,,,,,,,-61346.0,,1541189.0,,,,,,,,,,,,,,,,,,58098.0,,,,,,,,,,,,,,,,,,,5471344.0,15181091.0,,,,,,,,,,,,636900.0,9046380143.0,0.00018441,,,,,,,,,151227.0,,,,,,,,,,,,,,,,,,,,,,,,,,,,,,,,,,,,,,,,,,,,,,,,,,,,,,,,,,,,,,,,,,,,,,,,,,,,,,,,,,,,,,,,,,,,,,,,,,,,,,,,,,,,,,,,,,,,,,,,,,,,,,,,,,,,,,,,,,,,,,,,,,,,,,,,,,,,,,,,,,,,,,,,,,,,,,,,206416118.0,4817698.0,40882606.0,65831652.0,207012001.0,873189.0,139753.0,2395022.0,3433012.0,,,,,-277880.0,10407792.0,10363249.0,,,,,-47519057.0,66807196.0,15364017.0,177197971.0,3471823.0,108275.0,-47519057.0,-28160.0,196486110.0,18565020.0,423643.0,188090009.0,41300012.0,658608.0,12519061.0,2035490.0,20738.0,184030042.0,187845295.0,184136419.0,41300012.0,658608.0,620285791.0,620285791.0,112647273.0,860643.0,1263133442.0,41300012.0,41300012.0,9102424.0,12657607.0,23153651.0,678309.0,861242.0,1539551.0,21614100.0,94077315.0,94077315.0,26725953.0,321293.0,12657607.0,225930.0,71532.0,60454.0,16488.0,13324.0,597497.0,448619.0,692790.0,7114.0,71532.0,16488.0,,,,,,,,,,,,,,,,,,112647273.0,125791614.0,137662933.0,620108443.0,,,244005167.0,1239546602.0,,1200.0,995828849.0,8112456.0,7825042.0,7825042.0,243717753.0,244005167.0,-287414.0,12469.0,0.145693,5642677.0,290465.0,5352212.0,779780.0,3244963.0,8647731.0,403803.0,58831.0,50874.0,17224418.0,2509477.0,2465183.0,1.0,1.0,1.0,1312.18,1343.0,2905.0,2905.0,12683.0,12683.0,209.0,223.0,249.0,209.0,76799.0,81909.0,76799.0,13324.0,14292.0,13324.0,55025.0,58721.0,55025.0,560151.0,73887092.0,342366.0,,,,-1192758.0,-9961107.0,,,,322423.0,,,,,,,642847651.0,642847651.0,,,,,,,,,,,,,,,,,,,,,,,,,,,,,,,,,,482445510.0,,618090515.0,619438159.0,795282.0,,107.0,107.0,,,,,,716.0,735.0,,716.0,,66807196.0,3117315.0,4641466.0,1801904.0,2047104.0,1972713.0,1665776.0,1238730.0,,61493086.0,3117315.0,58375771.0,99061477.0,61493086.0,3236679.0,58256407.0,98942113.0,18992379.0,,57341143.0,57341143.0,6784386.0,,,,,,,,,,,,,,,,,,,,6712137.0,8268220.0,1882358.0,6385588.0,8183013.0,7428279.0,7412415.0,228728.0,148673.0,150694.0,7561088.0,7561325.0,7296788.0,3354.0,,7147123.0,4234200.0,1957436.0,4234200.0,,,,,,2111269.0,12683.0,14292.0,58721.0,1263133442.0,,,507428.0,,140730.0,2749232.0,2333966.0,66807196.0,3236679.0,507428.0,4669330.0,,1801904.0,140730.0,2047104.0,1476156.0,1665776.0,2749232.0,1238730.0,2199432.0,2793434.44,23.92,2656477.31,2539234.1,23.15,22.94,33.02,,,,,2604337.0,1155230.0,339689.0,,,,,,,,40.98,96600.72,7445953.0,16488.0,66103.0,0.249429,1857237.0,,,25167759.0,24814637.0,6794997.0,6779133.0,31593770.0,0.785428,0.214572,4859401.0,3816710.0,41.91,1042691.0,64.29,41.91,15.29,14.89,13.72,14.63,14.63,136154.22,1991936.0,66103.0,22.35,14.57,5461774.0,4859401.0,59.65,38.89,1042691.0,109956.0,64.8,65.21,,2276764.0,,,,3708876.0,,,,17224418.0,209.4,5402768.0,8737271.0,16820615.0,2450646.0,2414309.0,83675538.0,12190940.0,4644512.0,,,5429.0,18697328.0,,,18697328.0,,,175848.0,26.55,18703039.0,18703039.0,845913.0,32.1,22.45,,,95019.0,,,2008047.0,190113.0,73786.0,,,,,,,,,,,,,,,,,1163954.0,248637.0,,,,75959.0,53628.0,,6263.0,,10377.0,10377.0,,77416.0,77416.0,67039.0,10377.0,10651.0,11871319.0,1342.0,3497.0,7644885.0,1375292.0,12961749.0,892704.0,,7644885.0,1375292.0,12961749.0,892704.0,,117243.21,182355.88,8168.0,266800.59,7640.0,82653.0,161340.0,93698.0,53672.0,,70693.0,68983.0,27.61,41.92,168.38,48.58,66.42,21.8,12.69,15.75,31.04,,17.52,31.88,21982667.0,21982667.0,117243.21,457337.97,27.61,48.07,,,,,168452.0,13179.0,72249.0,1331668.0,1396862.0,13179.0,23788.0,9267.0,4114.0,27164.0,,269235.0,0.0407,0.0721,0.1128,,,168452.0,353122.0,34261418.0,2403584.0,137296.0,214526.0,139442.0,91592.0,31859980.0,31844991.0,,,15864.0,72249.0,,,1627341.0,0.0231,37592.0,6771.0,160.88,0.0407,0.0721,0.1128,989796.0,144206.0,-1190843.0,96895.0,303.0,,27164.0,5711.0,7442.0,43114.0,56171.0,5711.0,7442.0,,43114.0,56171.0,,287.0,84591.0,374.0,,150.22,32.5,150.19,2996572.07,45939.0,,-237.0,,,,,,,136.0,36337.0,7957.0,44294.0,719.0,,,633.0,,,,,,,7644885.0,7644885.0,,1540322.0,,348620.0,,,-47004.0,1985271.0,4340482.0,245167.0,4340482.0,13144341.0,,,4340482.0,4340482.0,1291204.0,722904.0,2014108.0,72929.0,36610.0,109539.0,1904569.0,,,,,3798204.0,3897802.0,22853.0,722904.0,16070.0,7382.0,2196.0,72929.0,,,26444.0,506.0,,,,,,,,427405.0,20.224658,2926636.0,2926636.0,2926636.0,27648.0,2898988.0,6592.0,2892396.0,3616.0,2350.0,3616.0,2894746.0,11412.0,2904912.0,2826855.0,-8031.0,14411.0,24.32,23.88,28.74,25.65,25.65,135276.34,3469838.0,936602.0,353122.0,15864.0,37.3,24.32,31038.0,0.46954,3496173.0,494009.0,63.88,43.24,43.67,39.34,42.08,42.08,0.200955,0.199052,0.199052,6141117.0,21.56,6596191.0,38974687.0,38.57,3816710.0,42.32,,48.11,8.81,143369.0,,,196.0,5.0,617.0,26.0,8746.0,2196.0,36.0,7382.0,,496557.0,35338.0,14.05,,,,,,,,,,,,,,,,,,,,,,,,,,,,,,0.813,5456967.0,,13144341.0,,7067.0,,,,,,,,,,,,,,,,,,,,,,,,,,,,,,,,,,,,,,,,,,,,3210.0,,,,,,,,11457.0,,12.28,,,,,,,,,,,,,,,,,,,,,,,315368.0,,,,,,,,,,,,,,,,,690440.0,153741.0,144032.0,,0.0234,,22.38,,0.93,6.03,6.03,0.028797,0.007632,455074.0,,153741.0,,3.75,12958.0,30.82,5235.0,,3874.0,,,,741.0,741.0,13.5,54.89,,,,,,,,,,,,,,,,,,,,,,,,,45933.0,,,,,,1224021.0,13281118.0,1934966.0,710945.0,226.0,19638985.0,424834.0,,,,,,,,,,,,,,,,,,,,,,,,,,,,,,,,,,,,,,,,47311.0,,,,,,,,,,,,,,,,,,,,,,,,,,,,,34439.0,,,,,,,,,,,,,,,,,,13885679.0,509932.0,509932.0,,14395611.0,,,,,,,,,,,,,,,,,,,,,,,,,,,,,,22.14,20.54,0.72,0.92,1142703.0,269235.0,6771.0,43676.0,,,43676.0,,,,397.0,,,110.02,,,19214151.0,,,,,,,,,,,,,,,,,,,,,,,,,,,,,,,,,,,,,,,,,,,,,,,495730.0,,,,,,,,,,,,,,,,,,,,,,,,,,,,,,,,,,,,,,,,,,,,,,,,,,,,,,,1532852.0,84546.0,,,,,,,,,,,,,,,,,,,,,,,,,,,1426572.0,,,,-52737.0,,,,,61484.0,,27273.0,,,,,,,10166.0,1331668.0,1338188.0,,,,,,,,,,10166.0,,,,,0.41,,,,,,,,,,,,,,,,,,,,,,14411.0,,,,,,,,,,,,,,,,,,,,,,,,,,,,234.0,,258.0,52.0,206.0,258.0,206.0,206.0,206.0,206.0,202.0,,,,,,,,,65194.0,,6520.0,,,,,,,1984179.0,,,,,,,,,,,,,,,,,,,,,,,,,,,,,,,,,,,,,,,,,,,,,,,,,,,,,,,,,,,,,,,,,,,,,,,,,35800.0,35800.0,,,,,,,,,,,,,,,,,,,,,,,,,,,,,,,,,,,,,,,,,,,,,,,,,,,,,,,,,,,,,,,,,,,,,,,,,,,,,,,,,,,,,,,,,,,,,27990.0,,,,,,,,,,,,,,,,,,,,,,,,,,,,,,,,,,,,,,,,,,,,,,,,,,,,,,,,,,,,,,,,,,,,,,,,,,,,,,,,,,,,,,,,,,,,,,,,,,,,,,,,,,,,,,,,,,,,1567912.0,3799.0,,,,,,,,,,,,,1635562.0,390000.0,,,,,,,,,,,,,,,,,,,,,,,,,,,,,,,,,,,,,,,,,,,,,,,,,,,,,,,,,,,,,,,,,,,,,,,,,,,,,,,,,,,,,,,,,,,,,,,,,,,,,,,,,,,,,,,,,,,,,,,,,,,,,,,,,,,,,,,815 FREEPORT ROAD,PITTSBURGH,15215,ALLEGHENY,UPMC ST MARGARET,38300,P,2,N,N,N,Y,Y,N,,N,N,,,N,N,N,N,Y,Y,Y,,,HO0164,UNIVERSITY OF PITTSBURGH MEDICAL CEN,200 LOTHROP STREET,PITTSBURGH,PA,15213-2582,,Y,,,N,N,,,,UPMC ST MARGARET REHABILITATION UNIT,39T102,,,,,,,,,,,,,,,,,,,,,,,,,,,,,,,,,,,,,,,,,,,,,,,,,,,,,,,,,,,,,,,,,,,,,,,,,,,,,,,,,,,,,,,,,,,,,,,,,,,,,,,,,,,,,,,,,,,,,,,,,,,,,,,,,,,,,,,,,,,,,,,,,,,,,,,,,,,,,,,,,,,,,,,,,,-277880.0,,4709104.0,5698688.0,4790685.0,5572564.0,-36365192.0,2749232.0,1238730.0,2333966.0,4641466.0,1543287.0,,,1375196.0,2047104.0,,2015239.0,12542879.0,552352.0,482172.0,,12722299.0,63587531.0,26440588.0,,6521774.0,2196903.0,886081.0,4216480.0,1630942.0,636345.0,1923346.0,1521222.0,,540429.0,4588920.0,17732.0,,,771903.0,-13643.0,-652.0,-24865.0,-31886193.0,4709104.0,2696118.0,3541175.0,1790430.0,2532539.0,5698688.0,17564946.0,26241284.0,11114547.0,,1715772.0,3789843.0,1564942.0,1429601.0,1097914.0,8582438.0,1704719.0,,2158517.0,2049413.0,1010628.0,,1844622.0,6345001.0,142060.0,5394853.0,15509092.0,11626587.0,2819007.0,2327458.0,4535272.0,21090805.0,,3063077.0,8005396.0,3202073.0,2593614.0,1997582.0,13473698.0,2063144.0,,3502100.0,2699813.0,1393362.0,,3582421.0,247993.0,6434356.0,18692453.0,20835116.0,3670516.0,9362895.0,2961083.0,,347398.0,1387677.0,692182.0,179363.0,167271.0,702613.0,14038.0,,202081.0,82619.0,66156.0,,444194.0,20134.0,33246.0,107070.0,244036.0,326926.0,673892.0,21090805.0,,3063077.0,8020125.0,3202073.0,2594689.0,1997582.0,13473698.0,2063144.0,,3523215.0,2699813.0,1393362.0,,3582421.0,247993.0,6434356.0,18692453.0,20835116.0,3686039.0,9362895.0,102027003.0,,26462458.0,18400307.0,1737946.0,22999358.0,10190601.0,46991948.0,4625031.0,,10175090.0,6664044.0,9184887.0,,11699382.0,358865.0,16277842.0,95359133.0,69999693.0,17255.0,25443325.0,16083090.0,,4249093.0,4668780.0,300278.0,5405110.0,2406009.0,11025334.0,1075867.0,,2549340.0,1124061.0,1221619.0,,3208582.0,119979.0,2505828.0,15319256.0,15174571.0,3337.0,6675619.0,1797285.0,,152877.0,664578.0,41462.0,160251.0,90656.0,1037717.0,327185.0,,436434.0,430413.0,178965.0,,342073.0,34022.0,594137.0,2492994.0,2624366.0,2693.0,961670.0,252328.0,,21008.0,118420.0,8963.0,11075.0,7591.0,48403.0,2226.0,,25032.0,13172.0,8498.0,,43896.0,2762.0,3070.0,14278.0,30744.0,177.0,69213.0,16083090.0,,4249093.0,4668780.0,300278.0,5405110.0,2406009.0,11025334.0,1075867.0,,2549340.0,1124061.0,1221619.0,,3208582.0,119979.0,2505828.0,15319256.0,15174571.0,3337.0,6675619.0,431895.0,114342.0,27211157.0,2540934.0,-1193715.0,41022359.0,-7621.0,-23151690.0,66269238.0,-48134374.0,69424004.0,23819797.0,23819797.0,120454958.0,1156865.0,,60019845.0,1699654.0,3974938.0,2618459.0,5376378.0,91493406.0,115078580.0,-40060065.0,120454958.0,684366.0,,,,,1972713.0,1665776.0,,345908.0,1801904.0,1510676.0,4831132.0,,1279402.0,700133.0,1127866.0,,-796624.0,,-302066.0,474099.0,1896025.0,,1841917.0,840318.0,,4059967.0,,167181.0,12300841.0,560151.0,74229458.0,-45323484.0,,,,1401440.0,1401440.0,,1058909.0,3093362.0,,,4229446.0,,1052581.0,3089946.0,,,,,,6206999.0,,6206999.0,,1073469.0,,,,733581.0,507428.0,3287593.0,,4529795.0,140730.0,-45823.0,,,-21111.0,,,1496023.0,1496023.0,548594.0,,-3416.0,,4987864.0,5816169.0,585529.0,259729.0,5188854.0,,,-4600883.0,,,-545.0,,,,,,,86705046.0,,42427926.0,90377880.0,10859637.0,50473122.0,6151923.0,6151923.0,687477.0,7193062.0,-5876834.0,,,,371178.0,256718.0,126067.0,-353158.0,,-70240.0,,10405045.0,27844295.0,4993423.0,5515464.0,776098.0,2853253.0,4993423.0,5515464.0,776098.0,2853253.0,683560.0,562916.0,132068.0,246103.0,,,44923.0,28863.0,,,-272765.0,,,,,,151376.0,97261.0,,2066251.0,726513.0,-3674619.0,-1200.0,-21115.0,2740572.0,5267174.0,289992.0,5321109.0,11871319.0,386757.0,,2924404.0,3696.0,968.0,75949.0,,,,,11871319.0,,14.0,5110.0,968.0,3696.0,,,,,494693.0,,663105.0,503766.0,260817.0,,112258.0,3708202.0,,,,,545179.0,,1390607.0,,-4966.0,-24000.0,12070.0,-309322.0,,1029558.0,,,,327069.0,,,,,655428.0,,,,,51681.0,,,,655428.0,,,,3074994.0,,45940825.0,,64517442.0,42825474.0,3919895.0,,515677.0,19504634.0,39551240.0,,,,,625821.0,,,58640.0,,,,,,,,,4624.0,,,625821.0,,,,3518663.0,,6808575.0,3055579.0,641863.0,,19094.0,54627.0,1081716.0,1576651.0,3672340.0,,,,,3518663.0,,6808575.0,3055579.0,641863.0,,19094.0,54627.0,1081716.0,1576651.0,3672340.0,,,,23788.0,,,179486.0,,201779.0,115131.0,60143.0,,7311.0,15491.0,256477.0,256578.0,529026.0,,,,4114.0,,,,,,,,,,,,,19.0,,,,,,,,326270.0,,,,,,,,,,,-5264176.0,,,,,,,,,,,,,,,,,-14989.0,1347644.0,,,,8118860.0,-53935.0,1630855.0,,,,,,,,,,,,,,,,,,,,,,,,,,,,,,,63408.0,,13138.0,55867.0,,357239.0,122072.0,643175.0,1416778.0,,36836.0,27613.0,3270.0,919477.0,,7086.0,,472.0,7959.0,,33403.0,20898.0,246277.0,207555.0,,5643.0,6547.0,532.0,159019.0,,,,,,,,,,,,,,,,,995.0,,65.0,1419.0,,1528.0,1199.0,7537.0,9855.0,,879.0,34.0,3.0,1863.0,,9160.0,9160.0,1342.0,,,,,,,,,,,,,,,,,,,,,,,,,,,,,,,394358.0,,678140.0,1636973.0,124221.0,,4549317.0,-2610806.0,-767.0,,721.0,,,,3702627.0,130691.0,393243.0,,,5897924.0,,717144.0,,5897924.0,,26814.0,21452352.0,57356463.0,4767.0,490.0,,,,,,,4361.0,53871.0,21934.0,2051.0,,16135.0,602.0,1597.0,826.0,582.0,,2324.0,,60.0,,,,130.0,110.0,69.0,47.0,,167.0,9709.0,4767.0,3277640.0,4619660.0,3277640.0,4619660.0,5419.0,,452570.0,474813.0,882.0,,,,,,,,374.0,35.0,,,,,,,,,,,,,,,,,,,,,,,,,,,,,47835.0,,,,,,5346.0,,,,,,,,,,,,,,,,,,,,,,,,,,,,,,,,,,,,,,,,,,,,,,384838.0,,,,,2159100.0,276563.0,276563.0,84106.0,,,,,,,,,,,,,,,,,,,,,73777.0,,,,,,8947.0,294628.0,886523.0,,,249433.0,,,,,,,,,,549625.0,,449140.0,3969.0,,,110643.0,,,,,,,,,243802.0,,199229.0,,,,,,,,,,,167740.0,,668.0,,,,,,,,,,,68612.0,,367.0,,,,,,,,,,,,1331668.0,,,,,,,,,,,,,,,,,,,,14395611.0,-13106712.0,,,50.0,,,,118127.0,,,,,,,,,,,,,,,,,,,,,,,,,,,,,,,,,,,,,,,,,,,,,,,,,,,,,,,,,,,,,,,,,,,,,,3841831.0,23467047.0,,,,,,,,,,,,,,,,,,,,,,,,,,,,,,,,,,18126.0,,,5512.0,,,,,38.0,,,,,,,,,,,,,,1278064.0,,,,,,,,,,,,,,,,,,,,,,,,,,978296.0,362175.0,,,,,,,,,6520.0,2.0,,,,,,,,,,,,,,,,,,,,,,,,,,,,,,,,,,,,,,,,,,,,,,,,,,,,,-1455307.0,,,126523.0,,56123.0,,,,,,,,,,,,,,,,,,,,,,,,,,,,,,,,,,,,,,,,,,836727.0,,,,,,,,,,,,,,,,,,,,,,,,,,,,,,,,,,,,,,,,,,,,,,,,,,,,,,,,,,,,,,,,,,,,,,,,,,,,,,,,,,,,,,,,,,,,,,,,,,,,,10164.0,,,,,,,,,,,,,,,,,,,,,,,,,,,,,,,,,,,,,,,,,,,,,,,,,,,,,,,,,,,,,,,,,,,,,,,,,,,,,,,,,,,,,,,,,,,,,,,,,,,,,,,,,,,,,,,,,,,,,,,,,,,,,,,,,,,,,,,,,,,,,,,,,,,,,,,,,,,,,,,,,,,,,,,,,,,,,,,,,,,,,,,,,,,,,,,,,,,,,,,,,,,,,,,,,,,,,,,,,,,,,,,,,,,,,,,,,,,,,,,,,,,,,,,,,2013,,,,,,,,,,,,,,,,,,,,,,,,,,40.487472,-79.896038,Voluntary non-profit - Private,Acute Care Hospitals,UPMC ST MARGARET (390102)
26246,685321,390102,12001,2,2021-01-19 00:00:00,2014-07-01 00:00:00,2015-06-30,F,J,39,39010,2.0,3.0,6280,,,,,,,,,,,,,,,,,,,,,,,,,,,,,,,,,,,,,,,,,,,773744.0,,,,,,,,,,,,,,,,,,86145.0,,,,,,,,,,,,,,,,,,,5158918.0,16598799.0,,,9046380143.0,0.00018441,,,,,,,,661823.0,7647644885.0,0.000173278,,,,,,,,,162368.0,,,,,,,,,,,,,,,,,,,,,,,,,,,,,,,,,,,,,,,,,,,,,,,,,,,,,,,,,,,,,,,,,,,,,,,,,,,,,,,,,,,,,,,,,,,,,,,,,,,,,,,,,,,,,,,,,,,,,,,,,,,,,,,,,,,,,,,,,,,,,,,,,,,,,,,,,,,,,,,,,,,,,,,,,,,,,,,,203055107.0,2540934.0,41022359.0,66269238.0,206210813.0,1773162.0,122458.0,90989.0,2083049.0,,,,,-257128.0,9815218.0,9827945.0,,,,,-52065749.0,63086171.0,14397850.0,177782310.0,3077878.0,102947.0,-52065749.0,-53692.0,188802732.0,17228646.0,363283.0,180561522.0,37894975.0,563716.0,11748769.0,1896753.0,20484.0,177238063.0,182002728.0,177493754.0,37894975.0,563716.0,629412340.0,629412340.0,112557171.0,718537.0,1291158280.0,37894975.0,37894975.0,8624678.0,13139282.0,23177437.0,593380.0,867434.0,1460814.0,21716623.0,104081335.0,104081335.0,28419323.0,279862.0,13139282.0,198266.0,71185.0,58393.0,17538.0,13290.0,620783.0,431659.0,728702.0,7204.0,71185.0,17538.0,,,,,,,,,,,,,,,,,,112557171.0,129329178.0,142443205.0,629773416.0,,,240868481.0,1265298039.0,,525.0,1025089903.0,7456496.0,6796151.0,6796151.0,240208136.0,240868481.0,-660345.0,20113.0,0.137271,7201935.0,418364.0,6558298.0,1125537.0,3203715.0,8300243.0,251492.0,251492.0,249534.0,13652465.0,2091057.0,2078178.0,1.0,1.0,1.0,1203.41,1239.96,3117.0,3117.0,11999.0,11999.0,208.0,222.0,248.0,208.0,75274.0,80384.0,75274.0,13290.0,14288.0,13290.0,51445.0,55345.0,51445.0,560151.0,74229458.0,782172.0,,,,-1528135.0,-7242112.0,,,,244401.0,,,,,,,661745940.0,661745940.0,,,,,,,,,,,,,,,,,,,,,,,,,,,,,,,,,,487330211.0,,,635524623.0,741958.0,,117.0,117.0,,,,,,601.0,608.0,,601.0,,63086171.0,3458607.0,4706044.0,1809561.0,2067096.0,1858265.0,1191073.0,618215.0,,58789056.0,3458607.0,55330449.0,92966834.0,58780311.0,3386732.0,55393579.0,93029964.0,17308449.0,,63223720.0,63223720.0,7053188.0,,,,,,,,,,,,,,,,,,,,6981032.0,8755491.0,1910204.0,6850624.0,8667963.0,7944862.0,7929963.0,289459.0,188148.0,178942.0,8118111.0,8118375.0,7803623.0,-1097936.0,635534530.0,7193062.0,2023930.0,2023930.0,2023930.0,,,,,,1933551.0,11999.0,14288.0,55345.0,1291158280.0,,,103745.0,,141717.0,2643857.0,2212810.0,63077426.0,3386732.0,105251.0,4704323.0,,1828077.0,144873.0,2088816.0,1466891.0,1178018.0,2620954.0,619313.0,2049451.0,2579113.29,24.46,2453102.82,2328284.01,23.96,23.79,33.5,,,,,2298461.0,1478191.0,332064.0,,,,,,,,40.98,96919.51,7062240.0,17538.0,64237.0,0.27302,1928133.0,,,26152688.0,25940909.0,7067755.0,7052856.0,32993765.0,0.786237,0.213763,5118931.0,4024693.0,37.7,1094238.0,58.9,37.7,13.78,15.29,14.89,14.65,14.65,136603.53,2001242.0,64237.0,19.21,12.3,5183940.0,5118931.0,53.83,34.46,1094238.0,1250320.0,59.46,60.46,,,,,,4508974.0,,,,13652465.0,200.93,5096528.0,9959918.0,13400973.0,1839565.0,1828644.0,96457498.0,13240817.0,4719333.0,,,6948.0,17437986.0,,,17437986.0,,,169707.67,27.72,17486492.0,17486492.0,761209.42,31.57,22.74,,,1236739.0,,,2019180.0,397559.0,84432.0,,,,,,,,,,,,,,,,,53716.0,159969.0,,,,77174.0,29985.0,,3274.0,,10260.0,10260.0,70705.0,70705.0,70705.0,60445.0,10260.0,4923.0,13114027.0,1147.0,3498.0,4310752.0,1566861.0,14272280.0,995982.0,,4310752.0,1566861.0,14272280.0,995982.0,,124818.81,126888.46,9607.0,312520.0,3442.44,81657.57,159732.21,92969.89,39295.91,,31634.77,64741.7,27.13,33.97,163.1,45.67,30.57,22.39,13.08,15.78,29.98,,19.58,31.66,20149893.0,20149893.0,124818.81,449015.46,27.13,44.88,,,,,138731.0,21911.0,72156.0,1060173.0,1098687.0,21911.0,40720.0,15523.0,6986.0,26356.0,,172510.0,0.0408,0.0742,0.115,,,138731.0,211779.0,35920409.0,2673712.0,179484.0,351912.0,228743.0,153311.0,33295956.0,33091128.0,,,14899.0,72156.0,,,1718116.0,0.0236,40548.0,4745.0,151.63,0.0408,0.0742,0.115,702165.0,96387.0,-1438434.0,55989.0,239.0,,26356.0,48506.0,8990.0,323738.0,65901.0,48506.0,8990.0,,323738.0,65901.0,,2741.0,78277.12,439.0,,118.11,33.48,150.12,2777299.47,,,-264.0,,,,,,,52.0,10921.0,1958.0,12879.0,614.0,,7.0,766.0,,,,,,,4310752.0,4310752.0,,1825403.0,,446858.0,,,-117988.0,2372732.0,5198464.0,252481.0,5198464.0,16772007.0,,,5198464.0,5198464.0,1900015.0,1075236.0,2975251.0,94316.0,51952.0,146268.0,2828983.0,,,,,6251017.0,6120576.0,10824.0,1075236.0,7668.0,8892.0,3250.0,92268.0,,,39483.0,279.0,,,,,,,,4198015.0,24.361644,4344457.0,4344457.0,4344457.0,28452.0,4316005.0,24760.0,4291245.0,2266.0,1473.0,2266.0,4292718.0,95715.0,4307235.0,4180565.0,-7675.0,50727.0,22.16,24.32,23.88,23.45,23.45,135722.75,3182698.0,795711.0,211779.0,14899.0,34.62,22.16,15114.0,0.235285,1661639.0,97372.0,57.9,54.38,43.24,43.67,47.1,47.1,0.23441,0.224928,0.224928,6885807.0,5.08,7285340.0,37802933.0,38.57,4024693.0,52.82,,52.18,10.2,175248.0,,,266.0,5.0,723.0,26.0,9490.0,3250.0,59.0,8892.0,,397148.0,27902.61,14.23,,,,,,,,,,,,,,,,,,,,,,,,,,,,,,0.813,5675579.0,,16772007.0,,5584.0,,,,,,,,,,,,,,,,,,,,,,,,,,,,,,,,,,,,,,,,,,,,3246.0,,,,,,,,11086.91,,13.07,,,,,,,,,,,,,,,,,,,,,,,260336.0,,,,,,,,,,,,,,,,,287748.0,66913.0,59406.0,,0.0301,,21.2,,-3.28,6.03,5.08,0.025282,0.006708,399533.0,,64865.0,,14.25,15372.0,36.55,5046.0,,4384.0,,,,,,,,,,,,,,,,,,,,,,,,,,,,,,,,34173.0,,,,,,665561.0,7302037.0,1002358.0,336797.0,327.0,18503196.0,499697.0,,,,,,105334.0,105334.0,760.62,138.48,,,,,,,,,,,,,,,,,,,,,,,,,,,,,,,40398.0,,,,,,,,,,,,,,,,,,,,,,,,,,,,,20581.0,,,,,,,,,,,,,,,,,,14395611.0,1087430.0,1087430.0,,15483041.0,,,,,,,,,,,,,,,,,,,,,,,,,,,,,,22.14,19.38,1.48,1.56,747970.0,172510.0,4745.0,193762.0,,,193762.0,,,,1156.0,,,167.61,,,18003499.0,,,,,,,,,,,,,,,,,,,,,,,,,,,,,,,,,,,,,,,,,,,,,,,435658.0,,,,,,,,,,,,,,,,,,,,,,,,,,,,,,,,,,,,,,,,,,,,,,,,,,,,,,,1459072.0,926.0,,,,,,,,,,,,,,,,,,,,,,,,,,,1875697.0,,,,-638497.0,,,,,131809.0,,84769.0,,,2048.0,,,,12469.0,1060173.0,1067656.0,,,,,,,,,,14517.0,,,,,1.0,,,,,,,,,,,,,,,,,,,,,,50727.0,,,,,,,,,,,,,,,,,,,,,,,,,,,,4307.0,,1529.0,315.0,1214.0,1529.0,1214.0,1214.0,1214.0,1214.0,1190.0,,,,,,,,,38514.0,,7483.0,,,,,,,1878300.0,,,,,,,,,,,,,,,,,,,,,,,,,,,,,,,,,,,,,,,,,,,,,,,,,,,,,,,,,,,,,,,,,,,,,,,,,11732.0,11732.0,,,,,,,,,,,,,,,,,,,,,,,,,,,,,,,,,,,,,,,,,,,,,,,,,,,,,,,,,,,,,,,,,,,,,,,,,,,,,,,,,,,,,,,,,,,,,48200.0,,,,,,,,,,,,,,,,,,,,,,,,,,,,,,,,,,,,,,,,,,,,,,,,,,,,,,,,,,,,,,,,,,,,,,,,,,,,,,,,,,,,,,,,,,,,,,,,,,,,,,,,,,,,,,,,,,,,753177.0,5092.0,,,,,,,,,,,,,1444345.0,2390000.0,,,,,,,,,,,,,,,,,,,,,,,,,,,,,,,,,,,,,,,,,,,,,,,,,,,,,,,,,,,,,,,,,,,,,,,,,,,,,,,,,,,,,,,,,,,,,,643637.0,,,,,,,,,,,,,,,,,,,,,,,,,,,,,,,,,,,,,,,,,815 FREEPORT ROAD,PITTSBURGH,15215,ALLEGHENY,UPMC ST MARGARET,38300,P,2,N,N,N,Y,Y,N,,N,N,,,N,N,N,N,Y,Y,Y,,,HO0164,UNIVERSITY OF PITTSBURGH MEDICAL CEN,200 LOTHROP STREET,PITTSBURGH,PA,15213-2582,,Y,,,N,N,,,,UPMC ST MARGARET REHABILITATION UNIT,39T102,,,,,,,,,,,,,,,,,,,,,,,,,,,,,,,,,,,,,,,,,,,,,,,,,,,,,,,,,,,,,,,,,,,,,,,,,,,,,,,,,,,,,,,,,,,,,,,,,,,,,,,,,,,,,,,,,,,,,,,,,,,,,,,,,,,,,,,,,,,,,,,,,,,,,,,,,,,,,,,,,,,,,,,,,,-257128.0,,4683798.0,5131420.0,4791099.0,5036846.0,-43243492.0,2643857.0,618215.0,2212810.0,4706044.0,1412199.0,,,1435991.0,2067096.0,,2182714.0,12854168.0,409717.0,418008.0,,11290201.0,66800578.0,29657824.0,,6483875.0,2182147.0,853308.0,4170679.0,1446049.0,669813.0,1980525.0,1606844.0,,611191.0,5453546.0,14080.0,,,696961.0,-12040.0,-3606.0,-113165.0,-34475749.0,4683798.0,2797674.0,3372264.0,1025424.0,2230255.0,5131420.0,14840237.0,27263063.0,10103620.0,,1568048.0,3782079.0,1551155.0,1401066.0,1004961.0,8312421.0,1534090.0,,2051678.0,2042670.0,987528.0,,2031993.0,7247450.0,129356.0,4681130.0,15284022.0,12549629.0,2785777.0,2085469.0,4488631.0,18583328.0,,2768697.0,7984528.0,3150212.0,2528039.0,1828249.0,12914874.0,1879957.0,,3355678.0,2727104.0,1387237.0,,3717347.0,227482.0,5637525.0,18558440.0,21591599.0,3237222.0,9934976.0,2051665.0,,298494.0,1528068.0,626363.0,177629.0,167434.0,550082.0,12102.0,,218905.0,80547.0,63945.0,,426264.0,17988.0,26352.0,95643.0,234943.0,306073.0,1266906.0,18652998.0,,2818109.0,8018731.0,3150212.0,2535194.0,1828249.0,12914874.0,1879957.0,,3376793.0,2727104.0,1387654.0,,3719681.0,227482.0,5637525.0,18558440.0,21591599.0,3239425.0,9934976.0,102735852.0,,27685210.0,12932406.0,2087237.0,23129987.0,8667127.0,47515481.0,4188756.0,,11113238.0,7214904.0,10292166.0,,11154475.0,282123.0,15505238.0,95771914.0,70400798.0,20905.0,26086453.0,17989671.0,,4965416.0,3451538.0,451619.0,6234355.0,2335092.0,11907221.0,906309.0,,2859678.0,1124094.0,1233866.0,,3217626.0,73301.0,2936637.0,16687359.0,16374500.0,8239.0,7651263.0,1762844.0,,161000.0,687195.0,53404.0,161744.0,85590.0,1070713.0,271383.0,,458120.0,396852.0,159434.0,,348812.0,27302.0,637984.0,2612339.0,2809389.0,4326.0,1104437.0,193893.0,,20772.0,134785.0,10618.0,11334.0,7839.0,44197.0,1747.0,,29698.0,11721.0,7346.0,,38706.0,2159.0,2984.0,13467.0,30571.0,459.0,140837.0,17989671.0,,4965416.0,3451538.0,451619.0,6234355.0,2335092.0,11907221.0,906309.0,,2859678.0,1124094.0,1233866.0,,3217626.0,73301.0,2936637.0,16687359.0,16374500.0,8239.0,7651263.0,412114.0,32001.0,32445377.0,2540934.0,-1450844.0,41144817.0,5548.0,-24804431.0,64336297.0,-49728350.0,61088049.0,24808678.0,24808678.0,118342104.0,1228995.0,,65120792.0,1023420.0,3175709.0,6491355.0,3787354.0,89936117.0,114554750.0,-44050799.0,118342104.0,979118.0,,,,,1858265.0,1191073.0,,-421.0,1809561.0,1242693.0,651584.0,,1083871.0,577587.0,1054365.0,,-743104.0,5012.0,-254119.0,486189.0,1301895.0,,1303056.0,721452.0,,3323459.0,,125674.0,12370100.0,560151.0,75011630.0,-48378513.0,,,,611645.0,611645.0,,878918.0,3123504.0,,,3182416.0,,872215.0,3123504.0,,,,,,8358954.0,,8358954.0,,1434154.0,,,,763091.0,103745.0,3004916.0,,4289440.0,141717.0,-34173.0,,,-19786.0,,,1772703.0,1772703.0,513018.0,,,,4250548.0,5015579.0,427665.0,275041.0,4902330.0,,,-527707.0,,,-1008.0,,,,,,,87616816.0,,31907242.0,89952268.0,10444295.0,55445905.0,6232544.0,6232544.0,608458.0,7193062.0,-6021617.0,,,,375831.0,219233.0,62145.0,-315268.0,,-20703.0,,9965340.0,27848206.0,3306266.0,6959952.0,898303.0,3055607.0,3306266.0,6959952.0,898303.0,3055607.0,592952.0,681497.0,143009.0,274867.0,,,51760.0,32672.0,,,-129537.0,,,,,,98067.0,61902.0,,2130830.0,846275.0,-8608640.0,-3587.0,-21115.0,2944704.0,5469661.0,378485.0,5523596.0,13114027.0,509682.0,,3139257.0,3900.0,998.0,96856.0,,,,,13114027.0,,14.0,5110.0,998.0,3900.0,,,,,461875.0,,689416.0,481094.0,261563.0,,115331.0,3702125.0,,,,,534715.0,,1054407.0,,-32941.0,-15247.0,,-102584.0,,787784.0,,,,220570.0,,,,,742023.0,,,,,110184.0,,,,757270.0,,,,9344398.0,,45543042.0,,74588440.0,41210906.0,11182499.0,,328627.0,22777883.0,42740476.0,,,,,3356075.0,,,123812.0,,,,,,,,,18015.0,,,3356075.0,288.0,,,3756021.0,,8003257.0,3244703.0,2178751.0,,12660.0,23342.0,1102613.0,1794403.0,4063075.0,100.0,,,,3756021.0,,8003257.0,3244703.0,2178751.0,,12660.0,23342.0,1102613.0,1794403.0,4063075.0,,,,40720.0,,,183187.0,,207052.0,118931.0,78760.0,,4470.0,8694.0,239543.0,280907.0,586493.0,,,,6986.0,,,,,,,,,,,,,7.0,,,,,,,,446923.0,,,,,,,,,,,-5257898.0,,,,,,,,,,,,,,,,,-204828.0,-9907.0,,,,8047221.0,-53935.0,2221337.0,,,,,,,,,,,,,,,,,,,,,,,,,,,,,,,69597.0,,28247.0,100770.0,,660678.0,216976.0,1010595.0,2188082.0,,64466.0,67424.0,4342.0,1479891.0,,6820.0,,915.0,20583.0,,58926.0,34760.0,356782.0,282733.0,,10220.0,14648.0,680.0,253906.0,,,,,,,,,,,,,,,,,750.0,,118.0,4063.0,,2418.0,2253.0,10537.0,13028.0,,1321.0,69.0,4.0,2763.0,,7303.0,7303.0,943.0,,,,,,,,,,,,,,,,,,,,,,,,,,,,,,,704979.0,,695422.0,1487637.0,155337.0,,4868462.0,-2750975.0,,,,,,,3637909.0,186117.0,571654.0,,,5356730.0,,483241.0,,5356730.0,,51652.0,24552857.0,55423640.0,34232.0,3305.0,,,,,,,24478.0,144487.0,92575.0,10046.0,,10292.0,2895.0,3749.0,3393.0,3742.0,,1486.0,,298.0,,,,576.0,263.0,311.0,296.0,,189.0,5459.0,34232.0,2905276.0,4539902.0,2905276.0,4539902.0,268.0,,343552.0,438377.0,42.0,,,,,,,,5369.0,476.0,,,,,,,,,,,,,,,,,,,,,,,,,,,,,21182.0,,,,3166.0,,2068.0,,,,688.0,,,,,,,,,,,,,,,,,,,,,,,,,,,,,,,,,,,,,,,,,,160203.0,,,,,2089528.0,329892.0,329892.0,98782.0,,,,,,,,,,,,,,,,,,,,,89403.0,,,,,,,289396.0,888873.0,,,33604.0,,,,,,,,,,514192.0,,403130.0,,,,21612.0,,,,,,,,,330689.0,,259262.0,,,,,,,,,,,137939.0,,497.0,,,,,,,,,,,70416.0,,264.0,,,,,,,,,,,,1060173.0,,,,,,,,,,,,,,,,,,,,15483041.0,-14798128.0,,,95.0,,,,116767.0,,,,,,,,,,,,,,,,,,,,,,,,,,,,,,,,,,,,,,,,,,,,,,,,,,,,,,,,,,,,,,,,,,,,,,3867362.0,24501866.0,,,,,,,,,,,,,,,,,,,,,,,,,,,,,,,,,33540.0,33707.0,,1237.0,10093.0,,,,180.0,65.0,,,,,,,,,,1.0,,,,1214730.0,,,,,,,,,,,,,,,,,,,,,,,,,,656688.0,,,,,,,,2993.0,,4490.0,1.0,,,,,,,,,,,,,,,,,,,,,,,,,,,,,,,,,,,,,,,,,,,,,,,,,,,,,-1646755.0,,,28449.0,,18296.0,,,,,,,,,,,,,,,,,,,,,,,,,,,,,,,,,,,,,,,,,,928646.0,,,,,,,,,,,,,,,,,,,,,,,,,,,,,,,,,,,,,,,,,,,,,,,,,,,,,,,,,,,,,,,,,,,,,,,,,,,,,,,,,,,,,,,,,,,,,,,,,,,,,12467.0,,,,,,,,,,,,,,,,,,,,,,,,,,,,,,,,,,,,,,,,,,,,,,,,,,,,,,,,,,,,,,,,,,,,,,,,,,,,,,,,,,,,,,,,,,,,,,,,,,,,,,,,,,,,,,,,,,,,,,,,,,,,,,,,,,,,,,,,,,,,,,,,,,,,,,,,,,,,,,,,,,,,,,,,,,,,,,,,,,,,,,,,,,,,,,,,,,,,,,,,,,,,,,,,,,,,,,,,,,,,,,,,,,,,,,,,,,,,,,,,,,,,,,,,,2014,,,,,,,,,,,,,,,,,,,,,,,,,,40.487472,-79.896038,Voluntary non-profit - Private,Acute Care Hospitals,UPMC ST MARGARET (390102)
33037,713813,390102,12001,4,2022-03-07 00:00:00,2015-07-01 00:00:00,2016-06-30,F,J,39,39010,2.0,3.0,6280,,,,,,,,,,,,,,,,,,,,,,,,,,,,,,,,,,,,,,,,,,,,,,,,,,,,,,,,,,,,,86026.0,,,,,,,,,,,,,,,,,,,4857834.0,14466659.0,,4896525.0,7647644885.0,0.000173278,,,,,,,,620804.0,6406145534.0,0.000167674,,,,,,,,,171661.0,,,,,,,,,,,,,,,,,,,,,,,,,,,,,,,,,,,,,,,,,,,,,,,,,,,,,,,,,,,,,,,,,,,,,,,,,,,,,,,,,,,,,,,,,,,,,,,,,,,,,,,,,,,,,,,,,,,,,,,,,,,,,,,,,,,,,,,,,,,,,,,,,,,,,,,,,,,,,,,,,,,,,,,,,,,,,,,,202804339.0,2540934.0,41144817.0,64336297.0,206269932.0,2595208.0,157498.0,,5060482.0,,,,,-240421.0,9468654.0,9522940.0,,,,,-42565129.0,61604312.0,14281588.0,164103331.0,3077568.0,126919.0,-42565129.0,-85173.0,183142514.0,17154858.0,371236.0,173663637.0,37150274.0,550908.0,11428816.0,1869147.0,13121.0,170300447.0,176526305.0,170480341.0,37150274.0,550908.0,573141356.0,573141356.0,108555603.0,769453.0,1266931653.0,37150274.0,37150274.0,7590866.0,11645687.0,20330761.0,727104.0,861811.0,1588915.0,18741846.0,91808515.0,91808515.0,25779089.0,285452.0,11645687.0,177787.0,67416.0,55597.0,15342.0,11360.0,542329.0,381923.0,638110.0,4234.0,67416.0,15342.0,,,,,,,,,,,,,,,,,,108555603.0,125597245.0,137800461.0,571238832.0,,,225707643.0,1240175224.0,,-423.0,1017236845.0,6255036.0,3485772.0,3485772.0,222938379.0,225707643.0,-2769264.0,131163.0,0.13442,7774052.0,405054.0,7150892.0,1179329.0,2785803.0,8023495.0,142788.0,142788.0,142084.0,11092703.0,1614676.0,1606474.0,1.0,1.0,1.0,1157.57,1193.45,2750.0,2750.0,10601.0,10601.0,206.0,220.0,246.0,206.0,74729.0,79853.0,74729.0,11360.0,12087.0,11360.0,46549.0,49927.0,46549.0,560151.0,75011630.0,3658390.0,,,,-11399812.0,2987840.0,,,,186135.0,,,,,,,693790297.0,693790297.0,,,,,,,,,,,,,,,,,,,,,,,,,,,,,,,,,,433438371.0,,668908376.0,668936392.0,661164.0,,117.0,117.0,,,,,,571.0,616.0,,571.0,,61604312.0,3322431.0,4562305.0,1783673.0,2139682.0,1823748.0,1157454.0,598017.0,,56471582.0,3322431.0,53149151.0,89033086.0,56471882.0,3506835.0,52965047.0,88848982.0,15846014.0,,68887923.0,68887923.0,7582845.0,,,,,,,,,,,,,,,,,,,,7434900.0,9009785.0,1891312.0,7127940.0,8858170.0,8399575.0,8393979.0,290835.0,189043.0,187172.0,8583022.0,8583069.0,6830421.0,74352.0,,7193062.0,6557853.0,6557853.0,6557853.0,,,,,,1960162.0,10601.0,12087.0,49927.0,1266931653.0,,,21255.0,,71313.0,2427732.0,2043201.0,61434937.0,3506835.0,20471.0,3817548.0,,1785394.0,59709.0,2177784.0,1560501.0,1150408.0,2433361.0,601307.0,1925469.0,2496144.0,24.61,2358708.8,2240106.15,23.94,23.64,32.95,,,,,2361496.0,1402338.0,349692.0,,,,,,,,40.98,97937.16,7222974.0,15342.0,58368.0,0.26285,1898559.0,,,23275727.0,23087347.0,7595690.0,7590094.0,30677441.0,0.752584,0.247416,5139664.0,3868029.0,39.86,1271635.0,63.15,39.86,15.56,13.78,15.29,14.88,14.88,138037.87,2054004.0,58368.0,22.54,14.23,5215262.0,5139664.0,58.46,36.9,1271635.0,1506635.0,62.36,64.48,,,,,,6045964.0,,,,11092703.0,193.2,5237692.0,13029345.0,10949915.0,1471888.0,1464390.0,126289302.0,16975808.0,5163387.0,,,9048.0,16066797.0,,,16066797.0,,,146635.5,26.03,16099936.0,16099936.0,709259.61,30.4,22.34,,,-361036.0,,,2014852.0,196381.0,25614.0,,,,,,,,,,,,,,,,,27234.0,160521.0,,,,115076.0,17253.0,,2290.0,,12845.0,12845.0,80475.0,80475.0,80475.0,67630.0,12845.0,3378.0,12203216.0,1046.0,4311.0,4851388.0,1133019.0,13799592.0,899167.0,,4851388.0,1133019.0,13799592.0,899167.0,,118602.65,138111.19,7528.0,310858.26,541.72,75372.31,163199.41,95543.93,37832.31,,31801.99,58045.04,29.57,35.13,150.51,44.39,37.79,23.69,13.34,16.33,30.41,,18.91,33.17,19783999.0,19783999.0,118602.65,456497.45,29.57,43.34,,,,,223701.0,27528.0,147945.0,1908284.0,2116440.0,27528.0,63222.0,17145.0,10555.0,24120.0,,195591.0,0.0361,0.0987,0.1348,,,223701.0,188380.0,33476202.0,2477048.0,103859.0,329749.0,214337.0,122923.0,31109632.0,31040183.0,,,5596.0,147945.0,,,1528768.0,0.0277,42347.0,7788.0,136.41,0.0361,0.0987,0.1348,1016187.0,136596.0,-1216924.0,68462.0,365.0,,24120.0,33139.0,20250.0,258443.0,230375.0,33139.0,20250.0,,258443.0,60700.0,,1863.0,73276.44,440.0,,138.72,33.21,137.95,2696603.6,,,-47.0,,,,,,,290.0,7498.0,704.0,8202.0,616.0,,12.0,1117.0,,,,,,,4851388.0,4851388.0,,1791415.0,,438022.0,,,-141248.0,2091252.0,4550755.0,249217.0,4550755.0,17041642.0,,,4550755.0,4550755.0,1754868.0,1190098.0,2944966.0,96088.0,70435.0,166523.0,2778443.0,,,,,6969575.0,6494732.0,32827.0,1190098.0,20446.0,8441.0,3255.0,96088.0,,,48120.0,487.0,,,,,,,,4188989.0,23.062842,4325616.0,4325616.0,4325616.0,44436.0,4281180.0,3864.0,4277316.0,2576.0,1674.0,2576.0,4278990.0,121900.0,4301305.0,4147433.0,,14727.0,22.67,22.16,24.32,23.05,23.05,137147.84,3161258.0,884529.0,188380.0,5596.0,35.92,22.67,13949.0,0.238984,1726175.0,91833.0,61.03,55.18,54.38,43.24,50.93,50.93,0.263613,0.270642,0.263613,2593018.0,7.18,2752774.0,34373639.0,38.57,3868029.0,53.85,,56.96,12.51,191249.0,,,260.0,8.0,668.0,26.0,9516.0,3255.0,119.0,8441.0,,297562.0,21471.1,13.86,,,,,,,,,,,,,,,,,,,,,,,,,,,,,,0.813,6044574.0,,17041642.0,,9582.0,,,,,,,,,,,,,,,,,,,,,,,,,,,,,,,,,,,,,,,,,,,,3934.0,,,,,,,,5494.66,,10.87,,,,,,,,,,,,,,,,,,,,,,,244317.0,,,,,,,,,,,,,,,,,1359263.0,280863.0,218566.0,,0.0191,,23.29,,-1.12,6.03,6.03,0.031211,0.008267,159756.0,,280863.0,,15.28,3670.0,35.88,4537.0,,3495.0,,,,,,,,,,,,,,,,,,,,,,,,,,,,,,,,21909.0,,,,,,2307.0,63069.0,8478.0,6171.0,517.0,17061137.0,460690.0,,,,,,16500.0,16500.0,45.2,365.04,,,,,,,,,,,,,,,,,,,,,,,,,,,,,,,68134.0,,,,,,,,,,,,,,,,,,,,,,,,,,,,,,,,,,,,,,,,,,,,,,,15483041.0,1244594.0,1244594.0,,16727635.0,,,,,,,,,,,,,,,,,,,,,,,,,,,,,,22.14,20.5,1.33,1.33,349279.0,175212.0,7150.0,516007.0,,,516007.0,,,,5289.0,,,97.56,,,16600447.0,,,,,,,,,,,,,,,,,,,,,,,,,,,,,,,,,,,,,,,,,,,,,,,421797.0,,,,,,,,,,,,,,,,,,,,,,,,,,,,,,,,,,,,,,,,,,,,,,,,,,,,,,,1480784.0,,,,,,,,,,,,,,,,,,,,,,,,,,,,915188.0,,,,-164611.0,,,,,311643.0,,185065.0,,,,,,,22315.0,1908284.0,1964671.0,,,,,,,,,,22315.0,,,,,2.12,,,,,,,,,,,,,,,,,,,,,,14727.0,,,,,,,,,,,,,,,,,,,,,,,,,,,,,,,,,,,,,,,,,,,,,,,208156.0,,56387.0,,,,,,,2007712.0,,,,,,,,,,,,,,,,,,,,,,,,,,,,,,,,,,,,,,,,,,,,,,,,,,,,,,,,,,,,,,,,,,,,,,,,,41783.0,41783.0,,,,,,,,,,,,,,,,,,,,,,,,,,,,,,,,,,,,,,,,,,,,,,,,,,,,,,,,,,,,,,,,,,,,,,,,,,,,,,,,,,,,,,,,,,,,,67846.0,,,,,,,,,,,,,,,,,,,,,,,,,,,,,,,,,,,,,,,,,,,,,,,,,,,,,,,,,,,,,,,,,,,,,,,,,,,,,,,,,,,,,,,,,,,,,,,,,,,,,,,,,,,,,,,,,,,,,,,,,,,,,,,,,,1335075.0,1415000.0,,,,,,,,,,,,,,,,,,,,,,,,,,,,,,,,,,,,,,,,,,,,,,,,,,,,,,,,,,,,,,,,,,,,,,,,,,,,,,,,,,,,,,,,,,,,,,623160.0,,,,,,,,,,,,,,,,,,,,,,,,,,,,,,,,,,,,,,,,,815 FREEPORT ROAD,PITTSBURGH,15215,ALLEGHENY,UPMC ST MARGARET,38300,P,2,N,N,N,Y,Y,N,,N,N,,,N,N,N,N,Y,Y,Y,,,HO0164,UNIVERSITY OF PITTSBURGH MEDICAL CEN,200 LOTHROP STREET,PITTSBURGH,PA,15213-2582,,Y,,,N,N,,,,UPMC ST MARGARET REHABILITATION UNIT,39T102,,,,,,,,,,,,,,,,,,,,,,,,,,,,,,,,,,,,,,,,,,,,,,,,,,,,,,,,,,,,,,,,,,,,,,,,,,,,,,,,,,,,,,,,,,,,,,,,,,,,,,,,,,,,,,,,,,,,,,,,,,,,,,,,,,,,,,,,,,,,,,,,,,,,,,,,,,,,,,,,,,,,,,,,,,-240421.0,,4647797.0,4820857.0,4769808.0,4753132.0,-34104338.0,2427732.0,598017.0,2043201.0,4562305.0,1353131.0,,,1458338.0,2139682.0,,1955753.0,13752567.0,226436.0,411648.0,,95720.0,72774586.0,20999473.0,,6450960.0,1416009.0,799739.0,4456845.0,1579505.0,672301.0,1983005.0,1480276.0,,779676.0,5116702.0,13191.0,,,691830.0,-13097.0,638.0,-140929.0,-32069598.0,4647797.0,2641394.0,3157280.0,828381.0,2096965.0,4820857.0,13269618.0,23303231.0,11252779.0,,1561498.0,3637570.0,1417722.0,1374979.0,975369.0,8721766.0,1659607.0,,2037727.0,2025032.0,1071955.0,,2104207.0,6869918.0,125473.0,3601670.0,13558364.0,12954310.0,2869614.0,1914791.0,5110671.0,19251663.0,,2648052.0,7354703.0,2759363.0,2339085.0,1737457.0,12908996.0,1979887.0,,3225176.0,2574441.0,1497876.0,,3676014.0,213857.0,4245191.0,15992580.0,21992261.0,2891671.0,10244171.0,2083895.0,,297588.0,1298649.0,532759.0,167036.0,163958.0,613932.0,12203.0,,260100.0,58826.0,83105.0,,407119.0,17798.0,19246.0,73072.0,218517.0,309891.0,1240851.0,19251663.0,,2662202.0,7387689.0,2759363.0,2342748.0,1737457.0,12968733.0,1979887.0,,3225176.0,2574441.0,1497876.0,,3676014.0,213857.0,4245191.0,15992580.0,21992261.0,2894368.0,10281800.0,93512016.0,,25040985.0,17741063.0,2148795.0,24050251.0,8860314.0,47743317.0,4288003.0,,9215542.0,6803254.0,9991075.0,,10973339.0,229610.0,12001117.0,65914808.0,67957570.0,18938.0,24515277.0,17141758.0,,4658747.0,4384554.0,388743.0,6055043.0,2280984.0,11080274.0,934816.0,,2041226.0,985567.0,1059228.0,,3018292.0,77438.0,2431991.0,12040014.0,15207539.0,7780.0,6848042.0,1735432.0,,147297.0,600119.0,39557.0,149493.0,66906.0,998114.0,270268.0,,363371.0,339265.0,150050.0,,293230.0,27225.0,463333.0,2214435.0,2538807.0,2210.0,977579.0,187857.0,,20586.0,108912.0,7638.0,10657.0,6314.0,40077.0,1666.0,,29304.0,7752.0,8326.0,,32584.0,2266.0,2101.0,10114.0,25229.0,269.0,117978.0,17141758.0,,4658747.0,4384554.0,388743.0,6055043.0,2280984.0,11080274.0,934816.0,,2041226.0,985567.0,1059228.0,,3018292.0,77438.0,2431991.0,12040014.0,15207539.0,7780.0,6848042.0,374359.0,39263.0,39781212.0,2540934.0,-1691267.0,41302314.0,,-26401106.0,57778444.0,-45225733.0,57756861.0,22707811.0,22707811.0,120245884.0,1677416.0,,71684994.0,843716.0,3261541.0,14530338.0,3483291.0,94369950.0,116762593.0,-51106675.0,120245884.0,989920.0,,,,,1823748.0,1157454.0,,4964.0,1783673.0,1123876.0,687139.0,,1067480.0,750363.0,1004797.0,,-662210.0,,-249697.0,495020.0,1307151.0,,1327578.0,810072.0,,3363190.0,,145669.0,13464902.0,560151.0,78670020.0,-51469296.0,,,,221750.0,221750.0,,813382.0,2877909.0,,,1536519.0,,807932.0,2877909.0,,,,,,9477979.0,,9477979.0,,1582292.0,,,,645736.0,21255.0,2761723.0,,4198141.0,71313.0,-32178.0,,,-15192.0,,,1900085.0,1900085.0,452544.0,,,,4652443.0,5373986.0,516903.0,306956.0,4653019.0,,,-530396.0,,,,,,,,,,96646948.0,,40793389.0,90713797.0,10281437.0,63776418.0,7534565.0,7534565.0,762799.0,7193062.0,-6164586.0,,,,430133.0,222987.0,42027.0,-407931.0,,-70240.0,,8901762.0,30292327.0,4664645.0,7078577.0,751032.0,2987810.0,4664645.0,7078577.0,751032.0,2987810.0,603310.0,688212.0,133696.0,261094.0,,,16294.0,9320.0,,,-176630.0,,,,,,102116.0,58405.0,,2000803.0,738550.0,-1704368.0,162253.0,-547.0,2560373.0,5084217.0,298844.0,5084217.0,12203216.0,675518.0,,2374648.0,3378.0,727.0,64318.0,,,,,12203216.0,,14.0,5124.0,727.0,3378.0,,,,,473458.0,,623117.0,453064.0,636674.0,,112762.0,4133847.0,,,,,1031627.0,,1182729.0,,-135333.0,-3032.0,,3792.0,,1460077.0,,,,305170.0,,,,,749725.0,,,,,127667.0,,,,778757.0,,,,3429747.0,,44710746.0,,70841006.0,50373524.0,4417087.0,,378672.0,21037576.0,47510032.0,,,,,851288.0,,,84486.0,,,,,,,,,13850.0,,,851288.0,,,,4074874.0,,7548889.0,4297406.0,740333.0,,23764.0,19913.0,984954.0,2077798.0,4426271.0,,,,,4074874.0,,7548889.0,4297406.0,740333.0,,23764.0,19913.0,984954.0,2077798.0,4426271.0,,,,63222.0,,,194508.0,,186080.0,126052.0,70735.0,,8180.0,7001.0,187649.0,382155.0,629549.0,,,,10555.0,,,,,,,,,,,,,45.0,,,,,,,,582692.0,,,,,,,,,,,-5366336.0,,,,,,,,,,,,,,,,,-69449.0,28016.0,,,,8350065.0,-160694.0,2315459.0,,,,,,,,,,,,,,,,,,,,,,,,,,,,,,,23512.0,,2146.0,189816.0,,710216.0,203154.0,1082865.0,2358521.0,,122021.0,57997.0,19451.0,1535751.0,,2380.0,,68.0,26486.0,,63116.0,36165.0,372758.0,334108.0,,17997.0,11049.0,3577.0,256384.0,,,,,,,,,,,,,,,,,258.0,,9.0,4841.0,,2373.0,2916.0,8518.0,18538.0,,2436.0,50.0,16.0,2548.0,,21530.0,21530.0,3050.0,,,,,,,,,,,,,,,,,,,,,,,,,,,,,,,834377.0,,764415.0,1238557.0,168915.0,,4132752.0,-2095001.0,,,-150540.0,,,,3157186.0,174735.0,593179.0,,,4682124.0,,516914.0,,4682124.0,,44589.0,24968450.0,50484452.0,10326.0,957.0,,,,,,,111707.0,223368.0,154741.0,6639.0,,86397.0,11367.0,5515.0,4539.0,2334.0,,12333.0,,106.0,,,,2195.0,393.0,428.0,194.0,,1488.0,62297.0,10326.0,3993391.0,4766149.0,3993391.0,4766149.0,,,406355.0,441641.0,,,,,,,,,362.0,32.0,,,,,,,,,,,,,,,,,,,,,,,,,,,,,10749.0,,,,6142.0,,1088.0,,,,1170.0,,,,,,,,,,,,,,,,,,,,,,,,,,,,,,,,,,,,,,,,,,94673.0,,,,,2560114.0,490410.0,490410.0,141784.0,,,,,-82000.0,,,,,,,,,,,,,,,,81344.0,,,,,,,294248.0,998894.0,,,84106.0,,,,,,,,,,526913.0,,246458.0,,,,49945.0,,,,,,,,,312899.0,,146356.0,,,,,,,,,,,220296.0,,3239.0,,,,,,,,,,,137298.0,,2094.0,,,,,,,,,,,,1908284.0,,,,,,,,,,,,,,,,,,,,16727635.0,-16063711.0,,,94.0,,,,116767.0,,,,,,,,,,,,,,,,,,,,,,,,,,,,,,,,,,,,,,,,,,,,,,,,,,,,,,,,,,,,,,,,,,,,,,3643372.0,22275876.0,,,,,,,,,,,,,,,,,,,,,,,,,,,,,,,,,23860.0,24586.0,,2368.0,7108.0,,,,388.0,44.0,,,,,,,,,,,,,,1061327.0,,,,,,,,,,,,,,,,,,,,,,,,,,1159637.0,1838253.0,,,,,,,,,34056.0,68.0,,,,,,,,,,,,,,,,,,,,,,,,,,,,,,,,,,,,,,,,,,,,,,,,,,,,,-17988.0,,,33325.0,,19790.0,,,,,,,,,,,,,,,,,,,,,,,,,,,,,,,,,,,,,,,,,,691675.0,,,,,,,,,,,,,,,,,,,,,,,,,,,,,,,,,,,,,,,,,,,,,,,,,,,,,,,,,,,,,,,,,,,,,,,,,,,,,,,,,,,,,,,,,,,,,,,,,,,,,22247.0,,,,,,,,,,,,,,,,,,,,,,,,,,,,,,,,,,,,,,,,,,,,,,,,,,,,,,,,,,,,,,,,,,,,,,,,,,,,,,,,,,,,,,,,,,,,,,,,,,,,,,,,,,,,,,,,,,,,,,,,,,,,,,,,,,,,,,,,,,,,,,,,,,,,,,,,,,,,,,,,,,,,,,,,,,,,,,,,,,,,,,,,,,,,,,,,,,,,,,,,,,,,,,,,,,,,,,,,,,,,,,,,,,,,,,,,,,,,,,,,,,,,,,,,,2015,PA,,N,N,30945026.0,,,37604.0,,-107053.0,,27169383.0,1770152.0,3175.0,33664582.0,,,22272858.0,,,28942710.0,28873261.0,288733.0,28584528.0,336645.82,40.487472,-79.896038,Voluntary non-profit - Private,Acute Care Hospitals,UPMC ST MARGARET (390102)
39139,713814,390102,12001,4,2022-03-09 00:00:00,2016-07-01 00:00:00,2017-06-30,F,L,39,39010,2.0,3.0,6280,,,,,,,,,,,,,,,,,,,,,,,,,,,,,,,,,,,,,,,,,,,,,,,,,,,,,,,,,,,,,83635.0,,,,,,,,,,,,,,,,,,,5560395.0,17486610.0,,5732586.0,,,,,,,,,,724862.0,,,,,,,,,,,186979.0,,,,,,,,,,,,,,,,,,,,,,,,,,,,,,,,,,,,,,,,,,,,,,,,,,,,,,,,,,,,,,,,,,,,,,,,,,,,,,,,,,,,,,,,,,,,,,,,,,,,,,,,,,,,,,,,,10158748.0,2544752.0,2865241.0,647352.0,,,,,,,,,,10158748.0,2544752.0,,,2865241.0,647352.0,,,33.94,41.88,,,,,,,,,,,,,,,,,,,,,,,,,,,,,,,,,,,,,,,,,198841693.0,2540934.0,41302314.0,57778444.0,204772560.0,15325592.0,3559678.0,10472853.0,22556714.0,,,,,-158173.0,9452350.0,9311797.0,,,,,-55358529.0,63694358.0,15134665.0,182914872.0,3313270.0,167280.0,-55358529.0,-60481.0,191250701.0,18207920.0,439962.0,182633000.0,40284392.0,675936.0,11307495.0,1987073.0,9424.0,179479096.0,186311816.0,179724346.0,40293535.0,675936.0,610219712.0,610219712.0,115775421.0,874938.0,1350362879.0,40293535.0,40293535.0,9342411.0,14059363.0,24589428.0,703568.0,863762.0,1567330.0,23022098.0,113514702.0,113514702.0,31217113.0,391870.0,14059363.0,233071.0,68584.0,56836.0,17243.0,13178.0,631218.0,460703.0,734912.0,3249.0,68584.0,17243.0,,,,,,,,,,,,,,,,,,115775421.0,133637531.0,146561430.0,610986297.0,,,246609230.0,1321397197.0,,272.0,1093304158.0,6296079.0,-12220112.0,-12220112.0,228093039.0,246609230.0,-18516191.0,24918.0,0.132912,9865786.0,410303.0,9234550.0,1448316.0,3144290.0,9008004.0,142285.0,142285.0,142199.0,11903990.0,1705557.0,1695974.0,1.0,1.0,1.0,1146.49,1181.44,3069.0,3069.0,10967.0,10967.0,202.0,216.0,243.0,202.0,73773.0,78883.0,73773.0,13178.0,14028.0,13178.0,47544.0,50975.0,47544.0,560151.0,78670020.0,7772909.0,,,,-11790374.0,-5848406.0,,,,298726.0,,,,,,,740143167.0,740143167.0,,,,,,,,,,,,,,,,,,,,,,,,,,,,,,,,,,464424867.0,,710394040.0,710410900.0,750214.0,,122.0,122.0,,,,,,605.0,713.0,,605.0,,63694358.0,3395762.0,3464269.0,2020333.0,2275374.0,1905537.0,1279568.0,610527.0,,58714016.0,3395762.0,55318254.0,95260306.0,57807219.0,3180073.0,54627146.0,94569198.0,15810692.0,,80721420.0,80721420.0,8788218.0,,,,,,,,,,,,,,,,,,,,8685334.0,9870059.0,2004123.0,7870558.0,9758463.0,9162623.0,9158023.0,293792.0,190965.0,183220.0,9348988.0,9348965.0,7606166.0,75384.0,,7193062.0,355208.0,110082.0,355208.0,,,,,,1855145.0,10967.0,14028.0,50975.0,1350362879.0,,,,,,2439367.0,2090440.0,62632367.0,3180073.0,,3533470.0,,2025368.0,,2297799.0,1569123.0,1302778.0,2387355.0,611396.0,1704416.0,2464142.86,25.42,2330298.46,2213542.8,24.81,24.68,34.76,,,,,2659230.0,1630740.0,346905.0,,,,,,,,40.98,100179.92,7322643.0,17243.0,59292.0,0.290815,2129534.0,,,27832258.0,27625564.0,8800940.0,8796340.0,36421904.0,0.758488,0.241512,5349898.0,4057833.0,39.65,1292065.0,61.77,39.65,15.29,15.56,13.78,14.88,14.88,141198.93,2101040.0,59292.0,21.75,13.96,5265949.0,5349898.0,57.34,36.81,1292065.0,1480436.0,62.09,63.07,,,,,,6587470.0,,,,11903990.0,190.47,5863714.0,15173374.0,11761705.0,1563272.0,1553775.0,149029975.0,19807872.0,5755572.0,,,9292.0,17432692.0,,,17432692.0,,,100663.41,35.1,20999021.0,20999021.0,665649.0,38.44,23.75,,,-536705.0,,,1990057.0,319940.0,76666.0,,,,,,,,,,,,,,,,,19849.0,222060.0,,,,261535.0,40502.0,,4762.0,,12722.0,12722.0,88974.0,88974.0,88974.0,76252.0,12722.0,8100.0,12923899.0,1307.0,4869.0,5182660.0,1056871.0,,986534.0,,5182660.0,1056871.0,,986534.0,,116755.66,140183.74,6680.0,,,82351.03,167117.64,95616.53,39766.76,,31894.93,52571.98,27.24,36.97,158.21,,,24.59,13.75,16.41,32.76,,19.17,32.42,18943031.0,18943031.0,116755.66,506953.72,27.24,37.37,,,,,128850.0,106173.0,102884.0,1049800.0,1178392.0,106173.0,48472.0,63148.0,7960.0,23914.0,,298338.0,0.0383,0.1095,0.1478,,,128850.0,206694.0,39242267.0,2765840.0,148771.0,327219.0,212692.0,108045.0,36540348.0,36243099.0,,,4600.0,102884.0,,,1839065.0,0.0304,55908.0,12539.0,139.66,0.0383,0.1095,0.1478,1266040.0,168272.0,-1121074.0,71208.0,446.0,,23914.0,53736.0,,382940.0,155194.0,53736.0,,,382940.0,,,2560.0,71347.12,,,149.59,33.46,,2720496.52,751274.0,,23.0,,,,,,,276.0,9497.0,86.0,9583.0,713.0,,2.0,1242.0,,,,,,,5182660.0,5182660.0,,1970788.0,,441613.0,,,-147339.0,2234389.0,5004249.0,261592.0,5004249.0,17862110.0,,,5004249.0,5004249.0,1934433.0,1308397.0,3242830.0,131847.0,60150.0,191997.0,3050833.0,,,,,7429284.0,6832598.0,49847.0,1308397.0,29647.0,8317.0,3215.0,101112.0,,,46406.0,413.0,,,,,,,,4039630.0,22.786301,4169326.0,4169326.0,4169326.0,28588.0,4140738.0,10136.0,4130602.0,10225.0,6646.0,6489.0,4137248.0,90488.0,4181727.0,4053367.0,,39208.0,22.85,22.67,22.16,22.56,22.56,140288.53,3164909.0,1136473.0,206694.0,4600.0,35.59,22.85,13195.0,0.222543,1629603.0,81317.0,60.79,56.11,55.18,54.38,55.22,55.22,0.289914,0.285818,0.285818,3334717.0,6.01,3527298.0,37456136.0,38.57,4057833.0,54.78,,61.23,13.17,242205.0,,,226.0,8.0,588.0,27.0,9674.0,3215.0,107.0,8317.0,,356987.0,24226.4,14.74,,,,,,,,,,,,,,,,,,,,,,,,,,,,,,0.813,7061177.0,,17862110.0,,,,,,,,,,,,,,,,,,,,,,,,,,,,,,,,,,,,,,,,,,,,,,4421.0,,,,,,,,,,,,,,,,,,,,,,,,,,,,,,,,,272682.0,,,,,,,,,,,,,,,,,823799.0,204197.0,159454.0,,0.0127,,22.12,,-1.33,6.03,6.01,0.031554,0.008356,192581.0,,173462.0,,16.21,8712.0,34.95,4741.0,,3449.0,,,,,,,,,,,,,,,,,,,,,,,,,,,,,,,,29048.0,,,,,,19456.0,229729.0,30534.0,11078.0,387.0,18515399.0,488904.0,,,,,,22000.0,22000.0,93.2,236.05,,,,,,,,,,,,,,,,,,,,,,,,,,,,,,,97064.0,,,,,,,,,,,,,,,,,,,,,,,,,,,,,,,,,,,,,,,,,,,,,,,16727635.0,,,245126.0,16482509.0,,,,,,,,,,,,,,,,,,,,,,,,,,,,,,22.14,20.53,1.33,1.33,331815.0,,12243.0,523041.0,,,523041.0,,,,3441.0,,,152.0,,,17432692.0,,,,,,,,,,,,,,,,,,,,,,,,,,,,,,,,,,,,,,,,,,,,,,,413897.0,,,,,,,,,,,,,,,,,,,,,,,,,,,,,,,,,,,,,,,,,,,,,,,,,,,,,,,1399474.0,,,,,,,,,,,,,,,,,,,,,,,,,,,,870972.0,,,,-853055.0,,,,,163619.0,,100337.0,,,30735.0,,,,13744.0,1049800.0,1065950.0,,,,,,,,,,44479.0,,,,,0.98,,,,,,,,,,,,,,,,,,,,,,39208.0,,,,,,,,,,,,,,,,,,,,,,,,,,,,,,,,,,,,,,,,,,,,,,,128592.0,,16150.0,,,,,,,2056694.0,,,,,,,,,,,,,,,,,,,,,,,,,,,,,,,,,,,,,,,,,,,,,,,,,,,,,,,,,,,,,,,,,,,,,,,,,42437.0,42437.0,,,,,,,,,,,,,,,,,,,,,,,,,,,,,,,,,,,,,,,,,,,,,,,,,,,,,,,,,,,,,,,,,,,,,,,,,,,,,,,,,,,,,,,,,,,,,44725.0,,,,,,,,,,,,,,,,,,,,,,,,,,,,,,,,,,,,,,,,,,,,,,,,,,,,,,,,,,,,,,,,,,,,,,,,,,,,,,,,,,,,,,,,,,593803.0,,,,,,,,,,,,,,,,,,,,,,,,,,,,,,,,,,,,,,,,1376585.0,725000.0,,,,,,,,,,,,,,,,,,,,,,,,,,,,,,,,,,,,,,,,,,,,,,,,,,,,,,,,,,,,,,,,,,,,,,,,,,,,,,,,,,,,,,,,,,,,,,631236.0,,,,,,,,,,,,,,,,,,,,,,,,,,,,,,,,,,,,,,,,,815 FREEPORT ROAD,PITTSBURGH,15215,ALLEGHENY,UPMC ST MARGARET,38300,P,2,N,N,N,Y,Y,N,,N,N,,,N,N,N,N,Y,Y,Y,,,HO0164,UNIVERSITY OF PITTSBURGH MEDICAL CEN,200 LOTHROP STREET,PITTSBURGH,PA,15213-2582,,Y,,,N,N,,,,UPMC ST MARGARET REHABILITATION UNIT,39T102,,,,,,,,,,,,,,,,,,,,,,,,,,,,,,,,,,,,,,,,,,,,,,,,,,,,,,,,,,,,,,,,,,,,,,,,,,,,,,,,,,,,,,,,,,,,,,,,,,,,,,,,,,,,,,,,,,,,,,,,,,,,,,,,,,,,,,,,,,,,,,,,,,,,,,,,,,,,,,,,,,,,,,,,,,-158173.0,,4862652.0,4589698.0,4833475.0,4478322.0,-37705260.0,2439367.0,610527.0,2090440.0,3464269.0,1428182.0,,,1506766.0,2275374.0,,1882851.0,14257687.0,280949.0,382083.0,,64752.0,85148124.0,21787256.0,,6458954.0,1670064.0,680166.0,4145244.0,1445217.0,726132.0,2156922.0,1600215.0,,689300.0,6113209.0,14113.0,,,875658.0,-500.0,-792.0,-86877.0,-42162751.0,4862652.0,2555540.0,3155944.0,891510.0,1918743.0,4589698.0,16255701.0,24859757.0,11168746.0,,1529582.0,3698989.0,1391756.0,1367038.0,1006786.0,8180448.0,1526102.0,,2158141.0,2196622.0,1175473.0,,2071036.0,8109005.0,132144.0,4404753.0,13870945.0,14198332.0,3173457.0,2056505.0,5570076.0,19714194.0,,2652113.0,7542770.0,2824096.0,2470970.0,1884708.0,12766336.0,1838649.0,,3429026.0,2802189.0,1657457.0,,3714509.0,226433.0,5231670.0,16400527.0,22974987.0,3157869.0,11446606.0,2108010.0,,302190.0,1146242.0,483661.0,154659.0,150980.0,603483.0,11804.0,,271628.0,61737.0,85592.0,,398830.0,17665.0,35527.0,71888.0,222227.0,320025.0,1251247.0,19714194.0,,2692188.0,7559115.0,2856227.0,2474633.0,1884708.0,12826074.0,1838649.0,,3443521.0,2802189.0,1657457.0,,3714509.0,226433.0,5231670.0,16400527.0,22974987.0,3163025.0,11498452.0,101501037.0,,27350759.0,18944987.0,2486828.0,25701243.0,8471622.0,56857308.0,4182153.0,,9722373.0,7220552.0,10598780.0,,12533880.0,239495.0,12778483.0,62530073.0,70666088.0,26228.0,27415765.0,23179282.0,,6118852.0,5448249.0,510051.0,7434872.0,2515613.0,15079892.0,1052582.0,,2418729.0,1163064.0,1362631.0,,3825659.0,84725.0,3444515.0,13061804.0,16949718.0,10367.0,8408560.0,2268858.0,,187423.0,727550.0,48669.0,174690.0,77224.0,1227446.0,289732.0,,434404.0,412760.0,199995.0,,347365.0,26736.0,774296.0,2610206.0,2783584.0,4071.0,1113377.0,242594.0,,26549.0,113337.0,8241.0,10914.0,6186.0,55253.0,1860.0,,34266.0,9094.0,10327.0,,37498.0,2086.0,5260.0,11442.0,26916.0,395.0,121159.0,23179282.0,,6118852.0,5448249.0,510051.0,7434872.0,2515613.0,15079892.0,1052582.0,,2418729.0,1163064.0,1362631.0,,3825659.0,84725.0,3444515.0,13061804.0,16949718.0,10367.0,8408560.0,476131.0,29258.0,12821583.0,2540934.0,-1849440.0,44861992.0,,-28043649.0,68141215.0,-55891234.0,64304544.0,24894773.0,24894773.0,102020900.0,2117646.0,,81363248.0,2072179.0,5152807.0,-13256885.0,5186943.0,72243693.0,96833957.0,-60227868.0,102020900.0,1225085.0,,,,,1905537.0,1279568.0,,,2020333.0,1258812.0,5340180.0,,910969.0,763233.0,1078604.0,,-751522.0,,-273255.0,491711.0,1577842.0,,1196843.0,763233.0,,3153904.0,,152490.0,14205739.0,560151.0,86442929.0,-54508028.0,,,,34136.0,34136.0,,660744.0,3206936.0,,,3941754.0,,654889.0,3206936.0,,,,,,12673006.0,,12673006.0,,2081237.0,,,,645736.0,,2373172.0,,3992433.0,,-29572.0,,,-10188.0,,,1901045.0,1901045.0,459734.0,,,,4608347.0,5341867.0,489483.0,300169.0,5475281.0,,,-5065116.0,,,,,,,,,,99905489.0,,41738504.0,101238080.0,10494977.0,69232271.0,7795454.0,7795454.0,763042.0,7944336.0,-6360144.0,,,,358757.0,205554.0,39700.0,-424064.0,,-71470.0,,9450911.0,31139469.0,5221154.0,9489518.0,1013430.0,3595376.0,5221154.0,9489518.0,1013430.0,3595376.0,664016.0,764846.0,181246.0,294700.0,,,48082.0,28584.0,,,-151590.0,,,,,,139268.0,82792.0,,1923094.0,640900.0,-1523511.0,155471.0,-14495.0,2452541.0,4785926.0,280128.0,4793945.0,12923899.0,675374.0,,3135890.0,3431.0,850.0,69403.0,,,,,12923899.0,,14.0,5110.0,850.0,3431.0,,,,,472486.0,,657971.0,514674.0,777521.0,,116380.0,4543010.0,,,,,1144440.0,,1198381.0,,-32163.0,-2677.0,,29304.0,,774961.0,,,,425343.0,,,,,840842.0,,,,,60291.0,,,,845481.0,,,,3442622.0,,44608539.0,,79622317.0,52923273.0,4349345.0,,478051.0,19540228.0,59424137.0,,,,,1035116.0,,,112317.0,,,,,,,,,8010.0,,,1035116.0,,,,4249338.0,,8809475.0,5097114.0,770587.0,,50050.0,27610.0,1102699.0,1688619.0,5643302.0,,,,,4249338.0,,8809475.0,5097114.0,770587.0,,50050.0,27610.0,1102699.0,1688619.0,5643302.0,80.0,,,48472.0,,,205310.0,,206679.0,156471.0,83155.0,,17762.0,8713.0,247877.0,337445.0,743861.0,13.0,,,7960.0,,,,,,,,,,,,,108.0,,,,,,,,694057.0,,,,,,,,,,,-5393257.0,,,,,,,,,,,,,,,,,227853.0,16860.0,,,,8236510.0,-98019.0,2297797.0,,,,,,,,,,,,,,,,,,,,,,,,,,,,,,,57912.0,,21939.0,168086.0,,864883.0,183568.0,1174156.0,2406576.0,,124444.0,60595.0,32176.0,1830887.0,,5669.0,,672.0,22837.0,,70428.0,32969.0,416696.0,353216.0,,20857.0,13621.0,6430.0,300679.0,,,,,,,,,,,,,,,,,606.0,,95.0,3580.0,,3152.0,2601.0,9181.0,18239.0,,2921.0,93.0,28.0,2907.0,,44659.0,44659.0,6555.0,,,,,,,,,,,,,,,,,,,,,,,,,,,,,,,707355.0,,739877.0,1635427.0,152234.0,,3717842.0,-2277738.0,,,-32395.0,,-2562.0,,3317209.0,179964.0,523928.0,,,5152642.0,,512197.0,,5152642.0,,52293.0,27446462.0,48414382.0,,,,,,,,,88289.0,212107.0,61986.0,5559.0,,25405.0,8425.0,4984.0,1903.0,1754.0,,3364.0,,,,,,1427.0,311.0,152.0,137.0,,366.0,14008.0,,4987808.0,4611349.0,4987808.0,4611349.0,,,470580.0,490246.0,,,,,,,,,,,,,,,,,,,,,,,,,,,,,,,,,,,,,,,34182.0,,,,6240.0,,3346.0,,,,1403.0,,,,,,,,,,,,,,,,,,,,,,,,,,,,,,,,,,,,,,,,,,317246.0,,,,,2497575.0,533883.0,533883.0,146956.0,,,,,,,,,,,,,,,,,,,,,78599.0,,,,,,,293465.0,854364.0,,,77908.0,,,,,,,,,,540173.0,,235034.0,,,,47776.0,,,,,,,,,331255.0,,144132.0,,,,,,,,,,,127191.0,,1564.0,,,,,,,,,,,95098.0,,1050.0,,,,,,,,,,,,1049800.0,,,,,,,,,,,,,,,,,,,,16482509.0,-16017027.0,,,68.0,,,,4555743.0,,,,,,,,,,,,,,,,,,,,,,,,,,,,,,,,,,,,,,,,,,,,,,,,,,,,,,,,,,,,,,,,,,,,,,3688745.0,20034521.0,,,,,,,,,,,,,,,,,,,,,,,,,,,,,,,,,15044.0,45825.0,,1632.0,12614.0,,,,116.0,81.0,,,,,,,,,,,,,,1312149.0,,,,,,,,,,,,,,,,,,,,,,,,,,699803.0,525297.0,,,,,,,,,16150.0,5.0,,,,,,,,,,,,,,,,,,,,,,,,,,,,,,,,,,,,,,,,,,,,,,,,,,,,,-912424.0,,,28591.0,,17533.0,,,,,,,,,,,,,,,,,,,,,,,,,,,,,,,,,,,,,,,,,,717619.0,,,,,,,,,,,,,,,,,,,,,,,,,,,,,,,,,,,,,,,,,,,,,,,,,,,,,,,,,,,,,,,,,,,,,,,,,,,,,,,,,,,,,,,,,,,,,,,,,,,,,13739.0,,,,,,,,,,,,,,,,,,,,,,,,,,,,,,,,,,,,,,,,,,,,,,,,,,,,,,,,,,,,,,,,,,,,,,,,,,,,,,,,,,,,,,,,,,,,,,,,,,,,,,,,,,,,,,,,,,,,,,,,,,,,,,,,,,,,,,,,,,,,,,,,,,,,,,,,,,,,,,,,,,,,,,,,,,,,,,,,,,,,,,,,,,,,,,,,,,,,,,,,,,,,,,,,,,,,,,,,,,,,,,,,,,,,,,,,,,,,,,,,,,,,,,,,,2016,PA,,N,Y,36907997.0,,,-10461.0,,-24237.0,,32605227.0,2149717.0,2057.0,39448961.0,,,26872641.0,,262551.0,34757001.0,34722303.0,347223.0,34375080.0,394489.61,40.487472,-79.896038,Voluntary non-profit - Private,Acute Care Hospitals,UPMC ST MARGARET (390102)
45707,722454,390102,12001,4,2022-08-03 00:00:00,2017-07-01 00:00:00,2018-06-30,F,M,39,39010,2.0,3.0,6280,,,,,,,,,,,,,,,,,,,,,,,,,,,,,,,,,,,,,,,,,,,,,,,,,,,,,,,,,,,,,80727.0,,,,,,,,,,,,,,,,,,,4834468.0,15403747.0,,5851902.0,,,,,,,,,,669407.0,,,,,,,,,,,203938.0,,,,,,,,,,,,,,,,,,,,,,,,,,,,,,,,,,,,,,,,,,,,,,,,,,,,,,,,,,,,,,,,,,,,,,,,,,,,,,,,,,,,,,,,,,,,,,,,,,,,,,,,,,,,,,,,,10032170.0,3279253.0,2642063.0,702183.0,,,,,,,,,,10032170.0,3279253.0,,,2642063.0,702183.0,,,36.08,41.87,,,,,,,,,,,,,,,,,,,,,,,,,,,,,,,,,,,,,,,,,213812077.0,2540934.0,44861992.0,68141215.0,226974066.0,3741474.0,130266.0,3165181.0,23099892.0,,,,,-117543.0,8949461.0,8767631.0,,,,,-56345954.0,64426215.0,14486870.0,182453726.0,3234316.0,137908.0,-56345954.0,-123989.0,190533987.0,17438353.0,383670.0,181900114.0,38935492.0,592939.0,10431176.0,1958974.0,9017.0,178203734.0,185049720.0,178370463.0,38949307.0,592939.0,604457702.0,604457702.0,105064227.0,806543.0,1376407796.0,38949307.0,38949307.0,8110414.0,12384150.0,21570993.0,739413.0,679298.0,1418711.0,20152282.0,102154533.0,102154533.0,25224915.0,273428.0,12384150.0,172027.0,60771.0,49532.0,13930.0,10314.0,562140.0,407919.0,543594.0,2616.0,60771.0,13930.0,,,,,,,,,,,,,,,,,,105064227.0,123210053.0,136198447.0,605161838.0,,,246879802.0,1346889158.0,,63.0,1118099204.0,7044141.0,-11045707.0,-11045707.0,228789954.0,246879802.0,-18089848.0,21792.0,0.12947,8868380.0,297807.0,8410216.0,1249228.0,2726637.0,8006889.0,145047.0,145047.0,144959.0,10511371.0,1487175.0,1477409.0,1.0,1.0,1.0,1134.4,1170.83,2721.0,2721.0,10308.0,10308.0,208.0,222.0,250.0,208.0,71929.0,77039.0,71929.0,10314.0,11008.0,10314.0,41038.0,44293.0,41038.0,560151.0,86442929.0,19804445.0,,,,-11965460.0,-7721653.0,,,,299373.0,,,,,,,771950094.0,771950094.0,,,,,,,,,,,,,,,,,,,,,,,,,,,,,,,,,,468963391.0,,741714783.0,741727320.0,751444.0,,111.0,111.0,,,,,,489.0,555.0,,489.0,,64426215.0,3980046.0,3718762.0,1963400.0,2400001.0,1903660.0,1262416.0,602160.0,,59122127.0,3980046.0,55142081.0,95302885.0,58794828.0,3677809.0,55117019.0,95277823.0,15820408.0,,87787073.0,87787073.0,9272045.0,,,,,,,,,,,,,,,,,,,,9135443.0,10637482.0,2100945.0,8551362.0,10492555.0,10080249.0,10064750.0,202612.0,131698.0,97087.0,10196448.0,10196883.0,8220053.0,14662.0,,7944336.0,5233550.0,978901.0,6212451.0,,,,,,1481715.0,,,,,,,,,,2629198.0,1615952.0,63931604.0,3677809.0,,3357877.0,,1972802.0,,2403254.0,1515193.0,1288244.0,2648581.0,604126.0,1627651.0,2442015.4,26.18,2306288.6,2179772.85,25.49,25.29,35.6,,,,,2688766.0,1567537.0,335123.0,,,,,,,,40.98,102273.68,7558007.0,13930.0,52277.0,0.266465,2013944.0,,,24680909.0,24374243.0,9295365.0,9279866.0,33654109.0,0.724258,0.275742,5544629.0,4015742.0,39.41,1528887.0,61.08,39.41,15.32,15.29,15.56,15.39,15.39,144149.99,2218468.0,52277.0,21.69,13.99,5483897.0,5544629.0,57.17,36.88,1528887.0,1758230.0,61.45,62.41,,,,,,6679257.0,,,,,187.58,5280252.0,14291420.0,10366324.0,1342128.0,1332450.0,143910177.0,18632051.0,5196641.0,,,8494.0,17328423.0,,,17328423.0,,,96348.49,34.85,20674754.0,20674754.0,661994.03,37.51,23.9,,,38515.0,,,1917530.0,291979.0,72889.0,,,,,,,,,,,,,,,,,-65.0,226484.0,,,,135901.0,41771.0,,15779.0,,23179.0,23179.0,86080.0,86080.0,86080.0,62901.0,23179.0,8354.0,12988394.0,623.0,4012.0,4994255.0,1180372.0,,1070220.0,,4994255.0,1180372.0,,1070220.0,,126515.75,133702.7,6134.0,,,78758.6,170738.82,93900.44,39729.54,,30255.78,51652.17,29.07,37.35,192.43,,,25.05,14.08,16.14,32.43,,19.97,31.51,19486050.0,19486050.0,126515.75,496203.75,29.07,39.27,,,,,135704.0,25321.0,136602.0,1252314.0,1474508.0,25321.0,44309.0,15931.0,7400.0,,,144011.0,0.0401,0.1031,0.1432,,,135704.0,289759.0,36365356.0,2527844.0,137154.0,238789.0,155213.0,70532.0,33855571.0,33470331.0,,,15499.0,136602.0,,,1627529.0,0.0294,47849.0,4656.0,121.35,0.0401,0.1031,0.1432,1254844.0,162465.0,-856010.0,81986.0,334.0,,21976.0,2085.0,17457.0,15125.0,278675.0,2085.0,17457.0,,15125.0,111363.0,,107.0,75247.92,1050.0,,141.36,35.2,106.06,2675976.6,,,-435.0,,,,,,,562.0,9678.0,88.0,9766.0,555.0,,,1031.0,,,,,,,4994255.0,4994255.0,,1986608.0,,475529.0,,,-147776.0,2328990.0,5089497.0,257734.0,5089497.0,18145826.0,,,5089497.0,5089497.0,1862658.0,1247258.0,3109916.0,114425.0,57020.0,171445.0,2938471.0,,,,,6966301.0,6579016.0,39439.0,1247258.0,24813.0,7984.0,2922.0,94322.0,,,40327.0,377.0,,,,,,,,3963125.0,21.873973,4078311.0,4078311.0,4061404.0,25220.0,4036184.0,47508.0,3988676.0,16763.0,10896.0,12502.0,3999572.0,108590.0,4036368.0,3908892.0,,6596.0,22.89,22.85,22.67,22.8,22.8,143220.56,3265429.0,942444.0,306666.0,15499.0,35.48,22.89,12480.0,0.238728,1804308.0,80111.0,60.12,53.86,56.11,55.18,55.05,55.05,0.293475,0.294587,0.293475,3001105.0,7.59,3173373.0,37320562.0,38.57,4015742.0,52.53,,61.08,15.26,248361.0,,,214.0,2.0,566.0,28.0,10220.0,2922.0,41.0,7984.0,,402680.0,25362.27,15.88,,,,,,,,,,,,,,,,,,,,,,,,,,,,,,0.813,7427115.0,,18145826.0,,45.0,,,,,,,,,,,,,,,,,,,,,,,,,,,,,,,,,,,,,,,,,,,,3678.0,,,,,,,,,,,,,,,,,,,,,,,,,,,,,,,,,245762.0,,,,,,,,,,,,,,,,,1358266.0,291698.0,261872.0,,0.0339,,21.67,,-1.57,6.03,6.03,0.032146,0.008512,172268.0,,271595.0,,13.96,8325.0,36.43,4625.0,,3536.0,,,,,,,,,,,,,,,,,,,,,,,,,,,,,,,,,,,,,,24307.0,211930.0,27439.0,3132.0,398.0,18482435.0,517989.0,,,,139.0,139.0,,,,,,,,,,,,,,,,,,,,,,,,,,,,,,,,,,,80479.0,,,,,,,,,,,,,,,,,,,,,,,,,,,,,,,,,,,,,,,,,,,,,,,16482509.0,,,5233550.0,11248959.0,,,,,,,,,,,,,,,,,,,,,,,,,,,,,,22.14,20.28,1.33,1.33,896178.0,,4656.0,537799.0,,,537799.0,,,,2968.0,,,181.2,,,17964446.0,,,,,,,,,,,,,,,,,,,,,,,,,,,,,,,,,,,,,,,,,,,,,,,436604.0,,,,,,,,,,,,,,,,,,,,,,,,,,,,,,,,,,,,,,,,,,,,,,,,,,,,,,,1370217.0,,,,,,,,,,,,,,,,,,,,,,,,,,,,1159457.0,,,,-1759199.0,,,,,165256.0,,96343.0,,,20103.0,,,,16693.0,1252314.0,1258828.0,,,,,,,,,,36796.0,,,,,0.96,,,,,,,,,,,,,,,,,,,,,,6596.0,,,,,,,,,,,,,,,,,,,,,,118.0,118.0,706.0,706.0,706.0,588.0,22.0,118.0,236.0,,354.0,235.0,354.0,354.0,354.0,354.0,382.0,,,,,,,,,222194.0,,6514.0,,,,,,,2074110.0,,,,,,,,,,,,,,,,,,,,,,,,,,,,,,,,,,,,,,,,,,,,,,,,,,,,,,,1.0,16907.0,,,,,,1.0,,,,,,,,,,,64250.0,64250.0,,,,,,,,,,,,,,,,,,,,,,,,,,,,,,,,,,,,,,,,,,,,,,,,,,,,,,,,,,,,,,,,,,,,,,,,,,,,,,,,,,,,,,,,,,,,,46749.0,,,-35.0,,,,,,,,,,,,,,,,,,,,,,,,,,,,,,,,,,,,,,,,,,,,,,,,,,,,,,,,,,,,,,,,,,,,,,,,,,,,,,,,,,,,,,,,,,,,,,,,,,,,,,,,,,,,,,,,,,,,,,,,,,,,,,,1388858.0,2040186.0,,,,,,,,,,,,,,,,,,,,,,,,,,,,,,,,,,,,,,,,,,,,,,,,,,,,,,,,,,,,,,,,,,,,,,,,,,,,,,,,,,,,,,,,,,,,,,458164.0,,,,,,,,,,,,,,,,,,,,,,,,,,,,,,,,,,,,,,,,,815 FREEPORT ROAD,PITTSBURGH,15215,ALLEGHENY,UPMC ST MARGARET,38300,P,2,N,N,N,Y,Y,N,,N,N,,,N,N,N,N,Y,Y,Y,,,HO0164,UNIVERSITY OF PITTSBURGH MEDICAL CEN,200 LOTHROP STREET,PITTSBURGH,PA,15213-2582,,Y,,,N,N,,,,UPMC ST MARGARET REHABILITATION UNIT,39T102,,,,,,,,,,,,,,,,,,,,,,,,,,,,,,,,,,,,,,,,,,,,,,,,,,,,,,,,,,,,,,,,,,,,,,,,,,,,,,,,,,,,,,,,,,,,,,,,,,,,,,,,,,,,,,,,,,,,,,,,,,,,,,,,,,,,,,,,,,,,,,,,,,,,,,,,,,,,,,,,,,,,,,,,,,-117543.0,,4829060.0,4120401.0,4747376.0,4020255.0,-36589911.0,2629198.0,602160.0,1615952.0,3718762.0,1408069.0,,,1562962.0,2400001.0,,1987610.0,13975348.0,224197.0,358595.0,,74745.0,83108795.0,22336701.0,,6561621.0,1410559.0,680926.0,4625454.0,1489166.0,664699.0,2287256.0,1685732.0,,731774.0,5248247.0,13939.0,,,946194.0,-45.0,-2696.0,-89801.0,-41043974.0,4829060.0,2422449.0,3447683.0,825627.0,1896445.0,4120401.0,14131066.0,24777057.0,11687349.0,,1674971.0,3595057.0,1328527.0,1279863.0,1026338.0,8235799.0,1568380.0,,2042195.0,2315880.0,1237667.0,,2238940.0,7221049.0,126633.0,4035474.0,14148712.0,13800192.0,3349044.0,2260287.0,5629323.0,20095878.0,,2768586.0,7180815.0,2437793.0,2334887.0,1889675.0,12971661.0,1877463.0,,3246220.0,2915219.0,1709072.0,,3858155.0,214815.0,4789799.0,16721347.0,22928183.0,3425663.0,10690178.0,1829523.0,,262364.0,1086535.0,303302.0,136629.0,145462.0,882179.0,9949.0,,268832.0,59303.0,85876.0,,408545.0,19950.0,25528.0,57752.0,242552.0,336153.0,650492.0,20095878.0,,2838661.0,7198666.0,2437793.0,2334887.0,1889675.0,13031399.0,1877463.0,,3246220.0,2915219.0,1709072.0,,3858155.0,214815.0,4789799.0,16721347.0,22928183.0,3425663.0,10690178.0,102355788.0,,28213608.0,17784149.0,2001622.0,26440351.0,7819404.0,55268025.0,4262634.0,,8689412.0,7299530.0,10794704.0,,13050178.0,221210.0,13583328.0,72420782.0,67213375.0,19495.0,27533386.0,20409327.0,,5679213.0,4294067.0,296913.0,6734607.0,1950687.0,12918677.0,951933.0,,1925035.0,1086279.0,1205029.0,,3520128.0,61805.0,2956193.0,14770804.0,14767688.0,5933.0,7703244.0,2012686.0,,171122.0,539598.0,27049.0,137824.0,54292.0,1008716.0,273230.0,,333127.0,391877.0,177566.0,,309789.0,21596.0,577513.0,2574330.0,2466470.0,3419.0,1036757.0,183235.0,,20057.0,80213.0,3365.0,8068.0,4178.0,51418.0,1448.0,,27588.0,7972.0,8922.0,,32970.0,2006.0,3077.0,8892.0,26095.0,276.0,63090.0,20409327.0,,5679213.0,4294067.0,296913.0,6734607.0,1950687.0,12918677.0,951933.0,,1925035.0,1086279.0,1205029.0,,3520128.0,61805.0,2956193.0,14770804.0,14767688.0,5933.0,7703244.0,1094452.0,38394.0,27246662.0,2540934.0,-1960435.0,44992258.0,-6488.0,-29654102.0,70327496.0,-55472888.0,82061293.0,25849557.0,25849557.0,135157512.0,2635262.0,-15.0,81043504.0,1775557.0,4889775.0,1227050.0,5622911.0,104064547.0,129534601.0,-59981708.0,135157512.0,1174051.0,,,,,1903660.0,1262416.0,,309504.0,1963400.0,1396761.0,5629010.0,,1070209.0,712279.0,1145136.0,,-752067.0,,-268099.0,717213.0,2721030.0,,1581544.0,712279.0,,3696380.0,,159812.0,15441408.0,560151.0,106247375.0,-57564729.0,,,,733136.0,733136.0,,638179.0,3094870.0,,,2433846.0,,624020.0,3094870.0,,,,,,13527813.0,,13527813.0,,2259388.0,,,,367159.0,,2374942.0,,4009985.0,,,,,-13754.0,,,2797726.0,2797726.0,644842.0,,,,4714328.0,5453916.0,456975.0,266414.0,5716303.0,,,-4196224.0,,,,-404.0,,,,,,101424007.0,,43491944.0,108555179.0,10934848.0,70066659.0,8992749.0,8992749.0,886829.0,7944336.0,-6571953.0,,,,308733.0,204610.0,28624.0,-447490.0,,-70417.0,,10069478.0,31695106.0,5479749.0,10347342.0,953464.0,3728648.0,5479749.0,10347342.0,953464.0,3728648.0,650783.0,830190.0,164997.0,321283.0,,,48506.0,24383.0,,,-182714.0,,,,,,150721.0,75763.0,,2084601.0,717922.0,-1776477.0,-359337.0,-45000.0,2687009.0,5048681.0,280953.0,5048681.0,12988394.0,781416.0,,2649164.0,3255.0,694.0,59899.0,,,,,12988394.0,,14.0,5110.0,694.0,3255.0,,,,,525916.0,,643125.0,547458.0,847665.0,,111481.0,4574539.0,,,,,1022856.0,,1188678.0,,,14500.0,,-37.0,,950495.0,,,,420682.0,,,,,823430.0,,,,,74175.0,,,,828680.0,,,,2312865.0,,48159084.0,,87650800.0,60077522.0,3565779.0,,393564.0,23521504.0,51896220.0,,,,,565645.0,,,79736.0,,,,,,,,,7137.0,,,565645.0,,,,4809914.0,,10441905.0,6292991.0,703421.0,,54774.0,24284.0,1141172.0,2387018.0,4847218.0,,,,,4809914.0,,10441905.0,6292991.0,703421.0,,54774.0,24284.0,1141172.0,2387018.0,4847218.0,,,,44309.0,,,228288.0,,213694.0,175147.0,98529.0,,19760.0,8485.0,222936.0,416021.0,652373.0,,,,7400.0,,,,,,,,,,,,,66.0,,,,,,,,803687.0,,,,,,,,,,,-5393257.0,,,,,,,,,,,,,,,,,240026.0,12537.0,,,,8438683.0,-115731.0,2255574.0,,,,,,,,,,,,,,,,,,,,,,,,,,,,,,,26942.0,,9782.0,134722.0,,708533.0,134956.0,1130243.0,2299799.0,,125357.0,39371.0,7303.0,1829882.0,,2657.0,,294.0,17054.0,,55124.0,23354.0,407737.0,338885.0,,15763.0,7691.0,1273.0,305623.0,,,,,,,,,,,,,,,,,242.0,,35.0,2531.0,,2575.0,1934.0,8295.0,17028.0,,2069.0,41.0,4.0,3233.0,,48851.0,48851.0,7198.0,,,,,,,,,,,,,,,,,,,,,,,,,,,,,,,882382.0,,740925.0,1792582.0,161149.0,,4092445.0,-2404682.0,-3141.0,,-99913.0,,-552.0,,3670930.0,164348.0,591062.0,,,5658286.0,,544462.0,,5658286.0,,64458.0,24757912.0,54141351.0,40738.0,4252.0,,,,,,,96093.0,162373.0,95104.0,1674.0,,16538.0,8754.0,3323.0,2647.0,585.0,,2226.0,,409.0,,,,1089.0,195.0,204.0,54.0,,135.0,9723.0,40738.0,4407957.0,4975611.0,4407957.0,4975611.0,,,401565.0,519379.0,,,,,,,,,36234.0,14697.0,,,,,,,,,,,,,,,,,,,,,,,,,,,,,,,,,5537.0,,,,,,1082.0,,,,,,,,,,,,,,,,,,,,,,,,,,,,,,,,,,,,,,,,,,111812.0,,,,,2278429.0,480454.0,480454.0,137903.0,,,,,,,,,,,,,,,,,,,,,78849.0,,,,,,,281903.0,1013837.0,,,80525.0,,,,,,,,,,524947.0,6944.0,225015.0,,,,46946.0,,,,,,,,,306041.0,4048.0,131183.0,,,,,,,,,,,134711.0,,632.0,,,,,,,,,,,123401.0,,397.0,,,,,,,,,,,,1252314.0,,,,,,,,,,,,,,,,,,,,11248959.0,-10576109.0,,,79.0,,,,4669809.0,,,,,,,,,,,,,,,,,,,,,,,,,,,,,,,,,,,,,,,,,,,,,,,,,,,,,,,,,,,,,,,,,,,,,,3751859.0,20800245.0,,,,,,,,,,,,,,,,,,,,,,,,,,,,,,,,,10944.0,97246.0,,1543.0,27912.0,,,,138.0,148.0,,,,,,,,,,,,,,1201825.0,,,,,,,,,,,,,,,,,,,,,,,,,,1470283.0,981532.0,,,,,,,,,6514.0,1.0,,,,,,,,,,,,,,,,,,,,,,,,,,,,,,,,,,,,,,,,,,,,,,,,,,,,,-1285347.0,,,9748.0,,5683.0,,,,,,,,,,,,,,,,,,,,,,,,,,,,,,,,,,,,,,,,,,801552.0,,,,,,,,,,,,,,,,,,,,,,,,,,,,,,,,,,,,,,,,,,,,,,,,,,,,,,,,,,,,,,,,,,,,,,,,,,,,,,,,,,,,,,,,,,,,,,,,,,,,,16692.0,1.0,,,,,,,,,,,,,,,,,,,,,,,,,,,,,,,,,,,,,,,,,,,,,,,,,,,,,,,,,,,,,,,,,,,,,,,,,,,,,,,,,,,,,,,,,,,,,,,,,,,,,,,,,,,,,,,,,,,,,,,,,,,,,,,,,,,,,,,,,,,,,,,,,,,,,,,,,,,,,,,,,,,,,,,,,,,,,,,,,,,,,,,,,,,,,,,,,,,,,,,,,,,,,,,,,,,,,,,,,,,,,,,,,,,,,,,,,,,,,,,,,,,,,,,,2017,PA,,Y,Y,34521608.0,,,-66052.0,,-6555.0,,29407501.0,1928395.0,,36655115.0,,,23555599.0,,312633.0,31335896.0,31263289.0,312633.0,30950656.0,366551.15,40.487472,-79.896038,Voluntary non-profit - Private,Acute Care Hospitals,UPMC ST MARGARET (390102)
51600,725024,390102,12001,2,2022-09-23 00:00:00,2018-07-01 00:00:00,2019-06-30,F,N,39,39010,2.0,3.0,6280,,,,,,,,,,,,,,,,,,,,,,,,,,,,,,,,,,,,,,,,,,,,,,,,,,,,,,,,,,,,,75039.0,,,,,,,,,,,,,,,,,,,4779390.0,15474383.0,,5563286.0,6766695164.0,0.000143623,971853.0,244960.0,954486.0,,,,,677948.0,8272872447.0,0.000114668,948634.0,709526.0,,,,,,,203940.0,,,,,,,,,,,,,,,,,,,,,,,,,,,,,,,,,,,,,,,,,,,,,,,,,,,,,,,,,,,,,,,,,,,,,,,,,,,,,,,,,,,,,,,,,,,,,,,,,,,,,,,,,,,,,,,,,10115306.0,3404775.0,2613194.0,772349.0,,,,,,,,,,10115306.0,3404775.0,,536979.0,2613194.0,772349.0,,,33.49,48.56,,,,,,,,,,,,,,,,,,,,,,,,,,,,,,,,,,,,,,,,,212320001.0,2540934.0,44992258.0,70327495.0,243861507.0,10448055.0,1192699.0,3770702.0,10627784.0,,,,,-289448.0,8861414.0,8931749.0,,,,,-61216487.0,65551922.0,14227223.0,181089708.0,3134479.0,148685.0,-61216487.0,-167009.0,185425143.0,17026844.0,391618.0,176635471.0,36299294.0,575641.0,10204252.0,1858403.0,5593.0,172888691.0,179530742.0,173050256.0,36313109.0,575641.0,586155568.0,586155568.0,107069456.0,706498.0,1374526474.0,36313109.0,36313109.0,7786278.0,13035113.0,21773160.0,553985.0,676315.0,1230300.0,20542860.0,106390590.0,106390590.0,26909754.0,246806.0,13035113.0,162847.0,57224.0,47943.0,13553.0,10280.0,549066.0,398453.0,540343.0,1582.0,57224.0,13553.0,,,,,,,,,,,,,,,,,,107069456.0,123562795.0,134193484.0,586754449.0,,,246641630.0,1342057254.0,,,1118554875.0,7068829.0,-16070422.0,-16070422.0,223502379.0,246641630.0,-23139251.0,68835.0,0.125781,8724072.0,376705.0,8144525.0,1227268.0,2840827.0,5661096.0,176135.0,176135.0,176093.0,11714935.0,1627497.0,1613559.0,1.0,1.0,1.0,1127.43,1161.44,2654.0,2654.0,9582.0,9582.0,208.0,222.0,250.0,208.0,72171.0,77281.0,72171.0,10280.0,10838.0,10280.0,39387.0,41853.0,39387.0,560151.0,106247374.0,3991350.0,,,,-12007781.0,-8343945.0,,,,219113.0,,,,,,,788370906.0,788370906.0,,,,,,,,,,,,,,,,,,,,,,,,,,,,,,,,,,452560965.0,,755284239.0,755302805.0,764080.0,,103.0,103.0,,,,,,527.0,554.0,,527.0,,65551922.0,4039746.0,4307457.0,1868736.0,2436806.0,1983626.0,1447821.0,605998.0,,60302353.0,4039746.0,56262607.0,95627621.0,60076318.0,3460813.0,56615505.0,95980519.0,16673332.0,,89593305.0,89593305.0,9153675.0,,,,,,,,,,,,,,,,,,,,9045239.0,10583878.0,2090480.0,8496234.0,10466349.0,10082619.0,10069213.0,196703.0,127857.0,36319.0,10197070.0,10197008.0,8201098.0,86224.0,,7944336.0,7838464.0,103795.0,25140325.0,,,,,,1342838.0,,,,,,,,,,2732405.0,1564075.0,65325887.0,3460813.0,,3897472.0,,1894168.0,,2454371.0,1670007.0,1475899.0,2755193.0,607232.0,1577264.0,2415786.24,27.04,2276949.56,2167578.3,26.38,26.12,35.84,,,,,2930302.0,1602428.0,334277.0,,,,,,,,40.98,104043.21,7766093.0,13553.0,48668.0,0.278479,2162694.0,,,24883169.0,24540976.0,9177749.0,9164343.0,33705319.0,0.728104,0.271896,5834527.0,4248142.0,39.39,1586385.0,62.34,39.39,15.95,15.32,15.29,15.52,15.52,146643.8,2275912.0,48668.0,22.82,14.42,5597833.0,5834527.0,58.67,37.07,1586385.0,1705746.0,63.89,63.91,1058540.0,,,,,6480486.0,,,,,188.01,2820269.0,14128867.0,11538800.0,1451362.0,1437466.0,138373618.0,17404772.0,2691810.0,,,8556.0,17006395.0,,,17006395.0,,,106674.27,36.54,20423482.0,20423482.0,662727.55,36.07,25.16,,,-21679.0,,,1928711.0,176178.0,71001.0,,,,,,,,,,,,,,,,,,148112.0,,,,165926.0,105693.0,,15846.0,,23975.0,23975.0,154404.0,154404.0,154404.0,130429.0,23975.0,21139.0,10630689.0,654.0,3589.0,4935832.0,485619.0,,886788.0,134.0,4935832.0,485619.0,,886788.0,134.0,109371.26,134305.78,3620.0,,,72704.21,166277.82,98552.14,42044.16,4.5,29323.22,49630.76,31.64,36.75,134.15,,,26.05,14.76,16.95,35.1,29.78,20.71,31.78,18941532.0,18941532.0,109371.26,510096.56,31.64,37.13,,,,,135972.0,28665.0,108436.0,1087940.0,1171814.0,28665.0,48711.0,18914.0,8129.0,,,219550.0,0.0511,0.099,0.1501,0.0251,127093.0,135972.0,342193.0,36823351.0,2517952.0,146555.0,380268.0,247174.0,13787.0,34406018.0,33897415.0,,,13406.0,108436.0,,,1625673.0,0.0309,50233.0,7181.0,114.67,0.0511,0.099,0.1501,1598929.0,201115.0,584095.0,96870.0,240.0,,20997.0,31544.0,,225312.0,,31544.0,,,225312.0,,,1928.0,76556.91,,,116.86,35.99,,2677674.86,614493.0,,62.0,,,,,,,143.0,13896.0,42.0,13938.0,554.0,,,1162.0,,,,,,,4912071.0,4912071.0,17198066.0,1871113.0,,482767.0,,,-147599.0,2178976.0,4634826.0,237516.0,4634826.0,16493339.0,,,4634826.0,4634826.0,1846444.0,1263565.0,3110009.0,94618.0,53806.0,148424.0,2961585.0,,,,,6827590.0,6521082.0,43262.0,1263565.0,28545.0,6815.0,2715.0,94618.0,,,40212.0,277.0,,,,,,,,3673324.0,18.671233,3779368.0,3779368.0,3779368.0,20292.0,3759076.0,22416.0,3736660.0,2576.0,1674.0,,3738334.0,73099.0,3751928.0,3670244.0,3820.0,32945.0,22.65,22.89,22.85,22.8,22.8,145698.28,3321921.0,872424.0,342193.0,13406.0,35.85,22.65,12185.0,0.25037,1944397.0,80109.0,62.32,52.64,53.86,56.11,54.2,54.2,0.288283,0.287131,0.287131,2943056.0,11.25,3115071.0,36171740.0,38.57,4248142.0,51.07,,60.23,15.97,259620.0,,,205.0,5.0,491.0,28.0,10220.0,2715.0,87.0,6815.0,,339388.0,20951.96,16.2,,,,,,,,,,,,,,,,,,,,,,,,,,,,,,0.813,7353779.0,,16493339.0,,,,,,,,,,,,,,,,,,,,,,,,,,,,,,,,,,,,,,,,,,,,,,3349.0,,,,,,,,,,,,,,,,,,,,,,,,,,,,,,,,,242933.0,,,,,,,,,,,,,,,,,462476.0,99537.0,92623.0,,0.0235,,22.95,,-1.59,6.03,6.03,0.032073,0.008493,172015.0,,99537.0,,12.5,9093.0,34.01,4301.0,,2996.0,,,,,,,,,,,,,,,,,,,,,,,,,,,,,,,,27021.0,,,,,,6295.0,242560.0,30509.0,24214.0,189.0,17988469.0,472915.0,,,,,,2204.0,2204.0,7.6,290.0,,,,,,,,,,,,,,,,,,,,,,,,,,,,,,,104245.0,,,,,,,,,,,,,,,,,,,,,,,,,,,,,,,,,,,,,,,,,,,,,,,11248959.0,,,7838464.0,3410495.0,,,,,,,,,,,,,,,,,,,,,,,,,,,,,,22.14,20.84,1.53,1.57,505927.0,,7181.0,,,,,,,,,,,,,,17515554.0,,,,,,,,,,,,,,,,,,,,,,,,,,,,,,,,,,,,,,,,,,,,,,,649941.0,,,,,,,,,,,,,,,,,,,,,,,,,,,,,,,,,,,,,,,,,,,,,,,,,,,,,,,1203390.0,,,,,,,,,,,,,,,,,,,,,,,,,,,,1160469.0,,,,-1544854.0,,,,,33775.0,,18470.0,,,,,,,13594.0,1087940.0,1094729.0,,,,,,,,,,13594.0,,,,,0.02,,,,,,,,,,,,,,,,,,,,,,32945.0,,,,,,,,,,,,,,,,,,,,,,82.0,82.0,493.0,493.0,493.0,411.0,16.0,82.0,172.0,,254.0,171.0,254.0,254.0,254.0,254.0,274.0,,,,,,,,,83874.0,,6789.0,,,,,,,2168260.0,,,,-1158149.0,,,,,,,,,,,,,,,,,,,,,,,,,,,,,,,,,,,,,,,,,,,,,,,,,,,1.0,,,,,,,1.0,,,,,,,,,,,63742.0,63742.0,,,,,,,,,,,,,,,,,,,,,,,,,,,,,,,,,,,,,,,,,,,,,,,,,,,,,,,,,,,,,,,,,,,,,,,,,,,,,,,,,,,,,,,,,,,,,2825.0,,,-25.0,,,,,,,,,,,,,,,,,,,,,,,,,,,,,,,,,,,,,,,,,,,,,,,,,,,,,,,,,,,,,,,,,,,,,,,,,,,,,,,,,,,,,,,,,,,,,,,,,,,,,,,,,,,,,,,,,,,,,,,,,,,,,,,1405904.0,505000.0,,,,,,,,,,,,,,,,,,,,,,,,,,,,,,,,,,,,,,,,,,,,,,,,,,,,,,,,,,,,,,,,,,,,,,,,,,,,,,,,,,,,,,,,,,,,,,579547.0,,,,,,,,,,,,,,,,,,,,,,,,,,,,,,,,,,,,,,,,,815 FREEPORT ROAD,PITTSBURGH,15215,ALLEGHENY,UPMC ST MARGARET,38300,P,2,Y,N,N,Y,Y,N,,N,N,,,N,N,N,N,Y,Y,Y,,,HO0164,UNIVERSITY OF PITTSBURGH MEDICAL CEN,200 LOTHROP STREET,PITTSBURGH,PA,15213-2582,,Y,,,N,N,,,,UPMC ST MARGARET REHABILITATION UNIT,39T102,,,,,,,,,,,,,,,,,,,,,,,,,,,,,,,,,,,,,,,,,,,,,,,,,,,,,,,,,,,,,,,,,,,,,,,,,,,,,,,,,,,,,,,,,,,,,,,,,,,,,,,,,,,,,,,,,,,,,,,,,,,,,,,,,,,,,,,,,,,,,,,,,,,,,,,,,,,,,,,,,,,,,,,,,,-289448.0,,4471735.0,4389679.0,4616021.0,4315728.0,-39597150.0,2732405.0,605998.0,1564075.0,4307457.0,1437085.0,,,1625237.0,2436806.0,,1990396.0,14481296.0,277653.0,312188.0,,74239.0,83899911.0,21440215.0,,6635643.0,1297968.0,681482.0,4723470.0,1316433.0,654394.0,2290284.0,1728527.0,,644266.0,5740606.0,11477.0,,,1039779.0,-804.0,-296.0,-93170.0,-42319570.0,4471735.0,2330228.0,3671473.0,884589.0,1796282.0,4389679.0,11982360.0,24633706.0,12284279.0,,1752028.0,3579215.0,1329008.0,1271145.0,1076949.0,8179897.0,1401373.0,,2063356.0,2335044.0,1282706.0,,2193866.0,7607447.0,117855.0,3456750.0,12856702.0,14424127.0,3492554.0,2204763.0,5841436.0,20544512.0,,2788993.0,7020201.0,2277023.0,2393331.0,2050670.0,12820562.0,1689690.0,,3230856.0,2952391.0,1766026.0,,3757953.0,195215.0,4128439.0,15226321.0,23799669.0,3261889.0,10668535.0,1930304.0,,211425.0,995701.0,174505.0,199815.0,242537.0,943994.0,10089.0,,231505.0,60291.0,82312.0,,399653.0,16115.0,27605.0,58758.0,265311.0,327861.0,561367.0,20544512.0,,2859068.0,7032576.0,2277023.0,2393331.0,2050670.0,12880300.0,1689690.0,,3230856.0,2952391.0,1766026.0,,3757953.0,195215.0,4128439.0,15226321.0,23799669.0,3261889.0,10668535.0,99011333.0,,27714426.0,17411190.0,2820220.0,26720447.0,7667729.0,54889719.0,4065530.0,,8302561.0,6793368.0,10448866.0,,12627588.0,195873.0,11726131.0,61246401.0,70275453.0,28703.0,27695282.0,21057803.0,,6034673.0,4108885.0,422995.0,7205980.0,2147895.0,13266064.0,978188.0,,1903235.0,1136333.0,1349888.0,,3375632.0,62308.0,2694425.0,14465461.0,17736470.0,15187.0,7869870.0,2138673.0,,172693.0,496996.0,34291.0,144941.0,63374.0,1013957.0,243309.0,,328538.0,435401.0,210306.0,,295352.0,22392.0,499228.0,2725611.0,2959756.0,3231.0,1009476.0,200934.0,,16604.0,65801.0,2628.0,12099.0,7496.0,49779.0,1453.0,,23541.0,8985.0,9802.0,,31354.0,1848.0,3338.0,10516.0,32990.0,336.0,53114.0,21057803.0,,6034673.0,4108885.0,422995.0,7205980.0,2147895.0,13266064.0,978188.0,,1903235.0,1136333.0,1349888.0,,3375632.0,62308.0,2694425.0,14465461.0,17736470.0,15187.0,7869870.0,1089550.0,55956.0,27992997.0,3599474.0,-2249883.0,46184956.0,,-31218889.0,73994402.0,-59298492.0,66564355.0,25986310.0,25986310.0,120543662.0,2053092.0,,82569424.0,1473464.0,4043208.0,2108207.0,4492148.0,90543998.0,116051514.0,-61933801.0,120543662.0,1442779.0,,,,,1983626.0,1447821.0,,422273.0,1868736.0,1418912.0,5813472.0,,1049853.0,652724.0,1096602.0,,-764733.0,,-270004.0,886422.0,1764177.0,,1501077.0,652724.0,,3746780.0,,156101.0,18899575.0,560151.0,93040657.0,-60469945.0,,,,448940.0,448940.0,,336221.0,3003262.0,,,9725.0,,319029.0,3003262.0,,,,,,13769989.0,,13769989.0,,2297853.0,,,,393763.0,,2469236.0,,4036464.0,,-27327.0,,,-18408.0,,,3433105.0,3433105.0,603504.0,,,,4892986.0,5682313.0,443167.0,242345.0,6046265.0,,,-5525194.0,-13709.0,,,-1596.0,,,,,,103274457.0,,43490727.0,110215900.0,10555810.0,72344787.0,9171934.0,9171934.0,931520.0,8558828.0,-6825459.0,,,,271592.0,195608.0,12760.0,-445641.0,,-70601.0,,10413860.0,32505191.0,5259094.0,10556601.0,1149370.0,3676276.0,5259094.0,10556601.0,1149370.0,3676276.0,615594.0,839130.0,198405.0,301539.0,,,47038.0,23963.0,,,-183787.0,,,,,,98124.0,49988.0,134.0,1757641.0,654682.0,-1974117.0,-484776.0,-45756.0,2277765.0,4205897.0,247467.0,4206209.0,10630689.0,1068569.0,,2336652.0,2466.0,558.0,55995.0,,,,,10630689.0,,14.0,5110.0,558.0,2466.0,,,,,543707.0,,656438.0,579924.0,934235.0,,107029.0,4686908.0,,,,,899992.0,,1088227.0,,-1741.0,14063.0,,-79.0,,831718.0,,,,529414.0,,,,,926610.0,,,,,77706.0,,,,931860.0,,,,1508087.0,,48550425.0,,92267158.0,61835754.0,2407614.0,,347343.0,19563288.0,55476833.0,,,,,302324.0,,,71947.0,,,,,,,,,6000.0,,,302324.0,,,,5108129.0,,11025959.0,6624821.0,435930.0,,170587.0,22063.0,1237010.0,1897926.0,4765277.0,,,,,5108129.0,,11025959.0,6624821.0,435930.0,,170587.0,22063.0,1237010.0,1897926.0,4765277.0,,,,48711.0,,,261292.0,,221776.0,195465.0,103158.0,,33245.0,7929.0,229196.0,357611.0,611247.0,,,,8129.0,,,,,,,,,,,,,27.0,,,,,,,,886711.0,,,,,,,,,,,-5393257.0,,,,,,,,,,,,,,,,,131141.0,18566.0,,,,8044587.0,-115960.0,2218100.0,,,,,,,,,,,,,,,,,,,,,,,,,,,,,,,37115.0,,14605.0,152292.0,,690692.0,129178.0,1096827.0,2337753.0,,145200.0,46055.0,3128.0,1781940.0,,3769.0,,416.0,18598.0,,52654.0,22299.0,420264.0,364210.0,,20274.0,8533.0,589.0,297359.0,,,,,,,,,,,,,,,,,354.0,,40.0,2428.0,,2421.0,1598.0,8673.0,16974.0,,2723.0,57.0,2.0,3314.0,,34863.0,34863.0,5431.0,,,,,,,,,,,,,,,,,,,,,,,,,,,,,,,967934.0,,759562.0,1827944.0,162678.0,,3841116.0,-1795563.0,-2391.0,,-110000.0,,-685.0,,3793112.0,155892.0,554839.0,,,5674147.0,,548041.0,,5674147.0,,44381.0,25267973.0,52587193.0,,,,,,,,,66733.0,165686.0,49302.0,4166.0,,11216.0,5410.0,3333.0,1455.0,1497.0,,1439.0,,,,,,415.0,278.0,172.0,124.0,,76.0,6914.0,,4543453.0,5205409.0,4543453.0,5205409.0,,,368324.0,561190.0,,,,,,,,,,,,,,,,,,,,,,,,,,,,,,,,,,,,,,,,102424.0,,,3269.0,,,15240.0,,,606.0,,,,,,,,,,,,,,,,,,,,,,,,,,,,,,,,,,,,,,,,,,122889.0,,,,,2727620.0,556554.0,556554.0,138434.0,,,,,,,,,,,,,,,,,,,,,83931.0,,,,,,,285074.0,1014613.0,,,82424.0,,,,,,,,,,566055.0,13510.0,268836.0,,,,45073.0,,,,,,,,,309546.0,7388.0,147012.0,,,,,,,,,,,135294.0,,645.0,,,,,,,,,,,105037.0,,391.0,,,,,,,,,,,,1087940.0,,,,,,,,,,,,,,,,,,,,3410495.0,-2721940.0,,,102.0,,,,4756493.0,,,,,,,,,,,,,,,,,,,,,,,,,,,,,,,,,,,,,,,,,,,,,,,,,,,,,,,,,,,,,,,,,,,,,,3750432.0,20751023.0,,,,,,,,,,,,,,,,,,,,,,,,,,,,,,,,,11322.0,41118.0,,2694.0,10227.0,,,,225.0,61.0,,,,,,,,,,,,,,1124444.0,,,,,,,,,,,,,,,,,,,,,,,,,,753821.0,247367.0,,,,,,,,,6789.0,1.0,,,,,,,,,,,,,,,,,,,,,,,,,,,,,,,,,,,,,,,,,,,,,,,,,,,,,-1279262.0,,,44557.0,,24366.0,,,,,,,,,,,,,,,,,,,,,,,,,,,,,,,,,,,,,,,,,,778426.0,,,,,,,,,,,,,,,,,,,,,,,,,,,,,,,,,,,,,,,,,,,,,,,,,,,,,,,,,,,,,,,,,,,,,,,,,,,,,,,,,,,,,,,,,,,,,,,,,,,,,13593.0,1.0,,,,,,,,,,,,,,,,,,,,,,,,,,,,,,,,,,,,,,,,,,,,,,,,,,,,,,,,,,,,,,,,,,,,,,,,,,,,,,,,,,,,,,,,,,,,,,,,,,,,,,,,,,,,,,,,,,,,,,,,,,,,,,,,,,,,,,,,,,,,,,,,,,,,,,,,,,,,,,,,,,,,,,,,,,,,,,,,,,,,,,,,,,,,,,,,,,,,,,,,,,,,,,,,,,,,,,,,,,,,,,,,,,,,,,,,,,,,,,,,,,,,,,,,2018,PA,,Y,Y,34786000.0,,,-140875.0,,-47856.0,,30233259.0,1942707.0,,37165544.0,,,24669973.0,,319872.0,32175966.0,31987235.0,319872.0,31667363.0,371655.44,40.487472,-79.896038,Voluntary non-profit - Private,Acute Care Hospitals,UPMC ST MARGARET (390102)
56197,711648,390102,12001,5,2022-02-07 00:00:00,2019-07-01 00:00:00,2020-06-30,F,N,39,39010,2.0,3.0,6280,,,,,,,,,,,,,,,,,,,,,,,,,,,,,,,,,,,,,,,,,,,,,,,,,,,,,,,,,,,,,60966.0,,,,,,,,,,,,,,,,,,,4208455.0,13082637.0,,4954685.0,8272872447.0,0.000114668,948634.0,239108.0,816720.0,,,,,493266.0,8350599096.0,9.2395e-05,771554.0,577612.0,,,,,,,159778.0,,,,,,,,,,,,,,,,,4931139.0,,,,,,,,,,,,,,,,,,,,,,,,,,,,,,,,,,,,,,,,,,,,,,,,,,,,,,,,,,,,,,,,,,,,,,,,,,,,,,,,,,,,,,,,,,,,,,,,10829285.0,3205392.0,2619308.0,852658.0,,,,,,,,,,10829285.0,3205392.0,,476077.0,2619308.0,852658.0,,,33.75,49.37,,,,,,,,,,,,,,,,,,,,,,,,,,,,,,,,,,,,,,,,,214929592.0,3599474.0,46184957.0,73994402.0,229348966.0,649730.0,318136.0,83601.0,13556633.0,,,,,-120690.0,8035989.0,7880288.0,,,,,-60632442.0,65059330.0,12939955.0,186052230.0,2566985.0,128063.0,-60632442.0,-113220.0,190479118.0,15299204.0,355059.0,181372220.0,34647746.0,535785.0,9413793.0,1703832.0,19398.0,177815775.0,185315728.0,177970010.0,34661561.0,535785.0,558017782.0,558017782.0,99254626.0,670653.0,1380888434.0,34661561.0,34661561.0,6663721.0,11148150.0,18736808.0,442356.0,519286.0,961642.0,17775166.0,90691782.0,90691782.0,23241105.0,186611.0,11148150.0,117278.0,54911.0,44369.0,11659.0,8530.0,442695.0,327552.0,405632.0,4246.0,54911.0,11659.0,,,,,,,,,,,,,,,,,,99254626.0,120745090.0,130589369.0,557865832.0,,,251111560.0,1347081665.0,,30.0,1127828428.0,12100953.0,-19757370.0,-19757370.0,219253237.0,251111560.0,-31858323.0,7458.0,0.128769,7881428.0,247950.0,7499966.0,1099275.0,2604684.0,6785381.0,177588.0,177588.0,177588.0,10489242.0,1505409.0,1505409.0,1.0,1.0,1.0,1076.08,1110.12,2301.0,2301.0,8386.0,8386.0,173.0,187.0,215.0,173.0,72975.0,78099.0,72975.0,8530.0,8991.0,8530.0,34966.0,37159.0,34966.0,560151.0,93040658.0,13011840.0,,,,-11655046.0,-7132591.0,,,,276391.0,,,,,,,822870652.0,822870652.0,,,,,,,,,,,,,,,,,,,,,,,,,,,,,,,,,,427276463.0,,789196363.0,789215833.0,718683.0,,69.0,69.0,,,,,,292.0,357.0,,292.0,,65059330.0,4235606.0,5049832.0,1815738.0,2462844.0,2012100.0,1454434.0,606069.0,,59937958.0,4235606.0,55702352.0,96129934.0,59645352.0,3774476.0,55870876.0,96298458.0,17290698.0,,87129540.0,87129540.0,9075097.0,,,,,,,,,,,,,,,,,,,,8971616.0,9667947.0,1915776.0,7782430.0,9564466.0,9496831.0,9486390.0,127534.0,82897.0,16811.0,9569287.0,9567532.0,7505000.0,1902754.0,,8558829.0,2125392.0,96594.0,2221986.0,,,,,,1377804.0,,,,,,,,,,2702574.0,1505529.0,64766724.0,3774476.0,,4635175.0,,1837085.0,,2487963.0,1615190.0,1505526.0,2672449.0,609147.0,1509041.0,2309041.33,28.05,2179576.13,2068122.37,27.37,27.02,37.16,,,,,3011590.0,1726691.0,329409.0,,,,,,,,40.98,106529.65,7760703.0,11659.0,45508.0,0.256197,1988269.0,,,21686098.0,21524850.0,9124441.0,9114000.0,30638850.0,0.702535,0.297465,5763370.0,4048969.0,38.48,1714401.0,60.13,38.48,13.09,15.95,15.32,14.79,14.79,150148.58,2220697.0,45508.0,19.7,12.61,5627979.0,5763370.0,55.6,35.58,1714401.0,,59.79,60.68,,1058540.0,,,,7345718.0,,,,,187.49,4180697.0,13702915.0,10311654.0,1327821.0,1327821.0,142482109.0,18347279.0,4113143.0,,,9403.0,16960164.0,,,16960164.0,,,127434.75,36.37,20461558.0,20461558.0,666036.62,36.62,25.96,,,-1793384.0,,,1995864.0,494651.0,77391.0,,,,,,,,,,,,,,,,,,199000.0,,,,181881.0,94997.0,,44557.0,,49258.0,49258.0,123960.0,123960.0,123960.0,74702.0,49258.0,18999.0,9844279.0,1361.0,3723.0,4966791.0,964556.0,,952103.0,1051.0,4966791.0,964556.0,,952103.0,1051.0,111453.76,128819.9,8682.0,,,70000.02,161556.15,92599.34,41072.92,40.3,27695.84,46609.04,33.87,38.56,111.1,,,26.24,15.4,17.44,36.65,26.08,21.99,32.38,19966024.0,19966024.0,111453.76,523302.6,33.87,38.15,51927.0,,,,113654.0,29032.0,103481.0,1204979.0,1290727.0,29032.0,28963.0,18246.0,4701.0,,,,0.0483,0.1098,0.1581,0.0321,138761.0,113654.0,142642.0,32131637.0,2337104.0,79299.0,244345.0,158824.0,20264.0,29874058.0,29536906.0,779783.0,,10441.0,103481.0,,,1365881.0,0.0325,44391.0,2997.0,101.53,0.0483,0.1098,0.1581,714792.0,92043.0,531221.0,34184.0,255.0,,19149.0,29428.0,,252500.0,,29428.0,,,252500.0,,,1714.0,75052.49,,,147.32,35.61,,2591424.97,91129.0,,1755.0,,,,,,,77.0,,,,357.0,,,1243.0,,,,,,,4966791.0,4966791.0,,1962712.0,,458743.0,,,-147348.0,2297748.0,5302569.0,245165.0,5302569.0,21490464.0,,,5302569.0,5302569.0,1694473.0,1254817.0,2949290.0,78332.0,51505.0,129837.0,2819453.0,,,,,7086023.0,6834379.0,33827.0,1254817.0,21259.0,8349.0,2668.0,78332.0,,,35564.0,770.0,,,,,,,,3553667.0,22.811475,3687236.0,3687236.0,3668630.0,13772.0,3654858.0,26356.0,3628502.0,9583.0,6229.0,,3634731.0,73916.0,3650672.0,3578516.0,11190.0,59653.0,22.97,22.65,22.89,22.84,22.84,149180.46,3407282.0,852534.0,161248.0,10441.0,35.9,22.97,11998.0,0.263646,2046078.0,83275.0,59.24,53.18,52.64,53.86,53.23,53.23,0.283908,0.283123,0.283123,2479906.0,6.61,2627157.0,32610124.0,38.57,4048969.0,52.63,,59.26,17.9,244493.0,,,191.0,4.0,583.0,28.0,10248.0,2668.0,52.0,8349.0,,408321.0,23944.57,17.05,,,,,,,,,,,,,,,,,,,,,,,,,,,,,,0.813,7293924.0,,21490464.0,,,,,,,,,,,,,,,,,,,,,,,,,,,,,,,,,,,,,,,,,,,,,,3468.0,,,,,,,,,,,,,,,,,,,,,,,,,,,,,,,,,226996.0,,,,,,,,,,,,,,,,,403313.0,77993.0,72420.0,,0.0099,,21.65,,-2.5,6.03,6.03,0.032162,0.008516,147251.0,,77993.0,,14.06,,34.04,3786.0,,3927.0,,,,,,,,,,,,,,,,,,,,,,,,,,,,,,,,23569.0,,,,,,4476.0,110049.0,14171.0,9695.0,424.0,17986066.0,501008.0,,,,,,9750.0,9750.0,31.2,312.5,,,,,,,,,,,,,,,,,,,,,,,,,,,,,,,57859.0,,,,,,,,,,,,,,,,,,,,,,,,,,,,,,,,,,,,,,,,,,,,,,,3410495.0,,,1066852.0,2343643.0,,,,,,,,,,,,,,,,,,,,,,,,,,,,,,22.14,20.02,0.48,0.55,402300.0,,2997.0,,,,,,,,,,,,,,16960164.0,,,,,,,,,,,,,,,,,,,,,,,,,,,,,,,,,,,,,,,,,,,,,,,530370.0,,,,,,,,,,,,,,,,,,,,,,,,,,,,,,,,,,,,,,,,,,,,,,,,,,,,,,,992967.0,,,,,,,,,,,,,,,,,,,,,,,,,,,,1515152.0,81695.0,,,,,,,,163062.0,,93491.0,,,,,,,15941.0,1204979.0,1210872.0,,,,,,,,,,15941.0,,,,,0.89,,,,,,,,,,,,,,,,,,,,,,59653.0,,,,,,,,,,,,,,,,,,,,,,67.0,67.0,412.0,412.0,412.0,345.0,18.0,67.0,208.0,,275.0,207.0,275.0,275.0,275.0,275.0,272.0,-2.0,,,,,,,,85748.0,,5893.0,,,,,,,2132724.0,,,,,,,,,,,,,,,,,,,,,,,,,,,,,,,,,,,,,,,,,,,,,,,,,,,,,,,1.0,18606.0,,,,,,1.0,,,,,,,,,,,44371.0,44371.0,,,,,,,,,,,,,,,,,,,,,,,,,,,,,,,,,,,,,,,,,,,,,,,,,,,,,,,,,,,,,,,,,,,,,,,,,,,,,,,,,,,,,,,,,,,,,,,,,,,,,,,,,,,,,,,,,,,,,,,,,,,,,,,,,,,,,,,,,,,,,,,,,,,,,,,,,,,,,,,,,,,,,,,,,,,,,,,,,,,,,,,524894.0,,,,,,,,,,,,,,,,,,,,,,,,,,,,,,,,,,,,,,,,1417811.0,1000000.0,,,,,,,,,,,,,,,,,,,,,,,,,,,,,,,,,,,,,,,,,,,,,,,,,,,,,,,,,,,,,,,,,,,,,,,,,,,,,,,,,,,,,,,,,,,,,,381462.0,,,,,,,,,,,,,,,,,,,,,,,,,,,,,,,,,,,,,,,,,815 FREEPORT ROAD,PITTSBURGH,15215,ALLEGHENY,UPMC ST MARGARET,38300,P,2,Y,N,N,Y,Y,N,,N,N,,,N,N,N,N,Y,Y,Y,,,HO0164,UNIVERSITY OF PITTSBURGH MEDICAL CEN,200 LOTHROP STREET,PITTSBURGH,PA,15213-2582,,Y,,,N,N,,,,UPMC ST MARGARET REHABILITATION UNIT,39T102,,,,,,,,,,,,,,,,,,,,,,,,,,,,,,,,,,,,,,,,,,,,,,,,,,,,,,,,,,,,,,,,,,,,,,,,,,,,,,,,,,,,,,,,,,,,,,,,,,,,,,,,,,,,,,,,,,,,,,,,,,,,,,,,,,,,,,,,,,,,,,,,,,,,,,,,,,,,,,,,,,,,,,,,,,-120690.0,,4316815.0,3719174.0,4248762.0,3631526.0,-41778238.0,2702574.0,606069.0,1505529.0,5049832.0,1427096.0,,,1558747.0,2462844.0,,1950137.0,13530487.0,244063.0,334492.0,,79067.0,89237104.0,22378051.0,,6643595.0,2438984.0,702217.0,4673058.0,1398098.0,723756.0,2331806.0,1869387.0,,638686.0,5178542.0,11106.0,,,971283.0,,-1947.0,-93137.0,-43169797.0,4316815.0,2330995.0,3602961.0,851263.0,1750396.0,3719174.0,15732754.0,29098382.0,13161278.0,,1733470.0,4278327.0,1274359.0,1203083.0,1099319.0,8166775.0,1431577.0,,2145266.0,2449162.0,1419305.0,,2190245.0,6992058.0,119323.0,3423612.0,13106314.0,13460637.0,3458356.0,2213902.0,5868402.0,22560385.0,,2780532.0,8587119.0,2392288.0,2497947.0,2247053.0,13389460.0,1755699.0,,3484588.0,3127931.0,2003852.0,,3875645.0,201879.0,4187513.0,15857504.0,23443963.0,3443151.0,11206878.0,1770541.0,,126396.0,985093.0,184362.0,263009.0,291173.0,892317.0,8930.0,,203688.0,58079.0,81653.0,,235346.0,10839.0,24369.0,48872.0,249155.0,332582.0,511327.0,22560385.0,,2850607.0,8597726.0,2392288.0,2497947.0,2247053.0,13449198.0,1755699.0,,3484588.0,3127931.0,2003852.0,,3875645.0,201879.0,4187513.0,15857504.0,23443963.0,3443151.0,11206878.0,98113313.0,,25999915.0,15094316.0,2071212.0,26306348.0,6966723.0,51618720.0,4256381.0,,8646295.0,7178825.0,11952996.0,,11316947.0,147910.0,10807165.0,52477657.0,67764189.0,16569.0,25905191.0,19291429.0,,5205939.0,2394740.0,438324.0,7141355.0,1949903.0,12226268.0,900953.0,,1833562.0,986219.0,1203723.0,,3146484.0,40917.0,2200036.0,10322557.0,13555734.0,4718.0,7628835.0,1981577.0,,152335.0,358497.0,34694.0,144305.0,63694.0,981778.0,214658.0,,354490.0,367380.0,184452.0,,283062.0,20645.0,398178.0,2257997.0,2200340.0,3463.0,1024804.0,155508.0,,8028.0,38637.0,2674.0,15197.0,8254.0,40714.0,1092.0,,20721.0,7043.0,7516.0,,14840.0,1108.0,2317.0,6957.0,23384.0,303.0,46757.0,19291429.0,,5205939.0,2394740.0,438324.0,7141355.0,1949903.0,12226268.0,900953.0,,1833562.0,986219.0,1203723.0,,3146484.0,40917.0,2200036.0,10322557.0,13555734.0,4718.0,7628835.0,5820848.0,27212.0,28482233.0,2540934.0,-2164313.0,46503093.0,154.0,-32743771.0,73981410.0,-60084225.0,73906165.0,28543022.0,28543022.0,130931420.0,3408672.0,,85559610.0,22242115.0,26250003.0,1754411.0,26326859.0,76419900.0,104604561.0,-63668358.0,130931420.0,1078409.0,,,,,2012100.0,1454434.0,,409199.0,1815738.0,1407596.0,6142650.0,,901221.0,534272.0,1136587.0,,-720044.0,,-268000.0,910588.0,1799190.0,,1373039.0,534272.0,,3556445.0,,147338.0,17782621.0,612078.0,106052499.0,-62976048.0,,,,76856.0,76856.0,,333711.0,2648585.0,,,2179806.0,,314739.0,2648585.0,,,,,,12083268.0,,12083268.0,,1961332.0,,,,421334.0,,3422029.0,,4151875.0,,-23569.0,,,-12021.0,,,3085649.0,3085649.0,619907.0,,,,4860822.0,5788228.0,494834.0,283712.0,6246517.0,,,-5848986.0,-298.0,,,-890.0,,,,,,121521124.0,,43980694.0,105462566.0,12329961.0,76667899.0,9382541.0,9382541.0,963756.0,8649958.0,-7102549.0,,,,246135.0,208732.0,21847.0,-449722.0,,-64380.0,,9377334.0,31688519.0,5132236.0,8932093.0,869748.0,3834316.0,5132236.0,8932093.0,869748.0,3834316.0,752150.0,819531.0,168152.0,342017.0,,,52849.0,24542.0,,,-211792.0,,,,,,135894.0,63106.0,1051.0,1769417.0,638050.0,-1924845.0,-621051.0,-1243.0,2337355.0,4399964.0,175111.0,4399964.0,9844279.0,1154691.0,,2062920.0,2193.0,461.0,36811.0,,,,,9844279.0,,14.0,5124.0,461.0,2193.0,,,,,570791.0,,643267.0,597374.0,,,110756.0,4541228.0,,,,,,,1351048.0,,-2580.0,,,-106002.0,,874927.0,,,,,,,,,,,,,,,,,,,,,,,,50221760.0,,97311422.0,61823373.0,,,252201.0,20015650.0,57521075.0,,,,,,,,,,,,,,,,,,,,,,,,5053302.0,,11023559.0,6854738.0,,,95652.0,25279.0,1332459.0,1652272.0,4641527.0,,,,,5053302.0,,11023559.0,6854738.0,,,95652.0,25279.0,1332459.0,1652272.0,4641527.0,,,,28963.0,,,262119.0,,222753.0,223910.0,,,44316.0,12755.0,241158.0,361425.0,623510.0,,,,4701.0,,,,,,,,,,,,,65.0,,,,,,,,1123994.0,,,,,,,,,,,-5393257.0,,,,,,,,,,,,,,,,,214248.0,19470.0,,,,8027503.0,-96596.0,2226256.0,,,,,,,,,,,,,,,,,,,,,,,,,,,,,,,132394.0,,26593.0,131853.0,,721867.0,174345.0,1066159.0,2273691.0,,91680.0,49350.0,2438.0,1910560.0,,13599.0,,778.0,20542.0,,57124.0,33707.0,397159.0,348409.0,,14538.0,8932.0,533.0,310118.0,,,,,,,,,,,,,,,,,1067.0,,41.0,2022.0,,2032.0,1970.0,7613.0,14197.0,,783.0,52.0,2.0,3296.0,,17151.0,17151.0,2628.0,,,,,,,,,,,,,,,,,,,,,,,,,,,,,,,957122.0,,648489.0,1762318.0,168070.0,,4088834.0,-1773109.0,-2391.0,,-80139.0,,-1209.0,,3956049.0,170372.0,734595.0,,,5886324.0,,515809.0,,5886324.0,,27301.0,28152992.0,54428320.0,27301.0,2951.0,,,,,,,91106.0,188580.0,133437.0,1918.0,,15653.0,7211.0,3811.0,4359.0,968.0,,2103.0,,259.0,,,,556.0,401.0,565.0,52.0,,96.0,5573.0,27301.0,5709350.0,6050349.0,5709350.0,6050349.0,,,451901.0,654006.0,,,,,,,,,,,,,,,,,,,,,,,,,,,,,,,,,,,,,,,,94997.0,,,,,,44557.0,,,,,,,,,,,,,,,,,,,,,,,,,,,,,,,,,,,,,,,,,,,,,177882.0,,,,,3112545.0,479787.0,479787.0,114313.0,,,,,,,,,,,,,,,,,,,,,37193.0,,,,,,,297153.0,1281238.0,,,89837.0,,,,,,,,,,136815.0,12426.0,252899.0,,,,51508.0,,,,,,,,,78443.0,7124.0,144999.0,,,,,,,,,,,113095.0,,542.0,,,,,,,,,,,100811.0,,330.0,,,,,,,,,,,,1204979.0,,,,,,,,,,,,,,,,,,,,2343643.0,-1706544.0,,,76.0,,,,5378862.0,,,,,,,,,,,,,,,,,,,,,,,,,,,,,,,,,,,,,,,,,,,,,,,,,,,,,,,,,,,,,,,,,,,,,,3730795.0,22805799.0,,,,,,,,,,,,,,,,,,,,,,,,,,,,,,,,,,40572.0,,,9667.0,,,,,49.0,,,,,,,,,,,,,,1151909.0,,,,,,,,,,,,,,,,,,,,,,,,,,862731.0,93775.0,,,,,,,,,5893.0,1.0,,,,,,,,,,,,,,,,,,,,,,,,,,,,,,,,,,,,,,,,,,,,,,,,,,,,,-1706522.0,,,48374.0,,27735.0,,,,,,,,,,,,,,,,,,,,,,,,,,,,,,,,,,,,,,,,,,906573.0,,,,,,,,,,,,,,,,,,,,,,,,,,,,,,,,,,,,,,,,,,,,,,,,,,,,,,,,,,,,,,,,,,,,,,,,,,,,,,,,,,,,,,,,,,,,,,,,,,,,,15940.0,1.0,,,,,,,,,,,,,,,,,,,,,,,,,,,,,,,,,,,,,,,,,,,,,,,,,,,,,,,,,,,,,,,,,,,,,,,,,,,,,,,,,,,,,,,,,,,,,,,,,,,,,,,,,,,,,,,,,,,,,,,,,,,,,,,,,,,,,,,,,,,,,,,,,,,,,,,,,,,,,,,,,,,,,,,,,,,,,,,,,,,,,,,,,,,,,,,,,,,,,,,,,,,,,,,,,,,,,,,,,,,,,,,,,,,,,,,,,,,,,,,,,,,,,,,,2019,PA,,Y,Y,30837024.0,,,-23969.0,,-37483.0,,25973601.0,1657762.0,,32274279.0,,,21018916.0,,275700.0,27631363.0,27569911.0,275699.0,27294212.0,322742.79,40.487472,-79.896038,Voluntary non-profit - Private,Acute Care Hospitals,UPMC ST MARGARET (390102)
63719,724031,390102,12001,5,2022-09-08 00:00:00,2020-07-01 00:00:00,2021-06-30,F,O,39,39010,2.0,3.0,6280,,,,,,,,,,,,,,,,,,,,,,,,,,,,,,,,,,,,,,,,,,,,,,,,,,,,,,,,,,,,,,,,,,,,,,,,,,,,,,,,4492465.0,13997046.0,,5472493.0,8350599096.0,9.2395e-05,771554.0,193942.0,718015.0,,,,,,8290014521.0,8.4521e-05,700684.0,524073.0,,,,,,,,,,,,,,,,,,,,,,,,971310.0,,,,,,,,,,,,,,,,,,,,,,,,,,,,,,,,,,,,,,,,,,,,,,,,,,,,,,,,,,,,,,,,,,,,,,,,,,,,,,,,,,,,,,,,,,,,,,,,10725943.0,3520835.0,3146641.0,1032508.0,,,,,,,,,,10725943.0,3520835.0,,477691.0,3146641.0,1032508.0,,,34.56,49.56,,,,,,,,,,,,,,,,,,,,,,,,,,,,,,,,,,,,,,,,,213453931.0,2540934.0,46503093.0,73981410.0,240683615.0,19135159.0,9861966.0,4304527.0,19818406.0,,,,,-101939.0,7717670.0,7526120.0,,,,,-57771731.0,68178191.0,14186999.0,187395171.0,2768197.0,118461.0,-57771731.0,-82856.0,197801631.0,16933834.0,365657.0,189097288.0,36427695.0,550222.0,9175975.0,1688259.0,25333.0,185701498.0,193755777.0,185848127.0,36467481.0,550222.0,634399574.0,634399574.0,117533655.0,702773.0,1600004730.0,36467481.0,36467481.0,6837231.0,11717045.0,19299773.0,454169.0,513846.0,968015.0,18331758.0,102422421.0,102422421.0,26376081.0,204523.0,11717045.0,116100.0,60448.0,49331.0,11992.0,9249.0,410051.0,316501.0,398792.0,5345.0,60448.0,11992.0,,,,,,,,,,,,,,,,,,117533655.0,140856202.0,152752970.0,637766211.0,,,255573362.0,1561321836.0,,59.0,1316835335.0,12776387.0,1689526.0,1689526.0,244486501.0,255573362.0,-11086861.0,9302.0,0.116063,7948456.0,255786.0,7554939.0,1014580.0,2169157.0,5886818.0,161712.0,161712.0,161712.0,8716243.0,1154577.0,1154577.0,1.0,1.0,1.0,1090.85,1124.99,2225.0,2225.0,8537.0,8537.0,204.0,218.0,246.0,204.0,73762.0,78872.0,73762.0,9249.0,9639.0,9249.0,38634.0,41209.0,38634.0,612078.0,106052499.0,5728421.0,,,,-10065861.0,-8859711.0,,,,293489.0,,,,,,,965605156.0,965605156.0,,,,,,,,,,,,,,,,,,,,,,,,,,,,,,,,,,485013241.0,,923534079.0,923555625.0,671581.0,,48.0,48.0,,,,,,280.0,291.0,,280.0,,68178191.0,4334165.0,5748741.0,1832387.0,2483567.0,2072166.0,1514986.0,604372.0,,63295115.0,4334165.0,58960950.0,100967449.0,62433517.0,3871841.0,58561676.0,100568175.0,18080566.0,,99588921.0,99588921.0,9249844.0,,,,,,,,,,,,,,,,,,,,9164162.0,10318112.0,2015852.0,8321737.0,10213632.0,10043258.0,10033553.0,179100.0,116415.0,19694.0,10149968.0,10149882.0,8205668.0,1944214.0,,8649958.0,1368565.0,,1368565.0,,,,,,1458305.0,,,,,,,,,,2713323.0,1426129.0,67316593.0,3871841.0,,5101672.0,,1830558.0,,2507826.0,1519501.0,1584087.0,2741931.0,606277.0,1457449.0,2339978.7,28.77,2213192.55,2099461.35,28.21,27.89,38.36,,,,,2737372.0,1381588.0,320524.0,,,,,,,,40.98,107999.95,7763376.0,11992.0,49751.0,0.24104,1871284.0,,,21766145.0,21624636.0,9286583.0,9276878.0,30901514.0,0.699792,0.300208,5734426.0,4012905.0,37.28,1721521.0,59.08,37.28,13.79,13.09,15.95,14.28,14.28,152220.64,2173711.0,49751.0,20.04,12.65,5579617.0,5734426.0,54.8,34.58,1721521.0,,59.36,60.3,,,,,,7907650.0,,,,,186.57,3717661.0,14433940.0,8554531.0,992865.0,992865.0,168673847.0,19576793.0,3661045.0,,,10697.0,16775657.0,,,16775657.0,,,136499.68,37.37,20980278.0,20980278.0,663520.35,35.83,27.25,,,-1327966.0,,,1971001.0,545543.0,91446.0,,,,,,,,,,,,,,,,,,202043.0,,,,266508.0,86310.0,,32914.0,,36739.0,36739.0,112487.0,112487.0,112487.0,75748.0,36739.0,17262.0,11896768.0,3112.0,4042.0,5789299.0,990144.0,,933353.0,,5789299.0,990144.0,,933353.0,,113731.2,131904.61,8921.0,,,67489.6,155483.36,81759.9,41628.14,,27258.12,43544.68,34.04,43.89,110.99,,,27.12,16.13,18.58,38.05,,22.24,33.47,21026221.0,21026221.0,113731.2,522249.12,34.04,40.26,-24345.0,,,,115054.0,45288.0,85682.0,1164563.0,1293149.0,45288.0,26177.0,25708.0,3825.0,,,,0.0495,0.1051,0.1546,0.028,129426.0,115054.0,141509.0,34140639.0,2290776.0,81860.0,214417.0,139371.0,14017.0,31907374.0,31787725.0,1877754.0,,9705.0,85682.0,,,1410454.0,0.0318,44852.0,3523.0,112.9,0.0495,0.1051,0.1546,1348918.0,156559.0,1481808.0,100969.0,205.0,,21328.0,25472.0,,242600.0,,25472.0,,,242600.0,,,1617.0,76496.76,,,150.03,35.84,,2621710.47,-52163.0,,86.0,,,,,,,94.0,,,,291.0,,23.0,1512.0,,,,,,,5789299.0,5789299.0,,1982693.0,,467081.0,,,-147339.0,2348133.0,5199105.0,241271.0,5199105.0,23322547.0,,,5199105.0,5199105.0,1432153.0,1034219.0,2466372.0,66472.0,37941.0,104413.0,2361959.0,,,,,6115551.0,6302365.0,26787.0,1034219.0,15206.0,8542.0,2353.0,66472.0,,,26009.0,700.0,,,,,,,,2773516.0,23.40274,3006914.0,3006914.0,3006914.0,21576.0,2985338.0,56746.0,2928592.0,,,,2928592.0,92635.0,2940524.0,2920437.0,20087.0,140763.0,21.93,22.97,22.65,22.52,22.52,151239.16,3405906.0,969281.0,141509.0,9705.0,34.76,21.93,12921.0,0.259713,2016250.0,82061.0,58.14,53.33,53.18,52.64,53.05,53.05,0.284344,0.283642,0.283642,2656314.0,6.03,2814547.0,35950266.0,38.57,4012905.0,52.11,,59.08,15.92,224544.0,,,146.0,5.0,523.0,28.0,10220.0,2353.0,105.0,8542.0,,587090.0,33020.41,17.78,,,,,,,,,,,,,,,,,,,,,,,,,,,,,,0.813,7450464.0,,23322547.0,,234.0,,,,,,,,,,,,,,,,,,,,,,,,,,,,,,,,,,,,,,,,,,,,3814.0,,,,,,,,,,,,,,,,,,,,,,,,,,,,,,,,,247196.0,,,,,,,,,,,,,,,,,594982.0,110590.0,106733.0,,0.0397,,21.8,,-3.7,6.03,6.03,0.03232,0.008558,158233.0,,110590.0,,13.54,18798.0,34.14,3820.0,,4479.0,,,,,,,,,,,,,,,,,,,,,,,,,,,,,,,,16933.0,,,,,,8103.0,78653.0,9129.0,1026.0,487.0,18403140.0,485163.0,,,,,,144175.0,144175.0,339.7,424.42,,,,,,,,,,,,,,,,,,,,,,,,,,,,,,,55590.0,,,,,,,,,,,,,,,,,,,,,,,,,,,,,,,,,,,,,,,,,,,,,,,2343643.0,,,1368565.0,975078.0,,,,,,,,,,,,,,,,,,,,,,,,,,,,,,22.14,20.22,1.14,1.22,387987.0,,3523.0,,,,,,,,,,,,,,16775657.0,,,,,,,,,,,,,,,,,,,,,,,,,,,,,,,,,,,,,,,,,,,,,,,446547.0,,,,,,,,,,,,,,,,,,,,,,,,,,,,,,,,,,,,,,,,,,,,,,,,,,,,,,,975408.0,177276.0,,,,,,,,,,,,,,,,,,,,,,,,,,,1600024.0,13036.0,,,,,,,,179320.0,,90505.0,,,,,,,11932.0,1164563.0,1169655.0,,,,,,,,,,11932.0,,,,,0.94,,,,,,,,,,,,,,,,,,,,,,140763.0,,,,,,,,,,,,,,,,,,,,,,,,,,,,,,,,,,,,,,,,,,,,,,,128586.0,,5092.0,,,,,,,2183759.0,,,,,,,,,,,,,,,,,,,,,,,,,,,,,,,,,,,,,,,,,,,,,,,,,,,,,,,,,,,,,,,,,,,,,,,,,22010.0,22010.0,,,,,,,,,,,,,,,,,,,,,,,,,,,,,,,,,,,,,,,,,,,,,,,,,,,,,,,,,,,,,,,,,,,,,,,,,,,,,,,,,,,,,,,,,,,,,,,,,,,,,,,,,,,,,,,,,,,,,,,,,,,,,,,,,,,,,,,,,,,,,,,,,,,,,,,,,,,,,,,,,,,,,,,,,,,,,,,,,,,,,,,1142320.0,,,,,,,,,,,,,,,,,,,,,,,,,,,,,,,,,,,,,,,,1355956.0,1390000.0,,,,,,,,,,,,,,,,,,,,,,,,,,,,,,,,,,,,,,,,,,,,,,,,,,,,,,,,,,,,,,,,,,,,,,,,,,,,,,,,,,,,,,,,,,,,,,393517.0,,,,,,,,,,,,,,,,,,,,,,,,,,,,,,,,,,,,,,,,,815 FREEPORT ROAD,PITTSBURGH,15215,ALLEGHENY,UPMC ST MARGARET,38300,P,2,Y,N,N,Y,Y,N,,N,N,,,N,N,N,N,Y,Y,Y,,,HO0164,UNIVERSITY OF PITTSBURGH MEDICAL CEN,200 LOTHROP STREET,PITTSBURGH,PA,15213-2582,,Y,,,N,N,,,,UPMC ST MARGARET REHABILITATION UNIT,39T102,,,,,,,,,,,,,,,,,,,,,,,,,,,,,,,,,,,,,,,,,,,,,,,,,,,,,,,,,,,,,,,,,,,,,,,,,,,,,,,,,,,,,,,,,,,,,,,,,,,,,,,,,,,,,,,,,,,,,,,,,,,,,,,,,,,,,,,,,,,,,,,,,,,,,,,,,,,,,,,,,,,,,,,,,,-101939.0,,4068648.0,3649022.0,3966867.0,3559253.0,-38780829.0,2713323.0,604372.0,1426129.0,5748741.0,1543377.0,,,1588855.0,2483567.0,,1917076.0,14407487.0,203682.0,245186.0,,89199.0,87222456.0,24258153.0,,5240480.0,2203939.0,686425.0,4988614.0,1391063.0,683164.0,2524414.0,1962640.0,,711687.0,5491181.0,12357.0,,1038.0,1012199.0,-798.0,-239.0,-24643.0,-41108378.0,4068648.0,2475948.0,3592567.0,809720.0,1677992.0,3649022.0,14288723.0,29478118.0,13785820.0,,1861609.0,4008135.0,1353512.0,1383831.0,1123843.0,8618972.0,1391063.0,,2233862.0,2657704.0,1553710.0,,2294359.0,7304806.0,124189.0,3733664.0,15224092.0,14461343.0,3516689.0,2228302.0,5368471.0,23420957.0,,2901060.0,8136515.0,2468292.0,2711452.0,2201134.0,13764560.0,1686695.0,,3569607.0,3360829.0,2143734.0,,3975996.0,217263.0,4553854.0,18325973.0,24545679.0,3429553.0,10156294.0,1811508.0,,105444.0,943971.0,169174.0,227842.0,231968.0,907201.0,8114.0,,174721.0,56421.0,70233.0,,249946.0,22241.0,22007.0,53301.0,270358.0,323361.0,469664.0,23420957.0,,2971135.0,8147122.0,2468292.0,2711452.0,2201134.0,13790721.0,1686695.0,,3569607.0,3360829.0,2143734.0,,3975996.0,217263.0,4553854.0,18325973.0,24545679.0,3429553.0,10156294.0,107151412.0,,28043291.0,16546735.0,1797354.0,31151136.0,7819656.0,56810709.0,4878313.0,,10673889.0,7732175.0,12598369.0,,13100258.0,186930.0,12003662.0,63385659.0,79305676.0,17241.0,27609803.0,20483008.0,,5597080.0,3946612.0,275567.0,8126460.0,2009758.0,12625458.0,1124932.0,,2167542.0,1067900.0,1429936.0,,3590636.0,46875.0,2469779.0,13016132.0,16528550.0,8280.0,7694568.0,1890131.0,,143908.0,546377.0,20986.0,147528.0,54263.0,940923.0,242754.0,,369715.0,384646.0,216507.0,,280644.0,24034.0,400561.0,2619523.0,2414854.0,4660.0,896902.0,146187.0,,6442.0,55995.0,1438.0,12393.0,5718.0,35966.0,1168.0,,18097.0,6669.0,7092.0,,15728.0,2460.0,1936.0,7614.0,26594.0,382.0,41474.0,20483008.0,,5597080.0,3946612.0,275567.0,8126460.0,2009758.0,12625458.0,1124932.0,,2167542.0,1067900.0,1429936.0,,3590636.0,46875.0,2469779.0,13016132.0,16528550.0,8280.0,7694568.0,6536643.0,32501.0,39921217.0,2540934.0,-2266252.0,56365059.0,-846.0,-34304274.0,78285937.0,-61917929.0,87562980.0,36037439.0,36037439.0,163521636.0,4219339.0,,100704489.0,22194842.0,26717769.0,7784249.0,26789949.0,100994342.0,136731687.0,-73699268.0,163521636.0,1391311.0,,,,,2072166.0,1514986.0,,426127.0,1832387.0,1463331.0,6295562.0,,808338.0,541263.0,1134584.0,,-674693.0,,-301951.0,844278.0,1897829.0,,1266617.0,541263.0,,3395790.0,,135101.0,25004347.0,587733.0,111780920.0,-64818931.0,,,,79775.0,72180.0,,855378.0,2998957.0,,,204316.0,,723822.0,2998957.0,,,,,,11846174.0,,11846174.0,,1730750.0,,,,141438.0,,3358449.0,,4276376.0,,-16933.0,,,-28658.0,,,4449248.0,4449248.0,592243.0,,,,4881952.0,5784718.0,501497.0,253113.0,6490937.0,,,-5981820.0,,,,-3336.0,,,,,,146658473.0,,44903833.0,114555218.0,16074498.0,88698571.0,12317790.0,12317790.0,1136661.0,8597795.0,-7297769.0,,,138940.0,304965.0,199218.0,27690.0,-408750.0,,-70254.0,-1560.0,10253697.0,38506858.0,4746952.0,9538561.0,851494.0,4159654.0,4746952.0,9538561.0,851494.0,4159654.0,634456.0,842971.0,145238.0,312062.0,,,63476.0,27970.0,,,-211185.0,,,,,,140244.0,61799.0,,2125675.0,718923.0,-1372699.0,-576469.0,,2799878.0,4922182.0,178794.0,4922182.0,11896768.0,1579120.0,,2438253.0,2575.0,390.0,27078.0,,,,,11896768.0,-7595.0,14.0,5110.0,390.0,2575.0,,,,,601848.0,,745104.0,626662.0,,,111237.0,4060964.0,,,,,,,924129.0,,-3883.0,,,341319.0,,862613.0,,,,,,,,,,,,,,,,,,,,,,,,60329214.0,,118208196.0,73704645.0,,,236806.0,27674177.0,59521428.0,,,,,,,,,,,,,,,,,,,,,,,,6338976.0,,13001003.0,7196514.0,,,84625.0,10118.0,1759109.0,3708159.0,4660222.0,,,,,6338976.0,,13001003.0,7196514.0,,,84625.0,10118.0,1759109.0,3708159.0,4660222.0,,,,26177.0,,,278216.0,,236020.0,194306.0,,,32179.0,5188.0,285301.0,746274.0,543209.0,,,,3825.0,,,,,,,,,,,,,11.0,,,,,,,,1560146.0,,,,,,,,,,,-3956520.0,,,,,,,,,,,,,,,,,23507.0,21546.0,,,,7609081.0,-90000.0,1953984.0,,,,,,,,,,,,,,,,,,,,,,,,,,,,,,,110817.0,,21826.0,111122.0,,539046.0,152463.0,945480.0,1922620.0,,92457.0,36458.0,3435.0,1721325.0,,10226.0,,561.0,15133.0,,39127.0,26005.0,340551.0,291104.0,,12374.0,5913.0,691.0,251489.0,,,,,,,,,,,,,,,,,791.0,,25.0,1627.0,,1106.0,1273.0,5905.0,9536.0,,653.0,29.0,2.0,2770.0,,3707.0,3707.0,561.0,,,,,,,,,,,,,,,,,,,,,,,,,,,,,,,937767.0,,659705.0,2150314.0,157436.0,,4908641.0,-1510933.0,-2899.0,,2441.0,,-2130.0,,4836304.0,169541.0,701139.0,,,7032847.0,,469218.0,,7032847.0,,17308.0,30614617.0,70044119.0,,,,,,,,,192100.0,129647.0,77750.0,1980.0,,7899.0,14629.0,2354.0,2099.0,1015.0,,921.0,,,,,,1003.0,198.0,221.0,104.0,,43.0,3857.0,,5928394.0,7675000.0,5928394.0,7675000.0,,,451471.0,770424.0,,,,,,,,,,,,,,,,,,,,,,,,,,,,,,,,,,,,,,,,86310.0,,,,,,32914.0,,,,,,,,,,,,,,,,,,,,,,,,,,,,,,,,,,,,,,,,,,,,,162150.0,,,,,2937909.0,350723.0,350723.0,75684.0,,,,,,,,,,,,,,,,,,,,,,,,,,,,335915.0,1389183.0,,,79065.0,,,,,,,,,,205188.0,,308512.0,,,,39905.0,,,,,,,,,103561.0,,155710.0,,,,,,,,,,,114576.0,,446.0,,,,,,,,,,,82118.0,,270.0,,,,,,,,,,,,1164563.0,,,,,,,,,,,,,,,,,,,,975078.0,-965321.0,,,76.0,,,,5679593.0,,,,,,,,,,,,,,,,,,,,,,,,,,,,,,,,,,,,,,,,,,,,,,,,,,,,,,,,,,,,,,,,,,,,,,3708781.0,30057752.0,,,,,,,,,,,,,,,,,,,,,,,,,,,,,,,,,,22339.0,,,4821.0,,,,,23.0,,,,,,,,,,,,,,1072386.0,,,,,,,,,,,,,,,,,,,,,,,,,,1039028.0,277796.0,,,,,,,,,5092.0,,,,,,,,,,,,,,,,,,,,,,,,,,,,,,,,,,,,,,,,,,,,,,,,,,,,,,-1768571.0,,,48666.0,,24563.0,,,,,,,,,,,,,,,,,,,,,,,,,,,,,,,,,,,,,,,,,,987578.0,,,,,,,,,,,,,,,,,,,,,,,,,,,,,,,,,,,,,,,,,,,,,,,,,,,,,,,,,,,,,,,,,,,,,,,,,,,,,,,,,,,,,,,,,,,,,,,,,,,,,11932.0,,,,,,,,,,,,,,,,,,,,,,,,,,,,,,,,,,,,,,,,,,,,,,,,,,,,,,,,,,,,,,,,,,,,,,,,,,,,,,,,,,,,,,,,,,,,,,,,,,,,,,,,,,,,,,,,,,,,,,,,,,,,,,,,,,,,,,,,,,,,,,,,,,,,,,,,,,,,,,,,,,,,,,,,,,,,,,,,,,,,,,,,,,,,,,,,,,,,,,,,,,,,,,,,,,,,,,,,,,,,,,,,,,,,,,,,,,,,,,,,,,,,,,,,,2020,PA,,Y,N,33115691.0,,,76521.0,,-124592.0,,27816095.0,1683373.0,156144.0,34282148.0,,,22343602.0,,71578.0,29655612.0,29607541.0,296075.0,29311466.0,342821.48,40.487472,-79.896038,Voluntary non-profit - Private,Acute Care Hospitals,UPMC ST MARGARET (390102)
